CAGE	Caption	Channel	Duration	EndL	EndT	File	Index	InterTime	Name	Nature	SlotI	StartL	StartT	Type	Value	Velocity	linen	period
4	Drink 2	Intake 2	20	330	1335958338	/users/cn/jespinosa/phecomp/data/CRG/20120502_FDF_CRG/20120502_FDF_CRG/20120502_FDF_CRG_c12.mtb	144	NA	WWSS	water	2	310	1335958318	1	0.02	0.001	8641	1
4	Food 1	Intake 3	147	19487	1335977495	/users/cn/jespinosa/phecomp/data/CRG/20120502_FDF_CRG/20120502_FDF_CRG/20120502_FDF_CRG_c12.mtb	133	24	WWSS	food_sc	3	19340	1335977348	1	0.02	0.000136054421768707	8642	1
4	Food 1	Intake 3	110	19621	1335977629	/users/cn/jespinosa/phecomp/data/CRG/20120502_FDF_CRG/20120502_FDF_CRG/20120502_FDF_CRG_c12.mtb	134	12	WWSS	food_sc	3	19511	1335977519	1	0.02	0.000181818181818182	8643	1
4	Food 1	Intake 3	269	19902	1335977910	/users/cn/jespinosa/phecomp/data/CRG/20120502_FDF_CRG/20120502_FDF_CRG/20120502_FDF_CRG_c12.mtb	135	6903	WWSS	food_sc	3	19633	1335977641	1	0.08	0.000297397769516729	8644	1
4	Drink 1	Intake 1	40	20413	1335978421	/users/cn/jespinosa/phecomp/data/CRG/20120502_FDF_CRG/20120502_FDF_CRG/20120502_FDF_CRG_c12.mtb	232	NA	WWSS	water	1	20373	1335978381	1	0.04	0.001	8645	1
4	Food 1	Intake 3	393	27198	1335985206	/users/cn/jespinosa/phecomp/data/CRG/20120502_FDF_CRG/20120502_FDF_CRG/20120502_FDF_CRG_c12.mtb	149	886	WWSS	food_sc	3	26805	1335984813	1	0.1	0.000254452926208651	8646	1
4	Drink 2	Intake 2	23	27941	1335985949	/users/cn/jespinosa/phecomp/data/CRG/20120502_FDF_CRG/20120502_FDF_CRG/20120502_FDF_CRG_c12.mtb	162	NA	WWSS	water	2	27918	1335985926	1	0.02	0.000869565217391304	8647	1
4	Food 2	Intake 4	218	28302	1335986310	/users/cn/jespinosa/phecomp/data/CRG/20120502_FDF_CRG/20120502_FDF_CRG/20120502_FDF_CRG_c12.mtb	302	19	WWSS	food_sc	4	28084	1335986092	1	0.04	0.00018348623853211	8648	1
4	Food 2	Intake 4	257	28578	1335986586	/users/cn/jespinosa/phecomp/data/CRG/20120502_FDF_CRG/20120502_FDF_CRG/20120502_FDF_CRG_c12.mtb	303	604	WWSS	food_sc	4	28321	1335986329	1	0.08	0.000311284046692607	8649	1
4	Drink 2	Intake 2	46	28648	1335986656	/users/cn/jespinosa/phecomp/data/CRG/20120502_FDF_CRG/20120502_FDF_CRG/20120502_FDF_CRG_c12.mtb	166	NA	WWSS	water	2	28602	1335986610	1	0.08	0.00173913043478261	8650	1
4	Drink 2	Intake 2	24	28698	1335986706	/users/cn/jespinosa/phecomp/data/CRG/20120502_FDF_CRG/20120502_FDF_CRG/20120502_FDF_CRG_c12.mtb	167	NA	WWSS	water	2	28674	1335986682	1	0.04	0.00166666666666667	8651	1
4	Drink 2	Intake 2	15	28914	1335986922	/users/cn/jespinosa/phecomp/data/CRG/20120502_FDF_CRG/20120502_FDF_CRG/20120502_FDF_CRG_c12.mtb	171	NA	WWSS	water	2	28899	1335986907	1	0.02	0.00133333333333333	8652	1
4	Food 2	Intake 4	285	29467	1335987475	/users/cn/jespinosa/phecomp/data/CRG/20120502_FDF_CRG/20120502_FDF_CRG/20120502_FDF_CRG_c12.mtb	309	80	WWSS	food_sc	4	29182	1335987190	1	0.08	0.000280701754385965	8653	1
4	Drink 2	Intake 2	34	29529	1335987537	/users/cn/jespinosa/phecomp/data/CRG/20120502_FDF_CRG/20120502_FDF_CRG/20120502_FDF_CRG_c12.mtb	174	NA	WWSS	water	2	29495	1335987503	1	0.06	0.00176470588235294	8654	1
4	Food 2	Intake 4	147	29694	1335987702	/users/cn/jespinosa/phecomp/data/CRG/20120502_FDF_CRG/20120502_FDF_CRG/20120502_FDF_CRG_c12.mtb	310	1036	WWSS	food_sc	4	29547	1335987555	1	0.06	0.000408163265306122	8655	1
4	Drink 2	Intake 2	27	29724	1335987732	/users/cn/jespinosa/phecomp/data/CRG/20120502_FDF_CRG/20120502_FDF_CRG/20120502_FDF_CRG_c12.mtb	175	NA	WWSS	water	2	29697	1335987705	1	0.1	0.0037037037037037	8656	1
4	Food 2	Intake 4	164	30894	1335988902	/users/cn/jespinosa/phecomp/data/CRG/20120502_FDF_CRG/20120502_FDF_CRG/20120502_FDF_CRG_c12.mtb	321	415	WWSS	food_sc	4	30730	1335988738	1	0.06	0.000365853658536585	8657	1
4	Drink 1	Intake 1	17	30919	1335988927	/users/cn/jespinosa/phecomp/data/CRG/20120502_FDF_CRG/20120502_FDF_CRG/20120502_FDF_CRG_c12.mtb	236	NA	WWSS	water	1	30902	1335988910	1	0.02	0.00117647058823529	8658	1
4	Food 2	Intake 4	273	31582	1335989590	/users/cn/jespinosa/phecomp/data/CRG/20120502_FDF_CRG/20120502_FDF_CRG/20120502_FDF_CRG_c12.mtb	324	1132	WWSS	food_sc	4	31309	1335989317	1	0.1	0.000366300366300366	8659	1
4	Drink 2	Intake 2	42	31627	1335989635	/users/cn/jespinosa/phecomp/data/CRG/20120502_FDF_CRG/20120502_FDF_CRG/20120502_FDF_CRG_c12.mtb	185	NA	WWSS	water	2	31585	1335989593	1	0.06	0.00142857142857143	8660	1
4	Drink 1	Intake 1	17	32181	1335990189	/users/cn/jespinosa/phecomp/data/CRG/20120502_FDF_CRG/20120502_FDF_CRG/20120502_FDF_CRG_c12.mtb	238	NA	WWSS	water	1	32164	1335990172	1	0.02	0.00117647058823529	8661	1
4	Drink 2	Intake 2	22	32310	1335990318	/users/cn/jespinosa/phecomp/data/CRG/20120502_FDF_CRG/20120502_FDF_CRG/20120502_FDF_CRG_c12.mtb	188	NA	WWSS	water	2	32288	1335990296	1	0.02	0.000909090909090909	8662	1
4	Food 2	Intake 4	32	32746	1335990754	/users/cn/jespinosa/phecomp/data/CRG/20120502_FDF_CRG/20120502_FDF_CRG/20120502_FDF_CRG_c12.mtb	337	548	WWSS	food_sc	4	32714	1335990722	1	0.02	0.000625	8663	1
4	Food 1	Intake 3	149	33443	1335991451	/users/cn/jespinosa/phecomp/data/CRG/20120502_FDF_CRG/20120502_FDF_CRG/20120502_FDF_CRG_c12.mtb	185	3	WWSS	food_sc	3	33294	1335991302	1	0.02	0.000134228187919463	8664	1
4	Food 2	Intake 4	230	33676	1335991684	/users/cn/jespinosa/phecomp/data/CRG/20120502_FDF_CRG/20120502_FDF_CRG/20120502_FDF_CRG_c12.mtb	345	38	WWSS	food_sc	4	33446	1335991454	1	0.04	0.000173913043478261	8665	1
4	Drink 1	Intake 1	20	33707	1335991715	/users/cn/jespinosa/phecomp/data/CRG/20120502_FDF_CRG/20120502_FDF_CRG/20120502_FDF_CRG_c12.mtb	242	NA	WWSS	water	1	33687	1335991695	1	0.04	0.002	8666	1
4	Food 1	Intake 3	126	33840	1335991848	/users/cn/jespinosa/phecomp/data/CRG/20120502_FDF_CRG/20120502_FDF_CRG/20120502_FDF_CRG_c12.mtb	186	28	WWSS	food_sc	3	33714	1335991722	1	0.08	0.000634920634920635	8667	1
4	Food 1	Intake 3	59	33927	1335991935	/users/cn/jespinosa/phecomp/data/CRG/20120502_FDF_CRG/20120502_FDF_CRG/20120502_FDF_CRG_c12.mtb	187	7	WWSS	food_sc	3	33868	1335991876	1	0.04	0.000677966101694915	8668	1
4	Food 1	Intake 3	208	34142	1335992150	/users/cn/jespinosa/phecomp/data/CRG/20120502_FDF_CRG/20120502_FDF_CRG/20120502_FDF_CRG_c12.mtb	188	1493	WWSS	food_sc	3	33934	1335991942	1	0.08	0.000384615384615385	8669	1
4	Drink 2	Intake 2	45	34186	1335992194	/users/cn/jespinosa/phecomp/data/CRG/20120502_FDF_CRG/20120502_FDF_CRG/20120502_FDF_CRG_c12.mtb	196	NA	WWSS	water	2	34141	1335992149	1	0.14	0.00311111111111111	8670	1
4	Drink 1	Intake 1	18	34238	1335992246	/users/cn/jespinosa/phecomp/data/CRG/20120502_FDF_CRG/20120502_FDF_CRG/20120502_FDF_CRG_c12.mtb	243	NA	WWSS	water	1	34220	1335992228	1	0.04	0.00222222222222222	8671	1
4	Food 1	Intake 3	218	35853	1335993861	/users/cn/jespinosa/phecomp/data/CRG/20120502_FDF_CRG/20120502_FDF_CRG/20120502_FDF_CRG_c12.mtb	196	515	WWSS	food_sc	3	35635	1335993643	1	0.1	0.000458715596330275	8672	1
4	Drink 2	Intake 2	43	35925	1335993933	/users/cn/jespinosa/phecomp/data/CRG/20120502_FDF_CRG/20120502_FDF_CRG/20120502_FDF_CRG_c12.mtb	210	NA	WWSS	water	2	35882	1335993890	1	0.1	0.00232558139534884	8673	1
4	Drink 1	Intake 1	16	36202	1335994210	/users/cn/jespinosa/phecomp/data/CRG/20120502_FDF_CRG/20120502_FDF_CRG/20120502_FDF_CRG_c12.mtb	250	NA	WWSS	water	1	36186	1335994194	1	0.02	0.00125	8674	1
4	Food 1	Intake 3	178	36546	1335994554	/users/cn/jespinosa/phecomp/data/CRG/20120502_FDF_CRG/20120502_FDF_CRG/20120502_FDF_CRG_c12.mtb	202	255	WWSS	food_sc	3	36368	1335994376	1	0.02	0.000112359550561798	8675	1
4	Drink 1	Intake 1	19	36637	1335994645	/users/cn/jespinosa/phecomp/data/CRG/20120502_FDF_CRG/20120502_FDF_CRG/20120502_FDF_CRG_c12.mtb	251	NA	WWSS	water	1	36618	1335994626	1	0.06	0.00315789473684211	8676	1
4	Food 2	Intake 4	214	37015	1335995023	/users/cn/jespinosa/phecomp/data/CRG/20120502_FDF_CRG/20120502_FDF_CRG/20120502_FDF_CRG_c12.mtb	361	804	WWSS	food_sc	4	36801	1335994809	1	0.04	0.000186915887850467	8677	1
4	Drink 2	Intake 2	24	37035	1335995043	/users/cn/jespinosa/phecomp/data/CRG/20120502_FDF_CRG/20120502_FDF_CRG/20120502_FDF_CRG_c12.mtb	216	NA	WWSS	water	2	37011	1335995019	1	0.04	0.00166666666666667	8678	1
4	Drink 1	Intake 1	16	37402	1335995410	/users/cn/jespinosa/phecomp/data/CRG/20120502_FDF_CRG/20120502_FDF_CRG/20120502_FDF_CRG_c12.mtb	252	NA	WWSS	water	1	37386	1335995394	1	0.02	0.00125	8679	1
4	Food 1	Intake 3	199	38018	1335996026	/users/cn/jespinosa/phecomp/data/CRG/20120502_FDF_CRG/20120502_FDF_CRG/20120502_FDF_CRG_c12.mtb	209	7	WWSS	food_sc	3	37819	1335995827	1	0.0600000000000001	0.000301507537688443	8680	1
4	Food 1	Intake 3	305	38330	1335996338	/users/cn/jespinosa/phecomp/data/CRG/20120502_FDF_CRG/20120502_FDF_CRG/20120502_FDF_CRG_c12.mtb	210	55	WWSS	food_sc	3	38025	1335996033	1	0.1	0.000327868852459016	8681	1
4	Drink 2	Intake 2	31	38355	1335996363	/users/cn/jespinosa/phecomp/data/CRG/20120502_FDF_CRG/20120502_FDF_CRG/20120502_FDF_CRG_c12.mtb	222	NA	WWSS	water	2	38324	1335996332	1	0.12	0.00387096774193548	8682	1
4	Drink 2	Intake 2	28	38390	1335996398	/users/cn/jespinosa/phecomp/data/CRG/20120502_FDF_CRG/20120502_FDF_CRG/20120502_FDF_CRG_c12.mtb	223	NA	WWSS	water	2	38362	1335996370	1	0.02	0.000714285714285714	8683	1
4	Food 1	Intake 3	109	38494	1335996502	/users/cn/jespinosa/phecomp/data/CRG/20120502_FDF_CRG/20120502_FDF_CRG/20120502_FDF_CRG_c12.mtb	211	712	WWSS	food_sc	3	38385	1335996393	1	0.02	0.00018348623853211	8684	1
4	Drink 1	Intake 1	26	38517	1335996525	/users/cn/jespinosa/phecomp/data/CRG/20120502_FDF_CRG/20120502_FDF_CRG/20120502_FDF_CRG_c12.mtb	253	NA	WWSS	water	1	38491	1335996499	1	0.06	0.00230769230769231	8685	1
4	Drink 1	Intake 1	18	38733	1335996741	/users/cn/jespinosa/phecomp/data/CRG/20120502_FDF_CRG/20120502_FDF_CRG/20120502_FDF_CRG_c12.mtb	254	NA	WWSS	water	1	38715	1335996723	1	0.02	0.00111111111111111	8686	1
4	Food 1	Intake 3	95	39301	1335997309	/users/cn/jespinosa/phecomp/data/CRG/20120502_FDF_CRG/20120502_FDF_CRG/20120502_FDF_CRG_c12.mtb	216	58	WWSS	food_sc	3	39206	1335997214	1	0.02	0.000210526315789474	8687	1
4	Drink 1	Intake 1	21	39334	1335997342	/users/cn/jespinosa/phecomp/data/CRG/20120502_FDF_CRG/20120502_FDF_CRG/20120502_FDF_CRG_c12.mtb	256	NA	WWSS	water	1	39313	1335997321	1	0.06	0.00285714285714286	8688	1
4	Food 2	Intake 4	430	39789	1335997797	/users/cn/jespinosa/phecomp/data/CRG/20120502_FDF_CRG/20120502_FDF_CRG/20120502_FDF_CRG_c12.mtb	373	666	WWSS	food_sc	4	39359	1335997367	1	0.12	0.00027906976744186	8689	1
4	Drink 2	Intake 2	30	39816	1335997824	/users/cn/jespinosa/phecomp/data/CRG/20120502_FDF_CRG/20120502_FDF_CRG/20120502_FDF_CRG_c12.mtb	231	NA	WWSS	water	2	39786	1335997794	1	0.08	0.00266666666666667	8690	1
4	Food 2	Intake 4	621	41076	1335999084	/users/cn/jespinosa/phecomp/data/CRG/20120502_FDF_CRG/20120502_FDF_CRG/20120502_FDF_CRG_c12.mtb	376	818	WWSS	food_sc	4	40455	1335998463	1	0.24	0.000386473429951691	8691	1
4	Drink 2	Intake 2	52	41130	1335999138	/users/cn/jespinosa/phecomp/data/CRG/20120502_FDF_CRG/20120502_FDF_CRG/20120502_FDF_CRG_c12.mtb	236	NA	WWSS	water	2	41078	1335999086	1	0.12	0.00230769230769231	8692	1
4	Drink 1	Intake 1	19	41237	1335999245	/users/cn/jespinosa/phecomp/data/CRG/20120502_FDF_CRG/20120502_FDF_CRG/20120502_FDF_CRG_c12.mtb	258	NA	WWSS	water	1	41218	1335999226	1	0.02	0.00105263157894737	8693	1
4	Drink 2	Intake 2	49	41697	1335999705	/users/cn/jespinosa/phecomp/data/CRG/20120502_FDF_CRG/20120502_FDF_CRG/20120502_FDF_CRG_c12.mtb	240	NA	WWSS	water	2	41648	1335999656	1	0.0999999999999999	0.00204081632653061	8694	1
4	Food 2	Intake 4	413	42307	1336000315	/users/cn/jespinosa/phecomp/data/CRG/20120502_FDF_CRG/20120502_FDF_CRG/20120502_FDF_CRG_c12.mtb	380	7634	WWSS	food_sc	4	41894	1335999902	1	0.12	0.000290556900726392	8695	1
4	Drink 2	Intake 2	21	42327	1336000335	/users/cn/jespinosa/phecomp/data/CRG/20120502_FDF_CRG/20120502_FDF_CRG/20120502_FDF_CRG_c12.mtb	242	NA	WWSS	water	2	42306	1336000314	1	0.04	0.0019047619047619	8696	1
4	Drink 1	Intake 1	21	42378	1336000386	/users/cn/jespinosa/phecomp/data/CRG/20120502_FDF_CRG/20120502_FDF_CRG/20120502_FDF_CRG_c12.mtb	262	NA	WWSS	water	1	42357	1336000365	1	0.08	0.00380952380952381	8697	1
4	Drink 2	Intake 2	41	49869	1336007877	/users/cn/jespinosa/phecomp/data/CRG/20120502_FDF_CRG/20120502_FDF_CRG/20120502_FDF_CRG_c12.mtb	250	NA	WWSS	water	2	49828	1336007836	1	0.04	0.000975609756097561	8698	1
4	Food 1	Intake 3	29	49970	1336007978	/users/cn/jespinosa/phecomp/data/CRG/20120502_FDF_CRG/20120502_FDF_CRG/20120502_FDF_CRG_c12.mtb	244	68	WWSS	food_sc	3	49941	1336007949	1	0.02	0.000689655172413793	8699	1
4	Food 2	Intake 4	65	50103	1336008111	/users/cn/jespinosa/phecomp/data/CRG/20120502_FDF_CRG/20120502_FDF_CRG/20120502_FDF_CRG_c12.mtb	388	172	WWSS	food_sc	4	50038	1336008046	1	0.02	0.000307692307692308	8700	1
4	Food 2	Intake 4	248	50523	1336008531	/users/cn/jespinosa/phecomp/data/CRG/20120502_FDF_CRG/20120502_FDF_CRG/20120502_FDF_CRG_c12.mtb	390	696	WWSS	food_sc	4	50275	1336008283	1	0.0600000000000001	0.000241935483870968	8701	1
4	Drink 2	Intake 2	51	50574	1336008582	/users/cn/jespinosa/phecomp/data/CRG/20120502_FDF_CRG/20120502_FDF_CRG/20120502_FDF_CRG_c12.mtb	254	NA	WWSS	water	2	50523	1336008531	1	0.0999999999999999	0.00196078431372549	8702	1
4	Drink 2	Intake 2	80	50865	1336008873	/users/cn/jespinosa/phecomp/data/CRG/20120502_FDF_CRG/20120502_FDF_CRG/20120502_FDF_CRG_c12.mtb	257	NA	WWSS	water	2	50785	1336008793	1	0.02	0.00025	8703	1
4	Drink 2	Intake 2	39	51188	1336009196	/users/cn/jespinosa/phecomp/data/CRG/20120502_FDF_CRG/20120502_FDF_CRG/20120502_FDF_CRG_c12.mtb	259	NA	WWSS	water	2	51149	1336009157	1	0.02	0.000512820512820513	8704	1
4	Food 2	Intake 4	219	51438	1336009446	/users/cn/jespinosa/phecomp/data/CRG/20120502_FDF_CRG/20120502_FDF_CRG/20120502_FDF_CRG_c12.mtb	396	62	WWSS	food_sc	4	51219	1336009227	1	0.04	0.000182648401826484	8705	1
4	Food 2	Intake 4	215	51715	1336009723	/users/cn/jespinosa/phecomp/data/CRG/20120502_FDF_CRG/20120502_FDF_CRG/20120502_FDF_CRG_c12.mtb	397	14	WWSS	food_sc	4	51500	1336009508	1	0.0399999999999998	0.000186046511627906	8706	1
4	Food 2	Intake 4	113	51842	1336009850	/users/cn/jespinosa/phecomp/data/CRG/20120502_FDF_CRG/20120502_FDF_CRG/20120502_FDF_CRG_c12.mtb	398	23	WWSS	food_sc	4	51729	1336009737	1	0.02	0.000176991150442478	8707	1
4	Food 2	Intake 4	400	52265	1336010273	/users/cn/jespinosa/phecomp/data/CRG/20120502_FDF_CRG/20120502_FDF_CRG/20120502_FDF_CRG_c12.mtb	399	9385	WWSS	food_sc	4	51865	1336009873	1	0.14	0.00035	8708	1
4	Drink 2	Intake 2	60	52319	1336010327	/users/cn/jespinosa/phecomp/data/CRG/20120502_FDF_CRG/20120502_FDF_CRG/20120502_FDF_CRG_c12.mtb	262	NA	WWSS	water	2	52259	1336010267	1	0.22	0.00366666666666667	8709	1
4	Drink 1	Intake 1	21	53131	1336011139	/users/cn/jespinosa/phecomp/data/CRG/20120502_FDF_CRG/20120502_FDF_CRG/20120502_FDF_CRG_c12.mtb	266	NA	WWSS	water	1	53110	1336011118	1	0.04	0.0019047619047619	8710	1
4	Food 1	Intake 3	277	61927	1336019935	/users/cn/jespinosa/phecomp/data/CRG/20120502_FDF_CRG/20120502_FDF_CRG/20120502_FDF_CRG_c12.mtb	269	41	WWSS	food_sc	3	61650	1336019658	1	0.0399999999999999	0.000144404332129964	8711	1
4	Food 1	Intake 3	182	62150	1336020158	/users/cn/jespinosa/phecomp/data/CRG/20120502_FDF_CRG/20120502_FDF_CRG/20120502_FDF_CRG_c12.mtb	270	5733	WWSS	food_sc	3	61968	1336019976	1	0.02	0.00010989010989011	8712	1
4	Drink 2	Intake 2	31	63059	1336021067	/users/cn/jespinosa/phecomp/data/CRG/20120502_FDF_CRG/20120502_FDF_CRG/20120502_FDF_CRG_c12.mtb	290	NA	WWSS	water	2	63028	1336021036	1	0.12	0.00387096774193548	8713	1
4	Drink 2	Intake 2	23	65081	1336023089	/users/cn/jespinosa/phecomp/data/CRG/20120502_FDF_CRG/20120502_FDF_CRG/20120502_FDF_CRG_c12.mtb	291	NA	WWSS	water	2	65058	1336023066	1	0.02	0.000869565217391304	8714	1
4	Food 2	Intake 4	352	68235	1336026243	/users/cn/jespinosa/phecomp/data/CRG/20120502_FDF_CRG/20120502_FDF_CRG/20120502_FDF_CRG_c12.mtb	424	13	WWSS	food_sc	4	67883	1336025891	1	0.0599999999999998	0.000170454545454545	8715	1
4	Food 2	Intake 4	574	68822	1336026830	/users/cn/jespinosa/phecomp/data/CRG/20120502_FDF_CRG/20120502_FDF_CRG/20120502_FDF_CRG_c12.mtb	425	507	WWSS	food_sc	4	68248	1336026256	1	0.14	0.00024390243902439	8716	1
4	Drink 2	Intake 2	44	68888	1336026896	/users/cn/jespinosa/phecomp/data/CRG/20120502_FDF_CRG/20120502_FDF_CRG/20120502_FDF_CRG_c12.mtb	295	NA	WWSS	water	2	68844	1336026852	1	0.12	0.00272727272727273	8717	1
4	Drink 2	Intake 2	20	69031	1336027039	/users/cn/jespinosa/phecomp/data/CRG/20120502_FDF_CRG/20120502_FDF_CRG/20120502_FDF_CRG_c12.mtb	296	NA	WWSS	water	2	69011	1336027019	1	0.04	0.002	8718	1
4	Drink 1	Intake 1	33	69203	1336027211	/users/cn/jespinosa/phecomp/data/CRG/20120502_FDF_CRG/20120502_FDF_CRG/20120502_FDF_CRG_c12.mtb	271	NA	WWSS	water	1	69170	1336027178	1	0.02	0.000606060606060606	8719	1
4	Drink 2	Intake 2	11	69281	1336027289	/users/cn/jespinosa/phecomp/data/CRG/20120502_FDF_CRG/20120502_FDF_CRG/20120502_FDF_CRG_c12.mtb	301	NA	WWSS	water	2	69270	1336027278	1	0.02	0.00181818181818182	8720	1
4	Drink 1	Intake 1	15	69293	1336027301	/users/cn/jespinosa/phecomp/data/CRG/20120502_FDF_CRG/20120502_FDF_CRG/20120502_FDF_CRG_c12.mtb	273	NA	WWSS	water	1	69278	1336027286	1	0.0399999999999999	0.00266666666666666	8721	1
4	Food 2	Intake 4	197	69526	1336027534	/users/cn/jespinosa/phecomp/data/CRG/20120502_FDF_CRG/20120502_FDF_CRG/20120502_FDF_CRG_c12.mtb	428	30	WWSS	food_sc	4	69329	1336027337	1	0.02	0.000101522842639594	8722	1
4	Food 2	Intake 4	443	69999	1336028007	/users/cn/jespinosa/phecomp/data/CRG/20120502_FDF_CRG/20120502_FDF_CRG/20120502_FDF_CRG_c12.mtb	429	5577	WWSS	food_sc	4	69556	1336027564	1	0.0600000000000001	0.000135440180586908	8723	1
4	Drink 2	Intake 2	25	70017	1336028025	/users/cn/jespinosa/phecomp/data/CRG/20120502_FDF_CRG/20120502_FDF_CRG/20120502_FDF_CRG_c12.mtb	303	NA	WWSS	water	2	69992	1336028000	1	0.12	0.0048	8724	1
4	Food 1	Intake 3	16	75592	1336033600	/users/cn/jespinosa/phecomp/data/CRG/20120502_FDF_CRG/20120502_FDF_CRG/20120502_FDF_CRG_c12.mtb	285	175	WWSS	food_sc	3	75576	1336033584	1	0.02	0.00125	8725	1
4	Food 2	Intake 4	19	75786	1336033794	/users/cn/jespinosa/phecomp/data/CRG/20120502_FDF_CRG/20120502_FDF_CRG/20120502_FDF_CRG_c12.mtb	436	35266	WWSS	food_sc	4	75767	1336033775	1	0.02	0.00105263157894737	8726	1
4	Drink 2	Intake 2	19	105767	1336063775	/users/cn/jespinosa/phecomp/data/CRG/20120502_FDF_CRG/20120502_FDF_CRG/20120502_FDF_CRG_c12.mtb	313	NA	WWSS	water	2	105748	1336063756	1	0.02	0.00105263157894737	8727	1
4	Food 2	Intake 4	461	111513	1336069521	/users/cn/jespinosa/phecomp/data/CRG/20120502_FDF_CRG/20120502_FDF_CRG/20120502_FDF_CRG_c12.mtb	460	60	WWSS	food_sc	4	111052	1336069060	1	0.0600000000000001	0.000130151843817788	8728	1
4	Food 2	Intake 4	340	111913	1336069921	/users/cn/jespinosa/phecomp/data/CRG/20120502_FDF_CRG/20120502_FDF_CRG/20120502_FDF_CRG_c12.mtb	461	78	WWSS	food_sc	4	111573	1336069581	1	0.0399999999999998	0.000117647058823529	8729	1
4	Food 2	Intake 4	680	112671	1336070679	/users/cn/jespinosa/phecomp/data/CRG/20120502_FDF_CRG/20120502_FDF_CRG/20120502_FDF_CRG_c12.mtb	462	475	WWSS	food_sc	4	111991	1336069999	1	0.12	0.000176470588235294	8730	1
4	Drink 2	Intake 2	44	112707	1336070715	/users/cn/jespinosa/phecomp/data/CRG/20120502_FDF_CRG/20120502_FDF_CRG/20120502_FDF_CRG_c12.mtb	320	NA	WWSS	water	2	112663	1336070671	1	0.12	0.00272727272727273	8731	1
4	Food 2	Intake 4	85	113231	1336071239	/users/cn/jespinosa/phecomp/data/CRG/20120502_FDF_CRG/20120502_FDF_CRG/20120502_FDF_CRG_c12.mtb	465	297	WWSS	food_sc	4	113146	1336071154	1	0.02	0.000235294117647059	8732	1
4	Food 2	Intake 4	227	113755	1336071763	/users/cn/jespinosa/phecomp/data/CRG/20120502_FDF_CRG/20120502_FDF_CRG/20120502_FDF_CRG_c12.mtb	466	49	WWSS	food_sc	4	113528	1336071536	1	0.02	8.81057268722467e-05	8733	1
4	Drink 2	Intake 2	24	113794	1336071802	/users/cn/jespinosa/phecomp/data/CRG/20120502_FDF_CRG/20120502_FDF_CRG/20120502_FDF_CRG_c12.mtb	327	NA	WWSS	water	2	113770	1336071778	1	0.04	0.00166666666666667	8734	1
4	Food 2	Intake 4	601	114405	1336072413	/users/cn/jespinosa/phecomp/data/CRG/20120502_FDF_CRG/20120502_FDF_CRG/20120502_FDF_CRG_c12.mtb	468	114	WWSS	food_sc	4	113804	1336071812	1	0.0800000000000001	0.000133111480865225	8735	1
4	Drink 2	Intake 2	26	114424	1336072432	/users/cn/jespinosa/phecomp/data/CRG/20120502_FDF_CRG/20120502_FDF_CRG/20120502_FDF_CRG_c12.mtb	328	NA	WWSS	water	2	114398	1336072406	1	0.0599999999999996	0.00230769230769229	8736	1
4	Food 2	Intake 4	18	114537	1336072545	/users/cn/jespinosa/phecomp/data/CRG/20120502_FDF_CRG/20120502_FDF_CRG/20120502_FDF_CRG_c12.mtb	469	62	WWSS	food_sc	4	114519	1336072527	1	0.02	0.00111111111111111	8737	1
4	Food 2	Intake 4	385	114984	1336072992	/users/cn/jespinosa/phecomp/data/CRG/20120502_FDF_CRG/20120502_FDF_CRG/20120502_FDF_CRG_c12.mtb	470	2038	WWSS	food_sc	4	114599	1336072607	1	0.04	0.000103896103896104	8738	1
4	Drink 2	Intake 2	20	115003	1336073011	/users/cn/jespinosa/phecomp/data/CRG/20120502_FDF_CRG/20120502_FDF_CRG/20120502_FDF_CRG_c12.mtb	331	NA	WWSS	water	2	114983	1336072991	1	0.0800000000000001	0.00400000000000001	8739	1
4	Food 2	Intake 4	797	117819	1336075827	/users/cn/jespinosa/phecomp/data/CRG/20120502_FDF_CRG/20120502_FDF_CRG/20120502_FDF_CRG_c12.mtb	473	816	WWSS	food_sc	4	117022	1336075030	1	0.16	0.000200752823086575	8740	1
4	Drink 2	Intake 2	31	117856	1336075864	/users/cn/jespinosa/phecomp/data/CRG/20120502_FDF_CRG/20120502_FDF_CRG/20120502_FDF_CRG_c12.mtb	335	NA	WWSS	water	2	117825	1336075833	1	0.12	0.00387096774193548	8741	1
4	Food 2	Intake 4	285	118920	1336076928	/users/cn/jespinosa/phecomp/data/CRG/20120502_FDF_CRG/20120502_FDF_CRG/20120502_FDF_CRG_c12.mtb	481	38	WWSS	food_sc	4	118635	1336076643	1	0.0600000000000001	0.000210526315789474	8742	1
4	Drink 2	Intake 2	39	118963	1336076971	/users/cn/jespinosa/phecomp/data/CRG/20120502_FDF_CRG/20120502_FDF_CRG/20120502_FDF_CRG_c12.mtb	343	NA	WWSS	water	2	118924	1336076932	1	0.12	0.00307692307692308	8743	1
4	Food 2	Intake 4	575	119533	1336077541	/users/cn/jespinosa/phecomp/data/CRG/20120502_FDF_CRG/20120502_FDF_CRG/20120502_FDF_CRG_c12.mtb	482	66	WWSS	food_sc	4	118958	1336076966	1	0.14	0.000243478260869565	8744	1
4	Drink 1	Intake 1	28	119580	1336077588	/users/cn/jespinosa/phecomp/data/CRG/20120502_FDF_CRG/20120502_FDF_CRG/20120502_FDF_CRG_c12.mtb	283	NA	WWSS	water	1	119552	1336077560	1	0.14	0.005	8745	1
4	Food 2	Intake 4	63	119662	1336077670	/users/cn/jespinosa/phecomp/data/CRG/20120502_FDF_CRG/20120502_FDF_CRG/20120502_FDF_CRG_c12.mtb	483	540	WWSS	food_sc	4	119599	1336077607	1	0.02	0.000317460317460317	8746	1
4	Food 2	Intake 4	47	120249	1336078257	/users/cn/jespinosa/phecomp/data/CRG/20120502_FDF_CRG/20120502_FDF_CRG/20120502_FDF_CRG_c12.mtb	487	91	WWSS	food_sc	4	120202	1336078210	1	0.02	0.000425531914893617	8747	1
4	Food 2	Intake 4	86	120426	1336078434	/users/cn/jespinosa/phecomp/data/CRG/20120502_FDF_CRG/20120502_FDF_CRG/20120502_FDF_CRG_c12.mtb	489	870	WWSS	food_sc	4	120340	1336078348	1	0.02	0.000232558139534884	8748	1
4	Drink 1	Intake 1	19	120438	1336078446	/users/cn/jespinosa/phecomp/data/CRG/20120502_FDF_CRG/20120502_FDF_CRG/20120502_FDF_CRG_c12.mtb	285	NA	WWSS	water	1	120419	1336078427	1	0.04	0.00210526315789474	8749	1
4	Drink 1	Intake 1	18	120793	1336078801	/users/cn/jespinosa/phecomp/data/CRG/20120502_FDF_CRG/20120502_FDF_CRG/20120502_FDF_CRG_c12.mtb	287	NA	WWSS	water	1	120775	1336078783	1	0.02	0.00111111111111111	8750	1
4	Food 2	Intake 4	58	121354	1336079362	/users/cn/jespinosa/phecomp/data/CRG/20120502_FDF_CRG/20120502_FDF_CRG/20120502_FDF_CRG_c12.mtb	496	823	WWSS	food_sc	4	121296	1336079304	1	0.02	0.000344827586206897	8751	1
4	Food 1	Intake 3	212	122389	1336080397	/users/cn/jespinosa/phecomp/data/CRG/20120502_FDF_CRG/20120502_FDF_CRG/20120502_FDF_CRG_c12.mtb	333	34	WWSS	food_sc	3	122177	1336080185	1	0.04	0.000188679245283019	8752	1
4	Food 1	Intake 3	273	122696	1336080704	/users/cn/jespinosa/phecomp/data/CRG/20120502_FDF_CRG/20120502_FDF_CRG/20120502_FDF_CRG_c12.mtb	334	14	WWSS	food_sc	3	122423	1336080431	1	0.0599999999999999	0.000219780219780219	8753	1
4	Drink 2	Intake 2	24	122716	1336080724	/users/cn/jespinosa/phecomp/data/CRG/20120502_FDF_CRG/20120502_FDF_CRG/20120502_FDF_CRG_c12.mtb	355	NA	WWSS	water	2	122692	1336080700	1	0.0600000000000001	0.0025	8754	1
4	Food 1	Intake 3	300	123010	1336081018	/users/cn/jespinosa/phecomp/data/CRG/20120502_FDF_CRG/20120502_FDF_CRG/20120502_FDF_CRG_c12.mtb	335	55	WWSS	food_sc	3	122710	1336080718	1	0.0600000000000001	0.0002	8755	1
4	Drink 1	Intake 1	29	123057	1336081065	/users/cn/jespinosa/phecomp/data/CRG/20120502_FDF_CRG/20120502_FDF_CRG/20120502_FDF_CRG_c12.mtb	290	NA	WWSS	water	1	123028	1336081036	1	0.08	0.00275862068965517	8756	1
4	Food 1	Intake 3	180	123245	1336081253	/users/cn/jespinosa/phecomp/data/CRG/20120502_FDF_CRG/20120502_FDF_CRG/20120502_FDF_CRG_c12.mtb	336	245	WWSS	food_sc	3	123065	1336081073	1	0.02	0.000111111111111111	8757	1
4	Drink 2	Intake 2	17	123402	1336081410	/users/cn/jespinosa/phecomp/data/CRG/20120502_FDF_CRG/20120502_FDF_CRG/20120502_FDF_CRG_c12.mtb	356	NA	WWSS	water	2	123385	1336081393	1	0.02	0.00117647058823529	8758	1
4	Food 1	Intake 3	324	123814	1336081822	/users/cn/jespinosa/phecomp/data/CRG/20120502_FDF_CRG/20120502_FDF_CRG/20120502_FDF_CRG_c12.mtb	339	57	WWSS	food_sc	3	123490	1336081498	1	0.04	0.000123456790123457	8759	1
4	Drink 1	Intake 1	20	123826	1336081834	/users/cn/jespinosa/phecomp/data/CRG/20120502_FDF_CRG/20120502_FDF_CRG/20120502_FDF_CRG_c12.mtb	293	NA	WWSS	water	1	123806	1336081814	1	0.0599999999999999	0.00299999999999999	8760	1
4	Food 1	Intake 3	427	124298	1336082306	/users/cn/jespinosa/phecomp/data/CRG/20120502_FDF_CRG/20120502_FDF_CRG/20120502_FDF_CRG_c12.mtb	340	212	WWSS	food_sc	3	123871	1336081879	1	0.0799999999999998	0.00018735362997658	8761	1
4	Drink 1	Intake 1	23	124312	1336082320	/users/cn/jespinosa/phecomp/data/CRG/20120502_FDF_CRG/20120502_FDF_CRG/20120502_FDF_CRG_c12.mtb	294	NA	WWSS	water	1	124289	1336082297	1	0.0800000000000001	0.00347826086956522	8762	1
4	Food 1	Intake 3	81	124591	1336082599	/users/cn/jespinosa/phecomp/data/CRG/20120502_FDF_CRG/20120502_FDF_CRG/20120502_FDF_CRG_c12.mtb	342	483	WWSS	food_sc	3	124510	1336082518	1	0.02	0.000246913580246914	8763	1
4	Food 1	Intake 3	301	125375	1336083383	/users/cn/jespinosa/phecomp/data/CRG/20120502_FDF_CRG/20120502_FDF_CRG/20120502_FDF_CRG_c12.mtb	346	960	WWSS	food_sc	3	125074	1336083082	1	0.0600000000000001	0.000199335548172758	8764	1
4	Drink 2	Intake 2	28	125394	1336083402	/users/cn/jespinosa/phecomp/data/CRG/20120502_FDF_CRG/20120502_FDF_CRG/20120502_FDF_CRG_c12.mtb	364	NA	WWSS	water	2	125366	1336083374	1	0.0599999999999996	0.00214285714285713	8765	1
4	Drink 1	Intake 1	15	126079	1336084087	/users/cn/jespinosa/phecomp/data/CRG/20120502_FDF_CRG/20120502_FDF_CRG/20120502_FDF_CRG_c12.mtb	297	NA	WWSS	water	1	126064	1336084072	1	0.02	0.00133333333333333	8766	1
4	Drink 2	Intake 2	17	126287	1336084295	/users/cn/jespinosa/phecomp/data/CRG/20120502_FDF_CRG/20120502_FDF_CRG/20120502_FDF_CRG_c12.mtb	368	NA	WWSS	water	2	126270	1336084278	1	0.0200000000000005	0.00117647058823532	8767	1
4	Food 1	Intake 3	1106	127441	1336085449	/users/cn/jespinosa/phecomp/data/CRG/20120502_FDF_CRG/20120502_FDF_CRG/20120502_FDF_CRG_c12.mtb	355	498	WWSS	food_sc	3	126335	1336084343	1	0.28	0.000253164556962025	8768	1
4	Drink 1	Intake 1	58	127492	1336085500	/users/cn/jespinosa/phecomp/data/CRG/20120502_FDF_CRG/20120502_FDF_CRG/20120502_FDF_CRG_c12.mtb	299	NA	WWSS	water	1	127434	1336085442	1	0.14	0.00241379310344828	8769	1
4	Drink 1	Intake 1	24	127680	1336085688	/users/cn/jespinosa/phecomp/data/CRG/20120502_FDF_CRG/20120502_FDF_CRG/20120502_FDF_CRG_c12.mtb	301	NA	WWSS	water	1	127656	1336085664	1	0.04	0.00166666666666667	8770	1
4	Drink 1	Intake 1	15	127881	1336085889	/users/cn/jespinosa/phecomp/data/CRG/20120502_FDF_CRG/20120502_FDF_CRG/20120502_FDF_CRG_c12.mtb	302	NA	WWSS	water	1	127866	1336085874	1	0.04	0.00266666666666667	8771	1
4	Food 1	Intake 3	446	128385	1336086393	/users/cn/jespinosa/phecomp/data/CRG/20120502_FDF_CRG/20120502_FDF_CRG/20120502_FDF_CRG_c12.mtb	359	59	WWSS	food_sc	3	127939	1336085947	1	0.04	8.96860986547085e-05	8772	1
4	Drink 1	Intake 1	38	128415	1336086423	/users/cn/jespinosa/phecomp/data/CRG/20120502_FDF_CRG/20120502_FDF_CRG/20120502_FDF_CRG_c12.mtb	304	NA	WWSS	water	1	128377	1336086385	1	0.12	0.00315789473684211	8773	1
4	Food 1	Intake 3	66	128510	1336086518	/users/cn/jespinosa/phecomp/data/CRG/20120502_FDF_CRG/20120502_FDF_CRG/20120502_FDF_CRG_c12.mtb	360	5	WWSS	food_sc	3	128444	1336086452	1	0.02	0.000303030303030303	8774	1
4	Food 1	Intake 3	198	128713	1336086721	/users/cn/jespinosa/phecomp/data/CRG/20120502_FDF_CRG/20120502_FDF_CRG/20120502_FDF_CRG_c12.mtb	361	1163	WWSS	food_sc	3	128515	1336086523	1	0.04	0.000202020202020202	8775	1
4	Drink 1	Intake 1	41	128751	1336086759	/users/cn/jespinosa/phecomp/data/CRG/20120502_FDF_CRG/20120502_FDF_CRG/20120502_FDF_CRG_c12.mtb	305	NA	WWSS	water	1	128710	1336086718	1	0.12	0.00292682926829268	8776	1
4	Food 2	Intake 4	22	129898	1336087906	/users/cn/jespinosa/phecomp/data/CRG/20120502_FDF_CRG/20120502_FDF_CRG/20120502_FDF_CRG_c12.mtb	526	162	WWSS	food_sc	4	129876	1336087884	1	0.02	0.000909090909090909	8777	1
4	Food 2	Intake 4	16	130076	1336088084	/users/cn/jespinosa/phecomp/data/CRG/20120502_FDF_CRG/20120502_FDF_CRG/20120502_FDF_CRG_c12.mtb	529	376	WWSS	food_sc	4	130060	1336088068	1	0.02	0.00125	8778	1
4	Food 1	Intake 3	669	131121	1336089129	/users/cn/jespinosa/phecomp/data/CRG/20120502_FDF_CRG/20120502_FDF_CRG/20120502_FDF_CRG_c12.mtb	368	441	WWSS	food_sc	3	130452	1336088460	1	0.18	0.000269058295964126	8779	1
4	Drink 2	Intake 2	27	131144	1336089152	/users/cn/jespinosa/phecomp/data/CRG/20120502_FDF_CRG/20120502_FDF_CRG/20120502_FDF_CRG_c12.mtb	380	NA	WWSS	water	2	131117	1336089125	1	0.12	0.00444444444444444	8780	1
4	Drink 2	Intake 2	23	131179	1336089187	/users/cn/jespinosa/phecomp/data/CRG/20120502_FDF_CRG/20120502_FDF_CRG/20120502_FDF_CRG_c12.mtb	381	NA	WWSS	water	2	131156	1336089164	1	0.04	0.00173913043478261	8781	1
4	Food 1	Intake 3	71	131633	1336089641	/users/cn/jespinosa/phecomp/data/CRG/20120502_FDF_CRG/20120502_FDF_CRG/20120502_FDF_CRG_c12.mtb	370	19	WWSS	food_sc	3	131562	1336089570	1	0.02	0.00028169014084507	8782	1
4	Drink 2	Intake 2	17	131657	1336089665	/users/cn/jespinosa/phecomp/data/CRG/20120502_FDF_CRG/20120502_FDF_CRG/20120502_FDF_CRG_c12.mtb	382	NA	WWSS	water	2	131640	1336089648	1	0.0600000000000001	0.00352941176470589	8783	1
4	Food 1	Intake 3	86	131738	1336089746	/users/cn/jespinosa/phecomp/data/CRG/20120502_FDF_CRG/20120502_FDF_CRG/20120502_FDF_CRG_c12.mtb	371	1312	WWSS	food_sc	3	131652	1336089660	1	0.02	0.000232558139534884	8784	1
4	Drink 2	Intake 2	17	132810	1336090818	/users/cn/jespinosa/phecomp/data/CRG/20120502_FDF_CRG/20120502_FDF_CRG/20120502_FDF_CRG_c12.mtb	383	NA	WWSS	water	2	132793	1336090801	1	0.04	0.00235294117647059	8785	1
4	Food 1	Intake 3	44	133094	1336091102	/users/cn/jespinosa/phecomp/data/CRG/20120502_FDF_CRG/20120502_FDF_CRG/20120502_FDF_CRG_c12.mtb	374	5532	WWSS	food_sc	3	133050	1336091058	1	0.02	0.000454545454545455	8786	1
4	Food 1	Intake 3	177	138803	1336096811	/users/cn/jespinosa/phecomp/data/CRG/20120502_FDF_CRG/20120502_FDF_CRG/20120502_FDF_CRG_c12.mtb	376	5	WWSS	food_sc	3	138626	1336096634	1	0.02	0.000112994350282486	8787	1
4	Food 1	Intake 3	377	139185	1336097193	/users/cn/jespinosa/phecomp/data/CRG/20120502_FDF_CRG/20120502_FDF_CRG/20120502_FDF_CRG_c12.mtb	377	314	WWSS	food_sc	3	138808	1336096816	1	0.12	0.000318302387267905	8788	1
4	Drink 1	Intake 1	23	139490	1336097498	/users/cn/jespinosa/phecomp/data/CRG/20120502_FDF_CRG/20120502_FDF_CRG/20120502_FDF_CRG_c12.mtb	309	NA	WWSS	water	1	139467	1336097475	1	0.1	0.00434782608695652	8789	1
4	Food 2	Intake 4	851	140350	1336098358	/users/cn/jespinosa/phecomp/data/CRG/20120502_FDF_CRG/20120502_FDF_CRG/20120502_FDF_CRG_c12.mtb	536	2327	WWSS	food_sc	4	139499	1336097507	1	0.36	0.000423031727379553	8790	1
4	Drink 1	Intake 1	57	140445	1336098453	/users/cn/jespinosa/phecomp/data/CRG/20120502_FDF_CRG/20120502_FDF_CRG/20120502_FDF_CRG_c12.mtb	310	NA	WWSS	water	1	140388	1336098396	1	0.32	0.0056140350877193	8791	1
4	Drink 1	Intake 1	27	140798	1336098806	/users/cn/jespinosa/phecomp/data/CRG/20120502_FDF_CRG/20120502_FDF_CRG/20120502_FDF_CRG_c12.mtb	313	NA	WWSS	water	1	140771	1336098779	1	0.0600000000000001	0.00222222222222223	8792	1
4	Drink 1	Intake 1	21	141108	1336099116	/users/cn/jespinosa/phecomp/data/CRG/20120502_FDF_CRG/20120502_FDF_CRG/20120502_FDF_CRG_c12.mtb	314	NA	WWSS	water	1	141087	1336099095	1	0.1	0.00476190476190476	8793	1
4	Food 2	Intake 4	732	143409	1336101417	/users/cn/jespinosa/phecomp/data/CRG/20120502_FDF_CRG/20120502_FDF_CRG/20120502_FDF_CRG_c12.mtb	540	5422	WWSS	food_sc	4	142677	1336100685	1	0.36	0.000491803278688525	8794	1
4	Drink 2	Intake 2	49	143473	1336101481	/users/cn/jespinosa/phecomp/data/CRG/20120502_FDF_CRG/20120502_FDF_CRG/20120502_FDF_CRG_c12.mtb	394	NA	WWSS	water	2	143424	1336101432	1	0.16	0.00326530612244898	8795	1
4	Food 2	Intake 4	17	148848	1336106856	/users/cn/jespinosa/phecomp/data/CRG/20120502_FDF_CRG/20120502_FDF_CRG/20120502_FDF_CRG_c12.mtb	542	87	WWSS	food_sc	4	148831	1336106839	1	0.02	0.00117647058823529	8796	1
4	Food 2	Intake 4	279	149214	1336107222	/users/cn/jespinosa/phecomp/data/CRG/20120502_FDF_CRG/20120502_FDF_CRG/20120502_FDF_CRG_c12.mtb	543	7	WWSS	food_sc	4	148935	1336106943	1	0.04	0.00014336917562724	8797	1
4	Food 2	Intake 4	229	149450	1336107458	/users/cn/jespinosa/phecomp/data/CRG/20120502_FDF_CRG/20120502_FDF_CRG/20120502_FDF_CRG_c12.mtb	544	9989	WWSS	food_sc	4	149221	1336107229	1	0.34	0.00148471615720524	8798	1
4	Drink 1	Intake 1	35	149814	1336107822	/users/cn/jespinosa/phecomp/data/CRG/20120502_FDF_CRG/20120502_FDF_CRG/20120502_FDF_CRG_c12.mtb	315	NA	WWSS	water	1	149779	1336107787	1	0.18	0.00514285714285714	8799	1
4	Drink 1	Intake 1	21	150054	1336108062	/users/cn/jespinosa/phecomp/data/CRG/20120502_FDF_CRG/20120502_FDF_CRG/20120502_FDF_CRG_c12.mtb	317	NA	WWSS	water	1	150033	1336108041	1	0.0800000000000001	0.00380952380952381	8800	1
4	Drink 1	Intake 1	17	151283	1336109291	/users/cn/jespinosa/phecomp/data/CRG/20120502_FDF_CRG/20120502_FDF_CRG/20120502_FDF_CRG_c12.mtb	319	NA	WWSS	water	1	151266	1336109274	1	0.02	0.00117647058823529	8801	1
4	Drink 1	Intake 1	28	151317	1336109325	/users/cn/jespinosa/phecomp/data/CRG/20120502_FDF_CRG/20120502_FDF_CRG/20120502_FDF_CRG_c12.mtb	320	NA	WWSS	water	1	151289	1336109297	1	0.0800000000000001	0.00285714285714286	8802	1
4	Food 2	Intake 4	58	159497	1336117505	/users/cn/jespinosa/phecomp/data/CRG/20120502_FDF_CRG/20120502_FDF_CRG/20120502_FDF_CRG_c12.mtb	558	65	WWSS	food_sc	4	159439	1336117447	1	0.02	0.000344827586206897	8803	1
4	Food 1	Intake 3	59	159621	1336117629	/users/cn/jespinosa/phecomp/data/CRG/20120502_FDF_CRG/20120502_FDF_CRG/20120502_FDF_CRG_c12.mtb	397	31804	WWSS	food_sc	3	159562	1336117570	1	0.02	0.000338983050847458	8804	1
4	Food 1	Intake 3	658	27905	1336150091	/users/cn/jespinosa/phecomp/data/CRG/20120502_FDF_CRG/20120502_FDF_CRG/20120504_FDF_CRG_c12.mtb	530	7	WWSS	food_sc	3	27247	1336149433	1	0.12	0.000182370820668693	8805	1
4	Food 1	Intake 3	191	28103	1336150289	/users/cn/jespinosa/phecomp/data/CRG/20120502_FDF_CRG/20120502_FDF_CRG/20120504_FDF_CRG_c12.mtb	531	4473	WWSS	food_sc	3	27912	1336150098	1	0.04	0.000209424083769634	8806	1
4	Drink 2	Intake 2	23	28123	1336150309	/users/cn/jespinosa/phecomp/data/CRG/20120502_FDF_CRG/20120502_FDF_CRG/20120504_FDF_CRG_c12.mtb	539	NA	WWSS	water	2	28100	1336150286	1	0.06	0.00260869565217391	8807	1
4	Drink 1	Intake 1	17	28271	1336150457	/users/cn/jespinosa/phecomp/data/CRG/20120502_FDF_CRG/20120502_FDF_CRG/20120504_FDF_CRG_c12.mtb	545	NA	WWSS	water	1	28254	1336150440	1	0.02	0.00117647058823529	8808	1
4	Drink 1	Intake 1	19	28686	1336150872	/users/cn/jespinosa/phecomp/data/CRG/20120502_FDF_CRG/20120502_FDF_CRG/20120504_FDF_CRG_c12.mtb	546	NA	WWSS	water	1	28667	1336150853	1	0.04	0.00210526315789474	8809	1
4	Food 2	Intake 4	316	32892	1336155078	/users/cn/jespinosa/phecomp/data/CRG/20120502_FDF_CRG/20120502_FDF_CRG/20120504_FDF_CRG_c12.mtb	835	293	WWSS	food_sc	4	32576	1336154762	1	0.04	0.000126582278481013	8810	1
4	Food 1	Intake 3	18	33203	1336155389	/users/cn/jespinosa/phecomp/data/CRG/20120502_FDF_CRG/20120502_FDF_CRG/20120504_FDF_CRG_c12.mtb	534	241	WWSS	food_sc	3	33185	1336155371	1	0.02	0.00111111111111111	8811	1
4	Food 1	Intake 3	858	34302	1336156488	/users/cn/jespinosa/phecomp/data/CRG/20120502_FDF_CRG/20120502_FDF_CRG/20120504_FDF_CRG_c12.mtb	538	1434	WWSS	food_sc	3	33444	1336155630	1	0.22	0.000256410256410256	8812	1
4	Drink 1	Intake 1	28	34327	1336156513	/users/cn/jespinosa/phecomp/data/CRG/20120502_FDF_CRG/20120502_FDF_CRG/20120504_FDF_CRG_c12.mtb	548	NA	WWSS	water	1	34299	1336156485	1	0.12	0.00428571428571429	8813	1
4	Drink 1	Intake 1	15	35456	1336157642	/users/cn/jespinosa/phecomp/data/CRG/20120502_FDF_CRG/20120502_FDF_CRG/20120504_FDF_CRG_c12.mtb	549	NA	WWSS	water	1	35441	1336157627	1	0.1	0.00666666666666667	8814	1
4	Food 1	Intake 3	797	36533	1336158719	/users/cn/jespinosa/phecomp/data/CRG/20120502_FDF_CRG/20120502_FDF_CRG/20120504_FDF_CRG_c12.mtb	539	867	WWSS	food_sc	3	35736	1336157922	1	0.22	0.00027603513174404	8815	1
4	Drink 1	Intake 1	22	36551	1336158737	/users/cn/jespinosa/phecomp/data/CRG/20120502_FDF_CRG/20120502_FDF_CRG/20120504_FDF_CRG_c12.mtb	550	NA	WWSS	water	1	36529	1336158715	1	0.1	0.00454545454545455	8816	1
4	Food 2	Intake 4	227	37627	1336159813	/users/cn/jespinosa/phecomp/data/CRG/20120502_FDF_CRG/20120502_FDF_CRG/20120504_FDF_CRG_c12.mtb	845	14	WWSS	food_sc	4	37400	1336159586	1	0.08	0.000352422907488987	8817	1
4	Food 2	Intake 4	87	37728	1336159914	/users/cn/jespinosa/phecomp/data/CRG/20120502_FDF_CRG/20120502_FDF_CRG/20120504_FDF_CRG_c12.mtb	846	5	WWSS	food_sc	4	37641	1336159827	1	0.06	0.000689655172413793	8818	1
4	Food 2	Intake 4	224	37957	1336160143	/users/cn/jespinosa/phecomp/data/CRG/20120502_FDF_CRG/20120502_FDF_CRG/20120504_FDF_CRG_c12.mtb	847	2214	WWSS	food_sc	4	37733	1336159919	1	0.06	0.000267857142857143	8819	1
4	Drink 1	Intake 1	37	37996	1336160182	/users/cn/jespinosa/phecomp/data/CRG/20120502_FDF_CRG/20120502_FDF_CRG/20120504_FDF_CRG_c12.mtb	554	NA	WWSS	water	1	37959	1336160145	1	0.14	0.00378378378378378	8820	1
4	Drink 1	Intake 1	17	38757	1336160943	/users/cn/jespinosa/phecomp/data/CRG/20120502_FDF_CRG/20120502_FDF_CRG/20120504_FDF_CRG_c12.mtb	557	NA	WWSS	water	1	38740	1336160926	1	0.02	0.00117647058823529	8821	1
4	Drink 1	Intake 1	20	39358	1336161544	/users/cn/jespinosa/phecomp/data/CRG/20120502_FDF_CRG/20120502_FDF_CRG/20120504_FDF_CRG_c12.mtb	558	NA	WWSS	water	1	39338	1336161524	1	0.08	0.004	8822	1
4	Food 1	Intake 3	341	40512	1336162698	/users/cn/jespinosa/phecomp/data/CRG/20120502_FDF_CRG/20120502_FDF_CRG/20120504_FDF_CRG_c12.mtb	549	10	WWSS	food_sc	3	40171	1336162357	1	0.1	0.000293255131964809	8823	1
4	Food 2	Intake 4	108	40630	1336162816	/users/cn/jespinosa/phecomp/data/CRG/20120502_FDF_CRG/20120502_FDF_CRG/20120504_FDF_CRG_c12.mtb	856	82	WWSS	food_sc	4	40522	1336162708	1	0.02	0.000185185185185185	8824	1
4	Food 2	Intake 4	139	40851	1336163037	/users/cn/jespinosa/phecomp/data/CRG/20120502_FDF_CRG/20120502_FDF_CRG/20120504_FDF_CRG_c12.mtb	858	75	WWSS	food_sc	4	40712	1336162898	1	0.02	0.000143884892086331	8825	1
4	Food 2	Intake 4	32	40958	1336163144	/users/cn/jespinosa/phecomp/data/CRG/20120502_FDF_CRG/20120502_FDF_CRG/20120504_FDF_CRG_c12.mtb	859	6	WWSS	food_sc	4	40926	1336163112	1	0.02	0.000625	8826	1
4	Food 1	Intake 3	78	41042	1336163228	/users/cn/jespinosa/phecomp/data/CRG/20120502_FDF_CRG/20120502_FDF_CRG/20120504_FDF_CRG_c12.mtb	551	203	WWSS	food_sc	3	40964	1336163150	1	0.02	0.000256410256410256	8827	1
4	Drink 1	Intake 1	17	41051	1336163237	/users/cn/jespinosa/phecomp/data/CRG/20120502_FDF_CRG/20120502_FDF_CRG/20120504_FDF_CRG_c12.mtb	562	NA	WWSS	water	1	41034	1336163220	1	0.0600000000000001	0.00352941176470589	8828	1
4	Food 1	Intake 3	192	41437	1336163623	/users/cn/jespinosa/phecomp/data/CRG/20120502_FDF_CRG/20120502_FDF_CRG/20120504_FDF_CRG_c12.mtb	553	169	WWSS	food_sc	3	41245	1336163431	1	0.02	0.000104166666666667	8829	1
4	Food 1	Intake 3	193	41799	1336163985	/users/cn/jespinosa/phecomp/data/CRG/20120502_FDF_CRG/20120502_FDF_CRG/20120504_FDF_CRG_c12.mtb	557	1560	WWSS	food_sc	3	41606	1336163792	1	0.04	0.000207253886010363	8830	1
4	Drink 1	Intake 1	17	41814	1336164000	/users/cn/jespinosa/phecomp/data/CRG/20120502_FDF_CRG/20120502_FDF_CRG/20120504_FDF_CRG_c12.mtb	564	NA	WWSS	water	1	41797	1336163983	1	0.04	0.00235294117647059	8831	1
4	Drink 2	Intake 2	64	41911	1336164097	/users/cn/jespinosa/phecomp/data/CRG/20120502_FDF_CRG/20120502_FDF_CRG/20120504_FDF_CRG_c12.mtb	552	NA	WWSS	water	2	41847	1336164033	1	0.02	0.0003125	8832	1
4	Drink 2	Intake 2	18	42275	1336164461	/users/cn/jespinosa/phecomp/data/CRG/20120502_FDF_CRG/20120502_FDF_CRG/20120504_FDF_CRG_c12.mtb	555	NA	WWSS	water	2	42257	1336164443	1	0.02	0.00111111111111111	8833	1
4	Drink 2	Intake 2	17	42357	1336164543	/users/cn/jespinosa/phecomp/data/CRG/20120502_FDF_CRG/20120502_FDF_CRG/20120504_FDF_CRG_c12.mtb	556	NA	WWSS	water	2	42340	1336164526	1	0.02	0.00117647058823529	8834	1
4	Food 2	Intake 4	654	44013	1336166199	/users/cn/jespinosa/phecomp/data/CRG/20120502_FDF_CRG/20120502_FDF_CRG/20120504_FDF_CRG_c12.mtb	877	451	WWSS	food_sc	4	43359	1336165545	1	0.16	0.000244648318042813	8835	1
4	Drink 2	Intake 2	36	44049	1336166235	/users/cn/jespinosa/phecomp/data/CRG/20120502_FDF_CRG/20120502_FDF_CRG/20120504_FDF_CRG_c12.mtb	560	NA	WWSS	water	2	44013	1336166199	1	0.12	0.00333333333333333	8836	1
4	Drink 2	Intake 2	36	44255	1336166441	/users/cn/jespinosa/phecomp/data/CRG/20120502_FDF_CRG/20120502_FDF_CRG/20120504_FDF_CRG_c12.mtb	562	NA	WWSS	water	2	44219	1336166405	1	0.02	0.000555555555555556	8837	1
4	Food 1	Intake 3	693	45157	1336167343	/users/cn/jespinosa/phecomp/data/CRG/20120502_FDF_CRG/20120502_FDF_CRG/20120504_FDF_CRG_c12.mtb	571	569	WWSS	food_sc	3	44464	1336166650	1	0.26	0.000375180375180375	8838	1
4	Drink 1	Intake 1	36	45189	1336167375	/users/cn/jespinosa/phecomp/data/CRG/20120502_FDF_CRG/20120502_FDF_CRG/20120504_FDF_CRG_c12.mtb	573	NA	WWSS	water	1	45153	1336167339	1	0.18	0.005	8839	1
4	Drink 2	Intake 2	23	45664	1336167850	/users/cn/jespinosa/phecomp/data/CRG/20120502_FDF_CRG/20120502_FDF_CRG/20120504_FDF_CRG_c12.mtb	564	NA	WWSS	water	2	45641	1336167827	1	0.02	0.000869565217391304	8840	1
4	Food 1	Intake 3	566	46292	1336168478	/users/cn/jespinosa/phecomp/data/CRG/20120502_FDF_CRG/20120502_FDF_CRG/20120504_FDF_CRG_c12.mtb	574	487	WWSS	food_sc	3	45726	1336167912	1	0.22	0.0003886925795053	8841	1
4	Drink 1	Intake 1	45	46334	1336168520	/users/cn/jespinosa/phecomp/data/CRG/20120502_FDF_CRG/20120502_FDF_CRG/20120504_FDF_CRG_c12.mtb	575	NA	WWSS	water	1	46289	1336168475	1	0.2	0.00444444444444444	8842	1
4	Food 2	Intake 4	158	46937	1336169123	/users/cn/jespinosa/phecomp/data/CRG/20120502_FDF_CRG/20120502_FDF_CRG/20120504_FDF_CRG_c12.mtb	889	224	WWSS	food_sc	4	46779	1336168965	1	0.02	0.000126582278481013	8843	1
4	Drink 1	Intake 1	28	47160	1336169346	/users/cn/jespinosa/phecomp/data/CRG/20120502_FDF_CRG/20120502_FDF_CRG/20120504_FDF_CRG_c12.mtb	579	NA	WWSS	water	1	47132	1336169318	1	0.0599999999999998	0.00214285714285714	8844	1
4	Food 1	Intake 3	85	47246	1336169432	/users/cn/jespinosa/phecomp/data/CRG/20120502_FDF_CRG/20120502_FDF_CRG/20120504_FDF_CRG_c12.mtb	576	15	WWSS	food_sc	3	47161	1336169347	1	0.02	0.000235294117647059	8845	1
4	Food 1	Intake 3	374	47635	1336169821	/users/cn/jespinosa/phecomp/data/CRG/20120502_FDF_CRG/20120502_FDF_CRG/20120504_FDF_CRG_c12.mtb	577	2872	WWSS	food_sc	3	47261	1336169447	1	0.2	0.00053475935828877	8846	1
4	Drink 2	Intake 2	31	47705	1336169891	/users/cn/jespinosa/phecomp/data/CRG/20120502_FDF_CRG/20120502_FDF_CRG/20120504_FDF_CRG_c12.mtb	565	NA	WWSS	water	2	47674	1336169860	1	0.18	0.00580645161290323	8847	1
4	Food 1	Intake 3	639	51146	1336173332	/users/cn/jespinosa/phecomp/data/CRG/20120502_FDF_CRG/20120502_FDF_CRG/20120504_FDF_CRG_c12.mtb	580	669	WWSS	food_sc	3	50507	1336172693	1	0.26	0.000406885758998435	8848	1
4	Drink 2	Intake 2	33	51172	1336173358	/users/cn/jespinosa/phecomp/data/CRG/20120502_FDF_CRG/20120502_FDF_CRG/20120504_FDF_CRG_c12.mtb	568	NA	WWSS	water	2	51139	1336173325	1	0.16	0.00484848484848485	8849	1
4	Drink 1	Intake 1	17	51542	1336173728	/users/cn/jespinosa/phecomp/data/CRG/20120502_FDF_CRG/20120502_FDF_CRG/20120504_FDF_CRG_c12.mtb	583	NA	WWSS	water	1	51525	1336173711	1	0.02	0.00117647058823529	8850	1
4	Drink 1	Intake 1	16	51583	1336173769	/users/cn/jespinosa/phecomp/data/CRG/20120502_FDF_CRG/20120502_FDF_CRG/20120504_FDF_CRG_c12.mtb	584	NA	WWSS	water	1	51567	1336173753	1	0.04	0.0025	8851	1
4	Food 1	Intake 3	75	51890	1336174076	/users/cn/jespinosa/phecomp/data/CRG/20120502_FDF_CRG/20120502_FDF_CRG/20120504_FDF_CRG_c12.mtb	584	329	WWSS	food_sc	3	51815	1336174001	1	0.02	0.000266666666666667	8852	1
4	Drink 2	Intake 2	40	51923	1336174109	/users/cn/jespinosa/phecomp/data/CRG/20120502_FDF_CRG/20120502_FDF_CRG/20120504_FDF_CRG_c12.mtb	572	NA	WWSS	water	2	51883	1336174069	1	0.0600000000000001	0.0015	8853	1
4	Food 1	Intake 3	152	52371	1336174557	/users/cn/jespinosa/phecomp/data/CRG/20120502_FDF_CRG/20120502_FDF_CRG/20120504_FDF_CRG_c12.mtb	588	5881	WWSS	food_sc	3	52219	1336174405	1	0.28	0.00184210526315789	8854	1
4	Drink 1	Intake 1	24	52777	1336174963	/users/cn/jespinosa/phecomp/data/CRG/20120502_FDF_CRG/20120502_FDF_CRG/20120504_FDF_CRG_c12.mtb	586	NA	WWSS	water	1	52753	1336174939	1	0.0600000000000001	0.0025	8855	1
4	Drink 1	Intake 1	23	52804	1336174990	/users/cn/jespinosa/phecomp/data/CRG/20120502_FDF_CRG/20120502_FDF_CRG/20120504_FDF_CRG_c12.mtb	587	NA	WWSS	water	1	52781	1336174967	1	0.0599999999999998	0.0026086956521739	8856	1
4	Drink 2	Intake 2	13	52892	1336175078	/users/cn/jespinosa/phecomp/data/CRG/20120502_FDF_CRG/20120502_FDF_CRG/20120504_FDF_CRG_c12.mtb	574	NA	WWSS	water	2	52879	1336175065	1	0.0599999999999999	0.00461538461538461	8857	1
4	Drink 1	Intake 1	17	53536	1336175722	/users/cn/jespinosa/phecomp/data/CRG/20120502_FDF_CRG/20120502_FDF_CRG/20120504_FDF_CRG_c12.mtb	588	NA	WWSS	water	1	53519	1336175705	1	0.02	0.00117647058823529	8858	1
4	Drink 1	Intake 1	20	53570	1336175756	/users/cn/jespinosa/phecomp/data/CRG/20120502_FDF_CRG/20120502_FDF_CRG/20120504_FDF_CRG_c12.mtb	589	NA	WWSS	water	1	53550	1336175736	1	0.04	0.002	8859	1
4	Drink 1	Intake 1	20	53705	1336175891	/users/cn/jespinosa/phecomp/data/CRG/20120502_FDF_CRG/20120502_FDF_CRG/20120504_FDF_CRG_c12.mtb	590	NA	WWSS	water	1	53685	1336175871	1	0.02	0.001	8860	1
4	Drink 1	Intake 1	19	55244	1336177430	/users/cn/jespinosa/phecomp/data/CRG/20120502_FDF_CRG/20120502_FDF_CRG/20120504_FDF_CRG_c12.mtb	592	NA	WWSS	water	1	55225	1336177411	1	0.02	0.00105263157894737	8861	1
4	Food 1	Intake 3	62	58314	1336180500	/users/cn/jespinosa/phecomp/data/CRG/20120502_FDF_CRG/20120502_FDF_CRG/20120504_FDF_CRG_c12.mtb	592	222	WWSS	food_sc	3	58252	1336180438	1	0.02	0.00032258064516129	8862	1
4	Food 2	Intake 4	78	58614	1336180800	/users/cn/jespinosa/phecomp/data/CRG/20120502_FDF_CRG/20120502_FDF_CRG/20120504_FDF_CRG_c12.mtb	906	COLL	WWSS	food_sc	4	58536	1336180722	1	0.02	0.000256410256410256	8863	1
4	Food 1	Intake 3	96	58702	1336180888	/users/cn/jespinosa/phecomp/data/CRG/20120502_FDF_CRG/20120502_FDF_CRG/20120504_FDF_CRG_c12.mtb	595	403	WWSS	food_sc	3	58606	1336180792	1	0.02	0.000208333333333333	8864	1
4	Drink 2	Intake 2	13	58775	1336180961	/users/cn/jespinosa/phecomp/data/CRG/20120502_FDF_CRG/20120502_FDF_CRG/20120504_FDF_CRG_c12.mtb	579	NA	WWSS	water	2	58762	1336180948	1	0.0600000000000001	0.00461538461538462	8865	1
4	Food 2	Intake 4	285	59390	1336181576	/users/cn/jespinosa/phecomp/data/CRG/20120502_FDF_CRG/20120502_FDF_CRG/20120504_FDF_CRG_c12.mtb	910	11596	WWSS	food_sc	4	59105	1336181291	1	0.04	0.000140350877192982	8866	1
4	Drink 1	Intake 1	15	59407	1336181593	/users/cn/jespinosa/phecomp/data/CRG/20120502_FDF_CRG/20120502_FDF_CRG/20120504_FDF_CRG_c12.mtb	595	NA	WWSS	water	1	59392	1336181578	1	0.04	0.00266666666666667	8867	1
4	Drink 1	Intake 1	18	59447	1336181633	/users/cn/jespinosa/phecomp/data/CRG/20120502_FDF_CRG/20120502_FDF_CRG/20120504_FDF_CRG_c12.mtb	596	NA	WWSS	water	1	59429	1336181615	1	0.04	0.00222222222222222	8868	1
4	Drink 2	Intake 2	54	70625	1336192811	/users/cn/jespinosa/phecomp/data/CRG/20120502_FDF_CRG/20120502_FDF_CRG/20120504_FDF_CRG_c12.mtb	583	NA	WWSS	water	2	70571	1336192757	1	0.02	0.00037037037037037	8869	1
4	Drink 2	Intake 2	20	70863	1336193049	/users/cn/jespinosa/phecomp/data/CRG/20120502_FDF_CRG/20120502_FDF_CRG/20120504_FDF_CRG_c12.mtb	584	NA	WWSS	water	2	70843	1336193029	1	0.02	0.001	8870	1
4	Food 1	Intake 3	381	71367	1336193553	/users/cn/jespinosa/phecomp/data/CRG/20120502_FDF_CRG/20120502_FDF_CRG/20120504_FDF_CRG_c12.mtb	606	60	WWSS	food_sc	3	70986	1336193172	1	0.04	0.00010498687664042	8871	1
4	Food 1	Intake 3	278	71705	1336193891	/users/cn/jespinosa/phecomp/data/CRG/20120502_FDF_CRG/20120502_FDF_CRG/20120504_FDF_CRG_c12.mtb	607	1431	WWSS	food_sc	3	71427	1336193613	1	0.0600000000000001	0.000215827338129497	8872	1
4	Drink 1	Intake 1	8	71829	1336194015	/users/cn/jespinosa/phecomp/data/CRG/20120502_FDF_CRG/20120502_FDF_CRG/20120504_FDF_CRG_c12.mtb	601	NA	WWSS	water	1	71821	1336194007	1	0.02	0.0025	8873	1
4	Drink 1	Intake 1	20	72528	1336194714	/users/cn/jespinosa/phecomp/data/CRG/20120502_FDF_CRG/20120502_FDF_CRG/20120504_FDF_CRG_c12.mtb	603	NA	WWSS	water	1	72508	1336194694	1	0.0600000000000001	0.00300000000000001	8874	1
4	Drink 1	Intake 1	22	72600	1336194786	/users/cn/jespinosa/phecomp/data/CRG/20120502_FDF_CRG/20120502_FDF_CRG/20120504_FDF_CRG_c12.mtb	604	NA	WWSS	water	1	72578	1336194764	1	0.04	0.00181818181818182	8875	1
4	Food 1	Intake 3	491	73627	1336195813	/users/cn/jespinosa/phecomp/data/CRG/20120502_FDF_CRG/20120502_FDF_CRG/20120504_FDF_CRG_c12.mtb	618	109	WWSS	food_sc	3	73136	1336195322	1	0.14	0.000285132382892057	8876	1
4	Drink 2	Intake 2	27	73722	1336195908	/users/cn/jespinosa/phecomp/data/CRG/20120502_FDF_CRG/20120502_FDF_CRG/20120504_FDF_CRG_c12.mtb	595	NA	WWSS	water	2	73695	1336195881	1	0.02	0.000740740740740741	8877	1
4	Food 1	Intake 3	556	74292	1336196478	/users/cn/jespinosa/phecomp/data/CRG/20120502_FDF_CRG/20120502_FDF_CRG/20120504_FDF_CRG_c12.mtb	620	47	WWSS	food_sc	3	73736	1336195922	1	0.24	0.000431654676258993	8878	1
4	Food 1	Intake 3	38	74377	1336196563	/users/cn/jespinosa/phecomp/data/CRG/20120502_FDF_CRG/20120502_FDF_CRG/20120504_FDF_CRG_c12.mtb	621	9	WWSS	food_sc	3	74339	1336196525	1	0.02	0.000526315789473684	8879	1
4	Food 1	Intake 3	49	74435	1336196621	/users/cn/jespinosa/phecomp/data/CRG/20120502_FDF_CRG/20120502_FDF_CRG/20120504_FDF_CRG_c12.mtb	622	677	WWSS	food_sc	3	74386	1336196572	1	0.02	0.000408163265306122	8880	1
4	Drink 2	Intake 2	44	74475	1336196661	/users/cn/jespinosa/phecomp/data/CRG/20120502_FDF_CRG/20120502_FDF_CRG/20120504_FDF_CRG_c12.mtb	596	NA	WWSS	water	2	74431	1336196617	1	0.14	0.00318181818181818	8881	1
4	Drink 2	Intake 2	23	74542	1336196728	/users/cn/jespinosa/phecomp/data/CRG/20120502_FDF_CRG/20120502_FDF_CRG/20120504_FDF_CRG_c12.mtb	597	NA	WWSS	water	2	74519	1336196705	1	0.02	0.000869565217391304	8882	1
4	Drink 2	Intake 2	18	74624	1336196810	/users/cn/jespinosa/phecomp/data/CRG/20120502_FDF_CRG/20120502_FDF_CRG/20120504_FDF_CRG_c12.mtb	598	NA	WWSS	water	2	74606	1336196792	1	0.04	0.00222222222222222	8883	1
4	Drink 2	Intake 2	23	74759	1336196945	/users/cn/jespinosa/phecomp/data/CRG/20120502_FDF_CRG/20120502_FDF_CRG/20120504_FDF_CRG_c12.mtb	599	NA	WWSS	water	2	74736	1336196922	1	0.0600000000000001	0.00260869565217392	8884	1
4	Food 1	Intake 3	612	75724	1336197910	/users/cn/jespinosa/phecomp/data/CRG/20120502_FDF_CRG/20120502_FDF_CRG/20120504_FDF_CRG_c12.mtb	624	COLL	WWSS	food_sc	3	75112	1336197298	1	0.22	0.000359477124183007	8885	1
4	Food 2	Intake 4	19	75743	1336197929	/users/cn/jespinosa/phecomp/data/CRG/20120502_FDF_CRG/20120502_FDF_CRG/20120504_FDF_CRG_c12.mtb	932	3847	WWSS	food_sc	4	75724	1336197910	1	0.02	0.00105263157894737	8886	1
4	Drink 1	Intake 1	28	75769	1336197955	/users/cn/jespinosa/phecomp/data/CRG/20120502_FDF_CRG/20120502_FDF_CRG/20120504_FDF_CRG_c12.mtb	609	NA	WWSS	water	1	75741	1336197927	1	0.2	0.00714285714285714	8887	1
4	Drink 1	Intake 1	17	76022	1336198208	/users/cn/jespinosa/phecomp/data/CRG/20120502_FDF_CRG/20120502_FDF_CRG/20120504_FDF_CRG_c12.mtb	610	NA	WWSS	water	1	76005	1336198191	1	0.04	0.00235294117647059	8888	1
4	Food 1	Intake 3	382	79972	1336202158	/users/cn/jespinosa/phecomp/data/CRG/20120502_FDF_CRG/20120502_FDF_CRG/20120504_FDF_CRG_c12.mtb	627	4153	WWSS	food_sc	3	79590	1336201776	1	0.12	0.00031413612565445	8889	1
4	Drink 1	Intake 1	28	80013	1336202199	/users/cn/jespinosa/phecomp/data/CRG/20120502_FDF_CRG/20120502_FDF_CRG/20120504_FDF_CRG_c12.mtb	611	NA	WWSS	water	1	79985	1336202171	1	0.1	0.00357142857142857	8890	1
4	Food 1	Intake 3	76	84201	1336206387	/users/cn/jespinosa/phecomp/data/CRG/20120502_FDF_CRG/20120502_FDF_CRG/20120504_FDF_CRG_c12.mtb	629	952	WWSS	food_sc	3	84125	1336206311	1	0.02	0.000263157894736842	8891	1
4	Food 1	Intake 3	357	85510	1336207696	/users/cn/jespinosa/phecomp/data/CRG/20120502_FDF_CRG/20120502_FDF_CRG/20120504_FDF_CRG_c12.mtb	632	32879	WWSS	food_sc	3	85153	1336207339	1	0.38	0.00106442577030812	8892	1
4	Drink 1	Intake 1	33	85936	1336208122	/users/cn/jespinosa/phecomp/data/CRG/20120502_FDF_CRG/20120502_FDF_CRG/20120504_FDF_CRG_c12.mtb	613	NA	WWSS	water	1	85903	1336208089	1	0.2	0.00606060606060606	8893	1
4	Drink 1	Intake 1	15	86077	1336208263	/users/cn/jespinosa/phecomp/data/CRG/20120502_FDF_CRG/20120502_FDF_CRG/20120504_FDF_CRG_c12.mtb	614	NA	WWSS	water	1	86062	1336208248	1	0.04	0.00266666666666667	8894	1
4	Drink 2	Intake 2	44	92345	1336214531	/users/cn/jespinosa/phecomp/data/CRG/20120502_FDF_CRG/20120502_FDF_CRG/20120504_FDF_CRG_c12.mtb	611	NA	WWSS	water	2	92301	1336214487	1	0.02	0.000454545454545455	8895	1
4	Drink 2	Intake 2	76	93401	1336215587	/users/cn/jespinosa/phecomp/data/CRG/20120502_FDF_CRG/20120502_FDF_CRG/20120504_FDF_CRG_c12.mtb	618	NA	WWSS	water	2	93325	1336215511	1	0.02	0.000263157894736842	8896	1
4	Drink 2	Intake 2	65	93494	1336215680	/users/cn/jespinosa/phecomp/data/CRG/20120502_FDF_CRG/20120502_FDF_CRG/20120504_FDF_CRG_c12.mtb	620	NA	WWSS	water	2	93429	1336215615	1	0.02	0.000307692307692308	8897	1
4	Drink 2	Intake 2	28	93597	1336215783	/users/cn/jespinosa/phecomp/data/CRG/20120502_FDF_CRG/20120502_FDF_CRG/20120504_FDF_CRG_c12.mtb	621	NA	WWSS	water	2	93569	1336215755	1	0.02	0.000714285714285714	8898	1
4	Drink 2	Intake 2	78	95583	1336217769	/users/cn/jespinosa/phecomp/data/CRG/20120502_FDF_CRG/20120502_FDF_CRG/20120504_FDF_CRG_c12.mtb	630	NA	WWSS	water	2	95505	1336217691	1	0.02	0.000256410256410256	8899	1
4	Drink 2	Intake 2	332	95956	1336218142	/users/cn/jespinosa/phecomp/data/CRG/20120502_FDF_CRG/20120502_FDF_CRG/20120504_FDF_CRG_c12.mtb	631	NA	WWSS	water	2	95624	1336217810	1	0.04	0.000120481927710843	8900	1
4	Drink 2	Intake 2	26	96263	1336218449	/users/cn/jespinosa/phecomp/data/CRG/20120502_FDF_CRG/20120502_FDF_CRG/20120504_FDF_CRG_c12.mtb	633	NA	WWSS	water	2	96237	1336218423	1	0.02	0.000769230769230769	8901	1
4	Drink 2	Intake 2	290	96808	1336218994	/users/cn/jespinosa/phecomp/data/CRG/20120502_FDF_CRG/20120502_FDF_CRG/20120504_FDF_CRG_c12.mtb	635	NA	WWSS	water	2	96518	1336218704	1	0.04	0.000137931034482759	8902	1
4	Drink 2	Intake 2	14	97003	1336219189	/users/cn/jespinosa/phecomp/data/CRG/20120502_FDF_CRG/20120502_FDF_CRG/20120504_FDF_CRG_c12.mtb	636	NA	WWSS	water	2	96989	1336219175	1	0.02	0.00142857142857143	8903	1
4	Drink 2	Intake 2	288	98168	1336220354	/users/cn/jespinosa/phecomp/data/CRG/20120502_FDF_CRG/20120502_FDF_CRG/20120504_FDF_CRG_c12.mtb	639	NA	WWSS	water	2	97880	1336220066	1	0.04	0.000138888888888889	8904	1
4	Drink 2	Intake 2	56	98432	1336220618	/users/cn/jespinosa/phecomp/data/CRG/20120502_FDF_CRG/20120502_FDF_CRG/20120504_FDF_CRG_c12.mtb	641	NA	WWSS	water	2	98376	1336220562	1	0.02	0.000357142857142857	8905	1
4	Drink 2	Intake 2	23	98472	1336220658	/users/cn/jespinosa/phecomp/data/CRG/20120502_FDF_CRG/20120502_FDF_CRG/20120504_FDF_CRG_c12.mtb	642	NA	WWSS	water	2	98449	1336220635	1	0.02	0.000869565217391304	8906	1
4	Drink 2	Intake 2	12	99495	1336221681	/users/cn/jespinosa/phecomp/data/CRG/20120502_FDF_CRG/20120502_FDF_CRG/20120504_FDF_CRG_c12.mtb	646	NA	WWSS	water	2	99483	1336221669	1	0.02	0.00166666666666667	8907	1
4	Drink 2	Intake 2	17	100716	1336222902	/users/cn/jespinosa/phecomp/data/CRG/20120502_FDF_CRG/20120502_FDF_CRG/20120504_FDF_CRG_c12.mtb	648	NA	WWSS	water	2	100699	1336222885	1	0.02	0.00117647058823529	8908	1
4	Food 1	Intake 3	170	118559	1336240745	/users/cn/jespinosa/phecomp/data/CRG/20120502_FDF_CRG/20120502_FDF_CRG/20120504_FDF_CRG_c12.mtb	642	181	WWSS	food_sc	3	118389	1336240575	1	0.02	0.000117647058823529	8909	1
4	Food 1	Intake 3	588	119328	1336241514	/users/cn/jespinosa/phecomp/data/CRG/20120502_FDF_CRG/20120502_FDF_CRG/20120504_FDF_CRG_c12.mtb	644	1931	WWSS	food_sc	3	118740	1336240926	1	0.16	0.000272108843537415	8910	1
4	Drink 1	Intake 1	21	120762	1336242948	/users/cn/jespinosa/phecomp/data/CRG/20120502_FDF_CRG/20120502_FDF_CRG/20120504_FDF_CRG_c12.mtb	617	NA	WWSS	water	1	120741	1336242927	1	0.0999999999999996	0.00476190476190474	8911	1
4	Food 1	Intake 3	739	121998	1336244184	/users/cn/jespinosa/phecomp/data/CRG/20120502_FDF_CRG/20120502_FDF_CRG/20120504_FDF_CRG_c12.mtb	645	404	WWSS	food_sc	3	121259	1336243445	1	0.26	0.000351826792963464	8912	1
4	Drink 2	Intake 2	32	122033	1336244219	/users/cn/jespinosa/phecomp/data/CRG/20120502_FDF_CRG/20120502_FDF_CRG/20120504_FDF_CRG_c12.mtb	655	NA	WWSS	water	2	122001	1336244187	1	0.0800000000000001	0.0025	8913	1
4	Food 1	Intake 3	407	122809	1336244995	/users/cn/jespinosa/phecomp/data/CRG/20120502_FDF_CRG/20120502_FDF_CRG/20120504_FDF_CRG_c12.mtb	646	217	WWSS	food_sc	3	122402	1336244588	1	0.14	0.000343980343980344	8914	1
4	Drink 2	Intake 2	37	122839	1336245025	/users/cn/jespinosa/phecomp/data/CRG/20120502_FDF_CRG/20120502_FDF_CRG/20120504_FDF_CRG_c12.mtb	656	NA	WWSS	water	2	122802	1336244988	1	0.14	0.00378378378378378	8915	1
4	Food 1	Intake 3	277	123303	1336245489	/users/cn/jespinosa/phecomp/data/CRG/20120502_FDF_CRG/20120502_FDF_CRG/20120504_FDF_CRG_c12.mtb	648	1267	WWSS	food_sc	3	123026	1336245212	1	0.12	0.000433212996389892	8916	1
4	Drink 2	Intake 2	24	123328	1336245514	/users/cn/jespinosa/phecomp/data/CRG/20120502_FDF_CRG/20120502_FDF_CRG/20120504_FDF_CRG_c12.mtb	659	NA	WWSS	water	2	123304	1336245490	1	0.12	0.005	8917	1
4	Food 1	Intake 3	495	125065	1336247251	/users/cn/jespinosa/phecomp/data/CRG/20120502_FDF_CRG/20120502_FDF_CRG/20120504_FDF_CRG_c12.mtb	650	4502	WWSS	food_sc	3	124570	1336246756	1	0.460000000000001	0.000929292929292931	8918	1
4	Drink 2	Intake 2	40	125368	1336247554	/users/cn/jespinosa/phecomp/data/CRG/20120502_FDF_CRG/20120502_FDF_CRG/20120504_FDF_CRG_c12.mtb	661	NA	WWSS	water	2	125328	1336247514	1	0.18	0.0045	8919	1
4	Drink 2	Intake 2	31	126041	1336248227	/users/cn/jespinosa/phecomp/data/CRG/20120502_FDF_CRG/20120502_FDF_CRG/20120504_FDF_CRG_c12.mtb	666	NA	WWSS	water	2	126010	1336248196	1	0.02	0.000645161290322581	8920	1
4	Drink 1	Intake 1	41	126427	1336248613	/users/cn/jespinosa/phecomp/data/CRG/20120502_FDF_CRG/20120502_FDF_CRG/20120504_FDF_CRG_c12.mtb	620	NA	WWSS	water	1	126386	1336248572	1	0.2	0.0048780487804878	8921	1
4	Drink 1	Intake 1	19	127965	1336250151	/users/cn/jespinosa/phecomp/data/CRG/20120502_FDF_CRG/20120502_FDF_CRG/20120504_FDF_CRG_c12.mtb	623	NA	WWSS	water	1	127946	1336250132	1	0.0800000000000001	0.00421052631578948	8922	1
4	Drink 2	Intake 2	24	128482	1336250668	/users/cn/jespinosa/phecomp/data/CRG/20120502_FDF_CRG/20120502_FDF_CRG/20120504_FDF_CRG_c12.mtb	674	NA	WWSS	water	2	128458	1336250644	1	0.02	0.000833333333333333	8923	1
4	Food 1	Intake 3	172	129739	1336251925	/users/cn/jespinosa/phecomp/data/CRG/20120502_FDF_CRG/20120502_FDF_CRG/20120504_FDF_CRG_c12.mtb	672	6	WWSS	food_sc	3	129567	1336251753	1	0.0600000000000005	0.000348837209302328	8924	1
4	Food 1	Intake 3	190	129935	1336252121	/users/cn/jespinosa/phecomp/data/CRG/20120502_FDF_CRG/20120502_FDF_CRG/20120504_FDF_CRG_c12.mtb	673	54	WWSS	food_sc	3	129745	1336251931	1	0.0599999999999996	0.000315789473684208	8925	1
4	Drink 1	Intake 1	19	129948	1336252134	/users/cn/jespinosa/phecomp/data/CRG/20120502_FDF_CRG/20120502_FDF_CRG/20120504_FDF_CRG_c12.mtb	626	NA	WWSS	water	1	129929	1336252115	1	0.0800000000000001	0.00421052631578948	8926	1
4	Food 1	Intake 3	79	130068	1336252254	/users/cn/jespinosa/phecomp/data/CRG/20120502_FDF_CRG/20120502_FDF_CRG/20120504_FDF_CRG_c12.mtb	674	98	WWSS	food_sc	3	129989	1336252175	1	0.0200000000000005	0.000253164556962032	8927	1
4	Food 1	Intake 3	489	130655	1336252841	/users/cn/jespinosa/phecomp/data/CRG/20120502_FDF_CRG/20120502_FDF_CRG/20120504_FDF_CRG_c12.mtb	676	1599	WWSS	food_sc	3	130166	1336252352	1	0.18	0.000368098159509202	8928	1
4	Drink 1	Intake 1	25	130682	1336252868	/users/cn/jespinosa/phecomp/data/CRG/20120502_FDF_CRG/20120502_FDF_CRG/20120504_FDF_CRG_c12.mtb	627	NA	WWSS	water	1	130657	1336252843	1	0.14	0.0056	8929	1
4	Drink 2	Intake 2	37	131371	1336253557	/users/cn/jespinosa/phecomp/data/CRG/20120502_FDF_CRG/20120502_FDF_CRG/20120504_FDF_CRG_c12.mtb	684	NA	WWSS	water	2	131334	1336253520	1	0.02	0.000540540540540541	8930	1
4	Food 1	Intake 3	221	132475	1336254661	/users/cn/jespinosa/phecomp/data/CRG/20120502_FDF_CRG/20120502_FDF_CRG/20120504_FDF_CRG_c12.mtb	682	319	WWSS	food_sc	3	132254	1336254440	1	0.0800000000000001	0.000361990950226245	8931	1
4	Drink 2	Intake 2	41	132515	1336254701	/users/cn/jespinosa/phecomp/data/CRG/20120502_FDF_CRG/20120502_FDF_CRG/20120504_FDF_CRG_c12.mtb	685	NA	WWSS	water	2	132474	1336254660	1	0.04	0.000975609756097561	8932	1
4	Drink 2	Intake 2	15	132595	1336254781	/users/cn/jespinosa/phecomp/data/CRG/20120502_FDF_CRG/20120502_FDF_CRG/20120504_FDF_CRG_c12.mtb	686	NA	WWSS	water	2	132580	1336254766	1	0.02	0.00133333333333333	8933	1
4	Food 1	Intake 3	191	132985	1336255171	/users/cn/jespinosa/phecomp/data/CRG/20120502_FDF_CRG/20120502_FDF_CRG/20120504_FDF_CRG_c12.mtb	684	2957	WWSS	food_sc	3	132794	1336254980	1	0.0800000000000001	0.000418848167539268	8934	1
4	Drink 2	Intake 2	18	133013	1336255199	/users/cn/jespinosa/phecomp/data/CRG/20120502_FDF_CRG/20120502_FDF_CRG/20120504_FDF_CRG_c12.mtb	687	NA	WWSS	water	2	132995	1336255181	1	0.0800000000000001	0.00444444444444445	8935	1
4	Food 1	Intake 3	167	136109	1336258295	/users/cn/jespinosa/phecomp/data/CRG/20120502_FDF_CRG/20120502_FDF_CRG/20120504_FDF_CRG_c12.mtb	688	17	WWSS	food_sc	3	135942	1336258128	1	0.0599999999999996	0.000359281437125746	8936	1
4	Food 1	Intake 3	156	136282	1336258468	/users/cn/jespinosa/phecomp/data/CRG/20120502_FDF_CRG/20120502_FDF_CRG/20120504_FDF_CRG_c12.mtb	689	565	WWSS	food_sc	3	136126	1336258312	1	0.0600000000000005	0.000384615384615388	8937	1
4	Drink 1	Intake 1	20	136766	1336258952	/users/cn/jespinosa/phecomp/data/CRG/20120502_FDF_CRG/20120502_FDF_CRG/20120504_FDF_CRG_c12.mtb	631	NA	WWSS	water	1	136746	1336258932	1	0.02	0.001	8938	1
4	Food 1	Intake 3	396	137243	1336259429	/users/cn/jespinosa/phecomp/data/CRG/20120502_FDF_CRG/20120502_FDF_CRG/20120504_FDF_CRG_c12.mtb	691	971	WWSS	food_sc	3	136847	1336259033	1	0.2	0.000505050505050505	8939	1
4	Drink 2	Intake 2	33	137276	1336259462	/users/cn/jespinosa/phecomp/data/CRG/20120502_FDF_CRG/20120502_FDF_CRG/20120504_FDF_CRG_c12.mtb	692	NA	WWSS	water	2	137243	1336259429	1	0.16	0.00484848484848485	8940	1
4	Drink 2	Intake 2	75	137904	1336260090	/users/cn/jespinosa/phecomp/data/CRG/20120502_FDF_CRG/20120502_FDF_CRG/20120504_FDF_CRG_c12.mtb	695	NA	WWSS	water	2	137829	1336260015	1	0.02	0.000266666666666667	8941	1
4	Drink 1	Intake 1	25	138214	1336260400	/users/cn/jespinosa/phecomp/data/CRG/20120502_FDF_CRG/20120502_FDF_CRG/20120504_FDF_CRG_c12.mtb	634	NA	WWSS	water	1	138189	1336260375	1	0.02	0.0008	8942	1
4	Food 1	Intake 3	108	138322	1336260508	/users/cn/jespinosa/phecomp/data/CRG/20120502_FDF_CRG/20120502_FDF_CRG/20120504_FDF_CRG_c12.mtb	693	743	WWSS	food_sc	3	138214	1336260400	1	0.0600000000000005	0.00055555555555556	8943	1
4	Drink 1	Intake 1	12	138384	1336260570	/users/cn/jespinosa/phecomp/data/CRG/20120502_FDF_CRG/20120502_FDF_CRG/20120504_FDF_CRG_c12.mtb	635	NA	WWSS	water	1	138372	1336260558	1	0.0600000000000001	0.00500000000000001	8944	1
4	Food 1	Intake 3	398	139463	1336261649	/users/cn/jespinosa/phecomp/data/CRG/20120502_FDF_CRG/20120502_FDF_CRG/20120504_FDF_CRG_c12.mtb	694	3454	WWSS	food_sc	3	139065	1336261251	1	0.18	0.000452261306532663	8945	1
4	Drink 2	Intake 2	37	139515	1336261701	/users/cn/jespinosa/phecomp/data/CRG/20120502_FDF_CRG/20120502_FDF_CRG/20120504_FDF_CRG_c12.mtb	697	NA	WWSS	water	2	139478	1336261664	1	0.14	0.00378378378378378	8946	1
4	Food 1	Intake 3	34	142951	1336265137	/users/cn/jespinosa/phecomp/data/CRG/20120502_FDF_CRG/20120502_FDF_CRG/20120504_FDF_CRG_c12.mtb	697	500	WWSS	food_sc	3	142917	1336265103	1	0.279999999999999	0.00823529411764703	8947	1
4	Drink 1	Intake 1	20	143441	1336265627	/users/cn/jespinosa/phecomp/data/CRG/20120502_FDF_CRG/20120502_FDF_CRG/20120504_FDF_CRG_c12.mtb	636	NA	WWSS	water	1	143421	1336265607	1	0.02	0.001	8948	1
4	Food 1	Intake 3	18	143469	1336265655	/users/cn/jespinosa/phecomp/data/CRG/20120502_FDF_CRG/20120502_FDF_CRG/20120504_FDF_CRG_c12.mtb	698	6025	WWSS	food_sc	3	143451	1336265637	1	0.0200000000000005	0.00111111111111114	8949	1
4	Drink 2	Intake 2	17	144283	1336266469	/users/cn/jespinosa/phecomp/data/CRG/20120502_FDF_CRG/20120502_FDF_CRG/20120504_FDF_CRG_c12.mtb	704	NA	WWSS	water	2	144266	1336266452	1	0.02	0.00117647058823529	8950	1
4	Drink 1	Intake 1	21	144758	1336266944	/users/cn/jespinosa/phecomp/data/CRG/20120502_FDF_CRG/20120502_FDF_CRG/20120504_FDF_CRG_c12.mtb	640	NA	WWSS	water	1	144737	1336266923	1	0.1	0.00476190476190476	8951	1
4	Food 1	Intake 3	107	149601	1336271787	/users/cn/jespinosa/phecomp/data/CRG/20120502_FDF_CRG/20120502_FDF_CRG/20120504_FDF_CRG_c12.mtb	714	129	WWSS	food_sc	3	149494	1336271680	1	0.04	0.000373831775700935	8952	1
4	Food 1	Intake 3	165	149895	1336272081	/users/cn/jespinosa/phecomp/data/CRG/20120502_FDF_CRG/20120502_FDF_CRG/20120504_FDF_CRG_c12.mtb	717	6	WWSS	food_sc	3	149730	1336271916	1	0.0599999999999996	0.000363636363636361	8953	1
4	Food 1	Intake 3	153	150054	1336272240	/users/cn/jespinosa/phecomp/data/CRG/20120502_FDF_CRG/20120502_FDF_CRG/20120504_FDF_CRG_c12.mtb	718	648	WWSS	food_sc	3	149901	1336272087	1	0.04	0.000261437908496732	8954	1
4	Drink 1	Intake 1	23	150202	1336272388	/users/cn/jespinosa/phecomp/data/CRG/20120502_FDF_CRG/20120502_FDF_CRG/20120504_FDF_CRG_c12.mtb	644	NA	WWSS	water	1	150179	1336272365	1	0.0800000000000001	0.00347826086956522	8955	1
4	Food 1	Intake 3	242	150944	1336273130	/users/cn/jespinosa/phecomp/data/CRG/20120502_FDF_CRG/20120502_FDF_CRG/20120504_FDF_CRG_c12.mtb	723	355	WWSS	food_sc	3	150702	1336272888	1	0.0800000000000001	0.000330578512396695	8956	1
4	Drink 1	Intake 1	28	150962	1336273148	/users/cn/jespinosa/phecomp/data/CRG/20120502_FDF_CRG/20120502_FDF_CRG/20120504_FDF_CRG_c12.mtb	646	NA	WWSS	water	1	150934	1336273120	1	0.16	0.00571428571428571	8957	1
4	Drink 1	Intake 1	17	151286	1336273472	/users/cn/jespinosa/phecomp/data/CRG/20120502_FDF_CRG/20120502_FDF_CRG/20120504_FDF_CRG_c12.mtb	647	NA	WWSS	water	1	151269	1336273455	1	0.02	0.00117647058823529	8958	1
4	Food 1	Intake 3	29	151328	1336273514	/users/cn/jespinosa/phecomp/data/CRG/20120502_FDF_CRG/20120502_FDF_CRG/20120504_FDF_CRG_c12.mtb	726	5504	WWSS	food_sc	3	151299	1336273485	1	0.0200000000000005	0.00068965517241381	8959	1
4	Food 1	Intake 3	180	157012	1336279198	/users/cn/jespinosa/phecomp/data/CRG/20120502_FDF_CRG/20120502_FDF_CRG/20120504_FDF_CRG_c12.mtb	730	20	WWSS	food_sc	3	156832	1336279018	1	0.04	0.000222222222222222	8960	1
4	Food 1	Intake 3	242	157274	1336279460	/users/cn/jespinosa/phecomp/data/CRG/20120502_FDF_CRG/20120502_FDF_CRG/20120504_FDF_CRG_c12.mtb	731	21	WWSS	food_sc	3	157032	1336279218	1	0.0599999999999996	0.000247933884297519	8961	1
4	Food 1	Intake 3	180	157475	1336279661	/users/cn/jespinosa/phecomp/data/CRG/20120502_FDF_CRG/20120502_FDF_CRG/20120504_FDF_CRG_c12.mtb	732	33	WWSS	food_sc	3	157295	1336279481	1	0.100000000000001	0.000555555555555561	8962	1
4	Food 1	Intake 3	170	157678	1336279864	/users/cn/jespinosa/phecomp/data/CRG/20120502_FDF_CRG/20120502_FDF_CRG/20120504_FDF_CRG_c12.mtb	733	648	WWSS	food_sc	3	157508	1336279694	1	0.0800000000000001	0.000470588235294118	8963	1
4	Drink 2	Intake 2	26	157706	1336279892	/users/cn/jespinosa/phecomp/data/CRG/20120502_FDF_CRG/20120502_FDF_CRG/20120504_FDF_CRG_c12.mtb	722	NA	WWSS	water	2	157680	1336279866	1	0.0800000000000001	0.00307692307692308	8964	1
4	Drink 2	Intake 2	27	157862	1336280048	/users/cn/jespinosa/phecomp/data/CRG/20120502_FDF_CRG/20120502_FDF_CRG/20120504_FDF_CRG_c12.mtb	723	NA	WWSS	water	2	157835	1336280021	1	0.0800000000000001	0.00296296296296297	8965	1
4	Food 1	Intake 3	343	158669	1336280855	/users/cn/jespinosa/phecomp/data/CRG/20120502_FDF_CRG/20120502_FDF_CRG/20120504_FDF_CRG_c12.mtb	736	88	WWSS	food_sc	3	158326	1336280512	1	0.0999999999999996	0.000291545189504372	8966	1
4	Drink 2	Intake 2	31	158694	1336280880	/users/cn/jespinosa/phecomp/data/CRG/20120502_FDF_CRG/20120502_FDF_CRG/20120504_FDF_CRG_c12.mtb	726	NA	WWSS	water	2	158663	1336280849	1	0.2	0.00645161290322581	8967	1
4	Food 1	Intake 3	123	158880	1336281066	/users/cn/jespinosa/phecomp/data/CRG/20120502_FDF_CRG/20120502_FDF_CRG/20120504_FDF_CRG_c12.mtb	737	3404	WWSS	food_sc	3	158757	1336280943	1	0.04	0.00032520325203252	8968	1
4	Drink 1	Intake 1	13	159713	1336281899	/users/cn/jespinosa/phecomp/data/CRG/20120502_FDF_CRG/20120502_FDF_CRG/20120504_FDF_CRG_c12.mtb	649	NA	WWSS	water	1	159700	1336281886	1	0.02	0.00153846153846154	8969	1
4	Food 1	Intake 3	48	162332	1336284518	/users/cn/jespinosa/phecomp/data/CRG/20120502_FDF_CRG/20120502_FDF_CRG/20120504_FDF_CRG_c12.mtb	738	433	WWSS	food_sc	3	162284	1336284470	1	0.0200000000000005	0.000416666666666677	8970	1
4	Food 1	Intake 3	169	162934	1336285120	/users/cn/jespinosa/phecomp/data/CRG/20120502_FDF_CRG/20120502_FDF_CRG/20120504_FDF_CRG_c12.mtb	740	9	WWSS	food_sc	3	162765	1336284951	1	0.04	0.000236686390532544	8971	1
4	Food 1	Intake 3	85	163028	1336285214	/users/cn/jespinosa/phecomp/data/CRG/20120502_FDF_CRG/20120502_FDF_CRG/20120504_FDF_CRG_c12.mtb	741	5	WWSS	food_sc	3	162943	1336285129	1	0.0599999999999996	0.000705882352941172	8972	1
4	Food 1	Intake 3	96	163129	1336285315	/users/cn/jespinosa/phecomp/data/CRG/20120502_FDF_CRG/20120502_FDF_CRG/20120504_FDF_CRG_c12.mtb	742	4	WWSS	food_sc	3	163033	1336285219	1	0.04	0.000416666666666667	8973	1
4	Food 1	Intake 3	152	163285	1336285471	/users/cn/jespinosa/phecomp/data/CRG/20120502_FDF_CRG/20120502_FDF_CRG/20120504_FDF_CRG_c12.mtb	743	10586	WWSS	food_sc	3	163133	1336285319	1	0.0600000000000005	0.000394736842105266	8974	1
4	Drink 2	Intake 2	20	164087	1336286273	/users/cn/jespinosa/phecomp/data/CRG/20120502_FDF_CRG/20120502_FDF_CRG/20120504_FDF_CRG_c12.mtb	731	NA	WWSS	water	2	164067	1336286253	1	0.0800000000000001	0.00400000000000001	8975	1
4	Food 1	Intake 3	30	173901	1336296087	/users/cn/jespinosa/phecomp/data/CRG/20120502_FDF_CRG/20120502_FDF_CRG/20120504_FDF_CRG_c12.mtb	749	18846	WWSS	food_sc	3	173871	1336296057	1	0.0200000000000005	0.000666666666666683	8976	1
4	Food 1	Intake 3	295	193042	1336315228	/users/cn/jespinosa/phecomp/data/CRG/20120502_FDF_CRG/20120502_FDF_CRG/20120504_FDF_CRG_c12.mtb	755	10115	WWSS	food_sc	3	192747	1336314933	1	0.0800000000000001	0.000271186440677966	8977	1
4	Food 1	Intake 3	61	203218	1336325404	/users/cn/jespinosa/phecomp/data/CRG/20120502_FDF_CRG/20120502_FDF_CRG/20120504_FDF_CRG_c12.mtb	758	1820	WWSS	food_sc	3	203157	1336325343	1	0.0200000000000005	0.000327868852459025	8978	1
4	Food 1	Intake 3	146	205184	1336327370	/users/cn/jespinosa/phecomp/data/CRG/20120502_FDF_CRG/20120502_FDF_CRG/20120504_FDF_CRG_c12.mtb	766	110	WWSS	food_sc	3	205038	1336327224	1	0.0200000000000005	0.000136986301369866	8979	1
4	Food 1	Intake 3	433	205727	1336327913	/users/cn/jespinosa/phecomp/data/CRG/20120502_FDF_CRG/20120502_FDF_CRG/20120504_FDF_CRG_c12.mtb	767	2266	WWSS	food_sc	3	205294	1336327480	1	0.12	0.000277136258660508	8980	1
4	Drink 1	Intake 1	23	206922	1336329108	/users/cn/jespinosa/phecomp/data/CRG/20120502_FDF_CRG/20120502_FDF_CRG/20120504_FDF_CRG_c12.mtb	651	NA	WWSS	water	1	206899	1336329085	1	0.0800000000000001	0.00347826086956522	8981	1
4	Drink 1	Intake 1	18	207980	1336330166	/users/cn/jespinosa/phecomp/data/CRG/20120502_FDF_CRG/20120502_FDF_CRG/20120504_FDF_CRG_c12.mtb	652	NA	WWSS	water	1	207962	1336330148	1	0.02	0.00111111111111111	8982	1
4	Food 1	Intake 3	429	208422	1336330608	/users/cn/jespinosa/phecomp/data/CRG/20120502_FDF_CRG/20120502_FDF_CRG/20120504_FDF_CRG_c12.mtb	770	44	WWSS	food_sc	3	207993	1336330179	1	0.18	0.00041958041958042	8983	1
4	Drink 2	Intake 2	33	208462	1336330648	/users/cn/jespinosa/phecomp/data/CRG/20120502_FDF_CRG/20120502_FDF_CRG/20120504_FDF_CRG_c12.mtb	739	NA	WWSS	water	2	208429	1336330615	1	0.1	0.00303030303030303	8984	1
4	Food 1	Intake 3	29	208495	1336330681	/users/cn/jespinosa/phecomp/data/CRG/20120502_FDF_CRG/20120502_FDF_CRG/20120504_FDF_CRG_c12.mtb	771	599	WWSS	food_sc	3	208466	1336330652	1	0.0200000000000005	0.00068965517241381	8985	1
4	Food 1	Intake 3	181	209275	1336331461	/users/cn/jespinosa/phecomp/data/CRG/20120502_FDF_CRG/20120502_FDF_CRG/20120504_FDF_CRG_c12.mtb	773	1123	WWSS	food_sc	3	209094	1336331280	1	0.0800000000000001	0.000441988950276244	8986	1
4	Drink 1	Intake 1	48	209316	1336331502	/users/cn/jespinosa/phecomp/data/CRG/20120502_FDF_CRG/20120502_FDF_CRG/20120504_FDF_CRG_c12.mtb	653	NA	WWSS	water	1	209268	1336331454	1	0.1	0.00208333333333333	8987	1
4	Drink 2	Intake 2	17	209776	1336331962	/users/cn/jespinosa/phecomp/data/CRG/20120502_FDF_CRG/20120502_FDF_CRG/20120504_FDF_CRG_c12.mtb	745	NA	WWSS	water	2	209759	1336331945	1	0.02	0.00117647058823529	8988	1
4	Drink 1	Intake 1	20	210139	1336332325	/users/cn/jespinosa/phecomp/data/CRG/20120502_FDF_CRG/20120502_FDF_CRG/20120504_FDF_CRG_c12.mtb	655	NA	WWSS	water	1	210119	1336332305	1	0.1	0.005	8989	1
4	Food 1	Intake 3	110	210508	1336332694	/users/cn/jespinosa/phecomp/data/CRG/20120502_FDF_CRG/20120502_FDF_CRG/20120504_FDF_CRG_c12.mtb	781	556	WWSS	food_sc	3	210398	1336332584	1	0.0200000000000005	0.000181818181818186	8990	1
4	Food 1	Intake 3	191	211255	1336333441	/users/cn/jespinosa/phecomp/data/CRG/20120502_FDF_CRG/20120502_FDF_CRG/20120504_FDF_CRG_c12.mtb	785	9	WWSS	food_sc	3	211064	1336333250	1	0.0999999999999996	0.000523560209424082	8991	1
4	Food 1	Intake 3	129	211393	1336333579	/users/cn/jespinosa/phecomp/data/CRG/20120502_FDF_CRG/20120502_FDF_CRG/20120504_FDF_CRG_c12.mtb	786	408	WWSS	food_sc	3	211264	1336333450	1	0.0600000000000005	0.000465116279069771	8992	1
4	Drink 1	Intake 1	22	211404	1336333590	/users/cn/jespinosa/phecomp/data/CRG/20120502_FDF_CRG/20120502_FDF_CRG/20120504_FDF_CRG_c12.mtb	656	NA	WWSS	water	1	211382	1336333568	1	0.1	0.00454545454545455	8993	1
4	Food 1	Intake 3	43	211844	1336334030	/users/cn/jespinosa/phecomp/data/CRG/20120502_FDF_CRG/20120502_FDF_CRG/20120504_FDF_CRG_c12.mtb	788	3515	WWSS	food_sc	3	211801	1336333987	1	0.3	0.00697674418604651	8994	1
4	Drink 2	Intake 2	56	212309	1336334495	/users/cn/jespinosa/phecomp/data/CRG/20120502_FDF_CRG/20120502_FDF_CRG/20120504_FDF_CRG_c12.mtb	750	NA	WWSS	water	2	212253	1336334439	1	0.14	0.0025	8995	1
4	Drink 2	Intake 2	15	213383	1336335569	/users/cn/jespinosa/phecomp/data/CRG/20120502_FDF_CRG/20120502_FDF_CRG/20120504_FDF_CRG_c12.mtb	758	NA	WWSS	water	2	213368	1336335554	1	0.0599999999999996	0.00399999999999997	8996	1
4	Food 2	Intake 4	344	215703	1336337889	/users/cn/jespinosa/phecomp/data/CRG/20120502_FDF_CRG/20120502_FDF_CRG/20120504_FDF_CRG_c12.mtb	1111	206	WWSS	food_sc	4	215359	1336337545	1	0.12	0.000348837209302326	8997	1
4	Drink 2	Intake 2	31	215729	1336337915	/users/cn/jespinosa/phecomp/data/CRG/20120502_FDF_CRG/20120502_FDF_CRG/20120504_FDF_CRG_c12.mtb	766	NA	WWSS	water	2	215698	1336337884	1	0.0800000000000001	0.00258064516129033	8998	1
4	Food 2	Intake 4	142	216051	1336338237	/users/cn/jespinosa/phecomp/data/CRG/20120502_FDF_CRG/20120502_FDF_CRG/20120504_FDF_CRG_c12.mtb	1114	716	WWSS	food_sc	4	215909	1336338095	1	0.02	0.000140845070422535	8999	1
4	Drink 2	Intake 2	13	216060	1336338246	/users/cn/jespinosa/phecomp/data/CRG/20120502_FDF_CRG/20120502_FDF_CRG/20120504_FDF_CRG_c12.mtb	768	NA	WWSS	water	2	216047	1336338233	1	0.02	0.00153846153846154	9000	1
4	Drink 1	Intake 1	14	216411	1336338597	/users/cn/jespinosa/phecomp/data/CRG/20120502_FDF_CRG/20120502_FDF_CRG/20120504_FDF_CRG_c12.mtb	660	NA	WWSS	water	1	216397	1336338583	1	0.0799999999999996	0.00571428571428569	9001	1
4	Food 2	Intake 4	89	216856	1336339042	/users/cn/jespinosa/phecomp/data/CRG/20120502_FDF_CRG/20120502_FDF_CRG/20120504_FDF_CRG_c12.mtb	1116	3390	WWSS	food_sc	4	216767	1336338953	1	0.02	0.000224719101123596	9002	1
4	Food 2	Intake 4	519	220765	1336342951	/users/cn/jespinosa/phecomp/data/CRG/20120502_FDF_CRG/20120502_FDF_CRG/20120504_FDF_CRG_c12.mtb	1118	541	WWSS	food_sc	4	220246	1336342432	1	0.26	0.000500963391136802	9003	1
4	Drink 2	Intake 2	25	220790	1336342976	/users/cn/jespinosa/phecomp/data/CRG/20120502_FDF_CRG/20120502_FDF_CRG/20120504_FDF_CRG_c12.mtb	770	NA	WWSS	water	2	220765	1336342951	1	0.0600000000000001	0.0024	9004	1
4	Drink 1	Intake 1	21	221101	1336343287	/users/cn/jespinosa/phecomp/data/CRG/20120502_FDF_CRG/20120502_FDF_CRG/20120504_FDF_CRG_c12.mtb	664	NA	WWSS	water	1	221080	1336343266	1	0.0800000000000001	0.00380952380952381	9005	1
4	Food 2	Intake 4	118	221424	1336343610	/users/cn/jespinosa/phecomp/data/CRG/20120502_FDF_CRG/20120502_FDF_CRG/20120504_FDF_CRG_c12.mtb	1122	220	WWSS	food_sc	4	221306	1336343492	1	0.02	0.000169491525423729	9006	1
4	Drink 1	Intake 1	17	221468	1336343654	/users/cn/jespinosa/phecomp/data/CRG/20120502_FDF_CRG/20120502_FDF_CRG/20120504_FDF_CRG_c12.mtb	665	NA	WWSS	water	1	221451	1336343637	1	0.0800000000000001	0.00470588235294118	9007	1
4	Food 2	Intake 4	129	221773	1336343959	/users/cn/jespinosa/phecomp/data/CRG/20120502_FDF_CRG/20120502_FDF_CRG/20120504_FDF_CRG_c12.mtb	1123	589	WWSS	food_sc	4	221644	1336343830	1	0.04	0.000310077519379845	9008	1
4	Drink 2	Intake 2	41	222012	1336344198	/users/cn/jespinosa/phecomp/data/CRG/20120502_FDF_CRG/20120502_FDF_CRG/20120504_FDF_CRG_c12.mtb	776	NA	WWSS	water	2	221971	1336344157	1	0.0800000000000001	0.00195121951219512	9009	1
4	Food 2	Intake 4	21	222383	1336344569	/users/cn/jespinosa/phecomp/data/CRG/20120502_FDF_CRG/20120502_FDF_CRG/20120504_FDF_CRG_c12.mtb	1125	53	WWSS	food_sc	4	222362	1336344548	1	0.02	0.000952380952380952	9010	1
4	Food 2	Intake 4	171	222607	1336344793	/users/cn/jespinosa/phecomp/data/CRG/20120502_FDF_CRG/20120502_FDF_CRG/20120504_FDF_CRG_c12.mtb	1126	977	WWSS	food_sc	4	222436	1336344622	1	0.0799999999999998	0.00046783625730994	9011	1
4	Drink 2	Intake 2	23	222895	1336345081	/users/cn/jespinosa/phecomp/data/CRG/20120502_FDF_CRG/20120502_FDF_CRG/20120504_FDF_CRG_c12.mtb	778	NA	WWSS	water	2	222872	1336345058	1	0.0600000000000001	0.00260869565217392	9012	1
4	Drink 1	Intake 1	28	223442	1336345628	/users/cn/jespinosa/phecomp/data/CRG/20120502_FDF_CRG/20120502_FDF_CRG/20120504_FDF_CRG_c12.mtb	666	NA	WWSS	water	1	223414	1336345600	1	0.02	0.000714285714285714	9013	1
4	Food 2	Intake 4	286	223870	1336346056	/users/cn/jespinosa/phecomp/data/CRG/20120502_FDF_CRG/20120502_FDF_CRG/20120504_FDF_CRG_c12.mtb	1131	2237	WWSS	food_sc	4	223584	1336345770	1	0.12	0.00041958041958042	9014	1
4	Drink 1	Intake 1	23	223946	1336346132	/users/cn/jespinosa/phecomp/data/CRG/20120502_FDF_CRG/20120502_FDF_CRG/20120504_FDF_CRG_c12.mtb	667	NA	WWSS	water	1	223923	1336346109	1	0.14	0.00608695652173913	9015	1
4	Food 2	Intake 4	136	226243	1336348429	/users/cn/jespinosa/phecomp/data/CRG/20120502_FDF_CRG/20120502_FDF_CRG/20120504_FDF_CRG_c12.mtb	1137	9517	WWSS	food_sc	4	226107	1336348293	1	0.28	0.00205882352941176	9016	1
4	Drink 2	Intake 2	31	226593	1336348779	/users/cn/jespinosa/phecomp/data/CRG/20120502_FDF_CRG/20120502_FDF_CRG/20120504_FDF_CRG_c12.mtb	787	NA	WWSS	water	2	226562	1336348748	1	0.14	0.00451612903225806	9017	1
4	Drink 2	Intake 2	22	227463	1336349649	/users/cn/jespinosa/phecomp/data/CRG/20120502_FDF_CRG/20120502_FDF_CRG/20120504_FDF_CRG_c12.mtb	790	NA	WWSS	water	2	227441	1336349627	1	0.0599999999999996	0.00272727272727271	9018	1
4	Drink 2	Intake 2	23	229933	1336352119	/users/cn/jespinosa/phecomp/data/CRG/20120502_FDF_CRG/20120502_FDF_CRG/20120504_FDF_CRG_c12.mtb	793	NA	WWSS	water	2	229910	1336352096	1	0.02	0.000869565217391304	9019	1
4	Drink 1	Intake 1	26	230024	1336352210	/users/cn/jespinosa/phecomp/data/CRG/20120502_FDF_CRG/20120502_FDF_CRG/20120504_FDF_CRG_c12.mtb	673	NA	WWSS	water	1	229998	1336352184	1	0.0200000000000005	0.000769230769230788	9020	1
4	Food 2	Intake 4	415	236175	1336358361	/users/cn/jespinosa/phecomp/data/CRG/20120502_FDF_CRG/20120502_FDF_CRG/20120504_FDF_CRG_c12.mtb	1151	59	WWSS	food_sc	4	235760	1336357946	1	0.04	9.63855421686747e-05	9021	1
4	Food 2	Intake 4	210	236444	1336358630	/users/cn/jespinosa/phecomp/data/CRG/20120502_FDF_CRG/20120502_FDF_CRG/20120504_FDF_CRG_c12.mtb	1153	5908	WWSS	food_sc	4	236234	1336358420	1	0.04	0.00019047619047619	9022	1
4	Drink 1	Intake 1	17	237099	1336359285	/users/cn/jespinosa/phecomp/data/CRG/20120502_FDF_CRG/20120502_FDF_CRG/20120504_FDF_CRG_c12.mtb	679	NA	WWSS	water	1	237082	1336359268	1	0.0200000000000005	0.00117647058823532	9023	1
4	Food 2	Intake 4	539	242891	1336365077	/users/cn/jespinosa/phecomp/data/CRG/20120502_FDF_CRG/20120502_FDF_CRG/20120504_FDF_CRG_c12.mtb	1165	190	WWSS	food_sc	4	242352	1336364538	1	0.18	0.000333951762523191	9024	1
4	Drink 2	Intake 2	15	242915	1336365101	/users/cn/jespinosa/phecomp/data/CRG/20120502_FDF_CRG/20120502_FDF_CRG/20120504_FDF_CRG_c12.mtb	807	NA	WWSS	water	2	242900	1336365086	1	0.04	0.00266666666666667	9025	1
4	Food 2	Intake 4	79	243160	1336365346	/users/cn/jespinosa/phecomp/data/CRG/20120502_FDF_CRG/20120502_FDF_CRG/20120504_FDF_CRG_c12.mtb	1167	6620	WWSS	food_sc	4	243081	1336365267	1	0.02	0.000253164556962025	9026	1
4	Drink 1	Intake 1	20	243247	1336365433	/users/cn/jespinosa/phecomp/data/CRG/20120502_FDF_CRG/20120502_FDF_CRG/20120504_FDF_CRG_c12.mtb	684	NA	WWSS	water	1	243227	1336365413	1	0.0999999999999996	0.00499999999999998	9027	1
4	Drink 2	Intake 2	58	243408	1336365594	/users/cn/jespinosa/phecomp/data/CRG/20120502_FDF_CRG/20120502_FDF_CRG/20120504_FDF_CRG_c12.mtb	810	NA	WWSS	water	2	243350	1336365536	1	0.02	0.000344827586206897	9028	1
4	Drink 2	Intake 2	32	243507	1336365693	/users/cn/jespinosa/phecomp/data/CRG/20120502_FDF_CRG/20120502_FDF_CRG/20120504_FDF_CRG_c12.mtb	811	NA	WWSS	water	2	243475	1336365661	1	0.0800000000000001	0.0025	9029	1
4	Drink 2	Intake 2	47	244317	1336366503	/users/cn/jespinosa/phecomp/data/CRG/20120502_FDF_CRG/20120502_FDF_CRG/20120504_FDF_CRG_c12.mtb	814	NA	WWSS	water	2	244270	1336366456	1	0.02	0.000425531914893617	9030	1
4	Food 2	Intake 4	17	249797	1336371983	/users/cn/jespinosa/phecomp/data/CRG/20120502_FDF_CRG/20120502_FDF_CRG/20120504_FDF_CRG_c12.mtb	1175	4494	WWSS	food_sc	4	249780	1336371966	1	0.02	0.00117647058823529	9031	1
4	Food 2	Intake 4	406	254697	1336376883	/users/cn/jespinosa/phecomp/data/CRG/20120502_FDF_CRG/20120502_FDF_CRG/20120504_FDF_CRG_c12.mtb	1182	8601	WWSS	food_sc	4	254291	1336376477	1	0.1	0.000246305418719212	9032	1
4	Food 1	Intake 3	262	3235	1336385746	/users/cn/jespinosa/phecomp/data/CRG/20120502_FDF_CRG/20120502_FDF_CRG/20120507_FDF_CRG_c12.mtb	924	2930	WWSS	food_sc	3	2973	1336385484	1	0.08	0.000305343511450382	9033	1
4	Drink 2	Intake 2	43	3339	1336385850	/users/cn/jespinosa/phecomp/data/CRG/20120502_FDF_CRG/20120502_FDF_CRG/20120507_FDF_CRG_c12.mtb	921	NA	WWSS	water	2	3296	1336385807	1	0.02	0.000465116279069767	9034	1
4	Food 1	Intake 3	207	6372	1336388883	/users/cn/jespinosa/phecomp/data/CRG/20120502_FDF_CRG/20120502_FDF_CRG/20120507_FDF_CRG_c12.mtb	927	7	WWSS	food_sc	3	6165	1336388676	1	0.06	0.000289855072463768	9035	1
4	Food 1	Intake 3	362	6741	1336389252	/users/cn/jespinosa/phecomp/data/CRG/20120502_FDF_CRG/20120502_FDF_CRG/20120507_FDF_CRG_c12.mtb	928	10336	WWSS	food_sc	3	6379	1336388890	1	0.14	0.000386740331491713	9036	1
4	Drink 2	Intake 2	28	6765	1336389276	/users/cn/jespinosa/phecomp/data/CRG/20120502_FDF_CRG/20120502_FDF_CRG/20120507_FDF_CRG_c12.mtb	922	NA	WWSS	water	2	6737	1336389248	1	0.08	0.00285714285714286	9037	1
4	Drink 1	Intake 1	13	7353	1336389864	/users/cn/jespinosa/phecomp/data/CRG/20120502_FDF_CRG/20120502_FDF_CRG/20120507_FDF_CRG_c12.mtb	917	NA	WWSS	water	1	7340	1336389851	1	0.06	0.00461538461538461	9038	1
4	Food 1	Intake 3	25	17102	1336399613	/users/cn/jespinosa/phecomp/data/CRG/20120502_FDF_CRG/20120502_FDF_CRG/20120507_FDF_CRG_c12.mtb	929	746	WWSS	food_sc	3	17077	1336399588	1	0.02	0.0008	9039	1
4	Food 2	Intake 4	63	17911	1336400422	/users/cn/jespinosa/phecomp/data/CRG/20120502_FDF_CRG/20120502_FDF_CRG/20120507_FDF_CRG_c12.mtb	1353	7617	WWSS	food_sc	4	17848	1336400359	1	0.02	0.000317460317460317	9040	1
4	Food 1	Intake 3	229	25757	1336408268	/users/cn/jespinosa/phecomp/data/CRG/20120502_FDF_CRG/20120502_FDF_CRG/20120507_FDF_CRG_c12.mtb	931	3962	WWSS	food_sc	3	25528	1336408039	1	0.04	0.000174672489082969	9041	1
4	Drink 2	Intake 2	16	25838	1336408349	/users/cn/jespinosa/phecomp/data/CRG/20120502_FDF_CRG/20120502_FDF_CRG/20120507_FDF_CRG_c12.mtb	923	NA	WWSS	water	2	25822	1336408333	1	0.02	0.00125	9042	1
4	Food 1	Intake 3	636	30355	1336412866	/users/cn/jespinosa/phecomp/data/CRG/20120502_FDF_CRG/20120502_FDF_CRG/20120507_FDF_CRG_c12.mtb	932	2005	WWSS	food_sc	3	29719	1336412230	1	0.14	0.000220125786163522	9043	1
4	Drink 1	Intake 1	20	31768	1336414279	/users/cn/jespinosa/phecomp/data/CRG/20120502_FDF_CRG/20120502_FDF_CRG/20120507_FDF_CRG_c12.mtb	918	NA	WWSS	water	1	31748	1336414259	1	0.06	0.003	9044	1
4	Food 1	Intake 3	206	32566	1336415077	/users/cn/jespinosa/phecomp/data/CRG/20120502_FDF_CRG/20120502_FDF_CRG/20120507_FDF_CRG_c12.mtb	934	83	WWSS	food_sc	3	32360	1336414871	1	0.02	9.70873786407767e-05	9045	1
4	Food 1	Intake 3	141	32790	1336415301	/users/cn/jespinosa/phecomp/data/CRG/20120502_FDF_CRG/20120502_FDF_CRG/20120507_FDF_CRG_c12.mtb	935	196	WWSS	food_sc	3	32649	1336415160	1	0.02	0.000141843971631206	9046	1
4	Food 2	Intake 4	215	33201	1336415712	/users/cn/jespinosa/phecomp/data/CRG/20120502_FDF_CRG/20120502_FDF_CRG/20120507_FDF_CRG_c12.mtb	1361	95	WWSS	food_sc	4	32986	1336415497	1	0.1	0.000465116279069767	9047	1
4	Drink 2	Intake 2	20	33261	1336415772	/users/cn/jespinosa/phecomp/data/CRG/20120502_FDF_CRG/20120502_FDF_CRG/20120507_FDF_CRG_c12.mtb	925	NA	WWSS	water	2	33241	1336415752	1	0.02	0.001	9048	1
4	Food 2	Intake 4	167	33463	1336415974	/users/cn/jespinosa/phecomp/data/CRG/20120502_FDF_CRG/20120502_FDF_CRG/20120507_FDF_CRG_c12.mtb	1363	554	WWSS	food_sc	4	33296	1336415807	1	0.08	0.000479041916167665	9049	1
4	Drink 1	Intake 1	21	33480	1336415991	/users/cn/jespinosa/phecomp/data/CRG/20120502_FDF_CRG/20120502_FDF_CRG/20120507_FDF_CRG_c12.mtb	921	NA	WWSS	water	1	33459	1336415970	1	0.06	0.00285714285714286	9050	1
4	Food 2	Intake 4	107	34124	1336416635	/users/cn/jespinosa/phecomp/data/CRG/20120502_FDF_CRG/20120502_FDF_CRG/20120507_FDF_CRG_c12.mtb	1364	115	WWSS	food_sc	4	34017	1336416528	1	0.02	0.000186915887850467	9051	1
4	Drink 2	Intake 2	18	34147	1336416658	/users/cn/jespinosa/phecomp/data/CRG/20120502_FDF_CRG/20120502_FDF_CRG/20120507_FDF_CRG_c12.mtb	926	NA	WWSS	water	2	34129	1336416640	1	0.04	0.00222222222222222	9052	1
4	Food 2	Intake 4	71	34310	1336416821	/users/cn/jespinosa/phecomp/data/CRG/20120502_FDF_CRG/20120502_FDF_CRG/20120507_FDF_CRG_c12.mtb	1365	370	WWSS	food_sc	4	34239	1336416750	1	0.02	0.00028169014084507	9053	1
4	Drink 1	Intake 1	23	34351	1336416862	/users/cn/jespinosa/phecomp/data/CRG/20120502_FDF_CRG/20120502_FDF_CRG/20120507_FDF_CRG_c12.mtb	922	NA	WWSS	water	1	34328	1336416839	1	0.02	0.000869565217391304	9054	1
4	Drink 2	Intake 2	18	34570	1336417081	/users/cn/jespinosa/phecomp/data/CRG/20120502_FDF_CRG/20120502_FDF_CRG/20120507_FDF_CRG_c12.mtb	929	NA	WWSS	water	2	34552	1336417063	1	0.04	0.00222222222222222	9055	1
4	Food 2	Intake 4	89	34769	1336417280	/users/cn/jespinosa/phecomp/data/CRG/20120502_FDF_CRG/20120502_FDF_CRG/20120507_FDF_CRG_c12.mtb	1367	286	WWSS	food_sc	4	34680	1336417191	1	0.02	0.000224719101123596	9056	1
4	Drink 1	Intake 1	17	35064	1336417575	/users/cn/jespinosa/phecomp/data/CRG/20120502_FDF_CRG/20120502_FDF_CRG/20120507_FDF_CRG_c12.mtb	924	NA	WWSS	water	1	35047	1336417558	1	0.04	0.00235294117647059	9057	1
4	Food 2	Intake 4	217	35272	1336417783	/users/cn/jespinosa/phecomp/data/CRG/20120502_FDF_CRG/20120502_FDF_CRG/20120507_FDF_CRG_c12.mtb	1368	154	WWSS	food_sc	4	35055	1336417566	1	0.06	0.000276497695852535	9058	1
4	Food 2	Intake 4	297	35723	1336418234	/users/cn/jespinosa/phecomp/data/CRG/20120502_FDF_CRG/20120502_FDF_CRG/20120507_FDF_CRG_c12.mtb	1370	83	WWSS	food_sc	4	35426	1336417937	1	0.1	0.000336700336700337	9059	1
4	Drink 1	Intake 1	36	35765	1336418276	/users/cn/jespinosa/phecomp/data/CRG/20120502_FDF_CRG/20120502_FDF_CRG/20120507_FDF_CRG_c12.mtb	925	NA	WWSS	water	1	35729	1336418240	1	0.12	0.00333333333333333	9060	1
4	Drink 2	Intake 2	27	35817	1336418328	/users/cn/jespinosa/phecomp/data/CRG/20120502_FDF_CRG/20120502_FDF_CRG/20120507_FDF_CRG_c12.mtb	931	NA	WWSS	water	2	35790	1336418301	1	0.02	0.000740740740740741	9061	1
4	Food 2	Intake 4	171	35977	1336418488	/users/cn/jespinosa/phecomp/data/CRG/20120502_FDF_CRG/20120502_FDF_CRG/20120507_FDF_CRG_c12.mtb	1371	344	WWSS	food_sc	4	35806	1336418317	1	0.06	0.000350877192982456	9062	1
4	Drink 2	Intake 2	33	36060	1336418571	/users/cn/jespinosa/phecomp/data/CRG/20120502_FDF_CRG/20120502_FDF_CRG/20120507_FDF_CRG_c12.mtb	932	NA	WWSS	water	2	36027	1336418538	1	0.06	0.00181818181818182	9063	1
4	Drink 1	Intake 1	16	36183	1336418694	/users/cn/jespinosa/phecomp/data/CRG/20120502_FDF_CRG/20120502_FDF_CRG/20120507_FDF_CRG_c12.mtb	927	NA	WWSS	water	1	36167	1336418678	1	0.02	0.00125	9064	1
4	Food 2	Intake 4	90	36411	1336418922	/users/cn/jespinosa/phecomp/data/CRG/20120502_FDF_CRG/20120502_FDF_CRG/20120507_FDF_CRG_c12.mtb	1373	112	WWSS	food_sc	4	36321	1336418832	1	0.02	0.000222222222222222	9065	1
4	Drink 2	Intake 2	16	36513	1336419024	/users/cn/jespinosa/phecomp/data/CRG/20120502_FDF_CRG/20120502_FDF_CRG/20120507_FDF_CRG_c12.mtb	934	NA	WWSS	water	2	36497	1336419008	1	0.02	0.00125	9066	1
4	Food 2	Intake 4	80	36603	1336419114	/users/cn/jespinosa/phecomp/data/CRG/20120502_FDF_CRG/20120502_FDF_CRG/20120507_FDF_CRG_c12.mtb	1374	541	WWSS	food_sc	4	36523	1336419034	1	0.02	0.00025	9067	1
4	Drink 1	Intake 1	33	37065	1336419576	/users/cn/jespinosa/phecomp/data/CRG/20120502_FDF_CRG/20120502_FDF_CRG/20120507_FDF_CRG_c12.mtb	928	NA	WWSS	water	1	37032	1336419543	1	0.04	0.00121212121212121	9068	1
4	Drink 2	Intake 2	15	37089	1336419600	/users/cn/jespinosa/phecomp/data/CRG/20120502_FDF_CRG/20120502_FDF_CRG/20120507_FDF_CRG_c12.mtb	937	NA	WWSS	water	2	37074	1336419585	1	0.04	0.00266666666666667	9069	1
4	Food 2	Intake 4	239	37383	1336419894	/users/cn/jespinosa/phecomp/data/CRG/20120502_FDF_CRG/20120502_FDF_CRG/20120507_FDF_CRG_c12.mtb	1377	1378	WWSS	food_sc	4	37144	1336419655	1	0.1	0.000418410041841004	9070	1
4	Drink 2	Intake 2	21	37403	1336419914	/users/cn/jespinosa/phecomp/data/CRG/20120502_FDF_CRG/20120502_FDF_CRG/20120507_FDF_CRG_c12.mtb	938	NA	WWSS	water	2	37382	1336419893	1	0.06	0.00285714285714286	9071	1
4	Drink 1	Intake 1	23	37977	1336420488	/users/cn/jespinosa/phecomp/data/CRG/20120502_FDF_CRG/20120502_FDF_CRG/20120507_FDF_CRG_c12.mtb	929	NA	WWSS	water	1	37954	1336420465	1	0.08	0.00347826086956522	9072	1
4	Drink 2	Intake 2	17	38589	1336421100	/users/cn/jespinosa/phecomp/data/CRG/20120502_FDF_CRG/20120502_FDF_CRG/20120507_FDF_CRG_c12.mtb	940	NA	WWSS	water	2	38572	1336421083	1	0.02	0.00117647058823529	9073	1
4	Food 2	Intake 4	124	38885	1336421396	/users/cn/jespinosa/phecomp/data/CRG/20120502_FDF_CRG/20120502_FDF_CRG/20120507_FDF_CRG_c12.mtb	1381	8	WWSS	food_sc	4	38761	1336421272	1	0.0600000000000001	0.000483870967741936	9074	1
4	Food 2	Intake 4	189	39082	1336421593	/users/cn/jespinosa/phecomp/data/CRG/20120502_FDF_CRG/20120502_FDF_CRG/20120507_FDF_CRG_c12.mtb	1382	14	WWSS	food_sc	4	38893	1336421404	1	0.08	0.000423280423280423	9075	1
4	Food 2	Intake 4	18	39114	1336421625	/users/cn/jespinosa/phecomp/data/CRG/20120502_FDF_CRG/20120502_FDF_CRG/20120507_FDF_CRG_c12.mtb	1383	5	WWSS	food_sc	4	39096	1336421607	1	0.02	0.00111111111111111	9076	1
4	Food 2	Intake 4	83	39202	1336421713	/users/cn/jespinosa/phecomp/data/CRG/20120502_FDF_CRG/20120502_FDF_CRG/20120507_FDF_CRG_c12.mtb	1384	685	WWSS	food_sc	4	39119	1336421630	1	0.0399999999999999	0.000481927710843372	9077	1
4	Drink 2	Intake 2	26	39232	1336421743	/users/cn/jespinosa/phecomp/data/CRG/20120502_FDF_CRG/20120502_FDF_CRG/20120507_FDF_CRG_c12.mtb	941	NA	WWSS	water	2	39206	1336421717	1	0.12	0.00461538461538461	9078	1
4	Drink 1	Intake 1	48	39824	1336422335	/users/cn/jespinosa/phecomp/data/CRG/20120502_FDF_CRG/20120502_FDF_CRG/20120507_FDF_CRG_c12.mtb	933	NA	WWSS	water	1	39776	1336422287	1	0.02	0.000416666666666667	9079	1
4	Food 2	Intake 4	89	39976	1336422487	/users/cn/jespinosa/phecomp/data/CRG/20120502_FDF_CRG/20120502_FDF_CRG/20120507_FDF_CRG_c12.mtb	1388	24	WWSS	food_sc	4	39887	1336422398	1	0.04	0.000449438202247191	9080	1
4	Drink 1	Intake 1	16	39985	1336422496	/users/cn/jespinosa/phecomp/data/CRG/20120502_FDF_CRG/20120502_FDF_CRG/20120507_FDF_CRG_c12.mtb	934	NA	WWSS	water	1	39969	1336422480	1	0.0599999999999999	0.00374999999999999	9081	1
4	Food 2	Intake 4	118	40118	1336422629	/users/cn/jespinosa/phecomp/data/CRG/20120502_FDF_CRG/20120502_FDF_CRG/20120507_FDF_CRG_c12.mtb	1389	844	WWSS	food_sc	4	40000	1336422511	1	0.02	0.000169491525423729	9082	1
4	Food 2	Intake 4	185	41147	1336423658	/users/cn/jespinosa/phecomp/data/CRG/20120502_FDF_CRG/20120502_FDF_CRG/20120507_FDF_CRG_c12.mtb	1393	918	WWSS	food_sc	4	40962	1336423473	1	0.0599999999999999	0.000324324324324324	9083	1
4	Drink 2	Intake 2	23	41172	1336423683	/users/cn/jespinosa/phecomp/data/CRG/20120502_FDF_CRG/20120502_FDF_CRG/20120507_FDF_CRG_c12.mtb	945	NA	WWSS	water	2	41149	1336423660	1	0.0600000000000001	0.00260869565217392	9084	1
4	Drink 1	Intake 1	25	41327	1336423838	/users/cn/jespinosa/phecomp/data/CRG/20120502_FDF_CRG/20120502_FDF_CRG/20120507_FDF_CRG_c12.mtb	937	NA	WWSS	water	1	41302	1336423813	1	0.02	0.0008	9085	1
4	Drink 2	Intake 2	20	41332	1336423843	/users/cn/jespinosa/phecomp/data/CRG/20120502_FDF_CRG/20120502_FDF_CRG/20120507_FDF_CRG_c12.mtb	947	NA	WWSS	water	2	41312	1336423823	1	0.02	0.001	9086	1
4	Food 2	Intake 4	139	42204	1336424715	/users/cn/jespinosa/phecomp/data/CRG/20120502_FDF_CRG/20120502_FDF_CRG/20120507_FDF_CRG_c12.mtb	1395	32	WWSS	food_sc	4	42065	1336424576	1	0.04	0.000287769784172662	9087	1
4	Food 2	Intake 4	261	42497	1336425008	/users/cn/jespinosa/phecomp/data/CRG/20120502_FDF_CRG/20120502_FDF_CRG/20120507_FDF_CRG_c12.mtb	1396	6	WWSS	food_sc	4	42236	1336424747	1	0.12	0.000459770114942529	9088	1
4	Food 2	Intake 4	147	42650	1336425161	/users/cn/jespinosa/phecomp/data/CRG/20120502_FDF_CRG/20120502_FDF_CRG/20120507_FDF_CRG_c12.mtb	1397	2622	WWSS	food_sc	4	42503	1336425014	1	0.0799999999999998	0.000544217687074829	9089	1
4	Drink 1	Intake 1	30	42678	1336425189	/users/cn/jespinosa/phecomp/data/CRG/20120502_FDF_CRG/20120502_FDF_CRG/20120507_FDF_CRG_c12.mtb	944	NA	WWSS	water	1	42648	1336425159	1	0.1	0.00333333333333333	9090	1
4	Drink 2	Intake 2	15	43001	1336425512	/users/cn/jespinosa/phecomp/data/CRG/20120502_FDF_CRG/20120502_FDF_CRG/20120507_FDF_CRG_c12.mtb	950	NA	WWSS	water	2	42986	1336425497	1	0.02	0.00133333333333333	9091	1
4	Drink 1	Intake 1	21	43573	1336426084	/users/cn/jespinosa/phecomp/data/CRG/20120502_FDF_CRG/20120502_FDF_CRG/20120507_FDF_CRG_c12.mtb	946	NA	WWSS	water	1	43552	1336426063	1	0.04	0.0019047619047619	9092	1
4	Food 2	Intake 4	57	45329	1336427840	/users/cn/jespinosa/phecomp/data/CRG/20120502_FDF_CRG/20120502_FDF_CRG/20120507_FDF_CRG_c12.mtb	1402	759	WWSS	food_sc	4	45272	1336427783	1	0.02	0.000350877192982456	9093	1
4	Food 2	Intake 4	20	46108	1336428619	/users/cn/jespinosa/phecomp/data/CRG/20120502_FDF_CRG/20120502_FDF_CRG/20120507_FDF_CRG_c12.mtb	1404	120	WWSS	food_sc	4	46088	1336428599	1	0.02	0.001	9094	1
4	Food 2	Intake 4	153	46381	1336428892	/users/cn/jespinosa/phecomp/data/CRG/20120502_FDF_CRG/20120502_FDF_CRG/20120507_FDF_CRG_c12.mtb	1405	1316	WWSS	food_sc	4	46228	1336428739	1	0.02	0.000130718954248366	9095	1
4	Food 2	Intake 4	328	48025	1336430536	/users/cn/jespinosa/phecomp/data/CRG/20120502_FDF_CRG/20120502_FDF_CRG/20120507_FDF_CRG_c12.mtb	1408	335	WWSS	food_sc	4	47697	1336430208	1	0.0600000000000001	0.000182926829268293	9096	1
4	Drink 2	Intake 2	25	48371	1336430882	/users/cn/jespinosa/phecomp/data/CRG/20120502_FDF_CRG/20120502_FDF_CRG/20120507_FDF_CRG_c12.mtb	954	NA	WWSS	water	2	48346	1336430857	1	0.0800000000000001	0.0032	9097	1
4	Food 2	Intake 4	245	48605	1336431116	/users/cn/jespinosa/phecomp/data/CRG/20120502_FDF_CRG/20120502_FDF_CRG/20120507_FDF_CRG_c12.mtb	1411	342	WWSS	food_sc	4	48360	1336430871	1	0.0599999999999998	0.000244897959183673	9098	1
4	Drink 2	Intake 2	26	48897	1336431408	/users/cn/jespinosa/phecomp/data/CRG/20120502_FDF_CRG/20120502_FDF_CRG/20120507_FDF_CRG_c12.mtb	955	NA	WWSS	water	2	48871	1336431382	1	0.0399999999999999	0.00153846153846153	9099	1
4	Food 2	Intake 4	59	49006	1336431517	/users/cn/jespinosa/phecomp/data/CRG/20120502_FDF_CRG/20120502_FDF_CRG/20120507_FDF_CRG_c12.mtb	1415	847	WWSS	food_sc	4	48947	1336431458	1	0.02	0.000338983050847458	9100	1
4	Drink 1	Intake 1	41	49177	1336431688	/users/cn/jespinosa/phecomp/data/CRG/20120502_FDF_CRG/20120502_FDF_CRG/20120507_FDF_CRG_c12.mtb	953	NA	WWSS	water	1	49136	1336431647	1	0.0600000000000001	0.00146341463414634	9101	1
4	Food 2	Intake 4	249	50102	1336432613	/users/cn/jespinosa/phecomp/data/CRG/20120502_FDF_CRG/20120502_FDF_CRG/20120507_FDF_CRG_c12.mtb	1421	195	WWSS	food_sc	4	49853	1336432364	1	0.04	0.000160642570281124	9102	1
4	Drink 1	Intake 1	32	50297	1336432808	/users/cn/jespinosa/phecomp/data/CRG/20120502_FDF_CRG/20120502_FDF_CRG/20120507_FDF_CRG_c12.mtb	954	NA	WWSS	water	1	50265	1336432776	1	0.12	0.00375	9103	1
4	Food 2	Intake 4	392	50689	1336433200	/users/cn/jespinosa/phecomp/data/CRG/20120502_FDF_CRG/20120502_FDF_CRG/20120507_FDF_CRG_c12.mtb	1423	153	WWSS	food_sc	4	50297	1336432808	1	0.14	0.000357142857142857	9104	1
4	Drink 2	Intake 2	14	50699	1336433210	/users/cn/jespinosa/phecomp/data/CRG/20120502_FDF_CRG/20120502_FDF_CRG/20120507_FDF_CRG_c12.mtb	960	NA	WWSS	water	2	50685	1336433196	1	0.0600000000000001	0.00428571428571429	9105	1
4	Food 2	Intake 4	170	51012	1336433523	/users/cn/jespinosa/phecomp/data/CRG/20120502_FDF_CRG/20120502_FDF_CRG/20120507_FDF_CRG_c12.mtb	1425	20	WWSS	food_sc	4	50842	1336433353	1	0.04	0.000235294117647059	9106	1
4	Drink 2	Intake 2	23	51035	1336433546	/users/cn/jespinosa/phecomp/data/CRG/20120502_FDF_CRG/20120502_FDF_CRG/20120507_FDF_CRG_c12.mtb	961	NA	WWSS	water	2	51012	1336433523	1	0.04	0.00173913043478261	9107	1
4	Food 2	Intake 4	165	51197	1336433708	/users/cn/jespinosa/phecomp/data/CRG/20120502_FDF_CRG/20120502_FDF_CRG/20120507_FDF_CRG_c12.mtb	1426	2637	WWSS	food_sc	4	51032	1336433543	1	0.0800000000000001	0.000484848484848485	9108	1
4	Drink 2	Intake 2	29	51224	1336433735	/users/cn/jespinosa/phecomp/data/CRG/20120502_FDF_CRG/20120502_FDF_CRG/20120507_FDF_CRG_c12.mtb	962	NA	WWSS	water	2	51195	1336433706	1	0.0599999999999999	0.00206896551724138	9109	1
4	Drink 1	Intake 1	33	51559	1336434070	/users/cn/jespinosa/phecomp/data/CRG/20120502_FDF_CRG/20120502_FDF_CRG/20120507_FDF_CRG_c12.mtb	956	NA	WWSS	water	1	51526	1336434037	1	0.08	0.00242424242424242	9110	1
4	Drink 2	Intake 2	17	51565	1336434076	/users/cn/jespinosa/phecomp/data/CRG/20120502_FDF_CRG/20120502_FDF_CRG/20120507_FDF_CRG_c12.mtb	963	NA	WWSS	water	2	51548	1336434059	1	0.04	0.00235294117647059	9111	1
4	Drink 1	Intake 1	16	52011	1336434522	/users/cn/jespinosa/phecomp/data/CRG/20120502_FDF_CRG/20120502_FDF_CRG/20120507_FDF_CRG_c12.mtb	957	NA	WWSS	water	1	51995	1336434506	1	0.02	0.00125	9112	1
4	Food 1	Intake 3	218	54052	1336436563	/users/cn/jespinosa/phecomp/data/CRG/20120502_FDF_CRG/20120502_FDF_CRG/20120507_FDF_CRG_c12.mtb	988	981	WWSS	food_sc	3	53834	1336436345	1	0.08	0.00036697247706422	9113	1
4	Drink 1	Intake 1	18	54368	1336436879	/users/cn/jespinosa/phecomp/data/CRG/20120502_FDF_CRG/20120502_FDF_CRG/20120507_FDF_CRG_c12.mtb	963	NA	WWSS	water	1	54350	1336436861	1	0.02	0.00111111111111111	9114	1
4	Drink 1	Intake 1	21	54683	1336437194	/users/cn/jespinosa/phecomp/data/CRG/20120502_FDF_CRG/20120502_FDF_CRG/20120507_FDF_CRG_c12.mtb	964	NA	WWSS	water	1	54662	1336437173	1	0.02	0.000952380952380952	9115	1
4	Food 1	Intake 3	158	55191	1336437702	/users/cn/jespinosa/phecomp/data/CRG/20120502_FDF_CRG/20120502_FDF_CRG/20120507_FDF_CRG_c12.mtb	991	1186	WWSS	food_sc	3	55033	1336437544	1	0.0600000000000001	0.000379746835443039	9116	1
4	Drink 1	Intake 1	17	55232	1336437743	/users/cn/jespinosa/phecomp/data/CRG/20120502_FDF_CRG/20120502_FDF_CRG/20120507_FDF_CRG_c12.mtb	966	NA	WWSS	water	1	55215	1336437726	1	0.02	0.00117647058823529	9117	1
4	Drink 1	Intake 1	18	55351	1336437862	/users/cn/jespinosa/phecomp/data/CRG/20120502_FDF_CRG/20120502_FDF_CRG/20120507_FDF_CRG_c12.mtb	967	NA	WWSS	water	1	55333	1336437844	1	0.0600000000000001	0.00333333333333334	9118	1
4	Food 1	Intake 3	31	56408	1336438919	/users/cn/jespinosa/phecomp/data/CRG/20120502_FDF_CRG/20120502_FDF_CRG/20120507_FDF_CRG_c12.mtb	994	4593	WWSS	food_sc	3	56377	1336438888	1	0.02	0.000645161290322581	9119	1
4	Food 2	Intake 4	410	61411	1336443922	/users/cn/jespinosa/phecomp/data/CRG/20120502_FDF_CRG/20120502_FDF_CRG/20120507_FDF_CRG_c12.mtb	1447	6302	WWSS	food_sc	4	61001	1336443512	1	0.16	0.000390243902439024	9120	1
4	Drink 1	Intake 1	28	61493	1336444004	/users/cn/jespinosa/phecomp/data/CRG/20120502_FDF_CRG/20120502_FDF_CRG/20120507_FDF_CRG_c12.mtb	973	NA	WWSS	water	1	61465	1336443976	1	0.04	0.00142857142857143	9121	1
4	Drink 2	Intake 2	19	61740	1336444251	/users/cn/jespinosa/phecomp/data/CRG/20120502_FDF_CRG/20120502_FDF_CRG/20120507_FDF_CRG_c12.mtb	971	NA	WWSS	water	2	61721	1336444232	1	0.02	0.00105263157894737	9122	1
4	Drink 1	Intake 1	42	61834	1336444345	/users/cn/jespinosa/phecomp/data/CRG/20120502_FDF_CRG/20120502_FDF_CRG/20120507_FDF_CRG_c12.mtb	975	NA	WWSS	water	1	61792	1336444303	1	0.0800000000000001	0.00190476190476191	9123	1
4	Drink 2	Intake 2	16	62138	1336444649	/users/cn/jespinosa/phecomp/data/CRG/20120502_FDF_CRG/20120502_FDF_CRG/20120507_FDF_CRG_c12.mtb	973	NA	WWSS	water	2	62122	1336444633	1	0.02	0.00125	9124	1
4	Drink 2	Intake 2	15	62442	1336444953	/users/cn/jespinosa/phecomp/data/CRG/20120502_FDF_CRG/20120502_FDF_CRG/20120507_FDF_CRG_c12.mtb	974	NA	WWSS	water	2	62427	1336444938	1	0.02	0.00133333333333333	9125	1
4	Food 2	Intake 4	76	67789	1336450300	/users/cn/jespinosa/phecomp/data/CRG/20120502_FDF_CRG/20120502_FDF_CRG/20120507_FDF_CRG_c12.mtb	1455	COLL	WWSS	food_sc	4	67713	1336450224	1	0.02	0.000263157894736842	9126	1
4	Food 1	Intake 3	102	67881	1336450392	/users/cn/jespinosa/phecomp/data/CRG/20120502_FDF_CRG/20120502_FDF_CRG/20120507_FDF_CRG_c12.mtb	1003	76	WWSS	food_sc	3	67779	1336450290	1	0.0599999999999999	0.000588235294117646	9127	1
4	Food 1	Intake 3	220	68177	1336450688	/users/cn/jespinosa/phecomp/data/CRG/20120502_FDF_CRG/20120502_FDF_CRG/20120507_FDF_CRG_c12.mtb	1004	4	WWSS	food_sc	3	67957	1336450468	1	0.12	0.000545454545454545	9128	1
4	Food 1	Intake 3	39	68220	1336450731	/users/cn/jespinosa/phecomp/data/CRG/20120502_FDF_CRG/20120502_FDF_CRG/20120507_FDF_CRG_c12.mtb	1005	858	WWSS	food_sc	3	68181	1336450692	1	0.02	0.000512820512820513	9129	1
4	Drink 2	Intake 2	19	68730	1336451241	/users/cn/jespinosa/phecomp/data/CRG/20120502_FDF_CRG/20120502_FDF_CRG/20120507_FDF_CRG_c12.mtb	975	NA	WWSS	water	2	68711	1336451222	1	0.02	0.00105263157894737	9130	1
4	Drink 2	Intake 2	36	68833	1336451344	/users/cn/jespinosa/phecomp/data/CRG/20120502_FDF_CRG/20120502_FDF_CRG/20120507_FDF_CRG_c12.mtb	976	NA	WWSS	water	2	68797	1336451308	1	0.02	0.000555555555555556	9131	1
4	Drink 2	Intake 2	16	69088	1336451599	/users/cn/jespinosa/phecomp/data/CRG/20120502_FDF_CRG/20120502_FDF_CRG/20120507_FDF_CRG_c12.mtb	977	NA	WWSS	water	2	69072	1336451583	1	0.02	0.00125	9132	1
4	Food 2	Intake 4	121	69199	1336451710	/users/cn/jespinosa/phecomp/data/CRG/20120502_FDF_CRG/20120502_FDF_CRG/20120507_FDF_CRG_c12.mtb	1458	92	WWSS	food_sc	4	69078	1336451589	1	0.04	0.000330578512396694	9133	1
4	Drink 2	Intake 2	18	69247	1336451758	/users/cn/jespinosa/phecomp/data/CRG/20120502_FDF_CRG/20120502_FDF_CRG/20120507_FDF_CRG_c12.mtb	979	NA	WWSS	water	2	69229	1336451740	1	0.12	0.00666666666666667	9134	1
4	Food 1	Intake 3	57	69348	1336451859	/users/cn/jespinosa/phecomp/data/CRG/20120502_FDF_CRG/20120502_FDF_CRG/20120507_FDF_CRG_c12.mtb	1007	2919	WWSS	food_sc	3	69291	1336451802	1	0.02	0.000350877192982456	9135	1
4	Drink 1	Intake 1	26	69455	1336451966	/users/cn/jespinosa/phecomp/data/CRG/20120502_FDF_CRG/20120502_FDF_CRG/20120507_FDF_CRG_c12.mtb	979	NA	WWSS	water	1	69429	1336451940	1	0.02	0.000769230769230769	9136	1
4	Food 2	Intake 4	458	72725	1336455236	/users/cn/jespinosa/phecomp/data/CRG/20120502_FDF_CRG/20120502_FDF_CRG/20120507_FDF_CRG_c12.mtb	1463	22	WWSS	food_sc	4	72267	1336454778	1	0.16	0.000349344978165939	9137	1
4	Food 2	Intake 4	20	72767	1336455278	/users/cn/jespinosa/phecomp/data/CRG/20120502_FDF_CRG/20120502_FDF_CRG/20120507_FDF_CRG_c12.mtb	1464	843	WWSS	food_sc	4	72747	1336455258	1	0.02	0.001	9138	1
4	Drink 2	Intake 2	20	72783	1336455294	/users/cn/jespinosa/phecomp/data/CRG/20120502_FDF_CRG/20120502_FDF_CRG/20120507_FDF_CRG_c12.mtb	984	NA	WWSS	water	2	72763	1336455274	1	0.0999999999999999	0.00499999999999999	9139	1
4	Food 1	Intake 3	17	73627	1336456138	/users/cn/jespinosa/phecomp/data/CRG/20120502_FDF_CRG/20120502_FDF_CRG/20120507_FDF_CRG_c12.mtb	1013	12187	WWSS	food_sc	3	73610	1336456121	1	0.02	0.00117647058823529	9140	1
4	Food 1	Intake 3	105	85919	1336468430	/users/cn/jespinosa/phecomp/data/CRG/20120502_FDF_CRG/20120502_FDF_CRG/20120507_FDF_CRG_c12.mtb	1019	717	WWSS	food_sc	3	85814	1336468325	1	0.0399999999999999	0.00038095238095238	9141	1
4	Food 2	Intake 4	333	86969	1336469480	/users/cn/jespinosa/phecomp/data/CRG/20120502_FDF_CRG/20120502_FDF_CRG/20120507_FDF_CRG_c12.mtb	1474	26465	WWSS	food_sc	4	86636	1336469147	1	0.0800000000000001	0.000240240240240241	9142	1
4	Drink 1	Intake 1	23	87253	1336469764	/users/cn/jespinosa/phecomp/data/CRG/20120502_FDF_CRG/20120502_FDF_CRG/20120507_FDF_CRG_c12.mtb	983	NA	WWSS	water	1	87230	1336469741	1	0.0599999999999998	0.0026086956521739	9143	1
4	Food 2	Intake 4	97	113531	1336496042	/users/cn/jespinosa/phecomp/data/CRG/20120502_FDF_CRG/20120502_FDF_CRG/20120507_FDF_CRG_c12.mtb	1479	COLL	WWSS	food_sc	4	113434	1336495945	1	0.02	0.000206185567010309	9144	1
4	Food 1	Intake 3	34	113561	1336496072	/users/cn/jespinosa/phecomp/data/CRG/20120502_FDF_CRG/20120502_FDF_CRG/20120507_FDF_CRG_c12.mtb	1030	251	WWSS	food_sc	3	113527	1336496038	1	0.02	0.000588235294117647	9145	1
4	Food 2	Intake 4	601	114413	1336496924	/users/cn/jespinosa/phecomp/data/CRG/20120502_FDF_CRG/20120502_FDF_CRG/20120507_FDF_CRG_c12.mtb	1481	3813	WWSS	food_sc	4	113812	1336496323	1	0.18	0.000299500831946755	9146	1
4	Drink 2	Intake 2	22	114436	1336496947	/users/cn/jespinosa/phecomp/data/CRG/20120502_FDF_CRG/20120502_FDF_CRG/20120507_FDF_CRG_c12.mtb	991	NA	WWSS	water	2	114414	1336496925	1	0.0600000000000001	0.00272727272727273	9147	1
4	Drink 1	Intake 1	16	114887	1336497398	/users/cn/jespinosa/phecomp/data/CRG/20120502_FDF_CRG/20120502_FDF_CRG/20120507_FDF_CRG_c12.mtb	987	NA	WWSS	water	1	114871	1336497382	1	0.04	0.0025	9148	1
4	Food 1	Intake 3	17	118243	1336500754	/users/cn/jespinosa/phecomp/data/CRG/20120502_FDF_CRG/20120502_FDF_CRG/20120507_FDF_CRG_c12.mtb	1032	75	WWSS	food_sc	3	118226	1336500737	1	0.02	0.00117647058823529	9149	1
4	Food 2	Intake 4	217	118535	1336501046	/users/cn/jespinosa/phecomp/data/CRG/20120502_FDF_CRG/20120502_FDF_CRG/20120507_FDF_CRG_c12.mtb	1484	71	WWSS	food_sc	4	118318	1336500829	1	0.0600000000000001	0.000276497695852535	9150	1
4	Food 2	Intake 4	271	118877	1336501388	/users/cn/jespinosa/phecomp/data/CRG/20120502_FDF_CRG/20120502_FDF_CRG/20120507_FDF_CRG_c12.mtb	1486	527	WWSS	food_sc	4	118606	1336501117	1	0.1	0.0003690036900369	9151	1
4	Drink 2	Intake 2	20	118907	1336501418	/users/cn/jespinosa/phecomp/data/CRG/20120502_FDF_CRG/20120502_FDF_CRG/20120507_FDF_CRG_c12.mtb	994	NA	WWSS	water	2	118887	1336501398	1	0.0600000000000001	0.00300000000000001	9152	1
4	Drink 2	Intake 2	15	119205	1336501716	/users/cn/jespinosa/phecomp/data/CRG/20120502_FDF_CRG/20120502_FDF_CRG/20120507_FDF_CRG_c12.mtb	995	NA	WWSS	water	2	119190	1336501701	1	0.02	0.00133333333333333	9153	1
4	Food 2	Intake 4	228	119632	1336502143	/users/cn/jespinosa/phecomp/data/CRG/20120502_FDF_CRG/20120502_FDF_CRG/20120507_FDF_CRG_c12.mtb	1490	573	WWSS	food_sc	4	119404	1336501915	1	0.04	0.000175438596491228	9154	1
4	Drink 2	Intake 2	36	119747	1336502258	/users/cn/jespinosa/phecomp/data/CRG/20120502_FDF_CRG/20120502_FDF_CRG/20120507_FDF_CRG_c12.mtb	998	NA	WWSS	water	2	119711	1336502222	1	0.1	0.00277777777777778	9155	1
4	Food 1	Intake 3	108	120313	1336502824	/users/cn/jespinosa/phecomp/data/CRG/20120502_FDF_CRG/20120502_FDF_CRG/20120507_FDF_CRG_c12.mtb	1039	106	WWSS	food_sc	3	120205	1336502716	1	0.0600000000000001	0.000555555555555557	9156	1
4	Food 1	Intake 3	128	120547	1336503058	/users/cn/jespinosa/phecomp/data/CRG/20120502_FDF_CRG/20120502_FDF_CRG/20120507_FDF_CRG_c12.mtb	1041	2122	WWSS	food_sc	3	120419	1336502930	1	0.0600000000000001	0.000468750000000001	9157	1
4	Food 1	Intake 3	144	122813	1336505324	/users/cn/jespinosa/phecomp/data/CRG/20120502_FDF_CRG/20120502_FDF_CRG/20120507_FDF_CRG_c12.mtb	1044	4	WWSS	food_sc	3	122669	1336505180	1	0.0599999999999998	0.000416666666666665	9158	1
4	Food 1	Intake 3	184	123001	1336505512	/users/cn/jespinosa/phecomp/data/CRG/20120502_FDF_CRG/20120502_FDF_CRG/20120507_FDF_CRG_c12.mtb	1045	648	WWSS	food_sc	3	122817	1336505328	1	0.0600000000000001	0.00032608695652174	9159	1
4	Drink 2	Intake 2	33	123247	1336505758	/users/cn/jespinosa/phecomp/data/CRG/20120502_FDF_CRG/20120502_FDF_CRG/20120507_FDF_CRG_c12.mtb	1003	NA	WWSS	water	2	123214	1336505725	1	0.02	0.000606060606060606	9160	1
4	Food 1	Intake 3	68	123717	1336506228	/users/cn/jespinosa/phecomp/data/CRG/20120502_FDF_CRG/20120502_FDF_CRG/20120507_FDF_CRG_c12.mtb	1048	363	WWSS	food_sc	3	123649	1336506160	1	0.02	0.000294117647058824	9161	1
4	Drink 1	Intake 1	34	123816	1336506327	/users/cn/jespinosa/phecomp/data/CRG/20120502_FDF_CRG/20120502_FDF_CRG/20120507_FDF_CRG_c12.mtb	990	NA	WWSS	water	1	123782	1336506293	1	0.12	0.00352941176470588	9162	1
4	Food 1	Intake 3	115	124195	1336506706	/users/cn/jespinosa/phecomp/data/CRG/20120502_FDF_CRG/20120502_FDF_CRG/20120507_FDF_CRG_c12.mtb	1050	161	WWSS	food_sc	3	124080	1336506591	1	0.02	0.000173913043478261	9163	1
4	Food 2	Intake 4	137	124493	1336507004	/users/cn/jespinosa/phecomp/data/CRG/20120502_FDF_CRG/20120502_FDF_CRG/20120507_FDF_CRG_c12.mtb	1508	61	WWSS	food_sc	4	124356	1336506867	1	0.04	0.000291970802919708	9164	1
4	Drink 2	Intake 2	24	124521	1336507032	/users/cn/jespinosa/phecomp/data/CRG/20120502_FDF_CRG/20120502_FDF_CRG/20120507_FDF_CRG_c12.mtb	1006	NA	WWSS	water	2	124497	1336507008	1	0.0799999999999998	0.00333333333333332	9165	1
4	Food 2	Intake 4	76	124630	1336507141	/users/cn/jespinosa/phecomp/data/CRG/20120502_FDF_CRG/20120502_FDF_CRG/20120507_FDF_CRG_c12.mtb	1509	22	WWSS	food_sc	4	124554	1336507065	1	0.02	0.000263157894736842	9166	1
4	Food 2	Intake 4	129	124781	1336507292	/users/cn/jespinosa/phecomp/data/CRG/20120502_FDF_CRG/20120502_FDF_CRG/20120507_FDF_CRG_c12.mtb	1510	165	WWSS	food_sc	4	124652	1336507163	1	0.04	0.000310077519379845	9167	1
4	Food 2	Intake 4	73	125019	1336507530	/users/cn/jespinosa/phecomp/data/CRG/20120502_FDF_CRG/20120502_FDF_CRG/20120507_FDF_CRG_c12.mtb	1511	256	WWSS	food_sc	4	124946	1336507457	1	0.02	0.000273972602739726	9168	1
4	Drink 1	Intake 1	21	125032	1336507543	/users/cn/jespinosa/phecomp/data/CRG/20120502_FDF_CRG/20120502_FDF_CRG/20120507_FDF_CRG_c12.mtb	992	NA	WWSS	water	1	125011	1336507522	1	0.0600000000000001	0.00285714285714286	9169	1
4	Food 1	Intake 3	42	125317	1336507828	/users/cn/jespinosa/phecomp/data/CRG/20120502_FDF_CRG/20120502_FDF_CRG/20120507_FDF_CRG_c12.mtb	1056	21	WWSS	food_sc	3	125275	1336507786	1	0.02	0.000476190476190476	9170	1
4	Food 1	Intake 3	97	125435	1336507946	/users/cn/jespinosa/phecomp/data/CRG/20120502_FDF_CRG/20120502_FDF_CRG/20120507_FDF_CRG_c12.mtb	1057	680	WWSS	food_sc	3	125338	1336507849	1	0.02	0.000206185567010309	9171	1
4	Drink 1	Intake 1	16	125862	1336508373	/users/cn/jespinosa/phecomp/data/CRG/20120502_FDF_CRG/20120502_FDF_CRG/20120507_FDF_CRG_c12.mtb	993	NA	WWSS	water	1	125846	1336508357	1	0.02	0.00125	9172	1
4	Food 1	Intake 3	313	126428	1336508939	/users/cn/jespinosa/phecomp/data/CRG/20120502_FDF_CRG/20120502_FDF_CRG/20120507_FDF_CRG_c12.mtb	1063	500	WWSS	food_sc	3	126115	1336508626	1	0.14	0.000447284345047923	9173	1
4	Drink 2	Intake 2	31	126461	1336508972	/users/cn/jespinosa/phecomp/data/CRG/20120502_FDF_CRG/20120502_FDF_CRG/20120507_FDF_CRG_c12.mtb	1012	NA	WWSS	water	2	126430	1336508941	1	0.14	0.00451612903225806	9174	1
4	Food 2	Intake 4	155	127083	1336509594	/users/cn/jespinosa/phecomp/data/CRG/20120502_FDF_CRG/20120502_FDF_CRG/20120507_FDF_CRG_c12.mtb	1523	338	WWSS	food_sc	4	126928	1336509439	1	0.04	0.000258064516129032	9175	1
4	Drink 1	Intake 1	16	127091	1336509602	/users/cn/jespinosa/phecomp/data/CRG/20120502_FDF_CRG/20120502_FDF_CRG/20120507_FDF_CRG_c12.mtb	995	NA	WWSS	water	1	127075	1336509586	1	0.02	0.00125	9176	1
4	Drink 1	Intake 1	17	127220	1336509731	/users/cn/jespinosa/phecomp/data/CRG/20120502_FDF_CRG/20120502_FDF_CRG/20120507_FDF_CRG_c12.mtb	996	NA	WWSS	water	1	127203	1336509714	1	0.0600000000000001	0.00352941176470589	9177	1
4	Drink 1	Intake 1	16	127366	1336509877	/users/cn/jespinosa/phecomp/data/CRG/20120502_FDF_CRG/20120502_FDF_CRG/20120507_FDF_CRG_c12.mtb	997	NA	WWSS	water	1	127350	1336509861	1	0.0399999999999998	0.00249999999999999	9178	1
4	Food 1	Intake 3	260	127681	1336510192	/users/cn/jespinosa/phecomp/data/CRG/20120502_FDF_CRG/20120502_FDF_CRG/20120507_FDF_CRG_c12.mtb	1069	1189	WWSS	food_sc	3	127421	1336509932	1	0.12	0.000461538461538462	9179	1
4	Drink 1	Intake 1	26	127701	1336510212	/users/cn/jespinosa/phecomp/data/CRG/20120502_FDF_CRG/20120502_FDF_CRG/20120507_FDF_CRG_c12.mtb	998	NA	WWSS	water	1	127675	1336510186	1	0.0800000000000001	0.00307692307692308	9180	1
4	Food 2	Intake 4	71	128941	1336511452	/users/cn/jespinosa/phecomp/data/CRG/20120502_FDF_CRG/20120502_FDF_CRG/20120507_FDF_CRG_c12.mtb	1530	273	WWSS	food_sc	4	128870	1336511381	1	0.0200000000000005	0.000281690140845077	9181	1
4	Food 1	Intake 3	113	129327	1336511838	/users/cn/jespinosa/phecomp/data/CRG/20120502_FDF_CRG/20120502_FDF_CRG/20120507_FDF_CRG_c12.mtb	1074	86	WWSS	food_sc	3	129214	1336511725	1	0.04	0.000353982300884956	9182	1
4	Food 1	Intake 3	68	129481	1336511992	/users/cn/jespinosa/phecomp/data/CRG/20120502_FDF_CRG/20120502_FDF_CRG/20120507_FDF_CRG_c12.mtb	1075	9	WWSS	food_sc	3	129413	1336511924	1	0.02	0.000294117647058824	9183	1
4	Food 1	Intake 3	191	129681	1336512192	/users/cn/jespinosa/phecomp/data/CRG/20120502_FDF_CRG/20120502_FDF_CRG/20120507_FDF_CRG_c12.mtb	1076	185	WWSS	food_sc	3	129490	1336512001	1	0.0799999999999998	0.000418848167539266	9184	1
4	Drink 2	Intake 2	29	129701	1336512212	/users/cn/jespinosa/phecomp/data/CRG/20120502_FDF_CRG/20120502_FDF_CRG/20120507_FDF_CRG_c12.mtb	1016	NA	WWSS	water	2	129672	1336512183	1	0.14	0.00482758620689655	9185	1
4	Food 1	Intake 3	170	130036	1336512547	/users/cn/jespinosa/phecomp/data/CRG/20120502_FDF_CRG/20120502_FDF_CRG/20120507_FDF_CRG_c12.mtb	1077	922	WWSS	food_sc	3	129866	1336512377	1	0.0600000000000001	0.000352941176470589	9186	1
4	Drink 1	Intake 1	20	130052	1336512563	/users/cn/jespinosa/phecomp/data/CRG/20120502_FDF_CRG/20120502_FDF_CRG/20120507_FDF_CRG_c12.mtb	1000	NA	WWSS	water	1	130032	1336512543	1	0.04	0.002	9187	1
4	Drink 2	Intake 2	16	130092	1336512603	/users/cn/jespinosa/phecomp/data/CRG/20120502_FDF_CRG/20120502_FDF_CRG/20120507_FDF_CRG_c12.mtb	1018	NA	WWSS	water	2	130076	1336512587	1	0.0600000000000001	0.00375000000000001	9188	1
4	Drink 2	Intake 2	121	130739	1336513250	/users/cn/jespinosa/phecomp/data/CRG/20120502_FDF_CRG/20120502_FDF_CRG/20120507_FDF_CRG_c12.mtb	1020	NA	WWSS	water	2	130618	1336513129	1	0.02	0.000165289256198347	9189	1
4	Food 1	Intake 3	114	131072	1336513583	/users/cn/jespinosa/phecomp/data/CRG/20120502_FDF_CRG/20120502_FDF_CRG/20120507_FDF_CRG_c12.mtb	1080	2666	WWSS	food_sc	3	130958	1336513469	1	0.0599999999999998	0.000526315789473682	9190	1
4	Drink 1	Intake 1	15	131393	1336513904	/users/cn/jespinosa/phecomp/data/CRG/20120502_FDF_CRG/20120502_FDF_CRG/20120507_FDF_CRG_c12.mtb	1003	NA	WWSS	water	1	131378	1336513889	1	0.02	0.00133333333333333	9191	1
4	Drink 1	Intake 1	17	132964	1336515475	/users/cn/jespinosa/phecomp/data/CRG/20120502_FDF_CRG/20120502_FDF_CRG/20120507_FDF_CRG_c12.mtb	1006	NA	WWSS	water	1	132947	1336515458	1	0.02	0.00117647058823529	9192	1
4	Drink 1	Intake 1	20	133699	1336516210	/users/cn/jespinosa/phecomp/data/CRG/20120502_FDF_CRG/20120502_FDF_CRG/20120507_FDF_CRG_c12.mtb	1007	NA	WWSS	water	1	133679	1336516190	1	0.02	0.001	9193	1
4	Food 1	Intake 3	287	134025	1336516536	/users/cn/jespinosa/phecomp/data/CRG/20120502_FDF_CRG/20120502_FDF_CRG/20120507_FDF_CRG_c12.mtb	1086	2699	WWSS	food_sc	3	133738	1336516249	1	0.0800000000000001	0.000278745644599303	9194	1
4	Food 1	Intake 3	29	136753	1336519264	/users/cn/jespinosa/phecomp/data/CRG/20120502_FDF_CRG/20120502_FDF_CRG/20120507_FDF_CRG_c12.mtb	1088	2146	WWSS	food_sc	3	136724	1336519235	1	0.02	0.000689655172413793	9195	1
4	Food 1	Intake 3	234	139133	1336521644	/users/cn/jespinosa/phecomp/data/CRG/20120502_FDF_CRG/20120502_FDF_CRG/20120507_FDF_CRG_c12.mtb	1096	22	WWSS	food_sc	3	138899	1336521410	1	0.1	0.000427350427350427	9196	1
4	Food 1	Intake 3	159	139314	1336521825	/users/cn/jespinosa/phecomp/data/CRG/20120502_FDF_CRG/20120502_FDF_CRG/20120507_FDF_CRG_c12.mtb	1097	11	WWSS	food_sc	3	139155	1336521666	1	0.1	0.000628930817610063	9197	1
4	Food 1	Intake 3	104	139429	1336521940	/users/cn/jespinosa/phecomp/data/CRG/20120502_FDF_CRG/20120502_FDF_CRG/20120507_FDF_CRG_c12.mtb	1098	272	WWSS	food_sc	3	139325	1336521836	1	0.0600000000000001	0.000576923076923078	9198	1
4	Drink 2	Intake 2	34	139465	1336521976	/users/cn/jespinosa/phecomp/data/CRG/20120502_FDF_CRG/20120502_FDF_CRG/20120507_FDF_CRG_c12.mtb	1026	NA	WWSS	water	2	139431	1336521942	1	0.0600000000000001	0.00176470588235294	9199	1
4	Food 1	Intake 3	136	139837	1336522348	/users/cn/jespinosa/phecomp/data/CRG/20120502_FDF_CRG/20120502_FDF_CRG/20120507_FDF_CRG_c12.mtb	1100	7471	WWSS	food_sc	3	139701	1336522212	1	0.04	0.000294117647058824	9200	1
4	Drink 1	Intake 1	20	139870	1336522381	/users/cn/jespinosa/phecomp/data/CRG/20120502_FDF_CRG/20120502_FDF_CRG/20120507_FDF_CRG_c12.mtb	1013	NA	WWSS	water	1	139850	1336522361	1	0.12	0.006	9201	1
4	Drink 2	Intake 2	19	140027	1336522538	/users/cn/jespinosa/phecomp/data/CRG/20120502_FDF_CRG/20120502_FDF_CRG/20120507_FDF_CRG_c12.mtb	1029	NA	WWSS	water	2	140008	1336522519	1	0.02	0.00105263157894737	9202	1
4	Drink 2	Intake 2	24	140221	1336522732	/users/cn/jespinosa/phecomp/data/CRG/20120502_FDF_CRG/20120502_FDF_CRG/20120507_FDF_CRG_c12.mtb	1030	NA	WWSS	water	2	140197	1336522708	1	0.0800000000000001	0.00333333333333334	9203	1
4	Drink 1	Intake 1	25	140966	1336523477	/users/cn/jespinosa/phecomp/data/CRG/20120502_FDF_CRG/20120502_FDF_CRG/20120507_FDF_CRG_c12.mtb	1015	NA	WWSS	water	1	140941	1336523452	1	0.0600000000000001	0.0024	9204	1
4	Food 1	Intake 3	340	147648	1336530159	/users/cn/jespinosa/phecomp/data/CRG/20120502_FDF_CRG/20120502_FDF_CRG/20120507_FDF_CRG_c12.mtb	1117	210	WWSS	food_sc	3	147308	1336529819	1	0.14	0.000411764705882353	9205	1
4	Drink 1	Intake 1	22	147795	1336530306	/users/cn/jespinosa/phecomp/data/CRG/20120502_FDF_CRG/20120502_FDF_CRG/20120507_FDF_CRG_c12.mtb	1021	NA	WWSS	water	1	147773	1336530284	1	0.1	0.00454545454545455	9206	1
4	Food 1	Intake 3	86	147944	1336530455	/users/cn/jespinosa/phecomp/data/CRG/20120502_FDF_CRG/20120502_FDF_CRG/20120507_FDF_CRG_c12.mtb	1119	195	WWSS	food_sc	3	147858	1336530369	1	0.02	0.000232558139534884	9207	1
4	Drink 2	Intake 2	17	148072	1336530583	/users/cn/jespinosa/phecomp/data/CRG/20120502_FDF_CRG/20120502_FDF_CRG/20120507_FDF_CRG_c12.mtb	1038	NA	WWSS	water	2	148055	1336530566	1	0.02	0.00117647058823529	9208	1
4	Food 1	Intake 3	290	148429	1336530940	/users/cn/jespinosa/phecomp/data/CRG/20120502_FDF_CRG/20120502_FDF_CRG/20120507_FDF_CRG_c12.mtb	1122	6491	WWSS	food_sc	3	148139	1336530650	1	0.12	0.000413793103448276	9209	1
4	Drink 1	Intake 1	30	148461	1336530972	/users/cn/jespinosa/phecomp/data/CRG/20120502_FDF_CRG/20120502_FDF_CRG/20120507_FDF_CRG_c12.mtb	1023	NA	WWSS	water	1	148431	1336530942	1	0.14	0.00466666666666667	9210	1
4	Drink 1	Intake 1	129	149340	1336531851	/users/cn/jespinosa/phecomp/data/CRG/20120502_FDF_CRG/20120502_FDF_CRG/20120507_FDF_CRG_c12.mtb	1026	NA	WWSS	water	1	149211	1336531722	1	0.04	0.000310077519379845	9211	1
4	Food 1	Intake 3	453	155373	1336537884	/users/cn/jespinosa/phecomp/data/CRG/20120502_FDF_CRG/20120502_FDF_CRG/20120507_FDF_CRG_c12.mtb	1127	114	WWSS	food_sc	3	154920	1336537431	1	0.16	0.000353200883002208	9212	1
4	Food 1	Intake 3	71	155558	1336538069	/users/cn/jespinosa/phecomp/data/CRG/20120502_FDF_CRG/20120502_FDF_CRG/20120507_FDF_CRG_c12.mtb	1129	57	WWSS	food_sc	3	155487	1336537998	1	0.04	0.000563380281690141	9213	1
4	Drink 1	Intake 1	24	155579	1336538090	/users/cn/jespinosa/phecomp/data/CRG/20120502_FDF_CRG/20120502_FDF_CRG/20120507_FDF_CRG_c12.mtb	1029	NA	WWSS	water	1	155555	1336538066	1	0.12	0.005	9214	1
4	Food 1	Intake 3	176	155791	1336538302	/users/cn/jespinosa/phecomp/data/CRG/20120502_FDF_CRG/20120502_FDF_CRG/20120507_FDF_CRG_c12.mtb	1130	1992	WWSS	food_sc	3	155615	1336538126	1	0.04	0.000227272727272727	9215	1
4	Drink 1	Intake 1	28	156092	1336538603	/users/cn/jespinosa/phecomp/data/CRG/20120502_FDF_CRG/20120502_FDF_CRG/20120507_FDF_CRG_c12.mtb	1030	NA	WWSS	water	1	156064	1336538575	1	0.1	0.00357142857142857	9216	1
4	Food 1	Intake 3	286	158069	1336540580	/users/cn/jespinosa/phecomp/data/CRG/20120502_FDF_CRG/20120502_FDF_CRG/20120507_FDF_CRG_c12.mtb	1133	4169	WWSS	food_sc	3	157783	1336540294	1	0.12	0.00041958041958042	9217	1
4	Drink 2	Intake 2	26	158179	1336540690	/users/cn/jespinosa/phecomp/data/CRG/20120502_FDF_CRG/20120502_FDF_CRG/20120507_FDF_CRG_c12.mtb	1046	NA	WWSS	water	2	158153	1336540664	1	0.0800000000000001	0.00307692307692308	9218	1
4	Drink 1	Intake 1	25	158198	1336540709	/users/cn/jespinosa/phecomp/data/CRG/20120502_FDF_CRG/20120502_FDF_CRG/20120507_FDF_CRG_c12.mtb	1031	NA	WWSS	water	1	158173	1336540684	1	0.02	0.0008	9219	1
4	Food 1	Intake 3	264	162502	1336545013	/users/cn/jespinosa/phecomp/data/CRG/20120502_FDF_CRG/20120502_FDF_CRG/20120507_FDF_CRG_c12.mtb	1142	2567	WWSS	food_sc	3	162238	1336544749	1	0.12	0.000454545454545455	9220	1
4	Food 1	Intake 3	22	165091	1336547602	/users/cn/jespinosa/phecomp/data/CRG/20120502_FDF_CRG/20120502_FDF_CRG/20120507_FDF_CRG_c12.mtb	1144	LAST	WWSS	food_sc	3	165069	1336547580	1	0.3	0.0136363636363636	9221	1
4	Drink 2	Intake 2	44	165634	1336548145	/users/cn/jespinosa/phecomp/data/CRG/20120502_FDF_CRG/20120502_FDF_CRG/20120507_FDF_CRG_c12.mtb	1050	NA	WWSS	water	2	165590	1336548101	1	0.02	0.000454545454545455	9222	1
4	Drink 1	Intake 1	37	165872	1336548383	/users/cn/jespinosa/phecomp/data/CRG/20120502_FDF_CRG/20120502_FDF_CRG/20120507_FDF_CRG_c12.mtb	1036	NA	WWSS	water	1	165835	1336548346	1	0.0999999999999996	0.00270270270270269	9223	1
4	Food 1	Intake 3	53	345	1336554033	/users/cn/jespinosa/phecomp/data/CRG/20120502_FDF_CRG/20120502_FDF_CRG/20120509_FDF_CRG_c12.mtb	1569	COLL	WWFF	food_fat	3	292	1336553980	1	0.02	0.000377358490566038	9224	1
4	Food 2	Intake 4	16	358	1336554046	/users/cn/jespinosa/phecomp/data/CRG/20120502_FDF_CRG/20120502_FDF_CRG/20120509_FDF_CRG_c12.mtb	2077	75	WWFF	food_fat	4	342	1336554030	1	0.04	0.0025	9225	1
4	Food 1	Intake 3	80	513	1336554201	/users/cn/jespinosa/phecomp/data/CRG/20120502_FDF_CRG/20120502_FDF_CRG/20120509_FDF_CRG_c12.mtb	1571	81	WWFF	food_fat	3	433	1336554121	1	0.24	0.003	9226	1
4	Food 1	Intake 3	94	688	1336554376	/users/cn/jespinosa/phecomp/data/CRG/20120502_FDF_CRG/20120502_FDF_CRG/20120509_FDF_CRG_c12.mtb	1572	COLL	WWFF	food_fat	3	594	1336554282	1	0.26	0.00276595744680851	9227	1
4	Food 2	Intake 4	70	746	1336554434	/users/cn/jespinosa/phecomp/data/CRG/20120502_FDF_CRG/20120502_FDF_CRG/20120509_FDF_CRG_c12.mtb	2079	COLL	WWFF	food_fat	4	676	1336554364	1	0.22	0.00314285714285714	9228	1
4	Food 1	Intake 3	84	820	1336554508	/users/cn/jespinosa/phecomp/data/CRG/20120502_FDF_CRG/20120502_FDF_CRG/20120509_FDF_CRG_c12.mtb	1573	48	WWFF	food_fat	3	736	1336554424	1	0.46	0.00547619047619048	9229	1
4	Food 2	Intake 4	105	973	1336554661	/users/cn/jespinosa/phecomp/data/CRG/20120502_FDF_CRG/20120502_FDF_CRG/20120509_FDF_CRG_c12.mtb	2081	COLL	WWFF	food_fat	4	868	1336554556	1	0.04	0.000380952380952381	9230	1
4	Food 1	Intake 3	16	900	1336554588	/users/cn/jespinosa/phecomp/data/CRG/20120502_FDF_CRG/20120502_FDF_CRG/20120509_FDF_CRG_c12.mtb	1575	64	WWFF	food_fat	3	884	1336554572	1	0.24	0.015	9231	1
4	Food 1	Intake 3	31	995	1336554683	/users/cn/jespinosa/phecomp/data/CRG/20120502_FDF_CRG/20120502_FDF_CRG/20120509_FDF_CRG_c12.mtb	1576	35	WWFF	food_fat	3	964	1336554652	1	0.18	0.00580645161290323	9232	1
4	Food 1	Intake 3	91	1121	1336554809	/users/cn/jespinosa/phecomp/data/CRG/20120502_FDF_CRG/20120502_FDF_CRG/20120509_FDF_CRG_c12.mtb	1577	COLL	WWFF	food_fat	3	1030	1336554718	1	0.1	0.0010989010989011	9233	1
4	Food 2	Intake 4	17	1073	1336554761	/users/cn/jespinosa/phecomp/data/CRG/20120502_FDF_CRG/20120502_FDF_CRG/20120509_FDF_CRG_c12.mtb	2082	35	WWFF	food_fat	4	1056	1336554744	1	0.04	0.00235294117647059	9234	1
4	Food 2	Intake 4	61	1169	1336554857	/users/cn/jespinosa/phecomp/data/CRG/20120502_FDF_CRG/20120502_FDF_CRG/20120509_FDF_CRG_c12.mtb	2083	COLL	WWFF	food_fat	4	1108	1336554796	1	0.04	0.000655737704918033	9235	1
4	Food 1	Intake 3	65	1203	1336554891	/users/cn/jespinosa/phecomp/data/CRG/20120502_FDF_CRG/20120502_FDF_CRG/20120509_FDF_CRG_c12.mtb	1578	COLL	WWFF	food_fat	3	1138	1336554826	1	0.12	0.00184615384615385	9236	1
4	Food 2	Intake 4	71	1262	1336554950	/users/cn/jespinosa/phecomp/data/CRG/20120502_FDF_CRG/20120502_FDF_CRG/20120509_FDF_CRG_c12.mtb	2084	208	WWFF	food_fat	4	1191	1336554879	1	0.02	0.00028169014084507	9237	1
4	Food 2	Intake 4	69	1539	1336555227	/users/cn/jespinosa/phecomp/data/CRG/20120502_FDF_CRG/20120502_FDF_CRG/20120509_FDF_CRG_c12.mtb	2085	3	WWFF	food_fat	4	1470	1336555158	1	0.12	0.00173913043478261	9238	1
4	Food 1	Intake 3	21	1563	1336555251	/users/cn/jespinosa/phecomp/data/CRG/20120502_FDF_CRG/20120502_FDF_CRG/20120509_FDF_CRG_c12.mtb	1580	COLL	WWFF	food_fat	3	1542	1336555230	1	0.0799999999999998	0.0038095238095238	9239	1
4	Food 2	Intake 4	51	1604	1336555292	/users/cn/jespinosa/phecomp/data/CRG/20120502_FDF_CRG/20120502_FDF_CRG/20120509_FDF_CRG_c12.mtb	2086	COLL	WWFF	food_fat	4	1553	1336555241	1	0.12	0.00235294117647059	9240	1
4	Food 1	Intake 3	68	1650	1336555338	/users/cn/jespinosa/phecomp/data/CRG/20120502_FDF_CRG/20120502_FDF_CRG/20120509_FDF_CRG_c12.mtb	1581	COLL	WWFF	food_fat	3	1582	1336555270	1	0.04	0.000588235294117647	9241	1
4	Food 2	Intake 4	33	1652	1336555340	/users/cn/jespinosa/phecomp/data/CRG/20120502_FDF_CRG/20120502_FDF_CRG/20120509_FDF_CRG_c12.mtb	2087	102	WWFF	food_fat	4	1619	1336555307	1	0.0599999999999999	0.00181818181818182	9242	1
4	Food 1	Intake 3	23	1777	1336555465	/users/cn/jespinosa/phecomp/data/CRG/20120502_FDF_CRG/20120502_FDF_CRG/20120509_FDF_CRG_c12.mtb	1582	16	WWFF	food_fat	3	1754	1336555442	1	0.04	0.00173913043478261	9243	1
4	Food 2	Intake 4	84	1877	1336555565	/users/cn/jespinosa/phecomp/data/CRG/20120502_FDF_CRG/20120502_FDF_CRG/20120509_FDF_CRG_c12.mtb	2089	217	WWFF	food_fat	4	1793	1336555481	1	0.16	0.0019047619047619	9244	1
4	Food 2	Intake 4	98	2192	1336555880	/users/cn/jespinosa/phecomp/data/CRG/20120502_FDF_CRG/20120502_FDF_CRG/20120509_FDF_CRG_c12.mtb	2093	133	WWFF	food_fat	4	2094	1336555782	1	0.08	0.000816326530612245	9245	1
4	Food 1	Intake 3	112	2437	1336556125	/users/cn/jespinosa/phecomp/data/CRG/20120502_FDF_CRG/20120502_FDF_CRG/20120509_FDF_CRG_c12.mtb	1586	282	WWFF	food_fat	3	2325	1336556013	1	0.2	0.00178571428571429	9246	1
4	Food 1	Intake 3	86	2805	1336556493	/users/cn/jespinosa/phecomp/data/CRG/20120502_FDF_CRG/20120502_FDF_CRG/20120509_FDF_CRG_c12.mtb	1588	COLL	WWFF	food_fat	3	2719	1336556407	1	0.02	0.000232558139534884	9247	1
4	Food 2	Intake 4	89	2876	1336556564	/users/cn/jespinosa/phecomp/data/CRG/20120502_FDF_CRG/20120502_FDF_CRG/20120509_FDF_CRG_c12.mtb	2098	COLL	WWFF	food_fat	4	2787	1336556475	1	0.02	0.000224719101123596	9248	1
4	Food 1	Intake 3	13	2827	1336556515	/users/cn/jespinosa/phecomp/data/CRG/20120502_FDF_CRG/20120502_FDF_CRG/20120509_FDF_CRG_c12.mtb	1589	8	WWFF	food_fat	3	2814	1336556502	1	0.02	0.00153846153846154	9249	1
4	Food 1	Intake 3	86	2921	1336556609	/users/cn/jespinosa/phecomp/data/CRG/20120502_FDF_CRG/20120502_FDF_CRG/20120509_FDF_CRG_c12.mtb	1590	40	WWFF	food_fat	3	2835	1336556523	1	0.3	0.00348837209302326	9250	1
4	Food 2	Intake 4	28	2989	1336556677	/users/cn/jespinosa/phecomp/data/CRG/20120502_FDF_CRG/20120502_FDF_CRG/20120509_FDF_CRG_c12.mtb	2099	353	WWFF	food_fat	4	2961	1336556649	1	0.02	0.000714285714285714	9251	1
4	Food 2	Intake 4	121	3463	1336557151	/users/cn/jespinosa/phecomp/data/CRG/20120502_FDF_CRG/20120502_FDF_CRG/20120509_FDF_CRG_c12.mtb	2101	COLL	WWFF	food_fat	4	3342	1336557030	1	0.0600000000000001	0.000495867768595042	9252	1
4	Food 1	Intake 3	73	3459	1336557147	/users/cn/jespinosa/phecomp/data/CRG/20120502_FDF_CRG/20120502_FDF_CRG/20120509_FDF_CRG_c12.mtb	1592	3769	WWFF	food_fat	3	3386	1336557074	1	0.04	0.000547945205479452	9253	1
4	Food 2	Intake 4	20	7248	1336560936	/users/cn/jespinosa/phecomp/data/CRG/20120502_FDF_CRG/20120502_FDF_CRG/20120509_FDF_CRG_c12.mtb	2104	2377	WWFF	food_fat	4	7228	1336560916	1	0.02	0.001	9254	1
4	Food 2	Intake 4	24	9649	1336563337	/users/cn/jespinosa/phecomp/data/CRG/20120502_FDF_CRG/20120502_FDF_CRG/20120509_FDF_CRG_c12.mtb	2105	4837	WWFF	food_fat	4	9625	1336563313	1	0.02	0.000833333333333333	9255	1
4	Food 2	Intake 4	31	14517	1336568205	/users/cn/jespinosa/phecomp/data/CRG/20120502_FDF_CRG/20120502_FDF_CRG/20120509_FDF_CRG_c12.mtb	2110	COLL	WWFF	food_fat	4	14486	1336568174	1	0.02	0.000645161290322581	9256	1
4	Food 1	Intake 3	12	14515	1336568203	/users/cn/jespinosa/phecomp/data/CRG/20120502_FDF_CRG/20120502_FDF_CRG/20120509_FDF_CRG_c12.mtb	1598	185	WWFF	food_fat	3	14503	1336568191	1	0.04	0.00333333333333333	9257	1
4	Food 2	Intake 4	10	14710	1336568398	/users/cn/jespinosa/phecomp/data/CRG/20120502_FDF_CRG/20120502_FDF_CRG/20120509_FDF_CRG_c12.mtb	2112	15	WWFF	food_fat	4	14700	1336568388	1	0.02	0.002	9258	1
4	Food 2	Intake 4	14	14739	1336568427	/users/cn/jespinosa/phecomp/data/CRG/20120502_FDF_CRG/20120502_FDF_CRG/20120509_FDF_CRG_c12.mtb	2113	105	WWFF	food_fat	4	14725	1336568413	1	0.04	0.00285714285714286	9259	1
4	Food 2	Intake 4	14	14858	1336568546	/users/cn/jespinosa/phecomp/data/CRG/20120502_FDF_CRG/20120502_FDF_CRG/20120509_FDF_CRG_c12.mtb	2115	COLL	WWFF	food_fat	4	14844	1336568532	1	0.0600000000000001	0.00428571428571429	9260	1
4	Food 1	Intake 3	11	14857	1336568545	/users/cn/jespinosa/phecomp/data/CRG/20120502_FDF_CRG/20120502_FDF_CRG/20120509_FDF_CRG_c12.mtb	1600	394	WWFF	food_fat	3	14846	1336568534	1	0.0600000000000001	0.00545454545454546	9261	1
4	Food 1	Intake 3	33	15284	1336568972	/users/cn/jespinosa/phecomp/data/CRG/20120502_FDF_CRG/20120502_FDF_CRG/20120509_FDF_CRG_c12.mtb	1601	136	WWFF	food_fat	3	15251	1336568939	1	0.02	0.000606060606060606	9262	1
4	Food 2	Intake 4	9	15429	1336569117	/users/cn/jespinosa/phecomp/data/CRG/20120502_FDF_CRG/20120502_FDF_CRG/20120509_FDF_CRG_c12.mtb	2119	769	WWFF	food_fat	4	15420	1336569108	1	0.02	0.00222222222222222	9263	1
4	Drink 2	Intake 2	32	15847	1336569535	/users/cn/jespinosa/phecomp/data/CRG/20120502_FDF_CRG/20120502_FDF_CRG/20120509_FDF_CRG_c12.mtb	1150	NA	WWFF	water	2	15815	1336569503	1	0.16	0.005	9264	1
4	Food 2	Intake 4	22	16220	1336569908	/users/cn/jespinosa/phecomp/data/CRG/20120502_FDF_CRG/20120502_FDF_CRG/20120509_FDF_CRG_c12.mtb	2126	COLL	WWFF	food_fat	4	16198	1336569886	1	0.02	0.000909090909090909	9265	1
4	Food 1	Intake 3	13	16219	1336569907	/users/cn/jespinosa/phecomp/data/CRG/20120502_FDF_CRG/20120502_FDF_CRG/20120509_FDF_CRG_c12.mtb	1604	53	WWFF	food_fat	3	16206	1336569894	1	0.02	0.00153846153846154	9266	1
4	Food 2	Intake 4	12	16284	1336569972	/users/cn/jespinosa/phecomp/data/CRG/20120502_FDF_CRG/20120502_FDF_CRG/20120509_FDF_CRG_c12.mtb	2127	2208	WWFF	food_fat	4	16272	1336569960	1	0.04	0.00333333333333333	9267	1
4	Drink 2	Intake 2	21	16297	1336569985	/users/cn/jespinosa/phecomp/data/CRG/20120502_FDF_CRG/20120502_FDF_CRG/20120509_FDF_CRG_c12.mtb	1151	NA	WWFF	water	2	16276	1336569964	1	0.04	0.0019047619047619	9268	1
4	Food 1	Intake 3	22	18514	1336572202	/users/cn/jespinosa/phecomp/data/CRG/20120502_FDF_CRG/20120502_FDF_CRG/20120509_FDF_CRG_c12.mtb	1606	163	WWFF	food_fat	3	18492	1336572180	1	0.04	0.00181818181818182	9269	1
4	Food 2	Intake 4	33	18710	1336572398	/users/cn/jespinosa/phecomp/data/CRG/20120502_FDF_CRG/20120502_FDF_CRG/20120509_FDF_CRG_c12.mtb	2133	COLL	WWFF	food_fat	4	18677	1336572365	1	0.04	0.00121212121212121	9270	1
4	Food 1	Intake 3	9	18707	1336572395	/users/cn/jespinosa/phecomp/data/CRG/20120502_FDF_CRG/20120502_FDF_CRG/20120509_FDF_CRG_c12.mtb	1608	10291	WWFF	food_fat	3	18698	1336572386	1	0.04	0.00444444444444444	9271	1
4	Drink 1	Intake 1	26	18726	1336572414	/users/cn/jespinosa/phecomp/data/CRG/20120502_FDF_CRG/20120502_FDF_CRG/20120509_FDF_CRG_c12.mtb	1220	NA	WWFF	water	1	18700	1336572388	1	0.12	0.00461538461538461	9272	1
4	Food 2	Intake 4	12	29010	1336582698	/users/cn/jespinosa/phecomp/data/CRG/20120502_FDF_CRG/20120502_FDF_CRG/20120509_FDF_CRG_c12.mtb	2142	750	WWFF	food_fat	4	28998	1336582686	1	0.02	0.00166666666666667	9273	1
4	Drink 1	Intake 1	17	29022	1336582710	/users/cn/jespinosa/phecomp/data/CRG/20120502_FDF_CRG/20120502_FDF_CRG/20120509_FDF_CRG_c12.mtb	1221	NA	WWFF	water	1	29005	1336582693	1	0.06	0.00352941176470588	9274	1
4	Food 2	Intake 4	9	29769	1336583457	/users/cn/jespinosa/phecomp/data/CRG/20120502_FDF_CRG/20120502_FDF_CRG/20120509_FDF_CRG_c12.mtb	2144	2184	WWFF	food_fat	4	29760	1336583448	1	0.02	0.00222222222222222	9275	1
4	Food 2	Intake 4	31	31984	1336585672	/users/cn/jespinosa/phecomp/data/CRG/20120502_FDF_CRG/20120502_FDF_CRG/20120509_FDF_CRG_c12.mtb	2148	COLL	WWFF	food_fat	4	31953	1336585641	1	0.04	0.00129032258064516	9276	1
4	Food 1	Intake 3	12	31982	1336585670	/users/cn/jespinosa/phecomp/data/CRG/20120502_FDF_CRG/20120502_FDF_CRG/20120509_FDF_CRG_c12.mtb	1615	1949	WWFF	food_fat	3	31970	1336585658	1	0.0600000000000001	0.00500000000000001	9277	1
4	Drink 1	Intake 1	21	32711	1336586399	/users/cn/jespinosa/phecomp/data/CRG/20120502_FDF_CRG/20120502_FDF_CRG/20120509_FDF_CRG_c12.mtb	1222	NA	WWFF	water	1	32690	1336586378	1	0.06	0.00285714285714286	9278	1
4	Food 1	Intake 3	76	34007	1336587695	/users/cn/jespinosa/phecomp/data/CRG/20120502_FDF_CRG/20120502_FDF_CRG/20120509_FDF_CRG_c12.mtb	1617	14	WWFF	food_fat	3	33931	1336587619	1	0.04	0.000526315789473684	9279	1
4	Food 2	Intake 4	46	34067	1336587755	/users/cn/jespinosa/phecomp/data/CRG/20120502_FDF_CRG/20120502_FDF_CRG/20120509_FDF_CRG_c12.mtb	2151	50	WWFF	food_fat	4	34021	1336587709	1	0.02	0.000434782608695652	9280	1
4	Drink 1	Intake 1	44	34101	1336587789	/users/cn/jespinosa/phecomp/data/CRG/20120502_FDF_CRG/20120502_FDF_CRG/20120509_FDF_CRG_c12.mtb	1223	NA	WWFF	water	1	34057	1336587745	1	0.02	0.000454545454545455	9281	1
4	Food 2	Intake 4	43	34160	1336587848	/users/cn/jespinosa/phecomp/data/CRG/20120502_FDF_CRG/20120502_FDF_CRG/20120509_FDF_CRG_c12.mtb	2153	COLL	WWFF	food_fat	4	34117	1336587805	1	0.04	0.000930232558139535	9282	1
4	Food 1	Intake 3	12	34160	1336587848	/users/cn/jespinosa/phecomp/data/CRG/20120502_FDF_CRG/20120502_FDF_CRG/20120509_FDF_CRG_c12.mtb	1620	138	WWFF	food_fat	3	34148	1336587836	1	0.02	0.00166666666666667	9283	1
4	Food 2	Intake 4	47	34345	1336588033	/users/cn/jespinosa/phecomp/data/CRG/20120502_FDF_CRG/20120502_FDF_CRG/20120509_FDF_CRG_c12.mtb	2155	COLL	WWFF	food_fat	4	34298	1336587986	1	0.04	0.000851063829787234	9284	1
4	Food 1	Intake 3	43	34348	1336588036	/users/cn/jespinosa/phecomp/data/CRG/20120502_FDF_CRG/20120502_FDF_CRG/20120509_FDF_CRG_c12.mtb	1623	448	WWFF	food_fat	3	34305	1336587993	1	0.02	0.000465116279069767	9285	1
4	Food 1	Intake 3	98	34894	1336588582	/users/cn/jespinosa/phecomp/data/CRG/20120502_FDF_CRG/20120502_FDF_CRG/20120509_FDF_CRG_c12.mtb	1625	COLL	WWFF	food_fat	3	34796	1336588484	1	0.02	0.000204081632653061	9286	1
4	Food 2	Intake 4	52	34917	1336588605	/users/cn/jespinosa/phecomp/data/CRG/20120502_FDF_CRG/20120502_FDF_CRG/20120509_FDF_CRG_c12.mtb	2157	17	WWFF	food_fat	4	34865	1336588553	1	0.02	0.000384615384615385	9287	1
4	Food 2	Intake 4	24	34958	1336588646	/users/cn/jespinosa/phecomp/data/CRG/20120502_FDF_CRG/20120502_FDF_CRG/20120509_FDF_CRG_c12.mtb	2158	708	WWFF	food_fat	4	34934	1336588622	1	0.04	0.00166666666666667	9288	1
4	Food 1	Intake 3	16	35682	1336589370	/users/cn/jespinosa/phecomp/data/CRG/20120502_FDF_CRG/20120502_FDF_CRG/20120509_FDF_CRG_c12.mtb	1629	COLL	WWFF	food_fat	3	35666	1336589354	1	0.02	0.00125	9289	1
4	Food 2	Intake 4	9	35678	1336589366	/users/cn/jespinosa/phecomp/data/CRG/20120502_FDF_CRG/20120502_FDF_CRG/20120509_FDF_CRG_c12.mtb	2161	68	WWFF	food_fat	4	35669	1336589357	1	0.02	0.00222222222222222	9290	1
4	Food 1	Intake 3	73	35819	1336589507	/users/cn/jespinosa/phecomp/data/CRG/20120502_FDF_CRG/20120502_FDF_CRG/20120509_FDF_CRG_c12.mtb	1630	COLL	WWFF	food_fat	3	35746	1336589434	1	0.04	0.000547945205479452	9291	1
4	Food 2	Intake 4	129	35914	1336589602	/users/cn/jespinosa/phecomp/data/CRG/20120502_FDF_CRG/20120502_FDF_CRG/20120509_FDF_CRG_c12.mtb	2163	COLL	WWFF	food_fat	4	35785	1336589473	1	0.0399999999999998	0.000310077519379843	9292	1
4	Food 1	Intake 3	31	35933	1336589621	/users/cn/jespinosa/phecomp/data/CRG/20120502_FDF_CRG/20120502_FDF_CRG/20120509_FDF_CRG_c12.mtb	1631	COLL	WWFF	food_fat	3	35902	1336589590	1	0.02	0.000645161290322581	9293	1
4	Food 2	Intake 4	121	36043	1336589731	/users/cn/jespinosa/phecomp/data/CRG/20120502_FDF_CRG/20120502_FDF_CRG/20120509_FDF_CRG_c12.mtb	2164	126	WWFF	food_fat	4	35922	1336589610	1	0.16	0.00132231404958678	9294	1
4	Food 1	Intake 3	20	36189	1336589877	/users/cn/jespinosa/phecomp/data/CRG/20120502_FDF_CRG/20120502_FDF_CRG/20120509_FDF_CRG_c12.mtb	1633	11	WWFF	food_fat	3	36169	1336589857	1	0.0200000000000005	0.00100000000000002	9295	1
4	Food 1	Intake 3	39	36239	1336589927	/users/cn/jespinosa/phecomp/data/CRG/20120502_FDF_CRG/20120502_FDF_CRG/20120509_FDF_CRG_c12.mtb	1634	19	WWFF	food_fat	3	36200	1336589888	1	0.14	0.00358974358974359	9296	1
4	Food 1	Intake 3	31	36289	1336589977	/users/cn/jespinosa/phecomp/data/CRG/20120502_FDF_CRG/20120502_FDF_CRG/20120509_FDF_CRG_c12.mtb	1635	COLL	WWFF	food_fat	3	36258	1336589946	1	0.16	0.00516129032258065	9297	1
4	Food 2	Intake 4	18	36281	1336589969	/users/cn/jespinosa/phecomp/data/CRG/20120502_FDF_CRG/20120502_FDF_CRG/20120509_FDF_CRG_c12.mtb	2166	27	WWFF	food_fat	4	36263	1336589951	1	0.0599999999999998	0.00333333333333332	9298	1
4	Food 2	Intake 4	26	36334	1336590022	/users/cn/jespinosa/phecomp/data/CRG/20120502_FDF_CRG/20120502_FDF_CRG/20120509_FDF_CRG_c12.mtb	2167	COLL	WWFF	food_fat	4	36308	1336589996	1	0.0800000000000001	0.00307692307692308	9299	1
4	Food 1	Intake 3	23	36334	1336590022	/users/cn/jespinosa/phecomp/data/CRG/20120502_FDF_CRG/20120502_FDF_CRG/20120509_FDF_CRG_c12.mtb	1636	204	WWFF	food_fat	3	36311	1336589999	1	0.0600000000000001	0.00260869565217392	9300	1
4	Food 2	Intake 4	263	36801	1336590489	/users/cn/jespinosa/phecomp/data/CRG/20120502_FDF_CRG/20120502_FDF_CRG/20120509_FDF_CRG_c12.mtb	2168	COLL	WWFF	food_fat	4	36538	1336590226	1	0.18	0.000684410646387833	9301	1
4	Food 1	Intake 3	59	36598	1336590286	/users/cn/jespinosa/phecomp/data/CRG/20120502_FDF_CRG/20120502_FDF_CRG/20120509_FDF_CRG_c12.mtb	1637	160	WWFF	food_fat	3	36539	1336590227	1	0.02	0.000338983050847458	9302	1
4	Food 1	Intake 3	12	36770	1336590458	/users/cn/jespinosa/phecomp/data/CRG/20120502_FDF_CRG/20120502_FDF_CRG/20120509_FDF_CRG_c12.mtb	1641	437	WWFF	food_fat	3	36758	1336590446	1	0.04	0.00333333333333333	9303	1
4	Food 2	Intake 4	57	37264	1336590952	/users/cn/jespinosa/phecomp/data/CRG/20120502_FDF_CRG/20120502_FDF_CRG/20120509_FDF_CRG_c12.mtb	2170	COLL	WWFF	food_fat	4	37207	1336590895	1	0.02	0.000350877192982456	9304	1
4	Food 1	Intake 3	28	37262	1336590950	/users/cn/jespinosa/phecomp/data/CRG/20120502_FDF_CRG/20120502_FDF_CRG/20120509_FDF_CRG_c12.mtb	1642	765	WWFF	food_fat	3	37234	1336590922	1	0.02	0.000714285714285714	9305	1
4	Food 1	Intake 3	66	38093	1336591781	/users/cn/jespinosa/phecomp/data/CRG/20120502_FDF_CRG/20120502_FDF_CRG/20120509_FDF_CRG_c12.mtb	1643	29	WWFF	food_fat	3	38027	1336591715	1	0.0800000000000001	0.00121212121212121	9306	1
4	Food 1	Intake 3	41	38163	1336591851	/users/cn/jespinosa/phecomp/data/CRG/20120502_FDF_CRG/20120502_FDF_CRG/20120509_FDF_CRG_c12.mtb	1644	12	WWFF	food_fat	3	38122	1336591810	1	0.0399999999999996	0.000975609756097551	9307	1
4	Food 2	Intake 4	54	38229	1336591917	/users/cn/jespinosa/phecomp/data/CRG/20120502_FDF_CRG/20120502_FDF_CRG/20120509_FDF_CRG_c12.mtb	2173	39	WWFF	food_fat	4	38175	1336591863	1	0.0999999999999999	0.00185185185185185	9308	1
4	Food 2	Intake 4	238	38506	1336592194	/users/cn/jespinosa/phecomp/data/CRG/20120502_FDF_CRG/20120502_FDF_CRG/20120509_FDF_CRG_c12.mtb	2174	COLL	WWFF	food_fat	4	38268	1336591956	1	0.52	0.00218487394957983	9309	1
4	Food 1	Intake 3	211	38502	1336592190	/users/cn/jespinosa/phecomp/data/CRG/20120502_FDF_CRG/20120502_FDF_CRG/20120509_FDF_CRG_c12.mtb	1646	83	WWFF	food_fat	3	38291	1336591979	1	0.28	0.00132701421800948	9310	1
4	Food 1	Intake 3	36	38621	1336592309	/users/cn/jespinosa/phecomp/data/CRG/20120502_FDF_CRG/20120502_FDF_CRG/20120509_FDF_CRG_c12.mtb	1647	11	WWFF	food_fat	3	38585	1336592273	1	0.02	0.000555555555555556	9311	1
4	Food 2	Intake 4	192	38824	1336592512	/users/cn/jespinosa/phecomp/data/CRG/20120502_FDF_CRG/20120502_FDF_CRG/20120509_FDF_CRG_c12.mtb	2176	COLL	WWFF	food_fat	4	38632	1336592320	1	0.12	0.000625	9312	1
4	Food 1	Intake 3	163	38819	1336592507	/users/cn/jespinosa/phecomp/data/CRG/20120502_FDF_CRG/20120502_FDF_CRG/20120509_FDF_CRG_c12.mtb	1648	143	WWFF	food_fat	3	38656	1336592344	1	0.02	0.000122699386503067	9313	1
4	Food 2	Intake 4	506	39468	1336593156	/users/cn/jespinosa/phecomp/data/CRG/20120502_FDF_CRG/20120502_FDF_CRG/20120509_FDF_CRG_c12.mtb	2177	COLL	WWFF	food_fat	4	38962	1336592650	1	0.7	0.00138339920948617	9314	1
4	Food 1	Intake 3	482	39461	1336593149	/users/cn/jespinosa/phecomp/data/CRG/20120502_FDF_CRG/20120502_FDF_CRG/20120509_FDF_CRG_c12.mtb	1649	344	WWFF	food_fat	3	38979	1336592667	1	1	0.0020746887966805	9315	1
4	Food 2	Intake 4	28	39833	1336593521	/users/cn/jespinosa/phecomp/data/CRG/20120502_FDF_CRG/20120502_FDF_CRG/20120509_FDF_CRG_c12.mtb	2178	COLL	WWFF	food_fat	4	39805	1336593493	1	0.02	0.000714285714285714	9316	1
4	Food 1	Intake 3	18	39824	1336593512	/users/cn/jespinosa/phecomp/data/CRG/20120502_FDF_CRG/20120502_FDF_CRG/20120509_FDF_CRG_c12.mtb	1650	269	WWFF	food_fat	3	39806	1336593494	1	0.04	0.00222222222222222	9317	1
4	Drink 1	Intake 1	19	39832	1336593520	/users/cn/jespinosa/phecomp/data/CRG/20120502_FDF_CRG/20120502_FDF_CRG/20120509_FDF_CRG_c12.mtb	1227	NA	WWFF	water	1	39813	1336593501	1	0.08	0.00421052631578947	9318	1
4	Food 2	Intake 4	163	40256	1336593944	/users/cn/jespinosa/phecomp/data/CRG/20120502_FDF_CRG/20120502_FDF_CRG/20120509_FDF_CRG_c12.mtb	2180	419	WWFF	food_fat	4	40093	1336593781	1	0.1	0.000613496932515337	9319	1
4	Food 2	Intake 4	122	40797	1336594485	/users/cn/jespinosa/phecomp/data/CRG/20120502_FDF_CRG/20120502_FDF_CRG/20120509_FDF_CRG_c12.mtb	2181	70	WWFF	food_fat	4	40675	1336594363	1	0.04	0.000327868852459016	9320	1
4	Food 2	Intake 4	101	40968	1336594656	/users/cn/jespinosa/phecomp/data/CRG/20120502_FDF_CRG/20120502_FDF_CRG/20120509_FDF_CRG_c12.mtb	2182	113	WWFF	food_fat	4	40867	1336594555	1	0.02	0.000198019801980198	9321	1
4	Food 2	Intake 4	20	41101	1336594789	/users/cn/jespinosa/phecomp/data/CRG/20120502_FDF_CRG/20120502_FDF_CRG/20120509_FDF_CRG_c12.mtb	2183	30	WWFF	food_fat	4	41081	1336594769	1	0.02	0.001	9322	1
4	Food 2	Intake 4	224	41355	1336595043	/users/cn/jespinosa/phecomp/data/CRG/20120502_FDF_CRG/20120502_FDF_CRG/20120509_FDF_CRG_c12.mtb	2184	400	WWFF	food_fat	4	41131	1336594819	1	0.14	0.000625	9323	1
4	Food 1	Intake 3	21	41776	1336595464	/users/cn/jespinosa/phecomp/data/CRG/20120502_FDF_CRG/20120502_FDF_CRG/20120509_FDF_CRG_c12.mtb	1658	95	WWFF	food_fat	3	41755	1336595443	1	0.04	0.0019047619047619	9324	1
4	Food 2	Intake 4	208	42079	1336595767	/users/cn/jespinosa/phecomp/data/CRG/20120502_FDF_CRG/20120502_FDF_CRG/20120509_FDF_CRG_c12.mtb	2186	COLL	WWFF	food_fat	4	41871	1336595559	1	0.0600000000000001	0.000288461538461539	9325	1
4	Food 1	Intake 3	198	42075	1336595763	/users/cn/jespinosa/phecomp/data/CRG/20120502_FDF_CRG/20120502_FDF_CRG/20120509_FDF_CRG_c12.mtb	1660	77	WWFF	food_fat	3	41877	1336595565	1	0.0399999999999991	0.000202020202020197	9326	1
4	Food 2	Intake 4	207	42359	1336596047	/users/cn/jespinosa/phecomp/data/CRG/20120502_FDF_CRG/20120502_FDF_CRG/20120509_FDF_CRG_c12.mtb	2187	COLL	WWFF	food_fat	4	42152	1336595840	1	0.28	0.00135265700483092	9327	1
4	Food 1	Intake 3	44	42198	1336595886	/users/cn/jespinosa/phecomp/data/CRG/20120502_FDF_CRG/20120502_FDF_CRG/20120509_FDF_CRG_c12.mtb	1661	468	WWFF	food_fat	3	42154	1336595842	1	0.0200000000000005	0.000454545454545466	9328	1
4	Drink 1	Intake 1	22	42215	1336595903	/users/cn/jespinosa/phecomp/data/CRG/20120502_FDF_CRG/20120502_FDF_CRG/20120509_FDF_CRG_c12.mtb	1231	NA	WWFF	water	1	42193	1336595881	1	0.08	0.00363636363636364	9329	1
4	Food 2	Intake 4	13	42679	1336596367	/users/cn/jespinosa/phecomp/data/CRG/20120502_FDF_CRG/20120502_FDF_CRG/20120509_FDF_CRG_c12.mtb	2188	424	WWFF	food_fat	4	42666	1336596354	1	0.02	0.00153846153846154	9330	1
4	Food 2	Intake 4	117	43220	1336596908	/users/cn/jespinosa/phecomp/data/CRG/20120502_FDF_CRG/20120502_FDF_CRG/20120509_FDF_CRG_c12.mtb	2192	COLL	WWFF	food_fat	4	43103	1336596791	1	0.22	0.00188034188034188	9331	1
4	Food 1	Intake 3	40	43145	1336596833	/users/cn/jespinosa/phecomp/data/CRG/20120502_FDF_CRG/20120502_FDF_CRG/20120509_FDF_CRG_c12.mtb	1664	51	WWFF	food_fat	3	43105	1336596793	1	0.0800000000000001	0.002	9332	1
4	Food 1	Intake 3	24	43220	1336596908	/users/cn/jespinosa/phecomp/data/CRG/20120502_FDF_CRG/20120502_FDF_CRG/20120509_FDF_CRG_c12.mtb	1666	151	WWFF	food_fat	3	43196	1336596884	1	0.12	0.005	9333	1
4	Food 2	Intake 4	15	43386	1336597074	/users/cn/jespinosa/phecomp/data/CRG/20120502_FDF_CRG/20120502_FDF_CRG/20120509_FDF_CRG_c12.mtb	2194	868	WWFF	food_fat	4	43371	1336597059	1	0.04	0.00266666666666667	9334	1
4	Drink 1	Intake 1	20	44256	1336597944	/users/cn/jespinosa/phecomp/data/CRG/20120502_FDF_CRG/20120502_FDF_CRG/20120509_FDF_CRG_c12.mtb	1232	NA	WWFF	water	1	44236	1336597924	1	0.1	0.005	9335	1
4	Food 2	Intake 4	23	44277	1336597965	/users/cn/jespinosa/phecomp/data/CRG/20120502_FDF_CRG/20120502_FDF_CRG/20120509_FDF_CRG_c12.mtb	2196	384	WWFF	food_fat	4	44254	1336597942	1	0.02	0.000869565217391304	9336	1
4	Food 2	Intake 4	111	44772	1336598460	/users/cn/jespinosa/phecomp/data/CRG/20120502_FDF_CRG/20120502_FDF_CRG/20120509_FDF_CRG_c12.mtb	2198	COLL	WWFF	food_fat	4	44661	1336598349	1	0.0800000000000001	0.000720720720720722	9337	1
4	Food 1	Intake 3	78	44759	1336598447	/users/cn/jespinosa/phecomp/data/CRG/20120502_FDF_CRG/20120502_FDF_CRG/20120509_FDF_CRG_c12.mtb	1669	611	WWFF	food_fat	3	44681	1336598369	1	0.0200000000000005	0.000256410256410263	9338	1
4	Food 2	Intake 4	226	45596	1336599284	/users/cn/jespinosa/phecomp/data/CRG/20120502_FDF_CRG/20120502_FDF_CRG/20120509_FDF_CRG_c12.mtb	2201	60	WWFF	food_fat	4	45370	1336599058	1	0.0800000000000001	0.000353982300884956	9339	1
4	Drink 2	Intake 2	31	45468	1336599156	/users/cn/jespinosa/phecomp/data/CRG/20120502_FDF_CRG/20120502_FDF_CRG/20120509_FDF_CRG_c12.mtb	1167	NA	WWFF	water	2	45437	1336599125	1	0.04	0.00129032258064516	9340	1
4	Food 1	Intake 3	187	45843	1336599531	/users/cn/jespinosa/phecomp/data/CRG/20120502_FDF_CRG/20120502_FDF_CRG/20120509_FDF_CRG_c12.mtb	1672	64	WWFF	food_fat	3	45656	1336599344	1	0.159999999999999	0.000855614973262027	9341	1
4	Food 2	Intake 4	414	46321	1336600009	/users/cn/jespinosa/phecomp/data/CRG/20120502_FDF_CRG/20120502_FDF_CRG/20120509_FDF_CRG_c12.mtb	2203	COLL	WWFF	food_fat	4	45907	1336599595	1	0.16	0.000386473429951691	9342	1
4	Food 1	Intake 3	410	46318	1336600006	/users/cn/jespinosa/phecomp/data/CRG/20120502_FDF_CRG/20120502_FDF_CRG/20120509_FDF_CRG_c12.mtb	1673	64	WWFF	food_fat	3	45908	1336599596	1	0.54	0.00131707317073171	9343	1
4	Food 2	Intake 4	110	46492	1336600180	/users/cn/jespinosa/phecomp/data/CRG/20120502_FDF_CRG/20120502_FDF_CRG/20120509_FDF_CRG_c12.mtb	2204	COLL	WWFF	food_fat	4	46382	1336600070	1	0.0200000000000005	0.000181818181818186	9344	1
4	Food 1	Intake 3	84	46488	1336600176	/users/cn/jespinosa/phecomp/data/CRG/20120502_FDF_CRG/20120502_FDF_CRG/20120509_FDF_CRG_c12.mtb	1674	33	WWFF	food_fat	3	46404	1336600092	1	0.12	0.00142857142857143	9345	1
4	Food 1	Intake 3	62	46583	1336600271	/users/cn/jespinosa/phecomp/data/CRG/20120502_FDF_CRG/20120502_FDF_CRG/20120509_FDF_CRG_c12.mtb	1675	COLL	WWFF	food_fat	3	46521	1336600209	1	0.12	0.00193548387096774	9346	1
4	Food 2	Intake 4	68	46590	1336600278	/users/cn/jespinosa/phecomp/data/CRG/20120502_FDF_CRG/20120502_FDF_CRG/20120509_FDF_CRG_c12.mtb	2205	7	WWFF	food_fat	4	46522	1336600210	1	0.0799999999999996	0.00117647058823529	9347	1
4	Drink 1	Intake 1	31	46613	1336600301	/users/cn/jespinosa/phecomp/data/CRG/20120502_FDF_CRG/20120502_FDF_CRG/20120509_FDF_CRG_c12.mtb	1234	NA	WWFF	water	1	46582	1336600270	1	0.12	0.00387096774193548	9348	1
4	Food 2	Intake 4	369	46966	1336600654	/users/cn/jespinosa/phecomp/data/CRG/20120502_FDF_CRG/20120502_FDF_CRG/20120509_FDF_CRG_c12.mtb	2206	COLL	WWFF	food_fat	4	46597	1336600285	1	0.16	0.00043360433604336	9349	1
4	Food 1	Intake 3	98	46713	1336600401	/users/cn/jespinosa/phecomp/data/CRG/20120502_FDF_CRG/20120502_FDF_CRG/20120509_FDF_CRG_c12.mtb	1676	9	WWFF	food_fat	3	46615	1336600303	1	0.58	0.00591836734693878	9350	1
4	Food 1	Intake 3	241	46963	1336600651	/users/cn/jespinosa/phecomp/data/CRG/20120502_FDF_CRG/20120502_FDF_CRG/20120509_FDF_CRG_c12.mtb	1677	106	WWFF	food_fat	3	46722	1336600410	1	0.2	0.000829875518672199	9351	1
4	Food 2	Intake 4	18	47087	1336600775	/users/cn/jespinosa/phecomp/data/CRG/20120502_FDF_CRG/20120502_FDF_CRG/20120509_FDF_CRG_c12.mtb	2208	184	WWFF	food_fat	4	47069	1336600757	1	0.1	0.00555555555555556	9352	1
4	Food 2	Intake 4	184	47455	1336601143	/users/cn/jespinosa/phecomp/data/CRG/20120502_FDF_CRG/20120502_FDF_CRG/20120509_FDF_CRG_c12.mtb	2210	COLL	WWFF	food_fat	4	47271	1336600959	1	0.12	0.000652173913043478	9353	1
4	Food 1	Intake 3	169	47453	1336601141	/users/cn/jespinosa/phecomp/data/CRG/20120502_FDF_CRG/20120502_FDF_CRG/20120509_FDF_CRG_c12.mtb	1680	154	WWFF	food_fat	3	47284	1336600972	1	0.0599999999999996	0.000355029585798814	9354	1
4	Drink 1	Intake 1	36	47560	1336601248	/users/cn/jespinosa/phecomp/data/CRG/20120502_FDF_CRG/20120502_FDF_CRG/20120509_FDF_CRG_c12.mtb	1236	NA	WWFF	water	1	47524	1336601212	1	0.02	0.000555555555555556	9355	1
4	Food 1	Intake 3	112	47719	1336601407	/users/cn/jespinosa/phecomp/data/CRG/20120502_FDF_CRG/20120502_FDF_CRG/20120509_FDF_CRG_c12.mtb	1682	COLL	WWFF	food_fat	3	47607	1336601295	1	0.34	0.00303571428571429	9356	1
4	Food 2	Intake 4	119	47727	1336601415	/users/cn/jespinosa/phecomp/data/CRG/20120502_FDF_CRG/20120502_FDF_CRG/20120509_FDF_CRG_c12.mtb	2212	12	WWFF	food_fat	4	47608	1336601296	1	0.0800000000000001	0.000672268907563026	9357	1
4	Food 1	Intake 3	196	47935	1336601623	/users/cn/jespinosa/phecomp/data/CRG/20120502_FDF_CRG/20120502_FDF_CRG/20120509_FDF_CRG_c12.mtb	1683	COLL	WWFF	food_fat	3	47739	1336601427	1	0.94	0.00479591836734694	9358	1
4	Food 2	Intake 4	198	47938	1336601626	/users/cn/jespinosa/phecomp/data/CRG/20120502_FDF_CRG/20120502_FDF_CRG/20120509_FDF_CRG_c12.mtb	2213	290	WWFF	food_fat	4	47740	1336601428	1	0.16	0.000808080808080808	9359	1
4	Food 1	Intake 3	52	48280	1336601968	/users/cn/jespinosa/phecomp/data/CRG/20120502_FDF_CRG/20120502_FDF_CRG/20120509_FDF_CRG_c12.mtb	1684	COLL	WWFF	food_fat	3	48228	1336601916	1	0.140000000000001	0.00269230769230771	9360	1
4	Food 2	Intake 4	271	48500	1336602188	/users/cn/jespinosa/phecomp/data/CRG/20120502_FDF_CRG/20120502_FDF_CRG/20120509_FDF_CRG_c12.mtb	2214	666	WWFF	food_fat	4	48229	1336601917	1	0.0800000000000001	0.000295202952029521	9361	1
4	Drink 2	Intake 2	14	48335	1336602023	/users/cn/jespinosa/phecomp/data/CRG/20120502_FDF_CRG/20120502_FDF_CRG/20120509_FDF_CRG_c12.mtb	1174	NA	WWFF	water	2	48321	1336602009	1	0.06	0.00428571428571429	9362	1
4	Food 2	Intake 4	104	49270	1336602958	/users/cn/jespinosa/phecomp/data/CRG/20120502_FDF_CRG/20120502_FDF_CRG/20120509_FDF_CRG_c12.mtb	2218	27	WWFF	food_fat	4	49166	1336602854	1	0.0800000000000001	0.00076923076923077	9363	1
4	Food 2	Intake 4	81	49378	1336603066	/users/cn/jespinosa/phecomp/data/CRG/20120502_FDF_CRG/20120502_FDF_CRG/20120509_FDF_CRG_c12.mtb	2219	13	WWFF	food_fat	4	49297	1336602985	1	0.12	0.00148148148148148	9364	1
4	Food 1	Intake 3	62	49453	1336603141	/users/cn/jespinosa/phecomp/data/CRG/20120502_FDF_CRG/20120502_FDF_CRG/20120509_FDF_CRG_c12.mtb	1688	COLL	WWFF	food_fat	3	49391	1336603079	1	0.100000000000001	0.00161290322580647	9365	1
4	Food 2	Intake 4	63	49455	1336603143	/users/cn/jespinosa/phecomp/data/CRG/20120502_FDF_CRG/20120502_FDF_CRG/20120509_FDF_CRG_c12.mtb	2220	4	WWFF	food_fat	4	49392	1336603080	1	0.04	0.000634920634920635	9366	1
4	Food 1	Intake 3	106	49565	1336603253	/users/cn/jespinosa/phecomp/data/CRG/20120502_FDF_CRG/20120502_FDF_CRG/20120509_FDF_CRG_c12.mtb	1689	COLL	WWFF	food_fat	3	49459	1336603147	1	0.32	0.0030188679245283	9367	1
4	Food 2	Intake 4	330	49790	1336603478	/users/cn/jespinosa/phecomp/data/CRG/20120502_FDF_CRG/20120502_FDF_CRG/20120509_FDF_CRG_c12.mtb	2221	COLL	WWFF	food_fat	4	49460	1336603148	1	0.14	0.000424242424242424	9368	1
4	Food 1	Intake 3	199	49788	1336603476	/users/cn/jespinosa/phecomp/data/CRG/20120502_FDF_CRG/20120502_FDF_CRG/20120509_FDF_CRG_c12.mtb	1690	699	WWFF	food_fat	3	49589	1336603277	1	0.119999999999999	0.000603015075376879	9369	1
4	Drink 1	Intake 1	20	49935	1336603623	/users/cn/jespinosa/phecomp/data/CRG/20120502_FDF_CRG/20120502_FDF_CRG/20120509_FDF_CRG_c12.mtb	1238	NA	WWFF	water	1	49915	1336603603	1	0.08	0.004	9370	1
4	Drink 2	Intake 2	24	49980	1336603668	/users/cn/jespinosa/phecomp/data/CRG/20120502_FDF_CRG/20120502_FDF_CRG/20120509_FDF_CRG_c12.mtb	1175	NA	WWFF	water	2	49956	1336603644	1	0.02	0.000833333333333333	9371	1
4	Food 2	Intake 4	450	50937	1336604625	/users/cn/jespinosa/phecomp/data/CRG/20120502_FDF_CRG/20120502_FDF_CRG/20120509_FDF_CRG_c12.mtb	2226	COLL	WWFF	food_fat	4	50487	1336604175	1	0.0999999999999996	0.000222222222222221	9372	1
4	Food 1	Intake 3	110	50658	1336604346	/users/cn/jespinosa/phecomp/data/CRG/20120502_FDF_CRG/20120502_FDF_CRG/20120509_FDF_CRG_c12.mtb	1695	294	WWFF	food_fat	3	50548	1336604236	1	0.0399999999999991	0.000363636363636355	9373	1
4	Food 1	Intake 3	250	51202	1336604890	/users/cn/jespinosa/phecomp/data/CRG/20120502_FDF_CRG/20120502_FDF_CRG/20120509_FDF_CRG_c12.mtb	1699	9	WWFF	food_fat	3	50952	1336604640	1	0.0400000000000009	0.000160000000000004	9374	1
4	Food 2	Intake 4	498	51709	1336605397	/users/cn/jespinosa/phecomp/data/CRG/20120502_FDF_CRG/20120502_FDF_CRG/20120509_FDF_CRG_c12.mtb	2228	38	WWFF	food_fat	4	51211	1336604899	1	0.12	0.000240963855421687	9375	1
4	Food 2	Intake 4	144	51891	1336605579	/users/cn/jespinosa/phecomp/data/CRG/20120502_FDF_CRG/20120502_FDF_CRG/20120509_FDF_CRG_c12.mtb	2229	4	WWFF	food_fat	4	51747	1336605435	1	0.0399999999999991	0.000277777777777772	9376	1
4	Drink 2	Intake 2	44	51884	1336605572	/users/cn/jespinosa/phecomp/data/CRG/20120502_FDF_CRG/20120502_FDF_CRG/20120509_FDF_CRG_c12.mtb	1177	NA	WWFF	water	2	51840	1336605528	1	0.12	0.00272727272727273	9377	1
4	Food 2	Intake 4	56	51951	1336605639	/users/cn/jespinosa/phecomp/data/CRG/20120502_FDF_CRG/20120502_FDF_CRG/20120509_FDF_CRG_c12.mtb	2230	COLL	WWFF	food_fat	4	51895	1336605583	1	0.0200000000000005	0.000357142857142866	9378	1
4	Food 1	Intake 3	54	51950	1336605638	/users/cn/jespinosa/phecomp/data/CRG/20120502_FDF_CRG/20120502_FDF_CRG/20120509_FDF_CRG_c12.mtb	1704	470	WWFF	food_fat	3	51896	1336605584	1	0.0200000000000014	0.000370370370370396	9379	1
4	Food 2	Intake 4	246	52666	1336606354	/users/cn/jespinosa/phecomp/data/CRG/20120502_FDF_CRG/20120502_FDF_CRG/20120509_FDF_CRG_c12.mtb	2233	COLL	WWFF	food_fat	4	52420	1336606108	1	0.16	0.000650406504065041	9380	1
4	Food 1	Intake 3	242	52663	1336606351	/users/cn/jespinosa/phecomp/data/CRG/20120502_FDF_CRG/20120502_FDF_CRG/20120509_FDF_CRG_c12.mtb	1709	9	WWFF	food_fat	3	52421	1336606109	1	0.180000000000001	0.000743801652892566	9381	1
4	Food 2	Intake 4	377	53049	1336606737	/users/cn/jespinosa/phecomp/data/CRG/20120502_FDF_CRG/20120502_FDF_CRG/20120509_FDF_CRG_c12.mtb	2234	431	WWFF	food_fat	4	52672	1336606360	1	0.04	0.000106100795755968	9382	1
4	Food 2	Intake 4	13	53493	1336607181	/users/cn/jespinosa/phecomp/data/CRG/20120502_FDF_CRG/20120502_FDF_CRG/20120509_FDF_CRG_c12.mtb	2237	2265	WWFF	food_fat	4	53480	1336607168	1	0.04	0.00307692307692308	9383	1
4	Drink 1	Intake 1	13	54611	1336608299	/users/cn/jespinosa/phecomp/data/CRG/20120502_FDF_CRG/20120502_FDF_CRG/20120509_FDF_CRG_c12.mtb	1240	NA	WWFF	water	1	54598	1336608286	1	0.08	0.00615384615384615	9384	1
4	Food 1	Intake 3	14	55772	1336609460	/users/cn/jespinosa/phecomp/data/CRG/20120502_FDF_CRG/20120502_FDF_CRG/20120509_FDF_CRG_c12.mtb	1716	27	WWFF	food_fat	3	55758	1336609446	1	0.0999999999999996	0.00714285714285711	9385	1
4	Food 2	Intake 4	52	55851	1336609539	/users/cn/jespinosa/phecomp/data/CRG/20120502_FDF_CRG/20120502_FDF_CRG/20120509_FDF_CRG_c12.mtb	2244	155	WWFF	food_fat	4	55799	1336609487	1	0.18	0.00346153846153846	9386	1
4	Food 2	Intake 4	90	56096	1336609784	/users/cn/jespinosa/phecomp/data/CRG/20120502_FDF_CRG/20120502_FDF_CRG/20120509_FDF_CRG_c12.mtb	2246	528	WWFF	food_fat	4	56006	1336609694	1	0.180000000000001	0.00200000000000001	9387	1
4	Drink 1	Intake 1	13	56362	1336610050	/users/cn/jespinosa/phecomp/data/CRG/20120502_FDF_CRG/20120502_FDF_CRG/20120509_FDF_CRG_c12.mtb	1241	NA	WWFF	water	1	56349	1336610037	1	0.04	0.00307692307692308	9388	1
4	Food 2	Intake 4	17	56641	1336610329	/users/cn/jespinosa/phecomp/data/CRG/20120502_FDF_CRG/20120502_FDF_CRG/20120509_FDF_CRG_c12.mtb	2248	1096	WWFF	food_fat	4	56624	1336610312	1	0.04	0.00235294117647059	9389	1
4	Drink 1	Intake 1	13	57453	1336611141	/users/cn/jespinosa/phecomp/data/CRG/20120502_FDF_CRG/20120502_FDF_CRG/20120509_FDF_CRG_c12.mtb	1242	NA	WWFF	water	1	57440	1336611128	1	0.02	0.00153846153846154	9390	1
4	Food 1	Intake 3	136	57873	1336611561	/users/cn/jespinosa/phecomp/data/CRG/20120502_FDF_CRG/20120502_FDF_CRG/20120509_FDF_CRG_c12.mtb	1723	COLL	WWFF	food_fat	3	57737	1336611425	1	0.0200000000000014	0.000147058823529422	9391	1
4	Food 2	Intake 4	137	57875	1336611563	/users/cn/jespinosa/phecomp/data/CRG/20120502_FDF_CRG/20120502_FDF_CRG/20120509_FDF_CRG_c12.mtb	2253	143	WWFF	food_fat	4	57738	1336611426	1	0.100000000000001	0.000729927007299277	9392	1
4	Food 1	Intake 3	118	58136	1336611824	/users/cn/jespinosa/phecomp/data/CRG/20120502_FDF_CRG/20120502_FDF_CRG/20120509_FDF_CRG_c12.mtb	1725	257	WWFF	food_fat	3	58018	1336611706	1	0.0999999999999996	0.000847457627118641	9393	1
4	Food 2	Intake 4	150	58543	1336612231	/users/cn/jespinosa/phecomp/data/CRG/20120502_FDF_CRG/20120502_FDF_CRG/20120509_FDF_CRG_c12.mtb	2257	22	WWFF	food_fat	4	58393	1336612081	1	0.24	0.0016	9394	1
4	Food 1	Intake 3	369	58934	1336612622	/users/cn/jespinosa/phecomp/data/CRG/20120502_FDF_CRG/20120502_FDF_CRG/20120509_FDF_CRG_c12.mtb	1728	148	WWFF	food_fat	3	58565	1336612253	1	0.100000000000001	0.000271002710027103	9395	1
4	Drink 1	Intake 1	13	58878	1336612566	/users/cn/jespinosa/phecomp/data/CRG/20120502_FDF_CRG/20120502_FDF_CRG/20120509_FDF_CRG_c12.mtb	1243	NA	WWFF	water	1	58865	1336612553	1	0.02	0.00153846153846154	9396	1
4	Food 2	Intake 4	11	59093	1336612781	/users/cn/jespinosa/phecomp/data/CRG/20120502_FDF_CRG/20120502_FDF_CRG/20120509_FDF_CRG_c12.mtb	2261	10	WWFF	food_fat	4	59082	1336612770	1	0.0600000000000005	0.0054545454545455	9397	1
4	Drink 2	Intake 2	38	59122	1336612810	/users/cn/jespinosa/phecomp/data/CRG/20120502_FDF_CRG/20120502_FDF_CRG/20120509_FDF_CRG_c12.mtb	1183	NA	WWFF	water	2	59084	1336612772	1	0.08	0.00210526315789474	9398	1
4	Food 2	Intake 4	256	59359	1336613047	/users/cn/jespinosa/phecomp/data/CRG/20120502_FDF_CRG/20120502_FDF_CRG/20120509_FDF_CRG_c12.mtb	2262	108	WWFF	food_fat	4	59103	1336612791	1	0.26	0.001015625	9399	1
4	Drink 2	Intake 2	38	59212	1336612900	/users/cn/jespinosa/phecomp/data/CRG/20120502_FDF_CRG/20120502_FDF_CRG/20120509_FDF_CRG_c12.mtb	1184	NA	WWFF	water	2	59174	1336612862	1	0.02	0.000526315789473684	9400	1
4	Drink 2	Intake 2	25	59251	1336612939	/users/cn/jespinosa/phecomp/data/CRG/20120502_FDF_CRG/20120502_FDF_CRG/20120509_FDF_CRG_c12.mtb	1185	NA	WWFF	water	2	59226	1336612914	1	0.02	0.0008	9401	1
4	Food 1	Intake 3	43	59510	1336613198	/users/cn/jespinosa/phecomp/data/CRG/20120502_FDF_CRG/20120502_FDF_CRG/20120509_FDF_CRG_c12.mtb	1733	353	WWFF	food_fat	3	59467	1336613155	1	0.0399999999999991	0.000930232558139514	9402	1
4	Food 2	Intake 4	615	60478	1336614166	/users/cn/jespinosa/phecomp/data/CRG/20120502_FDF_CRG/20120502_FDF_CRG/20120509_FDF_CRG_c12.mtb	2264	COLL	WWFF	food_fat	4	59863	1336613551	1	0.0999999999999996	0.00016260162601626	9403	1
4	Food 1	Intake 3	354	60481	1336614169	/users/cn/jespinosa/phecomp/data/CRG/20120502_FDF_CRG/20120502_FDF_CRG/20120509_FDF_CRG_c12.mtb	1736	24	WWFF	food_fat	3	60127	1336613815	1	0.239999999999998	0.00067796610169491	9404	1
4	Food 2	Intake 4	364	60869	1336614557	/users/cn/jespinosa/phecomp/data/CRG/20120502_FDF_CRG/20120502_FDF_CRG/20120509_FDF_CRG_c12.mtb	2265	COLL	WWFF	food_fat	4	60505	1336614193	1	0.3	0.000824175824175824	9405	1
4	Food 1	Intake 3	353	60866	1336614554	/users/cn/jespinosa/phecomp/data/CRG/20120502_FDF_CRG/20120502_FDF_CRG/20120509_FDF_CRG_c12.mtb	1737	77	WWFF	food_fat	3	60513	1336614201	1	0.9	0.00254957507082153	9406	1
4	Food 2	Intake 4	37	60980	1336614668	/users/cn/jespinosa/phecomp/data/CRG/20120502_FDF_CRG/20120502_FDF_CRG/20120509_FDF_CRG_c12.mtb	2266	COLL	WWFF	food_fat	4	60943	1336614631	1	0.12	0.00324324324324324	9407	1
4	Food 1	Intake 3	13	60962	1336614650	/users/cn/jespinosa/phecomp/data/CRG/20120502_FDF_CRG/20120502_FDF_CRG/20120509_FDF_CRG_c12.mtb	1738	426	WWFF	food_fat	3	60949	1336614637	1	0.0400000000000009	0.00307692307692315	9408	1
4	Drink 1	Intake 1	23	60974	1336614662	/users/cn/jespinosa/phecomp/data/CRG/20120502_FDF_CRG/20120502_FDF_CRG/20120509_FDF_CRG_c12.mtb	1246	NA	WWFF	water	1	60951	1336614639	1	0.1	0.00434782608695652	9409	1
4	Food 2	Intake 4	15	61403	1336615091	/users/cn/jespinosa/phecomp/data/CRG/20120502_FDF_CRG/20120502_FDF_CRG/20120509_FDF_CRG_c12.mtb	2267	519	WWFF	food_fat	4	61388	1336615076	1	0.0200000000000005	0.00133333333333337	9410	1
4	Food 2	Intake 4	14	61936	1336615624	/users/cn/jespinosa/phecomp/data/CRG/20120502_FDF_CRG/20120502_FDF_CRG/20120509_FDF_CRG_c12.mtb	2270	2073	WWFF	food_fat	4	61922	1336615610	1	0.0200000000000005	0.00142857142857146	9411	1
4	Drink 1	Intake 1	13	63042	1336616730	/users/cn/jespinosa/phecomp/data/CRG/20120502_FDF_CRG/20120502_FDF_CRG/20120509_FDF_CRG_c12.mtb	1247	NA	WWFF	water	1	63029	1336616717	1	0.0800000000000001	0.00615384615384616	9412	1
4	Food 2	Intake 4	28	64037	1336617725	/users/cn/jespinosa/phecomp/data/CRG/20120502_FDF_CRG/20120502_FDF_CRG/20120509_FDF_CRG_c12.mtb	2274	439	WWFF	food_fat	4	64009	1336617697	1	0.0200000000000005	0.000714285714285732	9413	1
4	Food 2	Intake 4	24	64500	1336618188	/users/cn/jespinosa/phecomp/data/CRG/20120502_FDF_CRG/20120502_FDF_CRG/20120509_FDF_CRG_c12.mtb	2276	596	WWFF	food_fat	4	64476	1336618164	1	0.0200000000000005	0.000833333333333354	9414	1
4	Food 2	Intake 4	38	65134	1336618822	/users/cn/jespinosa/phecomp/data/CRG/20120502_FDF_CRG/20120502_FDF_CRG/20120509_FDF_CRG_c12.mtb	2279	486	WWFF	food_fat	4	65096	1336618784	1	0.0800000000000001	0.00210526315789474	9415	1
4	Food 2	Intake 4	12	65632	1336619320	/users/cn/jespinosa/phecomp/data/CRG/20120502_FDF_CRG/20120502_FDF_CRG/20120509_FDF_CRG_c12.mtb	2282	28	WWFF	food_fat	4	65620	1336619308	1	0.0600000000000005	0.00500000000000004	9416	1
4	Food 2	Intake 4	223	65883	1336619571	/users/cn/jespinosa/phecomp/data/CRG/20120502_FDF_CRG/20120502_FDF_CRG/20120509_FDF_CRG_c12.mtb	2283	COLL	WWFF	food_fat	4	65660	1336619348	1	0.12	0.000538116591928251	9417	1
4	Food 1	Intake 3	123	65785	1336619473	/users/cn/jespinosa/phecomp/data/CRG/20120502_FDF_CRG/20120502_FDF_CRG/20120509_FDF_CRG_c12.mtb	1742	122	WWFF	food_fat	3	65662	1336619350	1	0.16	0.00130081300813008	9418	1
4	Food 2	Intake 4	150	66057	1336619745	/users/cn/jespinosa/phecomp/data/CRG/20120502_FDF_CRG/20120502_FDF_CRG/20120509_FDF_CRG_c12.mtb	2284	969	WWFF	food_fat	4	65907	1336619595	1	0.04	0.000266666666666667	9419	1
4	Food 2	Intake 4	17	67043	1336620731	/users/cn/jespinosa/phecomp/data/CRG/20120502_FDF_CRG/20120502_FDF_CRG/20120509_FDF_CRG_c12.mtb	2286	503	WWFF	food_fat	4	67026	1336620714	1	0.0200000000000005	0.00117647058823532	9420	1
4	Food 2	Intake 4	47	67593	1336621281	/users/cn/jespinosa/phecomp/data/CRG/20120502_FDF_CRG/20120502_FDF_CRG/20120509_FDF_CRG_c12.mtb	2287	1585	WWFF	food_fat	4	67546	1336621234	1	0.04	0.000851063829787234	9421	1
4	Food 2	Intake 4	44	69222	1336622910	/users/cn/jespinosa/phecomp/data/CRG/20120502_FDF_CRG/20120502_FDF_CRG/20120509_FDF_CRG_c12.mtb	2297	257	WWFF	food_fat	4	69178	1336622866	1	0.0600000000000005	0.00136363636363638	9422	1
4	Food 2	Intake 4	13	69492	1336623180	/users/cn/jespinosa/phecomp/data/CRG/20120502_FDF_CRG/20120502_FDF_CRG/20120509_FDF_CRG_c12.mtb	2298	292	WWFF	food_fat	4	69479	1336623167	1	0.04	0.00307692307692308	9423	1
4	Food 2	Intake 4	171	69955	1336623643	/users/cn/jespinosa/phecomp/data/CRG/20120502_FDF_CRG/20120502_FDF_CRG/20120509_FDF_CRG_c12.mtb	2301	COLL	WWFF	food_fat	4	69784	1336623472	1	0.0800000000000001	0.000467836257309942	9424	1
4	Food 1	Intake 3	73	69953	1336623641	/users/cn/jespinosa/phecomp/data/CRG/20120502_FDF_CRG/20120502_FDF_CRG/20120509_FDF_CRG_c12.mtb	1754	285	WWFF	food_fat	3	69880	1336623568	1	0.0400000000000009	0.000547945205479464	9425	1
4	Drink 2	Intake 2	31	70249	1336623937	/users/cn/jespinosa/phecomp/data/CRG/20120502_FDF_CRG/20120502_FDF_CRG/20120509_FDF_CRG_c12.mtb	1188	NA	WWFF	water	2	70218	1336623906	1	0.08	0.00258064516129032	9426	1
4	Food 2	Intake 4	13	70251	1336623939	/users/cn/jespinosa/phecomp/data/CRG/20120502_FDF_CRG/20120502_FDF_CRG/20120509_FDF_CRG_c12.mtb	2304	183	WWFF	food_fat	4	70238	1336623926	1	0.12	0.00923076923076923	9427	1
4	Food 2	Intake 4	12	70446	1336624134	/users/cn/jespinosa/phecomp/data/CRG/20120502_FDF_CRG/20120502_FDF_CRG/20120509_FDF_CRG_c12.mtb	2305	802	WWFF	food_fat	4	70434	1336624122	1	0.04	0.00333333333333333	9428	1
4	Food 2	Intake 4	15	71263	1336624951	/users/cn/jespinosa/phecomp/data/CRG/20120502_FDF_CRG/20120502_FDF_CRG/20120509_FDF_CRG_c12.mtb	2308	95	WWFF	food_fat	4	71248	1336624936	1	0.04	0.00266666666666667	9429	1
4	Food 2	Intake 4	13	71371	1336625059	/users/cn/jespinosa/phecomp/data/CRG/20120502_FDF_CRG/20120502_FDF_CRG/20120509_FDF_CRG_c12.mtb	2310	321	WWFF	food_fat	4	71358	1336625046	1	0.0600000000000005	0.00461538461538465	9430	1
4	Food 2	Intake 4	116	71808	1336625496	/users/cn/jespinosa/phecomp/data/CRG/20120502_FDF_CRG/20120502_FDF_CRG/20120509_FDF_CRG_c12.mtb	2311	587	WWFF	food_fat	4	71692	1336625380	1	0.0999999999999996	0.000862068965517238	9431	1
4	Food 2	Intake 4	36	72431	1336626119	/users/cn/jespinosa/phecomp/data/CRG/20120502_FDF_CRG/20120502_FDF_CRG/20120509_FDF_CRG_c12.mtb	2313	182	WWFF	food_fat	4	72395	1336626083	1	0.04	0.00111111111111111	9432	1
4	Food 2	Intake 4	90	72703	1336626391	/users/cn/jespinosa/phecomp/data/CRG/20120502_FDF_CRG/20120502_FDF_CRG/20120509_FDF_CRG_c12.mtb	2314	758	WWFF	food_fat	4	72613	1336626301	1	0.0200000000000005	0.000222222222222228	9433	1
4	Food 1	Intake 3	95	73556	1336627244	/users/cn/jespinosa/phecomp/data/CRG/20120502_FDF_CRG/20120502_FDF_CRG/20120509_FDF_CRG_c12.mtb	1764	22	WWFF	food_fat	3	73461	1336627149	1	0.0800000000000001	0.000842105263157896	9434	1
4	Food 1	Intake 3	83	73661	1336627349	/users/cn/jespinosa/phecomp/data/CRG/20120502_FDF_CRG/20120502_FDF_CRG/20120509_FDF_CRG_c12.mtb	1765	19	WWFF	food_fat	3	73578	1336627266	1	0.0800000000000001	0.000963855421686748	9435	1
4	Food 2	Intake 4	139	73819	1336627507	/users/cn/jespinosa/phecomp/data/CRG/20120502_FDF_CRG/20120502_FDF_CRG/20120509_FDF_CRG_c12.mtb	2316	COLL	WWFF	food_fat	4	73680	1336627368	1	0.26	0.0018705035971223	9436	1
4	Food 1	Intake 3	129	73817	1336627505	/users/cn/jespinosa/phecomp/data/CRG/20120502_FDF_CRG/20120502_FDF_CRG/20120509_FDF_CRG_c12.mtb	1766	8	WWFF	food_fat	3	73688	1336627376	1	0.5	0.00387596899224806	9437	1
4	Food 1	Intake 3	229	74054	1336627742	/users/cn/jespinosa/phecomp/data/CRG/20120502_FDF_CRG/20120502_FDF_CRG/20120509_FDF_CRG_c12.mtb	1767	46	WWFF	food_fat	3	73825	1336627513	1	0.539999999999999	0.00235807860262008	9438	1
4	Drink 1	Intake 1	21	74051	1336627739	/users/cn/jespinosa/phecomp/data/CRG/20120502_FDF_CRG/20120502_FDF_CRG/20120509_FDF_CRG_c12.mtb	1249	NA	WWFF	water	1	74030	1336627718	1	0.12	0.00571428571428571	9439	1
4	Food 2	Intake 4	80	74180	1336627868	/users/cn/jespinosa/phecomp/data/CRG/20120502_FDF_CRG/20120502_FDF_CRG/20120509_FDF_CRG_c12.mtb	2318	20	WWFF	food_fat	4	74100	1336627788	1	0.14	0.00175	9440	1
4	Food 2	Intake 4	247	74447	1336628135	/users/cn/jespinosa/phecomp/data/CRG/20120502_FDF_CRG/20120502_FDF_CRG/20120509_FDF_CRG_c12.mtb	2319	COLL	WWFF	food_fat	4	74200	1336627888	1	0.04	0.000161943319838057	9441	1
4	Food 1	Intake 3	242	74443	1336628131	/users/cn/jespinosa/phecomp/data/CRG/20120502_FDF_CRG/20120502_FDF_CRG/20120509_FDF_CRG_c12.mtb	1769	79	WWFF	food_fat	3	74201	1336627889	1	0.0999999999999996	0.000413223140495866	9442	1
4	Food 2	Intake 4	285	74807	1336628495	/users/cn/jespinosa/phecomp/data/CRG/20120502_FDF_CRG/20120502_FDF_CRG/20120509_FDF_CRG_c12.mtb	2320	COLL	WWFF	food_fat	4	74522	1336628210	1	0.0200000000000005	7.0175438596493e-05	9443	1
4	Food 1	Intake 3	141	74805	1336628493	/users/cn/jespinosa/phecomp/data/CRG/20120502_FDF_CRG/20120502_FDF_CRG/20120509_FDF_CRG_c12.mtb	1771	14	WWFF	food_fat	3	74664	1336628352	1	0.0600000000000005	0.000425531914893621	9444	1
4	Food 2	Intake 4	255	75074	1336628762	/users/cn/jespinosa/phecomp/data/CRG/20120502_FDF_CRG/20120502_FDF_CRG/20120509_FDF_CRG_c12.mtb	2321	COLL	WWFF	food_fat	4	74819	1336628507	1	0.0599999999999996	0.000235294117647057	9445	1
4	Food 1	Intake 3	252	75074	1336628762	/users/cn/jespinosa/phecomp/data/CRG/20120502_FDF_CRG/20120502_FDF_CRG/20120509_FDF_CRG_c12.mtb	1772	37	WWFF	food_fat	3	74822	1336628510	1	0.0599999999999987	0.000238095238095233	9446	1
4	Food 2	Intake 4	121	75232	1336628920	/users/cn/jespinosa/phecomp/data/CRG/20120502_FDF_CRG/20120502_FDF_CRG/20120509_FDF_CRG_c12.mtb	2322	COLL	WWFF	food_fat	4	75111	1336628799	1	0.14	0.00115702479338843	9447	1
4	Food 1	Intake 3	113	75225	1336628913	/users/cn/jespinosa/phecomp/data/CRG/20120502_FDF_CRG/20120502_FDF_CRG/20120509_FDF_CRG_c12.mtb	1773	62	WWFF	food_fat	3	75112	1336628800	1	0.5	0.00442477876106195	9448	1
4	Drink 1	Intake 1	20	75232	1336628920	/users/cn/jespinosa/phecomp/data/CRG/20120502_FDF_CRG/20120502_FDF_CRG/20120509_FDF_CRG_c12.mtb	1251	NA	WWFF	water	1	75212	1336628900	1	0.0600000000000001	0.00300000000000001	9449	1
4	Food 1	Intake 3	20	75307	1336628995	/users/cn/jespinosa/phecomp/data/CRG/20120502_FDF_CRG/20120502_FDF_CRG/20120509_FDF_CRG_c12.mtb	1774	106	WWFF	food_fat	3	75287	1336628975	1	0.0200000000000014	0.00100000000000007	9450	1
4	Food 1	Intake 3	161	75574	1336629262	/users/cn/jespinosa/phecomp/data/CRG/20120502_FDF_CRG/20120502_FDF_CRG/20120509_FDF_CRG_c12.mtb	1775	26	WWFF	food_fat	3	75413	1336629101	1	0.84	0.00521739130434783	9451	1
4	Food 2	Intake 4	116	75716	1336629404	/users/cn/jespinosa/phecomp/data/CRG/20120502_FDF_CRG/20120502_FDF_CRG/20120509_FDF_CRG_c12.mtb	2325	COLL	WWFF	food_fat	4	75600	1336629288	1	0.0999999999999996	0.000862068965517238	9452	1
4	Food 1	Intake 3	100	75707	1336629395	/users/cn/jespinosa/phecomp/data/CRG/20120502_FDF_CRG/20120502_FDF_CRG/20120509_FDF_CRG_c12.mtb	1776	57	WWFF	food_fat	3	75607	1336629295	1	0.799999999999999	0.00799999999999999	9453	1
4	Food 2	Intake 4	405	76169	1336629857	/users/cn/jespinosa/phecomp/data/CRG/20120502_FDF_CRG/20120502_FDF_CRG/20120509_FDF_CRG_c12.mtb	2326	COLL	WWFF	food_fat	4	75764	1336629452	1	0.14	0.000345679012345679	9454	1
4	Food 1	Intake 3	400	76165	1336629853	/users/cn/jespinosa/phecomp/data/CRG/20120502_FDF_CRG/20120502_FDF_CRG/20120509_FDF_CRG_c12.mtb	1777	104	WWFF	food_fat	3	75765	1336629453	1	0.440000000000001	0.0011	9455	1
4	Food 2	Intake 4	8	76277	1336629965	/users/cn/jespinosa/phecomp/data/CRG/20120502_FDF_CRG/20120502_FDF_CRG/20120509_FDF_CRG_c12.mtb	2327	33	WWFF	food_fat	4	76269	1336629957	1	0.0200000000000005	0.00250000000000006	9456	1
4	Drink 1	Intake 1	27	76307	1336629995	/users/cn/jespinosa/phecomp/data/CRG/20120502_FDF_CRG/20120502_FDF_CRG/20120509_FDF_CRG_c12.mtb	1252	NA	WWFF	water	1	76280	1336629968	1	0.12	0.00444444444444444	9457	1
4	Food 1	Intake 3	215	76525	1336630213	/users/cn/jespinosa/phecomp/data/CRG/20120502_FDF_CRG/20120502_FDF_CRG/20120509_FDF_CRG_c12.mtb	1778	2448	WWFF	food_fat	3	76310	1336629998	1	0.719999999999999	0.00334883720930232	9458	1
4	Drink 1	Intake 1	16	78076	1336631764	/users/cn/jespinosa/phecomp/data/CRG/20120502_FDF_CRG/20120502_FDF_CRG/20120509_FDF_CRG_c12.mtb	1253	NA	WWFF	water	1	78060	1336631748	1	0.0600000000000001	0.00375000000000001	9459	1
4	Food 2	Intake 4	14	78987	1336632675	/users/cn/jespinosa/phecomp/data/CRG/20120502_FDF_CRG/20120502_FDF_CRG/20120509_FDF_CRG_c12.mtb	2330	434	WWFF	food_fat	4	78973	1336632661	1	0.04	0.00285714285714286	9460	1
4	Food 2	Intake 4	19	79440	1336633128	/users/cn/jespinosa/phecomp/data/CRG/20120502_FDF_CRG/20120502_FDF_CRG/20120509_FDF_CRG_c12.mtb	2332	1779	WWFF	food_fat	4	79421	1336633109	1	0.0200000000000005	0.00105263157894739	9461	1
4	Drink 1	Intake 1	15	79437	1336633125	/users/cn/jespinosa/phecomp/data/CRG/20120502_FDF_CRG/20120502_FDF_CRG/20120509_FDF_CRG_c12.mtb	1254	NA	WWFF	water	1	79422	1336633110	1	0.0600000000000001	0.00400000000000001	9462	1
4	Drink 1	Intake 1	26	80680	1336634368	/users/cn/jespinosa/phecomp/data/CRG/20120502_FDF_CRG/20120502_FDF_CRG/20120509_FDF_CRG_c12.mtb	1255	NA	WWFF	water	1	80654	1336634342	1	0.12	0.00461538461538461	9463	1
4	Food 2	Intake 4	14	81233	1336634921	/users/cn/jespinosa/phecomp/data/CRG/20120502_FDF_CRG/20120502_FDF_CRG/20120509_FDF_CRG_c12.mtb	2336	237	WWFF	food_fat	4	81219	1336634907	1	0.0599999999999996	0.00428571428571426	9464	1
4	Food 2	Intake 4	84	81554	1336635242	/users/cn/jespinosa/phecomp/data/CRG/20120502_FDF_CRG/20120502_FDF_CRG/20120509_FDF_CRG_c12.mtb	2337	705	WWFF	food_fat	4	81470	1336635158	1	0.100000000000001	0.0011904761904762	9465	1
4	Food 2	Intake 4	32	82291	1336635979	/users/cn/jespinosa/phecomp/data/CRG/20120502_FDF_CRG/20120502_FDF_CRG/20120509_FDF_CRG_c12.mtb	2339	772	WWFF	food_fat	4	82259	1336635947	1	0.0200000000000005	0.000625000000000016	9466	1
4	Food 1	Intake 3	34	83097	1336636785	/users/cn/jespinosa/phecomp/data/CRG/20120502_FDF_CRG/20120502_FDF_CRG/20120509_FDF_CRG_c12.mtb	1787	13	WWFF	food_fat	3	83063	1336636751	1	0.0600000000000005	0.00176470588235296	9467	1
4	Food 2	Intake 4	14	83124	1336636812	/users/cn/jespinosa/phecomp/data/CRG/20120502_FDF_CRG/20120502_FDF_CRG/20120509_FDF_CRG_c12.mtb	2341	785	WWFF	food_fat	4	83110	1336636798	1	0.04	0.00285714285714286	9468	1
4	Food 1	Intake 3	12	83921	1336637609	/users/cn/jespinosa/phecomp/data/CRG/20120502_FDF_CRG/20120502_FDF_CRG/20120509_FDF_CRG_c12.mtb	1788	485	WWFF	food_fat	3	83909	1336637597	1	0.0399999999999991	0.00333333333333326	9469	1
4	Drink 1	Intake 1	21	83931	1336637619	/users/cn/jespinosa/phecomp/data/CRG/20120502_FDF_CRG/20120502_FDF_CRG/20120509_FDF_CRG_c12.mtb	1256	NA	WWFF	water	1	83910	1336637598	1	0.0799999999999998	0.0038095238095238	9470	1
4	Food 2	Intake 4	16	84422	1336638110	/users/cn/jespinosa/phecomp/data/CRG/20120502_FDF_CRG/20120502_FDF_CRG/20120509_FDF_CRG_c12.mtb	2343	711	WWFF	food_fat	4	84406	1336638094	1	0.0200000000000005	0.00125000000000003	9471	1
4	Drink 1	Intake 1	8	84630	1336638318	/users/cn/jespinosa/phecomp/data/CRG/20120502_FDF_CRG/20120502_FDF_CRG/20120509_FDF_CRG_c12.mtb	1257	NA	WWFF	water	1	84622	1336638310	1	0.04	0.005	9472	1
4	Food 1	Intake 3	76	85209	1336638897	/users/cn/jespinosa/phecomp/data/CRG/20120502_FDF_CRG/20120502_FDF_CRG/20120509_FDF_CRG_c12.mtb	1789	COLL	WWFF	food_fat	3	85133	1336638821	1	0.0200000000000014	0.000263157894736861	9473	1
4	Food 2	Intake 4	75	85209	1336638897	/users/cn/jespinosa/phecomp/data/CRG/20120502_FDF_CRG/20120502_FDF_CRG/20120509_FDF_CRG_c12.mtb	2344	834	WWFF	food_fat	4	85134	1336638822	1	0.0599999999999996	0.000799999999999995	9474	1
4	Food 2	Intake 4	39	86082	1336639770	/users/cn/jespinosa/phecomp/data/CRG/20120502_FDF_CRG/20120502_FDF_CRG/20120509_FDF_CRG_c12.mtb	2346	COLL	WWFF	food_fat	4	86043	1336639731	1	0.42	0.0107692307692308	9475	1
4	Food 1	Intake 3	16	86071	1336639759	/users/cn/jespinosa/phecomp/data/CRG/20120502_FDF_CRG/20120502_FDF_CRG/20120509_FDF_CRG_c12.mtb	1792	1833	WWFF	food_fat	3	86055	1336639743	1	0.180000000000001	0.0112500000000001	9476	1
4	Food 2	Intake 4	79	87983	1336641671	/users/cn/jespinosa/phecomp/data/CRG/20120502_FDF_CRG/20120502_FDF_CRG/20120509_FDF_CRG_c12.mtb	2350	1363	WWFF	food_fat	4	87904	1336641592	1	0.0799999999999992	0.00101265822784809	9477	1
4	Food 2	Intake 4	17	89363	1336643051	/users/cn/jespinosa/phecomp/data/CRG/20120502_FDF_CRG/20120502_FDF_CRG/20120509_FDF_CRG_c12.mtb	2351	1319	WWFF	food_fat	4	89346	1336643034	1	0.0200000000000005	0.00117647058823532	9478	1
4	Food 1	Intake 3	207	90889	1336644577	/users/cn/jespinosa/phecomp/data/CRG/20120502_FDF_CRG/20120502_FDF_CRG/20120509_FDF_CRG_c12.mtb	1798	COLL	WWFF	food_fat	3	90682	1336644370	1	0.32	0.00154589371980676	9479	1
4	Food 2	Intake 4	399	91082	1336644770	/users/cn/jespinosa/phecomp/data/CRG/20120502_FDF_CRG/20120502_FDF_CRG/20120509_FDF_CRG_c12.mtb	2356	COLL	WWFF	food_fat	4	90683	1336644371	1	0.04	0.000100250626566416	9480	1
4	Food 1	Intake 3	143	91081	1336644769	/users/cn/jespinosa/phecomp/data/CRG/20120502_FDF_CRG/20120502_FDF_CRG/20120509_FDF_CRG_c12.mtb	1800	696	WWFF	food_fat	3	90938	1336644626	1	0.700000000000001	0.0048951048951049	9481	1
4	Food 2	Intake 4	12	91789	1336645477	/users/cn/jespinosa/phecomp/data/CRG/20120502_FDF_CRG/20120502_FDF_CRG/20120509_FDF_CRG_c12.mtb	2360	1062	WWFF	food_fat	4	91777	1336645465	1	0.04	0.00333333333333333	9482	1
4	Drink 1	Intake 1	28	92129	1336645817	/users/cn/jespinosa/phecomp/data/CRG/20120502_FDF_CRG/20120502_FDF_CRG/20120509_FDF_CRG_c12.mtb	1258	NA	WWFF	water	1	92101	1336645789	1	0.12	0.00428571428571429	9483	1
4	Food 2	Intake 4	20	92871	1336646559	/users/cn/jespinosa/phecomp/data/CRG/20120502_FDF_CRG/20120502_FDF_CRG/20120509_FDF_CRG_c12.mtb	2361	913	WWFF	food_fat	4	92851	1336646539	1	0.04	0.002	9484	1
4	Food 1	Intake 3	23	93807	1336647495	/users/cn/jespinosa/phecomp/data/CRG/20120502_FDF_CRG/20120502_FDF_CRG/20120509_FDF_CRG_c12.mtb	1802	COLL	WWFF	food_fat	3	93784	1336647472	1	0.140000000000001	0.00608695652173917	9485	1
4	Food 2	Intake 4	33	93820	1336647508	/users/cn/jespinosa/phecomp/data/CRG/20120502_FDF_CRG/20120502_FDF_CRG/20120509_FDF_CRG_c12.mtb	2363	1396	WWFF	food_fat	4	93787	1336647475	1	0.2	0.00606060606060606	9486	1
4	Drink 1	Intake 1	14	94665	1336648353	/users/cn/jespinosa/phecomp/data/CRG/20120502_FDF_CRG/20120502_FDF_CRG/20120509_FDF_CRG_c12.mtb	1259	NA	WWFF	water	1	94651	1336648339	1	0.0800000000000001	0.00571428571428572	9487	1
4	Food 2	Intake 4	13	95229	1336648917	/users/cn/jespinosa/phecomp/data/CRG/20120502_FDF_CRG/20120502_FDF_CRG/20120509_FDF_CRG_c12.mtb	2365	1971	WWFF	food_fat	4	95216	1336648904	1	0.04	0.00307692307692308	9488	1
4	Drink 1	Intake 1	23	96112	1336649800	/users/cn/jespinosa/phecomp/data/CRG/20120502_FDF_CRG/20120502_FDF_CRG/20120509_FDF_CRG_c12.mtb	1260	NA	WWFF	water	1	96089	1336649777	1	0.0600000000000001	0.00260869565217392	9489	1
4	Food 2	Intake 4	36	97236	1336650924	/users/cn/jespinosa/phecomp/data/CRG/20120502_FDF_CRG/20120502_FDF_CRG/20120509_FDF_CRG_c12.mtb	2367	2292	WWFF	food_fat	4	97200	1336650888	1	0.04	0.00111111111111111	9490	1
4	Food 2	Intake 4	12	99540	1336653228	/users/cn/jespinosa/phecomp/data/CRG/20120502_FDF_CRG/20120502_FDF_CRG/20120509_FDF_CRG_c12.mtb	2370	201	WWFF	food_fat	4	99528	1336653216	1	0.04	0.00333333333333333	9491	1
4	Food 2	Intake 4	65	99806	1336653494	/users/cn/jespinosa/phecomp/data/CRG/20120502_FDF_CRG/20120502_FDF_CRG/20120509_FDF_CRG_c12.mtb	2371	COLL	WWFF	food_fat	4	99741	1336653429	1	0.26	0.004	9492	1
4	Drink 1	Intake 1	14	99761	1336653449	/users/cn/jespinosa/phecomp/data/CRG/20120502_FDF_CRG/20120502_FDF_CRG/20120509_FDF_CRG_c12.mtb	1261	NA	WWFF	water	1	99747	1336653435	1	0.1	0.00714285714285714	9493	1
4	Food 1	Intake 3	49	99805	1336653493	/users/cn/jespinosa/phecomp/data/CRG/20120502_FDF_CRG/20120502_FDF_CRG/20120509_FDF_CRG_c12.mtb	1804	462	WWFF	food_fat	3	99756	1336653444	1	0.18	0.0036734693877551	9494	1
4	Food 2	Intake 4	39	100306	1336653994	/users/cn/jespinosa/phecomp/data/CRG/20120502_FDF_CRG/20120502_FDF_CRG/20120509_FDF_CRG_c12.mtb	2372	1157	WWFF	food_fat	4	100267	1336653955	1	0.0200000000000005	0.000512820512820526	9495	1
4	Food 2	Intake 4	40	101503	1336655191	/users/cn/jespinosa/phecomp/data/CRG/20120502_FDF_CRG/20120502_FDF_CRG/20120509_FDF_CRG_c12.mtb	2375	COLL	WWFF	food_fat	4	101463	1336655151	1	0.22	0.0055	9496	1
4	Food 1	Intake 3	15	101479	1336655167	/users/cn/jespinosa/phecomp/data/CRG/20120502_FDF_CRG/20120502_FDF_CRG/20120509_FDF_CRG_c12.mtb	1807	288	WWFF	food_fat	3	101464	1336655152	1	0.0999999999999996	0.00666666666666664	9497	1
4	Drink 1	Intake 1	25	101790	1336655478	/users/cn/jespinosa/phecomp/data/CRG/20120502_FDF_CRG/20120502_FDF_CRG/20120509_FDF_CRG_c12.mtb	1262	NA	WWFF	water	1	101765	1336655453	1	0.0600000000000001	0.0024	9498	1
4	Food 2	Intake 4	9	101776	1336655464	/users/cn/jespinosa/phecomp/data/CRG/20120502_FDF_CRG/20120502_FDF_CRG/20120509_FDF_CRG_c12.mtb	2376	1272	WWFF	food_fat	4	101767	1336655455	1	0.0200000000000005	0.00222222222222228	9499	1
4	Food 2	Intake 4	36	103084	1336656772	/users/cn/jespinosa/phecomp/data/CRG/20120502_FDF_CRG/20120502_FDF_CRG/20120509_FDF_CRG_c12.mtb	2378	3021	WWFF	food_fat	4	103048	1336656736	1	0.0200000000000005	0.000555555555555569	9500	1
4	Drink 1	Intake 1	34	105460	1336659148	/users/cn/jespinosa/phecomp/data/CRG/20120502_FDF_CRG/20120502_FDF_CRG/20120509_FDF_CRG_c12.mtb	1264	NA	WWFF	water	1	105426	1336659114	1	0.12	0.00352941176470588	9501	1
4	Food 2	Intake 4	315	106420	1336660108	/users/cn/jespinosa/phecomp/data/CRG/20120502_FDF_CRG/20120502_FDF_CRG/20120509_FDF_CRG_c12.mtb	2382	COLL	WWFF	food_fat	4	106105	1336659793	1	0.16	0.000507936507936508	9502	1
4	Food 1	Intake 3	246	106419	1336660107	/users/cn/jespinosa/phecomp/data/CRG/20120502_FDF_CRG/20120502_FDF_CRG/20120509_FDF_CRG_c12.mtb	1810	49	WWFF	food_fat	3	106173	1336659861	1	0.0400000000000009	0.000162601626016264	9503	1
4	Food 1	Intake 3	166	106634	1336660322	/users/cn/jespinosa/phecomp/data/CRG/20120502_FDF_CRG/20120502_FDF_CRG/20120509_FDF_CRG_c12.mtb	1811	151	WWFF	food_fat	3	106468	1336660156	1	0.0399999999999991	0.000240963855421681	9504	1
4	Food 1	Intake 3	194	106979	1336660667	/users/cn/jespinosa/phecomp/data/CRG/20120502_FDF_CRG/20120502_FDF_CRG/20120509_FDF_CRG_c12.mtb	1814	364	WWFF	food_fat	3	106785	1336660473	1	0.0399999999999991	0.000206185567010305	9505	1
4	Food 1	Intake 3	51	107394	1336661082	/users/cn/jespinosa/phecomp/data/CRG/20120502_FDF_CRG/20120502_FDF_CRG/20120509_FDF_CRG_c12.mtb	1817	145	WWFF	food_fat	3	107343	1336661031	1	0.0400000000000009	0.000784313725490214	9506	1
4	Food 1	Intake 3	457	107996	1336661684	/users/cn/jespinosa/phecomp/data/CRG/20120502_FDF_CRG/20120502_FDF_CRG/20120509_FDF_CRG_c12.mtb	1820	COLL	WWFF	food_fat	3	107539	1336661227	1	0.0799999999999983	0.000175054704595182	9507	1
4	Food 2	Intake 4	459	108000	1336661688	/users/cn/jespinosa/phecomp/data/CRG/20120502_FDF_CRG/20120502_FDF_CRG/20120509_FDF_CRG_c12.mtb	2387	42	WWFF	food_fat	4	107541	1336661229	1	0.2	0.000435729847494553	9508	1
4	Food 1	Intake 3	75	108117	1336661805	/users/cn/jespinosa/phecomp/data/CRG/20120502_FDF_CRG/20120502_FDF_CRG/20120509_FDF_CRG_c12.mtb	1821	COLL	WWFF	food_fat	3	108042	1336661730	1	0.0400000000000009	0.000533333333333345	9509	1
4	Food 2	Intake 4	74	108117	1336661805	/users/cn/jespinosa/phecomp/data/CRG/20120502_FDF_CRG/20120502_FDF_CRG/20120509_FDF_CRG_c12.mtb	2388	204	WWFF	food_fat	4	108043	1336661731	1	0.0599999999999996	0.000810810810810805	9510	1
4	Drink 2	Intake 2	51	108331	1336662019	/users/cn/jespinosa/phecomp/data/CRG/20120502_FDF_CRG/20120502_FDF_CRG/20120509_FDF_CRG_c12.mtb	1196	NA	WWFF	water	2	108280	1336661968	1	0.04	0.000784313725490196	9511	1
4	Food 2	Intake 4	14	108335	1336662023	/users/cn/jespinosa/phecomp/data/CRG/20120502_FDF_CRG/20120502_FDF_CRG/20120509_FDF_CRG_c12.mtb	2390	390	WWFF	food_fat	4	108321	1336662009	1	0.12	0.00857142857142857	9512	1
4	Food 2	Intake 4	12	108737	1336662425	/users/cn/jespinosa/phecomp/data/CRG/20120502_FDF_CRG/20120502_FDF_CRG/20120509_FDF_CRG_c12.mtb	2391	2078	WWFF	food_fat	4	108725	1336662413	1	0.04	0.00333333333333333	9513	1
4	Food 2	Intake 4	21	110836	1336664524	/users/cn/jespinosa/phecomp/data/CRG/20120502_FDF_CRG/20120502_FDF_CRG/20120509_FDF_CRG_c12.mtb	2394	COLL	WWFF	food_fat	4	110815	1336664503	1	0.220000000000001	0.0104761904761905	9514	1
4	Food 1	Intake 3	18	110836	1336664524	/users/cn/jespinosa/phecomp/data/CRG/20120502_FDF_CRG/20120502_FDF_CRG/20120509_FDF_CRG_c12.mtb	1825	1635	WWFF	food_fat	3	110818	1336664506	1	0.0600000000000005	0.00333333333333336	9515	1
4	Drink 1	Intake 1	29	112472	1336666160	/users/cn/jespinosa/phecomp/data/CRG/20120502_FDF_CRG/20120502_FDF_CRG/20120509_FDF_CRG_c12.mtb	1265	NA	WWFF	water	1	112443	1336666131	1	0.0999999999999996	0.00344827586206895	9516	1
4	Food 2	Intake 4	15	112486	1336666174	/users/cn/jespinosa/phecomp/data/CRG/20120502_FDF_CRG/20120502_FDF_CRG/20120509_FDF_CRG_c12.mtb	2396	1226	WWFF	food_fat	4	112471	1336666159	1	0.0200000000000005	0.00133333333333337	9517	1
4	Food 1	Intake 3	19	113731	1336667419	/users/cn/jespinosa/phecomp/data/CRG/20120502_FDF_CRG/20120502_FDF_CRG/20120509_FDF_CRG_c12.mtb	1827	1955	WWFF	food_fat	3	113712	1336667400	1	0.139999999999999	0.00736842105263153	9518	1
4	Drink 1	Intake 1	20	114322	1336668010	/users/cn/jespinosa/phecomp/data/CRG/20120502_FDF_CRG/20120502_FDF_CRG/20120509_FDF_CRG_c12.mtb	1266	NA	WWFF	water	1	114302	1336667990	1	0.0600000000000001	0.00300000000000001	9519	1
4	Food 2	Intake 4	19	115705	1336669393	/users/cn/jespinosa/phecomp/data/CRG/20120502_FDF_CRG/20120502_FDF_CRG/20120509_FDF_CRG_c12.mtb	2399	785	WWFF	food_fat	4	115686	1336669374	1	0.0200000000000005	0.00105263157894739	9520	1
4	Food 1	Intake 3	18	116508	1336670196	/users/cn/jespinosa/phecomp/data/CRG/20120502_FDF_CRG/20120502_FDF_CRG/20120509_FDF_CRG_c12.mtb	1830	1073	WWFF	food_fat	3	116490	1336670178	1	0.0200000000000014	0.00111111111111119	9521	1
4	Food 2	Intake 4	19	117600	1336671288	/users/cn/jespinosa/phecomp/data/CRG/20120502_FDF_CRG/20120502_FDF_CRG/20120509_FDF_CRG_c12.mtb	2403	22	WWFF	food_fat	4	117581	1336671269	1	0.0599999999999996	0.00315789473684208	9522	1
4	Food 2	Intake 4	34	117656	1336671344	/users/cn/jespinosa/phecomp/data/CRG/20120502_FDF_CRG/20120502_FDF_CRG/20120509_FDF_CRG_c12.mtb	2404	COLL	WWFF	food_fat	4	117622	1336671310	1	0.28	0.00823529411764706	9523	1
4	Food 1	Intake 3	28	117651	1336671339	/users/cn/jespinosa/phecomp/data/CRG/20120502_FDF_CRG/20120502_FDF_CRG/20120509_FDF_CRG_c12.mtb	1832	4559	WWFF	food_fat	3	117623	1336671311	1	0.119999999999999	0.00428571428571425	9524	1
4	Drink 1	Intake 1	26	120716	1336674404	/users/cn/jespinosa/phecomp/data/CRG/20120502_FDF_CRG/20120502_FDF_CRG/20120509_FDF_CRG_c12.mtb	1267	NA	WWFF	water	1	120690	1336674378	1	0.1	0.00384615384615385	9525	1
4	Food 1	Intake 3	215	122425	1336676113	/users/cn/jespinosa/phecomp/data/CRG/20120502_FDF_CRG/20120502_FDF_CRG/20120509_FDF_CRG_c12.mtb	1833	COLL	WWFF	food_fat	3	122210	1336675898	1	0.140000000000001	0.000651162790697679	9526	1
4	Food 2	Intake 4	221	122432	1336676120	/users/cn/jespinosa/phecomp/data/CRG/20120502_FDF_CRG/20120502_FDF_CRG/20120509_FDF_CRG_c12.mtb	2409	1018	WWFF	food_fat	4	122211	1336675899	1	0.0800000000000001	0.000361990950226245	9527	1
4	Food 2	Intake 4	83	123533	1336677221	/users/cn/jespinosa/phecomp/data/CRG/20120502_FDF_CRG/20120502_FDF_CRG/20120509_FDF_CRG_c12.mtb	2415	348	WWFF	food_fat	4	123450	1336677138	1	0.0200000000000005	0.000240963855421693	9528	1
4	Food 1	Intake 3	27	123908	1336677596	/users/cn/jespinosa/phecomp/data/CRG/20120502_FDF_CRG/20120502_FDF_CRG/20120509_FDF_CRG_c12.mtb	1838	COLL	WWFF	food_fat	3	123881	1336677569	1	0.0600000000000005	0.00222222222222224	9529	1
4	Food 2	Intake 4	27	123909	1336677597	/users/cn/jespinosa/phecomp/data/CRG/20120502_FDF_CRG/20120502_FDF_CRG/20120509_FDF_CRG_c12.mtb	2418	2354	WWFF	food_fat	4	123882	1336677570	1	0.2	0.00740740740740741	9530	1
4	Drink 1	Intake 1	20	124746	1336678434	/users/cn/jespinosa/phecomp/data/CRG/20120502_FDF_CRG/20120502_FDF_CRG/20120509_FDF_CRG_c12.mtb	1269	NA	WWFF	water	1	124726	1336678414	1	0.1	0.005	9531	1
4	Food 2	Intake 4	302	126565	1336680253	/users/cn/jespinosa/phecomp/data/CRG/20120502_FDF_CRG/20120502_FDF_CRG/20120509_FDF_CRG_c12.mtb	2422	COLL	WWFF	food_fat	4	126263	1336679951	1	0.119999999999999	0.00039735099337748	9532	1
4	Food 1	Intake 3	125	126563	1336680251	/users/cn/jespinosa/phecomp/data/CRG/20120502_FDF_CRG/20120502_FDF_CRG/20120509_FDF_CRG_c12.mtb	1841	22	WWFF	food_fat	3	126438	1336680126	1	0.0800000000000001	0.000640000000000001	9533	1
4	Food 1	Intake 3	275	126860	1336680548	/users/cn/jespinosa/phecomp/data/CRG/20120502_FDF_CRG/20120502_FDF_CRG/20120509_FDF_CRG_c12.mtb	1842	COLL	WWFF	food_fat	3	126585	1336680273	1	0.300000000000001	0.00109090909090909	9534	1
4	Food 2	Intake 4	276	126862	1336680550	/users/cn/jespinosa/phecomp/data/CRG/20120502_FDF_CRG/20120502_FDF_CRG/20120509_FDF_CRG_c12.mtb	2423	316	WWFF	food_fat	4	126586	1336680274	1	0.100000000000001	0.000362318840579714	9535	1
4	Food 1	Intake 3	75	127253	1336680941	/users/cn/jespinosa/phecomp/data/CRG/20120502_FDF_CRG/20120502_FDF_CRG/20120509_FDF_CRG_c12.mtb	1845	117	WWFF	food_fat	3	127178	1336680866	1	0.0999999999999979	0.00133333333333331	9536	1
4	Food 2	Intake 4	20	127390	1336681078	/users/cn/jespinosa/phecomp/data/CRG/20120502_FDF_CRG/20120502_FDF_CRG/20120509_FDF_CRG_c12.mtb	2425	20	WWFF	food_fat	4	127370	1336681058	1	0.140000000000001	0.00700000000000005	9537	1
4	Food 2	Intake 4	207	127617	1336681305	/users/cn/jespinosa/phecomp/data/CRG/20120502_FDF_CRG/20120502_FDF_CRG/20120509_FDF_CRG_c12.mtb	2426	COLL	WWFF	food_fat	4	127410	1336681098	1	0.0800000000000001	0.000386473429951691	9538	1
4	Food 1	Intake 3	205	127617	1336681305	/users/cn/jespinosa/phecomp/data/CRG/20120502_FDF_CRG/20120502_FDF_CRG/20120509_FDF_CRG_c12.mtb	1847	41	WWFF	food_fat	3	127412	1336681100	1	0.220000000000002	0.00107317073170733	9539	1
4	Food 1	Intake 3	95	127753	1336681441	/users/cn/jespinosa/phecomp/data/CRG/20120502_FDF_CRG/20120502_FDF_CRG/20120509_FDF_CRG_c12.mtb	1848	221	WWFF	food_fat	3	127658	1336681346	1	0.0599999999999987	0.000631578947368407	9540	1
4	Food 2	Intake 4	129	128103	1336681791	/users/cn/jespinosa/phecomp/data/CRG/20120502_FDF_CRG/20120502_FDF_CRG/20120509_FDF_CRG_c12.mtb	2431	COLL	WWFF	food_fat	4	127974	1336681662	1	0.18	0.0013953488372093	9541	1
4	Food 1	Intake 3	106	128103	1336681791	/users/cn/jespinosa/phecomp/data/CRG/20120502_FDF_CRG/20120502_FDF_CRG/20120509_FDF_CRG_c12.mtb	1851	125	WWFF	food_fat	3	127997	1336681685	1	0.140000000000001	0.00132075471698114	9542	1
4	Food 2	Intake 4	144	128372	1336682060	/users/cn/jespinosa/phecomp/data/CRG/20120502_FDF_CRG/20120502_FDF_CRG/20120509_FDF_CRG_c12.mtb	2433	COLL	WWFF	food_fat	4	128228	1336681916	1	0.38	0.00263888888888889	9543	1
4	Food 1	Intake 3	61	128368	1336682056	/users/cn/jespinosa/phecomp/data/CRG/20120502_FDF_CRG/20120502_FDF_CRG/20120509_FDF_CRG_c12.mtb	1853	462	WWFF	food_fat	3	128307	1336681995	1	0.100000000000001	0.0016393442622951	9544	1
4	Drink 1	Intake 1	62	128472	1336682160	/users/cn/jespinosa/phecomp/data/CRG/20120502_FDF_CRG/20120502_FDF_CRG/20120509_FDF_CRG_c12.mtb	1272	NA	WWFF	water	1	128410	1336682098	1	0.02	0.00032258064516129	9545	1
4	Food 2	Intake 4	237	129067	1336682755	/users/cn/jespinosa/phecomp/data/CRG/20120502_FDF_CRG/20120502_FDF_CRG/20120509_FDF_CRG_c12.mtb	2437	COLL	WWFF	food_fat	4	128830	1336682518	1	0.119999999999999	0.000506329113924046	9546	1
4	Food 1	Intake 3	148	129065	1336682753	/users/cn/jespinosa/phecomp/data/CRG/20120502_FDF_CRG/20120502_FDF_CRG/20120509_FDF_CRG_c12.mtb	1858	104	WWFF	food_fat	3	128917	1336682605	1	0.0399999999999991	0.000270270270270264	9547	1
4	Food 2	Intake 4	28	129197	1336682885	/users/cn/jespinosa/phecomp/data/CRG/20120502_FDF_CRG/20120502_FDF_CRG/20120509_FDF_CRG_c12.mtb	2439	COLL	WWFF	food_fat	4	129169	1336682857	1	0.0999999999999996	0.00357142857142856	9548	1
4	Food 1	Intake 3	22	129192	1336682880	/users/cn/jespinosa/phecomp/data/CRG/20120502_FDF_CRG/20120502_FDF_CRG/20120509_FDF_CRG_c12.mtb	1860	25	WWFF	food_fat	3	129170	1336682858	1	0.0599999999999987	0.00272727272727267	9549	1
4	Food 1	Intake 3	243	129460	1336683148	/users/cn/jespinosa/phecomp/data/CRG/20120502_FDF_CRG/20120502_FDF_CRG/20120509_FDF_CRG_c12.mtb	1861	14	WWFF	food_fat	3	129217	1336682905	1	0.100000000000001	0.00041152263374486	9550	1
4	Food 1	Intake 3	107	129581	1336683269	/users/cn/jespinosa/phecomp/data/CRG/20120502_FDF_CRG/20120502_FDF_CRG/20120509_FDF_CRG_c12.mtb	1862	206	WWFF	food_fat	3	129474	1336683162	1	0.119999999999997	0.00112149532710278	9551	1
4	Food 2	Intake 4	60	129847	1336683535	/users/cn/jespinosa/phecomp/data/CRG/20120502_FDF_CRG/20120502_FDF_CRG/20120509_FDF_CRG_c12.mtb	2443	78	WWFF	food_fat	4	129787	1336683475	1	0.0800000000000001	0.00133333333333334	9552	1
4	Drink 2	Intake 2	26	129867	1336683555	/users/cn/jespinosa/phecomp/data/CRG/20120502_FDF_CRG/20120502_FDF_CRG/20120509_FDF_CRG_c12.mtb	1206	NA	WWFF	water	2	129841	1336683529	1	0.0399999999999999	0.00153846153846153	9553	1
4	Drink 1	Intake 1	47	129902	1336683590	/users/cn/jespinosa/phecomp/data/CRG/20120502_FDF_CRG/20120502_FDF_CRG/20120509_FDF_CRG_c12.mtb	1275	NA	WWFF	water	1	129855	1336683543	1	0.02	0.000425531914893617	9554	1
4	Food 1	Intake 3	26	129951	1336683639	/users/cn/jespinosa/phecomp/data/CRG/20120502_FDF_CRG/20120502_FDF_CRG/20120509_FDF_CRG_c12.mtb	1865	27	WWFF	food_fat	3	129925	1336683613	1	0.0200000000000031	0.000769230769230888	9555	1
4	Food 2	Intake 4	389	130367	1336684055	/users/cn/jespinosa/phecomp/data/CRG/20120502_FDF_CRG/20120502_FDF_CRG/20120509_FDF_CRG_c12.mtb	2445	COLL	WWFF	food_fat	4	129978	1336683666	1	0.380000000000001	0.00097686375321337	9556	1
4	Food 1	Intake 3	157	130136	1336683824	/users/cn/jespinosa/phecomp/data/CRG/20120502_FDF_CRG/20120502_FDF_CRG/20120509_FDF_CRG_c12.mtb	1866	59	WWFF	food_fat	3	129979	1336683667	1	0.0399999999999991	0.000254777070063689	9557	1
4	Food 1	Intake 3	170	130365	1336684053	/users/cn/jespinosa/phecomp/data/CRG/20120502_FDF_CRG/20120502_FDF_CRG/20120509_FDF_CRG_c12.mtb	1867	78	WWFF	food_fat	3	130195	1336683883	1	0.120000000000001	0.000705882352941182	9558	1
4	Food 2	Intake 4	139	130582	1336684270	/users/cn/jespinosa/phecomp/data/CRG/20120502_FDF_CRG/20120502_FDF_CRG/20120509_FDF_CRG_c12.mtb	2446	229	WWFF	food_fat	4	130443	1336684131	1	0.199999999999999	0.0014388489208633	9559	1
4	Food 1	Intake 3	250	131061	1336684749	/users/cn/jespinosa/phecomp/data/CRG/20120502_FDF_CRG/20120502_FDF_CRG/20120509_FDF_CRG_c12.mtb	1870	COLL	WWFF	food_fat	3	130811	1336684499	1	0.16	0.00064	9560	1
4	Food 2	Intake 4	251	131063	1336684751	/users/cn/jespinosa/phecomp/data/CRG/20120502_FDF_CRG/20120502_FDF_CRG/20120509_FDF_CRG_c12.mtb	2448	127	WWFF	food_fat	4	130812	1336684500	1	0.559999999999999	0.00223107569721115	9561	1
4	Food 2	Intake 4	134	131324	1336685012	/users/cn/jespinosa/phecomp/data/CRG/20120502_FDF_CRG/20120502_FDF_CRG/20120509_FDF_CRG_c12.mtb	2449	6	WWFF	food_fat	4	131190	1336684878	1	0.0600000000000005	0.000447761194029854	9562	1
4	Drink 2	Intake 2	78	131391	1336685079	/users/cn/jespinosa/phecomp/data/CRG/20120502_FDF_CRG/20120502_FDF_CRG/20120509_FDF_CRG_c12.mtb	1209	NA	WWFF	water	2	131313	1336685001	1	0.1	0.00128205128205128	9563	1
4	Food 2	Intake 4	340	131670	1336685358	/users/cn/jespinosa/phecomp/data/CRG/20120502_FDF_CRG/20120502_FDF_CRG/20120509_FDF_CRG_c12.mtb	2450	COLL	WWFF	food_fat	4	131330	1336685018	1	0.200000000000001	0.00058823529411765	9564	1
4	Drink 1	Intake 1	19	131398	1336685086	/users/cn/jespinosa/phecomp/data/CRG/20120502_FDF_CRG/20120502_FDF_CRG/20120509_FDF_CRG_c12.mtb	1277	NA	WWFF	water	1	131379	1336685067	1	0.02	0.00105263157894737	9565	1
4	Food 1	Intake 3	144	131670	1336685358	/users/cn/jespinosa/phecomp/data/CRG/20120502_FDF_CRG/20120502_FDF_CRG/20120509_FDF_CRG_c12.mtb	1873	156	WWFF	food_fat	3	131526	1336685214	1	0.0599999999999987	0.000416666666666658	9566	1
4	Food 1	Intake 3	127	131953	1336685641	/users/cn/jespinosa/phecomp/data/CRG/20120502_FDF_CRG/20120502_FDF_CRG/20120509_FDF_CRG_c12.mtb	1875	213	WWFF	food_fat	3	131826	1336685514	1	0.0400000000000027	0.000314960629921281	9567	1
4	Food 1	Intake 3	159	132325	1336686013	/users/cn/jespinosa/phecomp/data/CRG/20120502_FDF_CRG/20120502_FDF_CRG/20120509_FDF_CRG_c12.mtb	1878	COLL	WWFF	food_fat	3	132166	1336685854	1	0.0799999999999983	0.00050314465408804	9568	1
4	Food 2	Intake 4	159	132326	1336686014	/users/cn/jespinosa/phecomp/data/CRG/20120502_FDF_CRG/20120502_FDF_CRG/20120509_FDF_CRG_c12.mtb	2452	63	WWFF	food_fat	4	132167	1336685855	1	0.4	0.00251572327044025	9569	1
4	Food 2	Intake 4	192	132581	1336686269	/users/cn/jespinosa/phecomp/data/CRG/20120502_FDF_CRG/20120502_FDF_CRG/20120509_FDF_CRG_c12.mtb	2453	36	WWFF	food_fat	4	132389	1336686077	1	1	0.00520833333333333	9570	1
4	Food 2	Intake 4	263	132880	1336686568	/users/cn/jespinosa/phecomp/data/CRG/20120502_FDF_CRG/20120502_FDF_CRG/20120509_FDF_CRG_c12.mtb	2454	110	WWFF	food_fat	4	132617	1336686305	1	1.82	0.00692015209125475	9571	1
4	Drink 2	Intake 2	49	133003	1336686691	/users/cn/jespinosa/phecomp/data/CRG/20120502_FDF_CRG/20120502_FDF_CRG/20120509_FDF_CRG_c12.mtb	1211	NA	WWFF	water	2	132954	1336686642	1	0.0800000000000001	0.00163265306122449	9572	1
4	Food 2	Intake 4	363	133353	1336687041	/users/cn/jespinosa/phecomp/data/CRG/20120502_FDF_CRG/20120502_FDF_CRG/20120509_FDF_CRG_c12.mtb	2456	269	WWFF	food_fat	4	132990	1336686678	1	3.5	0.00964187327823691	9573	1
4	Food 2	Intake 4	397	134019	1336687707	/users/cn/jespinosa/phecomp/data/CRG/20120502_FDF_CRG/20120502_FDF_CRG/20120509_FDF_CRG_c12.mtb	2457	12	WWFF	food_fat	4	133622	1336687310	1	1.02	0.00256926952141058	9574	1
4	Food 2	Intake 4	30	134061	1336687749	/users/cn/jespinosa/phecomp/data/CRG/20120502_FDF_CRG/20120502_FDF_CRG/20120509_FDF_CRG_c12.mtb	2458	57	WWFF	food_fat	4	134031	1336687719	1	0.18	0.006	9575	1
4	Food 2	Intake 4	142	134260	1336687948	/users/cn/jespinosa/phecomp/data/CRG/20120502_FDF_CRG/20120502_FDF_CRG/20120509_FDF_CRG_c12.mtb	2460	25	WWFF	food_fat	4	134118	1336687806	1	0.0200000000000031	0.000140845070422557	9576	1
4	Food 2	Intake 4	51	134336	1336688024	/users/cn/jespinosa/phecomp/data/CRG/20120502_FDF_CRG/20120502_FDF_CRG/20120509_FDF_CRG_c12.mtb	2461	229	WWFF	food_fat	4	134285	1336687973	1	0.0799999999999983	0.00156862745098036	9577	1
4	Food 2	Intake 4	725	135290	1336688978	/users/cn/jespinosa/phecomp/data/CRG/20120502_FDF_CRG/20120502_FDF_CRG/20120509_FDF_CRG_c12.mtb	2463	COLL	WWFF	food_fat	4	134565	1336688253	1	0.640000000000001	0.000882758620689657	9578	1
4	Food 1	Intake 3	366	135085	1336688773	/users/cn/jespinosa/phecomp/data/CRG/20120502_FDF_CRG/20120502_FDF_CRG/20120509_FDF_CRG_c12.mtb	1887	62	WWFF	food_fat	3	134719	1336688407	1	0.0399999999999991	0.000109289617486336	9579	1
4	Food 1	Intake 3	137	135284	1336688972	/users/cn/jespinosa/phecomp/data/CRG/20120502_FDF_CRG/20120502_FDF_CRG/20120509_FDF_CRG_c12.mtb	1890	1006	WWFF	food_fat	3	135147	1336688835	1	0.0600000000000023	0.000437956204379579	9580	1
4	Food 2	Intake 4	21	136311	1336689999	/users/cn/jespinosa/phecomp/data/CRG/20120502_FDF_CRG/20120502_FDF_CRG/20120509_FDF_CRG_c12.mtb	2471	165	WWFF	food_fat	4	136290	1336689978	1	0.0400000000000027	0.00190476190476203	9581	1
4	Food 2	Intake 4	80	136556	1336690244	/users/cn/jespinosa/phecomp/data/CRG/20120502_FDF_CRG/20120502_FDF_CRG/20120509_FDF_CRG_c12.mtb	2473	490	WWFF	food_fat	4	136476	1336690164	1	0.0799999999999983	0.000999999999999979	9582	1
4	Food 2	Intake 4	86	137132	1336690820	/users/cn/jespinosa/phecomp/data/CRG/20120502_FDF_CRG/20120502_FDF_CRG/20120509_FDF_CRG_c12.mtb	2481	261	WWFF	food_fat	4	137046	1336690734	1	0.0399999999999991	0.000465116279069757	9583	1
4	Food 1	Intake 3	31	137424	1336691112	/users/cn/jespinosa/phecomp/data/CRG/20120502_FDF_CRG/20120502_FDF_CRG/20120509_FDF_CRG_c12.mtb	1896	50	WWFF	food_fat	3	137393	1336691081	1	0.0399999999999991	0.00129032258064513	9584	1
4	Food 2	Intake 4	60	137534	1336691222	/users/cn/jespinosa/phecomp/data/CRG/20120502_FDF_CRG/20120502_FDF_CRG/20120509_FDF_CRG_c12.mtb	2483	COLL	WWFF	food_fat	4	137474	1336691162	1	0.48	0.008	9585	1
4	Food 1	Intake 3	30	137506	1336691194	/users/cn/jespinosa/phecomp/data/CRG/20120502_FDF_CRG/20120502_FDF_CRG/20120509_FDF_CRG_c12.mtb	1898	43	WWFF	food_fat	3	137476	1336691164	1	0.140000000000001	0.0046666666666667	9586	1
4	Food 1	Intake 3	50	137599	1336691287	/users/cn/jespinosa/phecomp/data/CRG/20120502_FDF_CRG/20120502_FDF_CRG/20120509_FDF_CRG_c12.mtb	1899	COLL	WWFF	food_fat	3	137549	1336691237	1	0.0599999999999987	0.00119999999999997	9587	1
4	Food 2	Intake 4	327	137877	1336691565	/users/cn/jespinosa/phecomp/data/CRG/20120502_FDF_CRG/20120502_FDF_CRG/20120509_FDF_CRG_c12.mtb	2484	COLL	WWFF	food_fat	4	137550	1336691238	1	0.120000000000001	0.000366972477064223	9588	1
4	Drink 1	Intake 1	17	137591	1336691279	/users/cn/jespinosa/phecomp/data/CRG/20120502_FDF_CRG/20120502_FDF_CRG/20120509_FDF_CRG_c12.mtb	1285	NA	WWFF	water	1	137574	1336691262	1	0.0600000000000005	0.00352941176470591	9589	1
4	Food 1	Intake 3	72	137746	1336691434	/users/cn/jespinosa/phecomp/data/CRG/20120502_FDF_CRG/20120502_FDF_CRG/20120509_FDF_CRG_c12.mtb	1901	260	WWFF	food_fat	3	137674	1336691362	1	0.0799999999999983	0.00111111111111109	9590	1
4	Food 2	Intake 4	22	138028	1336691716	/users/cn/jespinosa/phecomp/data/CRG/20120502_FDF_CRG/20120502_FDF_CRG/20120509_FDF_CRG_c12.mtb	2486	1656	WWFF	food_fat	4	138006	1336691694	1	0.0200000000000031	0.00090909090909105	9591	1
4	Drink 1	Intake 1	26	139176	1336692864	/users/cn/jespinosa/phecomp/data/CRG/20120502_FDF_CRG/20120502_FDF_CRG/20120509_FDF_CRG_c12.mtb	1287	NA	WWFF	water	1	139150	1336692838	1	0.0800000000000001	0.00307692307692308	9592	1
4	Food 2	Intake 4	38	139722	1336693410	/users/cn/jespinosa/phecomp/data/CRG/20120502_FDF_CRG/20120502_FDF_CRG/20120509_FDF_CRG_c12.mtb	2495	COLL	WWFF	food_fat	4	139684	1336693372	1	0.0399999999999991	0.00105263157894734	9593	1
4	Food 1	Intake 3	27	139712	1336693400	/users/cn/jespinosa/phecomp/data/CRG/20120502_FDF_CRG/20120502_FDF_CRG/20120509_FDF_CRG_c12.mtb	1904	308	WWFF	food_fat	3	139685	1336693373	1	0.0200000000000031	0.000740740740740856	9594	1
4	Food 2	Intake 4	28	140048	1336693736	/users/cn/jespinosa/phecomp/data/CRG/20120502_FDF_CRG/20120502_FDF_CRG/20120509_FDF_CRG_c12.mtb	2500	1038	WWFF	food_fat	4	140020	1336693708	1	0.16	0.00571428571428571	9595	1
4	Drink 1	Intake 1	18	140856	1336694544	/users/cn/jespinosa/phecomp/data/CRG/20120502_FDF_CRG/20120502_FDF_CRG/20120509_FDF_CRG_c12.mtb	1288	NA	WWFF	water	1	140838	1336694526	1	0.0800000000000001	0.00444444444444445	9596	1
4	Food 2	Intake 4	14	141100	1336694788	/users/cn/jespinosa/phecomp/data/CRG/20120502_FDF_CRG/20120502_FDF_CRG/20120509_FDF_CRG_c12.mtb	2503	299	WWFF	food_fat	4	141086	1336694774	1	0.0400000000000027	0.00285714285714305	9597	1
4	Food 2	Intake 4	24	141423	1336695111	/users/cn/jespinosa/phecomp/data/CRG/20120502_FDF_CRG/20120502_FDF_CRG/20120509_FDF_CRG_c12.mtb	2505	516	WWFF	food_fat	4	141399	1336695087	1	0.0400000000000027	0.00166666666666678	9598	1
4	Food 2	Intake 4	52	141991	1336695679	/users/cn/jespinosa/phecomp/data/CRG/20120502_FDF_CRG/20120502_FDF_CRG/20120509_FDF_CRG_c12.mtb	2510	86	WWFF	food_fat	4	141939	1336695627	1	0.0200000000000031	0.000384615384615444	9599	1
4	Food 2	Intake 4	43	142120	1336695808	/users/cn/jespinosa/phecomp/data/CRG/20120502_FDF_CRG/20120502_FDF_CRG/20120509_FDF_CRG_c12.mtb	2511	63	WWFF	food_fat	4	142077	1336695765	1	0.0999999999999979	0.00232558139534879	9600	1
4	Food 1	Intake 3	116	142299	1336695987	/users/cn/jespinosa/phecomp/data/CRG/20120502_FDF_CRG/20120502_FDF_CRG/20120509_FDF_CRG_c12.mtb	1908	COLL	WWFF	food_fat	3	142183	1336695871	1	0.0600000000000023	0.000517241379310365	9601	1
4	Food 2	Intake 4	120	142305	1336695993	/users/cn/jespinosa/phecomp/data/CRG/20120502_FDF_CRG/20120502_FDF_CRG/20120509_FDF_CRG_c12.mtb	2513	363	WWFF	food_fat	4	142185	1336695873	1	0.84	0.007	9602	1
4	Food 2	Intake 4	319	142987	1336696675	/users/cn/jespinosa/phecomp/data/CRG/20120502_FDF_CRG/20120502_FDF_CRG/20120509_FDF_CRG_c12.mtb	2515	COLL	WWFF	food_fat	4	142668	1336696356	1	0.18	0.000564263322884013	9603	1
4	Food 1	Intake 3	108	142777	1336696465	/users/cn/jespinosa/phecomp/data/CRG/20120502_FDF_CRG/20120502_FDF_CRG/20120509_FDF_CRG_c12.mtb	1910	234	WWFF	food_fat	3	142669	1336696357	1	0.120000000000001	0.00111111111111112	9604	1
4	Drink 1	Intake 1	16	142813	1336696501	/users/cn/jespinosa/phecomp/data/CRG/20120502_FDF_CRG/20120502_FDF_CRG/20120509_FDF_CRG_c12.mtb	1290	NA	WWFF	water	1	142797	1336696485	1	0.02	0.00125	9605	1
4	Food 2	Intake 4	80	143091	1336696779	/users/cn/jespinosa/phecomp/data/CRG/20120502_FDF_CRG/20120502_FDF_CRG/20120509_FDF_CRG_c12.mtb	2516	297	WWFF	food_fat	4	143011	1336696699	1	0.16	0.002	9606	1
4	Drink 2	Intake 2	36	143152	1336696840	/users/cn/jespinosa/phecomp/data/CRG/20120502_FDF_CRG/20120502_FDF_CRG/20120509_FDF_CRG_c12.mtb	1219	NA	WWFF	water	2	143116	1336696804	1	0.02	0.000555555555555556	9607	1
4	Food 2	Intake 4	743	144131	1336697819	/users/cn/jespinosa/phecomp/data/CRG/20120502_FDF_CRG/20120502_FDF_CRG/20120509_FDF_CRG_c12.mtb	2518	COLL	WWFF	food_fat	4	143388	1336697076	1	0.399999999999999	0.000538358008075369	9608	1
4	Food 1	Intake 3	65	143471	1336697159	/users/cn/jespinosa/phecomp/data/CRG/20120502_FDF_CRG/20120502_FDF_CRG/20120509_FDF_CRG_c12.mtb	1915	41	WWFF	food_fat	3	143406	1336697094	1	0.119999999999997	0.0018461538461538	9609	1
4	Drink 2	Intake 2	24	143496	1336697184	/users/cn/jespinosa/phecomp/data/CRG/20120502_FDF_CRG/20120502_FDF_CRG/20120509_FDF_CRG_c12.mtb	1222	NA	WWFF	water	2	143472	1336697160	1	0.02	0.000833333333333333	9610	1
4	Food 1	Intake 3	17	143529	1336697217	/users/cn/jespinosa/phecomp/data/CRG/20120502_FDF_CRG/20120502_FDF_CRG/20120509_FDF_CRG_c12.mtb	1916	707	WWFF	food_fat	3	143512	1336697200	1	0.0400000000000027	0.00235294117647075	9611	1
4	Food 2	Intake 4	639	144875	1336698563	/users/cn/jespinosa/phecomp/data/CRG/20120502_FDF_CRG/20120502_FDF_CRG/20120509_FDF_CRG_c12.mtb	2519	COLL	WWFF	food_fat	4	144236	1336697924	1	0.0599999999999987	9.38967136150214e-05	9612	1
4	Food 1	Intake 3	113	144354	1336698042	/users/cn/jespinosa/phecomp/data/CRG/20120502_FDF_CRG/20120502_FDF_CRG/20120509_FDF_CRG_c12.mtb	1920	210	WWFF	food_fat	3	144241	1336697929	1	0.0400000000000027	0.00035398230088498	9613	1
4	Drink 2	Intake 2	17	144394	1336698082	/users/cn/jespinosa/phecomp/data/CRG/20120502_FDF_CRG/20120502_FDF_CRG/20120509_FDF_CRG_c12.mtb	1224	NA	WWFF	water	2	144377	1336698065	1	0.0800000000000001	0.00470588235294118	9614	1
4	Food 1	Intake 3	182	144746	1336698434	/users/cn/jespinosa/phecomp/data/CRG/20120502_FDF_CRG/20120502_FDF_CRG/20120509_FDF_CRG_c12.mtb	1926	172	WWFF	food_fat	3	144564	1336698252	1	0.0399999999999991	0.000219780219780215	9615	1
4	Food 2	Intake 4	242	145160	1336698848	/users/cn/jespinosa/phecomp/data/CRG/20120502_FDF_CRG/20120502_FDF_CRG/20120509_FDF_CRG_c12.mtb	2520	851	WWFF	food_fat	4	144918	1336698606	1	0.0600000000000023	0.00024793388429753	9616	1
4	Food 1	Intake 3	133	146144	1336699832	/users/cn/jespinosa/phecomp/data/CRG/20120502_FDF_CRG/20120502_FDF_CRG/20120509_FDF_CRG_c12.mtb	1931	107	WWFF	food_fat	3	146011	1336699699	1	0.0400000000000027	0.000300751879699268	9617	1
4	Food 2	Intake 4	856	147107	1336700795	/users/cn/jespinosa/phecomp/data/CRG/20120502_FDF_CRG/20120502_FDF_CRG/20120509_FDF_CRG_c12.mtb	2527	COLL	WWFF	food_fat	4	146251	1336699939	1	0.18	0.000210280373831776	9618	1
4	Food 1	Intake 3	158	146451	1336700139	/users/cn/jespinosa/phecomp/data/CRG/20120502_FDF_CRG/20120502_FDF_CRG/20120509_FDF_CRG_c12.mtb	1935	170	WWFF	food_fat	3	146293	1336699981	1	0.0800000000000018	0.000506329113924062	9619	1
4	Food 1	Intake 3	78	146699	1336700387	/users/cn/jespinosa/phecomp/data/CRG/20120502_FDF_CRG/20120502_FDF_CRG/20120509_FDF_CRG_c12.mtb	1938	790	WWFF	food_fat	3	146621	1336700309	1	0.0399999999999991	0.000512820512820501	9620	1
4	Food 2	Intake 4	307	147796	1336701484	/users/cn/jespinosa/phecomp/data/CRG/20120502_FDF_CRG/20120502_FDF_CRG/20120509_FDF_CRG_c12.mtb	2528	280	WWFF	food_fat	4	147489	1336701177	1	0.0399999999999991	0.000130293159609118	9621	1
4	Drink 2	Intake 2	42	147679	1336701367	/users/cn/jespinosa/phecomp/data/CRG/20120502_FDF_CRG/20120502_FDF_CRG/20120509_FDF_CRG_c12.mtb	1227	NA	WWFF	water	2	147637	1336701325	1	0.0800000000000001	0.00190476190476191	9622	1
4	Food 2	Intake 4	590	148666	1336702354	/users/cn/jespinosa/phecomp/data/CRG/20120502_FDF_CRG/20120502_FDF_CRG/20120509_FDF_CRG_c12.mtb	2530	966	WWFF	food_fat	4	148076	1336701764	1	0.0400000000000027	6.77966101694961e-05	9623	1
4	Food 2	Intake 4	19	149651	1336703339	/users/cn/jespinosa/phecomp/data/CRG/20120502_FDF_CRG/20120502_FDF_CRG/20120509_FDF_CRG_c12.mtb	2532	1724	WWFF	food_fat	4	149632	1336703320	1	0.0600000000000023	0.00315789473684223	9624	1
4	Food 2	Intake 4	151	151526	1336705214	/users/cn/jespinosa/phecomp/data/CRG/20120502_FDF_CRG/20120502_FDF_CRG/20120509_FDF_CRG_c12.mtb	2537	COLL	WWFF	food_fat	4	151375	1336705063	1	0.0399999999999991	0.00026490066225165	9625	1
4	Drink 2	Intake 2	23	151405	1336705093	/users/cn/jespinosa/phecomp/data/CRG/20120502_FDF_CRG/20120502_FDF_CRG/20120509_FDF_CRG_c12.mtb	1228	NA	WWFF	water	2	151382	1336705070	1	0.02	0.000869565217391304	9626	1
4	Food 1	Intake 3	100	151521	1336705209	/users/cn/jespinosa/phecomp/data/CRG/20120502_FDF_CRG/20120502_FDF_CRG/20120509_FDF_CRG_c12.mtb	1953	352	WWFF	food_fat	3	151421	1336705109	1	0.100000000000001	0.00100000000000001	9627	1
4	Food 2	Intake 4	301	152174	1336705862	/users/cn/jespinosa/phecomp/data/CRG/20120502_FDF_CRG/20120502_FDF_CRG/20120509_FDF_CRG_c12.mtb	2539	COLL	WWFF	food_fat	4	151873	1336705561	1	0.280000000000001	0.000930232558139538	9628	1
4	Food 1	Intake 3	25	152142	1336705830	/users/cn/jespinosa/phecomp/data/CRG/20120502_FDF_CRG/20120502_FDF_CRG/20120509_FDF_CRG_c12.mtb	1957	14	WWFF	food_fat	3	152117	1336705805	1	0.0399999999999991	0.00159999999999996	9629	1
4	Food 1	Intake 3	15	152171	1336705859	/users/cn/jespinosa/phecomp/data/CRG/20120502_FDF_CRG/20120502_FDF_CRG/20120509_FDF_CRG_c12.mtb	1958	8	WWFF	food_fat	3	152156	1336705844	1	0.0800000000000018	0.00533333333333345	9630	1
4	Food 2	Intake 4	152	152331	1336706019	/users/cn/jespinosa/phecomp/data/CRG/20120502_FDF_CRG/20120502_FDF_CRG/20120509_FDF_CRG_c12.mtb	2540	COLL	WWFF	food_fat	4	152179	1336705867	1	0.100000000000001	0.000657894736842112	9631	1
4	Food 1	Intake 3	126	152324	1336706012	/users/cn/jespinosa/phecomp/data/CRG/20120502_FDF_CRG/20120502_FDF_CRG/20120509_FDF_CRG_c12.mtb	1959	541	WWFF	food_fat	3	152198	1336705886	1	0.0399999999999991	0.00031746031746031	9632	1
4	Drink 1	Intake 1	23	152250	1336705938	/users/cn/jespinosa/phecomp/data/CRG/20120502_FDF_CRG/20120502_FDF_CRG/20120509_FDF_CRG_c12.mtb	1297	NA	WWFF	water	1	152227	1336705915	1	0.02	0.000869565217391304	9633	1
4	Drink 1	Intake 1	22	152555	1336706243	/users/cn/jespinosa/phecomp/data/CRG/20120502_FDF_CRG/20120502_FDF_CRG/20120509_FDF_CRG_c12.mtb	1298	NA	WWFF	water	1	152533	1336706221	1	0.12	0.00545454545454545	9634	1
4	Food 2	Intake 4	209	153074	1336706762	/users/cn/jespinosa/phecomp/data/CRG/20120502_FDF_CRG/20120502_FDF_CRG/20120509_FDF_CRG_c12.mtb	2543	COLL	WWFF	food_fat	4	152865	1336706553	1	0.0800000000000018	0.000382775119617234	9635	1
4	Food 1	Intake 3	23	152899	1336706587	/users/cn/jespinosa/phecomp/data/CRG/20120502_FDF_CRG/20120502_FDF_CRG/20120509_FDF_CRG_c12.mtb	1960	3235	WWFF	food_fat	3	152876	1336706564	1	0.0399999999999991	0.00173913043478257	9636	1
4	Drink 1	Intake 1	17	155415	1336709103	/users/cn/jespinosa/phecomp/data/CRG/20120502_FDF_CRG/20120502_FDF_CRG/20120509_FDF_CRG_c12.mtb	1300	NA	WWFF	water	1	155398	1336709086	1	0.0800000000000001	0.00470588235294118	9637	1
4	Food 2	Intake 4	110	156244	1336709932	/users/cn/jespinosa/phecomp/data/CRG/20120502_FDF_CRG/20120502_FDF_CRG/20120509_FDF_CRG_c12.mtb	2554	155	WWFF	food_fat	4	156134	1336709822	1	0.0600000000000023	0.000545454545454566	9638	1
4	Food 1	Intake 3	102	156501	1336710189	/users/cn/jespinosa/phecomp/data/CRG/20120502_FDF_CRG/20120502_FDF_CRG/20120509_FDF_CRG_c12.mtb	1968	310	WWFF	food_fat	3	156399	1336710087	1	0.16	0.00156862745098039	9639	1
4	Drink 2	Intake 2	39	156541	1336710229	/users/cn/jespinosa/phecomp/data/CRG/20120502_FDF_CRG/20120502_FDF_CRG/20120509_FDF_CRG_c12.mtb	1232	NA	WWFF	water	2	156502	1336710190	1	0.04	0.00102564102564103	9640	1
4	Food 2	Intake 4	91	156902	1336710590	/users/cn/jespinosa/phecomp/data/CRG/20120502_FDF_CRG/20120502_FDF_CRG/20120509_FDF_CRG_c12.mtb	2558	COLL	WWFF	food_fat	4	156811	1336710499	1	0.140000000000001	0.00153846153846155	9641	1
4	Food 1	Intake 3	78	156890	1336710578	/users/cn/jespinosa/phecomp/data/CRG/20120502_FDF_CRG/20120502_FDF_CRG/20120509_FDF_CRG_c12.mtb	1972	79	WWFF	food_fat	3	156812	1336710500	1	0.0999999999999979	0.00128205128205126	9642	1
4	Food 1	Intake 3	13	156982	1336710670	/users/cn/jespinosa/phecomp/data/CRG/20120502_FDF_CRG/20120502_FDF_CRG/20120509_FDF_CRG_c12.mtb	1973	64	WWFF	food_fat	3	156969	1336710657	1	0.0600000000000023	0.00461538461538479	9643	1
4	Food 1	Intake 3	20	157066	1336710754	/users/cn/jespinosa/phecomp/data/CRG/20120502_FDF_CRG/20120502_FDF_CRG/20120509_FDF_CRG_c12.mtb	1975	14	WWFF	food_fat	3	157046	1336710734	1	0.0599999999999987	0.00299999999999994	9644	1
4	Food 1	Intake 3	48	157128	1336710816	/users/cn/jespinosa/phecomp/data/CRG/20120502_FDF_CRG/20120502_FDF_CRG/20120509_FDF_CRG_c12.mtb	1976	56	WWFF	food_fat	3	157080	1336710768	1	0.0600000000000023	0.00125000000000005	9645	1
4	Food 1	Intake 3	54	157238	1336710926	/users/cn/jespinosa/phecomp/data/CRG/20120502_FDF_CRG/20120502_FDF_CRG/20120509_FDF_CRG_c12.mtb	1977	874	WWFF	food_fat	3	157184	1336710872	1	0.0399999999999991	0.000740740740740724	9646	1
4	Drink 1	Intake 1	18	157760	1336711448	/users/cn/jespinosa/phecomp/data/CRG/20120502_FDF_CRG/20120502_FDF_CRG/20120509_FDF_CRG_c12.mtb	1301	NA	WWFF	water	1	157742	1336711430	1	0.0599999999999996	0.00333333333333331	9647	1
4	Food 1	Intake 3	14	158126	1336711814	/users/cn/jespinosa/phecomp/data/CRG/20120502_FDF_CRG/20120502_FDF_CRG/20120509_FDF_CRG_c12.mtb	1979	614	WWFF	food_fat	3	158112	1336711800	1	0.120000000000001	0.00857142857142864	9648	1
4	Food 2	Intake 4	28	158768	1336712456	/users/cn/jespinosa/phecomp/data/CRG/20120502_FDF_CRG/20120502_FDF_CRG/20120509_FDF_CRG_c12.mtb	2564	624	WWFF	food_fat	4	158740	1336712428	1	0.0599999999999987	0.0021428571428571	9649	1
4	Food 2	Intake 4	100	159492	1336713180	/users/cn/jespinosa/phecomp/data/CRG/20120502_FDF_CRG/20120502_FDF_CRG/20120509_FDF_CRG_c12.mtb	2567	COLL	WWFF	food_fat	4	159392	1336713080	1	0.0400000000000027	0.000400000000000027	9650	1
4	Food 1	Intake 3	60	159461	1336713149	/users/cn/jespinosa/phecomp/data/CRG/20120502_FDF_CRG/20120502_FDF_CRG/20120509_FDF_CRG_c12.mtb	1982	48	WWFF	food_fat	3	159401	1336713089	1	0.0399999999999991	0.000666666666666652	9651	1
4	Food 1	Intake 3	13	159522	1336713210	/users/cn/jespinosa/phecomp/data/CRG/20120502_FDF_CRG/20120502_FDF_CRG/20120509_FDF_CRG_c12.mtb	1983	341	WWFF	food_fat	3	159509	1336713197	1	0.0200000000000031	0.00153846153846178	9652	1
4	Food 2	Intake 4	20	159883	1336713571	/users/cn/jespinosa/phecomp/data/CRG/20120502_FDF_CRG/20120502_FDF_CRG/20120509_FDF_CRG_c12.mtb	2569	6	WWFF	food_fat	4	159863	1336713551	1	0.140000000000001	0.00700000000000005	9653	1
4	Food 2	Intake 4	306	160195	1336713883	/users/cn/jespinosa/phecomp/data/CRG/20120502_FDF_CRG/20120502_FDF_CRG/20120509_FDF_CRG_c12.mtb	2570	18	WWFF	food_fat	4	159889	1336713577	1	0.0600000000000023	0.000196078431372557	9654	1
4	Drink 2	Intake 2	19	160165	1336713853	/users/cn/jespinosa/phecomp/data/CRG/20120502_FDF_CRG/20120502_FDF_CRG/20120509_FDF_CRG_c12.mtb	1234	NA	WWFF	water	2	160146	1336713834	1	0.0600000000000001	0.00315789473684211	9655	1
4	Food 2	Intake 4	12	160225	1336713913	/users/cn/jespinosa/phecomp/data/CRG/20120502_FDF_CRG/20120502_FDF_CRG/20120509_FDF_CRG_c12.mtb	2571	232	WWFF	food_fat	4	160213	1336713901	1	0.0399999999999991	0.00333333333333326	9656	1
4	Food 1	Intake 3	73	160530	1336714218	/users/cn/jespinosa/phecomp/data/CRG/20120502_FDF_CRG/20120502_FDF_CRG/20120509_FDF_CRG_c12.mtb	1989	COLL	WWFF	food_fat	3	160457	1336714145	1	0.0799999999999983	0.00109589041095888	9657	1
4	Food 2	Intake 4	175	160633	1336714321	/users/cn/jespinosa/phecomp/data/CRG/20120502_FDF_CRG/20120502_FDF_CRG/20120509_FDF_CRG_c12.mtb	2574	43	WWFF	food_fat	4	160458	1336714146	1	0.16	0.000914285714285714	9658	1
4	Food 2	Intake 4	363	161039	1336714727	/users/cn/jespinosa/phecomp/data/CRG/20120502_FDF_CRG/20120502_FDF_CRG/20120509_FDF_CRG_c12.mtb	2575	364	WWFF	food_fat	4	160676	1336714364	1	0.199999999999999	0.000550964187327821	9659	1
4	Drink 2	Intake 2	22	160726	1336714414	/users/cn/jespinosa/phecomp/data/CRG/20120502_FDF_CRG/20120502_FDF_CRG/20120509_FDF_CRG_c12.mtb	1236	NA	WWFF	water	2	160704	1336714392	1	0.0600000000000001	0.00272727272727273	9660	1
4	Drink 2	Intake 2	20	160830	1336714518	/users/cn/jespinosa/phecomp/data/CRG/20120502_FDF_CRG/20120502_FDF_CRG/20120509_FDF_CRG_c12.mtb	1238	NA	WWFF	water	2	160810	1336714498	1	0.0399999999999998	0.00199999999999999	9661	1
4	Food 2	Intake 4	28	161431	1336715119	/users/cn/jespinosa/phecomp/data/CRG/20120502_FDF_CRG/20120502_FDF_CRG/20120509_FDF_CRG_c12.mtb	2577	153	WWFF	food_fat	4	161403	1336715091	1	0.100000000000001	0.00357142857142861	9662	1
4	Food 2	Intake 4	24	161608	1336715296	/users/cn/jespinosa/phecomp/data/CRG/20120502_FDF_CRG/20120502_FDF_CRG/20120509_FDF_CRG_c12.mtb	2579	COLL	WWFF	food_fat	4	161584	1336715272	1	0.0999999999999979	0.00416666666666658	9663	1
4	Food 1	Intake 3	12	161605	1336715293	/users/cn/jespinosa/phecomp/data/CRG/20120502_FDF_CRG/20120502_FDF_CRG/20120509_FDF_CRG_c12.mtb	2005	88	WWFF	food_fat	3	161593	1336715281	1	0.0599999999999987	0.00499999999999989	9664	1
4	Food 2	Intake 4	141	161834	1336715522	/users/cn/jespinosa/phecomp/data/CRG/20120502_FDF_CRG/20120502_FDF_CRG/20120509_FDF_CRG_c12.mtb	2581	COLL	WWFF	food_fat	4	161693	1336715381	1	0.0399999999999991	0.000283687943262405	9665	1
4	Food 1	Intake 3	51	161800	1336715488	/users/cn/jespinosa/phecomp/data/CRG/20120502_FDF_CRG/20120502_FDF_CRG/20120509_FDF_CRG_c12.mtb	2008	2179	WWFF	food_fat	3	161749	1336715437	1	0.0200000000000031	0.000392156862745159	9666	1
4	Drink 1	Intake 1	15	163526	1336717214	/users/cn/jespinosa/phecomp/data/CRG/20120502_FDF_CRG/20120502_FDF_CRG/20120509_FDF_CRG_c12.mtb	1304	NA	WWFF	water	1	163511	1336717199	1	0.04	0.00266666666666667	9667	1
4	Food 2	Intake 4	13	163992	1336717680	/users/cn/jespinosa/phecomp/data/CRG/20120502_FDF_CRG/20120502_FDF_CRG/20120509_FDF_CRG_c12.mtb	2587	212	WWFF	food_fat	4	163979	1336717667	1	0.0800000000000018	0.00615384615384629	9668	1
4	Food 2	Intake 4	30	164234	1336717922	/users/cn/jespinosa/phecomp/data/CRG/20120502_FDF_CRG/20120502_FDF_CRG/20120509_FDF_CRG_c12.mtb	2588	1171	WWFF	food_fat	4	164204	1336717892	1	0.0599999999999987	0.00199999999999996	9669	1
4	Food 2	Intake 4	316	165721	1336719409	/users/cn/jespinosa/phecomp/data/CRG/20120502_FDF_CRG/20120502_FDF_CRG/20120509_FDF_CRG_c12.mtb	2592	COLL	WWFF	food_fat	4	165405	1336719093	1	0.0600000000000023	0.000189873417721526	9670	1
4	Food 1	Intake 3	65	165536	1336719224	/users/cn/jespinosa/phecomp/data/CRG/20120502_FDF_CRG/20120502_FDF_CRG/20120509_FDF_CRG_c12.mtb	2014	17	WWFF	food_fat	3	165471	1336719159	1	0.120000000000001	0.00184615384615386	9671	1
4	Food 1	Intake 3	147	165700	1336719388	/users/cn/jespinosa/phecomp/data/CRG/20120502_FDF_CRG/20120502_FDF_CRG/20120509_FDF_CRG_c12.mtb	2015	950	WWFF	food_fat	3	165553	1336719241	1	0.0399999999999991	0.000272108843537409	9672	1
4	Drink 1	Intake 1	26	166659	1336720347	/users/cn/jespinosa/phecomp/data/CRG/20120502_FDF_CRG/20120502_FDF_CRG/20120509_FDF_CRG_c12.mtb	1305	NA	WWFF	water	1	166633	1336720321	1	0.14	0.00538461538461539	9673	1
4	Food 2	Intake 4	13	166663	1336720351	/users/cn/jespinosa/phecomp/data/CRG/20120502_FDF_CRG/20120502_FDF_CRG/20120509_FDF_CRG_c12.mtb	2598	574	WWFF	food_fat	4	166650	1336720338	1	0.0399999999999991	0.00307692307692301	9674	1
4	Food 2	Intake 4	19	167256	1336720944	/users/cn/jespinosa/phecomp/data/CRG/20120502_FDF_CRG/20120502_FDF_CRG/20120509_FDF_CRG_c12.mtb	2599	625	WWFF	food_fat	4	167237	1336720925	1	0.0399999999999991	0.00210526315789469	9675	1
4	Food 2	Intake 4	14	167895	1336721583	/users/cn/jespinosa/phecomp/data/CRG/20120502_FDF_CRG/20120502_FDF_CRG/20120509_FDF_CRG_c12.mtb	2601	285	WWFF	food_fat	4	167881	1336721569	1	0.0399999999999991	0.00285714285714279	9676	1
4	Food 2	Intake 4	23	168203	1336721891	/users/cn/jespinosa/phecomp/data/CRG/20120502_FDF_CRG/20120502_FDF_CRG/20120509_FDF_CRG_c12.mtb	2602	386	WWFF	food_fat	4	168180	1336721868	1	0.0200000000000031	0.000869565217391439	9677	1
4	Food 2	Intake 4	24	168613	1336722301	/users/cn/jespinosa/phecomp/data/CRG/20120502_FDF_CRG/20120502_FDF_CRG/20120509_FDF_CRG_c12.mtb	2605	8911	WWFF	food_fat	4	168589	1336722277	1	0.0599999999999987	0.00249999999999995	9678	1
4	Food 1	Intake 3	16	363	1336731228	/users/cn/jespinosa/phecomp/data/CRG/20120502_FDF_CRG/20120502_FDF_CRG/20120511_FDF_CRG_c12.mtb	2703	COLL	WWFF	food_fat	3	347	1336731212	1	0.32	0.02	9679	1
4	Food 2	Intake 4	77	430	1336731295	/users/cn/jespinosa/phecomp/data/CRG/20120502_FDF_CRG/20120502_FDF_CRG/20120511_FDF_CRG_c12.mtb	3402	COLL	WWFF	food_fat	4	353	1336731218	1	0.3	0.0038961038961039	9680	1
4	Food 1	Intake 3	42	450	1336731315	/users/cn/jespinosa/phecomp/data/CRG/20120502_FDF_CRG/20120502_FDF_CRG/20120511_FDF_CRG_c12.mtb	2704	COLL	WWFF	food_fat	3	408	1336731273	1	0.88	0.020952380952381	9681	1
4	Food 2	Intake 4	65	504	1336731369	/users/cn/jespinosa/phecomp/data/CRG/20120502_FDF_CRG/20120502_FDF_CRG/20120511_FDF_CRG_c12.mtb	3403	COLL	WWFF	food_fat	4	439	1336731304	1	0.1	0.00153846153846154	9682	1
4	Food 1	Intake 3	21	487	1336731352	/users/cn/jespinosa/phecomp/data/CRG/20120502_FDF_CRG/20120502_FDF_CRG/20120511_FDF_CRG_c12.mtb	2705	5	WWFF	food_fat	3	466	1336731331	1	0.0800000000000001	0.00380952380952381	9683	1
4	Food 1	Intake 3	77	569	1336731434	/users/cn/jespinosa/phecomp/data/CRG/20120502_FDF_CRG/20120502_FDF_CRG/20120511_FDF_CRG_c12.mtb	2706	COLL	WWFF	food_fat	3	492	1336731357	1	0.76	0.00987012987012987	9684	1
4	Food 2	Intake 4	28	542	1336731407	/users/cn/jespinosa/phecomp/data/CRG/20120502_FDF_CRG/20120502_FDF_CRG/20120511_FDF_CRG_c12.mtb	3404	43	WWFF	food_fat	4	514	1336731379	1	0.02	0.000714285714285714	9685	1
4	Food 2	Intake 4	93	678	1336731543	/users/cn/jespinosa/phecomp/data/CRG/20120502_FDF_CRG/20120502_FDF_CRG/20120511_FDF_CRG_c12.mtb	3405	COLL	WWFF	food_fat	4	585	1336731450	1	0.0800000000000001	0.000860215053763442	9686	1
4	Food 1	Intake 3	16	606	1336731471	/users/cn/jespinosa/phecomp/data/CRG/20120502_FDF_CRG/20120502_FDF_CRG/20120511_FDF_CRG_c12.mtb	2707	90	WWFF	food_fat	3	590	1336731455	1	0.02	0.00125	9687	1
4	Food 2	Intake 4	186	882	1336731747	/users/cn/jespinosa/phecomp/data/CRG/20120502_FDF_CRG/20120502_FDF_CRG/20120511_FDF_CRG_c12.mtb	3406	COLL	WWFF	food_fat	4	696	1336731561	1	0.14	0.000752688172043011	9688	1
4	Food 1	Intake 3	209	906	1336731771	/users/cn/jespinosa/phecomp/data/CRG/20120502_FDF_CRG/20120502_FDF_CRG/20120511_FDF_CRG_c12.mtb	2709	113	WWFF	food_fat	3	697	1336731562	1	0.88	0.00421052631578947	9689	1
4	Food 2	Intake 4	149	1168	1336732033	/users/cn/jespinosa/phecomp/data/CRG/20120502_FDF_CRG/20120502_FDF_CRG/20120511_FDF_CRG_c12.mtb	3408	155	WWFF	food_fat	4	1019	1336731884	1	0.02	0.000134228187919463	9690	1
4	Drink 1	Intake 1	19	1161	1336732026	/users/cn/jespinosa/phecomp/data/CRG/20120502_FDF_CRG/20120502_FDF_CRG/20120511_FDF_CRG_c12.mtb	1480	NA	WWFF	water	1	1142	1336732007	1	0.08	0.00421052631578947	9691	1
4	Food 2	Intake 4	619	1942	1336732807	/users/cn/jespinosa/phecomp/data/CRG/20120502_FDF_CRG/20120502_FDF_CRG/20120511_FDF_CRG_c12.mtb	3410	COLL	WWFF	food_fat	4	1323	1336732188	1	0.36	0.000581583198707593	9692	1
4	Food 1	Intake 3	89	1893	1336732758	/users/cn/jespinosa/phecomp/data/CRG/20120502_FDF_CRG/20120502_FDF_CRG/20120511_FDF_CRG_c12.mtb	2716	277	WWFF	food_fat	3	1804	1336732669	1	0.12	0.00134831460674157	9693	1
4	Food 1	Intake 3	32	2202	1336733067	/users/cn/jespinosa/phecomp/data/CRG/20120502_FDF_CRG/20120502_FDF_CRG/20120511_FDF_CRG_c12.mtb	2721	578	WWFF	food_fat	3	2170	1336733035	1	0.04	0.00125	9694	1
4	Food 1	Intake 3	8	2788	1336733653	/users/cn/jespinosa/phecomp/data/CRG/20120502_FDF_CRG/20120502_FDF_CRG/20120511_FDF_CRG_c12.mtb	2723	337	WWFF	food_fat	3	2780	1336733645	1	0.02	0.0025	9695	1
4	Food 1	Intake 3	16	3141	1336734006	/users/cn/jespinosa/phecomp/data/CRG/20120502_FDF_CRG/20120502_FDF_CRG/20120511_FDF_CRG_c12.mtb	2724	809	WWFF	food_fat	3	3125	1336733990	1	0.04	0.0025	9696	1
4	Food 1	Intake 3	12	3962	1336734827	/users/cn/jespinosa/phecomp/data/CRG/20120502_FDF_CRG/20120502_FDF_CRG/20120511_FDF_CRG_c12.mtb	2732	184	WWFF	food_fat	3	3950	1336734815	1	0.02	0.00166666666666667	9697	1
4	Food 1	Intake 3	25	4171	1336735036	/users/cn/jespinosa/phecomp/data/CRG/20120502_FDF_CRG/20120502_FDF_CRG/20120511_FDF_CRG_c12.mtb	2733	72	WWFF	food_fat	3	4146	1336735011	1	0.02	0.0008	9698	1
4	Food 1	Intake 3	13	4256	1336735121	/users/cn/jespinosa/phecomp/data/CRG/20120502_FDF_CRG/20120502_FDF_CRG/20120511_FDF_CRG_c12.mtb	2734	1416	WWFF	food_fat	3	4243	1336735108	1	0.02	0.00153846153846154	9699	1
4	Food 1	Intake 3	12	5684	1336736549	/users/cn/jespinosa/phecomp/data/CRG/20120502_FDF_CRG/20120502_FDF_CRG/20120511_FDF_CRG_c12.mtb	2736	38	WWFF	food_fat	3	5672	1336736537	1	0.02	0.00166666666666667	9700	1
4	Food 1	Intake 3	13	5735	1336736600	/users/cn/jespinosa/phecomp/data/CRG/20120502_FDF_CRG/20120502_FDF_CRG/20120511_FDF_CRG_c12.mtb	2737	1815	WWFF	food_fat	3	5722	1336736587	1	0.04	0.00307692307692308	9701	1
4	Drink 1	Intake 1	18	6593	1336737458	/users/cn/jespinosa/phecomp/data/CRG/20120502_FDF_CRG/20120502_FDF_CRG/20120511_FDF_CRG_c12.mtb	1481	NA	WWFF	water	1	6575	1336737440	1	0.06	0.00333333333333333	9702	1
4	Food 1	Intake 3	19	7569	1336738434	/users/cn/jespinosa/phecomp/data/CRG/20120502_FDF_CRG/20120502_FDF_CRG/20120511_FDF_CRG_c12.mtb	2743	2195	WWFF	food_fat	3	7550	1336738415	1	0.02	0.00105263157894737	9703	1
4	Drink 1	Intake 1	26	7580	1336738445	/users/cn/jespinosa/phecomp/data/CRG/20120502_FDF_CRG/20120502_FDF_CRG/20120511_FDF_CRG_c12.mtb	1482	NA	WWFF	water	1	7554	1336738419	1	0.08	0.00307692307692308	9704	1
4	Food 2	Intake 4	14	9778	1336740643	/users/cn/jespinosa/phecomp/data/CRG/20120502_FDF_CRG/20120502_FDF_CRG/20120511_FDF_CRG_c12.mtb	3431	804	WWFF	food_fat	4	9764	1336740629	1	0.0600000000000001	0.00428571428571429	9705	1
4	Food 1	Intake 3	12	10594	1336741459	/users/cn/jespinosa/phecomp/data/CRG/20120502_FDF_CRG/20120502_FDF_CRG/20120511_FDF_CRG_c12.mtb	2753	3222	WWFF	food_fat	3	10582	1336741447	1	0.04	0.00333333333333333	9706	1
4	Drink 1	Intake 1	18	11611	1336742476	/users/cn/jespinosa/phecomp/data/CRG/20120502_FDF_CRG/20120502_FDF_CRG/20120511_FDF_CRG_c12.mtb	1483	NA	WWFF	water	1	11593	1336742458	1	0.02	0.00111111111111111	9707	1
4	Drink 1	Intake 1	17	13743	1336744608	/users/cn/jespinosa/phecomp/data/CRG/20120502_FDF_CRG/20120502_FDF_CRG/20120511_FDF_CRG_c12.mtb	1484	NA	WWFF	water	1	13726	1336744591	1	0.02	0.00117647058823529	9708	1
4	Food 2	Intake 4	34	13850	1336744715	/users/cn/jespinosa/phecomp/data/CRG/20120502_FDF_CRG/20120502_FDF_CRG/20120511_FDF_CRG_c12.mtb	3436	409	WWFF	food_fat	4	13816	1336744681	1	0.12	0.00352941176470588	9709	1
4	Food 1	Intake 3	18	14277	1336745142	/users/cn/jespinosa/phecomp/data/CRG/20120502_FDF_CRG/20120502_FDF_CRG/20120511_FDF_CRG_c12.mtb	2770	COLL	WWFF	food_fat	3	14259	1336745124	1	0.02	0.00111111111111111	9710	1
4	Food 2	Intake 4	10	14275	1336745140	/users/cn/jespinosa/phecomp/data/CRG/20120502_FDF_CRG/20120502_FDF_CRG/20120511_FDF_CRG_c12.mtb	3437	528	WWFF	food_fat	4	14265	1336745130	1	0.02	0.002	9711	1
4	Drink 2	Intake 2	25	14816	1336745681	/users/cn/jespinosa/phecomp/data/CRG/20120502_FDF_CRG/20120502_FDF_CRG/20120511_FDF_CRG_c12.mtb	1362	NA	WWFF	water	2	14791	1336745656	1	0.14	0.0056	9712	1
4	Food 2	Intake 4	14	14817	1336745682	/users/cn/jespinosa/phecomp/data/CRG/20120502_FDF_CRG/20120502_FDF_CRG/20120511_FDF_CRG_c12.mtb	3439	738	WWFF	food_fat	4	14803	1336745668	1	0.1	0.00714285714285714	9713	1
4	Food 1	Intake 3	15	15570	1336746435	/users/cn/jespinosa/phecomp/data/CRG/20120502_FDF_CRG/20120502_FDF_CRG/20120511_FDF_CRG_c12.mtb	2776	2213	WWFF	food_fat	3	15555	1336746420	1	0.02	0.00133333333333333	9714	1
4	Food 1	Intake 3	14	17797	1336748662	/users/cn/jespinosa/phecomp/data/CRG/20120502_FDF_CRG/20120502_FDF_CRG/20120511_FDF_CRG_c12.mtb	2781	858	WWFF	food_fat	3	17783	1336748648	1	0.0600000000000001	0.00428571428571429	9715	1
4	Food 1	Intake 3	13	18668	1336749533	/users/cn/jespinosa/phecomp/data/CRG/20120502_FDF_CRG/20120502_FDF_CRG/20120511_FDF_CRG_c12.mtb	2783	299	WWFF	food_fat	3	18655	1336749520	1	0.02	0.00153846153846154	9716	1
4	Food 2	Intake 4	28	18995	1336749860	/users/cn/jespinosa/phecomp/data/CRG/20120502_FDF_CRG/20120502_FDF_CRG/20120511_FDF_CRG_c12.mtb	3443	COLL	WWFF	food_fat	4	18967	1336749832	1	0.26	0.00928571428571429	9717	1
4	Food 1	Intake 3	44	19012	1336749877	/users/cn/jespinosa/phecomp/data/CRG/20120502_FDF_CRG/20120502_FDF_CRG/20120511_FDF_CRG_c12.mtb	2785	125	WWFF	food_fat	3	18968	1336749833	1	0.36	0.00818181818181818	9718	1
4	Food 1	Intake 3	54	19191	1336750056	/users/cn/jespinosa/phecomp/data/CRG/20120502_FDF_CRG/20120502_FDF_CRG/20120511_FDF_CRG_c12.mtb	2786	296	WWFF	food_fat	3	19137	1336750002	1	0.02	0.00037037037037037	9719	1
4	Food 1	Intake 3	30	19517	1336750382	/users/cn/jespinosa/phecomp/data/CRG/20120502_FDF_CRG/20120502_FDF_CRG/20120511_FDF_CRG_c12.mtb	2792	269	WWFF	food_fat	3	19487	1336750352	1	0.02	0.000666666666666667	9720	1
4	Food 2	Intake 4	45	19831	1336750696	/users/cn/jespinosa/phecomp/data/CRG/20120502_FDF_CRG/20120502_FDF_CRG/20120511_FDF_CRG_c12.mtb	3445	181	WWFF	food_fat	4	19786	1336750651	1	0.02	0.000444444444444444	9721	1
4	Drink 2	Intake 2	26	19817	1336750682	/users/cn/jespinosa/phecomp/data/CRG/20120502_FDF_CRG/20120502_FDF_CRG/20120511_FDF_CRG_c12.mtb	1363	NA	WWFF	water	2	19791	1336750656	1	0.1	0.00384615384615385	9722	1
4	Food 1	Intake 3	100	20112	1336750977	/users/cn/jespinosa/phecomp/data/CRG/20120502_FDF_CRG/20120502_FDF_CRG/20120511_FDF_CRG_c12.mtb	2800	COLL	WWFF	food_fat	3	20012	1336750877	1	0.02	0.0002	9723	1
4	Food 2	Intake 4	76	20115	1336750980	/users/cn/jespinosa/phecomp/data/CRG/20120502_FDF_CRG/20120502_FDF_CRG/20120511_FDF_CRG_c12.mtb	3447	177	WWFF	food_fat	4	20039	1336750904	1	0.12	0.00157894736842105	9724	1
4	Food 2	Intake 4	139	20431	1336751296	/users/cn/jespinosa/phecomp/data/CRG/20120502_FDF_CRG/20120502_FDF_CRG/20120511_FDF_CRG_c12.mtb	3450	142	WWFF	food_fat	4	20292	1336751157	1	0.02	0.000143884892086331	9725	1
4	Drink 2	Intake 2	21	20359	1336751224	/users/cn/jespinosa/phecomp/data/CRG/20120502_FDF_CRG/20120502_FDF_CRG/20120511_FDF_CRG_c12.mtb	1364	NA	WWFF	water	2	20338	1336751203	1	0.02	0.000952380952380952	9726	1
4	Food 2	Intake 4	22	20595	1336751460	/users/cn/jespinosa/phecomp/data/CRG/20120502_FDF_CRG/20120502_FDF_CRG/20120511_FDF_CRG_c12.mtb	3453	145	WWFF	food_fat	4	20573	1336751438	1	0.1	0.00454545454545455	9727	1
4	Food 2	Intake 4	27	20767	1336751632	/users/cn/jespinosa/phecomp/data/CRG/20120502_FDF_CRG/20120502_FDF_CRG/20120511_FDF_CRG_c12.mtb	3455	32	WWFF	food_fat	4	20740	1336751605	1	0.26	0.00962962962962963	9728	1
4	Food 1	Intake 3	19	20818	1336751683	/users/cn/jespinosa/phecomp/data/CRG/20120502_FDF_CRG/20120502_FDF_CRG/20120511_FDF_CRG_c12.mtb	2807	128	WWFF	food_fat	3	20799	1336751664	1	0.02	0.00105263157894737	9729	1
4	Food 2	Intake 4	15	20961	1336751826	/users/cn/jespinosa/phecomp/data/CRG/20120502_FDF_CRG/20120502_FDF_CRG/20120511_FDF_CRG_c12.mtb	3459	COLL	WWFF	food_fat	4	20946	1336751811	1	0.24	0.016	9730	1
4	Food 1	Intake 3	20	20967	1336751832	/users/cn/jespinosa/phecomp/data/CRG/20120502_FDF_CRG/20120502_FDF_CRG/20120511_FDF_CRG_c12.mtb	2809	532	WWFF	food_fat	3	20947	1336751812	1	0.26	0.013	9731	1
4	Food 2	Intake 4	12	21511	1336752376	/users/cn/jespinosa/phecomp/data/CRG/20120502_FDF_CRG/20120502_FDF_CRG/20120511_FDF_CRG_c12.mtb	3461	1235	WWFF	food_fat	4	21499	1336752364	1	0.02	0.00166666666666667	9732	1
4	Food 1	Intake 3	12	22758	1336753623	/users/cn/jespinosa/phecomp/data/CRG/20120502_FDF_CRG/20120502_FDF_CRG/20120511_FDF_CRG_c12.mtb	2816	156	WWFF	food_fat	3	22746	1336753611	1	0.04	0.00333333333333333	9733	1
4	Food 1	Intake 3	19	22933	1336753798	/users/cn/jespinosa/phecomp/data/CRG/20120502_FDF_CRG/20120502_FDF_CRG/20120511_FDF_CRG_c12.mtb	2817	811	WWFF	food_fat	3	22914	1336753779	1	0.02	0.00105263157894737	9734	1
4	Food 1	Intake 3	45	23789	1336754654	/users/cn/jespinosa/phecomp/data/CRG/20120502_FDF_CRG/20120502_FDF_CRG/20120511_FDF_CRG_c12.mtb	2819	2903	WWFF	food_fat	3	23744	1336754609	1	0.0600000000000001	0.00133333333333334	9735	1
4	Food 1	Intake 3	55	26747	1336757612	/users/cn/jespinosa/phecomp/data/CRG/20120502_FDF_CRG/20120502_FDF_CRG/20120511_FDF_CRG_c12.mtb	2826	442	WWFF	food_fat	3	26692	1336757557	1	0.02	0.000363636363636364	9736	1
4	Drink 1	Intake 1	21	26730	1336757595	/users/cn/jespinosa/phecomp/data/CRG/20120502_FDF_CRG/20120502_FDF_CRG/20120511_FDF_CRG_c12.mtb	1485	NA	WWFF	water	1	26709	1336757574	1	0.1	0.00476190476190476	9737	1
4	Food 2	Intake 4	22	27211	1336758076	/users/cn/jespinosa/phecomp/data/CRG/20120502_FDF_CRG/20120502_FDF_CRG/20120511_FDF_CRG_c12.mtb	3468	839	WWFF	food_fat	4	27189	1336758054	1	0.0599999999999998	0.00272727272727272	9738	1
4	Drink 1	Intake 1	19	27577	1336758442	/users/cn/jespinosa/phecomp/data/CRG/20120502_FDF_CRG/20120502_FDF_CRG/20120511_FDF_CRG_c12.mtb	1486	NA	WWFF	water	1	27558	1336758423	1	0.1	0.00526315789473684	9739	1
4	Food 1	Intake 3	15	28065	1336758930	/users/cn/jespinosa/phecomp/data/CRG/20120502_FDF_CRG/20120502_FDF_CRG/20120511_FDF_CRG_c12.mtb	2831	1364	WWFF	food_fat	3	28050	1336758915	1	0.02	0.00133333333333333	9740	1
4	Food 1	Intake 3	13	29442	1336760307	/users/cn/jespinosa/phecomp/data/CRG/20120502_FDF_CRG/20120502_FDF_CRG/20120511_FDF_CRG_c12.mtb	2838	635	WWFF	food_fat	3	29429	1336760294	1	0.02	0.00153846153846154	9741	1
4	Drink 2	Intake 2	28	30088	1336760953	/users/cn/jespinosa/phecomp/data/CRG/20120502_FDF_CRG/20120502_FDF_CRG/20120511_FDF_CRG_c12.mtb	1365	NA	WWFF	water	2	30060	1336760925	1	0.1	0.00357142857142857	9742	1
4	Food 1	Intake 3	18	30095	1336760960	/users/cn/jespinosa/phecomp/data/CRG/20120502_FDF_CRG/20120502_FDF_CRG/20120511_FDF_CRG_c12.mtb	2842	842	WWFF	food_fat	3	30077	1336760942	1	0.28	0.0155555555555556	9743	1
4	Food 2	Intake 4	20	30957	1336761822	/users/cn/jespinosa/phecomp/data/CRG/20120502_FDF_CRG/20120502_FDF_CRG/20120511_FDF_CRG_c12.mtb	3478	727	WWFF	food_fat	4	30937	1336761802	1	0.02	0.001	9744	1
4	Food 2	Intake 4	240	31924	1336762789	/users/cn/jespinosa/phecomp/data/CRG/20120502_FDF_CRG/20120502_FDF_CRG/20120511_FDF_CRG_c12.mtb	3485	COLL	WWFF	food_fat	4	31684	1336762549	1	0.0600000000000001	0.00025	9745	1
4	Drink 2	Intake 2	20	31727	1336762592	/users/cn/jespinosa/phecomp/data/CRG/20120502_FDF_CRG/20120502_FDF_CRG/20120511_FDF_CRG_c12.mtb	1366	NA	WWFF	water	2	31707	1336762572	1	0.06	0.003	9746	1
4	Food 1	Intake 3	87	31923	1336762788	/users/cn/jespinosa/phecomp/data/CRG/20120502_FDF_CRG/20120502_FDF_CRG/20120511_FDF_CRG_c12.mtb	2852	676	WWFF	food_fat	3	31836	1336762701	1	0.22	0.00252873563218391	9747	1
4	Food 2	Intake 4	110	32709	1336763574	/users/cn/jespinosa/phecomp/data/CRG/20120502_FDF_CRG/20120502_FDF_CRG/20120511_FDF_CRG_c12.mtb	3493	18	WWFF	food_fat	4	32599	1336763464	1	0.72	0.00654545454545455	9748	1
4	Food 2	Intake 4	93	32820	1336763685	/users/cn/jespinosa/phecomp/data/CRG/20120502_FDF_CRG/20120502_FDF_CRG/20120511_FDF_CRG_c12.mtb	3494	COLL	WWFF	food_fat	4	32727	1336763592	1	0.12	0.00129032258064516	9749	1
4	Food 1	Intake 3	73	32816	1336763681	/users/cn/jespinosa/phecomp/data/CRG/20120502_FDF_CRG/20120502_FDF_CRG/20120511_FDF_CRG_c12.mtb	2860	1667	WWFF	food_fat	3	32743	1336763608	1	0.0200000000000005	0.000273972602739733	9750	1
4	Drink 2	Intake 2	22	34183	1336765048	/users/cn/jespinosa/phecomp/data/CRG/20120502_FDF_CRG/20120502_FDF_CRG/20120511_FDF_CRG_c12.mtb	1369	NA	WWFF	water	2	34161	1336765026	1	0.04	0.00181818181818182	9751	1
4	Food 1	Intake 3	27	34510	1336765375	/users/cn/jespinosa/phecomp/data/CRG/20120502_FDF_CRG/20120502_FDF_CRG/20120511_FDF_CRG_c12.mtb	2867	COLL	WWFF	food_fat	3	34483	1336765348	1	0.0200000000000005	0.000740740740740759	9752	1
4	Food 2	Intake 4	25	34509	1336765374	/users/cn/jespinosa/phecomp/data/CRG/20120502_FDF_CRG/20120502_FDF_CRG/20120511_FDF_CRG_c12.mtb	3504	436	WWFF	food_fat	4	34484	1336765349	1	0.02	0.0008	9753	1
4	Food 1	Intake 3	83	35028	1336765893	/users/cn/jespinosa/phecomp/data/CRG/20120502_FDF_CRG/20120502_FDF_CRG/20120511_FDF_CRG_c12.mtb	2869	COLL	WWFF	food_fat	3	34945	1336765810	1	0.22	0.00265060240963855	9754	1
4	Food 2	Intake 4	48	34998	1336765863	/users/cn/jespinosa/phecomp/data/CRG/20120502_FDF_CRG/20120502_FDF_CRG/20120511_FDF_CRG_c12.mtb	3506	7	WWFF	food_fat	4	34950	1336765815	1	0.26	0.00541666666666667	9755	1
4	Food 2	Intake 4	25	35030	1336765895	/users/cn/jespinosa/phecomp/data/CRG/20120502_FDF_CRG/20120502_FDF_CRG/20120511_FDF_CRG_c12.mtb	3507	297	WWFF	food_fat	4	35005	1336765870	1	0.02	0.0008	9756	1
4	Food 2	Intake 4	15	35342	1336766207	/users/cn/jespinosa/phecomp/data/CRG/20120502_FDF_CRG/20120502_FDF_CRG/20120511_FDF_CRG_c12.mtb	3513	18	WWFF	food_fat	4	35327	1336766192	1	0.02	0.00133333333333333	9757	1
4	Food 2	Intake 4	280	35640	1336766505	/users/cn/jespinosa/phecomp/data/CRG/20120502_FDF_CRG/20120502_FDF_CRG/20120511_FDF_CRG_c12.mtb	3514	COLL	WWFF	food_fat	4	35360	1336766225	1	0.42	0.0015	9758	1
4	Food 1	Intake 3	13	35539	1336766404	/users/cn/jespinosa/phecomp/data/CRG/20120502_FDF_CRG/20120502_FDF_CRG/20120511_FDF_CRG_c12.mtb	2874	9	WWFF	food_fat	3	35526	1336766391	1	0.04	0.00307692307692308	9759	1
4	Food 1	Intake 3	329	35877	1336766742	/users/cn/jespinosa/phecomp/data/CRG/20120502_FDF_CRG/20120502_FDF_CRG/20120511_FDF_CRG_c12.mtb	2875	COLL	WWFF	food_fat	3	35548	1336766413	1	0.86	0.00261398176291793	9760	1
4	Food 2	Intake 4	249	35902	1336766767	/users/cn/jespinosa/phecomp/data/CRG/20120502_FDF_CRG/20120502_FDF_CRG/20120511_FDF_CRG_c12.mtb	3515	50	WWFF	food_fat	4	35653	1336766518	1	0.38	0.00152610441767068	9761	1
4	Food 1	Intake 3	77	36029	1336766894	/users/cn/jespinosa/phecomp/data/CRG/20120502_FDF_CRG/20120502_FDF_CRG/20120511_FDF_CRG_c12.mtb	2876	COLL	WWFF	food_fat	3	35952	1336766817	1	0.02	0.00025974025974026	9762	1
4	Food 2	Intake 4	87	36040	1336766905	/users/cn/jespinosa/phecomp/data/CRG/20120502_FDF_CRG/20120502_FDF_CRG/20120511_FDF_CRG_c12.mtb	3516	54	WWFF	food_fat	4	35953	1336766818	1	0.04	0.000459770114942529	9763	1
4	Food 1	Intake 3	157	36251	1336767116	/users/cn/jespinosa/phecomp/data/CRG/20120502_FDF_CRG/20120502_FDF_CRG/20120511_FDF_CRG_c12.mtb	2877	312	WWFF	food_fat	3	36094	1336766959	1	0.5	0.00318471337579618	9764	1
4	Drink 2	Intake 2	36	36583	1336767448	/users/cn/jespinosa/phecomp/data/CRG/20120502_FDF_CRG/20120502_FDF_CRG/20120511_FDF_CRG_c12.mtb	1371	NA	WWFF	water	2	36547	1336767412	1	0.06	0.00166666666666667	9765	1
4	Food 2	Intake 4	376	36939	1336767804	/users/cn/jespinosa/phecomp/data/CRG/20120502_FDF_CRG/20120502_FDF_CRG/20120511_FDF_CRG_c12.mtb	3520	COLL	WWFF	food_fat	4	36563	1336767428	1	0.48	0.00127659574468085	9766	1
4	Food 1	Intake 3	161	36725	1336767590	/users/cn/jespinosa/phecomp/data/CRG/20120502_FDF_CRG/20120502_FDF_CRG/20120511_FDF_CRG_c12.mtb	2881	12	WWFF	food_fat	3	36564	1336767429	1	0.300000000000001	0.00186335403726709	9767	1
4	Food 1	Intake 3	202	36939	1336767804	/users/cn/jespinosa/phecomp/data/CRG/20120502_FDF_CRG/20120502_FDF_CRG/20120511_FDF_CRG_c12.mtb	2882	151	WWFF	food_fat	3	36737	1336767602	1	1.02	0.00504950495049505	9768	1
4	Food 2	Intake 4	14	37104	1336767969	/users/cn/jespinosa/phecomp/data/CRG/20120502_FDF_CRG/20120502_FDF_CRG/20120511_FDF_CRG_c12.mtb	3523	15	WWFF	food_fat	4	37090	1336767955	1	0.1	0.00714285714285714	9769	1
4	Food 2	Intake 4	84	37203	1336768068	/users/cn/jespinosa/phecomp/data/CRG/20120502_FDF_CRG/20120502_FDF_CRG/20120511_FDF_CRG_c12.mtb	3524	COLL	WWFF	food_fat	4	37119	1336767984	1	0.0800000000000001	0.000952380952380954	9770	1
4	Food 1	Intake 3	36	37216	1336768081	/users/cn/jespinosa/phecomp/data/CRG/20120502_FDF_CRG/20120502_FDF_CRG/20120511_FDF_CRG_c12.mtb	2886	286	WWFF	food_fat	3	37180	1336768045	1	0.100000000000001	0.00277777777777781	9771	1
4	Food 2	Intake 4	123	37625	1336768490	/users/cn/jespinosa/phecomp/data/CRG/20120502_FDF_CRG/20120502_FDF_CRG/20120511_FDF_CRG_c12.mtb	3528	COLL	WWFF	food_fat	4	37502	1336768367	1	0.16	0.00130081300813008	9772	1
4	Food 1	Intake 3	128	37631	1336768496	/users/cn/jespinosa/phecomp/data/CRG/20120502_FDF_CRG/20120502_FDF_CRG/20120511_FDF_CRG_c12.mtb	2890	112	WWFF	food_fat	3	37503	1336768368	1	0.28	0.0021875	9773	1
4	Food 2	Intake 4	62	37805	1336768670	/users/cn/jespinosa/phecomp/data/CRG/20120502_FDF_CRG/20120502_FDF_CRG/20120511_FDF_CRG_c12.mtb	3530	54	WWFF	food_fat	4	37743	1336768608	1	0.02	0.00032258064516129	9774	1
4	Food 2	Intake 4	189	38048	1336768913	/users/cn/jespinosa/phecomp/data/CRG/20120502_FDF_CRG/20120502_FDF_CRG/20120511_FDF_CRG_c12.mtb	3532	COLL	WWFF	food_fat	4	37859	1336768724	1	0.24	0.00126984126984127	9775	1
4	Food 1	Intake 3	20	38052	1336768917	/users/cn/jespinosa/phecomp/data/CRG/20120502_FDF_CRG/20120502_FDF_CRG/20120511_FDF_CRG_c12.mtb	2894	162	WWFF	food_fat	3	38032	1336768897	1	0.12	0.006	9776	1
4	Food 2	Intake 4	96	38310	1336769175	/users/cn/jespinosa/phecomp/data/CRG/20120502_FDF_CRG/20120502_FDF_CRG/20120511_FDF_CRG_c12.mtb	3535	44	WWFF	food_fat	4	38214	1336769079	1	0.22	0.00229166666666667	9777	1
4	Food 1	Intake 3	267	38621	1336769486	/users/cn/jespinosa/phecomp/data/CRG/20120502_FDF_CRG/20120502_FDF_CRG/20120511_FDF_CRG_c12.mtb	2898	COLL	WWFF	food_fat	3	38354	1336769219	1	0.56	0.00209737827715356	9778	1
4	Food 2	Intake 4	106	38463	1336769328	/users/cn/jespinosa/phecomp/data/CRG/20120502_FDF_CRG/20120502_FDF_CRG/20120511_FDF_CRG_c12.mtb	3536	6	WWFF	food_fat	4	38357	1336769222	1	0.0999999999999996	0.000943396226415091	9779	1
4	Food 2	Intake 4	68	38537	1336769402	/users/cn/jespinosa/phecomp/data/CRG/20120502_FDF_CRG/20120502_FDF_CRG/20120511_FDF_CRG_c12.mtb	3537	23	WWFF	food_fat	4	38469	1336769334	1	0.02	0.000294117647058824	9780	1
4	Food 2	Intake 4	63	38623	1336769488	/users/cn/jespinosa/phecomp/data/CRG/20120502_FDF_CRG/20120502_FDF_CRG/20120511_FDF_CRG_c12.mtb	3538	22	WWFF	food_fat	4	38560	1336769425	1	0.0800000000000001	0.00126984126984127	9781	1
4	Food 2	Intake 4	213	38858	1336769723	/users/cn/jespinosa/phecomp/data/CRG/20120502_FDF_CRG/20120502_FDF_CRG/20120511_FDF_CRG_c12.mtb	3539	COLL	WWFF	food_fat	4	38645	1336769510	1	0.56	0.00262910798122066	9782	1
4	Food 1	Intake 3	185	38832	1336769697	/users/cn/jespinosa/phecomp/data/CRG/20120502_FDF_CRG/20120502_FDF_CRG/20120511_FDF_CRG_c12.mtb	2899	4	WWFF	food_fat	3	38647	1336769512	1	0.0599999999999996	0.000324324324324322	9783	1
4	Food 1	Intake 3	23	38859	1336769724	/users/cn/jespinosa/phecomp/data/CRG/20120502_FDF_CRG/20120502_FDF_CRG/20120511_FDF_CRG_c12.mtb	2900	252	WWFF	food_fat	3	38836	1336769701	1	0.0600000000000005	0.00260869565217393	9784	1
4	Food 1	Intake 3	31	39142	1336770007	/users/cn/jespinosa/phecomp/data/CRG/20120502_FDF_CRG/20120502_FDF_CRG/20120511_FDF_CRG_c12.mtb	2903	251	WWFF	food_fat	3	39111	1336769976	1	0.04	0.00129032258064516	9785	1
4	Food 1	Intake 3	18	39411	1336770276	/users/cn/jespinosa/phecomp/data/CRG/20120502_FDF_CRG/20120502_FDF_CRG/20120511_FDF_CRG_c12.mtb	2906	255	WWFF	food_fat	3	39393	1336770258	1	0.0200000000000005	0.00111111111111114	9786	1
4	Drink 1	Intake 1	24	39532	1336770397	/users/cn/jespinosa/phecomp/data/CRG/20120502_FDF_CRG/20120502_FDF_CRG/20120511_FDF_CRG_c12.mtb	1491	NA	WWFF	water	1	39508	1336770373	1	0.1	0.00416666666666667	9787	1
4	Food 2	Intake 4	62	39728	1336770593	/users/cn/jespinosa/phecomp/data/CRG/20120502_FDF_CRG/20120502_FDF_CRG/20120511_FDF_CRG_c12.mtb	3542	361	WWFF	food_fat	4	39666	1336770531	1	0.0600000000000005	0.000967741935483879	9788	1
4	Food 1	Intake 3	38	40127	1336770992	/users/cn/jespinosa/phecomp/data/CRG/20120502_FDF_CRG/20120502_FDF_CRG/20120511_FDF_CRG_c12.mtb	2911	265	WWFF	food_fat	3	40089	1336770954	1	0.0600000000000005	0.00157894736842107	9789	1
4	Food 1	Intake 3	16	40408	1336771273	/users/cn/jespinosa/phecomp/data/CRG/20120502_FDF_CRG/20120502_FDF_CRG/20120511_FDF_CRG_c12.mtb	2914	74	WWFF	food_fat	3	40392	1336771257	1	0.0200000000000005	0.00125000000000003	9790	1
4	Food 2	Intake 4	14	40496	1336771361	/users/cn/jespinosa/phecomp/data/CRG/20120502_FDF_CRG/20120502_FDF_CRG/20120511_FDF_CRG_c12.mtb	3549	112	WWFF	food_fat	4	40482	1336771347	1	0.0200000000000005	0.00142857142857146	9791	1
4	Food 1	Intake 3	19	40627	1336771492	/users/cn/jespinosa/phecomp/data/CRG/20120502_FDF_CRG/20120502_FDF_CRG/20120511_FDF_CRG_c12.mtb	2917	236	WWFF	food_fat	3	40608	1336771473	1	0.0200000000000005	0.00105263157894739	9792	1
4	Food 1	Intake 3	165	41028	1336771893	/users/cn/jespinosa/phecomp/data/CRG/20120502_FDF_CRG/20120502_FDF_CRG/20120511_FDF_CRG_c12.mtb	2920	COLL	WWFF	food_fat	3	40863	1336771728	1	0.44	0.00266666666666667	9793	1
4	Food 2	Intake 4	92	40957	1336771822	/users/cn/jespinosa/phecomp/data/CRG/20120502_FDF_CRG/20120502_FDF_CRG/20120511_FDF_CRG_c12.mtb	3553	59	WWFF	food_fat	4	40865	1336771730	1	0.279999999999999	0.00304347826086955	9794	1
4	Food 2	Intake 4	46	41062	1336771927	/users/cn/jespinosa/phecomp/data/CRG/20120502_FDF_CRG/20120502_FDF_CRG/20120511_FDF_CRG_c12.mtb	3555	COLL	WWFF	food_fat	4	41016	1336771881	1	0.0600000000000005	0.00130434782608697	9795	1
4	Food 1	Intake 3	13	41061	1336771926	/users/cn/jespinosa/phecomp/data/CRG/20120502_FDF_CRG/20120502_FDF_CRG/20120511_FDF_CRG_c12.mtb	2921	228	WWFF	food_fat	3	41048	1336771913	1	0.0599999999999996	0.00461538461538458	9796	1
4	Drink 2	Intake 2	47	41312	1336772177	/users/cn/jespinosa/phecomp/data/CRG/20120502_FDF_CRG/20120502_FDF_CRG/20120511_FDF_CRG_c12.mtb	1374	NA	WWFF	water	2	41265	1336772130	1	0.0600000000000001	0.00127659574468085	9797	1
4	Food 2	Intake 4	108	41397	1336772262	/users/cn/jespinosa/phecomp/data/CRG/20120502_FDF_CRG/20120502_FDF_CRG/20120511_FDF_CRG_c12.mtb	3557	COLL	WWFF	food_fat	4	41289	1336772154	1	0.0800000000000001	0.000740740740740742	9798	1
4	Food 1	Intake 3	111	41402	1336772267	/users/cn/jespinosa/phecomp/data/CRG/20120502_FDF_CRG/20120502_FDF_CRG/20120511_FDF_CRG_c12.mtb	2926	329	WWFF	food_fat	3	41291	1336772156	1	0.16	0.00144144144144144	9799	1
4	Food 1	Intake 3	26	41757	1336772622	/users/cn/jespinosa/phecomp/data/CRG/20120502_FDF_CRG/20120502_FDF_CRG/20120511_FDF_CRG_c12.mtb	2931	COLL	WWFF	food_fat	3	41731	1336772596	1	0.260000000000001	0.01	9800	1
4	Food 2	Intake 4	13	41753	1336772618	/users/cn/jespinosa/phecomp/data/CRG/20120502_FDF_CRG/20120502_FDF_CRG/20120511_FDF_CRG_c12.mtb	3559	131	WWFF	food_fat	4	41740	1336772605	1	0.0800000000000001	0.00615384615384616	9801	1
4	Food 1	Intake 3	34	41918	1336772783	/users/cn/jespinosa/phecomp/data/CRG/20120502_FDF_CRG/20120502_FDF_CRG/20120511_FDF_CRG_c12.mtb	2933	COLL	WWFF	food_fat	3	41884	1336772749	1	0.0200000000000005	0.000588235294117662	9802	1
4	Food 2	Intake 4	29	41917	1336772782	/users/cn/jespinosa/phecomp/data/CRG/20120502_FDF_CRG/20120502_FDF_CRG/20120511_FDF_CRG_c12.mtb	3560	302	WWFF	food_fat	4	41888	1336772753	1	0.0200000000000005	0.00068965517241381	9803	1
4	Food 1	Intake 3	17	42236	1336773101	/users/cn/jespinosa/phecomp/data/CRG/20120502_FDF_CRG/20120502_FDF_CRG/20120511_FDF_CRG_c12.mtb	2936	26	WWFF	food_fat	3	42219	1336773084	1	0.0599999999999996	0.00352941176470586	9804	1
4	Food 1	Intake 3	67	42329	1336773194	/users/cn/jespinosa/phecomp/data/CRG/20120502_FDF_CRG/20120502_FDF_CRG/20120511_FDF_CRG_c12.mtb	2938	COLL	WWFF	food_fat	3	42262	1336773127	1	0.16	0.00238805970149254	9805	1
4	Food 2	Intake 4	75	42394	1336773259	/users/cn/jespinosa/phecomp/data/CRG/20120502_FDF_CRG/20120502_FDF_CRG/20120511_FDF_CRG_c12.mtb	3568	COLL	WWFF	food_fat	4	42319	1336773184	1	0.0600000000000005	0.000800000000000007	9806	1
4	Food 1	Intake 3	13	42393	1336773258	/users/cn/jespinosa/phecomp/data/CRG/20120502_FDF_CRG/20120502_FDF_CRG/20120511_FDF_CRG_c12.mtb	2940	436	WWFF	food_fat	3	42380	1336773245	1	0.0599999999999996	0.00461538461538458	9807	1
4	Food 1	Intake 3	15	42844	1336773709	/users/cn/jespinosa/phecomp/data/CRG/20120502_FDF_CRG/20120502_FDF_CRG/20120511_FDF_CRG_c12.mtb	2943	2149	WWFF	food_fat	3	42829	1336773694	1	0.0200000000000005	0.00133333333333337	9808	1
4	Food 1	Intake 3	14	45007	1336775872	/users/cn/jespinosa/phecomp/data/CRG/20120502_FDF_CRG/20120502_FDF_CRG/20120511_FDF_CRG_c12.mtb	2951	345	WWFF	food_fat	3	44993	1336775858	1	0.0200000000000005	0.00142857142857146	9809	1
4	Food 1	Intake 3	20	45372	1336776237	/users/cn/jespinosa/phecomp/data/CRG/20120502_FDF_CRG/20120502_FDF_CRG/20120511_FDF_CRG_c12.mtb	2953	556	WWFF	food_fat	3	45352	1336776217	1	0.0200000000000005	0.00100000000000002	9810	1
4	Food 2	Intake 4	15	45943	1336776808	/users/cn/jespinosa/phecomp/data/CRG/20120502_FDF_CRG/20120502_FDF_CRG/20120511_FDF_CRG_c12.mtb	3572	463	WWFF	food_fat	4	45928	1336776793	1	0.0800000000000001	0.00533333333333334	9811	1
4	Food 1	Intake 3	22	46428	1336777293	/users/cn/jespinosa/phecomp/data/CRG/20120502_FDF_CRG/20120502_FDF_CRG/20120511_FDF_CRG_c12.mtb	2961	688	WWFF	food_fat	3	46406	1336777271	1	0.0200000000000005	0.000909090909090932	9812	1
4	Food 1	Intake 3	56	47172	1336778037	/users/cn/jespinosa/phecomp/data/CRG/20120502_FDF_CRG/20120502_FDF_CRG/20120511_FDF_CRG_c12.mtb	2969	204	WWFF	food_fat	3	47116	1336777981	1	0.0200000000000005	0.000357142857142866	9813	1
4	Food 2	Intake 4	31	47407	1336778272	/users/cn/jespinosa/phecomp/data/CRG/20120502_FDF_CRG/20120502_FDF_CRG/20120511_FDF_CRG_c12.mtb	3575	COLL	WWFF	food_fat	4	47376	1336778241	1	0.0800000000000001	0.00258064516129033	9814	1
4	Food 1	Intake 3	12	47389	1336778254	/users/cn/jespinosa/phecomp/data/CRG/20120502_FDF_CRG/20120502_FDF_CRG/20120511_FDF_CRG_c12.mtb	2972	28	WWFF	food_fat	3	47377	1336778242	1	0.0200000000000005	0.00166666666666671	9815	1
4	Food 1	Intake 3	199	47616	1336778481	/users/cn/jespinosa/phecomp/data/CRG/20120502_FDF_CRG/20120502_FDF_CRG/20120511_FDF_CRG_c12.mtb	2973	COLL	WWFF	food_fat	3	47417	1336778282	1	0.279999999999999	0.00140703517587939	9816	1
4	Food 2	Intake 4	108	47617	1336778482	/users/cn/jespinosa/phecomp/data/CRG/20120502_FDF_CRG/20120502_FDF_CRG/20120511_FDF_CRG_c12.mtb	3577	62	WWFF	food_fat	4	47509	1336778374	1	0.0800000000000001	0.000740740740740742	9817	1
4	Food 1	Intake 3	61	47740	1336778605	/users/cn/jespinosa/phecomp/data/CRG/20120502_FDF_CRG/20120502_FDF_CRG/20120511_FDF_CRG_c12.mtb	2975	COLL	WWFF	food_fat	3	47679	1336778544	1	0.0800000000000001	0.00131147540983607	9818	1
4	Food 2	Intake 4	56	47737	1336778602	/users/cn/jespinosa/phecomp/data/CRG/20120502_FDF_CRG/20120502_FDF_CRG/20120511_FDF_CRG_c12.mtb	3579	12	WWFF	food_fat	4	47681	1336778546	1	0.2	0.00357142857142857	9819	1
4	Food 2	Intake 4	101	47850	1336778715	/users/cn/jespinosa/phecomp/data/CRG/20120502_FDF_CRG/20120502_FDF_CRG/20120511_FDF_CRG_c12.mtb	3580	50	WWFF	food_fat	4	47749	1336778614	1	0.22	0.00217821782178218	9820	1
4	Food 2	Intake 4	101	48001	1336778866	/users/cn/jespinosa/phecomp/data/CRG/20120502_FDF_CRG/20120502_FDF_CRG/20120511_FDF_CRG_c12.mtb	3581	141	WWFF	food_fat	4	47900	1336778765	1	0.36	0.00356435643564356	9821	1
4	Drink 2	Intake 2	27	48047	1336778912	/users/cn/jespinosa/phecomp/data/CRG/20120502_FDF_CRG/20120502_FDF_CRG/20120511_FDF_CRG_c12.mtb	1377	NA	WWFF	water	2	48020	1336778885	1	0.12	0.00444444444444444	9822	1
4	Food 2	Intake 4	70	48212	1336779077	/users/cn/jespinosa/phecomp/data/CRG/20120502_FDF_CRG/20120502_FDF_CRG/20120511_FDF_CRG_c12.mtb	3585	COLL	WWFF	food_fat	4	48142	1336779007	1	0.14	0.002	9823	1
4	Food 1	Intake 3	57	48213	1336779078	/users/cn/jespinosa/phecomp/data/CRG/20120502_FDF_CRG/20120502_FDF_CRG/20120511_FDF_CRG_c12.mtb	2980	25	WWFF	food_fat	3	48156	1336779021	1	0.199999999999999	0.00350877192982454	9824	1
4	Food 2	Intake 4	186	48424	1336779289	/users/cn/jespinosa/phecomp/data/CRG/20120502_FDF_CRG/20120502_FDF_CRG/20120511_FDF_CRG_c12.mtb	3586	COLL	WWFF	food_fat	4	48238	1336779103	1	0.2	0.0010752688172043	9825	1
4	Food 1	Intake 3	33	48314	1336779179	/users/cn/jespinosa/phecomp/data/CRG/20120502_FDF_CRG/20120502_FDF_CRG/20120511_FDF_CRG_c12.mtb	2982	19	WWFF	food_fat	3	48281	1336779146	1	0.0200000000000005	0.000606060606060621	9826	1
4	Food 1	Intake 3	44	48377	1336779242	/users/cn/jespinosa/phecomp/data/CRG/20120502_FDF_CRG/20120502_FDF_CRG/20120511_FDF_CRG_c12.mtb	2983	146	WWFF	food_fat	3	48333	1336779198	1	0.0399999999999991	0.000909090909090889	9827	1
4	Drink 2	Intake 2	73	48505	1336779370	/users/cn/jespinosa/phecomp/data/CRG/20120502_FDF_CRG/20120502_FDF_CRG/20120511_FDF_CRG_c12.mtb	1378	NA	WWFF	water	2	48432	1336779297	1	0.02	0.000273972602739726	9828	1
4	Food 1	Intake 3	12	48535	1336779400	/users/cn/jespinosa/phecomp/data/CRG/20120502_FDF_CRG/20120502_FDF_CRG/20120511_FDF_CRG_c12.mtb	2986	14	WWFF	food_fat	3	48523	1336779388	1	0.04	0.00333333333333333	9829	1
4	Food 2	Intake 4	12	48561	1336779426	/users/cn/jespinosa/phecomp/data/CRG/20120502_FDF_CRG/20120502_FDF_CRG/20120511_FDF_CRG_c12.mtb	3588	179	WWFF	food_fat	4	48549	1336779414	1	0.04	0.00333333333333333	9830	1
4	Food 1	Intake 3	114	48854	1336779719	/users/cn/jespinosa/phecomp/data/CRG/20120502_FDF_CRG/20120502_FDF_CRG/20120511_FDF_CRG_c12.mtb	2990	COLL	WWFF	food_fat	3	48740	1336779605	1	0.0800000000000001	0.000701754385964913	9831	1
4	Food 2	Intake 4	153	48897	1336779762	/users/cn/jespinosa/phecomp/data/CRG/20120502_FDF_CRG/20120502_FDF_CRG/20120511_FDF_CRG_c12.mtb	3592	COLL	WWFF	food_fat	4	48744	1336779609	1	0.44	0.00287581699346405	9832	1
4	Food 1	Intake 3	28	48895	1336779760	/users/cn/jespinosa/phecomp/data/CRG/20120502_FDF_CRG/20120502_FDF_CRG/20120511_FDF_CRG_c12.mtb	2991	124	WWFF	food_fat	3	48867	1336779732	1	0.0999999999999996	0.00357142857142856	9833	1
4	Food 1	Intake 3	13	49032	1336779897	/users/cn/jespinosa/phecomp/data/CRG/20120502_FDF_CRG/20120502_FDF_CRG/20120511_FDF_CRG_c12.mtb	2993	51	WWFF	food_fat	3	49019	1336779884	1	0.04	0.00307692307692308	9834	1
4	Food 1	Intake 3	215	49298	1336780163	/users/cn/jespinosa/phecomp/data/CRG/20120502_FDF_CRG/20120502_FDF_CRG/20120511_FDF_CRG_c12.mtb	2995	COLL	WWFF	food_fat	3	49083	1336779948	1	0.28	0.00130232558139535	9835	1
4	Food 2	Intake 4	186	49297	1336780162	/users/cn/jespinosa/phecomp/data/CRG/20120502_FDF_CRG/20120502_FDF_CRG/20120511_FDF_CRG_c12.mtb	3595	115	WWFF	food_fat	4	49111	1336779976	1	0.24	0.00129032258064516	9836	1
4	Food 2	Intake 4	18	49430	1336780295	/users/cn/jespinosa/phecomp/data/CRG/20120502_FDF_CRG/20120502_FDF_CRG/20120511_FDF_CRG_c12.mtb	3597	COLL	WWFF	food_fat	4	49412	1336780277	1	0.04	0.00222222222222222	9837	1
4	Food 1	Intake 3	177	49600	1336780465	/users/cn/jespinosa/phecomp/data/CRG/20120502_FDF_CRG/20120502_FDF_CRG/20120511_FDF_CRG_c12.mtb	2997	25	WWFF	food_fat	3	49423	1336780288	1	0.539999999999999	0.00305084745762711	9838	1
4	Food 1	Intake 3	69	49694	1336780559	/users/cn/jespinosa/phecomp/data/CRG/20120502_FDF_CRG/20120502_FDF_CRG/20120511_FDF_CRG_c12.mtb	2998	55	WWFF	food_fat	3	49625	1336780490	1	0.220000000000001	0.00318840579710146	9839	1
4	Food 1	Intake 3	16	49765	1336780630	/users/cn/jespinosa/phecomp/data/CRG/20120502_FDF_CRG/20120502_FDF_CRG/20120511_FDF_CRG_c12.mtb	2999	46	WWFF	food_fat	3	49749	1336780614	1	0.0400000000000009	0.00250000000000006	9840	1
4	Food 1	Intake 3	58	49869	1336780734	/users/cn/jespinosa/phecomp/data/CRG/20120502_FDF_CRG/20120502_FDF_CRG/20120511_FDF_CRG_c12.mtb	3001	20	WWFF	food_fat	3	49811	1336780676	1	0.159999999999998	0.00275862068965514	9841	1
4	Food 1	Intake 3	98	49987	1336780852	/users/cn/jespinosa/phecomp/data/CRG/20120502_FDF_CRG/20120502_FDF_CRG/20120511_FDF_CRG_c12.mtb	3002	COLL	WWFF	food_fat	3	49889	1336780754	1	0.0800000000000001	0.000816326530612246	9842	1
4	Food 2	Intake 4	47	49988	1336780853	/users/cn/jespinosa/phecomp/data/CRG/20120502_FDF_CRG/20120502_FDF_CRG/20120511_FDF_CRG_c12.mtb	3604	239	WWFF	food_fat	4	49941	1336780806	1	0.04	0.000851063829787234	9843	1
4	Food 1	Intake 3	428	50655	1336781520	/users/cn/jespinosa/phecomp/data/CRG/20120502_FDF_CRG/20120502_FDF_CRG/20120511_FDF_CRG_c12.mtb	3004	COLL	WWFF	food_fat	3	50227	1336781092	1	1.54	0.0035981308411215	9844	1
4	Food 2	Intake 4	12	50653	1336781518	/users/cn/jespinosa/phecomp/data/CRG/20120502_FDF_CRG/20120502_FDF_CRG/20120511_FDF_CRG_c12.mtb	3608	44	WWFF	food_fat	4	50641	1336781506	1	0.04	0.00333333333333333	9845	1
4	Food 1	Intake 3	637	51334	1336782199	/users/cn/jespinosa/phecomp/data/CRG/20120502_FDF_CRG/20120502_FDF_CRG/20120511_FDF_CRG_c12.mtb	3005	COLL	WWFF	food_fat	3	50697	1336781562	1	1.26	0.00197802197802198	9846	1
4	Food 2	Intake 4	15	50922	1336781787	/users/cn/jespinosa/phecomp/data/CRG/20120502_FDF_CRG/20120502_FDF_CRG/20120511_FDF_CRG_c12.mtb	3612	331	WWFF	food_fat	4	50907	1336781772	1	0.04	0.00266666666666667	9847	1
4	Drink 1	Intake 1	18	51144	1336782009	/users/cn/jespinosa/phecomp/data/CRG/20120502_FDF_CRG/20120502_FDF_CRG/20120511_FDF_CRG_c12.mtb	1493	NA	WWFF	water	1	51126	1336781991	1	0.0599999999999999	0.00333333333333333	9848	1
4	Food 2	Intake 4	17	51270	1336782135	/users/cn/jespinosa/phecomp/data/CRG/20120502_FDF_CRG/20120502_FDF_CRG/20120511_FDF_CRG_c12.mtb	3614	274	WWFF	food_fat	4	51253	1336782118	1	0.04	0.00235294117647059	9849	1
4	Food 1	Intake 3	123	51667	1336782532	/users/cn/jespinosa/phecomp/data/CRG/20120502_FDF_CRG/20120502_FDF_CRG/20120511_FDF_CRG_c12.mtb	3008	372	WWFF	food_fat	3	51544	1336782409	1	0.0400000000000009	0.000325203252032528	9850	1
4	Food 1	Intake 3	27	52066	1336782931	/users/cn/jespinosa/phecomp/data/CRG/20120502_FDF_CRG/20120502_FDF_CRG/20120511_FDF_CRG_c12.mtb	3014	152	WWFF	food_fat	3	52039	1336782904	1	0.0399999999999991	0.00148148148148145	9851	1
4	Food 1	Intake 3	45	52263	1336783128	/users/cn/jespinosa/phecomp/data/CRG/20120502_FDF_CRG/20120502_FDF_CRG/20120511_FDF_CRG_c12.mtb	3016	214	WWFF	food_fat	3	52218	1336783083	1	0.0600000000000005	0.00133333333333334	9852	1
4	Food 1	Intake 3	528	53005	1336783870	/users/cn/jespinosa/phecomp/data/CRG/20120502_FDF_CRG/20120502_FDF_CRG/20120511_FDF_CRG_c12.mtb	3019	COLL	WWFF	food_fat	3	52477	1336783342	1	1.1	0.00208333333333333	9853	1
4	Food 2	Intake 4	33	52597	1336783462	/users/cn/jespinosa/phecomp/data/CRG/20120502_FDF_CRG/20120502_FDF_CRG/20120511_FDF_CRG_c12.mtb	3617	141	WWFF	food_fat	4	52564	1336783429	1	0.0200000000000005	0.000606060606060621	9854	1
4	Drink 1	Intake 1	23	52613	1336783478	/users/cn/jespinosa/phecomp/data/CRG/20120502_FDF_CRG/20120502_FDF_CRG/20120511_FDF_CRG_c12.mtb	1495	NA	WWFF	water	1	52590	1336783455	1	0.0600000000000001	0.00260869565217392	9855	1
4	Food 2	Intake 4	23	52761	1336783626	/users/cn/jespinosa/phecomp/data/CRG/20120502_FDF_CRG/20120502_FDF_CRG/20120511_FDF_CRG_c12.mtb	3621	231	WWFF	food_fat	4	52738	1336783603	1	0.0200000000000005	0.000869565217391326	9856	1
4	Food 2	Intake 4	14	53006	1336783871	/users/cn/jespinosa/phecomp/data/CRG/20120502_FDF_CRG/20120502_FDF_CRG/20120511_FDF_CRG_c12.mtb	3625	1810	WWFF	food_fat	4	52992	1336783857	1	0.04	0.00285714285714286	9857	1
4	Food 1	Intake 3	21	54837	1336785702	/users/cn/jespinosa/phecomp/data/CRG/20120502_FDF_CRG/20120502_FDF_CRG/20120511_FDF_CRG_c12.mtb	3025	1011	WWFF	food_fat	3	54816	1336785681	1	0.0200000000000014	0.000952380952381019	9858	1
4	Food 1	Intake 3	260	56108	1336786973	/users/cn/jespinosa/phecomp/data/CRG/20120502_FDF_CRG/20120502_FDF_CRG/20120511_FDF_CRG_c12.mtb	3034	COLL	WWFF	food_fat	3	55848	1336786713	1	0.299999999999999	0.00115384615384615	9859	1
4	Food 2	Intake 4	136	55986	1336786851	/users/cn/jespinosa/phecomp/data/CRG/20120502_FDF_CRG/20120502_FDF_CRG/20120511_FDF_CRG_c12.mtb	3628	104	WWFF	food_fat	4	55850	1336786715	1	0.0800000000000001	0.000588235294117648	9860	1
4	Drink 1	Intake 1	16	55987	1336786852	/users/cn/jespinosa/phecomp/data/CRG/20120502_FDF_CRG/20120502_FDF_CRG/20120511_FDF_CRG_c12.mtb	1497	NA	WWFF	water	1	55971	1336786836	1	0.02	0.00125	9861	1
4	Drink 2	Intake 2	23	56009	1336786874	/users/cn/jespinosa/phecomp/data/CRG/20120502_FDF_CRG/20120502_FDF_CRG/20120511_FDF_CRG_c12.mtb	1383	NA	WWFF	water	2	55986	1336786851	1	0.02	0.000869565217391304	9862	1
4	Drink 1	Intake 1	27	56077	1336786942	/users/cn/jespinosa/phecomp/data/CRG/20120502_FDF_CRG/20120502_FDF_CRG/20120511_FDF_CRG_c12.mtb	1500	NA	WWFF	water	1	56050	1336786915	1	0.02	0.000740740740740741	9863	1
4	Food 2	Intake 4	17	56107	1336786972	/users/cn/jespinosa/phecomp/data/CRG/20120502_FDF_CRG/20120502_FDF_CRG/20120511_FDF_CRG_c12.mtb	3630	39	WWFF	food_fat	4	56090	1336786955	1	0.0800000000000001	0.00470588235294118	9864	1
4	Food 2	Intake 4	33	56179	1336787044	/users/cn/jespinosa/phecomp/data/CRG/20120502_FDF_CRG/20120502_FDF_CRG/20120511_FDF_CRG_c12.mtb	3631	9	WWFF	food_fat	4	56146	1336787011	1	0.0200000000000005	0.000606060606060621	9865	1
4	Food 2	Intake 4	83	56271	1336787136	/users/cn/jespinosa/phecomp/data/CRG/20120502_FDF_CRG/20120502_FDF_CRG/20120511_FDF_CRG_c12.mtb	3632	4	WWFF	food_fat	4	56188	1336787053	1	0.04	0.000481927710843374	9866	1
4	Food 2	Intake 4	96	56371	1336787236	/users/cn/jespinosa/phecomp/data/CRG/20120502_FDF_CRG/20120502_FDF_CRG/20120511_FDF_CRG_c12.mtb	3633	COLL	WWFF	food_fat	4	56275	1336787140	1	0.0599999999999996	0.000624999999999996	9867	1
4	Food 1	Intake 3	55	56397	1336787262	/users/cn/jespinosa/phecomp/data/CRG/20120502_FDF_CRG/20120502_FDF_CRG/20120511_FDF_CRG_c12.mtb	3037	34	WWFF	food_fat	3	56342	1336787207	1	0.199999999999999	0.00363636363636362	9868	1
4	Food 2	Intake 4	141	56572	1336787437	/users/cn/jespinosa/phecomp/data/CRG/20120502_FDF_CRG/20120502_FDF_CRG/20120511_FDF_CRG_c12.mtb	3634	COLL	WWFF	food_fat	4	56431	1336787296	1	0.16	0.00113475177304965	9869	1
4	Food 1	Intake 3	36	56576	1336787441	/users/cn/jespinosa/phecomp/data/CRG/20120502_FDF_CRG/20120502_FDF_CRG/20120511_FDF_CRG_c12.mtb	3039	6	WWFF	food_fat	3	56540	1336787405	1	0.0999999999999996	0.00277777777777777	9870	1
4	Food 1	Intake 3	25	56607	1336787472	/users/cn/jespinosa/phecomp/data/CRG/20120502_FDF_CRG/20120502_FDF_CRG/20120511_FDF_CRG_c12.mtb	3040	69	WWFF	food_fat	3	56582	1336787447	1	0.0600000000000005	0.00240000000000002	9871	1
4	Food 2	Intake 4	87	56763	1336787628	/users/cn/jespinosa/phecomp/data/CRG/20120502_FDF_CRG/20120502_FDF_CRG/20120511_FDF_CRG_c12.mtb	3636	COLL	WWFF	food_fat	4	56676	1336787541	1	0.0800000000000001	0.000919540229885059	9872	1
4	Food 1	Intake 3	13	56764	1336787629	/users/cn/jespinosa/phecomp/data/CRG/20120502_FDF_CRG/20120502_FDF_CRG/20120511_FDF_CRG_c12.mtb	3043	83	WWFF	food_fat	3	56751	1336787616	1	0.0599999999999987	0.00461538461538452	9873	1
4	Drink 1	Intake 1	23	56799	1336787664	/users/cn/jespinosa/phecomp/data/CRG/20120502_FDF_CRG/20120502_FDF_CRG/20120511_FDF_CRG_c12.mtb	1501	NA	WWFF	water	1	56776	1336787641	1	0.12	0.00521739130434783	9874	1
4	Food 1	Intake 3	136	56983	1336787848	/users/cn/jespinosa/phecomp/data/CRG/20120502_FDF_CRG/20120502_FDF_CRG/20120511_FDF_CRG_c12.mtb	3045	COLL	WWFF	food_fat	3	56847	1336787712	1	0.220000000000001	0.00161764705882354	9875	1
4	Food 2	Intake 4	55	56906	1336787771	/users/cn/jespinosa/phecomp/data/CRG/20120502_FDF_CRG/20120502_FDF_CRG/20120511_FDF_CRG_c12.mtb	3638	61	WWFF	food_fat	4	56851	1336787716	1	0.04	0.000727272727272727	9876	1
4	Food 2	Intake 4	12	56979	1336787844	/users/cn/jespinosa/phecomp/data/CRG/20120502_FDF_CRG/20120502_FDF_CRG/20120511_FDF_CRG_c12.mtb	3639	26	WWFF	food_fat	4	56967	1336787832	1	0.04	0.00333333333333333	9877	1
4	Food 2	Intake 4	73	57078	1336787943	/users/cn/jespinosa/phecomp/data/CRG/20120502_FDF_CRG/20120502_FDF_CRG/20120511_FDF_CRG_c12.mtb	3640	17	WWFF	food_fat	4	57005	1336787870	1	0.18	0.00246575342465753	9878	1
4	Food 1	Intake 3	13	57108	1336787973	/users/cn/jespinosa/phecomp/data/CRG/20120502_FDF_CRG/20120502_FDF_CRG/20120511_FDF_CRG_c12.mtb	3047	293	WWFF	food_fat	3	57095	1336787960	1	0.0800000000000001	0.00615384615384616	9879	1
4	Food 1	Intake 3	124	57525	1336788390	/users/cn/jespinosa/phecomp/data/CRG/20120502_FDF_CRG/20120502_FDF_CRG/20120511_FDF_CRG_c12.mtb	3050	1241	WWFF	food_fat	3	57401	1336788266	1	0.0400000000000009	0.000322580645161298	9880	1
4	Food 2	Intake 4	16	58782	1336789647	/users/cn/jespinosa/phecomp/data/CRG/20120502_FDF_CRG/20120502_FDF_CRG/20120511_FDF_CRG_c12.mtb	3643	1153	WWFF	food_fat	4	58766	1336789631	1	0.0200000000000005	0.00125000000000003	9881	1
4	Food 1	Intake 3	17	59952	1336790817	/users/cn/jespinosa/phecomp/data/CRG/20120502_FDF_CRG/20120502_FDF_CRG/20120511_FDF_CRG_c12.mtb	3062	1091	WWFF	food_fat	3	59935	1336790800	1	0.0200000000000014	0.00117647058823538	9882	1
4	Food 1	Intake 3	248	61291	1336792156	/users/cn/jespinosa/phecomp/data/CRG/20120502_FDF_CRG/20120502_FDF_CRG/20120511_FDF_CRG_c12.mtb	3074	COLL	WWFF	food_fat	3	61043	1336791908	1	0.24	0.000967741935483871	9883	1
4	Food 2	Intake 4	61	61110	1336791975	/users/cn/jespinosa/phecomp/data/CRG/20120502_FDF_CRG/20120502_FDF_CRG/20120511_FDF_CRG_c12.mtb	3646	74	WWFF	food_fat	4	61049	1336791914	1	0.0200000000000005	0.000327868852459025	9884	1
4	Food 2	Intake 4	106	61290	1336792155	/users/cn/jespinosa/phecomp/data/CRG/20120502_FDF_CRG/20120502_FDF_CRG/20120511_FDF_CRG_c12.mtb	3648	48	WWFF	food_fat	4	61184	1336792049	1	0.0999999999999996	0.000943396226415091	9885	1
4	Drink 2	Intake 2	36	61360	1336792225	/users/cn/jespinosa/phecomp/data/CRG/20120502_FDF_CRG/20120502_FDF_CRG/20120511_FDF_CRG_c12.mtb	1385	NA	WWFF	water	2	61324	1336792189	1	0.02	0.000555555555555556	9886	1
4	Food 2	Intake 4	32	61370	1336792235	/users/cn/jespinosa/phecomp/data/CRG/20120502_FDF_CRG/20120502_FDF_CRG/20120511_FDF_CRG_c12.mtb	3650	63	WWFF	food_fat	4	61338	1336792203	1	0.0600000000000005	0.00187500000000002	9887	1
4	Food 1	Intake 3	89	61522	1336792387	/users/cn/jespinosa/phecomp/data/CRG/20120502_FDF_CRG/20120502_FDF_CRG/20120511_FDF_CRG_c12.mtb	3077	COLL	WWFF	food_fat	3	61433	1336792298	1	0.18	0.00202247191011236	9888	1
4	Food 2	Intake 4	69	61504	1336792369	/users/cn/jespinosa/phecomp/data/CRG/20120502_FDF_CRG/20120502_FDF_CRG/20120511_FDF_CRG_c12.mtb	3651	752	WWFF	food_fat	4	61435	1336792300	1	0.0599999999999996	0.000869565217391299	9889	1
4	Drink 2	Intake 2	34	62118	1336792983	/users/cn/jespinosa/phecomp/data/CRG/20120502_FDF_CRG/20120502_FDF_CRG/20120511_FDF_CRG_c12.mtb	1386	NA	WWFF	water	2	62084	1336792949	1	0.14	0.00411764705882353	9890	1
4	Food 1	Intake 3	23	62279	1336793144	/users/cn/jespinosa/phecomp/data/CRG/20120502_FDF_CRG/20120502_FDF_CRG/20120511_FDF_CRG_c12.mtb	3087	312	WWFF	food_fat	3	62256	1336793121	1	0.0999999999999996	0.0043478260869565	9891	1
4	Food 1	Intake 3	110	62701	1336793566	/users/cn/jespinosa/phecomp/data/CRG/20120502_FDF_CRG/20120502_FDF_CRG/20120511_FDF_CRG_c12.mtb	3090	467	WWFF	food_fat	3	62591	1336793456	1	0.0200000000000014	0.000181818181818195	9892	1
4	Food 1	Intake 3	18	63186	1336794051	/users/cn/jespinosa/phecomp/data/CRG/20120502_FDF_CRG/20120502_FDF_CRG/20120511_FDF_CRG_c12.mtb	3097	648	WWFF	food_fat	3	63168	1336794033	1	0.0399999999999991	0.00222222222222217	9893	1
4	Food 1	Intake 3	15	63849	1336794714	/users/cn/jespinosa/phecomp/data/CRG/20120502_FDF_CRG/20120502_FDF_CRG/20120511_FDF_CRG_c12.mtb	3102	504	WWFF	food_fat	3	63834	1336794699	1	0.0200000000000014	0.00133333333333343	9894	1
4	Food 1	Intake 3	33	64386	1336795251	/users/cn/jespinosa/phecomp/data/CRG/20120502_FDF_CRG/20120502_FDF_CRG/20120511_FDF_CRG_c12.mtb	3105	COLL	WWFF	food_fat	3	64353	1336795218	1	0.0200000000000014	0.000606060606060648	9895	1
4	Food 2	Intake 4	22	64377	1336795242	/users/cn/jespinosa/phecomp/data/CRG/20120502_FDF_CRG/20120502_FDF_CRG/20120511_FDF_CRG_c12.mtb	3655	1617	WWFF	food_fat	4	64355	1336795220	1	0.0200000000000005	0.000909090909090932	9896	1
4	Food 1	Intake 3	16	66010	1336796875	/users/cn/jespinosa/phecomp/data/CRG/20120502_FDF_CRG/20120502_FDF_CRG/20120511_FDF_CRG_c12.mtb	3114	51	WWFF	food_fat	3	65994	1336796859	1	0.140000000000001	0.00875000000000006	9897	1
4	Food 1	Intake 3	80	66141	1336797006	/users/cn/jespinosa/phecomp/data/CRG/20120502_FDF_CRG/20120502_FDF_CRG/20120511_FDF_CRG_c12.mtb	3116	536	WWFF	food_fat	3	66061	1336796926	1	0.159999999999998	0.00199999999999997	9898	1
4	Food 1	Intake 3	33	66710	1336797575	/users/cn/jespinosa/phecomp/data/CRG/20120502_FDF_CRG/20120502_FDF_CRG/20120511_FDF_CRG_c12.mtb	3120	177	WWFF	food_fat	3	66677	1336797542	1	0.0200000000000014	0.000606060606060648	9899	1
4	Food 2	Intake 4	18	66905	1336797770	/users/cn/jespinosa/phecomp/data/CRG/20120502_FDF_CRG/20120502_FDF_CRG/20120511_FDF_CRG_c12.mtb	3665	1763	WWFF	food_fat	4	66887	1336797752	1	0.0200000000000005	0.00111111111111114	9900	1
4	Food 2	Intake 4	73	68741	1336799606	/users/cn/jespinosa/phecomp/data/CRG/20120502_FDF_CRG/20120502_FDF_CRG/20120511_FDF_CRG_c12.mtb	3669	107	WWFF	food_fat	4	68668	1336799533	1	0.0599999999999996	0.000821917808219173	9901	1
4	Food 2	Intake 4	123	68971	1336799836	/users/cn/jespinosa/phecomp/data/CRG/20120502_FDF_CRG/20120502_FDF_CRG/20120511_FDF_CRG_c12.mtb	3672	129	WWFF	food_fat	4	68848	1336799713	1	0.04	0.00032520325203252	9902	1
4	Food 1	Intake 3	284	69384	1336800249	/users/cn/jespinosa/phecomp/data/CRG/20120502_FDF_CRG/20120502_FDF_CRG/20120511_FDF_CRG_c12.mtb	3138	COLL	WWFF	food_fat	3	69100	1336799965	1	0.0999999999999996	0.000352112676056337	9903	1
4	Food 2	Intake 4	237	69378	1336800243	/users/cn/jespinosa/phecomp/data/CRG/20120502_FDF_CRG/20120502_FDF_CRG/20120511_FDF_CRG_c12.mtb	3674	130	WWFF	food_fat	4	69141	1336800006	1	0.4	0.00168776371308017	9904	1
4	Drink 1	Intake 1	31	69454	1336800319	/users/cn/jespinosa/phecomp/data/CRG/20120502_FDF_CRG/20120502_FDF_CRG/20120511_FDF_CRG_c12.mtb	1504	NA	WWFF	water	1	69423	1336800288	1	0.1	0.0032258064516129	9905	1
4	Food 1	Intake 3	343	69851	1336800716	/users/cn/jespinosa/phecomp/data/CRG/20120502_FDF_CRG/20120502_FDF_CRG/20120511_FDF_CRG_c12.mtb	3140	89	WWFF	food_fat	3	69508	1336800373	1	1.9	0.00553935860058309	9906	1
4	Food 1	Intake 3	199	70139	1336801004	/users/cn/jespinosa/phecomp/data/CRG/20120502_FDF_CRG/20120502_FDF_CRG/20120511_FDF_CRG_c12.mtb	3142	635	WWFF	food_fat	3	69940	1336800805	1	0.459999999999999	0.00231155778894472	9907	1
4	Drink 2	Intake 2	24	70698	1336801563	/users/cn/jespinosa/phecomp/data/CRG/20120502_FDF_CRG/20120502_FDF_CRG/20120511_FDF_CRG_c12.mtb	1389	NA	WWFF	water	2	70674	1336801539	1	0.0600000000000001	0.0025	9908	1
4	Food 1	Intake 3	29	70803	1336801668	/users/cn/jespinosa/phecomp/data/CRG/20120502_FDF_CRG/20120502_FDF_CRG/20120511_FDF_CRG_c12.mtb	3146	212	WWFF	food_fat	3	70774	1336801639	1	0.0200000000000014	0.000689655172413841	9909	1
4	Food 1	Intake 3	99	71114	1336801979	/users/cn/jespinosa/phecomp/data/CRG/20120502_FDF_CRG/20120502_FDF_CRG/20120511_FDF_CRG_c12.mtb	3148	COLL	WWFF	food_fat	3	71015	1336801880	1	0.220000000000001	0.00222222222222223	9910	1
4	Food 2	Intake 4	86	71113	1336801978	/users/cn/jespinosa/phecomp/data/CRG/20120502_FDF_CRG/20120502_FDF_CRG/20120511_FDF_CRG_c12.mtb	3685	8	WWFF	food_fat	4	71027	1336801892	1	0.04	0.000465116279069767	9911	1
4	Food 1	Intake 3	123	71244	1336802109	/users/cn/jespinosa/phecomp/data/CRG/20120502_FDF_CRG/20120502_FDF_CRG/20120511_FDF_CRG_c12.mtb	3149	COLL	WWFF	food_fat	3	71121	1336801986	1	0.0599999999999987	0.00048780487804877	9912	1
4	Food 2	Intake 4	18	71230	1336802095	/users/cn/jespinosa/phecomp/data/CRG/20120502_FDF_CRG/20120502_FDF_CRG/20120511_FDF_CRG_c12.mtb	3688	555	WWFF	food_fat	4	71212	1336802077	1	0.04	0.00222222222222222	9913	1
4	Food 2	Intake 4	116	71901	1336802766	/users/cn/jespinosa/phecomp/data/CRG/20120502_FDF_CRG/20120502_FDF_CRG/20120511_FDF_CRG_c12.mtb	3692	COLL	WWFF	food_fat	4	71785	1336802650	1	0.04	0.000344827586206897	9914	1
4	Food 1	Intake 3	102	71954	1336802819	/users/cn/jespinosa/phecomp/data/CRG/20120502_FDF_CRG/20120502_FDF_CRG/20120511_FDF_CRG_c12.mtb	3156	121	WWFF	food_fat	3	71852	1336802717	1	0.0800000000000001	0.000784313725490197	9915	1
4	Food 1	Intake 3	75	72150	1336803015	/users/cn/jespinosa/phecomp/data/CRG/20120502_FDF_CRG/20120502_FDF_CRG/20120511_FDF_CRG_c12.mtb	3159	363	WWFF	food_fat	3	72075	1336802940	1	0.159999999999998	0.00213333333333331	9916	1
4	Drink 1	Intake 1	20	72162	1336803027	/users/cn/jespinosa/phecomp/data/CRG/20120502_FDF_CRG/20120502_FDF_CRG/20120511_FDF_CRG_c12.mtb	1507	NA	WWFF	water	1	72142	1336803007	1	0.0600000000000001	0.00300000000000001	9917	1
4	Food 1	Intake 3	13	72526	1336803391	/users/cn/jespinosa/phecomp/data/CRG/20120502_FDF_CRG/20120502_FDF_CRG/20120511_FDF_CRG_c12.mtb	3161	1378	WWFF	food_fat	3	72513	1336803378	1	0.0200000000000014	0.00153846153846165	9918	1
4	Food 1	Intake 3	19	73923	1336804788	/users/cn/jespinosa/phecomp/data/CRG/20120502_FDF_CRG/20120502_FDF_CRG/20120511_FDF_CRG_c12.mtb	3165	1054	WWFF	food_fat	3	73904	1336804769	1	0.0400000000000009	0.00210526315789478	9919	1
4	Food 1	Intake 3	55	75032	1336805897	/users/cn/jespinosa/phecomp/data/CRG/20120502_FDF_CRG/20120502_FDF_CRG/20120511_FDF_CRG_c12.mtb	3170	923	WWFF	food_fat	3	74977	1336805842	1	0.220000000000001	0.00400000000000002	9920	1
4	Drink 1	Intake 1	23	75659	1336806524	/users/cn/jespinosa/phecomp/data/CRG/20120502_FDF_CRG/20120502_FDF_CRG/20120511_FDF_CRG_c12.mtb	1508	NA	WWFF	water	1	75636	1336806501	1	0.0600000000000001	0.00260869565217392	9921	1
4	Food 1	Intake 3	25	75980	1336806845	/users/cn/jespinosa/phecomp/data/CRG/20120502_FDF_CRG/20120502_FDF_CRG/20120511_FDF_CRG_c12.mtb	3175	COLL	WWFF	food_fat	3	75955	1336806820	1	0.299999999999999	0.012	9922	1
4	Food 2	Intake 4	13	75978	1336806843	/users/cn/jespinosa/phecomp/data/CRG/20120502_FDF_CRG/20120502_FDF_CRG/20120511_FDF_CRG_c12.mtb	3699	233	WWFF	food_fat	4	75965	1336806830	1	0.0600000000000005	0.00461538461538465	9923	1
4	Food 1	Intake 3	20	76231	1336807096	/users/cn/jespinosa/phecomp/data/CRG/20120502_FDF_CRG/20120502_FDF_CRG/20120511_FDF_CRG_c12.mtb	3176	440	WWFF	food_fat	3	76211	1336807076	1	0.0400000000000009	0.00200000000000005	9924	1
4	Food 1	Intake 3	26	76697	1336807562	/users/cn/jespinosa/phecomp/data/CRG/20120502_FDF_CRG/20120502_FDF_CRG/20120511_FDF_CRG_c12.mtb	3179	83	WWFF	food_fat	3	76671	1336807536	1	0.0399999999999991	0.0015384615384615	9925	1
4	Food 1	Intake 3	28	76808	1336807673	/users/cn/jespinosa/phecomp/data/CRG/20120502_FDF_CRG/20120502_FDF_CRG/20120511_FDF_CRG_c12.mtb	3180	243	WWFF	food_fat	3	76780	1336807645	1	0.0200000000000014	0.000714285714285764	9926	1
4	Food 1	Intake 3	19	77070	1336807935	/users/cn/jespinosa/phecomp/data/CRG/20120502_FDF_CRG/20120502_FDF_CRG/20120511_FDF_CRG_c12.mtb	3182	348	WWFF	food_fat	3	77051	1336807916	1	0.0399999999999991	0.00210526315789469	9927	1
4	Drink 2	Intake 2	26	77425	1336808290	/users/cn/jespinosa/phecomp/data/CRG/20120502_FDF_CRG/20120502_FDF_CRG/20120511_FDF_CRG_c12.mtb	1390	NA	WWFF	water	2	77399	1336808264	1	0.12	0.00461538461538461	9928	1
4	Food 1	Intake 3	17	77435	1336808300	/users/cn/jespinosa/phecomp/data/CRG/20120502_FDF_CRG/20120502_FDF_CRG/20120511_FDF_CRG_c12.mtb	3184	149	WWFF	food_fat	3	77418	1336808283	1	0.26	0.0152941176470588	9929	1
4	Food 1	Intake 3	26	77610	1336808475	/users/cn/jespinosa/phecomp/data/CRG/20120502_FDF_CRG/20120502_FDF_CRG/20120511_FDF_CRG_c12.mtb	3185	5132	WWFF	food_fat	3	77584	1336808449	1	0.0200000000000014	0.000769230769230823	9930	1
4	Drink 2	Intake 2	15	82266	1336813131	/users/cn/jespinosa/phecomp/data/CRG/20120502_FDF_CRG/20120502_FDF_CRG/20120511_FDF_CRG_c12.mtb	1391	NA	WWFF	water	2	82251	1336813116	1	0.04	0.00266666666666667	9931	1
4	Food 1	Intake 3	13	82755	1336813620	/users/cn/jespinosa/phecomp/data/CRG/20120502_FDF_CRG/20120502_FDF_CRG/20120511_FDF_CRG_c12.mtb	3205	853	WWFF	food_fat	3	82742	1336813607	1	0.0399999999999991	0.00307692307692301	9932	1
4	Food 1	Intake 3	39	83647	1336814512	/users/cn/jespinosa/phecomp/data/CRG/20120502_FDF_CRG/20120502_FDF_CRG/20120511_FDF_CRG_c12.mtb	3210	COLL	WWFF	food_fat	3	83608	1336814473	1	0.32	0.00820512820512821	9933	1
4	Food 2	Intake 4	13	83633	1336814498	/users/cn/jespinosa/phecomp/data/CRG/20120502_FDF_CRG/20120502_FDF_CRG/20120511_FDF_CRG_c12.mtb	3706	1120	WWFF	food_fat	4	83620	1336814485	1	0.0600000000000005	0.00461538461538465	9934	1
4	Food 1	Intake 3	17	84770	1336815635	/users/cn/jespinosa/phecomp/data/CRG/20120502_FDF_CRG/20120502_FDF_CRG/20120511_FDF_CRG_c12.mtb	3211	627	WWFF	food_fat	3	84753	1336815618	1	0.0200000000000014	0.00117647058823538	9935	1
4	Drink 1	Intake 1	26	84978	1336815843	/users/cn/jespinosa/phecomp/data/CRG/20120502_FDF_CRG/20120502_FDF_CRG/20120511_FDF_CRG_c12.mtb	1509	NA	WWFF	water	1	84952	1336815817	1	0.12	0.00461538461538461	9936	1
4	Food 1	Intake 3	34	85431	1336816296	/users/cn/jespinosa/phecomp/data/CRG/20120502_FDF_CRG/20120502_FDF_CRG/20120511_FDF_CRG_c12.mtb	3213	383	WWFF	food_fat	3	85397	1336816262	1	0.0399999999999991	0.00117647058823527	9937	1
4	Drink 2	Intake 2	13	85706	1336816571	/users/cn/jespinosa/phecomp/data/CRG/20120502_FDF_CRG/20120502_FDF_CRG/20120511_FDF_CRG_c12.mtb	1392	NA	WWFF	water	2	85693	1336816558	1	0.04	0.00307692307692308	9938	1
4	Food 1	Intake 3	28	85842	1336816707	/users/cn/jespinosa/phecomp/data/CRG/20120502_FDF_CRG/20120502_FDF_CRG/20120511_FDF_CRG_c12.mtb	3215	321	WWFF	food_fat	3	85814	1336816679	1	0.0200000000000014	0.000714285714285764	9939	1
4	Food 1	Intake 3	20	86183	1336817048	/users/cn/jespinosa/phecomp/data/CRG/20120502_FDF_CRG/20120502_FDF_CRG/20120511_FDF_CRG_c12.mtb	3218	62	WWFF	food_fat	3	86163	1336817028	1	0.0400000000000009	0.00200000000000005	9940	1
4	Food 1	Intake 3	13	86258	1336817123	/users/cn/jespinosa/phecomp/data/CRG/20120502_FDF_CRG/20120502_FDF_CRG/20120511_FDF_CRG_c12.mtb	3219	624	WWFF	food_fat	3	86245	1336817110	1	0.0600000000000005	0.00461538461538465	9941	1
4	Food 1	Intake 3	11	86893	1336817758	/users/cn/jespinosa/phecomp/data/CRG/20120502_FDF_CRG/20120502_FDF_CRG/20120511_FDF_CRG_c12.mtb	3224	1058	WWFF	food_fat	3	86882	1336817747	1	0.0399999999999991	0.00363636363636355	9942	1
4	Drink 1	Intake 1	27	87946	1336818811	/users/cn/jespinosa/phecomp/data/CRG/20120502_FDF_CRG/20120502_FDF_CRG/20120511_FDF_CRG_c12.mtb	1510	NA	WWFF	water	1	87919	1336818784	1	0.12	0.00444444444444444	9943	1
4	Food 1	Intake 3	24	87975	1336818840	/users/cn/jespinosa/phecomp/data/CRG/20120502_FDF_CRG/20120502_FDF_CRG/20120511_FDF_CRG_c12.mtb	3236	1290	WWFF	food_fat	3	87951	1336818816	1	0.0200000000000014	0.000833333333333392	9944	1
4	Food 2	Intake 4	16	89281	1336820146	/users/cn/jespinosa/phecomp/data/CRG/20120502_FDF_CRG/20120502_FDF_CRG/20120511_FDF_CRG_c12.mtb	3711	3521	WWFF	food_fat	4	89265	1336820130	1	0.12	0.0075	9945	1
4	Drink 1	Intake 1	20	91200	1336822065	/users/cn/jespinosa/phecomp/data/CRG/20120502_FDF_CRG/20120502_FDF_CRG/20120511_FDF_CRG_c12.mtb	1511	NA	WWFF	water	1	91180	1336822045	1	0.0599999999999998	0.00299999999999999	9946	1
4	Food 1	Intake 3	21	92823	1336823688	/users/cn/jespinosa/phecomp/data/CRG/20120502_FDF_CRG/20120502_FDF_CRG/20120511_FDF_CRG_c12.mtb	3250	COLL	WWFF	food_fat	3	92802	1336823667	1	0.42	0.02	9947	1
4	Food 2	Intake 4	18	92822	1336823687	/users/cn/jespinosa/phecomp/data/CRG/20120502_FDF_CRG/20120502_FDF_CRG/20120511_FDF_CRG_c12.mtb	3713	2522	WWFF	food_fat	4	92804	1336823669	1	0.0999999999999996	0.00555555555555553	9948	1
4	Drink 1	Intake 1	16	93985	1336824850	/users/cn/jespinosa/phecomp/data/CRG/20120502_FDF_CRG/20120502_FDF_CRG/20120511_FDF_CRG_c12.mtb	1512	NA	WWFF	water	1	93969	1336824834	1	0.04	0.0025	9949	1
4	Food 1	Intake 3	14	95358	1336826223	/users/cn/jespinosa/phecomp/data/CRG/20120502_FDF_CRG/20120502_FDF_CRG/20120511_FDF_CRG_c12.mtb	3260	3233	WWFF	food_fat	3	95344	1336826209	1	0.0399999999999991	0.00285714285714279	9950	1
4	Drink 1	Intake 1	28	95407	1336826272	/users/cn/jespinosa/phecomp/data/CRG/20120502_FDF_CRG/20120502_FDF_CRG/20120511_FDF_CRG_c12.mtb	1513	NA	WWFF	water	1	95379	1336826244	1	0.14	0.005	9951	1
4	Food 2	Intake 4	44	98635	1336829500	/users/cn/jespinosa/phecomp/data/CRG/20120502_FDF_CRG/20120502_FDF_CRG/20120511_FDF_CRG_c12.mtb	3715	226	WWFF	food_fat	4	98591	1336829456	1	0.0200000000000005	0.000454545454545466	9952	1
4	Food 2	Intake 4	13	98874	1336829739	/users/cn/jespinosa/phecomp/data/CRG/20120502_FDF_CRG/20120502_FDF_CRG/20120511_FDF_CRG_c12.mtb	3717	56	WWFF	food_fat	4	98861	1336829726	1	0.0600000000000005	0.00461538461538465	9953	1
4	Food 2	Intake 4	12	98942	1336829807	/users/cn/jespinosa/phecomp/data/CRG/20120502_FDF_CRG/20120502_FDF_CRG/20120511_FDF_CRG_c12.mtb	3719	14	WWFF	food_fat	4	98930	1336829795	1	0.04	0.00333333333333333	9954	1
4	Food 2	Intake 4	44	99000	1336829865	/users/cn/jespinosa/phecomp/data/CRG/20120502_FDF_CRG/20120502_FDF_CRG/20120511_FDF_CRG_c12.mtb	3720	365	WWFF	food_fat	4	98956	1336829821	1	0.0200000000000005	0.000454545454545466	9955	1
4	Food 1	Intake 3	25	99390	1336830255	/users/cn/jespinosa/phecomp/data/CRG/20120502_FDF_CRG/20120502_FDF_CRG/20120511_FDF_CRG_c12.mtb	3278	COLL	WWFF	food_fat	3	99365	1336830230	1	0.219999999999999	0.00879999999999996	9956	1
4	Food 2	Intake 4	23	99389	1336830254	/users/cn/jespinosa/phecomp/data/CRG/20120502_FDF_CRG/20120502_FDF_CRG/20120511_FDF_CRG_c12.mtb	3723	39	WWFF	food_fat	4	99366	1336830231	1	0.04	0.00173913043478261	9957	1
4	Food 2	Intake 4	19	99447	1336830312	/users/cn/jespinosa/phecomp/data/CRG/20120502_FDF_CRG/20120502_FDF_CRG/20120511_FDF_CRG_c12.mtb	3725	378	WWFF	food_fat	4	99428	1336830293	1	0.0200000000000005	0.00105263157894739	9958	1
4	Drink 1	Intake 1	18	99521	1336830386	/users/cn/jespinosa/phecomp/data/CRG/20120502_FDF_CRG/20120502_FDF_CRG/20120511_FDF_CRG_c12.mtb	1516	NA	WWFF	water	1	99503	1336830368	1	0.04	0.00222222222222222	9959	1
4	Drink 2	Intake 2	21	99534	1336830399	/users/cn/jespinosa/phecomp/data/CRG/20120502_FDF_CRG/20120502_FDF_CRG/20120511_FDF_CRG_c12.mtb	1395	NA	WWFF	water	2	99513	1336830378	1	0.04	0.0019047619047619	9960	1
4	Food 2	Intake 4	77	99902	1336830767	/users/cn/jespinosa/phecomp/data/CRG/20120502_FDF_CRG/20120502_FDF_CRG/20120511_FDF_CRG_c12.mtb	3731	44	WWFF	food_fat	4	99825	1336830690	1	0.04	0.000519480519480519	9961	1
4	Food 1	Intake 3	175	100121	1336830986	/users/cn/jespinosa/phecomp/data/CRG/20120502_FDF_CRG/20120502_FDF_CRG/20120511_FDF_CRG_c12.mtb	3282	COLL	WWFF	food_fat	3	99946	1336830811	1	0.140000000000001	0.000800000000000006	9962	1
4	Food 2	Intake 4	44	100123	1336830988	/users/cn/jespinosa/phecomp/data/CRG/20120502_FDF_CRG/20120502_FDF_CRG/20120511_FDF_CRG_c12.mtb	3734	80	WWFF	food_fat	4	100079	1336830944	1	0.0200000000000005	0.000454545454545466	9963	1
4	Food 1	Intake 3	31	100234	1336831099	/users/cn/jespinosa/phecomp/data/CRG/20120502_FDF_CRG/20120502_FDF_CRG/20120511_FDF_CRG_c12.mtb	3284	32	WWFF	food_fat	3	100203	1336831068	1	0.0399999999999991	0.00129032258064513	9964	1
4	Food 1	Intake 3	135	100401	1336831266	/users/cn/jespinosa/phecomp/data/CRG/20120502_FDF_CRG/20120502_FDF_CRG/20120511_FDF_CRG_c12.mtb	3285	COLL	WWFF	food_fat	3	100266	1336831131	1	0.139999999999999	0.00103703703703703	9965	1
4	Food 2	Intake 4	11	100278	1336831143	/users/cn/jespinosa/phecomp/data/CRG/20120502_FDF_CRG/20120502_FDF_CRG/20120511_FDF_CRG_c12.mtb	3737	799	WWFF	food_fat	4	100267	1336831132	1	0.04	0.00363636363636364	9966	1
4	Drink 1	Intake 1	17	100389	1336831254	/users/cn/jespinosa/phecomp/data/CRG/20120502_FDF_CRG/20120502_FDF_CRG/20120511_FDF_CRG_c12.mtb	1517	NA	WWFF	water	1	100372	1336831237	1	0.02	0.00117647058823529	9967	1
4	Food 1	Intake 3	67	101144	1336832009	/users/cn/jespinosa/phecomp/data/CRG/20120502_FDF_CRG/20120502_FDF_CRG/20120511_FDF_CRG_c12.mtb	3293	167	WWFF	food_fat	3	101077	1336831942	1	0.0200000000000031	0.000298507462686613	9968	1
4	Food 2	Intake 4	10	101321	1336832186	/users/cn/jespinosa/phecomp/data/CRG/20120502_FDF_CRG/20120502_FDF_CRG/20120511_FDF_CRG_c12.mtb	3742	308	WWFF	food_fat	4	101311	1336832176	1	0.04	0.004	9969	1
4	Food 1	Intake 3	20	101649	1336832514	/users/cn/jespinosa/phecomp/data/CRG/20120502_FDF_CRG/20120502_FDF_CRG/20120511_FDF_CRG_c12.mtb	3298	471	WWFF	food_fat	3	101629	1336832494	1	0.0800000000000001	0.00400000000000001	9970	1
4	Food 2	Intake 4	29	102149	1336833014	/users/cn/jespinosa/phecomp/data/CRG/20120502_FDF_CRG/20120502_FDF_CRG/20120511_FDF_CRG_c12.mtb	3745	1914	WWFF	food_fat	4	102120	1336832985	1	0.0200000000000005	0.00068965517241381	9971	1
4	Food 1	Intake 3	38	104101	1336834966	/users/cn/jespinosa/phecomp/data/CRG/20120502_FDF_CRG/20120502_FDF_CRG/20120511_FDF_CRG_c12.mtb	3315	1387	WWFF	food_fat	3	104063	1336834928	1	0.0600000000000005	0.00157894736842107	9972	1
4	Food 1	Intake 3	12	105500	1336836365	/users/cn/jespinosa/phecomp/data/CRG/20120502_FDF_CRG/20120502_FDF_CRG/20120511_FDF_CRG_c12.mtb	3318	36	WWFF	food_fat	3	105488	1336836353	1	0.0399999999999991	0.00333333333333326	9973	1
4	Food 1	Intake 3	80	105616	1336836481	/users/cn/jespinosa/phecomp/data/CRG/20120502_FDF_CRG/20120502_FDF_CRG/20120511_FDF_CRG_c12.mtb	3319	8871	WWFF	food_fat	3	105536	1336836401	1	0.0200000000000014	0.000250000000000017	9974	1
4	Drink 2	Intake 2	27	110411	1336841276	/users/cn/jespinosa/phecomp/data/CRG/20120502_FDF_CRG/20120502_FDF_CRG/20120511_FDF_CRG_c12.mtb	1398	NA	WWFF	water	2	110384	1336841249	1	0.0999999999999999	0.0037037037037037	9975	1
4	Drink 2	Intake 2	16	112044	1336842909	/users/cn/jespinosa/phecomp/data/CRG/20120502_FDF_CRG/20120502_FDF_CRG/20120511_FDF_CRG_c12.mtb	1399	NA	WWFF	water	2	112028	1336842893	1	0.04	0.0025	9976	1
4	Drink 2	Intake 2	21	113001	1336843866	/users/cn/jespinosa/phecomp/data/CRG/20120502_FDF_CRG/20120502_FDF_CRG/20120511_FDF_CRG_c12.mtb	1400	NA	WWFF	water	2	112980	1336843845	1	0.0800000000000001	0.00380952380952381	9977	1
4	Food 2	Intake 4	20	114507	1336845372	/users/cn/jespinosa/phecomp/data/CRG/20120502_FDF_CRG/20120502_FDF_CRG/20120511_FDF_CRG_c12.mtb	3758	1411	WWFF	food_fat	4	114487	1336845352	1	0.04	0.002	9978	1
4	Food 1	Intake 3	12	115930	1336846795	/users/cn/jespinosa/phecomp/data/CRG/20120502_FDF_CRG/20120502_FDF_CRG/20120511_FDF_CRG_c12.mtb	3327	282	WWFF	food_fat	3	115918	1336846783	1	0.0600000000000005	0.00500000000000004	9979	1
4	Food 1	Intake 3	12	116224	1336847089	/users/cn/jespinosa/phecomp/data/CRG/20120502_FDF_CRG/20120502_FDF_CRG/20120511_FDF_CRG_c12.mtb	3328	109	WWFF	food_fat	3	116212	1336847077	1	0.0399999999999991	0.00333333333333326	9980	1
4	Food 1	Intake 3	12	116345	1336847210	/users/cn/jespinosa/phecomp/data/CRG/20120502_FDF_CRG/20120502_FDF_CRG/20120511_FDF_CRG_c12.mtb	3329	153	WWFF	food_fat	3	116333	1336847198	1	0.0200000000000014	0.00166666666666678	9981	1
4	Food 2	Intake 4	34	116532	1336847397	/users/cn/jespinosa/phecomp/data/CRG/20120502_FDF_CRG/20120502_FDF_CRG/20120511_FDF_CRG_c12.mtb	3760	904	WWFF	food_fat	4	116498	1336847363	1	0.0200000000000005	0.000588235294117662	9982	1
4	Drink 2	Intake 2	38	116856	1336847721	/users/cn/jespinosa/phecomp/data/CRG/20120502_FDF_CRG/20120502_FDF_CRG/20120511_FDF_CRG_c12.mtb	1404	NA	WWFF	water	2	116818	1336847683	1	0.04	0.00105263157894737	9983	1
4	Food 1	Intake 3	20	117456	1336848321	/users/cn/jespinosa/phecomp/data/CRG/20120502_FDF_CRG/20120502_FDF_CRG/20120511_FDF_CRG_c12.mtb	3335	326	WWFF	food_fat	3	117436	1336848301	1	0.0400000000000009	0.00200000000000005	9984	1
4	Food 1	Intake 3	23	117805	1336848670	/users/cn/jespinosa/phecomp/data/CRG/20120502_FDF_CRG/20120502_FDF_CRG/20120511_FDF_CRG_c12.mtb	3338	112	WWFF	food_fat	3	117782	1336848647	1	0.100000000000001	0.00434782608695657	9985	1
4	Food 1	Intake 3	33	117950	1336848815	/users/cn/jespinosa/phecomp/data/CRG/20120502_FDF_CRG/20120502_FDF_CRG/20120511_FDF_CRG_c12.mtb	3340	95	WWFF	food_fat	3	117917	1336848782	1	0.0800000000000001	0.00242424242424243	9986	1
4	Food 2	Intake 4	29	118074	1336848939	/users/cn/jespinosa/phecomp/data/CRG/20120502_FDF_CRG/20120502_FDF_CRG/20120511_FDF_CRG_c12.mtb	3769	144	WWFF	food_fat	4	118045	1336848910	1	0.0200000000000005	0.00068965517241381	9987	1
4	Food 1	Intake 3	41	118259	1336849124	/users/cn/jespinosa/phecomp/data/CRG/20120502_FDF_CRG/20120502_FDF_CRG/20120511_FDF_CRG_c12.mtb	3345	374	WWFF	food_fat	3	118218	1336849083	1	0.140000000000001	0.00341463414634149	9988	1
4	Food 1	Intake 3	57	118690	1336849555	/users/cn/jespinosa/phecomp/data/CRG/20120502_FDF_CRG/20120502_FDF_CRG/20120511_FDF_CRG_c12.mtb	3349	230	WWFF	food_fat	3	118633	1336849498	1	0.0999999999999996	0.00175438596491227	9989	1
4	Food 1	Intake 3	103	119023	1336849888	/users/cn/jespinosa/phecomp/data/CRG/20120502_FDF_CRG/20120502_FDF_CRG/20120511_FDF_CRG_c12.mtb	3352	367	WWFF	food_fat	3	118920	1336849785	1	0.16	0.00155339805825243	9990	1
4	Food 2	Intake 4	32	119422	1336850287	/users/cn/jespinosa/phecomp/data/CRG/20120502_FDF_CRG/20120502_FDF_CRG/20120511_FDF_CRG_c12.mtb	3776	89	WWFF	food_fat	4	119390	1336850255	1	0.0200000000000005	0.000625000000000016	9991	1
4	Food 1	Intake 3	43	119554	1336850419	/users/cn/jespinosa/phecomp/data/CRG/20120502_FDF_CRG/20120502_FDF_CRG/20120511_FDF_CRG_c12.mtb	3357	COLL	WWFF	food_fat	3	119511	1336850376	1	0.0800000000000001	0.00186046511627907	9992	1
4	Food 2	Intake 4	38	119553	1336850418	/users/cn/jespinosa/phecomp/data/CRG/20120502_FDF_CRG/20120502_FDF_CRG/20120511_FDF_CRG_c12.mtb	3778	129	WWFF	food_fat	4	119515	1336850380	1	0.04	0.00105263157894737	9993	1
4	Food 2	Intake 4	42	119724	1336850589	/users/cn/jespinosa/phecomp/data/CRG/20120502_FDF_CRG/20120502_FDF_CRG/20120511_FDF_CRG_c12.mtb	3780	61	WWFF	food_fat	4	119682	1336850547	1	0.04	0.000952380952380952	9994	1
4	Food 1	Intake 3	110	119895	1336850760	/users/cn/jespinosa/phecomp/data/CRG/20120502_FDF_CRG/20120502_FDF_CRG/20120511_FDF_CRG_c12.mtb	3359	COLL	WWFF	food_fat	3	119785	1336850650	1	0.0400000000000009	0.000363636363636372	9995	1
4	Food 2	Intake 4	74	119892	1336850757	/users/cn/jespinosa/phecomp/data/CRG/20120502_FDF_CRG/20120502_FDF_CRG/20120511_FDF_CRG_c12.mtb	3782	209	WWFF	food_fat	4	119818	1336850683	1	0.04	0.000540540540540541	9996	1
4	Food 2	Intake 4	107	120208	1336851073	/users/cn/jespinosa/phecomp/data/CRG/20120502_FDF_CRG/20120502_FDF_CRG/20120511_FDF_CRG_c12.mtb	3785	55	WWFF	food_fat	4	120101	1336850966	1	0.16	0.00149532710280374	9997	1
4	Food 2	Intake 4	75	120338	1336851203	/users/cn/jespinosa/phecomp/data/CRG/20120502_FDF_CRG/20120502_FDF_CRG/20120511_FDF_CRG_c12.mtb	3786	227	WWFF	food_fat	4	120263	1336851128	1	0.0600000000000005	0.000800000000000007	9998	1
4	Drink 2	Intake 2	23	120414	1336851279	/users/cn/jespinosa/phecomp/data/CRG/20120502_FDF_CRG/20120502_FDF_CRG/20120511_FDF_CRG_c12.mtb	1410	NA	WWFF	water	2	120391	1336851256	1	0.04	0.00173913043478261	9999	1
4	Food 1	Intake 3	91	120656	1336851521	/users/cn/jespinosa/phecomp/data/CRG/20120502_FDF_CRG/20120502_FDF_CRG/20120511_FDF_CRG_c12.mtb	3364	559	WWFF	food_fat	3	120565	1336851430	1	0.0600000000000005	0.000659340659340665	10000	1
4	Food 1	Intake 3	171	121386	1336852251	/users/cn/jespinosa/phecomp/data/CRG/20120502_FDF_CRG/20120502_FDF_CRG/20120511_FDF_CRG_c12.mtb	3369	104	WWFF	food_fat	3	121215	1336852080	1	0.0999999999999996	0.000584795321637425	10001	1
4	Drink 2	Intake 2	84	121432	1336852297	/users/cn/jespinosa/phecomp/data/CRG/20120502_FDF_CRG/20120502_FDF_CRG/20120511_FDF_CRG_c12.mtb	1411	NA	WWFF	water	2	121348	1336852213	1	0.04	0.000476190476190476	10002	1
4	Food 2	Intake 4	45	121535	1336852400	/users/cn/jespinosa/phecomp/data/CRG/20120502_FDF_CRG/20120502_FDF_CRG/20120511_FDF_CRG_c12.mtb	3792	10	WWFF	food_fat	4	121490	1336852355	1	0.04	0.000888888888888889	10003	1
4	Food 2	Intake 4	57	121602	1336852467	/users/cn/jespinosa/phecomp/data/CRG/20120502_FDF_CRG/20120502_FDF_CRG/20120511_FDF_CRG_c12.mtb	3793	63	WWFF	food_fat	4	121545	1336852410	1	0.0200000000000005	0.000350877192982465	10004	1
4	Drink 2	Intake 2	20	121677	1336852542	/users/cn/jespinosa/phecomp/data/CRG/20120502_FDF_CRG/20120502_FDF_CRG/20120511_FDF_CRG_c12.mtb	1413	NA	WWFF	water	2	121657	1336852522	1	0.0399999999999998	0.00199999999999999	10005	1
4	Food 1	Intake 3	15	121680	1336852545	/users/cn/jespinosa/phecomp/data/CRG/20120502_FDF_CRG/20120502_FDF_CRG/20120511_FDF_CRG_c12.mtb	3373	305	WWFF	food_fat	3	121665	1336852530	1	0.0999999999999996	0.00666666666666664	10006	1
4	Food 1	Intake 3	197	122182	1336853047	/users/cn/jespinosa/phecomp/data/CRG/20120502_FDF_CRG/20120502_FDF_CRG/20120511_FDF_CRG_c12.mtb	3375	614	WWFF	food_fat	3	121985	1336852850	1	0.0800000000000001	0.000406091370558376	10007	1
4	Food 1	Intake 3	115	122911	1336853776	/users/cn/jespinosa/phecomp/data/CRG/20120502_FDF_CRG/20120502_FDF_CRG/20120511_FDF_CRG_c12.mtb	3385	119	WWFF	food_fat	3	122796	1336853661	1	0.0999999999999996	0.000869565217391301	10008	1
4	Food 1	Intake 3	192	123222	1336854087	/users/cn/jespinosa/phecomp/data/CRG/20120502_FDF_CRG/20120502_FDF_CRG/20120511_FDF_CRG_c12.mtb	3387	COLL	WWFF	food_fat	3	123030	1336853895	1	0.0800000000000001	0.000416666666666667	10009	1
4	Food 2	Intake 4	37	123090	1336853955	/users/cn/jespinosa/phecomp/data/CRG/20120502_FDF_CRG/20120502_FDF_CRG/20120511_FDF_CRG_c12.mtb	3801	30	WWFF	food_fat	4	123053	1336853918	1	0.0599999999999996	0.00162162162162161	10010	1
4	Food 2	Intake 4	22	123142	1336854007	/users/cn/jespinosa/phecomp/data/CRG/20120502_FDF_CRG/20120502_FDF_CRG/20120511_FDF_CRG_c12.mtb	3802	41	WWFF	food_fat	4	123120	1336853985	1	0.04	0.00181818181818182	10011	1
4	Food 2	Intake 4	47	123230	1336854095	/users/cn/jespinosa/phecomp/data/CRG/20120502_FDF_CRG/20120502_FDF_CRG/20120511_FDF_CRG_c12.mtb	3803	25	WWFF	food_fat	4	123183	1336854048	1	0.04	0.000851063829787234	10012	1
4	Food 1	Intake 3	191	123446	1336854311	/users/cn/jespinosa/phecomp/data/CRG/20120502_FDF_CRG/20120502_FDF_CRG/20120511_FDF_CRG_c12.mtb	3388	COLL	WWFF	food_fat	3	123255	1336854120	1	0.139999999999999	0.000732984293193712	10013	1
4	Food 2	Intake 4	92	123444	1336854309	/users/cn/jespinosa/phecomp/data/CRG/20120502_FDF_CRG/20120502_FDF_CRG/20120511_FDF_CRG_c12.mtb	3805	20	WWFF	food_fat	4	123352	1336854217	1	0.12	0.00130434782608696	10014	1
4	Food 1	Intake 3	125	123589	1336854454	/users/cn/jespinosa/phecomp/data/CRG/20120502_FDF_CRG/20120502_FDF_CRG/20120511_FDF_CRG_c12.mtb	3389	COLL	WWFF	food_fat	3	123464	1336854329	1	0.0399999999999991	0.000319999999999993	10015	1
4	Drink 2	Intake 2	39	123505	1336854370	/users/cn/jespinosa/phecomp/data/CRG/20120502_FDF_CRG/20120502_FDF_CRG/20120511_FDF_CRG_c12.mtb	1416	NA	WWFF	water	2	123466	1336854331	1	0.0600000000000001	0.00153846153846154	10016	1
4	Food 2	Intake 4	89	123586	1336854451	/users/cn/jespinosa/phecomp/data/CRG/20120502_FDF_CRG/20120502_FDF_CRG/20120511_FDF_CRG_c12.mtb	3807	30	WWFF	food_fat	4	123497	1336854362	1	0.0800000000000001	0.000898876404494383	10017	1
4	Food 1	Intake 3	172	123788	1336854653	/users/cn/jespinosa/phecomp/data/CRG/20120502_FDF_CRG/20120502_FDF_CRG/20120511_FDF_CRG_c12.mtb	3390	COLL	WWFF	food_fat	3	123616	1336854481	1	0.0400000000000027	0.000232558139534899	10018	1
4	Food 2	Intake 4	112	123784	1336854649	/users/cn/jespinosa/phecomp/data/CRG/20120502_FDF_CRG/20120502_FDF_CRG/20120511_FDF_CRG_c12.mtb	3808	97	WWFF	food_fat	4	123672	1336854537	1	0.0800000000000001	0.000714285714285715	10019	1
4	Drink 2	Intake 2	27	123859	1336854724	/users/cn/jespinosa/phecomp/data/CRG/20120502_FDF_CRG/20120502_FDF_CRG/20120511_FDF_CRG_c12.mtb	1417	NA	WWFF	water	2	123832	1336854697	1	0.0799999999999998	0.00296296296296296	10020	1
4	Food 2	Intake 4	33	123914	1336854779	/users/cn/jespinosa/phecomp/data/CRG/20120502_FDF_CRG/20120502_FDF_CRG/20120511_FDF_CRG_c12.mtb	3810	106	WWFF	food_fat	4	123881	1336854746	1	0.0600000000000005	0.00181818181818183	10021	1
4	Drink 2	Intake 2	16	124024	1336854889	/users/cn/jespinosa/phecomp/data/CRG/20120502_FDF_CRG/20120502_FDF_CRG/20120511_FDF_CRG_c12.mtb	1418	NA	WWFF	water	2	124008	1336854873	1	0.02	0.00125	10022	1
4	Food 2	Intake 4	27	124047	1336854912	/users/cn/jespinosa/phecomp/data/CRG/20120502_FDF_CRG/20120502_FDF_CRG/20120511_FDF_CRG_c12.mtb	3814	42	WWFF	food_fat	4	124020	1336854885	1	0.0200000000000005	0.000740740740740759	10023	1
4	Food 1	Intake 3	160	124249	1336855114	/users/cn/jespinosa/phecomp/data/CRG/20120502_FDF_CRG/20120502_FDF_CRG/20120511_FDF_CRG_c12.mtb	3392	COLL	WWFF	food_fat	3	124089	1336854954	1	0.18	0.001125	10024	1
4	Food 2	Intake 4	93	124246	1336855111	/users/cn/jespinosa/phecomp/data/CRG/20120502_FDF_CRG/20120502_FDF_CRG/20120511_FDF_CRG_c12.mtb	3815	337	WWFF	food_fat	4	124153	1336855018	1	0.04	0.00043010752688172	10025	1
4	Food 1	Intake 3	10	124593	1336855458	/users/cn/jespinosa/phecomp/data/CRG/20120502_FDF_CRG/20120502_FDF_CRG/20120511_FDF_CRG_c12.mtb	3396	72	WWFF	food_fat	3	124583	1336855448	1	0.0400000000000009	0.00400000000000009	10026	1
4	Food 2	Intake 4	72	124737	1336855602	/users/cn/jespinosa/phecomp/data/CRG/20120502_FDF_CRG/20120502_FDF_CRG/20120511_FDF_CRG_c12.mtb	3820	21	WWFF	food_fat	4	124665	1336855530	1	0.0200000000000005	0.000277777777777785	10027	1
4	Food 1	Intake 3	86	124844	1336855709	/users/cn/jespinosa/phecomp/data/CRG/20120502_FDF_CRG/20120502_FDF_CRG/20120511_FDF_CRG_c12.mtb	3398	134	WWFF	food_fat	3	124758	1336855623	1	0.26	0.00302325581395349	10028	1
4	Drink 1	Intake 1	24	124857	1336855722	/users/cn/jespinosa/phecomp/data/CRG/20120502_FDF_CRG/20120502_FDF_CRG/20120511_FDF_CRG_c12.mtb	1524	NA	WWFF	water	1	124833	1336855698	1	0.02	0.000833333333333333	10029	1
4	Food 2	Intake 4	43	125021	1336855886	/users/cn/jespinosa/phecomp/data/CRG/20120502_FDF_CRG/20120502_FDF_CRG/20120511_FDF_CRG_c12.mtb	3824	426	WWFF	food_fat	4	124978	1336855843	1	0.04	0.000930232558139535	10030	1
4	Food 2	Intake 4	78	125525	1336856390	/users/cn/jespinosa/phecomp/data/CRG/20120502_FDF_CRG/20120502_FDF_CRG/20120511_FDF_CRG_c12.mtb	3828	219	WWFF	food_fat	4	125447	1336856312	1	0.0200000000000005	0.000256410256410263	10031	1
4	Drink 1	Intake 1	17	125483	1336856348	/users/cn/jespinosa/phecomp/data/CRG/20120502_FDF_CRG/20120502_FDF_CRG/20120511_FDF_CRG_c12.mtb	1525	NA	WWFF	water	1	125466	1336856331	1	0.02	0.00117647058823529	10032	1
4	Food 1	Intake 3	17	125761	1336856626	/users/cn/jespinosa/phecomp/data/CRG/20120502_FDF_CRG/20120502_FDF_CRG/20120511_FDF_CRG_c12.mtb	3406	COLL	WWFF	food_fat	3	125744	1336856609	1	0.26	0.0152941176470588	10033	1
4	Food 2	Intake 4	12	125758	1336856623	/users/cn/jespinosa/phecomp/data/CRG/20120502_FDF_CRG/20120502_FDF_CRG/20120511_FDF_CRG_c12.mtb	3831	3721	WWFF	food_fat	4	125746	1336856611	1	0.04	0.00333333333333333	10034	1
4	Drink 2	Intake 2	17	127536	1336858401	/users/cn/jespinosa/phecomp/data/CRG/20120502_FDF_CRG/20120502_FDF_CRG/20120511_FDF_CRG_c12.mtb	1421	NA	WWFF	water	2	127519	1336858384	1	0.04	0.00235294117647059	10035	1
4	Food 1	Intake 3	44	129523	1336860388	/users/cn/jespinosa/phecomp/data/CRG/20120502_FDF_CRG/20120502_FDF_CRG/20120511_FDF_CRG_c12.mtb	3430	159	WWFF	food_fat	3	129479	1336860344	1	0.0399999999999991	0.000909090909090889	10036	1
4	Food 2	Intake 4	54	129736	1336860601	/users/cn/jespinosa/phecomp/data/CRG/20120502_FDF_CRG/20120502_FDF_CRG/20120511_FDF_CRG_c12.mtb	3834	335	WWFF	food_fat	4	129682	1336860547	1	0.0200000000000005	0.00037037037037038	10037	1
4	Food 1	Intake 3	110	130181	1336861046	/users/cn/jespinosa/phecomp/data/CRG/20120502_FDF_CRG/20120502_FDF_CRG/20120511_FDF_CRG_c12.mtb	3432	COLL	WWFF	food_fat	3	130071	1336860936	1	0.0200000000000031	0.00018181818181821	10038	1
4	Food 2	Intake 4	13	130178	1336861043	/users/cn/jespinosa/phecomp/data/CRG/20120502_FDF_CRG/20120502_FDF_CRG/20120511_FDF_CRG_c12.mtb	3836	1096	WWFF	food_fat	4	130165	1336861030	1	0.0599999999999996	0.00461538461538458	10039	1
4	Food 2	Intake 4	14	131288	1336862153	/users/cn/jespinosa/phecomp/data/CRG/20120502_FDF_CRG/20120502_FDF_CRG/20120511_FDF_CRG_c12.mtb	3839	348	WWFF	food_fat	4	131274	1336862139	1	0.0599999999999996	0.00428571428571426	10040	1
4	Food 2	Intake 4	99	131735	1336862600	/users/cn/jespinosa/phecomp/data/CRG/20120502_FDF_CRG/20120502_FDF_CRG/20120511_FDF_CRG_c12.mtb	3840	174	WWFF	food_fat	4	131636	1336862501	1	0.0400000000000009	0.000404040404040413	10041	1
4	Food 1	Intake 3	163	132072	1336862937	/users/cn/jespinosa/phecomp/data/CRG/20120502_FDF_CRG/20120502_FDF_CRG/20120511_FDF_CRG_c12.mtb	3448	30	WWFF	food_fat	3	131909	1336862774	1	0.279999999999999	0.00171779141104294	10042	1
4	Food 1	Intake 3	315	132417	1336863282	/users/cn/jespinosa/phecomp/data/CRG/20120502_FDF_CRG/20120502_FDF_CRG/20120511_FDF_CRG_c12.mtb	3449	COLL	WWFF	food_fat	3	132102	1336862967	1	0.199999999999999	0.000634920634920632	10043	1
4	Food 2	Intake 4	152	132330	1336863195	/users/cn/jespinosa/phecomp/data/CRG/20120502_FDF_CRG/20120502_FDF_CRG/20120511_FDF_CRG_c12.mtb	3845	65	WWFF	food_fat	4	132178	1336863043	1	0.0999999999999996	0.000657894736842103	10044	1
4	Food 2	Intake 4	16	132411	1336863276	/users/cn/jespinosa/phecomp/data/CRG/20120502_FDF_CRG/20120502_FDF_CRG/20120511_FDF_CRG_c12.mtb	3846	134	WWFF	food_fat	4	132395	1336863260	1	0.0400000000000009	0.00250000000000006	10045	1
4	Food 2	Intake 4	83	132628	1336863493	/users/cn/jespinosa/phecomp/data/CRG/20120502_FDF_CRG/20120502_FDF_CRG/20120511_FDF_CRG_c12.mtb	3848	49	WWFF	food_fat	4	132545	1336863410	1	0.0400000000000009	0.000481927710843384	10046	1
4	Food 1	Intake 3	126	132803	1336863668	/users/cn/jespinosa/phecomp/data/CRG/20120502_FDF_CRG/20120502_FDF_CRG/20120511_FDF_CRG_c12.mtb	3451	362	WWFF	food_fat	3	132677	1336863542	1	0.18	0.00142857142857143	10047	1
4	Drink 2	Intake 2	17	132704	1336863569	/users/cn/jespinosa/phecomp/data/CRG/20120502_FDF_CRG/20120502_FDF_CRG/20120511_FDF_CRG_c12.mtb	1422	NA	WWFF	water	2	132687	1336863552	1	0.02	0.00117647058823529	10048	1
4	Drink 1	Intake 1	24	132816	1336863681	/users/cn/jespinosa/phecomp/data/CRG/20120502_FDF_CRG/20120502_FDF_CRG/20120511_FDF_CRG_c12.mtb	1528	NA	WWFF	water	1	132792	1336863657	1	0.0999999999999999	0.00416666666666666	10049	1
4	Drink 1	Intake 1	70	133030	1336863895	/users/cn/jespinosa/phecomp/data/CRG/20120502_FDF_CRG/20120502_FDF_CRG/20120511_FDF_CRG_c12.mtb	1529	NA	WWFF	water	1	132960	1336863825	1	0.02	0.000285714285714286	10050	1
4	Food 1	Intake 3	157	133322	1336864187	/users/cn/jespinosa/phecomp/data/CRG/20120502_FDF_CRG/20120502_FDF_CRG/20120511_FDF_CRG_c12.mtb	3453	215	WWFF	food_fat	3	133165	1336864030	1	0.120000000000001	0.000764331210191089	10051	1
4	Food 1	Intake 3	295	133832	1336864697	/users/cn/jespinosa/phecomp/data/CRG/20120502_FDF_CRG/20120502_FDF_CRG/20120511_FDF_CRG_c12.mtb	3457	1055	WWFF	food_fat	3	133537	1336864402	1	0.220000000000002	0.000745762711864414	10052	1
4	Food 1	Intake 3	232	135119	1336865984	/users/cn/jespinosa/phecomp/data/CRG/20120502_FDF_CRG/20120502_FDF_CRG/20120511_FDF_CRG_c12.mtb	3465	COLL	WWFF	food_fat	3	134887	1336865752	1	0.259999999999998	0.00112068965517241	10053	1
4	Food 2	Intake 4	67	134994	1336865859	/users/cn/jespinosa/phecomp/data/CRG/20120502_FDF_CRG/20120502_FDF_CRG/20120511_FDF_CRG_c12.mtb	3865	525	WWFF	food_fat	4	134927	1336865792	1	0.0200000000000014	0.000298507462686588	10054	1
4	Drink 2	Intake 2	23	135249	1336866114	/users/cn/jespinosa/phecomp/data/CRG/20120502_FDF_CRG/20120502_FDF_CRG/20120511_FDF_CRG_c12.mtb	1427	NA	WWFF	water	2	135226	1336866091	1	0.04	0.00173913043478261	10055	1
4	Food 1	Intake 3	282	135801	1336866666	/users/cn/jespinosa/phecomp/data/CRG/20120502_FDF_CRG/20120502_FDF_CRG/20120511_FDF_CRG_c12.mtb	3469	730	WWFF	food_fat	3	135519	1336866384	1	0.0400000000000027	0.000141843971631215	10056	1
4	Drink 1	Intake 1	17	136211	1336867076	/users/cn/jespinosa/phecomp/data/CRG/20120502_FDF_CRG/20120502_FDF_CRG/20120511_FDF_CRG_c12.mtb	1532	NA	WWFF	water	1	136194	1336867059	1	0.02	0.00117647058823529	10057	1
4	Drink 2	Intake 2	16	136225	1336867090	/users/cn/jespinosa/phecomp/data/CRG/20120502_FDF_CRG/20120502_FDF_CRG/20120511_FDF_CRG_c12.mtb	1430	NA	WWFF	water	2	136209	1336867074	1	0.02	0.00125	10058	1
4	Food 2	Intake 4	78	136609	1336867474	/users/cn/jespinosa/phecomp/data/CRG/20120502_FDF_CRG/20120502_FDF_CRG/20120511_FDF_CRG_c12.mtb	3879	2657	WWFF	food_fat	4	136531	1336867396	1	0.0400000000000009	0.000512820512820524	10059	1
4	Drink 2	Intake 2	30	138325	1336869190	/users/cn/jespinosa/phecomp/data/CRG/20120502_FDF_CRG/20120502_FDF_CRG/20120511_FDF_CRG_c12.mtb	1431	NA	WWFF	water	2	138295	1336869160	1	0.04	0.00133333333333333	10060	1
4	Food 2	Intake 4	14	139280	1336870145	/users/cn/jespinosa/phecomp/data/CRG/20120502_FDF_CRG/20120502_FDF_CRG/20120511_FDF_CRG_c12.mtb	3882	2047	WWFF	food_fat	4	139266	1336870131	1	0.0600000000000005	0.00428571428571432	10061	1
4	Food 2	Intake 4	10	141337	1336872202	/users/cn/jespinosa/phecomp/data/CRG/20120502_FDF_CRG/20120502_FDF_CRG/20120511_FDF_CRG_c12.mtb	3887	946	WWFF	food_fat	4	141327	1336872192	1	0.0200000000000014	0.00200000000000014	10062	1
4	Drink 2	Intake 2	23	141936	1336872801	/users/cn/jespinosa/phecomp/data/CRG/20120502_FDF_CRG/20120502_FDF_CRG/20120511_FDF_CRG_c12.mtb	1434	NA	WWFF	water	2	141913	1336872778	1	0.02	0.000869565217391304	10063	1
4	Food 1	Intake 3	212	142495	1336873360	/users/cn/jespinosa/phecomp/data/CRG/20120502_FDF_CRG/20120502_FDF_CRG/20120511_FDF_CRG_c12.mtb	3508	436	WWFF	food_fat	3	142283	1336873148	1	0.34	0.00160377358490566	10064	1
4	Drink 2	Intake 2	42	142346	1336873211	/users/cn/jespinosa/phecomp/data/CRG/20120502_FDF_CRG/20120502_FDF_CRG/20120511_FDF_CRG_c12.mtb	1435	NA	WWFF	water	2	142304	1336873169	1	0.02	0.000476190476190476	10065	1
4	Drink 1	Intake 1	28	142362	1336873227	/users/cn/jespinosa/phecomp/data/CRG/20120502_FDF_CRG/20120502_FDF_CRG/20120511_FDF_CRG_c12.mtb	1538	NA	WWFF	water	1	142334	1336873199	1	0.04	0.00142857142857143	10066	1
4	Food 1	Intake 3	207	143138	1336874003	/users/cn/jespinosa/phecomp/data/CRG/20120502_FDF_CRG/20120502_FDF_CRG/20120511_FDF_CRG_c12.mtb	3514	9	WWFF	food_fat	3	142931	1336873796	1	0.0800000000000018	0.0003864734299517	10067	1
4	Food 1	Intake 3	34	143181	1336874046	/users/cn/jespinosa/phecomp/data/CRG/20120502_FDF_CRG/20120502_FDF_CRG/20120511_FDF_CRG_c12.mtb	3515	8	WWFF	food_fat	3	143147	1336874012	1	0.0799999999999983	0.00235294117647054	10068	1
4	Drink 2	Intake 2	31	143181	1336874046	/users/cn/jespinosa/phecomp/data/CRG/20120502_FDF_CRG/20120502_FDF_CRG/20120511_FDF_CRG_c12.mtb	1436	NA	WWFF	water	2	143150	1336874015	1	0.0600000000000001	0.00193548387096775	10069	1
4	Food 1	Intake 3	216	143405	1336874270	/users/cn/jespinosa/phecomp/data/CRG/20120502_FDF_CRG/20120502_FDF_CRG/20120511_FDF_CRG_c12.mtb	3516	1221	WWFF	food_fat	3	143189	1336874054	1	0.0399999999999991	0.000185185185185181	10070	1
4	Food 1	Intake 3	20	144646	1336875511	/users/cn/jespinosa/phecomp/data/CRG/20120502_FDF_CRG/20120502_FDF_CRG/20120511_FDF_CRG_c12.mtb	3528	594	WWFF	food_fat	3	144626	1336875491	1	0.0200000000000031	0.00100000000000015	10071	1
4	Food 2	Intake 4	23	145263	1336876128	/users/cn/jespinosa/phecomp/data/CRG/20120502_FDF_CRG/20120502_FDF_CRG/20120511_FDF_CRG_c12.mtb	3908	2040	WWFF	food_fat	4	145240	1336876105	1	0.0399999999999991	0.00173913043478257	10072	1
4	Food 2	Intake 4	28	147331	1336878196	/users/cn/jespinosa/phecomp/data/CRG/20120502_FDF_CRG/20120502_FDF_CRG/20120511_FDF_CRG_c12.mtb	3911	1255	WWFF	food_fat	4	147303	1336878168	1	0.0200000000000014	0.000714285714285764	10073	1
4	Drink 2	Intake 2	14	147325	1336878190	/users/cn/jespinosa/phecomp/data/CRG/20120502_FDF_CRG/20120502_FDF_CRG/20120511_FDF_CRG_c12.mtb	1437	NA	WWFF	water	2	147311	1336878176	1	0.0600000000000001	0.00428571428571429	10074	1
4	Food 1	Intake 3	81	148667	1336879532	/users/cn/jespinosa/phecomp/data/CRG/20120502_FDF_CRG/20120502_FDF_CRG/20120511_FDF_CRG_c12.mtb	3555	COLL	WWFF	food_fat	3	148586	1336879451	1	0.0200000000000031	0.000246913580246952	10075	1
4	Food 2	Intake 4	13	148638	1336879503	/users/cn/jespinosa/phecomp/data/CRG/20120502_FDF_CRG/20120502_FDF_CRG/20120511_FDF_CRG_c12.mtb	3917	1231	WWFF	food_fat	4	148625	1336879490	1	0.119999999999999	0.00923076923076915	10076	1
4	Drink 2	Intake 2	15	149231	1336880096	/users/cn/jespinosa/phecomp/data/CRG/20120502_FDF_CRG/20120502_FDF_CRG/20120511_FDF_CRG_c12.mtb	1438	NA	WWFF	water	2	149216	1336880081	1	0.02	0.00133333333333333	10077	1
4	Food 2	Intake 4	13	149882	1336880747	/users/cn/jespinosa/phecomp/data/CRG/20120502_FDF_CRG/20120502_FDF_CRG/20120511_FDF_CRG_c12.mtb	3922	COLL	WWFF	food_fat	4	149869	1336880734	1	0.0800000000000001	0.00615384615384616	10078	1
4	Food 1	Intake 3	13	149883	1336880748	/users/cn/jespinosa/phecomp/data/CRG/20120502_FDF_CRG/20120502_FDF_CRG/20120511_FDF_CRG_c12.mtb	3562	663	WWFF	food_fat	3	149870	1336880735	1	0.52	0.04	10079	1
4	Food 2	Intake 4	21	150567	1336881432	/users/cn/jespinosa/phecomp/data/CRG/20120502_FDF_CRG/20120502_FDF_CRG/20120511_FDF_CRG_c12.mtb	3924	96	WWFF	food_fat	4	150546	1336881411	1	0.0200000000000014	0.000952380952381019	10080	1
4	Food 2	Intake 4	14	150677	1336881542	/users/cn/jespinosa/phecomp/data/CRG/20120502_FDF_CRG/20120502_FDF_CRG/20120511_FDF_CRG_c12.mtb	3926	179	WWFF	food_fat	4	150663	1336881528	1	0.0600000000000005	0.00428571428571432	10081	1
4	Food 2	Intake 4	14	150870	1336881735	/users/cn/jespinosa/phecomp/data/CRG/20120502_FDF_CRG/20120502_FDF_CRG/20120511_FDF_CRG_c12.mtb	3929	377	WWFF	food_fat	4	150856	1336881721	1	0.0800000000000001	0.00571428571428572	10082	1
4	Food 1	Intake 3	208	151455	1336882320	/users/cn/jespinosa/phecomp/data/CRG/20120502_FDF_CRG/20120502_FDF_CRG/20120511_FDF_CRG_c12.mtb	3572	94	WWFF	food_fat	3	151247	1336882112	1	0.260000000000002	0.00125000000000001	10083	1
4	Food 1	Intake 3	9	151558	1336882423	/users/cn/jespinosa/phecomp/data/CRG/20120502_FDF_CRG/20120502_FDF_CRG/20120511_FDF_CRG_c12.mtb	3574	31	WWFF	food_fat	3	151549	1336882414	1	0.0399999999999991	0.00444444444444434	10084	1
4	Food 1	Intake 3	553	152142	1336883007	/users/cn/jespinosa/phecomp/data/CRG/20120502_FDF_CRG/20120502_FDF_CRG/20120511_FDF_CRG_c12.mtb	3575	479	WWFF	food_fat	3	151589	1336882454	1	0.240000000000002	0.000433996383363476	10085	1
4	Drink 2	Intake 2	16	151788	1336882653	/users/cn/jespinosa/phecomp/data/CRG/20120502_FDF_CRG/20120502_FDF_CRG/20120511_FDF_CRG_c12.mtb	1440	NA	WWFF	water	2	151772	1336882637	1	0.04	0.0025	10086	1
4	Drink 2	Intake 2	33	151833	1336882698	/users/cn/jespinosa/phecomp/data/CRG/20120502_FDF_CRG/20120502_FDF_CRG/20120511_FDF_CRG_c12.mtb	1441	NA	WWFF	water	2	151800	1336882665	1	0.04	0.00121212121212121	10087	1
4	Drink 2	Intake 2	17	152317	1336883182	/users/cn/jespinosa/phecomp/data/CRG/20120502_FDF_CRG/20120502_FDF_CRG/20120511_FDF_CRG_c12.mtb	1442	NA	WWFF	water	2	152300	1336883165	1	0.0399999999999996	0.00235294117647056	10088	1
4	Food 2	Intake 4	10	152631	1336883496	/users/cn/jespinosa/phecomp/data/CRG/20120502_FDF_CRG/20120502_FDF_CRG/20120511_FDF_CRG_c12.mtb	3942	717	WWFF	food_fat	4	152621	1336883486	1	0.0200000000000014	0.00200000000000014	10089	1
4	Food 1	Intake 3	29	153377	1336884242	/users/cn/jespinosa/phecomp/data/CRG/20120502_FDF_CRG/20120502_FDF_CRG/20120511_FDF_CRG_c12.mtb	3581	2145	WWFF	food_fat	3	153348	1336884213	1	0.200000000000003	0.00689655172413804	10090	1
4	Food 1	Intake 3	92	155614	1336886479	/users/cn/jespinosa/phecomp/data/CRG/20120502_FDF_CRG/20120502_FDF_CRG/20120511_FDF_CRG_c12.mtb	3595	360	WWFF	food_fat	3	155522	1336886387	1	0.240000000000002	0.00260869565217393	10091	1
4	Drink 1	Intake 1	14	155763	1336886628	/users/cn/jespinosa/phecomp/data/CRG/20120502_FDF_CRG/20120502_FDF_CRG/20120511_FDF_CRG_c12.mtb	1543	NA	WWFF	water	1	155749	1336886614	1	0.02	0.00142857142857143	10092	1
4	Food 2	Intake 4	119	156093	1336886958	/users/cn/jespinosa/phecomp/data/CRG/20120502_FDF_CRG/20120502_FDF_CRG/20120511_FDF_CRG_c12.mtb	3960	COLL	WWFF	food_fat	4	155974	1336886839	1	0.0600000000000005	0.000504201680672273	10093	1
4	Food 1	Intake 3	31	156095	1336886960	/users/cn/jespinosa/phecomp/data/CRG/20120502_FDF_CRG/20120502_FDF_CRG/20120511_FDF_CRG_c12.mtb	3601	42	WWFF	food_fat	3	156064	1336886929	1	0.100000000000001	0.00322580645161294	10094	1
4	Drink 2	Intake 2	33	156142	1336887007	/users/cn/jespinosa/phecomp/data/CRG/20120502_FDF_CRG/20120502_FDF_CRG/20120511_FDF_CRG_c12.mtb	1445	NA	WWFF	water	2	156109	1336886974	1	0.0800000000000001	0.00242424242424243	10095	1
4	Food 2	Intake 4	75	156212	1336887077	/users/cn/jespinosa/phecomp/data/CRG/20120502_FDF_CRG/20120502_FDF_CRG/20120511_FDF_CRG_c12.mtb	3961	114	WWFF	food_fat	4	156137	1336887002	1	0.0399999999999991	0.000533333333333321	10096	1
4	Food 1	Intake 3	17	156343	1336887208	/users/cn/jespinosa/phecomp/data/CRG/20120502_FDF_CRG/20120502_FDF_CRG/20120511_FDF_CRG_c12.mtb	3604	143	WWFF	food_fat	3	156326	1336887191	1	0.0600000000000023	0.00352941176470602	10097	1
4	Food 1	Intake 3	13	156499	1336887364	/users/cn/jespinosa/phecomp/data/CRG/20120502_FDF_CRG/20120502_FDF_CRG/20120511_FDF_CRG_c12.mtb	3606	386	WWFF	food_fat	3	156486	1336887351	1	0.0999999999999979	0.00769230769230753	10098	1
4	Drink 2	Intake 2	45	156608	1336887473	/users/cn/jespinosa/phecomp/data/CRG/20120502_FDF_CRG/20120502_FDF_CRG/20120511_FDF_CRG_c12.mtb	1446	NA	WWFF	water	2	156563	1336887428	1	0.0600000000000001	0.00133333333333334	10099	1
4	Food 1	Intake 3	104	156989	1336887854	/users/cn/jespinosa/phecomp/data/CRG/20120502_FDF_CRG/20120502_FDF_CRG/20120511_FDF_CRG_c12.mtb	3610	271	WWFF	food_fat	3	156885	1336887750	1	0.0599999999999987	0.000576923076923064	10100	1
4	Drink 1	Intake 1	18	157033	1336887898	/users/cn/jespinosa/phecomp/data/CRG/20120502_FDF_CRG/20120502_FDF_CRG/20120511_FDF_CRG_c12.mtb	1544	NA	WWFF	water	1	157015	1336887880	1	0.02	0.00111111111111111	10101	1
4	Food 1	Intake 3	38	157298	1336888163	/users/cn/jespinosa/phecomp/data/CRG/20120502_FDF_CRG/20120502_FDF_CRG/20120511_FDF_CRG_c12.mtb	3613	14	WWFF	food_fat	3	157260	1336888125	1	0.0799999999999983	0.00210526315789469	10102	1
4	Food 1	Intake 3	93	157405	1336888270	/users/cn/jespinosa/phecomp/data/CRG/20120502_FDF_CRG/20120502_FDF_CRG/20120511_FDF_CRG_c12.mtb	3614	85	WWFF	food_fat	3	157312	1336888177	1	0.140000000000001	0.00150537634408603	10103	1
4	Food 2	Intake 4	48	157538	1336888403	/users/cn/jespinosa/phecomp/data/CRG/20120502_FDF_CRG/20120502_FDF_CRG/20120511_FDF_CRG_c12.mtb	3977	855	WWFF	food_fat	4	157490	1336888355	1	0.0399999999999991	0.000833333333333315	10104	1
4	Drink 1	Intake 1	17	158288	1336889153	/users/cn/jespinosa/phecomp/data/CRG/20120502_FDF_CRG/20120502_FDF_CRG/20120511_FDF_CRG_c12.mtb	1546	NA	WWFF	water	1	158271	1336889136	1	0.02	0.00117647058823529	10105	1
4	Drink 1	Intake 1	25	158346	1336889211	/users/cn/jespinosa/phecomp/data/CRG/20120502_FDF_CRG/20120502_FDF_CRG/20120511_FDF_CRG_c12.mtb	1547	NA	WWFF	water	1	158321	1336889186	1	0.02	0.0008	10106	1
4	Drink 2	Intake 2	47	158385	1336889250	/users/cn/jespinosa/phecomp/data/CRG/20120502_FDF_CRG/20120502_FDF_CRG/20120511_FDF_CRG_c12.mtb	1450	NA	WWFF	water	2	158338	1336889203	1	0.02	0.000425531914893617	10107	1
4	Food 2	Intake 4	14	158407	1336889272	/users/cn/jespinosa/phecomp/data/CRG/20120502_FDF_CRG/20120502_FDF_CRG/20120511_FDF_CRG_c12.mtb	3983	24	WWFF	food_fat	4	158393	1336889258	1	0.0399999999999991	0.00285714285714279	10108	1
4	Food 1	Intake 3	67	158498	1336889363	/users/cn/jespinosa/phecomp/data/CRG/20120502_FDF_CRG/20120502_FDF_CRG/20120511_FDF_CRG_c12.mtb	3623	91	WWFF	food_fat	3	158431	1336889296	1	0.0200000000000031	0.000298507462686613	10109	1
4	Food 2	Intake 4	14	158603	1336889468	/users/cn/jespinosa/phecomp/data/CRG/20120502_FDF_CRG/20120502_FDF_CRG/20120511_FDF_CRG_c12.mtb	3985	1725	WWFF	food_fat	4	158589	1336889454	1	0.0400000000000009	0.00285714285714292	10110	1
4	Food 1	Intake 3	20	160348	1336891213	/users/cn/jespinosa/phecomp/data/CRG/20120502_FDF_CRG/20120502_FDF_CRG/20120511_FDF_CRG_c12.mtb	3629	3863	WWFF	food_fat	3	160328	1336891193	1	0.0200000000000031	0.00100000000000015	10111	1
4	Drink 1	Intake 1	14	161925	1336892790	/users/cn/jespinosa/phecomp/data/CRG/20120502_FDF_CRG/20120502_FDF_CRG/20120511_FDF_CRG_c12.mtb	1549	NA	WWFF	water	1	161911	1336892776	1	0.04	0.00285714285714286	10112	1
4	Drink 1	Intake 1	12	163503	1336894368	/users/cn/jespinosa/phecomp/data/CRG/20120502_FDF_CRG/20120502_FDF_CRG/20120511_FDF_CRG_c12.mtb	1550	NA	WWFF	water	1	163491	1336894356	1	0.04	0.00333333333333333	10113	1
4	Food 2	Intake 4	14	164225	1336895090	/users/cn/jespinosa/phecomp/data/CRG/20120502_FDF_CRG/20120502_FDF_CRG/20120511_FDF_CRG_c12.mtb	3992	5337	WWFF	food_fat	4	164211	1336895076	1	0.0399999999999991	0.00285714285714279	10114	1
4	Drink 1	Intake 1	23	165257	1336896122	/users/cn/jespinosa/phecomp/data/CRG/20120502_FDF_CRG/20120502_FDF_CRG/20120511_FDF_CRG_c12.mtb	1552	NA	WWFF	water	1	165234	1336896099	1	0.12	0.00521739130434783	10115	1
4	Drink 2	Intake 2	23	169567	1336900432	/users/cn/jespinosa/phecomp/data/CRG/20120502_FDF_CRG/20120502_FDF_CRG/20120511_FDF_CRG_c12.mtb	1451	NA	WWFF	water	2	169544	1336900409	1	0.12	0.00521739130434783	10116	1
4	Food 1	Intake 3	26	169588	1336900453	/users/cn/jespinosa/phecomp/data/CRG/20120502_FDF_CRG/20120502_FDF_CRG/20120511_FDF_CRG_c12.mtb	3649	1889	WWFF	food_fat	3	169562	1336900427	1	0.120000000000001	0.00461538461538465	10117	1
4	Food 2	Intake 4	18	171495	1336902360	/users/cn/jespinosa/phecomp/data/CRG/20120502_FDF_CRG/20120502_FDF_CRG/20120511_FDF_CRG_c12.mtb	3995	2315	WWFF	food_fat	4	171477	1336902342	1	0.0200000000000014	0.00111111111111119	10118	1
4	Drink 1	Intake 1	28	173737	1336904602	/users/cn/jespinosa/phecomp/data/CRG/20120502_FDF_CRG/20120502_FDF_CRG/20120511_FDF_CRG_c12.mtb	1553	NA	WWFF	water	1	173709	1336904574	1	0.1	0.00357142857142857	10119	1
4	Food 2	Intake 4	13	173823	1336904688	/users/cn/jespinosa/phecomp/data/CRG/20120502_FDF_CRG/20120502_FDF_CRG/20120511_FDF_CRG_c12.mtb	3997	741	WWFF	food_fat	4	173810	1336904675	1	0.0599999999999987	0.00461538461538452	10120	1
4	Food 2	Intake 4	12	174576	1336905441	/users/cn/jespinosa/phecomp/data/CRG/20120502_FDF_CRG/20120502_FDF_CRG/20120511_FDF_CRG_c12.mtb	4002	121	WWFF	food_fat	4	174564	1336905429	1	0.0200000000000014	0.00166666666666678	10121	1
4	Food 1	Intake 3	306	175003	1336905868	/users/cn/jespinosa/phecomp/data/CRG/20120502_FDF_CRG/20120502_FDF_CRG/20120511_FDF_CRG_c12.mtb	3663	263	WWFF	food_fat	3	174697	1336905562	1	0.199999999999999	0.000653594771241827	10122	1
4	Food 1	Intake 3	49	175315	1336906180	/users/cn/jespinosa/phecomp/data/CRG/20120502_FDF_CRG/20120502_FDF_CRG/20120511_FDF_CRG_c12.mtb	3666	607	WWFF	food_fat	3	175266	1336906131	1	0.0200000000000031	0.000408163265306186	10123	1
4	Food 1	Intake 3	512	176434	1336907299	/users/cn/jespinosa/phecomp/data/CRG/20120502_FDF_CRG/20120502_FDF_CRG/20120511_FDF_CRG_c12.mtb	3670	COLL	WWFF	food_fat	3	175922	1336906787	1	0.120000000000001	0.000234375000000002	10124	1
4	Food 2	Intake 4	20	176010	1336906875	/users/cn/jespinosa/phecomp/data/CRG/20120502_FDF_CRG/20120502_FDF_CRG/20120511_FDF_CRG_c12.mtb	4008	3920	WWFF	food_fat	4	175990	1336906855	1	0.0200000000000014	0.00100000000000007	10125	1
4	Food 1	Intake 3	13	179943	1336910808	/users/cn/jespinosa/phecomp/data/CRG/20120502_FDF_CRG/20120502_FDF_CRG/20120511_FDF_CRG_c12.mtb	3676	8950	WWFF	food_fat	3	179930	1336910795	1	0.0400000000000027	0.00307692307692328	10126	1
4	Drink 1	Intake 1	21	180423	1336911288	/users/cn/jespinosa/phecomp/data/CRG/20120502_FDF_CRG/20120502_FDF_CRG/20120511_FDF_CRG_c12.mtb	1554	NA	WWFF	water	1	180402	1336911267	1	0.0999999999999996	0.00476190476190474	10127	1
4	Drink 1	Intake 1	24	181502	1336912367	/users/cn/jespinosa/phecomp/data/CRG/20120502_FDF_CRG/20120502_FDF_CRG/20120511_FDF_CRG_c12.mtb	1555	NA	WWFF	water	1	181478	1336912343	1	0.14	0.00583333333333333	10128	1
4	Drink 1	Intake 1	31	183844	1336914709	/users/cn/jespinosa/phecomp/data/CRG/20120502_FDF_CRG/20120502_FDF_CRG/20120511_FDF_CRG_c12.mtb	1556	NA	WWFF	water	1	183813	1336914678	1	0.0800000000000001	0.00258064516129033	10129	1
4	Drink 2	Intake 2	25	188715	1336919580	/users/cn/jespinosa/phecomp/data/CRG/20120502_FDF_CRG/20120502_FDF_CRG/20120511_FDF_CRG_c12.mtb	1452	NA	WWFF	water	2	188690	1336919555	1	0.0800000000000001	0.0032	10130	1
4	Food 2	Intake 4	14	188907	1336919772	/users/cn/jespinosa/phecomp/data/CRG/20120502_FDF_CRG/20120502_FDF_CRG/20120511_FDF_CRG_c12.mtb	4014	48	WWFF	food_fat	4	188893	1336919758	1	0.0600000000000005	0.00428571428571432	10131	1
4	Food 2	Intake 4	16	188971	1336919836	/users/cn/jespinosa/phecomp/data/CRG/20120502_FDF_CRG/20120502_FDF_CRG/20120511_FDF_CRG_c12.mtb	4015	131	WWFF	food_fat	4	188955	1336919820	1	0.0600000000000005	0.00375000000000003	10132	1
4	Food 1	Intake 3	72	189174	1336920039	/users/cn/jespinosa/phecomp/data/CRG/20120502_FDF_CRG/20120502_FDF_CRG/20120511_FDF_CRG_c12.mtb	3705	COLL	WWFF	food_fat	3	189102	1336919967	1	0.459999999999997	0.00638888888888885	10133	1
4	Food 2	Intake 4	13	189153	1336920018	/users/cn/jespinosa/phecomp/data/CRG/20120502_FDF_CRG/20120502_FDF_CRG/20120511_FDF_CRG_c12.mtb	4017	67	WWFF	food_fat	4	189140	1336920005	1	0.0399999999999991	0.00307692307692301	10134	1
4	Food 2	Intake 4	13	189233	1336920098	/users/cn/jespinosa/phecomp/data/CRG/20120502_FDF_CRG/20120502_FDF_CRG/20120511_FDF_CRG_c12.mtb	4018	54	WWFF	food_fat	4	189220	1336920085	1	0.0200000000000014	0.00153846153846165	10135	1
4	Food 1	Intake 3	67	189354	1336920219	/users/cn/jespinosa/phecomp/data/CRG/20120502_FDF_CRG/20120502_FDF_CRG/20120511_FDF_CRG_c12.mtb	3708	COLL	WWFF	food_fat	3	189287	1336920152	1	0.400000000000002	0.00597014925373137	10136	1
4	Food 2	Intake 4	11	189352	1336920217	/users/cn/jespinosa/phecomp/data/CRG/20120502_FDF_CRG/20120502_FDF_CRG/20120511_FDF_CRG_c12.mtb	4020	286	WWFF	food_fat	4	189341	1336920206	1	0.0200000000000014	0.00181818181818195	10137	1
4	Food 2	Intake 4	13	189651	1336920516	/users/cn/jespinosa/phecomp/data/CRG/20120502_FDF_CRG/20120502_FDF_CRG/20120511_FDF_CRG_c12.mtb	4023	421	WWFF	food_fat	4	189638	1336920503	1	0.0800000000000001	0.00615384615384616	10138	1
4	Food 1	Intake 3	13	190085	1336920950	/users/cn/jespinosa/phecomp/data/CRG/20120502_FDF_CRG/20120502_FDF_CRG/20120511_FDF_CRG_c12.mtb	3716	389	WWFF	food_fat	3	190072	1336920937	1	0.0400000000000027	0.00307692307692328	10139	1
4	Food 2	Intake 4	12	190486	1336921351	/users/cn/jespinosa/phecomp/data/CRG/20120502_FDF_CRG/20120502_FDF_CRG/20120511_FDF_CRG_c12.mtb	4025	9002	WWFF	food_fat	4	190474	1336921339	1	0.0400000000000009	0.00333333333333341	10140	1
4	Drink 1	Intake 1	26	194250	1336925115	/users/cn/jespinosa/phecomp/data/CRG/20120502_FDF_CRG/20120502_FDF_CRG/20120511_FDF_CRG_c12.mtb	1557	NA	WWFF	water	1	194224	1336925089	1	0.12	0.00461538461538461	10141	1
4	Drink 1	Intake 1	29	199491	1336930356	/users/cn/jespinosa/phecomp/data/CRG/20120502_FDF_CRG/20120502_FDF_CRG/20120511_FDF_CRG_c12.mtb	1558	NA	WWFF	water	1	199462	1336930327	1	0.14	0.00482758620689655	10142	1
4	Food 1	Intake 3	9	199497	1336930362	/users/cn/jespinosa/phecomp/data/CRG/20120502_FDF_CRG/20120502_FDF_CRG/20120511_FDF_CRG_c12.mtb	3725	2556	WWFF	food_fat	3	199488	1336930353	1	0.0399999999999991	0.00444444444444434	10143	1
4	Food 2	Intake 4	61	202114	1336932979	/users/cn/jespinosa/phecomp/data/CRG/20120502_FDF_CRG/20120502_FDF_CRG/20120511_FDF_CRG_c12.mtb	4030	1075	WWFF	food_fat	4	202053	1336932918	1	0.0399999999999991	0.000655737704918018	10144	1
4	Food 1	Intake 3	20	203209	1336934074	/users/cn/jespinosa/phecomp/data/CRG/20120502_FDF_CRG/20120502_FDF_CRG/20120511_FDF_CRG_c12.mtb	3737	160	WWFF	food_fat	3	203189	1336934054	1	0.0599999999999987	0.00299999999999994	10145	1
4	Food 1	Intake 3	194	203563	1336934428	/users/cn/jespinosa/phecomp/data/CRG/20120502_FDF_CRG/20120502_FDF_CRG/20120511_FDF_CRG_c12.mtb	3739	COLL	WWFF	food_fat	3	203369	1336934234	1	0.120000000000001	0.000618556701030933	10146	1
4	Food 2	Intake 4	34	203404	1336934269	/users/cn/jespinosa/phecomp/data/CRG/20120502_FDF_CRG/20120502_FDF_CRG/20120511_FDF_CRG_c12.mtb	4041	605	WWFF	food_fat	4	203370	1336934235	1	0.0400000000000009	0.00117647058823532	10147	1
4	Food 1	Intake 3	114	204123	1336934988	/users/cn/jespinosa/phecomp/data/CRG/20120502_FDF_CRG/20120502_FDF_CRG/20120511_FDF_CRG_c12.mtb	3743	242	WWFF	food_fat	3	204009	1336934874	1	0.0200000000000031	0.000175438596491255	10148	1
4	Drink 2	Intake 2	49	204373	1336935238	/users/cn/jespinosa/phecomp/data/CRG/20120502_FDF_CRG/20120502_FDF_CRG/20120511_FDF_CRG_c12.mtb	1459	NA	WWFF	water	2	204324	1336935189	1	0.0399999999999996	0.000816326530612237	10149	1
4	Food 2	Intake 4	162	204527	1336935392	/users/cn/jespinosa/phecomp/data/CRG/20120502_FDF_CRG/20120502_FDF_CRG/20120511_FDF_CRG_c12.mtb	4051	58	WWFF	food_fat	4	204365	1336935230	1	0.200000000000001	0.00123456790123457	10150	1
4	Food 1	Intake 3	143	204728	1336935593	/users/cn/jespinosa/phecomp/data/CRG/20120502_FDF_CRG/20120502_FDF_CRG/20120511_FDF_CRG_c12.mtb	3746	COLL	WWFF	food_fat	3	204585	1336935450	1	0.0599999999999987	0.00041958041958041	10151	1
4	Food 2	Intake 4	141	204728	1336935593	/users/cn/jespinosa/phecomp/data/CRG/20120502_FDF_CRG/20120502_FDF_CRG/20120511_FDF_CRG_c12.mtb	4052	334	WWFF	food_fat	4	204587	1336935452	1	0.18	0.00127659574468085	10152	1
4	Food 2	Intake 4	126	205188	1336936053	/users/cn/jespinosa/phecomp/data/CRG/20120502_FDF_CRG/20120502_FDF_CRG/20120511_FDF_CRG_c12.mtb	4054	COLL	WWFF	food_fat	4	205062	1336935927	1	0.24	0.0019047619047619	10153	1
4	Food 1	Intake 3	62	205194	1336936059	/users/cn/jespinosa/phecomp/data/CRG/20120502_FDF_CRG/20120502_FDF_CRG/20120511_FDF_CRG_c12.mtb	3750	75	WWFF	food_fat	3	205132	1336935997	1	0.0999999999999979	0.00161290322580642	10154	1
4	Food 2	Intake 4	115	205384	1336936249	/users/cn/jespinosa/phecomp/data/CRG/20120502_FDF_CRG/20120502_FDF_CRG/20120511_FDF_CRG_c12.mtb	4055	15	WWFF	food_fat	4	205269	1336936134	1	0.119999999999999	0.00104347826086956	10155	1
4	Food 1	Intake 3	12	205411	1336936276	/users/cn/jespinosa/phecomp/data/CRG/20120502_FDF_CRG/20120502_FDF_CRG/20120511_FDF_CRG_c12.mtb	3753	60	WWFF	food_fat	3	205399	1336936264	1	0.0999999999999979	0.00833333333333316	10156	1
4	Food 2	Intake 4	140	205611	1336936476	/users/cn/jespinosa/phecomp/data/CRG/20120502_FDF_CRG/20120502_FDF_CRG/20120511_FDF_CRG_c12.mtb	4057	COLL	WWFF	food_fat	4	205471	1336936336	1	0.119999999999999	0.00085714285714285	10157	1
4	Food 1	Intake 3	76	205612	1336936477	/users/cn/jespinosa/phecomp/data/CRG/20120502_FDF_CRG/20120502_FDF_CRG/20120511_FDF_CRG_c12.mtb	3756	20	WWFF	food_fat	3	205536	1336936401	1	0.0800000000000018	0.00105263157894739	10158	1
4	Food 2	Intake 4	164	205796	1336936661	/users/cn/jespinosa/phecomp/data/CRG/20120502_FDF_CRG/20120502_FDF_CRG/20120511_FDF_CRG_c12.mtb	4058	COLL	WWFF	food_fat	4	205632	1336936497	1	0.940000000000001	0.00573170731707318	10159	1
4	Food 1	Intake 3	101	205798	1336936663	/users/cn/jespinosa/phecomp/data/CRG/20120502_FDF_CRG/20120502_FDF_CRG/20120511_FDF_CRG_c12.mtb	3758	73	WWFF	food_fat	3	205697	1336936562	1	0.100000000000001	0.000990099009901	10160	1
4	Food 2	Intake 4	170	206041	1336936906	/users/cn/jespinosa/phecomp/data/CRG/20120502_FDF_CRG/20120502_FDF_CRG/20120511_FDF_CRG_c12.mtb	4059	64	WWFF	food_fat	4	205871	1336936736	1	0.84	0.00494117647058824	10161	1
4	Food 2	Intake 4	478	206583	1336937448	/users/cn/jespinosa/phecomp/data/CRG/20120502_FDF_CRG/20120502_FDF_CRG/20120511_FDF_CRG_c12.mtb	4060	COLL	WWFF	food_fat	4	206105	1336936970	1	3.56	0.00744769874476987	10162	1
4	Food 1	Intake 3	51	206539	1336937404	/users/cn/jespinosa/phecomp/data/CRG/20120502_FDF_CRG/20120502_FDF_CRG/20120511_FDF_CRG_c12.mtb	3762	5	WWFF	food_fat	3	206488	1336937353	1	0.0399999999999991	0.000784313725490178	10163	1
4	Food 1	Intake 3	41	206585	1336937450	/users/cn/jespinosa/phecomp/data/CRG/20120502_FDF_CRG/20120502_FDF_CRG/20120511_FDF_CRG_c12.mtb	3763	57	WWFF	food_fat	3	206544	1336937409	1	0.0600000000000023	0.0014634146341464	10164	1
4	Food 2	Intake 4	206	206848	1336937713	/users/cn/jespinosa/phecomp/data/CRG/20120502_FDF_CRG/20120502_FDF_CRG/20120511_FDF_CRG_c12.mtb	4061	148	WWFF	food_fat	4	206642	1336937507	1	2.38	0.0115533980582524	10165	1
4	Food 2	Intake 4	233	207229	1336938094	/users/cn/jespinosa/phecomp/data/CRG/20120502_FDF_CRG/20120502_FDF_CRG/20120511_FDF_CRG_c12.mtb	4062	273	WWFF	food_fat	4	206996	1336937861	1	0.280000000000001	0.00120171673819743	10166	1
4	Food 2	Intake 4	215	207717	1336938582	/users/cn/jespinosa/phecomp/data/CRG/20120502_FDF_CRG/20120502_FDF_CRG/20120511_FDF_CRG_c12.mtb	4064	31	WWFF	food_fat	4	207502	1336938367	1	0.380000000000003	0.00176744186046513	10167	1
4	Food 1	Intake 3	151	207899	1336938764	/users/cn/jespinosa/phecomp/data/CRG/20120502_FDF_CRG/20120502_FDF_CRG/20120511_FDF_CRG_c12.mtb	3771	COLL	WWFF	food_fat	3	207748	1336938613	1	0.16	0.00105960264900662	10168	1
4	Food 2	Intake 4	17	207885	1336938750	/users/cn/jespinosa/phecomp/data/CRG/20120502_FDF_CRG/20120502_FDF_CRG/20120511_FDF_CRG_c12.mtb	4067	51	WWFF	food_fat	4	207868	1336938733	1	0.0599999999999987	0.00352941176470581	10169	1
4	Food 2	Intake 4	284	208220	1336939085	/users/cn/jespinosa/phecomp/data/CRG/20120502_FDF_CRG/20120502_FDF_CRG/20120511_FDF_CRG_c12.mtb	4068	39	WWFF	food_fat	4	207936	1336938801	1	0.120000000000001	0.000422535211267609	10170	1
4	Food 2	Intake 4	284	208543	1336939408	/users/cn/jespinosa/phecomp/data/CRG/20120502_FDF_CRG/20120502_FDF_CRG/20120511_FDF_CRG_c12.mtb	4069	COLL	WWFF	food_fat	4	208259	1336939124	1	2.44	0.00859154929577465	10171	1
4	Food 1	Intake 3	166	208541	1336939406	/users/cn/jespinosa/phecomp/data/CRG/20120502_FDF_CRG/20120502_FDF_CRG/20120511_FDF_CRG_c12.mtb	3775	40	WWFF	food_fat	3	208375	1336939240	1	0.0399999999999991	0.000240963855421681	10172	1
4	Food 2	Intake 4	80	208661	1336939526	/users/cn/jespinosa/phecomp/data/CRG/20120502_FDF_CRG/20120502_FDF_CRG/20120511_FDF_CRG_c12.mtb	4070	80	WWFF	food_fat	4	208581	1336939446	1	0.0600000000000023	0.000750000000000029	10173	1
4	Food 2	Intake 4	305	209046	1336939911	/users/cn/jespinosa/phecomp/data/CRG/20120502_FDF_CRG/20120502_FDF_CRG/20120511_FDF_CRG_c12.mtb	4072	COLL	WWFF	food_fat	4	208741	1336939606	1	0.34	0.00111475409836066	10174	1
4	Food 1	Intake 3	109	208976	1336939841	/users/cn/jespinosa/phecomp/data/CRG/20120502_FDF_CRG/20120502_FDF_CRG/20120511_FDF_CRG_c12.mtb	3780	77	WWFF	food_fat	3	208867	1336939732	1	0.0399999999999991	0.000366972477064212	10175	1
4	Drink 1	Intake 1	23	208994	1336939859	/users/cn/jespinosa/phecomp/data/CRG/20120502_FDF_CRG/20120502_FDF_CRG/20120511_FDF_CRG_c12.mtb	1563	NA	WWFF	water	1	208971	1336939836	1	0.0800000000000001	0.00347826086956522	10176	1
4	Food 2	Intake 4	74	209127	1336939992	/users/cn/jespinosa/phecomp/data/CRG/20120502_FDF_CRG/20120502_FDF_CRG/20120511_FDF_CRG_c12.mtb	4073	COLL	WWFF	food_fat	4	209053	1336939918	1	0.0599999999999987	0.000810810810810793	10177	1
4	Food 1	Intake 3	17	209113	1336939978	/users/cn/jespinosa/phecomp/data/CRG/20120502_FDF_CRG/20120502_FDF_CRG/20120511_FDF_CRG_c12.mtb	3783	20	WWFF	food_fat	3	209096	1336939961	1	0.0600000000000023	0.00352941176470602	10178	1
4	Food 2	Intake 4	143	209276	1336940141	/users/cn/jespinosa/phecomp/data/CRG/20120502_FDF_CRG/20120502_FDF_CRG/20120511_FDF_CRG_c12.mtb	4074	COLL	WWFF	food_fat	4	209133	1336939998	1	0.199999999999999	0.00139860139860139	10179	1
4	Food 1	Intake 3	77	209273	1336940138	/users/cn/jespinosa/phecomp/data/CRG/20120502_FDF_CRG/20120502_FDF_CRG/20120511_FDF_CRG_c12.mtb	3785	75	WWFF	food_fat	3	209196	1336940061	1	0.0999999999999979	0.00129870129870127	10180	1
4	Food 2	Intake 4	404	209752	1336940617	/users/cn/jespinosa/phecomp/data/CRG/20120502_FDF_CRG/20120502_FDF_CRG/20120511_FDF_CRG_c12.mtb	4076	COLL	WWFF	food_fat	4	209348	1336940213	1	0.100000000000001	0.00024752475247525	10181	1
4	Food 1	Intake 3	172	209751	1336940616	/users/cn/jespinosa/phecomp/data/CRG/20120502_FDF_CRG/20120502_FDF_CRG/20120511_FDF_CRG_c12.mtb	3787	92	WWFF	food_fat	3	209579	1336940444	1	0.0399999999999991	0.000232558139534878	10182	1
4	Food 1	Intake 3	309	210152	1336941017	/users/cn/jespinosa/phecomp/data/CRG/20120502_FDF_CRG/20120502_FDF_CRG/20120511_FDF_CRG_c12.mtb	3788	COLL	WWFF	food_fat	3	209843	1336940708	1	0.0200000000000031	6.47249190938612e-05	10183	1
4	Food 2	Intake 4	187	210162	1336941027	/users/cn/jespinosa/phecomp/data/CRG/20120502_FDF_CRG/20120502_FDF_CRG/20120511_FDF_CRG_c12.mtb	4079	133	WWFF	food_fat	4	209975	1336940840	1	0.140000000000001	0.000748663101604283	10184	1
4	Drink 2	Intake 2	20	210120	1336940985	/users/cn/jespinosa/phecomp/data/CRG/20120502_FDF_CRG/20120502_FDF_CRG/20120511_FDF_CRG_c12.mtb	1469	NA	WWFF	water	2	210100	1336940965	1	0.0600000000000001	0.00300000000000001	10185	1
4	Food 2	Intake 4	187	210482	1336941347	/users/cn/jespinosa/phecomp/data/CRG/20120502_FDF_CRG/20120502_FDF_CRG/20120511_FDF_CRG_c12.mtb	4081	COLL	WWFF	food_fat	4	210295	1336941160	1	0.459999999999997	0.00245989304812833	10186	1
4	Food 1	Intake 3	159	210480	1336941345	/users/cn/jespinosa/phecomp/data/CRG/20120502_FDF_CRG/20120502_FDF_CRG/20120511_FDF_CRG_c12.mtb	3790	188	WWFF	food_fat	3	210321	1336941186	1	0.18	0.00113207547169811	10187	1
4	Food 1	Intake 3	191	210859	1336941724	/users/cn/jespinosa/phecomp/data/CRG/20120502_FDF_CRG/20120502_FDF_CRG/20120511_FDF_CRG_c12.mtb	3791	4	WWFF	food_fat	3	210668	1336941533	1	0.0599999999999987	0.000314136125654443	10188	1
4	Food 1	Intake 3	190	211053	1336941918	/users/cn/jespinosa/phecomp/data/CRG/20120502_FDF_CRG/20120502_FDF_CRG/20120511_FDF_CRG_c12.mtb	3792	COLL	WWFF	food_fat	3	210863	1336941728	1	0.0399999999999991	0.000210526315789469	10189	1
4	Food 2	Intake 4	191	211056	1336941921	/users/cn/jespinosa/phecomp/data/CRG/20120502_FDF_CRG/20120502_FDF_CRG/20120511_FDF_CRG_c12.mtb	4084	365	WWFF	food_fat	4	210865	1336941730	1	0.32	0.00167539267015707	10190	1
4	Food 1	Intake 3	96	211517	1336942382	/users/cn/jespinosa/phecomp/data/CRG/20120502_FDF_CRG/20120502_FDF_CRG/20120511_FDF_CRG_c12.mtb	3796	102	WWFF	food_fat	3	211421	1336942286	1	0.100000000000001	0.00104166666666668	10191	1
4	Food 1	Intake 3	92	211711	1336942576	/users/cn/jespinosa/phecomp/data/CRG/20120502_FDF_CRG/20120502_FDF_CRG/20120511_FDF_CRG_c12.mtb	3798	5	WWFF	food_fat	3	211619	1336942484	1	0.0200000000000031	0.00021739130434786	10192	1
4	Food 1	Intake 3	179	211895	1336942760	/users/cn/jespinosa/phecomp/data/CRG/20120502_FDF_CRG/20120502_FDF_CRG/20120511_FDF_CRG_c12.mtb	3799	598	WWFF	food_fat	3	211716	1336942581	1	0.0999999999999979	0.000558659217877083	10193	1
4	Drink 2	Intake 2	11	212101	1336942966	/users/cn/jespinosa/phecomp/data/CRG/20120502_FDF_CRG/20120502_FDF_CRG/20120511_FDF_CRG_c12.mtb	1470	NA	WWFF	water	2	212090	1336942955	1	0.02	0.00181818181818182	10194	1
4	Food 2	Intake 4	381	212874	1336943739	/users/cn/jespinosa/phecomp/data/CRG/20120502_FDF_CRG/20120502_FDF_CRG/20120511_FDF_CRG_c12.mtb	4093	3271	WWFF	food_fat	4	212493	1336943358	1	0.0200000000000031	5.24934383202181e-05	10195	1
4	Drink 1	Intake 1	27	215434	1336946299	/users/cn/jespinosa/phecomp/data/CRG/20120502_FDF_CRG/20120502_FDF_CRG/20120511_FDF_CRG_c12.mtb	1566	NA	WWFF	water	1	215407	1336946272	1	0.14	0.00518518518518519	10196	1
4	Food 2	Intake 4	14	216159	1336947024	/users/cn/jespinosa/phecomp/data/CRG/20120502_FDF_CRG/20120502_FDF_CRG/20120511_FDF_CRG_c12.mtb	4102	1027	WWFF	food_fat	4	216145	1336947010	1	0.0399999999999991	0.00285714285714279	10197	1
4	Drink 1	Intake 1	16	216614	1336947479	/users/cn/jespinosa/phecomp/data/CRG/20120502_FDF_CRG/20120502_FDF_CRG/20120511_FDF_CRG_c12.mtb	1567	NA	WWFF	water	1	216598	1336947463	1	0.02	0.00125	10198	1
4	Food 1	Intake 3	84	217270	1336948135	/users/cn/jespinosa/phecomp/data/CRG/20120502_FDF_CRG/20120502_FDF_CRG/20120511_FDF_CRG_c12.mtb	3812	621	WWFF	food_fat	3	217186	1336948051	1	0.0200000000000031	0.000238095238095275	10199	1
4	Drink 1	Intake 1	19	217297	1336948162	/users/cn/jespinosa/phecomp/data/CRG/20120502_FDF_CRG/20120502_FDF_CRG/20120511_FDF_CRG_c12.mtb	1569	NA	WWFF	water	1	217278	1336948143	1	0.0600000000000001	0.00315789473684211	10200	1
4	Food 1	Intake 3	73	217964	1336948829	/users/cn/jespinosa/phecomp/data/CRG/20120502_FDF_CRG/20120502_FDF_CRG/20120511_FDF_CRG_c12.mtb	3816	COLL	WWFF	food_fat	3	217891	1336948756	1	0.16	0.00219178082191781	10201	1
4	Food 2	Intake 4	58	217951	1336948816	/users/cn/jespinosa/phecomp/data/CRG/20120502_FDF_CRG/20120502_FDF_CRG/20120511_FDF_CRG_c12.mtb	4112	40	WWFF	food_fat	4	217893	1336948758	1	0.0399999999999991	0.000689655172413778	10202	1
4	Food 2	Intake 4	113	218104	1336948969	/users/cn/jespinosa/phecomp/data/CRG/20120502_FDF_CRG/20120502_FDF_CRG/20120511_FDF_CRG_c12.mtb	4113	COLL	WWFF	food_fat	4	217991	1336948856	1	0.140000000000001	0.00123893805309735	10203	1
4	Food 1	Intake 3	102	218097	1336948962	/users/cn/jespinosa/phecomp/data/CRG/20120502_FDF_CRG/20120502_FDF_CRG/20120511_FDF_CRG_c12.mtb	3817	400	WWFF	food_fat	3	217995	1336948860	1	0.0999999999999979	0.000980392156862724	10204	1
4	Food 1	Intake 3	279	218776	1336949641	/users/cn/jespinosa/phecomp/data/CRG/20120502_FDF_CRG/20120502_FDF_CRG/20120511_FDF_CRG_c12.mtb	3822	COLL	WWFF	food_fat	3	218497	1336949362	1	0.119999999999997	0.00043010752688171	10205	1
4	Food 2	Intake 4	240	218739	1336949604	/users/cn/jespinosa/phecomp/data/CRG/20120502_FDF_CRG/20120502_FDF_CRG/20120511_FDF_CRG_c12.mtb	4119	108	WWFF	food_fat	4	218499	1336949364	1	0.0399999999999991	0.000166666666666663	10206	1
4	Food 2	Intake 4	188	219035	1336949900	/users/cn/jespinosa/phecomp/data/CRG/20120502_FDF_CRG/20120502_FDF_CRG/20120511_FDF_CRG_c12.mtb	4121	COLL	WWFF	food_fat	4	218847	1336949712	1	0.100000000000001	0.000531914893617027	10207	1
4	Food 1	Intake 3	185	219033	1336949898	/users/cn/jespinosa/phecomp/data/CRG/20120502_FDF_CRG/20120502_FDF_CRG/20120511_FDF_CRG_c12.mtb	3823	87	WWFF	food_fat	3	218848	1336949713	1	0.0800000000000018	0.000432432432432442	10208	1
4	Drink 1	Intake 1	53	219079	1336949944	/users/cn/jespinosa/phecomp/data/CRG/20120502_FDF_CRG/20120502_FDF_CRG/20120511_FDF_CRG_c12.mtb	1571	NA	WWFF	water	1	219026	1336949891	1	0.1	0.00188679245283019	10209	1
4	Food 1	Intake 3	103	219223	1336950088	/users/cn/jespinosa/phecomp/data/CRG/20120502_FDF_CRG/20120502_FDF_CRG/20120511_FDF_CRG_c12.mtb	3825	8	WWFF	food_fat	3	219120	1336949985	1	0.0399999999999991	0.000388349514563098	10210	1
4	Food 1	Intake 3	28	219259	1336950124	/users/cn/jespinosa/phecomp/data/CRG/20120502_FDF_CRG/20120502_FDF_CRG/20120511_FDF_CRG_c12.mtb	3826	257	WWFF	food_fat	3	219231	1336950096	1	0.0600000000000023	0.00214285714285722	10211	1
4	Food 2	Intake 4	73	219589	1336950454	/users/cn/jespinosa/phecomp/data/CRG/20120502_FDF_CRG/20120502_FDF_CRG/20120511_FDF_CRG_c12.mtb	4124	134	WWFF	food_fat	4	219516	1336950381	1	0.0200000000000031	0.000273972602739768	10212	1
4	Food 2	Intake 4	104	219827	1336950692	/users/cn/jespinosa/phecomp/data/CRG/20120502_FDF_CRG/20120502_FDF_CRG/20120511_FDF_CRG_c12.mtb	4126	COLL	WWFF	food_fat	4	219723	1336950588	1	0.280000000000001	0.0026923076923077	10213	1
4	Food 1	Intake 3	103	219828	1336950693	/users/cn/jespinosa/phecomp/data/CRG/20120502_FDF_CRG/20120502_FDF_CRG/20120511_FDF_CRG_c12.mtb	3831	144	WWFF	food_fat	3	219725	1336950590	1	0.18	0.00174757281553398	10214	1
4	Drink 2	Intake 2	20	219844	1336950709	/users/cn/jespinosa/phecomp/data/CRG/20120502_FDF_CRG/20120502_FDF_CRG/20120511_FDF_CRG_c12.mtb	1475	NA	WWFF	water	2	219824	1336950689	1	0.02	0.001	10215	1
4	Food 1	Intake 3	208	220180	1336951045	/users/cn/jespinosa/phecomp/data/CRG/20120502_FDF_CRG/20120502_FDF_CRG/20120511_FDF_CRG_c12.mtb	3833	90	WWFF	food_fat	3	219972	1336950837	1	0.120000000000001	0.000576923076923082	10216	1
4	Food 2	Intake 4	36	220306	1336951171	/users/cn/jespinosa/phecomp/data/CRG/20120502_FDF_CRG/20120502_FDF_CRG/20120511_FDF_CRG_c12.mtb	4129	22	WWFF	food_fat	4	220270	1336951135	1	0.0599999999999987	0.00166666666666663	10217	1
4	Food 1	Intake 3	219	220547	1336951412	/users/cn/jespinosa/phecomp/data/CRG/20120502_FDF_CRG/20120502_FDF_CRG/20120511_FDF_CRG_c12.mtb	3836	6	WWFF	food_fat	3	220328	1336951193	1	0.0600000000000023	0.000273972602739737	10218	1
4	Food 1	Intake 3	173	220726	1336951591	/users/cn/jespinosa/phecomp/data/CRG/20120502_FDF_CRG/20120502_FDF_CRG/20120511_FDF_CRG_c12.mtb	3837	1151	WWFF	food_fat	3	220553	1336951418	1	0.0399999999999991	0.000231213872832365	10219	1
4	Food 1	Intake 3	15	221892	1336952757	/users/cn/jespinosa/phecomp/data/CRG/20120502_FDF_CRG/20120502_FDF_CRG/20120511_FDF_CRG_c12.mtb	3844	783	WWFF	food_fat	3	221877	1336952742	1	0.219999999999999	0.0146666666666666	10220	1
4	Food 1	Intake 3	14	222689	1336953554	/users/cn/jespinosa/phecomp/data/CRG/20120502_FDF_CRG/20120502_FDF_CRG/20120511_FDF_CRG_c12.mtb	3851	1587	WWFF	food_fat	3	222675	1336953540	1	0.0200000000000031	0.00142857142857165	10221	1
4	Food 2	Intake 4	12	224288	1336955153	/users/cn/jespinosa/phecomp/data/CRG/20120502_FDF_CRG/20120502_FDF_CRG/20120511_FDF_CRG_c12.mtb	4152	148	WWFF	food_fat	4	224276	1336955141	1	0.0399999999999991	0.00333333333333326	10222	1
4	Drink 1	Intake 1	18	224448	1336955313	/users/cn/jespinosa/phecomp/data/CRG/20120502_FDF_CRG/20120502_FDF_CRG/20120511_FDF_CRG_c12.mtb	1574	NA	WWFF	water	1	224430	1336955295	1	0.0399999999999996	0.0022222222222222	10223	1
4	Food 2	Intake 4	18	224454	1336955319	/users/cn/jespinosa/phecomp/data/CRG/20120502_FDF_CRG/20120502_FDF_CRG/20120511_FDF_CRG_c12.mtb	4153	COLL	WWFF	food_fat	4	224436	1336955301	1	0.0600000000000023	0.00333333333333346	10224	1
4	Food 1	Intake 3	18	224455	1336955320	/users/cn/jespinosa/phecomp/data/CRG/20120502_FDF_CRG/20120502_FDF_CRG/20120511_FDF_CRG_c12.mtb	3853	333	WWFF	food_fat	3	224437	1336955302	1	0.0399999999999991	0.00222222222222217	10225	1
4	Food 2	Intake 4	24	224812	1336955677	/users/cn/jespinosa/phecomp/data/CRG/20120502_FDF_CRG/20120502_FDF_CRG/20120511_FDF_CRG_c12.mtb	4155	2991	WWFF	food_fat	4	224788	1336955653	1	0.0399999999999991	0.00166666666666663	10226	1
4	Drink 1	Intake 1	13	225426	1336956291	/users/cn/jespinosa/phecomp/data/CRG/20120502_FDF_CRG/20120502_FDF_CRG/20120511_FDF_CRG_c12.mtb	1575	NA	WWFF	water	1	225413	1336956278	1	0.04	0.00307692307692308	10227	1
4	Drink 1	Intake 1	16	226755	1336957620	/users/cn/jespinosa/phecomp/data/CRG/20120502_FDF_CRG/20120502_FDF_CRG/20120511_FDF_CRG_c12.mtb	1576	NA	WWFF	water	1	226739	1336957604	1	0.0600000000000001	0.00375000000000001	10228	1
4	Food 2	Intake 4	13	227816	1336958681	/users/cn/jespinosa/phecomp/data/CRG/20120502_FDF_CRG/20120502_FDF_CRG/20120511_FDF_CRG_c12.mtb	4177	929	WWFF	food_fat	4	227803	1336958668	1	0.0400000000000027	0.00307692307692328	10229	1
4	Food 2	Intake 4	22	228767	1336959632	/users/cn/jespinosa/phecomp/data/CRG/20120502_FDF_CRG/20120502_FDF_CRG/20120511_FDF_CRG_c12.mtb	4183	294	WWFF	food_fat	4	228745	1336959610	1	0.0399999999999991	0.00181818181818178	10230	1
4	Food 2	Intake 4	11	229072	1336959937	/users/cn/jespinosa/phecomp/data/CRG/20120502_FDF_CRG/20120502_FDF_CRG/20120511_FDF_CRG_c12.mtb	4184	588	WWFF	food_fat	4	229061	1336959926	1	0.0399999999999991	0.00363636363636355	10231	1
4	Food 2	Intake 4	14	229674	1336960539	/users/cn/jespinosa/phecomp/data/CRG/20120502_FDF_CRG/20120502_FDF_CRG/20120511_FDF_CRG_c12.mtb	4186	975	WWFF	food_fat	4	229660	1336960525	1	0.0400000000000027	0.00285714285714305	10232	1
4	Food 2	Intake 4	25	230674	1336961539	/users/cn/jespinosa/phecomp/data/CRG/20120502_FDF_CRG/20120502_FDF_CRG/20120511_FDF_CRG_c12.mtb	4192	959	WWFF	food_fat	4	230649	1336961514	1	0.0399999999999991	0.00159999999999996	10233	1
4	Food 2	Intake 4	225	231858	1336962723	/users/cn/jespinosa/phecomp/data/CRG/20120502_FDF_CRG/20120502_FDF_CRG/20120511_FDF_CRG_c12.mtb	4200	78	WWFF	food_fat	4	231633	1336962498	1	0.0399999999999991	0.000177777777777774	10234	1
4	Food 2	Intake 4	127	232063	1336962928	/users/cn/jespinosa/phecomp/data/CRG/20120502_FDF_CRG/20120502_FDF_CRG/20120511_FDF_CRG_c12.mtb	4202	COLL	WWFF	food_fat	4	231936	1336962801	1	0.0800000000000018	0.000629921259842534	10235	1
4	Food 1	Intake 3	133	232073	1336962938	/users/cn/jespinosa/phecomp/data/CRG/20120502_FDF_CRG/20120502_FDF_CRG/20120511_FDF_CRG_c12.mtb	3889	9	WWFF	food_fat	3	231940	1336962805	1	0.180000000000003	0.00135338345864664	10236	1
4	Food 1	Intake 3	187	232269	1336963134	/users/cn/jespinosa/phecomp/data/CRG/20120502_FDF_CRG/20120502_FDF_CRG/20120511_FDF_CRG_c12.mtb	3890	COLL	WWFF	food_fat	3	232082	1336962947	1	0.18	0.000962566844919786	10237	1
4	Food 2	Intake 4	162	232273	1336963138	/users/cn/jespinosa/phecomp/data/CRG/20120502_FDF_CRG/20120502_FDF_CRG/20120511_FDF_CRG_c12.mtb	4204	49	WWFF	food_fat	4	232111	1336962976	1	0.120000000000001	0.000740740740740747	10238	1
4	Drink 1	Intake 1	15	232191	1336963056	/users/cn/jespinosa/phecomp/data/CRG/20120502_FDF_CRG/20120502_FDF_CRG/20120511_FDF_CRG_c12.mtb	1577	NA	WWFF	water	1	232176	1336963041	1	0.02	0.00133333333333333	10239	1
4	Food 2	Intake 4	96	232418	1336963283	/users/cn/jespinosa/phecomp/data/CRG/20120502_FDF_CRG/20120502_FDF_CRG/20120511_FDF_CRG_c12.mtb	4205	629	WWFF	food_fat	4	232322	1336963187	1	0.0999999999999979	0.00104166666666664	10240	1
4	Drink 1	Intake 1	35	232442	1336963307	/users/cn/jespinosa/phecomp/data/CRG/20120502_FDF_CRG/20120502_FDF_CRG/20120511_FDF_CRG_c12.mtb	1578	NA	WWFF	water	1	232407	1336963272	1	0.1	0.00285714285714286	10241	1
4	Drink 1	Intake 1	23	232725	1336963590	/users/cn/jespinosa/phecomp/data/CRG/20120502_FDF_CRG/20120502_FDF_CRG/20120511_FDF_CRG_c12.mtb	1579	NA	WWFF	water	1	232702	1336963567	1	0.02	0.000869565217391304	10242	1
4	Food 1	Intake 3	23	233070	1336963935	/users/cn/jespinosa/phecomp/data/CRG/20120502_FDF_CRG/20120502_FDF_CRG/20120511_FDF_CRG_c12.mtb	3899	COLL	WWFF	food_fat	3	233047	1336963912	1	0.139999999999997	0.006086956521739	10243	1
4	Food 2	Intake 4	151	233199	1336964064	/users/cn/jespinosa/phecomp/data/CRG/20120502_FDF_CRG/20120502_FDF_CRG/20120511_FDF_CRG_c12.mtb	4210	COLL	WWFF	food_fat	4	233048	1336963913	1	0.140000000000001	0.000927152317880801	10244	1
4	Food 1	Intake 3	13	233198	1336964063	/users/cn/jespinosa/phecomp/data/CRG/20120502_FDF_CRG/20120502_FDF_CRG/20120511_FDF_CRG_c12.mtb	3902	333	WWFF	food_fat	3	233185	1336964050	1	0.0399999999999991	0.00307692307692301	10245	1
4	Food 2	Intake 4	14	233545	1336964410	/users/cn/jespinosa/phecomp/data/CRG/20120502_FDF_CRG/20120502_FDF_CRG/20120511_FDF_CRG_c12.mtb	4213	341	WWFF	food_fat	4	233531	1336964396	1	0.16	0.0114285714285714	10246	1
4	Food 1	Intake 3	326	234212	1336965077	/users/cn/jespinosa/phecomp/data/CRG/20120502_FDF_CRG/20120502_FDF_CRG/20120511_FDF_CRG_c12.mtb	3910	COLL	WWFF	food_fat	3	233886	1336964751	1	0.199999999999999	0.000613496932515334	10247	1
4	Food 2	Intake 4	267	234157	1336965022	/users/cn/jespinosa/phecomp/data/CRG/20120502_FDF_CRG/20120502_FDF_CRG/20120511_FDF_CRG_c12.mtb	4219	1605	WWFF	food_fat	4	233890	1336964755	1	0.259999999999998	0.000973782771535573	10248	1
4	Drink 2	Intake 2	15	233943	1336964808	/users/cn/jespinosa/phecomp/data/CRG/20120502_FDF_CRG/20120502_FDF_CRG/20120511_FDF_CRG_c12.mtb	1481	NA	WWFF	water	2	233928	1336964793	1	0.04	0.00266666666666667	10249	1
4	Food 1	Intake 3	13	235775	1336966640	/users/cn/jespinosa/phecomp/data/CRG/20120502_FDF_CRG/20120502_FDF_CRG/20120511_FDF_CRG_c12.mtb	3913	1152	WWFF	food_fat	3	235762	1336966627	1	0.0399999999999991	0.00307692307692301	10250	1
4	Drink 2	Intake 2	27	236782	1336967647	/users/cn/jespinosa/phecomp/data/CRG/20120502_FDF_CRG/20120502_FDF_CRG/20120511_FDF_CRG_c12.mtb	1482	NA	WWFF	water	2	236755	1336967620	1	0.0600000000000001	0.00222222222222223	10251	1
4	Food 2	Intake 4	29	236956	1336967821	/users/cn/jespinosa/phecomp/data/CRG/20120502_FDF_CRG/20120502_FDF_CRG/20120511_FDF_CRG_c12.mtb	4228	219	WWFF	food_fat	4	236927	1336967792	1	0.0400000000000027	0.00137931034482768	10252	1
4	Food 1	Intake 3	17	237192	1336968057	/users/cn/jespinosa/phecomp/data/CRG/20120502_FDF_CRG/20120502_FDF_CRG/20120511_FDF_CRG_c12.mtb	3917	1199	WWFF	food_fat	3	237175	1336968040	1	0.0200000000000031	0.00117647058823548	10253	1
4	Drink 1	Intake 1	30	237560	1336968425	/users/cn/jespinosa/phecomp/data/CRG/20120502_FDF_CRG/20120502_FDF_CRG/20120511_FDF_CRG_c12.mtb	1581	NA	WWFF	water	1	237530	1336968395	1	0.0600000000000001	0.002	10254	1
4	Food 1	Intake 3	20	238411	1336969276	/users/cn/jespinosa/phecomp/data/CRG/20120502_FDF_CRG/20120502_FDF_CRG/20120511_FDF_CRG_c12.mtb	3925	COLL	WWFF	food_fat	3	238391	1336969256	1	0.48	0.024	10255	1
4	Food 2	Intake 4	45	238437	1336969302	/users/cn/jespinosa/phecomp/data/CRG/20120502_FDF_CRG/20120502_FDF_CRG/20120511_FDF_CRG_c12.mtb	4237	177	WWFF	food_fat	4	238392	1336969257	1	0.379999999999999	0.00844444444444442	10256	1
4	Food 2	Intake 4	218	238832	1336969697	/users/cn/jespinosa/phecomp/data/CRG/20120502_FDF_CRG/20120502_FDF_CRG/20120511_FDF_CRG_c12.mtb	4239	COLL	WWFF	food_fat	4	238614	1336969479	1	0.0600000000000023	0.000275229357798176	10257	1
4	Food 1	Intake 3	151	238878	1336969743	/users/cn/jespinosa/phecomp/data/CRG/20120502_FDF_CRG/20120502_FDF_CRG/20120511_FDF_CRG_c12.mtb	3929	60	WWFF	food_fat	3	238727	1336969592	1	0.16	0.00105960264900662	10258	1
4	Food 1	Intake 3	73	239011	1336969876	/users/cn/jespinosa/phecomp/data/CRG/20120502_FDF_CRG/20120502_FDF_CRG/20120511_FDF_CRG_c12.mtb	3930	6	WWFF	food_fat	3	238938	1336969803	1	0.0399999999999991	0.00054794520547944	10259	1
4	Food 1	Intake 3	92	239109	1336969974	/users/cn/jespinosa/phecomp/data/CRG/20120502_FDF_CRG/20120502_FDF_CRG/20120511_FDF_CRG_c12.mtb	3931	20	WWFF	food_fat	3	239017	1336969882	1	0.0599999999999987	0.000652173913043464	10260	1
4	Food 2	Intake 4	65	239194	1336970059	/users/cn/jespinosa/phecomp/data/CRG/20120502_FDF_CRG/20120502_FDF_CRG/20120511_FDF_CRG_c12.mtb	4244	COLL	WWFF	food_fat	4	239129	1336969994	1	0.16	0.00246153846153846	10261	1
4	Food 1	Intake 3	37	239167	1336970032	/users/cn/jespinosa/phecomp/data/CRG/20120502_FDF_CRG/20120502_FDF_CRG/20120511_FDF_CRG_c12.mtb	3932	2143	WWFF	food_fat	3	239130	1336969995	1	0.0600000000000023	0.00162162162162168	10262	1
4	Drink 1	Intake 1	25	239181	1336970046	/users/cn/jespinosa/phecomp/data/CRG/20120502_FDF_CRG/20120502_FDF_CRG/20120511_FDF_CRG_c12.mtb	1583	NA	WWFF	water	1	239156	1336970021	1	0.14	0.0056	10263	1
4	Food 1	Intake 3	389	241699	1336972564	/users/cn/jespinosa/phecomp/data/CRG/20120502_FDF_CRG/20120502_FDF_CRG/20120511_FDF_CRG_c12.mtb	3937	514	WWFF	food_fat	3	241310	1336972175	1	0.140000000000001	0.000359897172236506	10264	1
4	Food 2	Intake 4	54	242267	1336973132	/users/cn/jespinosa/phecomp/data/CRG/20120502_FDF_CRG/20120502_FDF_CRG/20120511_FDF_CRG_c12.mtb	4255	COLL	WWFF	food_fat	4	242213	1336973078	1	0.100000000000001	0.00185185185185187	10265	1
4	Food 1	Intake 3	12	242267	1336973132	/users/cn/jespinosa/phecomp/data/CRG/20120502_FDF_CRG/20120502_FDF_CRG/20120511_FDF_CRG_c12.mtb	3944	460	WWFF	food_fat	3	242255	1336973120	1	0.0399999999999991	0.00333333333333326	10266	1
4	Food 2	Intake 4	161	242888	1336973753	/users/cn/jespinosa/phecomp/data/CRG/20120502_FDF_CRG/20120502_FDF_CRG/20120511_FDF_CRG_c12.mtb	4258	COLL	WWFF	food_fat	4	242727	1336973592	1	0.0799999999999983	0.000496894409937878	10267	1
4	Food 1	Intake 3	134	242862	1336973727	/users/cn/jespinosa/phecomp/data/CRG/20120502_FDF_CRG/20120502_FDF_CRG/20120511_FDF_CRG_c12.mtb	3951	51	WWFF	food_fat	3	242728	1336973593	1	0.0599999999999987	0.000447761194029841	10268	1
4	Drink 2	Intake 2	16	242918	1336973783	/users/cn/jespinosa/phecomp/data/CRG/20120502_FDF_CRG/20120502_FDF_CRG/20120511_FDF_CRG_c12.mtb	1485	NA	WWFF	water	2	242902	1336973767	1	0.0600000000000001	0.00375000000000001	10269	1
4	Food 1	Intake 3	14	242927	1336973792	/users/cn/jespinosa/phecomp/data/CRG/20120502_FDF_CRG/20120502_FDF_CRG/20120511_FDF_CRG_c12.mtb	3952	24	WWFF	food_fat	3	242913	1336973778	1	0.0200000000000031	0.00142857142857165	10270	1
4	Food 2	Intake 4	71	243022	1336973887	/users/cn/jespinosa/phecomp/data/CRG/20120502_FDF_CRG/20120502_FDF_CRG/20120511_FDF_CRG_c12.mtb	4260	152	WWFF	food_fat	4	242951	1336973816	1	0.0399999999999991	0.000563380281690128	10271	1
4	Food 1	Intake 3	113	243287	1336974152	/users/cn/jespinosa/phecomp/data/CRG/20120502_FDF_CRG/20120502_FDF_CRG/20120511_FDF_CRG_c12.mtb	3956	93	WWFF	food_fat	3	243174	1336974039	1	0.0399999999999991	0.000353982300884948	10272	1
4	Food 2	Intake 4	14	243394	1336974259	/users/cn/jespinosa/phecomp/data/CRG/20120502_FDF_CRG/20120502_FDF_CRG/20120511_FDF_CRG_c12.mtb	4262	3318	WWFF	food_fat	4	243380	1336974245	1	0.0200000000000031	0.00142857142857165	10273	1
4	Food 2	Intake 4	20	246732	1336977597	/users/cn/jespinosa/phecomp/data/CRG/20120502_FDF_CRG/20120502_FDF_CRG/20120511_FDF_CRG_c12.mtb	4270	2462	WWFF	food_fat	4	246712	1336977577	1	0.0399999999999991	0.00199999999999995	10274	1
4	Drink 1	Intake 1	28	247748	1336978613	/users/cn/jespinosa/phecomp/data/CRG/20120502_FDF_CRG/20120502_FDF_CRG/20120511_FDF_CRG_c12.mtb	1585	NA	WWFF	water	1	247720	1336978585	1	0.12	0.00428571428571429	10275	1
4	Food 2	Intake 4	18	249212	1336980077	/users/cn/jespinosa/phecomp/data/CRG/20120502_FDF_CRG/20120502_FDF_CRG/20120511_FDF_CRG_c12.mtb	4277	13	WWFF	food_fat	4	249194	1336980059	1	0.0600000000000023	0.00333333333333346	10276	1
4	Food 2	Intake 4	82	249307	1336980172	/users/cn/jespinosa/phecomp/data/CRG/20120502_FDF_CRG/20120502_FDF_CRG/20120511_FDF_CRG_c12.mtb	4278	COLL	WWFF	food_fat	4	249225	1336980090	1	0.300000000000001	0.00365853658536587	10277	1
4	Food 1	Intake 3	49	249304	1336980169	/users/cn/jespinosa/phecomp/data/CRG/20120502_FDF_CRG/20120502_FDF_CRG/20120511_FDF_CRG_c12.mtb	3966	179	WWFF	food_fat	3	249255	1336980120	1	0.16	0.00326530612244898	10278	1
4	Drink 1	Intake 1	35	249353	1336980218	/users/cn/jespinosa/phecomp/data/CRG/20120502_FDF_CRG/20120502_FDF_CRG/20120511_FDF_CRG_c12.mtb	1587	NA	WWFF	water	1	249318	1336980183	1	0.1	0.00285714285714286	10279	1
4	Food 2	Intake 4	125	249608	1336980473	/users/cn/jespinosa/phecomp/data/CRG/20120502_FDF_CRG/20120502_FDF_CRG/20120511_FDF_CRG_c12.mtb	4280	COLL	WWFF	food_fat	4	249483	1336980348	1	0.200000000000003	0.00160000000000002	10280	1
4	Food 1	Intake 3	53	249538	1336980403	/users/cn/jespinosa/phecomp/data/CRG/20120502_FDF_CRG/20120502_FDF_CRG/20120511_FDF_CRG_c12.mtb	3969	219	WWFF	food_fat	3	249485	1336980350	1	0.100000000000001	0.00188679245283021	10281	1
4	Food 2	Intake 4	139	249896	1336980761	/users/cn/jespinosa/phecomp/data/CRG/20120502_FDF_CRG/20120502_FDF_CRG/20120511_FDF_CRG_c12.mtb	4283	155	WWFF	food_fat	4	249757	1336980622	1	0.0399999999999991	0.000287769784172655	10282	1
4	Food 1	Intake 3	26	250077	1336980942	/users/cn/jespinosa/phecomp/data/CRG/20120502_FDF_CRG/20120502_FDF_CRG/20120511_FDF_CRG_c12.mtb	3975	668	WWFF	food_fat	3	250051	1336980916	1	0.0400000000000027	0.00153846153846164	10283	1
4	Food 1	Intake 3	32	250777	1336981642	/users/cn/jespinosa/phecomp/data/CRG/20120502_FDF_CRG/20120502_FDF_CRG/20120511_FDF_CRG_c12.mtb	3983	237	WWFF	food_fat	3	250745	1336981610	1	0.0399999999999991	0.00124999999999997	10284	1
4	Food 2	Intake 4	70	251084	1336981949	/users/cn/jespinosa/phecomp/data/CRG/20120502_FDF_CRG/20120502_FDF_CRG/20120511_FDF_CRG_c12.mtb	4291	COLL	WWFF	food_fat	4	251014	1336981879	1	0.0599999999999987	0.000857142857142839	10285	1
4	Food 1	Intake 3	41	251063	1336981928	/users/cn/jespinosa/phecomp/data/CRG/20120502_FDF_CRG/20120502_FDF_CRG/20120511_FDF_CRG_c12.mtb	3985	10391	WWFF	food_fat	3	251022	1336981887	1	0.0399999999999991	0.000975609756097539	10286	1
4	Food 1	Intake 3	76	222	1336992395	/users/cn/jespinosa/phecomp/data/CRG/20120502_FDF_CRG/20120502_FDF_CRG/20120514_FDF_CRG_c12.mtb	4316	233	WWFF	food_fat	3	146	1336992319	1	0.04	0.000526315789473684	10287	1
4	Food 2	Intake 4	131	586	1336992759	/users/cn/jespinosa/phecomp/data/CRG/20120502_FDF_CRG/20120502_FDF_CRG/20120514_FDF_CRG_c12.mtb	4812	COLL	WWFF	food_fat	4	455	1336992628	1	0.16	0.00122137404580153	10288	1
4	Food 1	Intake 3	67	639	1336992812	/users/cn/jespinosa/phecomp/data/CRG/20120502_FDF_CRG/20120502_FDF_CRG/20120514_FDF_CRG_c12.mtb	4318	154	WWFF	food_fat	3	572	1336992745	1	0.02	0.000298507462686567	10289	1
4	Food 1	Intake 3	63	856	1336993029	/users/cn/jespinosa/phecomp/data/CRG/20120502_FDF_CRG/20120502_FDF_CRG/20120514_FDF_CRG_c12.mtb	4319	46	WWFF	food_fat	3	793	1336992966	1	0.52	0.00825396825396825	10290	1
4	Food 1	Intake 3	94	996	1336993169	/users/cn/jespinosa/phecomp/data/CRG/20120502_FDF_CRG/20120502_FDF_CRG/20120514_FDF_CRG_c12.mtb	4320	COLL	WWFF	food_fat	3	902	1336993075	1	0.0600000000000001	0.000638297872340427	10291	1
4	Food 2	Intake 4	14	1008	1336993181	/users/cn/jespinosa/phecomp/data/CRG/20120502_FDF_CRG/20120502_FDF_CRG/20120514_FDF_CRG_c12.mtb	4816	182	WWFF	food_fat	4	994	1336993167	1	0.06	0.00428571428571429	10292	1
4	Food 2	Intake 4	387	1577	1336993750	/users/cn/jespinosa/phecomp/data/CRG/20120502_FDF_CRG/20120502_FDF_CRG/20120514_FDF_CRG_c12.mtb	4818	COLL	WWFF	food_fat	4	1190	1336993363	1	0.64	0.00165374677002584	10293	1
4	Food 1	Intake 3	21	1361	1336993534	/users/cn/jespinosa/phecomp/data/CRG/20120502_FDF_CRG/20120502_FDF_CRG/20120514_FDF_CRG_c12.mtb	4322	61	WWFF	food_fat	3	1340	1336993513	1	0.02	0.000952380952380952	10294	1
4	Food 1	Intake 3	73	1495	1336993668	/users/cn/jespinosa/phecomp/data/CRG/20120502_FDF_CRG/20120502_FDF_CRG/20120514_FDF_CRG_c12.mtb	4323	17	WWFF	food_fat	3	1422	1336993595	1	0.0799999999999998	0.0010958904109589	10295	1
4	Food 1	Intake 3	58	1570	1336993743	/users/cn/jespinosa/phecomp/data/CRG/20120502_FDF_CRG/20120502_FDF_CRG/20120514_FDF_CRG_c12.mtb	4324	240	WWFF	food_fat	3	1512	1336993685	1	0.0800000000000001	0.00137931034482759	10296	1
4	Food 2	Intake 4	53	1863	1336994036	/users/cn/jespinosa/phecomp/data/CRG/20120502_FDF_CRG/20120502_FDF_CRG/20120514_FDF_CRG_c12.mtb	4821	302	WWFF	food_fat	4	1810	1336993983	1	0.0600000000000001	0.00113207547169812	10297	1
4	Drink 1	Intake 1	29	2089	1336994262	/users/cn/jespinosa/phecomp/data/CRG/20120502_FDF_CRG/20120502_FDF_CRG/20120514_FDF_CRG_c12.mtb	1673	NA	WWFF	water	1	2060	1336994233	1	0.1	0.00344827586206897	10298	1
4	Food 2	Intake 4	273	2438	1336994611	/users/cn/jespinosa/phecomp/data/CRG/20120502_FDF_CRG/20120502_FDF_CRG/20120514_FDF_CRG_c12.mtb	4825	87	WWFF	food_fat	4	2165	1336994338	1	0.26	0.000952380952380952	10299	1
4	Food 2	Intake 4	12	2537	1336994710	/users/cn/jespinosa/phecomp/data/CRG/20120502_FDF_CRG/20120502_FDF_CRG/20120514_FDF_CRG_c12.mtb	4827	40	WWFF	food_fat	4	2525	1336994698	1	0.02	0.00166666666666667	10300	1
4	Food 2	Intake 4	36	2613	1336994786	/users/cn/jespinosa/phecomp/data/CRG/20120502_FDF_CRG/20120502_FDF_CRG/20120514_FDF_CRG_c12.mtb	4828	4	WWFF	food_fat	4	2577	1336994750	1	0.26	0.00722222222222222	10301	1
4	Food 2	Intake 4	210	2827	1336995000	/users/cn/jespinosa/phecomp/data/CRG/20120502_FDF_CRG/20120502_FDF_CRG/20120514_FDF_CRG_c12.mtb	4829	COLL	WWFF	food_fat	4	2617	1336994790	1	0.26	0.00123809523809524	10302	1
4	Food 1	Intake 3	76	2791	1336994964	/users/cn/jespinosa/phecomp/data/CRG/20120502_FDF_CRG/20120502_FDF_CRG/20120514_FDF_CRG_c12.mtb	4325	146	WWFF	food_fat	3	2715	1336994888	1	0.28	0.00368421052631579	10303	1
4	Food 2	Intake 4	14	2951	1336995124	/users/cn/jespinosa/phecomp/data/CRG/20120502_FDF_CRG/20120502_FDF_CRG/20120514_FDF_CRG_c12.mtb	4831	904	WWFF	food_fat	4	2937	1336995110	1	0.02	0.00142857142857143	10304	1
4	Food 2	Intake 4	25	3880	1336996053	/users/cn/jespinosa/phecomp/data/CRG/20120502_FDF_CRG/20120502_FDF_CRG/20120514_FDF_CRG_c12.mtb	4837	317	WWFF	food_fat	4	3855	1336996028	1	0.04	0.0016	10305	1
4	Food 2	Intake 4	15	4212	1336996385	/users/cn/jespinosa/phecomp/data/CRG/20120502_FDF_CRG/20120502_FDF_CRG/20120514_FDF_CRG_c12.mtb	4839	1717	WWFF	food_fat	4	4197	1336996370	1	0.02	0.00133333333333333	10306	1
4	Food 2	Intake 4	19	5948	1336998121	/users/cn/jespinosa/phecomp/data/CRG/20120502_FDF_CRG/20120502_FDF_CRG/20120514_FDF_CRG_c12.mtb	4844	521	WWFF	food_fat	4	5929	1336998102	1	0.0800000000000001	0.00421052631578948	10307	1
4	Food 2	Intake 4	49	6518	1336998691	/users/cn/jespinosa/phecomp/data/CRG/20120502_FDF_CRG/20120502_FDF_CRG/20120514_FDF_CRG_c12.mtb	4846	990	WWFF	food_fat	4	6469	1336998642	1	0.02	0.000408163265306122	10308	1
4	Drink 1	Intake 1	23	6497	1336998670	/users/cn/jespinosa/phecomp/data/CRG/20120502_FDF_CRG/20120502_FDF_CRG/20120514_FDF_CRG_c12.mtb	1674	NA	WWFF	water	1	6474	1336998647	1	0.08	0.00347826086956522	10309	1
4	Drink 1	Intake 1	24	7496	1336999669	/users/cn/jespinosa/phecomp/data/CRG/20120502_FDF_CRG/20120502_FDF_CRG/20120514_FDF_CRG_c12.mtb	1675	NA	WWFF	water	1	7472	1336999645	1	0.1	0.00416666666666667	10310	1
4	Food 2	Intake 4	51	7559	1336999732	/users/cn/jespinosa/phecomp/data/CRG/20120502_FDF_CRG/20120502_FDF_CRG/20120514_FDF_CRG_c12.mtb	4851	1341	WWFF	food_fat	4	7508	1336999681	1	0.1	0.00196078431372549	10311	1
4	Food 2	Intake 4	166	9066	1337001239	/users/cn/jespinosa/phecomp/data/CRG/20120502_FDF_CRG/20120502_FDF_CRG/20120514_FDF_CRG_c12.mtb	4856	282	WWFF	food_fat	4	8900	1337001073	1	0.24	0.00144578313253012	10312	1
4	Food 2	Intake 4	14	9362	1337001535	/users/cn/jespinosa/phecomp/data/CRG/20120502_FDF_CRG/20120502_FDF_CRG/20120514_FDF_CRG_c12.mtb	4859	139	WWFF	food_fat	4	9348	1337001521	1	0.0600000000000001	0.00428571428571429	10313	1
4	Food 2	Intake 4	26	9527	1337001700	/users/cn/jespinosa/phecomp/data/CRG/20120502_FDF_CRG/20120502_FDF_CRG/20120514_FDF_CRG_c12.mtb	4860	485	WWFF	food_fat	4	9501	1337001674	1	0.02	0.000769230769230769	10314	1
4	Food 2	Intake 4	54	10066	1337002239	/users/cn/jespinosa/phecomp/data/CRG/20120502_FDF_CRG/20120502_FDF_CRG/20120514_FDF_CRG_c12.mtb	4864	345	WWFF	food_fat	4	10012	1337002185	1	0.54	0.01	10315	1
4	Food 2	Intake 4	31	10442	1337002615	/users/cn/jespinosa/phecomp/data/CRG/20120502_FDF_CRG/20120502_FDF_CRG/20120514_FDF_CRG_c12.mtb	4865	205	WWFF	food_fat	4	10411	1337002584	1	0.0600000000000001	0.00193548387096775	10316	1
4	Food 2	Intake 4	14	10661	1337002834	/users/cn/jespinosa/phecomp/data/CRG/20120502_FDF_CRG/20120502_FDF_CRG/20120514_FDF_CRG_c12.mtb	4866	627	WWFF	food_fat	4	10647	1337002820	1	0.0600000000000001	0.00428571428571429	10317	1
4	Drink 1	Intake 1	17	11074	1337003247	/users/cn/jespinosa/phecomp/data/CRG/20120502_FDF_CRG/20120502_FDF_CRG/20120514_FDF_CRG_c12.mtb	1676	NA	WWFF	water	1	11057	1337003230	1	0.1	0.00588235294117647	10318	1
4	Food 2	Intake 4	14	11302	1337003475	/users/cn/jespinosa/phecomp/data/CRG/20120502_FDF_CRG/20120502_FDF_CRG/20120514_FDF_CRG_c12.mtb	4868	115	WWFF	food_fat	4	11288	1337003461	1	0.04	0.00285714285714286	10319	1
4	Food 2	Intake 4	12	11429	1337003602	/users/cn/jespinosa/phecomp/data/CRG/20120502_FDF_CRG/20120502_FDF_CRG/20120514_FDF_CRG_c12.mtb	4869	843	WWFF	food_fat	4	11417	1337003590	1	0.04	0.00333333333333333	10320	1
4	Food 2	Intake 4	15	12287	1337004460	/users/cn/jespinosa/phecomp/data/CRG/20120502_FDF_CRG/20120502_FDF_CRG/20120514_FDF_CRG_c12.mtb	4872	744	WWFF	food_fat	4	12272	1337004445	1	0.0600000000000001	0.00400000000000001	10321	1
4	Food 2	Intake 4	33	13064	1337005237	/users/cn/jespinosa/phecomp/data/CRG/20120502_FDF_CRG/20120502_FDF_CRG/20120514_FDF_CRG_c12.mtb	4877	359	WWFF	food_fat	4	13031	1337005204	1	0.3	0.00909090909090909	10322	1
4	Food 2	Intake 4	11	13434	1337005607	/users/cn/jespinosa/phecomp/data/CRG/20120502_FDF_CRG/20120502_FDF_CRG/20120514_FDF_CRG_c12.mtb	4878	748	WWFF	food_fat	4	13423	1337005596	1	0.02	0.00181818181818182	10323	1
4	Food 2	Intake 4	26	14208	1337006381	/users/cn/jespinosa/phecomp/data/CRG/20120502_FDF_CRG/20120502_FDF_CRG/20120514_FDF_CRG_c12.mtb	4880	587	WWFF	food_fat	4	14182	1337006355	1	0.1	0.00384615384615385	10324	1
4	Food 2	Intake 4	24	14819	1337006992	/users/cn/jespinosa/phecomp/data/CRG/20120502_FDF_CRG/20120502_FDF_CRG/20120514_FDF_CRG_c12.mtb	4882	194	WWFF	food_fat	4	14795	1337006968	1	0.04	0.00166666666666667	10325	1
4	Food 2	Intake 4	33	15046	1337007219	/users/cn/jespinosa/phecomp/data/CRG/20120502_FDF_CRG/20120502_FDF_CRG/20120514_FDF_CRG_c12.mtb	4883	384	WWFF	food_fat	4	15013	1337007186	1	0.02	0.000606060606060606	10326	1
4	Drink 1	Intake 1	18	15329	1337007502	/users/cn/jespinosa/phecomp/data/CRG/20120502_FDF_CRG/20120502_FDF_CRG/20120514_FDF_CRG_c12.mtb	1677	NA	WWFF	water	1	15311	1337007484	1	0.08	0.00444444444444444	10327	1
4	Food 2	Intake 4	11	15441	1337007614	/users/cn/jespinosa/phecomp/data/CRG/20120502_FDF_CRG/20120502_FDF_CRG/20120514_FDF_CRG_c12.mtb	4885	1096	WWFF	food_fat	4	15430	1337007603	1	0.02	0.00181818181818182	10328	1
4	Food 2	Intake 4	23	16560	1337008733	/users/cn/jespinosa/phecomp/data/CRG/20120502_FDF_CRG/20120502_FDF_CRG/20120514_FDF_CRG_c12.mtb	4891	1021	WWFF	food_fat	4	16537	1337008710	1	0.72	0.031304347826087	10329	1
4	Drink 1	Intake 1	14	17579	1337009752	/users/cn/jespinosa/phecomp/data/CRG/20120502_FDF_CRG/20120502_FDF_CRG/20120514_FDF_CRG_c12.mtb	1678	NA	WWFF	water	1	17565	1337009738	1	0.08	0.00571428571428571	10330	1
4	Food 2	Intake 4	15	17596	1337009769	/users/cn/jespinosa/phecomp/data/CRG/20120502_FDF_CRG/20120502_FDF_CRG/20120514_FDF_CRG_c12.mtb	4895	380	WWFF	food_fat	4	17581	1337009754	1	0.02	0.00133333333333333	10331	1
4	Food 2	Intake 4	10	17986	1337010159	/users/cn/jespinosa/phecomp/data/CRG/20120502_FDF_CRG/20120502_FDF_CRG/20120514_FDF_CRG_c12.mtb	4896	258	WWFF	food_fat	4	17976	1337010149	1	0.04	0.004	10332	1
4	Food 2	Intake 4	9	18253	1337010426	/users/cn/jespinosa/phecomp/data/CRG/20120502_FDF_CRG/20120502_FDF_CRG/20120514_FDF_CRG_c12.mtb	4899	773	WWFF	food_fat	4	18244	1337010417	1	0.04	0.00444444444444444	10333	1
4	Food 2	Intake 4	27	19053	1337011226	/users/cn/jespinosa/phecomp/data/CRG/20120502_FDF_CRG/20120502_FDF_CRG/20120514_FDF_CRG_c12.mtb	4902	461	WWFF	food_fat	4	19026	1337011199	1	0.02	0.000740740740740741	10334	1
4	Food 2	Intake 4	273	19787	1337011960	/users/cn/jespinosa/phecomp/data/CRG/20120502_FDF_CRG/20120502_FDF_CRG/20120514_FDF_CRG_c12.mtb	4906	30	WWFF	food_fat	4	19514	1337011687	1	0.12	0.00043956043956044	10335	1
4	Food 2	Intake 4	102	19919	1337012092	/users/cn/jespinosa/phecomp/data/CRG/20120502_FDF_CRG/20120502_FDF_CRG/20120514_FDF_CRG_c12.mtb	4907	2254	WWFF	food_fat	4	19817	1337011990	1	0.02	0.000196078431372549	10336	1
4	Drink 1	Intake 1	30	20548	1337012721	/users/cn/jespinosa/phecomp/data/CRG/20120502_FDF_CRG/20120502_FDF_CRG/20120514_FDF_CRG_c12.mtb	1679	NA	WWFF	water	1	20518	1337012691	1	0.12	0.004	10337	1
4	Food 2	Intake 4	14	22187	1337014360	/users/cn/jespinosa/phecomp/data/CRG/20120502_FDF_CRG/20120502_FDF_CRG/20120514_FDF_CRG_c12.mtb	4915	649	WWFF	food_fat	4	22173	1337014346	1	0.0600000000000001	0.00428571428571429	10338	1
4	Food 2	Intake 4	17	22853	1337015026	/users/cn/jespinosa/phecomp/data/CRG/20120502_FDF_CRG/20120502_FDF_CRG/20120514_FDF_CRG_c12.mtb	4917	662	WWFF	food_fat	4	22836	1337015009	1	0.02	0.00117647058823529	10339	1
4	Food 2	Intake 4	53	23568	1337015741	/users/cn/jespinosa/phecomp/data/CRG/20120502_FDF_CRG/20120502_FDF_CRG/20120514_FDF_CRG_c12.mtb	4920	664	WWFF	food_fat	4	23515	1337015688	1	0.42	0.00792452830188679	10340	1
4	Food 2	Intake 4	50	24282	1337016455	/users/cn/jespinosa/phecomp/data/CRG/20120502_FDF_CRG/20120502_FDF_CRG/20120514_FDF_CRG_c12.mtb	4927	302	WWFF	food_fat	4	24232	1337016405	1	0.04	0.0008	10341	1
4	Food 2	Intake 4	111	24695	1337016868	/users/cn/jespinosa/phecomp/data/CRG/20120502_FDF_CRG/20120502_FDF_CRG/20120514_FDF_CRG_c12.mtb	4930	942	WWFF	food_fat	4	24584	1337016757	1	0.04	0.00036036036036036	10342	1
4	Drink 1	Intake 1	23	24652	1337016825	/users/cn/jespinosa/phecomp/data/CRG/20120502_FDF_CRG/20120502_FDF_CRG/20120514_FDF_CRG_c12.mtb	1680	NA	WWFF	water	1	24629	1337016802	1	0.02	0.000869565217391304	10343	1
4	Food 2	Intake 4	55	25692	1337017865	/users/cn/jespinosa/phecomp/data/CRG/20120502_FDF_CRG/20120502_FDF_CRG/20120514_FDF_CRG_c12.mtb	4935	277	WWFF	food_fat	4	25637	1337017810	1	0.02	0.000363636363636364	10344	1
4	Drink 1	Intake 1	31	25675	1337017848	/users/cn/jespinosa/phecomp/data/CRG/20120502_FDF_CRG/20120502_FDF_CRG/20120514_FDF_CRG_c12.mtb	1681	NA	WWFF	water	1	25644	1337017817	1	0.12	0.00387096774193548	10345	1
4	Food 2	Intake 4	125	26094	1337018267	/users/cn/jespinosa/phecomp/data/CRG/20120502_FDF_CRG/20120502_FDF_CRG/20120514_FDF_CRG_c12.mtb	4937	622	WWFF	food_fat	4	25969	1337018142	1	0.02	0.00016	10346	1
4	Food 2	Intake 4	426	27142	1337019315	/users/cn/jespinosa/phecomp/data/CRG/20120502_FDF_CRG/20120502_FDF_CRG/20120514_FDF_CRG_c12.mtb	4941	COLL	WWFF	food_fat	4	26716	1337018889	1	0.18	0.000422535211267606	10347	1
4	Food 1	Intake 3	85	26950	1337019123	/users/cn/jespinosa/phecomp/data/CRG/20120502_FDF_CRG/20120502_FDF_CRG/20120514_FDF_CRG_c12.mtb	4328	96	WWFF	food_fat	3	26865	1337019038	1	0.24	0.00282352941176471	10348	1
4	Food 1	Intake 3	93	27139	1337019312	/users/cn/jespinosa/phecomp/data/CRG/20120502_FDF_CRG/20120502_FDF_CRG/20120514_FDF_CRG_c12.mtb	4331	19	WWFF	food_fat	3	27046	1337019219	1	0.04	0.00043010752688172	10349	1
4	Food 2	Intake 4	599	27757	1337019930	/users/cn/jespinosa/phecomp/data/CRG/20120502_FDF_CRG/20120502_FDF_CRG/20120514_FDF_CRG_c12.mtb	4942	COLL	WWFF	food_fat	4	27158	1337019331	1	0.46	0.000767946577629382	10350	1
4	Food 1	Intake 3	71	27388	1337019561	/users/cn/jespinosa/phecomp/data/CRG/20120502_FDF_CRG/20120502_FDF_CRG/20120514_FDF_CRG_c12.mtb	4332	175	WWFF	food_fat	3	27317	1337019490	1	0.2	0.0028169014084507	10351	1
4	Food 1	Intake 3	113	27676	1337019849	/users/cn/jespinosa/phecomp/data/CRG/20120502_FDF_CRG/20120502_FDF_CRG/20120514_FDF_CRG_c12.mtb	4334	43	WWFF	food_fat	3	27563	1337019736	1	0.6	0.00530973451327434	10352	1
4	Food 1	Intake 3	29	27748	1337019921	/users/cn/jespinosa/phecomp/data/CRG/20120502_FDF_CRG/20120502_FDF_CRG/20120514_FDF_CRG_c12.mtb	4335	37	WWFF	food_fat	3	27719	1337019892	1	0.26	0.00896551724137931	10353	1
4	Food 2	Intake 4	244	28029	1337020202	/users/cn/jespinosa/phecomp/data/CRG/20120502_FDF_CRG/20120502_FDF_CRG/20120514_FDF_CRG_c12.mtb	4943	COLL	WWFF	food_fat	4	27785	1337019958	1	0.0800000000000001	0.000327868852459017	10354	1
4	Food 1	Intake 3	25	27842	1337020015	/users/cn/jespinosa/phecomp/data/CRG/20120502_FDF_CRG/20120502_FDF_CRG/20120514_FDF_CRG_c12.mtb	4336	36	WWFF	food_fat	3	27817	1337019990	1	0.04	0.0016	10355	1
4	Food 1	Intake 3	149	28027	1337020200	/users/cn/jespinosa/phecomp/data/CRG/20120502_FDF_CRG/20120502_FDF_CRG/20120514_FDF_CRG_c12.mtb	4337	101	WWFF	food_fat	3	27878	1337020051	1	0.12	0.000805369127516779	10356	1
4	Food 2	Intake 4	364	28492	1337020665	/users/cn/jespinosa/phecomp/data/CRG/20120502_FDF_CRG/20120502_FDF_CRG/20120514_FDF_CRG_c12.mtb	4944	COLL	WWFF	food_fat	4	28128	1337020301	1	0.4	0.0010989010989011	10357	1
4	Food 1	Intake 3	67	28313	1337020486	/users/cn/jespinosa/phecomp/data/CRG/20120502_FDF_CRG/20120502_FDF_CRG/20120514_FDF_CRG_c12.mtb	4338	77	WWFF	food_fat	3	28246	1337020419	1	0.04	0.000597014925373134	10358	1
4	Food 1	Intake 3	100	28490	1337020663	/users/cn/jespinosa/phecomp/data/CRG/20120502_FDF_CRG/20120502_FDF_CRG/20120514_FDF_CRG_c12.mtb	4339	35	WWFF	food_fat	3	28390	1337020563	1	0.42	0.0042	10359	1
4	Food 2	Intake 4	409	28934	1337021107	/users/cn/jespinosa/phecomp/data/CRG/20120502_FDF_CRG/20120502_FDF_CRG/20120514_FDF_CRG_c12.mtb	4945	COLL	WWFF	food_fat	4	28525	1337020698	1	0.62	0.0015158924205379	10360	1
4	Food 1	Intake 3	17	28712	1337020885	/users/cn/jespinosa/phecomp/data/CRG/20120502_FDF_CRG/20120502_FDF_CRG/20120514_FDF_CRG_c12.mtb	4341	171	WWFF	food_fat	3	28695	1337020868	1	0.04	0.00235294117647059	10361	1
4	Food 1	Intake 3	49	28932	1337021105	/users/cn/jespinosa/phecomp/data/CRG/20120502_FDF_CRG/20120502_FDF_CRG/20120514_FDF_CRG_c12.mtb	4342	51	WWFF	food_fat	3	28883	1337021056	1	0.02	0.000408163265306122	10362	1
4	Food 2	Intake 4	217	29200	1337021373	/users/cn/jespinosa/phecomp/data/CRG/20120502_FDF_CRG/20120502_FDF_CRG/20120514_FDF_CRG_c12.mtb	4946	34	WWFF	food_fat	4	28983	1337021156	1	0.36	0.00165898617511521	10363	1
4	Food 2	Intake 4	266	29500	1337021673	/users/cn/jespinosa/phecomp/data/CRG/20120502_FDF_CRG/20120502_FDF_CRG/20120514_FDF_CRG_c12.mtb	4947	COLL	WWFF	food_fat	4	29234	1337021407	1	0.0800000000000001	0.000300751879699248	10364	1
4	Food 1	Intake 3	115	29486	1337021659	/users/cn/jespinosa/phecomp/data/CRG/20120502_FDF_CRG/20120502_FDF_CRG/20120514_FDF_CRG_c12.mtb	4345	271	WWFF	food_fat	3	29371	1337021544	1	0.56	0.0048695652173913	10365	1
4	Food 2	Intake 4	242	29999	1337022172	/users/cn/jespinosa/phecomp/data/CRG/20120502_FDF_CRG/20120502_FDF_CRG/20120514_FDF_CRG_c12.mtb	4951	25	WWFF	food_fat	4	29757	1337021930	1	0.02	8.26446280991736e-05	10366	1
4	Food 2	Intake 4	115	30139	1337022312	/users/cn/jespinosa/phecomp/data/CRG/20120502_FDF_CRG/20120502_FDF_CRG/20120514_FDF_CRG_c12.mtb	4952	COLL	WWFF	food_fat	4	30024	1337022197	1	0.0399999999999996	0.000347826086956518	10367	1
4	Food 1	Intake 3	56	30116	1337022289	/users/cn/jespinosa/phecomp/data/CRG/20120502_FDF_CRG/20120502_FDF_CRG/20120514_FDF_CRG_c12.mtb	4347	32	WWFF	food_fat	3	30060	1337022233	1	0.04	0.000714285714285714	10368	1
4	Food 2	Intake 4	271	30419	1337022592	/users/cn/jespinosa/phecomp/data/CRG/20120502_FDF_CRG/20120502_FDF_CRG/20120514_FDF_CRG_c12.mtb	4953	COLL	WWFF	food_fat	4	30148	1337022321	1	0.600000000000001	0.00221402214022141	10369	1
4	Drink 1	Intake 1	15	30170	1337022343	/users/cn/jespinosa/phecomp/data/CRG/20120502_FDF_CRG/20120502_FDF_CRG/20120514_FDF_CRG_c12.mtb	1683	NA	WWFF	water	1	30155	1337022328	1	0.0399999999999999	0.00266666666666666	10370	1
4	Food 1	Intake 3	109	30406	1337022579	/users/cn/jespinosa/phecomp/data/CRG/20120502_FDF_CRG/20120502_FDF_CRG/20120514_FDF_CRG_c12.mtb	4349	22	WWFF	food_fat	3	30297	1337022470	1	0.42	0.00385321100917431	10371	1
4	Food 2	Intake 4	271	30699	1337022872	/users/cn/jespinosa/phecomp/data/CRG/20120502_FDF_CRG/20120502_FDF_CRG/20120514_FDF_CRG_c12.mtb	4954	391	WWFF	food_fat	4	30428	1337022601	1	0.12	0.00044280442804428	10372	1
4	Drink 1	Intake 1	20	30786	1337022959	/users/cn/jespinosa/phecomp/data/CRG/20120502_FDF_CRG/20120502_FDF_CRG/20120514_FDF_CRG_c12.mtb	1684	NA	WWFF	water	1	30766	1337022939	1	0.04	0.002	10373	1
4	Food 2	Intake 4	198	31288	1337023461	/users/cn/jespinosa/phecomp/data/CRG/20120502_FDF_CRG/20120502_FDF_CRG/20120514_FDF_CRG_c12.mtb	4956	256	WWFF	food_fat	4	31090	1337023263	1	0.4	0.00202020202020202	10374	1
4	Food 1	Intake 3	177	31721	1337023894	/users/cn/jespinosa/phecomp/data/CRG/20120502_FDF_CRG/20120502_FDF_CRG/20120514_FDF_CRG_c12.mtb	4354	11	WWFF	food_fat	3	31544	1337023717	1	0.48	0.00271186440677966	10375	1
4	Food 1	Intake 3	55	31787	1337023960	/users/cn/jespinosa/phecomp/data/CRG/20120502_FDF_CRG/20120502_FDF_CRG/20120514_FDF_CRG_c12.mtb	4355	32	WWFF	food_fat	3	31732	1337023905	1	0.0200000000000005	0.000363636363636373	10376	1
4	Food 2	Intake 4	387	32206	1337024379	/users/cn/jespinosa/phecomp/data/CRG/20120502_FDF_CRG/20120502_FDF_CRG/20120514_FDF_CRG_c12.mtb	4959	145	WWFF	food_fat	4	31819	1337023992	1	0.779999999999999	0.00201550387596899	10377	1
4	Food 2	Intake 4	138	32489	1337024662	/users/cn/jespinosa/phecomp/data/CRG/20120502_FDF_CRG/20120502_FDF_CRG/20120514_FDF_CRG_c12.mtb	4961	15	WWFF	food_fat	4	32351	1337024524	1	0.04	0.000289855072463768	10378	1
4	Food 2	Intake 4	128	32632	1337024805	/users/cn/jespinosa/phecomp/data/CRG/20120502_FDF_CRG/20120502_FDF_CRG/20120514_FDF_CRG_c12.mtb	4962	97	WWFF	food_fat	4	32504	1337024677	1	0.0200000000000005	0.000156250000000004	10379	1
4	Food 2	Intake 4	241	32970	1337025143	/users/cn/jespinosa/phecomp/data/CRG/20120502_FDF_CRG/20120502_FDF_CRG/20120514_FDF_CRG_c12.mtb	4964	141	WWFF	food_fat	4	32729	1337024902	1	0.180000000000001	0.000746887966804983	10380	1
4	Food 2	Intake 4	544	33655	1337025828	/users/cn/jespinosa/phecomp/data/CRG/20120502_FDF_CRG/20120502_FDF_CRG/20120514_FDF_CRG_c12.mtb	4965	4	WWFF	food_fat	4	33111	1337025284	1	0.84	0.00154411764705882	10381	1
4	Food 2	Intake 4	162	33821	1337025994	/users/cn/jespinosa/phecomp/data/CRG/20120502_FDF_CRG/20120502_FDF_CRG/20120514_FDF_CRG_c12.mtb	4966	311	WWFF	food_fat	4	33659	1337025832	1	0.28	0.0017283950617284	10382	1
4	Food 2	Intake 4	205	34337	1337026510	/users/cn/jespinosa/phecomp/data/CRG/20120502_FDF_CRG/20120502_FDF_CRG/20120514_FDF_CRG_c12.mtb	4967	COLL	WWFF	food_fat	4	34132	1337026305	1	0.239999999999999	0.00117073170731707	10383	1
4	Drink 2	Intake 2	16	34223	1337026396	/users/cn/jespinosa/phecomp/data/CRG/20120502_FDF_CRG/20120502_FDF_CRG/20120514_FDF_CRG_c12.mtb	1579	NA	WWFF	water	2	34207	1337026380	1	0.06	0.00375	10384	1
4	Food 1	Intake 3	50	34330	1337026503	/users/cn/jespinosa/phecomp/data/CRG/20120502_FDF_CRG/20120502_FDF_CRG/20120514_FDF_CRG_c12.mtb	4361	381	WWFF	food_fat	3	34280	1337026453	1	0.0200000000000005	0.00040000000000001	10385	1
4	Food 2	Intake 4	46	34757	1337026930	/users/cn/jespinosa/phecomp/data/CRG/20120502_FDF_CRG/20120502_FDF_CRG/20120514_FDF_CRG_c12.mtb	4969	121	WWFF	food_fat	4	34711	1337026884	1	0.0600000000000005	0.00130434782608697	10386	1
4	Drink 1	Intake 1	18	34749	1337026922	/users/cn/jespinosa/phecomp/data/CRG/20120502_FDF_CRG/20120502_FDF_CRG/20120514_FDF_CRG_c12.mtb	1686	NA	WWFF	water	1	34731	1337026904	1	0.04	0.00222222222222222	10387	1
4	Food 2	Intake 4	10	34888	1337027061	/users/cn/jespinosa/phecomp/data/CRG/20120502_FDF_CRG/20120502_FDF_CRG/20120514_FDF_CRG_c12.mtb	4971	98	WWFF	food_fat	4	34878	1337027051	1	0.04	0.004	10388	1
4	Food 2	Intake 4	533	35519	1337027692	/users/cn/jespinosa/phecomp/data/CRG/20120502_FDF_CRG/20120502_FDF_CRG/20120514_FDF_CRG_c12.mtb	4973	39	WWFF	food_fat	4	34986	1337027159	1	0.12	0.000225140712945591	10389	1
4	Food 2	Intake 4	20	35578	1337027751	/users/cn/jespinosa/phecomp/data/CRG/20120502_FDF_CRG/20120502_FDF_CRG/20120514_FDF_CRG_c12.mtb	4974	64	WWFF	food_fat	4	35558	1337027731	1	0.0200000000000005	0.00100000000000002	10390	1
4	Food 2	Intake 4	145	35787	1337027960	/users/cn/jespinosa/phecomp/data/CRG/20120502_FDF_CRG/20120502_FDF_CRG/20120514_FDF_CRG_c12.mtb	4975	143	WWFF	food_fat	4	35642	1337027815	1	0.26	0.00179310344827586	10391	1
4	Food 2	Intake 4	67	35997	1337028170	/users/cn/jespinosa/phecomp/data/CRG/20120502_FDF_CRG/20120502_FDF_CRG/20120514_FDF_CRG_c12.mtb	4977	671	WWFF	food_fat	4	35930	1337028103	1	0.0600000000000005	0.000895522388059709	10392	1
4	Food 2	Intake 4	60	36728	1337028901	/users/cn/jespinosa/phecomp/data/CRG/20120502_FDF_CRG/20120502_FDF_CRG/20120514_FDF_CRG_c12.mtb	4984	182	WWFF	food_fat	4	36668	1337028841	1	0.04	0.000666666666666667	10393	1
4	Drink 2	Intake 2	18	36689	1337028862	/users/cn/jespinosa/phecomp/data/CRG/20120502_FDF_CRG/20120502_FDF_CRG/20120514_FDF_CRG_c12.mtb	1580	NA	WWFF	water	2	36671	1337028844	1	0.04	0.00222222222222222	10394	1
4	Food 2	Intake 4	58	36968	1337029141	/users/cn/jespinosa/phecomp/data/CRG/20120502_FDF_CRG/20120502_FDF_CRG/20120514_FDF_CRG_c12.mtb	4986	340	WWFF	food_fat	4	36910	1337029083	1	0.0200000000000005	0.000344827586206905	10395	1
4	Food 2	Intake 4	22	37330	1337029503	/users/cn/jespinosa/phecomp/data/CRG/20120502_FDF_CRG/20120502_FDF_CRG/20120514_FDF_CRG_c12.mtb	4988	736	WWFF	food_fat	4	37308	1337029481	1	0.04	0.00181818181818182	10396	1
4	Food 2	Intake 4	13	38079	1337030252	/users/cn/jespinosa/phecomp/data/CRG/20120502_FDF_CRG/20120502_FDF_CRG/20120514_FDF_CRG_c12.mtb	4990	400	WWFF	food_fat	4	38066	1337030239	1	0.0399999999999991	0.00307692307692301	10397	1
4	Food 2	Intake 4	14	38493	1337030666	/users/cn/jespinosa/phecomp/data/CRG/20120502_FDF_CRG/20120502_FDF_CRG/20120514_FDF_CRG_c12.mtb	4991	412	WWFF	food_fat	4	38479	1337030652	1	0.0400000000000009	0.00285714285714292	10398	1
4	Drink 1	Intake 1	16	38651	1337030824	/users/cn/jespinosa/phecomp/data/CRG/20120502_FDF_CRG/20120502_FDF_CRG/20120514_FDF_CRG_c12.mtb	1688	NA	WWFF	water	1	38635	1337030808	1	0.08	0.005	10399	1
4	Food 2	Intake 4	17	38922	1337031095	/users/cn/jespinosa/phecomp/data/CRG/20120502_FDF_CRG/20120502_FDF_CRG/20120514_FDF_CRG_c12.mtb	4994	522	WWFF	food_fat	4	38905	1337031078	1	0.0400000000000009	0.00235294117647064	10400	1
4	Food 2	Intake 4	26	39470	1337031643	/users/cn/jespinosa/phecomp/data/CRG/20120502_FDF_CRG/20120502_FDF_CRG/20120514_FDF_CRG_c12.mtb	4997	2019	WWFF	food_fat	4	39444	1337031617	1	0.04	0.00153846153846154	10401	1
4	Food 2	Intake 4	21	41510	1337033683	/users/cn/jespinosa/phecomp/data/CRG/20120502_FDF_CRG/20120502_FDF_CRG/20120514_FDF_CRG_c12.mtb	5010	1847	WWFF	food_fat	4	41489	1337033662	1	0.0200000000000005	0.000952380952380976	10402	1
4	Drink 1	Intake 1	11	42025	1337034198	/users/cn/jespinosa/phecomp/data/CRG/20120502_FDF_CRG/20120502_FDF_CRG/20120514_FDF_CRG_c12.mtb	1690	NA	WWFF	water	1	42014	1337034187	1	0.0600000000000001	0.00545454545454546	10403	1
4	Drink 1	Intake 1	13	43101	1337035274	/users/cn/jespinosa/phecomp/data/CRG/20120502_FDF_CRG/20120502_FDF_CRG/20120514_FDF_CRG_c12.mtb	1691	NA	WWFF	water	1	43088	1337035261	1	0.02	0.00153846153846154	10404	1
4	Food 2	Intake 4	12	43369	1337035542	/users/cn/jespinosa/phecomp/data/CRG/20120502_FDF_CRG/20120502_FDF_CRG/20120514_FDF_CRG_c12.mtb	5018	291	WWFF	food_fat	4	43357	1337035530	1	0.04	0.00333333333333333	10405	1
4	Food 2	Intake 4	15	43675	1337035848	/users/cn/jespinosa/phecomp/data/CRG/20120502_FDF_CRG/20120502_FDF_CRG/20120514_FDF_CRG_c12.mtb	5020	547	WWFF	food_fat	4	43660	1337035833	1	0.0200000000000005	0.00133333333333337	10406	1
4	Food 2	Intake 4	12	44234	1337036407	/users/cn/jespinosa/phecomp/data/CRG/20120502_FDF_CRG/20120502_FDF_CRG/20120514_FDF_CRG_c12.mtb	5024	1066	WWFF	food_fat	4	44222	1337036395	1	0.04	0.00333333333333333	10407	1
4	Food 2	Intake 4	56	45356	1337037529	/users/cn/jespinosa/phecomp/data/CRG/20120502_FDF_CRG/20120502_FDF_CRG/20120514_FDF_CRG_c12.mtb	5030	445	WWFF	food_fat	4	45300	1337037473	1	0.04	0.000714285714285714	10408	1
4	Drink 1	Intake 1	16	45321	1337037494	/users/cn/jespinosa/phecomp/data/CRG/20120502_FDF_CRG/20120502_FDF_CRG/20120514_FDF_CRG_c12.mtb	1693	NA	WWFF	water	1	45305	1337037478	1	0.04	0.0025	10409	1
4	Food 2	Intake 4	279	46080	1337038253	/users/cn/jespinosa/phecomp/data/CRG/20120502_FDF_CRG/20120502_FDF_CRG/20120514_FDF_CRG_c12.mtb	5035	32	WWFF	food_fat	4	45801	1337037974	1	0.36	0.00129032258064516	10410	1
4	Food 2	Intake 4	181	46293	1337038466	/users/cn/jespinosa/phecomp/data/CRG/20120502_FDF_CRG/20120502_FDF_CRG/20120514_FDF_CRG_c12.mtb	5036	COLL	WWFF	food_fat	4	46112	1337038285	1	0.100000000000001	0.000552486187845309	10411	1
4	Food 1	Intake 3	142	46284	1337038457	/users/cn/jespinosa/phecomp/data/CRG/20120502_FDF_CRG/20120502_FDF_CRG/20120514_FDF_CRG_c12.mtb	4366	37	WWFF	food_fat	3	46142	1337038315	1	0.04	0.00028169014084507	10412	1
4	Food 2	Intake 4	330	46651	1337038824	/users/cn/jespinosa/phecomp/data/CRG/20120502_FDF_CRG/20120502_FDF_CRG/20120514_FDF_CRG_c12.mtb	5037	COLL	WWFF	food_fat	4	46321	1337038494	1	0.0399999999999991	0.000121212121212118	10413	1
4	Food 1	Intake 3	123	46557	1337038730	/users/cn/jespinosa/phecomp/data/CRG/20120502_FDF_CRG/20120502_FDF_CRG/20120514_FDF_CRG_c12.mtb	4367	7	WWFF	food_fat	3	46434	1337038607	1	0.18	0.00146341463414634	10414	1
4	Food 1	Intake 3	83	46647	1337038820	/users/cn/jespinosa/phecomp/data/CRG/20120502_FDF_CRG/20120502_FDF_CRG/20120514_FDF_CRG_c12.mtb	4368	66	WWFF	food_fat	3	46564	1337038737	1	0.0200000000000005	0.000240963855421693	10415	1
4	Drink 2	Intake 2	18	46703	1337038876	/users/cn/jespinosa/phecomp/data/CRG/20120502_FDF_CRG/20120502_FDF_CRG/20120514_FDF_CRG_c12.mtb	1581	NA	WWFF	water	2	46685	1337038858	1	0.04	0.00222222222222222	10416	1
4	Food 1	Intake 3	217	46930	1337039103	/users/cn/jespinosa/phecomp/data/CRG/20120502_FDF_CRG/20120502_FDF_CRG/20120514_FDF_CRG_c12.mtb	4369	249	WWFF	food_fat	3	46713	1337038886	1	0.119999999999999	0.000552995391705064	10417	1
4	Food 2	Intake 4	14	47193	1337039366	/users/cn/jespinosa/phecomp/data/CRG/20120502_FDF_CRG/20120502_FDF_CRG/20120514_FDF_CRG_c12.mtb	5041	160	WWFF	food_fat	4	47179	1337039352	1	0.159999999999999	0.0114285714285714	10418	1
4	Food 2	Intake 4	248	47601	1337039774	/users/cn/jespinosa/phecomp/data/CRG/20120502_FDF_CRG/20120502_FDF_CRG/20120514_FDF_CRG_c12.mtb	5043	COLL	WWFF	food_fat	4	47353	1337039526	1	0.16	0.000645161290322581	10419	1
4	Food 1	Intake 3	17	47397	1337039570	/users/cn/jespinosa/phecomp/data/CRG/20120502_FDF_CRG/20120502_FDF_CRG/20120514_FDF_CRG_c12.mtb	4370	239	WWFF	food_fat	3	47380	1337039553	1	0.0200000000000005	0.00117647058823532	10420	1
4	Food 2	Intake 4	307	47943	1337040116	/users/cn/jespinosa/phecomp/data/CRG/20120502_FDF_CRG/20120502_FDF_CRG/20120514_FDF_CRG_c12.mtb	5044	COLL	WWFF	food_fat	4	47636	1337039809	1	0.32	0.00104234527687296	10421	1
4	Food 1	Intake 3	51	47852	1337040025	/users/cn/jespinosa/phecomp/data/CRG/20120502_FDF_CRG/20120502_FDF_CRG/20120514_FDF_CRG_c12.mtb	4372	15	WWFF	food_fat	3	47801	1337039974	1	0.0599999999999996	0.00117647058823529	10422	1
4	Food 1	Intake 3	75	47942	1337040115	/users/cn/jespinosa/phecomp/data/CRG/20120502_FDF_CRG/20120502_FDF_CRG/20120514_FDF_CRG_c12.mtb	4373	67	WWFF	food_fat	3	47867	1337040040	1	0.0200000000000005	0.000266666666666673	10423	1
4	Food 2	Intake 4	281	48290	1337040463	/users/cn/jespinosa/phecomp/data/CRG/20120502_FDF_CRG/20120502_FDF_CRG/20120514_FDF_CRG_c12.mtb	5045	49	WWFF	food_fat	4	48009	1337040182	1	0.42	0.00149466192170819	10424	1
4	Drink 2	Intake 2	18	48054	1337040227	/users/cn/jespinosa/phecomp/data/CRG/20120502_FDF_CRG/20120502_FDF_CRG/20120514_FDF_CRG_c12.mtb	1583	NA	WWFF	water	2	48036	1337040209	1	0.04	0.00222222222222222	10425	1
4	Food 2	Intake 4	137	48476	1337040649	/users/cn/jespinosa/phecomp/data/CRG/20120502_FDF_CRG/20120502_FDF_CRG/20120514_FDF_CRG_c12.mtb	5046	45	WWFF	food_fat	4	48339	1337040512	1	0.0600000000000005	0.000437956204379566	10426	1
4	Drink 1	Intake 1	18	48496	1337040669	/users/cn/jespinosa/phecomp/data/CRG/20120502_FDF_CRG/20120502_FDF_CRG/20120514_FDF_CRG_c12.mtb	1695	NA	WWFF	water	1	48478	1337040651	1	0.0399999999999998	0.00222222222222221	10427	1
4	Food 2	Intake 4	256	48777	1337040950	/users/cn/jespinosa/phecomp/data/CRG/20120502_FDF_CRG/20120502_FDF_CRG/20120514_FDF_CRG_c12.mtb	5048	828	WWFF	food_fat	4	48521	1337040694	1	0.459999999999999	0.001796875	10428	1
4	Food 2	Intake 4	218	49823	1337041996	/users/cn/jespinosa/phecomp/data/CRG/20120502_FDF_CRG/20120502_FDF_CRG/20120514_FDF_CRG_c12.mtb	5058	221	WWFF	food_fat	4	49605	1337041778	1	0.18	0.000825688073394495	10429	1
4	Drink 1	Intake 1	17	49704	1337041877	/users/cn/jespinosa/phecomp/data/CRG/20120502_FDF_CRG/20120502_FDF_CRG/20120514_FDF_CRG_c12.mtb	1696	NA	WWFF	water	1	49687	1337041860	1	0.04	0.00235294117647059	10430	1
4	Food 2	Intake 4	120	50164	1337042337	/users/cn/jespinosa/phecomp/data/CRG/20120502_FDF_CRG/20120502_FDF_CRG/20120514_FDF_CRG_c12.mtb	5061	23	WWFF	food_fat	4	50044	1337042217	1	0.0200000000000014	0.000166666666666678	10431	1
4	Food 2	Intake 4	189	50376	1337042549	/users/cn/jespinosa/phecomp/data/CRG/20120502_FDF_CRG/20120502_FDF_CRG/20120514_FDF_CRG_c12.mtb	5062	120	WWFF	food_fat	4	50187	1337042360	1	0.0399999999999991	0.000211640211640207	10432	1
4	Food 2	Intake 4	43	50539	1337042712	/users/cn/jespinosa/phecomp/data/CRG/20120502_FDF_CRG/20120502_FDF_CRG/20120514_FDF_CRG_c12.mtb	5064	70	WWFF	food_fat	4	50496	1337042669	1	0.34	0.00790697674418605	10433	1
4	Food 2	Intake 4	26	50635	1337042808	/users/cn/jespinosa/phecomp/data/CRG/20120502_FDF_CRG/20120502_FDF_CRG/20120514_FDF_CRG_c12.mtb	5067	90	WWFF	food_fat	4	50609	1337042782	1	0.0999999999999996	0.00384615384615383	10434	1
4	Food 2	Intake 4	26	50751	1337042924	/users/cn/jespinosa/phecomp/data/CRG/20120502_FDF_CRG/20120502_FDF_CRG/20120514_FDF_CRG_c12.mtb	5069	143	WWFF	food_fat	4	50725	1337042898	1	0.299999999999999	0.0115384615384615	10435	1
4	Food 2	Intake 4	370	51264	1337043437	/users/cn/jespinosa/phecomp/data/CRG/20120502_FDF_CRG/20120502_FDF_CRG/20120514_FDF_CRG_c12.mtb	5072	654	WWFF	food_fat	4	50894	1337043067	1	0.0200000000000014	5.40540540540578e-05	10436	1
4	Food 2	Intake 4	83	52001	1337044174	/users/cn/jespinosa/phecomp/data/CRG/20120502_FDF_CRG/20120502_FDF_CRG/20120514_FDF_CRG_c12.mtb	5079	4850	WWFF	food_fat	4	51918	1337044091	1	0.34	0.00409638554216867	10437	1
4	Drink 1	Intake 1	14	53638	1337045811	/users/cn/jespinosa/phecomp/data/CRG/20120502_FDF_CRG/20120502_FDF_CRG/20120514_FDF_CRG_c12.mtb	1697	NA	WWFF	water	1	53624	1337045797	1	0.0800000000000001	0.00571428571428572	10438	1
4	Drink 2	Intake 2	18	55969	1337048142	/users/cn/jespinosa/phecomp/data/CRG/20120502_FDF_CRG/20120502_FDF_CRG/20120514_FDF_CRG_c12.mtb	1584	NA	WWFF	water	2	55951	1337048124	1	0.02	0.00111111111111111	10439	1
4	Drink 1	Intake 1	17	55977	1337048150	/users/cn/jespinosa/phecomp/data/CRG/20120502_FDF_CRG/20120502_FDF_CRG/20120514_FDF_CRG_c12.mtb	1698	NA	WWFF	water	1	55960	1337048133	1	0.02	0.00117647058823529	10440	1
4	Food 2	Intake 4	69	56920	1337049093	/users/cn/jespinosa/phecomp/data/CRG/20120502_FDF_CRG/20120502_FDF_CRG/20120514_FDF_CRG_c12.mtb	5099	551	WWFF	food_fat	4	56851	1337049024	1	0.319999999999999	0.00463768115942028	10441	1
4	Food 2	Intake 4	33	57504	1337049677	/users/cn/jespinosa/phecomp/data/CRG/20120502_FDF_CRG/20120502_FDF_CRG/20120514_FDF_CRG_c12.mtb	5101	1662	WWFF	food_fat	4	57471	1337049644	1	0.0400000000000009	0.00121212121212124	10442	1
4	Drink 1	Intake 1	16	57901	1337050074	/users/cn/jespinosa/phecomp/data/CRG/20120502_FDF_CRG/20120502_FDF_CRG/20120514_FDF_CRG_c12.mtb	1699	NA	WWFF	water	1	57885	1337050058	1	0.02	0.00125	10443	1
4	Food 2	Intake 4	37	59203	1337051376	/users/cn/jespinosa/phecomp/data/CRG/20120502_FDF_CRG/20120502_FDF_CRG/20120514_FDF_CRG_c12.mtb	5105	587	WWFF	food_fat	4	59166	1337051339	1	0.0399999999999991	0.00108108108108106	10444	1
4	Drink 1	Intake 1	19	59196	1337051369	/users/cn/jespinosa/phecomp/data/CRG/20120502_FDF_CRG/20120502_FDF_CRG/20120514_FDF_CRG_c12.mtb	1700	NA	WWFF	water	1	59177	1337051350	1	0.0599999999999998	0.00315789473684209	10445	1
4	Food 2	Intake 4	12	59802	1337051975	/users/cn/jespinosa/phecomp/data/CRG/20120502_FDF_CRG/20120502_FDF_CRG/20120514_FDF_CRG_c12.mtb	5107	1612	WWFF	food_fat	4	59790	1337051963	1	0.0200000000000014	0.00166666666666678	10446	1
4	Drink 1	Intake 1	22	60304	1337052477	/users/cn/jespinosa/phecomp/data/CRG/20120502_FDF_CRG/20120502_FDF_CRG/20120514_FDF_CRG_c12.mtb	1701	NA	WWFF	water	1	60282	1337052455	1	0.04	0.00181818181818182	10447	1
4	Food 2	Intake 4	272	61686	1337053859	/users/cn/jespinosa/phecomp/data/CRG/20120502_FDF_CRG/20120502_FDF_CRG/20120514_FDF_CRG_c12.mtb	5116	2556	WWFF	food_fat	4	61414	1337053587	1	0.619999999999999	0.00227941176470588	10448	1
4	Drink 1	Intake 1	22	61743	1337053916	/users/cn/jespinosa/phecomp/data/CRG/20120502_FDF_CRG/20120502_FDF_CRG/20120514_FDF_CRG_c12.mtb	1702	NA	WWFF	water	1	61721	1337053894	1	0.12	0.00545454545454545	10449	1
4	Food 2	Intake 4	371	64613	1337056786	/users/cn/jespinosa/phecomp/data/CRG/20120502_FDF_CRG/20120502_FDF_CRG/20120514_FDF_CRG_c12.mtb	5123	15	WWFF	food_fat	4	64242	1337056415	1	0.0800000000000001	0.000215633423180593	10450	1
4	Food 2	Intake 4	118	64746	1337056919	/users/cn/jespinosa/phecomp/data/CRG/20120502_FDF_CRG/20120502_FDF_CRG/20120514_FDF_CRG_c12.mtb	5124	22	WWFF	food_fat	4	64628	1337056801	1	0.119999999999999	0.00101694915254236	10451	1
4	Food 2	Intake 4	148	64916	1337057089	/users/cn/jespinosa/phecomp/data/CRG/20120502_FDF_CRG/20120502_FDF_CRG/20120514_FDF_CRG_c12.mtb	5125	COLL	WWFF	food_fat	4	64768	1337056941	1	0.0200000000000014	0.000135135135135145	10452	1
4	Food 1	Intake 3	23	64920	1337057093	/users/cn/jespinosa/phecomp/data/CRG/20120502_FDF_CRG/20120502_FDF_CRG/20120514_FDF_CRG_c12.mtb	4382	128	WWFF	food_fat	3	64897	1337057070	1	0.0200000000000005	0.000869565217391326	10453	1
4	Food 1	Intake 3	63	65111	1337057284	/users/cn/jespinosa/phecomp/data/CRG/20120502_FDF_CRG/20120502_FDF_CRG/20120514_FDF_CRG_c12.mtb	4384	COLL	WWFF	food_fat	3	65048	1337057221	1	0.04	0.000634920634920635	10454	1
4	Food 2	Intake 4	48	65128	1337057301	/users/cn/jespinosa/phecomp/data/CRG/20120502_FDF_CRG/20120502_FDF_CRG/20120514_FDF_CRG_c12.mtb	5127	42	WWFF	food_fat	4	65080	1337057253	1	0.119999999999999	0.00249999999999998	10455	1
4	Drink 2	Intake 2	24	65141	1337057314	/users/cn/jespinosa/phecomp/data/CRG/20120502_FDF_CRG/20120502_FDF_CRG/20120514_FDF_CRG_c12.mtb	1585	NA	WWFF	water	2	65117	1337057290	1	0.12	0.005	10456	1
4	Food 2	Intake 4	98	65268	1337057441	/users/cn/jespinosa/phecomp/data/CRG/20120502_FDF_CRG/20120502_FDF_CRG/20120514_FDF_CRG_c12.mtb	5129	60	WWFF	food_fat	4	65170	1337057343	1	0.0800000000000001	0.000816326530612246	10457	1
4	Food 2	Intake 4	105	65433	1337057606	/users/cn/jespinosa/phecomp/data/CRG/20120502_FDF_CRG/20120502_FDF_CRG/20120514_FDF_CRG_c12.mtb	5131	124	WWFF	food_fat	4	65328	1337057501	1	0.299999999999999	0.00285714285714285	10458	1
4	Food 2	Intake 4	174	65731	1337057904	/users/cn/jespinosa/phecomp/data/CRG/20120502_FDF_CRG/20120502_FDF_CRG/20120514_FDF_CRG_c12.mtb	5133	846	WWFF	food_fat	4	65557	1337057730	1	0.140000000000001	0.000804597701149431	10459	1
4	Drink 2	Intake 2	21	65820	1337057993	/users/cn/jespinosa/phecomp/data/CRG/20120502_FDF_CRG/20120502_FDF_CRG/20120514_FDF_CRG_c12.mtb	1586	NA	WWFF	water	2	65799	1337057972	1	0.04	0.0019047619047619	10460	1
4	Drink 1	Intake 1	18	66466	1337058639	/users/cn/jespinosa/phecomp/data/CRG/20120502_FDF_CRG/20120502_FDF_CRG/20120514_FDF_CRG_c12.mtb	1704	NA	WWFF	water	1	66448	1337058621	1	0.02	0.00111111111111111	10461	1
4	Food 2	Intake 4	126	66703	1337058876	/users/cn/jespinosa/phecomp/data/CRG/20120502_FDF_CRG/20120502_FDF_CRG/20120514_FDF_CRG_c12.mtb	5138	105	WWFF	food_fat	4	66577	1337058750	1	0.139999999999999	0.0011111111111111	10462	1
4	Food 2	Intake 4	61	66869	1337059042	/users/cn/jespinosa/phecomp/data/CRG/20120502_FDF_CRG/20120502_FDF_CRG/20120514_FDF_CRG_c12.mtb	5140	361	WWFF	food_fat	4	66808	1337058981	1	0.120000000000001	0.00196721311475411	10463	1
4	Food 2	Intake 4	190	67420	1337059593	/users/cn/jespinosa/phecomp/data/CRG/20120502_FDF_CRG/20120502_FDF_CRG/20120514_FDF_CRG_c12.mtb	5143	3135	WWFF	food_fat	4	67230	1337059403	1	0.260000000000002	0.00136842105263159	10464	1
4	Drink 1	Intake 1	22	69643	1337061816	/users/cn/jespinosa/phecomp/data/CRG/20120502_FDF_CRG/20120502_FDF_CRG/20120514_FDF_CRG_c12.mtb	1705	NA	WWFF	water	1	69621	1337061794	1	0.0800000000000001	0.00363636363636364	10465	1
4	Food 2	Intake 4	12	70567	1337062740	/users/cn/jespinosa/phecomp/data/CRG/20120502_FDF_CRG/20120502_FDF_CRG/20120514_FDF_CRG_c12.mtb	5148	731	WWFF	food_fat	4	70555	1337062728	1	0.0200000000000014	0.00166666666666678	10466	1
4	Drink 1	Intake 1	15	70730	1337062903	/users/cn/jespinosa/phecomp/data/CRG/20120502_FDF_CRG/20120502_FDF_CRG/20120514_FDF_CRG_c12.mtb	1706	NA	WWFF	water	1	70715	1337062888	1	0.02	0.00133333333333333	10467	1
4	Food 2	Intake 4	12	71310	1337063483	/users/cn/jespinosa/phecomp/data/CRG/20120502_FDF_CRG/20120502_FDF_CRG/20120514_FDF_CRG_c12.mtb	5150	847	WWFF	food_fat	4	71298	1337063471	1	0.0400000000000009	0.00333333333333341	10468	1
4	Food 2	Intake 4	20	72177	1337064350	/users/cn/jespinosa/phecomp/data/CRG/20120502_FDF_CRG/20120502_FDF_CRG/20120514_FDF_CRG_c12.mtb	5152	2637	WWFF	food_fat	4	72157	1337064330	1	0.0399999999999991	0.00199999999999995	10469	1
4	Drink 1	Intake 1	17	72674	1337064847	/users/cn/jespinosa/phecomp/data/CRG/20120502_FDF_CRG/20120502_FDF_CRG/20120514_FDF_CRG_c12.mtb	1707	NA	WWFF	water	1	72657	1337064830	1	0.0799999999999998	0.00470588235294116	10470	1
4	Drink 1	Intake 1	15	74541	1337066714	/users/cn/jespinosa/phecomp/data/CRG/20120502_FDF_CRG/20120502_FDF_CRG/20120514_FDF_CRG_c12.mtb	1708	NA	WWFF	water	1	74526	1337066699	1	0.0600000000000001	0.00400000000000001	10471	1
4	Food 2	Intake 4	20	74834	1337067007	/users/cn/jespinosa/phecomp/data/CRG/20120502_FDF_CRG/20120502_FDF_CRG/20120514_FDF_CRG_c12.mtb	5155	8088	WWFF	food_fat	4	74814	1337066987	1	0.0200000000000014	0.00100000000000007	10472	1
4	Drink 1	Intake 1	29	79643	1337071816	/users/cn/jespinosa/phecomp/data/CRG/20120502_FDF_CRG/20120502_FDF_CRG/20120514_FDF_CRG_c12.mtb	1710	NA	WWFF	water	1	79614	1337071787	1	0.1	0.00344827586206897	10473	1
4	Drink 1	Intake 1	22	80893	1337073066	/users/cn/jespinosa/phecomp/data/CRG/20120502_FDF_CRG/20120502_FDF_CRG/20120514_FDF_CRG_c12.mtb	1711	NA	WWFF	water	1	80871	1337073044	1	0.0800000000000001	0.00363636363636364	10474	1
4	Food 2	Intake 4	170	83092	1337075265	/users/cn/jespinosa/phecomp/data/CRG/20120502_FDF_CRG/20120502_FDF_CRG/20120514_FDF_CRG_c12.mtb	5164	12	WWFF	food_fat	4	82922	1337075095	1	0.219999999999999	0.00129411764705882	10475	1
4	Drink 2	Intake 2	28	82962	1337075135	/users/cn/jespinosa/phecomp/data/CRG/20120502_FDF_CRG/20120502_FDF_CRG/20120514_FDF_CRG_c12.mtb	1588	NA	WWFF	water	2	82934	1337075107	1	0.02	0.000714285714285714	10476	1
4	Food 2	Intake 4	340	83444	1337075617	/users/cn/jespinosa/phecomp/data/CRG/20120502_FDF_CRG/20120502_FDF_CRG/20120514_FDF_CRG_c12.mtb	5165	1829	WWFF	food_fat	4	83104	1337075277	1	0.0400000000000009	0.000117647058823532	10477	1
4	Drink 1	Intake 1	17	83338	1337075511	/users/cn/jespinosa/phecomp/data/CRG/20120502_FDF_CRG/20120502_FDF_CRG/20120514_FDF_CRG_c12.mtb	1712	NA	WWFF	water	1	83321	1337075494	1	0.02	0.00117647058823529	10478	1
4	Drink 2	Intake 2	111	83861	1337076034	/users/cn/jespinosa/phecomp/data/CRG/20120502_FDF_CRG/20120502_FDF_CRG/20120514_FDF_CRG_c12.mtb	1589	NA	WWFF	water	2	83750	1337075923	1	0.02	0.00018018018018018	10479	1
4	Food 2	Intake 4	52	85325	1337077498	/users/cn/jespinosa/phecomp/data/CRG/20120502_FDF_CRG/20120502_FDF_CRG/20120514_FDF_CRG_c12.mtb	5175	9532	WWFF	food_fat	4	85273	1337077446	1	0.0200000000000014	0.000384615384615412	10480	1
4	Drink 1	Intake 1	20	88724	1337080897	/users/cn/jespinosa/phecomp/data/CRG/20120502_FDF_CRG/20120502_FDF_CRG/20120514_FDF_CRG_c12.mtb	1714	NA	WWFF	water	1	88704	1337080877	1	0.12	0.006	10481	1
4	Drink 1	Intake 1	26	92815	1337084988	/users/cn/jespinosa/phecomp/data/CRG/20120502_FDF_CRG/20120502_FDF_CRG/20120514_FDF_CRG_c12.mtb	1715	NA	WWFF	water	1	92789	1337084962	1	0.1	0.00384615384615385	10482	1
4	Food 2	Intake 4	17	94874	1337087047	/users/cn/jespinosa/phecomp/data/CRG/20120502_FDF_CRG/20120502_FDF_CRG/20120514_FDF_CRG_c12.mtb	5181	626	WWFF	food_fat	4	94857	1337087030	1	0.0800000000000001	0.00470588235294118	10483	1
4	Food 2	Intake 4	11	95511	1337087684	/users/cn/jespinosa/phecomp/data/CRG/20120502_FDF_CRG/20120502_FDF_CRG/20120514_FDF_CRG_c12.mtb	5182	613	WWFF	food_fat	4	95500	1337087673	1	0.0399999999999991	0.00363636363636355	10484	1
4	Drink 1	Intake 1	30	95746	1337087919	/users/cn/jespinosa/phecomp/data/CRG/20120502_FDF_CRG/20120502_FDF_CRG/20120514_FDF_CRG_c12.mtb	1716	NA	WWFF	water	1	95716	1337087889	1	0.12	0.004	10485	1
4	Food 2	Intake 4	11	96135	1337088308	/users/cn/jespinosa/phecomp/data/CRG/20120502_FDF_CRG/20120502_FDF_CRG/20120514_FDF_CRG_c12.mtb	5183	12472	WWFF	food_fat	4	96124	1337088297	1	0.0200000000000014	0.00181818181818195	10486	1
4	Drink 1	Intake 1	11	99345	1337091518	/users/cn/jespinosa/phecomp/data/CRG/20120502_FDF_CRG/20120502_FDF_CRG/20120514_FDF_CRG_c12.mtb	1717	NA	WWFF	water	1	99334	1337091507	1	0.02	0.00181818181818182	10487	1
4	Drink 1	Intake 1	22	102286	1337094459	/users/cn/jespinosa/phecomp/data/CRG/20120502_FDF_CRG/20120502_FDF_CRG/20120514_FDF_CRG_c12.mtb	1718	NA	WWFF	water	1	102264	1337094437	1	0.12	0.00545454545454545	10488	1
4	Drink 1	Intake 1	26	105986	1337098159	/users/cn/jespinosa/phecomp/data/CRG/20120502_FDF_CRG/20120502_FDF_CRG/20120514_FDF_CRG_c12.mtb	1719	NA	WWFF	water	1	105960	1337098133	1	0.1	0.00384615384615385	10489	1
4	Food 2	Intake 4	24	108631	1337100804	/users/cn/jespinosa/phecomp/data/CRG/20120502_FDF_CRG/20120502_FDF_CRG/20120514_FDF_CRG_c12.mtb	5193	2730	WWFF	food_fat	4	108607	1337100780	1	0.0200000000000014	0.000833333333333392	10490	1
4	Drink 1	Intake 1	18	110835	1337103008	/users/cn/jespinosa/phecomp/data/CRG/20120502_FDF_CRG/20120502_FDF_CRG/20120514_FDF_CRG_c12.mtb	1720	NA	WWFF	water	1	110817	1337102990	1	0.0600000000000001	0.00333333333333334	10491	1
4	Food 2	Intake 4	43	111404	1337103577	/users/cn/jespinosa/phecomp/data/CRG/20120502_FDF_CRG/20120502_FDF_CRG/20120514_FDF_CRG_c12.mtb	5199	41	WWFF	food_fat	4	111361	1337103534	1	0.100000000000001	0.00232558139534886	10492	1
4	Food 2	Intake 4	129	111574	1337103747	/users/cn/jespinosa/phecomp/data/CRG/20120502_FDF_CRG/20120502_FDF_CRG/20120514_FDF_CRG_c12.mtb	5201	2487	WWFF	food_fat	4	111445	1337103618	1	0.0999999999999996	0.000775193798449609	10493	1
4	Drink 1	Intake 1	20	112723	1337104896	/users/cn/jespinosa/phecomp/data/CRG/20120502_FDF_CRG/20120502_FDF_CRG/20120514_FDF_CRG_c12.mtb	1722	NA	WWFF	water	1	112703	1337104876	1	0.0599999999999996	0.00299999999999998	10494	1
4	Food 2	Intake 4	279	114340	1337106513	/users/cn/jespinosa/phecomp/data/CRG/20120502_FDF_CRG/20120502_FDF_CRG/20120514_FDF_CRG_c12.mtb	5206	36	WWFF	food_fat	4	114061	1337106234	1	0.0600000000000005	0.000215053763440862	10495	1
4	Food 2	Intake 4	123	114499	1337106672	/users/cn/jespinosa/phecomp/data/CRG/20120502_FDF_CRG/20120502_FDF_CRG/20120514_FDF_CRG_c12.mtb	5207	127	WWFF	food_fat	4	114376	1337106549	1	0.18	0.00146341463414634	10496	1
4	Food 2	Intake 4	119	114745	1337106918	/users/cn/jespinosa/phecomp/data/CRG/20120502_FDF_CRG/20120502_FDF_CRG/20120514_FDF_CRG_c12.mtb	5208	COLL	WWFF	food_fat	4	114626	1337106799	1	0.26	0.00218487394957983	10497	1
4	Food 1	Intake 3	54	114697	1337106870	/users/cn/jespinosa/phecomp/data/CRG/20120502_FDF_CRG/20120502_FDF_CRG/20120514_FDF_CRG_c12.mtb	4397	62	WWFF	food_fat	3	114643	1337106816	1	0.0200000000000005	0.00037037037037038	10498	1
4	Food 2	Intake 4	379	115138	1337107311	/users/cn/jespinosa/phecomp/data/CRG/20120502_FDF_CRG/20120502_FDF_CRG/20120514_FDF_CRG_c12.mtb	5209	211	WWFF	food_fat	4	114759	1337106932	1	0.0800000000000001	0.000211081794195251	10499	1
4	Food 2	Intake 4	161	115510	1337107683	/users/cn/jespinosa/phecomp/data/CRG/20120502_FDF_CRG/20120502_FDF_CRG/20120514_FDF_CRG_c12.mtb	5211	81	WWFF	food_fat	4	115349	1337107522	1	0.0800000000000001	0.000496894409937889	10500	1
4	Food 2	Intake 4	260	115851	1337108024	/users/cn/jespinosa/phecomp/data/CRG/20120502_FDF_CRG/20120502_FDF_CRG/20120514_FDF_CRG_c12.mtb	5213	121	WWFF	food_fat	4	115591	1337107764	1	0.16	0.000615384615384615	10501	1
4	Food 2	Intake 4	81	116053	1337108226	/users/cn/jespinosa/phecomp/data/CRG/20120502_FDF_CRG/20120502_FDF_CRG/20120514_FDF_CRG_c12.mtb	5215	93	WWFF	food_fat	4	115972	1337108145	1	0.119999999999999	0.00148148148148147	10502	1
4	Food 2	Intake 4	123	116269	1337108442	/users/cn/jespinosa/phecomp/data/CRG/20120502_FDF_CRG/20120502_FDF_CRG/20120514_FDF_CRG_c12.mtb	5217	4	WWFF	food_fat	4	116146	1337108319	1	0.0800000000000001	0.000650406504065041	10503	1
4	Food 2	Intake 4	23	116296	1337108469	/users/cn/jespinosa/phecomp/data/CRG/20120502_FDF_CRG/20120502_FDF_CRG/20120514_FDF_CRG_c12.mtb	5218	207	WWFF	food_fat	4	116273	1337108446	1	0.0200000000000014	0.000869565217391365	10504	1
4	Food 2	Intake 4	163	116666	1337108839	/users/cn/jespinosa/phecomp/data/CRG/20120502_FDF_CRG/20120502_FDF_CRG/20120514_FDF_CRG_c12.mtb	5221	185	WWFF	food_fat	4	116503	1337108676	1	0.199999999999999	0.00122699386503067	10505	1
4	Food 2	Intake 4	132	116983	1337109156	/users/cn/jespinosa/phecomp/data/CRG/20120502_FDF_CRG/20120502_FDF_CRG/20120514_FDF_CRG_c12.mtb	5222	72	WWFF	food_fat	4	116851	1337109024	1	0.140000000000001	0.00106060606060607	10506	1
4	Food 2	Intake 4	52	117107	1337109280	/users/cn/jespinosa/phecomp/data/CRG/20120502_FDF_CRG/20120502_FDF_CRG/20120514_FDF_CRG_c12.mtb	5224	493	WWFF	food_fat	4	117055	1337109228	1	0.0399999999999991	0.000769230769230752	10507	1
4	Food 2	Intake 4	99	117699	1337109872	/users/cn/jespinosa/phecomp/data/CRG/20120502_FDF_CRG/20120502_FDF_CRG/20120514_FDF_CRG_c12.mtb	5228	14	WWFF	food_fat	4	117600	1337109773	1	0.0800000000000001	0.000808080808080809	10508	1
4	Food 2	Intake 4	242	117955	1337110128	/users/cn/jespinosa/phecomp/data/CRG/20120502_FDF_CRG/20120502_FDF_CRG/20120514_FDF_CRG_c12.mtb	5229	95	WWFF	food_fat	4	117713	1337109886	1	0.279999999999999	0.00115702479338843	10509	1
4	Food 2	Intake 4	122	118172	1337110345	/users/cn/jespinosa/phecomp/data/CRG/20120502_FDF_CRG/20120502_FDF_CRG/20120514_FDF_CRG_c12.mtb	5230	COLL	WWFF	food_fat	4	118050	1337110223	1	0.120000000000001	0.000983606557377057	10510	1
4	Food 1	Intake 3	54	118170	1337110343	/users/cn/jespinosa/phecomp/data/CRG/20120502_FDF_CRG/20120502_FDF_CRG/20120514_FDF_CRG_c12.mtb	4404	48	WWFF	food_fat	3	118116	1337110289	1	0.0200000000000005	0.00037037037037038	10511	1
4	Food 2	Intake 4	126	118344	1337110517	/users/cn/jespinosa/phecomp/data/CRG/20120502_FDF_CRG/20120502_FDF_CRG/20120514_FDF_CRG_c12.mtb	5231	49	WWFF	food_fat	4	118218	1337110391	1	0.0800000000000001	0.000634920634920636	10512	1
4	Drink 2	Intake 2	21	118407	1337110580	/users/cn/jespinosa/phecomp/data/CRG/20120502_FDF_CRG/20120502_FDF_CRG/20120514_FDF_CRG_c12.mtb	1601	NA	WWFF	water	2	118386	1337110559	1	0.02	0.000952380952380952	10513	1
4	Food 2	Intake 4	128	118521	1337110694	/users/cn/jespinosa/phecomp/data/CRG/20120502_FDF_CRG/20120502_FDF_CRG/20120514_FDF_CRG_c12.mtb	5233	43	WWFF	food_fat	4	118393	1337110566	1	0.0799999999999983	0.000624999999999987	10514	1
4	Food 2	Intake 4	177	118741	1337110914	/users/cn/jespinosa/phecomp/data/CRG/20120502_FDF_CRG/20120502_FDF_CRG/20120514_FDF_CRG_c12.mtb	5234	30	WWFF	food_fat	4	118564	1337110737	1	0.140000000000001	0.000790960451977407	10515	1
4	Food 2	Intake 4	182	118953	1337111126	/users/cn/jespinosa/phecomp/data/CRG/20120502_FDF_CRG/20120502_FDF_CRG/20120514_FDF_CRG_c12.mtb	5235	42	WWFF	food_fat	4	118771	1337110944	1	0.120000000000001	0.000659340659340665	10516	1
4	Food 2	Intake 4	89	119084	1337111257	/users/cn/jespinosa/phecomp/data/CRG/20120502_FDF_CRG/20120502_FDF_CRG/20120514_FDF_CRG_c12.mtb	5236	126	WWFF	food_fat	4	118995	1337111168	1	0.0999999999999996	0.00112359550561797	10517	1
4	Food 2	Intake 4	184	119394	1337111567	/users/cn/jespinosa/phecomp/data/CRG/20120502_FDF_CRG/20120502_FDF_CRG/20120514_FDF_CRG_c12.mtb	5238	5	WWFF	food_fat	4	119210	1337111383	1	0.359999999999999	0.00195652173913043	10518	1
4	Drink 2	Intake 2	18	119287	1337111460	/users/cn/jespinosa/phecomp/data/CRG/20120502_FDF_CRG/20120502_FDF_CRG/20120514_FDF_CRG_c12.mtb	1603	NA	WWFF	water	2	119269	1337111442	1	0.04	0.00222222222222222	10519	1
4	Food 2	Intake 4	192	119591	1337111764	/users/cn/jespinosa/phecomp/data/CRG/20120502_FDF_CRG/20120502_FDF_CRG/20120514_FDF_CRG_c12.mtb	5239	25	WWFF	food_fat	4	119399	1337111572	1	0.380000000000001	0.00197916666666667	10520	1
4	Food 2	Intake 4	206	119822	1337111995	/users/cn/jespinosa/phecomp/data/CRG/20120502_FDF_CRG/20120502_FDF_CRG/20120514_FDF_CRG_c12.mtb	5240	COLL	WWFF	food_fat	4	119616	1337111789	1	0.139999999999999	0.000679611650485432	10521	1
4	Food 1	Intake 3	57	119822	1337111995	/users/cn/jespinosa/phecomp/data/CRG/20120502_FDF_CRG/20120502_FDF_CRG/20120514_FDF_CRG_c12.mtb	4407	120	WWFF	food_fat	3	119765	1337111938	1	0.04	0.000701754385964912	10522	1
4	Food 2	Intake 4	118	120060	1337112233	/users/cn/jespinosa/phecomp/data/CRG/20120502_FDF_CRG/20120502_FDF_CRG/20120514_FDF_CRG_c12.mtb	5242	272	WWFF	food_fat	4	119942	1337112115	1	0.0200000000000014	0.000169491525423741	10523	1
4	Drink 2	Intake 2	21	120196	1337112369	/users/cn/jespinosa/phecomp/data/CRG/20120502_FDF_CRG/20120502_FDF_CRG/20120514_FDF_CRG_c12.mtb	1605	NA	WWFF	water	2	120175	1337112348	1	0.04	0.0019047619047619	10524	1
4	Food 2	Intake 4	184	120516	1337112689	/users/cn/jespinosa/phecomp/data/CRG/20120502_FDF_CRG/20120502_FDF_CRG/20120514_FDF_CRG_c12.mtb	5244	715	WWFF	food_fat	4	120332	1337112505	1	0.0999999999999996	0.000543478260869563	10525	1
4	Drink 1	Intake 1	36	120686	1337112859	/users/cn/jespinosa/phecomp/data/CRG/20120502_FDF_CRG/20120502_FDF_CRG/20120514_FDF_CRG_c12.mtb	1726	NA	WWFF	water	1	120650	1337112823	1	0.04	0.00111111111111111	10526	1
4	Drink 2	Intake 2	63	120740	1337112913	/users/cn/jespinosa/phecomp/data/CRG/20120502_FDF_CRG/20120502_FDF_CRG/20120514_FDF_CRG_c12.mtb	1606	NA	WWFF	water	2	120677	1337112850	1	0.0599999999999999	0.000952380952380951	10527	1
4	Food 2	Intake 4	37	121268	1337113441	/users/cn/jespinosa/phecomp/data/CRG/20120502_FDF_CRG/20120502_FDF_CRG/20120514_FDF_CRG_c12.mtb	5248	79	WWFF	food_fat	4	121231	1337113404	1	0.0599999999999987	0.00162162162162159	10528	1
4	Food 2	Intake 4	139	121486	1337113659	/users/cn/jespinosa/phecomp/data/CRG/20120502_FDF_CRG/20120502_FDF_CRG/20120514_FDF_CRG_c12.mtb	5250	75	WWFF	food_fat	4	121347	1337113520	1	0.379999999999999	0.00273381294964028	10529	1
4	Food 2	Intake 4	235	121796	1337113969	/users/cn/jespinosa/phecomp/data/CRG/20120502_FDF_CRG/20120502_FDF_CRG/20120514_FDF_CRG_c12.mtb	5251	327	WWFF	food_fat	4	121561	1337113734	1	0.0400000000000009	0.000170212765957451	10530	1
4	Drink 2	Intake 2	32	121736	1337113909	/users/cn/jespinosa/phecomp/data/CRG/20120502_FDF_CRG/20120502_FDF_CRG/20120514_FDF_CRG_c12.mtb	1608	NA	WWFF	water	2	121704	1337113877	1	0.02	0.000625	10531	1
4	Food 2	Intake 4	17	122140	1337114313	/users/cn/jespinosa/phecomp/data/CRG/20120502_FDF_CRG/20120502_FDF_CRG/20120514_FDF_CRG_c12.mtb	5254	91	WWFF	food_fat	4	122123	1337114296	1	0.139999999999999	0.008235294117647	10532	1
4	Food 1	Intake 3	76	122307	1337114480	/users/cn/jespinosa/phecomp/data/CRG/20120502_FDF_CRG/20120502_FDF_CRG/20120514_FDF_CRG_c12.mtb	4412	COLL	WWFF	food_fat	3	122231	1337114404	1	0.04	0.000526315789473684	10533	1
4	Food 2	Intake 4	134	122399	1337114572	/users/cn/jespinosa/phecomp/data/CRG/20120502_FDF_CRG/20120502_FDF_CRG/20120514_FDF_CRG_c12.mtb	5256	22	WWFF	food_fat	4	122265	1337114438	1	0.0999999999999996	0.000746268656716415	10534	1
4	Food 2	Intake 4	102	122523	1337114696	/users/cn/jespinosa/phecomp/data/CRG/20120502_FDF_CRG/20120502_FDF_CRG/20120514_FDF_CRG_c12.mtb	5257	90	WWFF	food_fat	4	122421	1337114594	1	0.0200000000000014	0.000196078431372563	10535	1
4	Food 2	Intake 4	23	122636	1337114809	/users/cn/jespinosa/phecomp/data/CRG/20120502_FDF_CRG/20120502_FDF_CRG/20120514_FDF_CRG_c12.mtb	5260	337	WWFF	food_fat	4	122613	1337114786	1	0.0599999999999987	0.00260869565217386	10536	1
4	Food 2	Intake 4	126	123099	1337115272	/users/cn/jespinosa/phecomp/data/CRG/20120502_FDF_CRG/20120502_FDF_CRG/20120514_FDF_CRG_c12.mtb	5262	159	WWFF	food_fat	4	122973	1337115146	1	0.140000000000001	0.00111111111111112	10537	1
4	Food 2	Intake 4	36	123294	1337115467	/users/cn/jespinosa/phecomp/data/CRG/20120502_FDF_CRG/20120502_FDF_CRG/20120514_FDF_CRG_c12.mtb	5264	546	WWFF	food_fat	4	123258	1337115431	1	0.0400000000000009	0.00111111111111114	10538	1
4	Food 2	Intake 4	161	124001	1337116174	/users/cn/jespinosa/phecomp/data/CRG/20120502_FDF_CRG/20120502_FDF_CRG/20120514_FDF_CRG_c12.mtb	5271	101	WWFF	food_fat	4	123840	1337116013	1	0.140000000000001	0.000869565217391311	10539	1
4	Food 2	Intake 4	55	124157	1337116330	/users/cn/jespinosa/phecomp/data/CRG/20120502_FDF_CRG/20120502_FDF_CRG/20120514_FDF_CRG_c12.mtb	5272	386	WWFF	food_fat	4	124102	1337116275	1	0.0400000000000009	0.000727272727272744	10540	1
4	Drink 1	Intake 1	18	124399	1337116572	/users/cn/jespinosa/phecomp/data/CRG/20120502_FDF_CRG/20120502_FDF_CRG/20120514_FDF_CRG_c12.mtb	1731	NA	WWFF	water	1	124381	1337116554	1	0.04	0.00222222222222222	10541	1
4	Food 2	Intake 4	94	124637	1337116810	/users/cn/jespinosa/phecomp/data/CRG/20120502_FDF_CRG/20120502_FDF_CRG/20120514_FDF_CRG_c12.mtb	5274	292	WWFF	food_fat	4	124543	1337116716	1	0.120000000000001	0.00127659574468086	10542	1
4	Drink 2	Intake 2	35	124683	1337116856	/users/cn/jespinosa/phecomp/data/CRG/20120502_FDF_CRG/20120502_FDF_CRG/20120514_FDF_CRG_c12.mtb	1611	NA	WWFF	water	2	124648	1337116821	1	0.02	0.000571428571428571	10543	1
4	Drink 2	Intake 2	31	124731	1337116904	/users/cn/jespinosa/phecomp/data/CRG/20120502_FDF_CRG/20120502_FDF_CRG/20120514_FDF_CRG_c12.mtb	1612	NA	WWFF	water	2	124700	1337116873	1	0.02	0.000645161290322581	10544	1
4	Food 2	Intake 4	224	125153	1337117326	/users/cn/jespinosa/phecomp/data/CRG/20120502_FDF_CRG/20120502_FDF_CRG/20120514_FDF_CRG_c12.mtb	5278	445	WWFF	food_fat	4	124929	1337117102	1	0.139999999999999	0.000624999999999995	10545	1
4	Drink 2	Intake 2	36	125537	1337117710	/users/cn/jespinosa/phecomp/data/CRG/20120502_FDF_CRG/20120502_FDF_CRG/20120514_FDF_CRG_c12.mtb	1614	NA	WWFF	water	2	125501	1337117674	1	0.02	0.000555555555555556	10546	1
4	Food 2	Intake 4	16	125614	1337117787	/users/cn/jespinosa/phecomp/data/CRG/20120502_FDF_CRG/20120502_FDF_CRG/20120514_FDF_CRG_c12.mtb	5282	45	WWFF	food_fat	4	125598	1337117771	1	0.139999999999999	0.00874999999999994	10547	1
4	Food 2	Intake 4	27	125686	1337117859	/users/cn/jespinosa/phecomp/data/CRG/20120502_FDF_CRG/20120502_FDF_CRG/20120514_FDF_CRG_c12.mtb	5284	118	WWFF	food_fat	4	125659	1337117832	1	0.0800000000000001	0.00296296296296297	10548	1
4	Food 2	Intake 4	388	126192	1337118365	/users/cn/jespinosa/phecomp/data/CRG/20120502_FDF_CRG/20120502_FDF_CRG/20120514_FDF_CRG_c12.mtb	5286	663	WWFF	food_fat	4	125804	1337117977	1	0.26	0.000670103092783505	10549	1
4	Drink 2	Intake 2	23	126610	1337118783	/users/cn/jespinosa/phecomp/data/CRG/20120502_FDF_CRG/20120502_FDF_CRG/20120514_FDF_CRG_c12.mtb	1615	NA	WWFF	water	2	126587	1337118760	1	0.02	0.000869565217391304	10550	1
4	Food 2	Intake 4	241	127096	1337119269	/users/cn/jespinosa/phecomp/data/CRG/20120502_FDF_CRG/20120502_FDF_CRG/20120514_FDF_CRG_c12.mtb	5292	906	WWFF	food_fat	4	126855	1337119028	1	0.0200000000000014	8.29875518672257e-05	10551	1
4	Drink 1	Intake 1	13	127108	1337119281	/users/cn/jespinosa/phecomp/data/CRG/20120502_FDF_CRG/20120502_FDF_CRG/20120514_FDF_CRG_c12.mtb	1735	NA	WWFF	water	1	127095	1337119268	1	0.0800000000000001	0.00615384615384616	10552	1
4	Food 2	Intake 4	181	128183	1337120356	/users/cn/jespinosa/phecomp/data/CRG/20120502_FDF_CRG/20120502_FDF_CRG/20120514_FDF_CRG_c12.mtb	5300	176	WWFF	food_fat	4	128002	1337120175	1	0.0200000000000014	0.000110497237569068	10553	1
4	Drink 1	Intake 1	21	128204	1337120377	/users/cn/jespinosa/phecomp/data/CRG/20120502_FDF_CRG/20120502_FDF_CRG/20120514_FDF_CRG_c12.mtb	1736	NA	WWFF	water	1	128183	1337120356	1	0.02	0.000952380952380952	10554	1
4	Food 2	Intake 4	16	128375	1337120548	/users/cn/jespinosa/phecomp/data/CRG/20120502_FDF_CRG/20120502_FDF_CRG/20120514_FDF_CRG_c12.mtb	5302	3756	WWFF	food_fat	4	128359	1337120532	1	0.0999999999999996	0.00624999999999998	10555	1
4	Drink 2	Intake 2	22	131265	1337123438	/users/cn/jespinosa/phecomp/data/CRG/20120502_FDF_CRG/20120502_FDF_CRG/20120514_FDF_CRG_c12.mtb	1616	NA	WWFF	water	2	131243	1337123416	1	0.0599999999999999	0.00272727272727272	10556	1
4	Food 2	Intake 4	36	132167	1337124340	/users/cn/jespinosa/phecomp/data/CRG/20120502_FDF_CRG/20120502_FDF_CRG/20120514_FDF_CRG_c12.mtb	5330	1812	WWFF	food_fat	4	132131	1337124304	1	0.0399999999999991	0.00111111111111109	10557	1
4	Drink 2	Intake 2	19	132829	1337125002	/users/cn/jespinosa/phecomp/data/CRG/20120502_FDF_CRG/20120502_FDF_CRG/20120514_FDF_CRG_c12.mtb	1617	NA	WWFF	water	2	132810	1337124983	1	0.04	0.00210526315789474	10558	1
4	Drink 2	Intake 2	20	133507	1337125680	/users/cn/jespinosa/phecomp/data/CRG/20120502_FDF_CRG/20120502_FDF_CRG/20120514_FDF_CRG_c12.mtb	1618	NA	WWFF	water	2	133487	1337125660	1	0.0399999999999999	0.00199999999999999	10559	1
4	Food 2	Intake 4	12	133991	1337126164	/users/cn/jespinosa/phecomp/data/CRG/20120502_FDF_CRG/20120502_FDF_CRG/20120514_FDF_CRG_c12.mtb	5336	126	WWFF	food_fat	4	133979	1337126152	1	0.0200000000000014	0.00166666666666678	10560	1
4	Food 2	Intake 4	21	134138	1337126311	/users/cn/jespinosa/phecomp/data/CRG/20120502_FDF_CRG/20120502_FDF_CRG/20120514_FDF_CRG_c12.mtb	5339	3010	WWFF	food_fat	4	134117	1337126290	1	0.0400000000000009	0.00190476190476195	10561	1
4	Food 2	Intake 4	420	137568	1337129741	/users/cn/jespinosa/phecomp/data/CRG/20120502_FDF_CRG/20120502_FDF_CRG/20120514_FDF_CRG_c12.mtb	5361	COLL	WWFF	food_fat	4	137148	1337129321	1	0.0600000000000005	0.000142857142857144	10562	1
4	Food 1	Intake 3	25	137246	1337129419	/users/cn/jespinosa/phecomp/data/CRG/20120502_FDF_CRG/20120502_FDF_CRG/20120514_FDF_CRG_c12.mtb	4421	841	WWFF	food_fat	3	137221	1337129394	1	0.0200000000000005	0.00080000000000002	10563	1
4	Drink 2	Intake 2	20	138023	1337130196	/users/cn/jespinosa/phecomp/data/CRG/20120502_FDF_CRG/20120502_FDF_CRG/20120514_FDF_CRG_c12.mtb	1620	NA	WWFF	water	2	138003	1337130176	1	0.02	0.001	10564	1
4	Drink 1	Intake 1	14	138025	1337130198	/users/cn/jespinosa/phecomp/data/CRG/20120502_FDF_CRG/20120502_FDF_CRG/20120514_FDF_CRG_c12.mtb	1737	NA	WWFF	water	1	138011	1337130184	1	0.0800000000000001	0.00571428571428572	10565	1
4	Food 2	Intake 4	14	138101	1337130274	/users/cn/jespinosa/phecomp/data/CRG/20120502_FDF_CRG/20120502_FDF_CRG/20120514_FDF_CRG_c12.mtb	5365	270	WWFF	food_fat	4	138087	1337130260	1	0.0800000000000001	0.00571428571428572	10566	1
4	Drink 1	Intake 1	36	138350	1337130523	/users/cn/jespinosa/phecomp/data/CRG/20120502_FDF_CRG/20120502_FDF_CRG/20120514_FDF_CRG_c12.mtb	1738	NA	WWFF	water	1	138314	1337130487	1	0.04	0.00111111111111111	10567	1
4	Food 1	Intake 3	94	138465	1337130638	/users/cn/jespinosa/phecomp/data/CRG/20120502_FDF_CRG/20120502_FDF_CRG/20120514_FDF_CRG_c12.mtb	4425	253	WWFF	food_fat	3	138371	1337130544	1	0.0599999999999996	0.000638297872340421	10568	1
4	Food 2	Intake 4	24	138742	1337130915	/users/cn/jespinosa/phecomp/data/CRG/20120502_FDF_CRG/20120502_FDF_CRG/20120514_FDF_CRG_c12.mtb	5368	414	WWFF	food_fat	4	138718	1337130891	1	0.199999999999999	0.00833333333333329	10569	1
4	Drink 2	Intake 2	41	138774	1337130947	/users/cn/jespinosa/phecomp/data/CRG/20120502_FDF_CRG/20120502_FDF_CRG/20120514_FDF_CRG_c12.mtb	1621	NA	WWFF	water	2	138733	1337130906	1	0.12	0.00292682926829268	10570	1
4	Food 1	Intake 3	43	139199	1337131372	/users/cn/jespinosa/phecomp/data/CRG/20120502_FDF_CRG/20120502_FDF_CRG/20120514_FDF_CRG_c12.mtb	4427	36	WWFF	food_fat	3	139156	1337131329	1	0.0200000000000005	0.000465116279069779	10571	1
4	Food 2	Intake 4	160	139395	1337131568	/users/cn/jespinosa/phecomp/data/CRG/20120502_FDF_CRG/20120502_FDF_CRG/20120514_FDF_CRG_c12.mtb	5371	1003	WWFF	food_fat	4	139235	1337131408	1	0.119999999999999	0.000749999999999994	10572	1
4	Drink 2	Intake 2	20	139380	1337131553	/users/cn/jespinosa/phecomp/data/CRG/20120502_FDF_CRG/20120502_FDF_CRG/20120514_FDF_CRG_c12.mtb	1622	NA	WWFF	water	2	139360	1337131533	1	0.04	0.002	10573	1
4	Food 2	Intake 4	12	140410	1337132583	/users/cn/jespinosa/phecomp/data/CRG/20120502_FDF_CRG/20120502_FDF_CRG/20120514_FDF_CRG_c12.mtb	5377	834	WWFF	food_fat	4	140398	1337132571	1	0.0400000000000009	0.00333333333333341	10574	1
4	Food 2	Intake 4	55	141299	1337133472	/users/cn/jespinosa/phecomp/data/CRG/20120502_FDF_CRG/20120502_FDF_CRG/20120514_FDF_CRG_c12.mtb	5386	583	WWFF	food_fat	4	141244	1337133417	1	0.0200000000000014	0.000363636363636389	10575	1
4	Food 2	Intake 4	32	141914	1337134087	/users/cn/jespinosa/phecomp/data/CRG/20120502_FDF_CRG/20120502_FDF_CRG/20120514_FDF_CRG_c12.mtb	5390	1248	WWFF	food_fat	4	141882	1337134055	1	0.0399999999999991	0.00124999999999997	10576	1
4	Food 2	Intake 4	52	143214	1337135387	/users/cn/jespinosa/phecomp/data/CRG/20120502_FDF_CRG/20120502_FDF_CRG/20120514_FDF_CRG_c12.mtb	5397	188	WWFF	food_fat	4	143162	1337135335	1	0.0399999999999991	0.000769230769230752	10577	1
4	Drink 1	Intake 1	22	143408	1337135581	/users/cn/jespinosa/phecomp/data/CRG/20120502_FDF_CRG/20120502_FDF_CRG/20120514_FDF_CRG_c12.mtb	1739	NA	WWFF	water	1	143386	1337135559	1	0.0800000000000001	0.00363636363636364	10578	1
4	Food 2	Intake 4	15	143417	1337135590	/users/cn/jespinosa/phecomp/data/CRG/20120502_FDF_CRG/20120502_FDF_CRG/20120514_FDF_CRG_c12.mtb	5399	1736	WWFF	food_fat	4	143402	1337135575	1	0.0600000000000005	0.00400000000000003	10579	1
4	Food 2	Intake 4	182	145335	1337137508	/users/cn/jespinosa/phecomp/data/CRG/20120502_FDF_CRG/20120502_FDF_CRG/20120514_FDF_CRG_c12.mtb	5415	38	WWFF	food_fat	4	145153	1337137326	1	0.0599999999999987	0.000329670329670323	10580	1
4	Food 2	Intake 4	136	145509	1337137682	/users/cn/jespinosa/phecomp/data/CRG/20120502_FDF_CRG/20120502_FDF_CRG/20120514_FDF_CRG_c12.mtb	5416	420	WWFF	food_fat	4	145373	1337137546	1	0.16	0.00117647058823529	10581	1
4	Food 2	Intake 4	345	146274	1337138447	/users/cn/jespinosa/phecomp/data/CRG/20120502_FDF_CRG/20120502_FDF_CRG/20120514_FDF_CRG_c12.mtb	5422	170	WWFF	food_fat	4	145929	1337138102	1	0.0399999999999991	0.000115942028985505	10582	1
4	Food 2	Intake 4	189	146633	1337138806	/users/cn/jespinosa/phecomp/data/CRG/20120502_FDF_CRG/20120502_FDF_CRG/20120514_FDF_CRG_c12.mtb	5425	120	WWFF	food_fat	4	146444	1337138617	1	0.119999999999999	0.00063492063492063	10583	1
4	Food 2	Intake 4	65	146818	1337138991	/users/cn/jespinosa/phecomp/data/CRG/20120502_FDF_CRG/20120502_FDF_CRG/20120514_FDF_CRG_c12.mtb	5427	144	WWFF	food_fat	4	146753	1337138926	1	0.0400000000000009	0.000615384615384629	10584	1
4	Food 2	Intake 4	13	146975	1337139148	/users/cn/jespinosa/phecomp/data/CRG/20120502_FDF_CRG/20120502_FDF_CRG/20120514_FDF_CRG_c12.mtb	5430	996	WWFF	food_fat	4	146962	1337139135	1	0.0400000000000009	0.00307692307692315	10585	1
4	Food 2	Intake 4	65	148036	1337140209	/users/cn/jespinosa/phecomp/data/CRG/20120502_FDF_CRG/20120502_FDF_CRG/20120514_FDF_CRG_c12.mtb	5436	466	WWFF	food_fat	4	147971	1337140144	1	0.0800000000000001	0.00123076923076923	10586	1
4	Food 2	Intake 4	12	148514	1337140687	/users/cn/jespinosa/phecomp/data/CRG/20120502_FDF_CRG/20120502_FDF_CRG/20120514_FDF_CRG_c12.mtb	5441	158	WWFF	food_fat	4	148502	1337140675	1	0.0600000000000005	0.00500000000000004	10587	1
4	Food 2	Intake 4	14	148686	1337140859	/users/cn/jespinosa/phecomp/data/CRG/20120502_FDF_CRG/20120502_FDF_CRG/20120514_FDF_CRG_c12.mtb	5443	896	WWFF	food_fat	4	148672	1337140845	1	0.0400000000000009	0.00285714285714292	10588	1
4	Food 2	Intake 4	84	149666	1337141839	/users/cn/jespinosa/phecomp/data/CRG/20120502_FDF_CRG/20120502_FDF_CRG/20120514_FDF_CRG_c12.mtb	5452	69	WWFF	food_fat	4	149582	1337141755	1	0.299999999999999	0.00357142857142856	10589	1
4	Food 2	Intake 4	18	149753	1337141926	/users/cn/jespinosa/phecomp/data/CRG/20120502_FDF_CRG/20120502_FDF_CRG/20120514_FDF_CRG_c12.mtb	5453	796	WWFF	food_fat	4	149735	1337141908	1	0.0600000000000005	0.00333333333333336	10590	1
4	Drink 2	Intake 2	18	150352	1337142525	/users/cn/jespinosa/phecomp/data/CRG/20120502_FDF_CRG/20120502_FDF_CRG/20120514_FDF_CRG_c12.mtb	1623	NA	WWFF	water	2	150334	1337142507	1	0.04	0.00222222222222222	10591	1
4	Food 2	Intake 4	36	150585	1337142758	/users/cn/jespinosa/phecomp/data/CRG/20120502_FDF_CRG/20120502_FDF_CRG/20120514_FDF_CRG_c12.mtb	5459	1395	WWFF	food_fat	4	150549	1337142722	1	0.0400000000000009	0.00111111111111114	10592	1
4	Food 2	Intake 4	251	152231	1337144404	/users/cn/jespinosa/phecomp/data/CRG/20120502_FDF_CRG/20120502_FDF_CRG/20120514_FDF_CRG_c12.mtb	5465	21	WWFF	food_fat	4	151980	1337144153	1	0.0600000000000005	0.000239043824701197	10593	1
4	Food 2	Intake 4	36	152288	1337144461	/users/cn/jespinosa/phecomp/data/CRG/20120502_FDF_CRG/20120502_FDF_CRG/20120514_FDF_CRG_c12.mtb	5466	33	WWFF	food_fat	4	152252	1337144425	1	0.0400000000000009	0.00111111111111114	10594	1
4	Food 2	Intake 4	55	152376	1337144549	/users/cn/jespinosa/phecomp/data/CRG/20120502_FDF_CRG/20120502_FDF_CRG/20120514_FDF_CRG_c12.mtb	5468	508	WWFF	food_fat	4	152321	1337144494	1	0.199999999999999	0.00363636363636362	10595	1
4	Drink 2	Intake 2	24	152400	1337144573	/users/cn/jespinosa/phecomp/data/CRG/20120502_FDF_CRG/20120502_FDF_CRG/20120514_FDF_CRG_c12.mtb	1624	NA	WWFF	water	2	152376	1337144549	1	0.0800000000000001	0.00333333333333334	10596	1
4	Drink 2	Intake 2	21	152713	1337144886	/users/cn/jespinosa/phecomp/data/CRG/20120502_FDF_CRG/20120502_FDF_CRG/20120514_FDF_CRG_c12.mtb	1625	NA	WWFF	water	2	152692	1337144865	1	0.0999999999999999	0.00476190476190476	10597	1
4	Food 2	Intake 4	271	153155	1337145328	/users/cn/jespinosa/phecomp/data/CRG/20120502_FDF_CRG/20120502_FDF_CRG/20120514_FDF_CRG_c12.mtb	5472	6	WWFF	food_fat	4	152884	1337145057	1	0.139999999999999	0.000516605166051657	10598	1
4	Food 2	Intake 4	36	153197	1337145370	/users/cn/jespinosa/phecomp/data/CRG/20120502_FDF_CRG/20120502_FDF_CRG/20120514_FDF_CRG_c12.mtb	5473	706	WWFF	food_fat	4	153161	1337145334	1	0.0800000000000001	0.00222222222222222	10599	1
4	Drink 2	Intake 2	32	153252	1337145425	/users/cn/jespinosa/phecomp/data/CRG/20120502_FDF_CRG/20120502_FDF_CRG/20120514_FDF_CRG_c12.mtb	1626	NA	WWFF	water	2	153220	1337145393	1	0.04	0.00125	10600	1
4	Drink 1	Intake 1	28	153373	1337145546	/users/cn/jespinosa/phecomp/data/CRG/20120502_FDF_CRG/20120502_FDF_CRG/20120514_FDF_CRG_c12.mtb	1741	NA	WWFF	water	1	153345	1337145518	1	0.0600000000000001	0.00214285714285715	10601	1
4	Food 2	Intake 4	52	153955	1337146128	/users/cn/jespinosa/phecomp/data/CRG/20120502_FDF_CRG/20120502_FDF_CRG/20120514_FDF_CRG_c12.mtb	5481	2877	WWFF	food_fat	4	153903	1337146076	1	0.0200000000000014	0.000384615384615412	10602	1
4	Drink 1	Intake 1	23	156714	1337148887	/users/cn/jespinosa/phecomp/data/CRG/20120502_FDF_CRG/20120502_FDF_CRG/20120514_FDF_CRG_c12.mtb	1742	NA	WWFF	water	1	156691	1337148864	1	0.0600000000000001	0.00260869565217392	10603	1
4	Food 2	Intake 4	147	156979	1337149152	/users/cn/jespinosa/phecomp/data/CRG/20120502_FDF_CRG/20120502_FDF_CRG/20120514_FDF_CRG_c12.mtb	5489	875	WWFF	food_fat	4	156832	1337149005	1	0.279999999999999	0.0019047619047619	10604	1
4	Food 2	Intake 4	21	157875	1337150048	/users/cn/jespinosa/phecomp/data/CRG/20120502_FDF_CRG/20120502_FDF_CRG/20120514_FDF_CRG_c12.mtb	5493	1609	WWFF	food_fat	4	157854	1337150027	1	0.0400000000000009	0.00190476190476195	10605	1
4	Food 2	Intake 4	21	159505	1337151678	/users/cn/jespinosa/phecomp/data/CRG/20120502_FDF_CRG/20120502_FDF_CRG/20120514_FDF_CRG_c12.mtb	5495	1395	WWFF	food_fat	4	159484	1337151657	1	0.0399999999999991	0.00190476190476186	10606	1
4	Food 2	Intake 4	18	160918	1337153091	/users/cn/jespinosa/phecomp/data/CRG/20120502_FDF_CRG/20120502_FDF_CRG/20120514_FDF_CRG_c12.mtb	5497	985	WWFF	food_fat	4	160900	1337153073	1	0.0200000000000014	0.00111111111111119	10607	1
4	Food 2	Intake 4	28	161931	1337154104	/users/cn/jespinosa/phecomp/data/CRG/20120502_FDF_CRG/20120502_FDF_CRG/20120514_FDF_CRG_c12.mtb	5502	211	WWFF	food_fat	4	161903	1337154076	1	0.0200000000000014	0.000714285714285764	10608	1
4	Food 2	Intake 4	127	162269	1337154442	/users/cn/jespinosa/phecomp/data/CRG/20120502_FDF_CRG/20120502_FDF_CRG/20120514_FDF_CRG_c12.mtb	5505	9235	WWFF	food_fat	4	162142	1337154315	1	0.18	0.00141732283464567	10609	1
4	Drink 1	Intake 1	36	163303	1337155476	/users/cn/jespinosa/phecomp/data/CRG/20120502_FDF_CRG/20120502_FDF_CRG/20120514_FDF_CRG_c12.mtb	1743	NA	WWFF	water	1	163267	1337155440	1	0.16	0.00444444444444444	10610	1
4	Food 1	Intake 3	33	431	1337163710	/users/cn/jespinosa/phecomp/data/CRG/20120502_FDF_CRG/20120502_FDF_CRG/20120516_FDF_CRG_c12.mtb	4695	353	WWFF	food_fat	3	398	1337163677	1	0.02	0.000606060606060606	10611	1
4	Food 1	Intake 3	22	806	1337164085	/users/cn/jespinosa/phecomp/data/CRG/20120502_FDF_CRG/20120502_FDF_CRG/20120516_FDF_CRG_c12.mtb	4696	7	WWFF	food_fat	3	784	1337164063	1	0.02	0.000909090909090909	10612	1
4	Food 1	Intake 3	15	828	1337164107	/users/cn/jespinosa/phecomp/data/CRG/20120502_FDF_CRG/20120502_FDF_CRG/20120516_FDF_CRG_c12.mtb	4697	10307	WWFF	food_fat	3	813	1337164092	1	0.04	0.00266666666666667	10613	1
4	Drink 1	Intake 1	17	2767	1337166046	/users/cn/jespinosa/phecomp/data/CRG/20120502_FDF_CRG/20120502_FDF_CRG/20120516_FDF_CRG_c12.mtb	1838	NA	WWFF	water	1	2750	1337166029	1	0.02	0.00117647058823529	10614	1
4	Drink 1	Intake 1	15	5408	1337168687	/users/cn/jespinosa/phecomp/data/CRG/20120502_FDF_CRG/20120502_FDF_CRG/20120516_FDF_CRG_c12.mtb	1839	NA	WWFF	water	1	5393	1337168672	1	0.04	0.00266666666666667	10615	1
4	Food 1	Intake 3	23	11158	1337174437	/users/cn/jespinosa/phecomp/data/CRG/20120502_FDF_CRG/20120502_FDF_CRG/20120516_FDF_CRG_c12.mtb	4700	9	WWFF	food_fat	3	11135	1337174414	1	0.04	0.00173913043478261	10616	1
4	Food 1	Intake 3	22	11189	1337174468	/users/cn/jespinosa/phecomp/data/CRG/20120502_FDF_CRG/20120502_FDF_CRG/20120516_FDF_CRG_c12.mtb	4701	10	WWFF	food_fat	3	11167	1337174446	1	0.08	0.00363636363636364	10617	1
4	Food 1	Intake 3	22	11221	1337174500	/users/cn/jespinosa/phecomp/data/CRG/20120502_FDF_CRG/20120502_FDF_CRG/20120516_FDF_CRG_c12.mtb	4702	5599	WWFF	food_fat	3	11199	1337174478	1	0.02	0.000909090909090909	10618	1
4	Drink 1	Intake 1	23	14461	1337177740	/users/cn/jespinosa/phecomp/data/CRG/20120502_FDF_CRG/20120502_FDF_CRG/20120516_FDF_CRG_c12.mtb	1840	NA	WWFF	water	1	14438	1337177717	1	0.1	0.00434782608695652	10619	1
4	Food 2	Intake 4	23	16843	1337180122	/users/cn/jespinosa/phecomp/data/CRG/20120502_FDF_CRG/20120502_FDF_CRG/20120516_FDF_CRG_c12.mtb	5999	12	WWFF	food_fat	4	16820	1337180099	1	0.06	0.00260869565217391	10620	1
4	Food 1	Intake 3	65	16920	1337180199	/users/cn/jespinosa/phecomp/data/CRG/20120502_FDF_CRG/20120502_FDF_CRG/20120516_FDF_CRG_c12.mtb	4704	53	WWFF	food_fat	3	16855	1337180134	1	0.1	0.00153846153846154	10621	1
4	Food 1	Intake 3	78	17051	1337180330	/users/cn/jespinosa/phecomp/data/CRG/20120502_FDF_CRG/20120502_FDF_CRG/20120516_FDF_CRG_c12.mtb	4705	3	WWFF	food_fat	3	16973	1337180252	1	0.2	0.00256410256410256	10622	1
4	Food 2	Intake 4	52	17106	1337180385	/users/cn/jespinosa/phecomp/data/CRG/20120502_FDF_CRG/20120502_FDF_CRG/20120516_FDF_CRG_c12.mtb	6000	12	WWFF	food_fat	4	17054	1337180333	1	0.24	0.00461538461538461	10623	1
4	Food 2	Intake 4	29	17147	1337180426	/users/cn/jespinosa/phecomp/data/CRG/20120502_FDF_CRG/20120502_FDF_CRG/20120516_FDF_CRG_c12.mtb	6001	30	WWFF	food_fat	4	17118	1337180397	1	0.12	0.00413793103448276	10624	1
4	Food 2	Intake 4	28	17205	1337180484	/users/cn/jespinosa/phecomp/data/CRG/20120502_FDF_CRG/20120502_FDF_CRG/20120516_FDF_CRG_c12.mtb	6002	COLL	WWFF	food_fat	4	17177	1337180456	1	0.08	0.00285714285714286	10625	1
4	Food 1	Intake 3	37	17232	1337180511	/users/cn/jespinosa/phecomp/data/CRG/20120502_FDF_CRG/20120502_FDF_CRG/20120516_FDF_CRG_c12.mtb	4707	128	WWFF	food_fat	3	17195	1337180474	1	0.12	0.00324324324324324	10626	1
4	Drink 2	Intake 2	20	17370	1337180649	/users/cn/jespinosa/phecomp/data/CRG/20120502_FDF_CRG/20120502_FDF_CRG/20120516_FDF_CRG_c12.mtb	1718	NA	WWFF	water	2	17350	1337180629	1	0.02	0.001	10627	1
4	Food 1	Intake 3	80	17440	1337180719	/users/cn/jespinosa/phecomp/data/CRG/20120502_FDF_CRG/20120502_FDF_CRG/20120516_FDF_CRG_c12.mtb	4708	11061	WWFF	food_fat	3	17360	1337180639	1	0.1	0.00125	10628	1
4	Drink 1	Intake 1	26	17537	1337180816	/users/cn/jespinosa/phecomp/data/CRG/20120502_FDF_CRG/20120502_FDF_CRG/20120516_FDF_CRG_c12.mtb	1841	NA	WWFF	water	1	17511	1337180790	1	0.1	0.00384615384615385	10629	1
4	Drink 1	Intake 1	26	23029	1337186308	/users/cn/jespinosa/phecomp/data/CRG/20120502_FDF_CRG/20120502_FDF_CRG/20120516_FDF_CRG_c12.mtb	1842	NA	WWFF	water	1	23003	1337186282	1	0.1	0.00384615384615385	10630	1
4	Drink 1	Intake 1	31	25595	1337188874	/users/cn/jespinosa/phecomp/data/CRG/20120502_FDF_CRG/20120502_FDF_CRG/20120516_FDF_CRG_c12.mtb	1843	NA	WWFF	water	1	25564	1337188843	1	0.12	0.00387096774193548	10631	1
4	Food 1	Intake 3	18	28519	1337191798	/users/cn/jespinosa/phecomp/data/CRG/20120502_FDF_CRG/20120502_FDF_CRG/20120516_FDF_CRG_c12.mtb	4710	79	WWFF	food_fat	3	28501	1337191780	1	0.02	0.00111111111111111	10632	1
4	Food 2	Intake 4	15	28613	1337191892	/users/cn/jespinosa/phecomp/data/CRG/20120502_FDF_CRG/20120502_FDF_CRG/20120516_FDF_CRG_c12.mtb	6005	55	WWFF	food_fat	4	28598	1337191877	1	0.04	0.00266666666666667	10633	1
4	Food 1	Intake 3	78	28746	1337192025	/users/cn/jespinosa/phecomp/data/CRG/20120502_FDF_CRG/20120502_FDF_CRG/20120516_FDF_CRG_c12.mtb	4712	7	WWFF	food_fat	3	28668	1337191947	1	0.1	0.00128205128205128	10634	1
4	Food 1	Intake 3	30	28783	1337192062	/users/cn/jespinosa/phecomp/data/CRG/20120502_FDF_CRG/20120502_FDF_CRG/20120516_FDF_CRG_c12.mtb	4713	COLL	WWFF	food_fat	3	28753	1337192032	1	0.04	0.00133333333333333	10635	1
4	Food 2	Intake 4	48	28821	1337192100	/users/cn/jespinosa/phecomp/data/CRG/20120502_FDF_CRG/20120502_FDF_CRG/20120516_FDF_CRG_c12.mtb	6006	651	WWFF	food_fat	4	28773	1337192052	1	0.28	0.00583333333333333	10636	1
4	Food 1	Intake 3	109	29581	1337192860	/users/cn/jespinosa/phecomp/data/CRG/20120502_FDF_CRG/20120502_FDF_CRG/20120516_FDF_CRG_c12.mtb	4714	9	WWFF	food_fat	3	29472	1337192751	1	0.08	0.00073394495412844	10637	1
4	Food 1	Intake 3	21	29611	1337192890	/users/cn/jespinosa/phecomp/data/CRG/20120502_FDF_CRG/20120502_FDF_CRG/20120516_FDF_CRG_c12.mtb	4715	152	WWFF	food_fat	3	29590	1337192869	1	0.02	0.000952380952380952	10638	1
4	Food 2	Intake 4	16	29779	1337193058	/users/cn/jespinosa/phecomp/data/CRG/20120502_FDF_CRG/20120502_FDF_CRG/20120516_FDF_CRG_c12.mtb	6007	COLL	WWFF	food_fat	4	29763	1337193042	1	0.02	0.00125	10639	1
4	Food 1	Intake 3	130	29898	1337193177	/users/cn/jespinosa/phecomp/data/CRG/20120502_FDF_CRG/20120502_FDF_CRG/20120516_FDF_CRG_c12.mtb	4717	84	WWFF	food_fat	3	29768	1337193047	1	0.6	0.00461538461538461	10640	1
4	Food 1	Intake 3	19	30001	1337193280	/users/cn/jespinosa/phecomp/data/CRG/20120502_FDF_CRG/20120502_FDF_CRG/20120516_FDF_CRG_c12.mtb	4718	COLL	WWFF	food_fat	3	29982	1337193261	1	0.02	0.00105263157894737	10641	1
4	Food 2	Intake 4	97	30089	1337193368	/users/cn/jespinosa/phecomp/data/CRG/20120502_FDF_CRG/20120502_FDF_CRG/20120516_FDF_CRG_c12.mtb	6008	COLL	WWFF	food_fat	4	29992	1337193271	1	1.12	0.0115463917525773	10642	1
4	Food 1	Intake 3	60	30139	1337193418	/users/cn/jespinosa/phecomp/data/CRG/20120502_FDF_CRG/20120502_FDF_CRG/20120516_FDF_CRG_c12.mtb	4719	56	WWFF	food_fat	3	30079	1337193358	1	0.42	0.007	10643	1
4	Drink 2	Intake 2	20	30193	1337193472	/users/cn/jespinosa/phecomp/data/CRG/20120502_FDF_CRG/20120502_FDF_CRG/20120516_FDF_CRG_c12.mtb	1719	NA	WWFF	water	2	30173	1337193452	1	0.04	0.002	10644	1
4	Food 2	Intake 4	60	30255	1337193534	/users/cn/jespinosa/phecomp/data/CRG/20120502_FDF_CRG/20120502_FDF_CRG/20120516_FDF_CRG_c12.mtb	6009	2	WWFF	food_fat	4	30195	1337193474	1	0.38	0.00633333333333333	10645	1
4	Food 1	Intake 3	101	30358	1337193637	/users/cn/jespinosa/phecomp/data/CRG/20120502_FDF_CRG/20120502_FDF_CRG/20120516_FDF_CRG_c12.mtb	4720	240	WWFF	food_fat	3	30257	1337193536	1	0.1	0.00099009900990099	10646	1
4	Food 1	Intake 3	69	30667	1337193946	/users/cn/jespinosa/phecomp/data/CRG/20120502_FDF_CRG/20120502_FDF_CRG/20120516_FDF_CRG_c12.mtb	4721	14	WWFF	food_fat	3	30598	1337193877	1	0.2	0.00289855072463768	10647	1
4	Food 2	Intake 4	66	30747	1337194026	/users/cn/jespinosa/phecomp/data/CRG/20120502_FDF_CRG/20120502_FDF_CRG/20120516_FDF_CRG_c12.mtb	6011	135	WWFF	food_fat	4	30681	1337193960	1	0.28	0.00424242424242424	10648	1
4	Food 1	Intake 3	90	30972	1337194251	/users/cn/jespinosa/phecomp/data/CRG/20120502_FDF_CRG/20120502_FDF_CRG/20120516_FDF_CRG_c12.mtb	4722	144	WWFF	food_fat	3	30882	1337194161	1	0.14	0.00155555555555556	10649	1
4	Food 1	Intake 3	205	31321	1337194600	/users/cn/jespinosa/phecomp/data/CRG/20120502_FDF_CRG/20120502_FDF_CRG/20120516_FDF_CRG_c12.mtb	4723	138	WWFF	food_fat	3	31116	1337194395	1	1.3	0.00634146341463415	10650	1
4	Food 2	Intake 4	51	31510	1337194789	/users/cn/jespinosa/phecomp/data/CRG/20120502_FDF_CRG/20120502_FDF_CRG/20120516_FDF_CRG_c12.mtb	6012	COLL	WWFF	food_fat	4	31459	1337194738	1	0.0600000000000001	0.0011764705882353	10651	1
4	Food 1	Intake 3	31	31529	1337194808	/users/cn/jespinosa/phecomp/data/CRG/20120502_FDF_CRG/20120502_FDF_CRG/20120516_FDF_CRG_c12.mtb	4724	32	WWFF	food_fat	3	31498	1337194777	1	0.18	0.00580645161290323	10652	1
4	Drink 2	Intake 2	31	31551	1337194830	/users/cn/jespinosa/phecomp/data/CRG/20120502_FDF_CRG/20120502_FDF_CRG/20120516_FDF_CRG_c12.mtb	1721	NA	WWFF	water	2	31520	1337194799	1	0.04	0.00129032258064516	10653	1
4	Food 1	Intake 3	121	31682	1337194961	/users/cn/jespinosa/phecomp/data/CRG/20120502_FDF_CRG/20120502_FDF_CRG/20120516_FDF_CRG_c12.mtb	4725	17	WWFF	food_fat	3	31561	1337194840	1	0.32	0.00264462809917355	10654	1
4	Food 2	Intake 4	61	31760	1337195039	/users/cn/jespinosa/phecomp/data/CRG/20120502_FDF_CRG/20120502_FDF_CRG/20120516_FDF_CRG_c12.mtb	6013	COLL	WWFF	food_fat	4	31699	1337194978	1	0.14	0.00229508196721312	10655	1
4	Food 1	Intake 3	36	31785	1337195064	/users/cn/jespinosa/phecomp/data/CRG/20120502_FDF_CRG/20120502_FDF_CRG/20120516_FDF_CRG_c12.mtb	4727	81	WWFF	food_fat	3	31749	1337195028	1	0.28	0.00777777777777778	10656	1
4	Food 2	Intake 4	57	31923	1337195202	/users/cn/jespinosa/phecomp/data/CRG/20120502_FDF_CRG/20120502_FDF_CRG/20120516_FDF_CRG_c12.mtb	6014	169	WWFF	food_fat	4	31866	1337195145	1	0.12	0.00210526315789474	10657	1
4	Drink 1	Intake 1	35	31948	1337195227	/users/cn/jespinosa/phecomp/data/CRG/20120502_FDF_CRG/20120502_FDF_CRG/20120516_FDF_CRG_c12.mtb	1846	NA	WWFF	water	1	31913	1337195192	1	0.0800000000000001	0.00228571428571429	10658	1
4	Food 2	Intake 4	63	32155	1337195434	/users/cn/jespinosa/phecomp/data/CRG/20120502_FDF_CRG/20120502_FDF_CRG/20120516_FDF_CRG_c12.mtb	6016	COLL	WWFF	food_fat	4	32092	1337195371	1	0.04	0.000634920634920635	10659	1
4	Food 1	Intake 3	60	32206	1337195485	/users/cn/jespinosa/phecomp/data/CRG/20120502_FDF_CRG/20120502_FDF_CRG/20120516_FDF_CRG_c12.mtb	4729	892	WWFF	food_fat	3	32146	1337195425	1	0.04	0.000666666666666667	10660	1
4	Food 1	Intake 3	218	33316	1337196595	/users/cn/jespinosa/phecomp/data/CRG/20120502_FDF_CRG/20120502_FDF_CRG/20120516_FDF_CRG_c12.mtb	4732	82	WWFF	food_fat	3	33098	1337196377	1	0.24	0.00110091743119266	10661	1
4	Food 1	Intake 3	102	33500	1337196779	/users/cn/jespinosa/phecomp/data/CRG/20120502_FDF_CRG/20120502_FDF_CRG/20120516_FDF_CRG_c12.mtb	4733	33	WWFF	food_fat	3	33398	1337196677	1	0.899999999999999	0.0088235294117647	10662	1
4	Food 1	Intake 3	152	33685	1337196964	/users/cn/jespinosa/phecomp/data/CRG/20120502_FDF_CRG/20120502_FDF_CRG/20120516_FDF_CRG_c12.mtb	4734	49	WWFF	food_fat	3	33533	1337196812	1	0.04	0.000263157894736842	10663	1
4	Food 1	Intake 3	147	33881	1337197160	/users/cn/jespinosa/phecomp/data/CRG/20120502_FDF_CRG/20120502_FDF_CRG/20120516_FDF_CRG_c12.mtb	4737	195	WWFF	food_fat	3	33734	1337197013	1	0.04	0.000272108843537415	10664	1
4	Food 1	Intake 3	135	34211	1337197490	/users/cn/jespinosa/phecomp/data/CRG/20120502_FDF_CRG/20120502_FDF_CRG/20120516_FDF_CRG_c12.mtb	4739	1	WWFF	food_fat	3	34076	1337197355	1	0.12	0.000888888888888889	10665	1
4	Food 2	Intake 4	17	34229	1337197508	/users/cn/jespinosa/phecomp/data/CRG/20120502_FDF_CRG/20120502_FDF_CRG/20120516_FDF_CRG_c12.mtb	6019	2	WWFF	food_fat	4	34212	1337197491	1	0.02	0.00117647058823529	10666	1
4	Food 1	Intake 3	33	34264	1337197543	/users/cn/jespinosa/phecomp/data/CRG/20120502_FDF_CRG/20120502_FDF_CRG/20120516_FDF_CRG_c12.mtb	4740	20	WWFF	food_fat	3	34231	1337197510	1	0.16	0.00484848484848485	10667	1
4	Food 1	Intake 3	107	34391	1337197670	/users/cn/jespinosa/phecomp/data/CRG/20120502_FDF_CRG/20120502_FDF_CRG/20120516_FDF_CRG_c12.mtb	4741	9	WWFF	food_fat	3	34284	1337197563	1	0.0800000000000001	0.00074766355140187	10668	1
4	Drink 1	Intake 1	18	34408	1337197687	/users/cn/jespinosa/phecomp/data/CRG/20120502_FDF_CRG/20120502_FDF_CRG/20120516_FDF_CRG_c12.mtb	1848	NA	WWFF	water	1	34390	1337197669	1	0.0399999999999999	0.00222222222222222	10669	1
4	Food 1	Intake 3	229	34629	1337197908	/users/cn/jespinosa/phecomp/data/CRG/20120502_FDF_CRG/20120502_FDF_CRG/20120516_FDF_CRG_c12.mtb	4742	589	WWFF	food_fat	3	34400	1337197679	1	0.76	0.00331877729257642	10670	1
4	Food 1	Intake 3	136	35354	1337198633	/users/cn/jespinosa/phecomp/data/CRG/20120502_FDF_CRG/20120502_FDF_CRG/20120516_FDF_CRG_c12.mtb	4745	COLL	WWFF	food_fat	3	35218	1337198497	1	1.02	0.0075	10671	1
4	Food 2	Intake 4	25	35375	1337198654	/users/cn/jespinosa/phecomp/data/CRG/20120502_FDF_CRG/20120502_FDF_CRG/20120516_FDF_CRG_c12.mtb	6021	COLL	WWFF	food_fat	4	35350	1337198629	1	0.02	0.0008	10672	1
4	Food 1	Intake 3	37	35402	1337198681	/users/cn/jespinosa/phecomp/data/CRG/20120502_FDF_CRG/20120502_FDF_CRG/20120516_FDF_CRG_c12.mtb	4746	236	WWFF	food_fat	3	35365	1337198644	1	0.359999999999999	0.0097297297297297	10673	1
4	Food 1	Intake 3	48	35686	1337198965	/users/cn/jespinosa/phecomp/data/CRG/20120502_FDF_CRG/20120502_FDF_CRG/20120516_FDF_CRG_c12.mtb	4748	799	WWFF	food_fat	3	35638	1337198917	1	0.120000000000001	0.00250000000000002	10674	1
4	Food 2	Intake 4	37	36522	1337199801	/users/cn/jespinosa/phecomp/data/CRG/20120502_FDF_CRG/20120502_FDF_CRG/20120516_FDF_CRG_c12.mtb	6024	367	WWFF	food_fat	4	36485	1337199764	1	0.02	0.000540540540540541	10675	1
4	Drink 2	Intake 2	20	36713	1337199992	/users/cn/jespinosa/phecomp/data/CRG/20120502_FDF_CRG/20120502_FDF_CRG/20120516_FDF_CRG_c12.mtb	1727	NA	WWFF	water	2	36693	1337199972	1	0.04	0.002	10676	1
4	Food 2	Intake 4	16	36905	1337200184	/users/cn/jespinosa/phecomp/data/CRG/20120502_FDF_CRG/20120502_FDF_CRG/20120516_FDF_CRG_c12.mtb	6025	7814	WWFF	food_fat	4	36889	1337200168	1	0.02	0.00125	10677	1
4	Drink 1	Intake 1	9	36975	1337200254	/users/cn/jespinosa/phecomp/data/CRG/20120502_FDF_CRG/20120502_FDF_CRG/20120516_FDF_CRG_c12.mtb	1850	NA	WWFF	water	1	36966	1337200245	1	0.02	0.00222222222222222	10678	1
4	Drink 1	Intake 1	17	37668	1337200947	/users/cn/jespinosa/phecomp/data/CRG/20120502_FDF_CRG/20120502_FDF_CRG/20120516_FDF_CRG_c12.mtb	1851	NA	WWFF	water	1	37651	1337200930	1	0.0600000000000001	0.00352941176470589	10679	1
4	Drink 2	Intake 2	28	39827	1337203106	/users/cn/jespinosa/phecomp/data/CRG/20120502_FDF_CRG/20120502_FDF_CRG/20120516_FDF_CRG_c12.mtb	1730	NA	WWFF	water	2	39799	1337203078	1	0.02	0.000714285714285714	10680	1
4	Drink 1	Intake 1	17	42417	1337205696	/users/cn/jespinosa/phecomp/data/CRG/20120502_FDF_CRG/20120502_FDF_CRG/20120516_FDF_CRG_c12.mtb	1852	NA	WWFF	water	1	42400	1337205679	1	0.0399999999999999	0.00235294117647058	10681	1
4	Drink 1	Intake 1	20	43345	1337206624	/users/cn/jespinosa/phecomp/data/CRG/20120502_FDF_CRG/20120502_FDF_CRG/20120516_FDF_CRG_c12.mtb	1853	NA	WWFF	water	1	43325	1337206604	1	0.04	0.002	10682	1
4	Food 2	Intake 4	11	44730	1337208009	/users/cn/jespinosa/phecomp/data/CRG/20120502_FDF_CRG/20120502_FDF_CRG/20120516_FDF_CRG_c12.mtb	6027	6644	WWFF	food_fat	4	44719	1337207998	1	0.02	0.00181818181818182	10683	1
4	Drink 1	Intake 1	23	45837	1337209116	/users/cn/jespinosa/phecomp/data/CRG/20120502_FDF_CRG/20120502_FDF_CRG/20120516_FDF_CRG_c12.mtb	1854	NA	WWFF	water	1	45814	1337209093	1	0.1	0.00434782608695652	10684	1
4	Drink 1	Intake 1	17	47586	1337210865	/users/cn/jespinosa/phecomp/data/CRG/20120502_FDF_CRG/20120502_FDF_CRG/20120516_FDF_CRG_c12.mtb	1855	NA	WWFF	water	1	47569	1337210848	1	0.0600000000000001	0.00352941176470589	10685	1
4	Drink 1	Intake 1	21	47959	1337211238	/users/cn/jespinosa/phecomp/data/CRG/20120502_FDF_CRG/20120502_FDF_CRG/20120516_FDF_CRG_c12.mtb	1856	NA	WWFF	water	1	47938	1337211217	1	0.0599999999999999	0.00285714285714285	10686	1
4	Drink 1	Intake 1	19	49330	1337212609	/users/cn/jespinosa/phecomp/data/CRG/20120502_FDF_CRG/20120502_FDF_CRG/20120516_FDF_CRG_c12.mtb	1857	NA	WWFF	water	1	49311	1337212590	1	0.0800000000000001	0.00421052631578948	10687	1
4	Drink 1	Intake 1	14	50089	1337213368	/users/cn/jespinosa/phecomp/data/CRG/20120502_FDF_CRG/20120502_FDF_CRG/20120516_FDF_CRG_c12.mtb	1858	NA	WWFF	water	1	50075	1337213354	1	0.02	0.00142857142857143	10688	1
4	Food 2	Intake 4	42	51416	1337214695	/users/cn/jespinosa/phecomp/data/CRG/20120502_FDF_CRG/20120502_FDF_CRG/20120516_FDF_CRG_c12.mtb	6028	155	WWFF	food_fat	4	51374	1337214653	1	0.04	0.000952380952380952	10689	1
4	Food 1	Intake 3	57	51628	1337214907	/users/cn/jespinosa/phecomp/data/CRG/20120502_FDF_CRG/20120502_FDF_CRG/20120516_FDF_CRG_c12.mtb	4755	171	WWFF	food_fat	3	51571	1337214850	1	0.0400000000000009	0.000701754385964928	10690	1
4	Food 1	Intake 3	46	51845	1337215124	/users/cn/jespinosa/phecomp/data/CRG/20120502_FDF_CRG/20120502_FDF_CRG/20120516_FDF_CRG_c12.mtb	4756	494	WWFF	food_fat	3	51799	1337215078	1	0.0399999999999991	0.000869565217391285	10691	1
4	Drink 1	Intake 1	18	52217	1337215496	/users/cn/jespinosa/phecomp/data/CRG/20120502_FDF_CRG/20120502_FDF_CRG/20120516_FDF_CRG_c12.mtb	1860	NA	WWFF	water	1	52199	1337215478	1	0.0799999999999998	0.00444444444444443	10692	1
4	Food 2	Intake 4	97	52436	1337215715	/users/cn/jespinosa/phecomp/data/CRG/20120502_FDF_CRG/20120502_FDF_CRG/20120516_FDF_CRG_c12.mtb	6032	168	WWFF	food_fat	4	52339	1337215618	1	0.04	0.000412371134020619	10693	1
4	Food 1	Intake 3	122	52726	1337216005	/users/cn/jespinosa/phecomp/data/CRG/20120502_FDF_CRG/20120502_FDF_CRG/20120516_FDF_CRG_c12.mtb	4757	63	WWFF	food_fat	3	52604	1337215883	1	0.0800000000000001	0.000655737704918034	10694	1
4	Food 2	Intake 4	237	53026	1337216305	/users/cn/jespinosa/phecomp/data/CRG/20120502_FDF_CRG/20120502_FDF_CRG/20120516_FDF_CRG_c12.mtb	6034	33	WWFF	food_fat	4	52789	1337216068	1	0.4	0.00168776371308017	10695	1
4	Drink 1	Intake 1	23	53059	1337216338	/users/cn/jespinosa/phecomp/data/CRG/20120502_FDF_CRG/20120502_FDF_CRG/20120516_FDF_CRG_c12.mtb	1861	NA	WWFF	water	1	53036	1337216315	1	0.04	0.00173913043478261	10696	1
4	Food 2	Intake 4	48	53107	1337216386	/users/cn/jespinosa/phecomp/data/CRG/20120502_FDF_CRG/20120502_FDF_CRG/20120516_FDF_CRG_c12.mtb	6035	41	WWFF	food_fat	4	53059	1337216338	1	0.0600000000000001	0.00125	10697	1
4	Food 2	Intake 4	177	53325	1337216604	/users/cn/jespinosa/phecomp/data/CRG/20120502_FDF_CRG/20120502_FDF_CRG/20120516_FDF_CRG_c12.mtb	6036	198	WWFF	food_fat	4	53148	1337216427	1	0.84	0.00474576271186441	10698	1
4	Food 2	Intake 4	109	53632	1337216911	/users/cn/jespinosa/phecomp/data/CRG/20120502_FDF_CRG/20120502_FDF_CRG/20120516_FDF_CRG_c12.mtb	6038	45	WWFF	food_fat	4	53523	1337216802	1	0.64	0.00587155963302752	10699	1
4	Food 2	Intake 4	62	53739	1337217018	/users/cn/jespinosa/phecomp/data/CRG/20120502_FDF_CRG/20120502_FDF_CRG/20120516_FDF_CRG_c12.mtb	6039	18	WWFF	food_fat	4	53677	1337216956	1	0.460000000000001	0.00741935483870969	10700	1
4	Food 2	Intake 4	59	53816	1337217095	/users/cn/jespinosa/phecomp/data/CRG/20120502_FDF_CRG/20120502_FDF_CRG/20120516_FDF_CRG_c12.mtb	6040	290	WWFF	food_fat	4	53757	1337217036	1	0.22	0.00372881355932203	10701	1
4	Drink 1	Intake 1	26	54035	1337217314	/users/cn/jespinosa/phecomp/data/CRG/20120502_FDF_CRG/20120502_FDF_CRG/20120516_FDF_CRG_c12.mtb	1863	NA	WWFF	water	1	54009	1337217288	1	0.1	0.00384615384615385	10702	1
4	Food 2	Intake 4	14	54120	1337217399	/users/cn/jespinosa/phecomp/data/CRG/20120502_FDF_CRG/20120502_FDF_CRG/20120516_FDF_CRG_c12.mtb	6042	1583	WWFF	food_fat	4	54106	1337217385	1	0.04	0.00285714285714286	10703	1
4	Food 2	Intake 4	14	55717	1337218996	/users/cn/jespinosa/phecomp/data/CRG/20120502_FDF_CRG/20120502_FDF_CRG/20120516_FDF_CRG_c12.mtb	6044	147	WWFF	food_fat	4	55703	1337218982	1	0.0600000000000005	0.00428571428571432	10704	1
4	Food 2	Intake 4	89	55953	1337219232	/users/cn/jespinosa/phecomp/data/CRG/20120502_FDF_CRG/20120502_FDF_CRG/20120516_FDF_CRG_c12.mtb	6047	16	WWFF	food_fat	4	55864	1337219143	1	0.0599999999999996	0.000674157303370782	10705	1
4	Food 2	Intake 4	52	56021	1337219300	/users/cn/jespinosa/phecomp/data/CRG/20120502_FDF_CRG/20120502_FDF_CRG/20120516_FDF_CRG_c12.mtb	6048	4750	WWFF	food_fat	4	55969	1337219248	1	0.0200000000000005	0.000384615384615394	10706	1
4	Drink 1	Intake 1	14	57501	1337220780	/users/cn/jespinosa/phecomp/data/CRG/20120502_FDF_CRG/20120502_FDF_CRG/20120516_FDF_CRG_c12.mtb	1864	NA	WWFF	water	1	57487	1337220766	1	0.0599999999999998	0.00428571428571427	10707	1
4	Drink 1	Intake 1	24	60473	1337223752	/users/cn/jespinosa/phecomp/data/CRG/20120502_FDF_CRG/20120502_FDF_CRG/20120516_FDF_CRG_c12.mtb	1865	NA	WWFF	water	1	60449	1337223728	1	0.04	0.00166666666666667	10708	1
4	Food 2	Intake 4	13	60784	1337224063	/users/cn/jespinosa/phecomp/data/CRG/20120502_FDF_CRG/20120502_FDF_CRG/20120516_FDF_CRG_c12.mtb	6050	3426	WWFF	food_fat	4	60771	1337224050	1	0.0600000000000005	0.00461538461538465	10709	1
4	Drink 1	Intake 1	42	63722	1337227001	/users/cn/jespinosa/phecomp/data/CRG/20120502_FDF_CRG/20120502_FDF_CRG/20120516_FDF_CRG_c12.mtb	1867	NA	WWFF	water	1	63680	1337226959	1	0.12	0.00285714285714286	10710	1
4	Food 2	Intake 4	17	64227	1337227506	/users/cn/jespinosa/phecomp/data/CRG/20120502_FDF_CRG/20120502_FDF_CRG/20120516_FDF_CRG_c12.mtb	6058	2999	WWFF	food_fat	4	64210	1337227489	1	0.0200000000000005	0.00117647058823532	10711	1
4	Drink 1	Intake 1	14	66674	1337229953	/users/cn/jespinosa/phecomp/data/CRG/20120502_FDF_CRG/20120502_FDF_CRG/20120516_FDF_CRG_c12.mtb	1868	NA	WWFF	water	1	66660	1337229939	1	0.02	0.00142857142857143	10712	1
4	Food 2	Intake 4	33	67259	1337230538	/users/cn/jespinosa/phecomp/data/CRG/20120502_FDF_CRG/20120502_FDF_CRG/20120516_FDF_CRG_c12.mtb	6061	224	WWFF	food_fat	4	67226	1337230505	1	0.0200000000000005	0.000606060606060621	10713	1
4	Food 2	Intake 4	19	67502	1337230781	/users/cn/jespinosa/phecomp/data/CRG/20120502_FDF_CRG/20120502_FDF_CRG/20120516_FDF_CRG_c12.mtb	6063	109	WWFF	food_fat	4	67483	1337230762	1	0.0599999999999996	0.00315789473684208	10714	1
4	Food 2	Intake 4	100	67711	1337230990	/users/cn/jespinosa/phecomp/data/CRG/20120502_FDF_CRG/20120502_FDF_CRG/20120516_FDF_CRG_c12.mtb	6065	93	WWFF	food_fat	4	67611	1337230890	1	0.0600000000000005	0.000600000000000005	10715	1
4	Food 2	Intake 4	133	67937	1337231216	/users/cn/jespinosa/phecomp/data/CRG/20120502_FDF_CRG/20120502_FDF_CRG/20120516_FDF_CRG_c12.mtb	6066	200	WWFF	food_fat	4	67804	1337231083	1	0.359999999999999	0.00270676691729323	10716	1
4	Drink 1	Intake 1	28	67993	1337231272	/users/cn/jespinosa/phecomp/data/CRG/20120502_FDF_CRG/20120502_FDF_CRG/20120516_FDF_CRG_c12.mtb	1869	NA	WWFF	water	1	67965	1337231244	1	0.14	0.005	10717	1
4	Food 2	Intake 4	80	68217	1337231496	/users/cn/jespinosa/phecomp/data/CRG/20120502_FDF_CRG/20120502_FDF_CRG/20120516_FDF_CRG_c12.mtb	6068	314	WWFF	food_fat	4	68137	1337231416	1	0.0200000000000005	0.000250000000000006	10718	1
4	Food 2	Intake 4	76	68607	1337231886	/users/cn/jespinosa/phecomp/data/CRG/20120502_FDF_CRG/20120502_FDF_CRG/20120516_FDF_CRG_c12.mtb	6071	408	WWFF	food_fat	4	68531	1337231810	1	0.0200000000000005	0.000263157894736849	10719	1
4	Drink 1	Intake 1	28	69010	1337232289	/users/cn/jespinosa/phecomp/data/CRG/20120502_FDF_CRG/20120502_FDF_CRG/20120516_FDF_CRG_c12.mtb	1871	NA	WWFF	water	1	68982	1337232261	1	0.0599999999999998	0.00214285714285714	10720	1
4	Food 1	Intake 3	49	69064	1337232343	/users/cn/jespinosa/phecomp/data/CRG/20120502_FDF_CRG/20120502_FDF_CRG/20120516_FDF_CRG_c12.mtb	4766	658	WWFF	food_fat	3	69015	1337232294	1	0.0200000000000014	0.000408163265306151	10721	1
4	Food 2	Intake 4	57	69779	1337233058	/users/cn/jespinosa/phecomp/data/CRG/20120502_FDF_CRG/20120502_FDF_CRG/20120516_FDF_CRG_c12.mtb	6086	236	WWFF	food_fat	4	69722	1337233001	1	0.04	0.000701754385964912	10722	1
4	Food 2	Intake 4	211	70226	1337233505	/users/cn/jespinosa/phecomp/data/CRG/20120502_FDF_CRG/20120502_FDF_CRG/20120516_FDF_CRG_c12.mtb	6090	6	WWFF	food_fat	4	70015	1337233294	1	0.0599999999999996	0.000284360189573458	10723	1
4	Food 2	Intake 4	171	70403	1337233682	/users/cn/jespinosa/phecomp/data/CRG/20120502_FDF_CRG/20120502_FDF_CRG/20120516_FDF_CRG_c12.mtb	6091	51	WWFF	food_fat	4	70232	1337233511	1	0.0200000000000005	0.000116959064327488	10724	1
4	Food 2	Intake 4	12	70466	1337233745	/users/cn/jespinosa/phecomp/data/CRG/20120502_FDF_CRG/20120502_FDF_CRG/20120516_FDF_CRG_c12.mtb	6093	360	WWFF	food_fat	4	70454	1337233733	1	0.04	0.00333333333333333	10725	1
4	Drink 2	Intake 2	23	70729	1337234008	/users/cn/jespinosa/phecomp/data/CRG/20120502_FDF_CRG/20120502_FDF_CRG/20120516_FDF_CRG_c12.mtb	1738	NA	WWFF	water	2	70706	1337233985	1	0.06	0.00260869565217391	10726	1
4	Food 2	Intake 4	222	71048	1337234327	/users/cn/jespinosa/phecomp/data/CRG/20120502_FDF_CRG/20120502_FDF_CRG/20120516_FDF_CRG_c12.mtb	6095	666	WWFF	food_fat	4	70826	1337234105	1	0.0600000000000005	0.000270270270270272	10727	1
4	Food 2	Intake 4	44	71758	1337235037	/users/cn/jespinosa/phecomp/data/CRG/20120502_FDF_CRG/20120502_FDF_CRG/20120516_FDF_CRG_c12.mtb	6097	179	WWFF	food_fat	4	71714	1337234993	1	0.0200000000000005	0.000454545454545466	10728	1
4	Food 2	Intake 4	35	71972	1337235251	/users/cn/jespinosa/phecomp/data/CRG/20120502_FDF_CRG/20120502_FDF_CRG/20120516_FDF_CRG_c12.mtb	6100	109	WWFF	food_fat	4	71937	1337235216	1	0.0200000000000005	0.000571428571428586	10729	1
4	Food 2	Intake 4	29	72110	1337235389	/users/cn/jespinosa/phecomp/data/CRG/20120502_FDF_CRG/20120502_FDF_CRG/20120516_FDF_CRG_c12.mtb	6102	4026	WWFF	food_fat	4	72081	1337235360	1	0.04	0.00137931034482759	10730	1
4	Drink 1	Intake 1	23	74077	1337237356	/users/cn/jespinosa/phecomp/data/CRG/20120502_FDF_CRG/20120502_FDF_CRG/20120516_FDF_CRG_c12.mtb	1873	NA	WWFF	water	1	74054	1337237333	1	0.0799999999999998	0.00347826086956521	10731	1
4	Food 2	Intake 4	23	76159	1337239438	/users/cn/jespinosa/phecomp/data/CRG/20120502_FDF_CRG/20120502_FDF_CRG/20120516_FDF_CRG_c12.mtb	6105	3745	WWFF	food_fat	4	76136	1337239415	1	0.14	0.00608695652173913	10732	1
4	Drink 1	Intake 1	18	76635	1337239914	/users/cn/jespinosa/phecomp/data/CRG/20120502_FDF_CRG/20120502_FDF_CRG/20120516_FDF_CRG_c12.mtb	1874	NA	WWFF	water	1	76617	1337239896	1	0.1	0.00555555555555556	10733	1
4	Drink 1	Intake 1	20	79877	1337243156	/users/cn/jespinosa/phecomp/data/CRG/20120502_FDF_CRG/20120502_FDF_CRG/20120516_FDF_CRG_c12.mtb	1875	NA	WWFF	water	1	79857	1337243136	1	0.0800000000000001	0.00400000000000001	10734	1
4	Food 2	Intake 4	22	79926	1337243205	/users/cn/jespinosa/phecomp/data/CRG/20120502_FDF_CRG/20120502_FDF_CRG/20120516_FDF_CRG_c12.mtb	6107	4586	WWFF	food_fat	4	79904	1337243183	1	0.16	0.00727272727272727	10735	1
4	Drink 1	Intake 1	15	80422	1337243701	/users/cn/jespinosa/phecomp/data/CRG/20120502_FDF_CRG/20120502_FDF_CRG/20120516_FDF_CRG_c12.mtb	1876	NA	WWFF	water	1	80407	1337243686	1	0.02	0.00133333333333333	10736	1
4	Drink 1	Intake 1	13	81576	1337244855	/users/cn/jespinosa/phecomp/data/CRG/20120502_FDF_CRG/20120502_FDF_CRG/20120516_FDF_CRG_c12.mtb	1877	NA	WWFF	water	1	81563	1337244842	1	0.04	0.00307692307692308	10737	1
4	Drink 1	Intake 1	15	83616	1337246895	/users/cn/jespinosa/phecomp/data/CRG/20120502_FDF_CRG/20120502_FDF_CRG/20120516_FDF_CRG_c12.mtb	1878	NA	WWFF	water	1	83601	1337246880	1	0.0800000000000001	0.00533333333333334	10738	1
4	Food 2	Intake 4	14	84526	1337247805	/users/cn/jespinosa/phecomp/data/CRG/20120502_FDF_CRG/20120502_FDF_CRG/20120516_FDF_CRG_c12.mtb	6109	2616	WWFF	food_fat	4	84512	1337247791	1	0.12	0.00857142857142857	10739	1
4	Drink 2	Intake 2	49	87025	1337250304	/users/cn/jespinosa/phecomp/data/CRG/20120502_FDF_CRG/20120502_FDF_CRG/20120516_FDF_CRG_c12.mtb	1739	NA	WWFF	water	2	86976	1337250255	1	0.02	0.000408163265306122	10740	1
4	Food 2	Intake 4	20	87162	1337250441	/users/cn/jespinosa/phecomp/data/CRG/20120502_FDF_CRG/20120502_FDF_CRG/20120516_FDF_CRG_c12.mtb	6115	549	WWFF	food_fat	4	87142	1337250421	1	0.04	0.002	10741	1
4	Drink 2	Intake 2	35	87339	1337250618	/users/cn/jespinosa/phecomp/data/CRG/20120502_FDF_CRG/20120502_FDF_CRG/20120516_FDF_CRG_c12.mtb	1743	NA	WWFF	water	2	87304	1337250583	1	0.02	0.000571428571428571	10742	1
4	Food 2	Intake 4	66	87777	1337251056	/users/cn/jespinosa/phecomp/data/CRG/20120502_FDF_CRG/20120502_FDF_CRG/20120516_FDF_CRG_c12.mtb	6123	100	WWFF	food_fat	4	87711	1337250990	1	0.04	0.000606060606060606	10743	1
4	Food 2	Intake 4	33	87910	1337251189	/users/cn/jespinosa/phecomp/data/CRG/20120502_FDF_CRG/20120502_FDF_CRG/20120516_FDF_CRG_c12.mtb	6124	164	WWFF	food_fat	4	87877	1337251156	1	0.04	0.00121212121212121	10744	1
4	Drink 2	Intake 2	19	87980	1337251259	/users/cn/jespinosa/phecomp/data/CRG/20120502_FDF_CRG/20120502_FDF_CRG/20120516_FDF_CRG_c12.mtb	1745	NA	WWFF	water	2	87961	1337251240	1	0.08	0.00421052631578947	10745	1
4	Drink 2	Intake 2	18	88012	1337251291	/users/cn/jespinosa/phecomp/data/CRG/20120502_FDF_CRG/20120502_FDF_CRG/20120516_FDF_CRG_c12.mtb	1746	NA	WWFF	water	2	87994	1337251273	1	0.02	0.00111111111111111	10746	1
4	Food 2	Intake 4	23	88097	1337251376	/users/cn/jespinosa/phecomp/data/CRG/20120502_FDF_CRG/20120502_FDF_CRG/20120516_FDF_CRG_c12.mtb	6128	438	WWFF	food_fat	4	88074	1337251353	1	0.0200000000000005	0.000869565217391326	10747	1
4	Food 2	Intake 4	21	88556	1337251835	/users/cn/jespinosa/phecomp/data/CRG/20120502_FDF_CRG/20120502_FDF_CRG/20120516_FDF_CRG_c12.mtb	6130	232	WWFF	food_fat	4	88535	1337251814	1	0.0599999999999996	0.00285714285714284	10748	1
4	Food 2	Intake 4	22	88810	1337252089	/users/cn/jespinosa/phecomp/data/CRG/20120502_FDF_CRG/20120502_FDF_CRG/20120516_FDF_CRG_c12.mtb	6132	184	WWFF	food_fat	4	88788	1337252067	1	0.0599999999999996	0.00272727272727271	10749	1
4	Food 2	Intake 4	12	89006	1337252285	/users/cn/jespinosa/phecomp/data/CRG/20120502_FDF_CRG/20120502_FDF_CRG/20120516_FDF_CRG_c12.mtb	6134	7838	WWFF	food_fat	4	88994	1337252273	1	0.04	0.00333333333333333	10750	1
4	Drink 1	Intake 1	26	95782	1337259061	/users/cn/jespinosa/phecomp/data/CRG/20120502_FDF_CRG/20120502_FDF_CRG/20120516_FDF_CRG_c12.mtb	1879	NA	WWFF	water	1	95756	1337259035	1	0.12	0.00461538461538461	10751	1
4	Food 2	Intake 4	29	96873	1337260152	/users/cn/jespinosa/phecomp/data/CRG/20120502_FDF_CRG/20120502_FDF_CRG/20120516_FDF_CRG_c12.mtb	6136	6311	WWFF	food_fat	4	96844	1337260123	1	0.04	0.00137931034482759	10752	1
4	Drink 1	Intake 1	26	99683	1337262962	/users/cn/jespinosa/phecomp/data/CRG/20120502_FDF_CRG/20120502_FDF_CRG/20120516_FDF_CRG_c12.mtb	1880	NA	WWFF	water	1	99657	1337262936	1	0.1	0.00384615384615385	10753	1
4	Food 2	Intake 4	13	103197	1337266476	/users/cn/jespinosa/phecomp/data/CRG/20120502_FDF_CRG/20120502_FDF_CRG/20120516_FDF_CRG_c12.mtb	6138	217	WWFF	food_fat	4	103184	1337266463	1	0.100000000000001	0.00769230769230777	10754	1
4	Food 2	Intake 4	28	103442	1337266721	/users/cn/jespinosa/phecomp/data/CRG/20120502_FDF_CRG/20120502_FDF_CRG/20120516_FDF_CRG_c12.mtb	6141	189	WWFF	food_fat	4	103414	1337266693	1	0.0999999999999996	0.00357142857142856	10755	1
4	Food 2	Intake 4	45	103676	1337266955	/users/cn/jespinosa/phecomp/data/CRG/20120502_FDF_CRG/20120502_FDF_CRG/20120516_FDF_CRG_c12.mtb	6142	27	WWFF	food_fat	4	103631	1337266910	1	0.0599999999999996	0.00133333333333332	10756	1
4	Food 2	Intake 4	14	103717	1337266996	/users/cn/jespinosa/phecomp/data/CRG/20120502_FDF_CRG/20120502_FDF_CRG/20120516_FDF_CRG_c12.mtb	6143	211	WWFF	food_fat	4	103703	1337266982	1	0.0200000000000005	0.00142857142857146	10757	1
4	Food 2	Intake 4	19	103947	1337267226	/users/cn/jespinosa/phecomp/data/CRG/20120502_FDF_CRG/20120502_FDF_CRG/20120516_FDF_CRG_c12.mtb	6145	250	WWFF	food_fat	4	103928	1337267207	1	0.0200000000000005	0.00105263157894739	10758	1
4	Food 2	Intake 4	13	104210	1337267489	/users/cn/jespinosa/phecomp/data/CRG/20120502_FDF_CRG/20120502_FDF_CRG/20120516_FDF_CRG_c12.mtb	6147	4839	WWFF	food_fat	4	104197	1337267476	1	0.0800000000000001	0.00615384615384616	10759	1
4	Food 2	Intake 4	36	109085	1337272364	/users/cn/jespinosa/phecomp/data/CRG/20120502_FDF_CRG/20120502_FDF_CRG/20120516_FDF_CRG_c12.mtb	6150	5757	WWFF	food_fat	4	109049	1337272328	1	0.0200000000000005	0.000555555555555569	10760	1
4	Drink 1	Intake 1	23	109524	1337272803	/users/cn/jespinosa/phecomp/data/CRG/20120502_FDF_CRG/20120502_FDF_CRG/20120516_FDF_CRG_c12.mtb	1881	NA	WWFF	water	1	109501	1337272780	1	0.14	0.00608695652173913	10761	1
4	Drink 1	Intake 1	25	110793	1337274072	/users/cn/jespinosa/phecomp/data/CRG/20120502_FDF_CRG/20120502_FDF_CRG/20120516_FDF_CRG_c12.mtb	1882	NA	WWFF	water	1	110768	1337274047	1	0.0800000000000001	0.0032	10762	1
4	Food 2	Intake 4	47	114889	1337278168	/users/cn/jespinosa/phecomp/data/CRG/20120502_FDF_CRG/20120502_FDF_CRG/20120516_FDF_CRG_c12.mtb	6155	69	WWFF	food_fat	4	114842	1337278121	1	0.04	0.000851063829787234	10763	1
4	Food 2	Intake 4	13	114971	1337278250	/users/cn/jespinosa/phecomp/data/CRG/20120502_FDF_CRG/20120502_FDF_CRG/20120516_FDF_CRG_c12.mtb	6157	90	WWFF	food_fat	4	114958	1337278237	1	0.0200000000000005	0.00153846153846158	10764	1
4	Food 2	Intake 4	55	115116	1337278395	/users/cn/jespinosa/phecomp/data/CRG/20120502_FDF_CRG/20120502_FDF_CRG/20120516_FDF_CRG_c12.mtb	6159	339	WWFF	food_fat	4	115061	1337278340	1	0.0999999999999996	0.00181818181818181	10765	1
4	Food 2	Intake 4	13	115468	1337278747	/users/cn/jespinosa/phecomp/data/CRG/20120502_FDF_CRG/20120502_FDF_CRG/20120516_FDF_CRG_c12.mtb	6163	126	WWFF	food_fat	4	115455	1337278734	1	0.0200000000000005	0.00153846153846158	10766	1
4	Food 1	Intake 3	116	115710	1337278989	/users/cn/jespinosa/phecomp/data/CRG/20120502_FDF_CRG/20120502_FDF_CRG/20120516_FDF_CRG_c12.mtb	4784	26	WWFF	food_fat	3	115594	1337278873	1	0.0800000000000001	0.000689655172413794	10767	1
4	Food 2	Intake 4	14	115750	1337279029	/users/cn/jespinosa/phecomp/data/CRG/20120502_FDF_CRG/20120502_FDF_CRG/20120516_FDF_CRG_c12.mtb	6166	142	WWFF	food_fat	4	115736	1337279015	1	0.04	0.00285714285714286	10768	1
4	Food 2	Intake 4	104	115996	1337279275	/users/cn/jespinosa/phecomp/data/CRG/20120502_FDF_CRG/20120502_FDF_CRG/20120516_FDF_CRG_c12.mtb	6169	205	WWFF	food_fat	4	115892	1337279171	1	0.0600000000000005	0.000576923076923082	10769	1
4	Food 1	Intake 3	20	116221	1337279500	/users/cn/jespinosa/phecomp/data/CRG/20120502_FDF_CRG/20120502_FDF_CRG/20120516_FDF_CRG_c12.mtb	4787	701	WWFF	food_fat	3	116201	1337279480	1	0.0200000000000014	0.00100000000000007	10770	1
4	Drink 1	Intake 1	33	116920	1337280199	/users/cn/jespinosa/phecomp/data/CRG/20120502_FDF_CRG/20120502_FDF_CRG/20120516_FDF_CRG_c12.mtb	1884	NA	WWFF	water	1	116887	1337280166	1	0.0600000000000001	0.00181818181818182	10771	1
4	Food 2	Intake 4	110	117032	1337280311	/users/cn/jespinosa/phecomp/data/CRG/20120502_FDF_CRG/20120502_FDF_CRG/20120516_FDF_CRG_c12.mtb	6175	85	WWFF	food_fat	4	116922	1337280201	1	0.0400000000000009	0.000363636363636372	10772	1
4	Food 2	Intake 4	147	117264	1337280543	/users/cn/jespinosa/phecomp/data/CRG/20120502_FDF_CRG/20120502_FDF_CRG/20120516_FDF_CRG_c12.mtb	6177	99	WWFF	food_fat	4	117117	1337280396	1	0.0999999999999996	0.000680272108843535	10773	1
4	Drink 2	Intake 2	17	117149	1337280428	/users/cn/jespinosa/phecomp/data/CRG/20120502_FDF_CRG/20120502_FDF_CRG/20120516_FDF_CRG_c12.mtb	1756	NA	WWFF	water	2	117132	1337280411	1	0.02	0.00117647058823529	10774	1
4	Food 1	Intake 3	89	117452	1337280731	/users/cn/jespinosa/phecomp/data/CRG/20120502_FDF_CRG/20120502_FDF_CRG/20120516_FDF_CRG_c12.mtb	4791	67	WWFF	food_fat	3	117363	1337280642	1	0.119999999999999	0.00134831460674156	10775	1
4	Food 1	Intake 3	65	117584	1337280863	/users/cn/jespinosa/phecomp/data/CRG/20120502_FDF_CRG/20120502_FDF_CRG/20120516_FDF_CRG_c12.mtb	4793	COLL	WWFF	food_fat	3	117519	1337280798	1	0.0600000000000005	0.000923076923076931	10776	1
4	Food 2	Intake 4	112	117668	1337280947	/users/cn/jespinosa/phecomp/data/CRG/20120502_FDF_CRG/20120502_FDF_CRG/20120516_FDF_CRG_c12.mtb	6181	355	WWFF	food_fat	4	117556	1337280835	1	0.28	0.0025	10777	1
4	Food 2	Intake 4	23	118046	1337281325	/users/cn/jespinosa/phecomp/data/CRG/20120502_FDF_CRG/20120502_FDF_CRG/20120516_FDF_CRG_c12.mtb	6182	662	WWFF	food_fat	4	118023	1337281302	1	0.0200000000000005	0.000869565217391326	10778	1
4	Drink 1	Intake 1	22	118058	1337281337	/users/cn/jespinosa/phecomp/data/CRG/20120502_FDF_CRG/20120502_FDF_CRG/20120516_FDF_CRG_c12.mtb	1885	NA	WWFF	water	1	118036	1337281315	1	0.0600000000000001	0.00272727272727273	10779	1
4	Food 2	Intake 4	43	118751	1337282030	/users/cn/jespinosa/phecomp/data/CRG/20120502_FDF_CRG/20120502_FDF_CRG/20120516_FDF_CRG_c12.mtb	6192	217	WWFF	food_fat	4	118708	1337281987	1	0.0400000000000009	0.000930232558139556	10780	1
4	Food 1	Intake 3	73	119041	1337282320	/users/cn/jespinosa/phecomp/data/CRG/20120502_FDF_CRG/20120502_FDF_CRG/20120516_FDF_CRG_c12.mtb	4795	68	WWFF	food_fat	3	118968	1337282247	1	0.0399999999999991	0.00054794520547944	10781	1
4	Drink 2	Intake 2	18	119115	1337282394	/users/cn/jespinosa/phecomp/data/CRG/20120502_FDF_CRG/20120502_FDF_CRG/20120516_FDF_CRG_c12.mtb	1758	NA	WWFF	water	2	119097	1337282376	1	0.02	0.00111111111111111	10782	1
4	Food 2	Intake 4	143	119252	1337282531	/users/cn/jespinosa/phecomp/data/CRG/20120502_FDF_CRG/20120502_FDF_CRG/20120516_FDF_CRG_c12.mtb	6197	90	WWFF	food_fat	4	119109	1337282388	1	0.120000000000001	0.000839160839160846	10783	1
4	Food 2	Intake 4	47	119389	1337282668	/users/cn/jespinosa/phecomp/data/CRG/20120502_FDF_CRG/20120502_FDF_CRG/20120516_FDF_CRG_c12.mtb	6198	52	WWFF	food_fat	4	119342	1337282621	1	0.0599999999999987	0.00127659574468082	10784	1
4	Drink 2	Intake 2	15	119412	1337282691	/users/cn/jespinosa/phecomp/data/CRG/20120502_FDF_CRG/20120502_FDF_CRG/20120516_FDF_CRG_c12.mtb	1759	NA	WWFF	water	2	119397	1337282676	1	0.02	0.00133333333333333	10785	1
4	Food 1	Intake 3	68	119509	1337282788	/users/cn/jespinosa/phecomp/data/CRG/20120502_FDF_CRG/20120502_FDF_CRG/20120516_FDF_CRG_c12.mtb	4796	COLL	WWFF	food_fat	3	119441	1337282720	1	0.0400000000000009	0.00058823529411766	10786	1
4	Food 2	Intake 4	19	119515	1337282794	/users/cn/jespinosa/phecomp/data/CRG/20120502_FDF_CRG/20120502_FDF_CRG/20120516_FDF_CRG_c12.mtb	6200	57	WWFF	food_fat	4	119496	1337282775	1	0.0200000000000014	0.00105263157894744	10787	1
4	Food 2	Intake 4	17	119589	1337282868	/users/cn/jespinosa/phecomp/data/CRG/20120502_FDF_CRG/20120502_FDF_CRG/20120516_FDF_CRG_c12.mtb	6201	1521	WWFF	food_fat	4	119572	1337282851	1	0.0399999999999991	0.00235294117647054	10788	1
4	Drink 1	Intake 1	156	120676	1337283955	/users/cn/jespinosa/phecomp/data/CRG/20120502_FDF_CRG/20120502_FDF_CRG/20120516_FDF_CRG_c12.mtb	1887	NA	WWFF	water	1	120520	1337283799	1	0.0999999999999996	0.000641025641025639	10789	1
4	Food 2	Intake 4	98	121208	1337284487	/users/cn/jespinosa/phecomp/data/CRG/20120502_FDF_CRG/20120502_FDF_CRG/20120516_FDF_CRG_c12.mtb	6209	COLL	WWFF	food_fat	4	121110	1337284389	1	0.24	0.00244897959183673	10790	1
4	Food 1	Intake 3	197	121390	1337284669	/users/cn/jespinosa/phecomp/data/CRG/20120502_FDF_CRG/20120502_FDF_CRG/20120516_FDF_CRG_c12.mtb	4800	899	WWFF	food_fat	3	121193	1337284472	1	0.140000000000001	0.000710659898477162	10791	1
4	Food 2	Intake 4	47	122336	1337285615	/users/cn/jespinosa/phecomp/data/CRG/20120502_FDF_CRG/20120502_FDF_CRG/20120516_FDF_CRG_c12.mtb	6219	1342	WWFF	food_fat	4	122289	1337285568	1	0.0200000000000014	0.000425531914893647	10792	1
4	Drink 2	Intake 2	27	122358	1337285637	/users/cn/jespinosa/phecomp/data/CRG/20120502_FDF_CRG/20120502_FDF_CRG/20120516_FDF_CRG_c12.mtb	1763	NA	WWFF	water	2	122331	1337285610	1	0.04	0.00148148148148148	10793	1
4	Drink 2	Intake 2	26	122388	1337285667	/users/cn/jespinosa/phecomp/data/CRG/20120502_FDF_CRG/20120502_FDF_CRG/20120516_FDF_CRG_c12.mtb	1764	NA	WWFF	water	2	122362	1337285641	1	0.04	0.00153846153846154	10794	1
4	Food 2	Intake 4	69	123747	1337287026	/users/cn/jespinosa/phecomp/data/CRG/20120502_FDF_CRG/20120502_FDF_CRG/20120516_FDF_CRG_c12.mtb	6225	55	WWFF	food_fat	4	123678	1337286957	1	0.0400000000000009	0.000579710144927549	10795	1
4	Food 1	Intake 3	113	123915	1337287194	/users/cn/jespinosa/phecomp/data/CRG/20120502_FDF_CRG/20120502_FDF_CRG/20120516_FDF_CRG_c12.mtb	4805	3	WWFF	food_fat	3	123802	1337287081	1	0.0399999999999991	0.000353982300884948	10796	1
4	Food 2	Intake 4	146	124064	1337287343	/users/cn/jespinosa/phecomp/data/CRG/20120502_FDF_CRG/20120502_FDF_CRG/20120516_FDF_CRG_c12.mtb	6228	COLL	WWFF	food_fat	4	123918	1337287197	1	0.140000000000001	0.000958904109589048	10797	1
4	Food 1	Intake 3	29	124007	1337287286	/users/cn/jespinosa/phecomp/data/CRG/20120502_FDF_CRG/20120502_FDF_CRG/20120516_FDF_CRG_c12.mtb	4806	1835	WWFF	food_fat	3	123978	1337287257	1	0.0200000000000014	0.000689655172413841	10798	1
4	Drink 2	Intake 2	25	124902	1337288181	/users/cn/jespinosa/phecomp/data/CRG/20120502_FDF_CRG/20120502_FDF_CRG/20120516_FDF_CRG_c12.mtb	1766	NA	WWFF	water	2	124877	1337288156	1	0.04	0.0016	10799	1
4	Food 2	Intake 4	16	125858	1337289137	/users/cn/jespinosa/phecomp/data/CRG/20120502_FDF_CRG/20120502_FDF_CRG/20120516_FDF_CRG_c12.mtb	6244	83	WWFF	food_fat	4	125842	1337289121	1	0.0200000000000014	0.00125000000000009	10800	1
4	Food 2	Intake 4	14	125955	1337289234	/users/cn/jespinosa/phecomp/data/CRG/20120502_FDF_CRG/20120502_FDF_CRG/20120516_FDF_CRG_c12.mtb	6246	17	WWFF	food_fat	4	125941	1337289220	1	0.0399999999999991	0.00285714285714279	10801	1
4	Drink 1	Intake 1	17	125967	1337289246	/users/cn/jespinosa/phecomp/data/CRG/20120502_FDF_CRG/20120502_FDF_CRG/20120516_FDF_CRG_c12.mtb	1892	NA	WWFF	water	1	125950	1337289229	1	0.02	0.00117647058823529	10802	1
4	Food 2	Intake 4	64	126036	1337289315	/users/cn/jespinosa/phecomp/data/CRG/20120502_FDF_CRG/20120502_FDF_CRG/20120516_FDF_CRG_c12.mtb	6247	105	WWFF	food_fat	4	125972	1337289251	1	0.0200000000000014	0.000312500000000022	10803	1
4	Food 2	Intake 4	12	126153	1337289432	/users/cn/jespinosa/phecomp/data/CRG/20120502_FDF_CRG/20120502_FDF_CRG/20120516_FDF_CRG_c12.mtb	6249	295	WWFF	food_fat	4	126141	1337289420	1	0.0399999999999991	0.00333333333333326	10804	1
4	Food 2	Intake 4	12	126460	1337289739	/users/cn/jespinosa/phecomp/data/CRG/20120502_FDF_CRG/20120502_FDF_CRG/20120516_FDF_CRG_c12.mtb	6252	154	WWFF	food_fat	4	126448	1337289727	1	0.0200000000000014	0.00166666666666678	10805	1
4	Food 2	Intake 4	37	126651	1337289930	/users/cn/jespinosa/phecomp/data/CRG/20120502_FDF_CRG/20120502_FDF_CRG/20120516_FDF_CRG_c12.mtb	6255	77	WWFF	food_fat	4	126614	1337289893	1	0.0399999999999991	0.00108108108108106	10806	1
4	Food 2	Intake 4	12	126740	1337290019	/users/cn/jespinosa/phecomp/data/CRG/20120502_FDF_CRG/20120502_FDF_CRG/20120516_FDF_CRG_c12.mtb	6256	4583	WWFF	food_fat	4	126728	1337290007	1	0.0400000000000009	0.00333333333333341	10807	1
4	Drink 1	Intake 1	26	129161	1337292440	/users/cn/jespinosa/phecomp/data/CRG/20120502_FDF_CRG/20120502_FDF_CRG/20120516_FDF_CRG_c12.mtb	1893	NA	WWFF	water	1	129135	1337292414	1	0.04	0.00153846153846154	10808	1
4	Drink 1	Intake 1	16	129452	1337292731	/users/cn/jespinosa/phecomp/data/CRG/20120502_FDF_CRG/20120502_FDF_CRG/20120516_FDF_CRG_c12.mtb	1894	NA	WWFF	water	1	129436	1337292715	1	0.02	0.00125	10809	1
4	Drink 1	Intake 1	16	130016	1337293295	/users/cn/jespinosa/phecomp/data/CRG/20120502_FDF_CRG/20120502_FDF_CRG/20120516_FDF_CRG_c12.mtb	1895	NA	WWFF	water	1	130000	1337293279	1	0.04	0.0025	10810	1
4	Food 2	Intake 4	50	131373	1337294652	/users/cn/jespinosa/phecomp/data/CRG/20120502_FDF_CRG/20120502_FDF_CRG/20120516_FDF_CRG_c12.mtb	6262	67	WWFF	food_fat	4	131323	1337294602	1	0.0800000000000001	0.0016	10811	1
4	Food 2	Intake 4	18	131458	1337294737	/users/cn/jespinosa/phecomp/data/CRG/20120502_FDF_CRG/20120502_FDF_CRG/20120516_FDF_CRG_c12.mtb	6263	40	WWFF	food_fat	4	131440	1337294719	1	0.0200000000000014	0.00111111111111119	10812	1
4	Food 2	Intake 4	73	131571	1337294850	/users/cn/jespinosa/phecomp/data/CRG/20120502_FDF_CRG/20120502_FDF_CRG/20120516_FDF_CRG_c12.mtb	6265	311	WWFF	food_fat	4	131498	1337294777	1	0.0399999999999991	0.00054794520547944	10813	1
4	Drink 2	Intake 2	110	131699	1337294978	/users/cn/jespinosa/phecomp/data/CRG/20120502_FDF_CRG/20120502_FDF_CRG/20120516_FDF_CRG_c12.mtb	1771	NA	WWFF	water	2	131589	1337294868	1	0.08	0.000727272727272727	10814	1
4	Food 2	Intake 4	69	131951	1337295230	/users/cn/jespinosa/phecomp/data/CRG/20120502_FDF_CRG/20120502_FDF_CRG/20120516_FDF_CRG_c12.mtb	6272	434	WWFF	food_fat	4	131882	1337295161	1	0.0200000000000014	0.000289855072463788	10815	1
4	Drink 2	Intake 2	21	132310	1337295589	/users/cn/jespinosa/phecomp/data/CRG/20120502_FDF_CRG/20120502_FDF_CRG/20120516_FDF_CRG_c12.mtb	1775	NA	WWFF	water	2	132289	1337295568	1	0.02	0.000952380952380952	10816	1
4	Food 2	Intake 4	13	132398	1337295677	/users/cn/jespinosa/phecomp/data/CRG/20120502_FDF_CRG/20120502_FDF_CRG/20120516_FDF_CRG_c12.mtb	6280	105	WWFF	food_fat	4	132385	1337295664	1	0.0200000000000014	0.00153846153846165	10817	1
4	Food 2	Intake 4	14	132517	1337295796	/users/cn/jespinosa/phecomp/data/CRG/20120502_FDF_CRG/20120502_FDF_CRG/20120516_FDF_CRG_c12.mtb	6281	4948	WWFF	food_fat	4	132503	1337295782	1	0.0399999999999991	0.00285714285714279	10818	1
4	Drink 1	Intake 1	32	132546	1337295825	/users/cn/jespinosa/phecomp/data/CRG/20120502_FDF_CRG/20120502_FDF_CRG/20120516_FDF_CRG_c12.mtb	1897	NA	WWFF	water	1	132514	1337295793	1	0.12	0.00375	10819	1
4	Drink 1	Intake 1	19	137422	1337300701	/users/cn/jespinosa/phecomp/data/CRG/20120502_FDF_CRG/20120502_FDF_CRG/20120516_FDF_CRG_c12.mtb	1899	NA	WWFF	water	1	137403	1337300682	1	0.0600000000000001	0.00315789473684211	10820	1
4	Food 2	Intake 4	33	137498	1337300777	/users/cn/jespinosa/phecomp/data/CRG/20120502_FDF_CRG/20120502_FDF_CRG/20120516_FDF_CRG_c12.mtb	6287	3776	WWFF	food_fat	4	137465	1337300744	1	0.0200000000000014	0.000606060606060648	10821	1
4	Food 2	Intake 4	13	141287	1337304566	/users/cn/jespinosa/phecomp/data/CRG/20120502_FDF_CRG/20120502_FDF_CRG/20120516_FDF_CRG_c12.mtb	6296	138	WWFF	food_fat	4	141274	1337304553	1	0.0600000000000005	0.00461538461538465	10822	1
4	Food 2	Intake 4	12	141437	1337304716	/users/cn/jespinosa/phecomp/data/CRG/20120502_FDF_CRG/20120502_FDF_CRG/20120516_FDF_CRG_c12.mtb	6298	409	WWFF	food_fat	4	141425	1337304704	1	0.0399999999999991	0.00333333333333326	10823	1
4	Drink 1	Intake 1	19	141842	1337305121	/users/cn/jespinosa/phecomp/data/CRG/20120502_FDF_CRG/20120502_FDF_CRG/20120516_FDF_CRG_c12.mtb	1900	NA	WWFF	water	1	141823	1337305102	1	0.1	0.00526315789473684	10824	1
4	Food 2	Intake 4	115	141961	1337305240	/users/cn/jespinosa/phecomp/data/CRG/20120502_FDF_CRG/20120502_FDF_CRG/20120516_FDF_CRG_c12.mtb	6303	176	WWFF	food_fat	4	141846	1337305125	1	0.0800000000000001	0.000695652173913044	10825	1
4	Food 2	Intake 4	30	142167	1337305446	/users/cn/jespinosa/phecomp/data/CRG/20120502_FDF_CRG/20120502_FDF_CRG/20120516_FDF_CRG_c12.mtb	6306	29	WWFF	food_fat	4	142137	1337305416	1	0.0800000000000001	0.00266666666666667	10826	1
4	Food 1	Intake 3	93	142289	1337305568	/users/cn/jespinosa/phecomp/data/CRG/20120502_FDF_CRG/20120502_FDF_CRG/20120516_FDF_CRG_c12.mtb	4816	4	WWFF	food_fat	3	142196	1337305475	1	0.0399999999999991	0.000430107526881711	10827	1
4	Food 1	Intake 3	92	142385	1337305664	/users/cn/jespinosa/phecomp/data/CRG/20120502_FDF_CRG/20120502_FDF_CRG/20120516_FDF_CRG_c12.mtb	4817	11	WWFF	food_fat	3	142293	1337305572	1	0.0400000000000009	0.000434782608695662	10828	1
4	Food 1	Intake 3	95	142491	1337305770	/users/cn/jespinosa/phecomp/data/CRG/20120502_FDF_CRG/20120502_FDF_CRG/20120516_FDF_CRG_c12.mtb	4818	63	WWFF	food_fat	3	142396	1337305675	1	0.0399999999999991	0.000421052631578938	10829	1
4	Food 1	Intake 3	177	142731	1337306010	/users/cn/jespinosa/phecomp/data/CRG/20120502_FDF_CRG/20120502_FDF_CRG/20120516_FDF_CRG_c12.mtb	4819	326	WWFF	food_fat	3	142554	1337305833	1	0.0800000000000001	0.000451977401129944	10830	1
4	Drink 1	Intake 1	29	142990	1337306269	/users/cn/jespinosa/phecomp/data/CRG/20120502_FDF_CRG/20120502_FDF_CRG/20120516_FDF_CRG_c12.mtb	1901	NA	WWFF	water	1	142961	1337306240	1	0.0999999999999996	0.00344827586206895	10831	1
4	Food 2	Intake 4	13	143070	1337306349	/users/cn/jespinosa/phecomp/data/CRG/20120502_FDF_CRG/20120502_FDF_CRG/20120516_FDF_CRG_c12.mtb	6316	272	WWFF	food_fat	4	143057	1337306336	1	0.0200000000000014	0.00153846153846165	10832	1
4	Food 2	Intake 4	49	143391	1337306670	/users/cn/jespinosa/phecomp/data/CRG/20120502_FDF_CRG/20120502_FDF_CRG/20120516_FDF_CRG_c12.mtb	6319	305	WWFF	food_fat	4	143342	1337306621	1	0.0399999999999991	0.000816326530612226	10833	1
4	Food 2	Intake 4	26	143722	1337307001	/users/cn/jespinosa/phecomp/data/CRG/20120502_FDF_CRG/20120502_FDF_CRG/20120516_FDF_CRG_c12.mtb	6324	191	WWFF	food_fat	4	143696	1337306975	1	0.0200000000000014	0.000769230769230823	10834	1
4	Food 2	Intake 4	25	143938	1337307217	/users/cn/jespinosa/phecomp/data/CRG/20120502_FDF_CRG/20120502_FDF_CRG/20120516_FDF_CRG_c12.mtb	6327	2236	WWFF	food_fat	4	143913	1337307192	1	0.0599999999999987	0.00239999999999995	10835	1
4	Food 2	Intake 4	15	146189	1337309468	/users/cn/jespinosa/phecomp/data/CRG/20120502_FDF_CRG/20120502_FDF_CRG/20120516_FDF_CRG_c12.mtb	6328	2114	WWFF	food_fat	4	146174	1337309453	1	0.0200000000000014	0.00133333333333343	10836	1
4	Drink 1	Intake 1	13	146610	1337309889	/users/cn/jespinosa/phecomp/data/CRG/20120502_FDF_CRG/20120502_FDF_CRG/20120516_FDF_CRG_c12.mtb	1902	NA	WWFF	water	1	146597	1337309876	1	0.0600000000000001	0.00461538461538462	10837	1
4	Food 2	Intake 4	18	148321	1337311600	/users/cn/jespinosa/phecomp/data/CRG/20120502_FDF_CRG/20120502_FDF_CRG/20120516_FDF_CRG_c12.mtb	6332	3460	WWFF	food_fat	4	148303	1337311582	1	0.0200000000000014	0.00111111111111119	10838	1
4	Drink 1	Intake 1	10	149469	1337312748	/users/cn/jespinosa/phecomp/data/CRG/20120502_FDF_CRG/20120502_FDF_CRG/20120516_FDF_CRG_c12.mtb	1903	NA	WWFF	water	1	149459	1337312738	1	0.04	0.004	10839	1
4	Food 2	Intake 4	66	151847	1337315126	/users/cn/jespinosa/phecomp/data/CRG/20120502_FDF_CRG/20120502_FDF_CRG/20120516_FDF_CRG_c12.mtb	6343	48	WWFF	food_fat	4	151781	1337315060	1	0.0200000000000014	0.000303030303030324	10840	1
4	Food 2	Intake 4	52	151947	1337315226	/users/cn/jespinosa/phecomp/data/CRG/20120502_FDF_CRG/20120502_FDF_CRG/20120516_FDF_CRG_c12.mtb	6345	16	WWFF	food_fat	4	151895	1337315174	1	0.0400000000000009	0.000769230769230787	10841	1
4	Food 2	Intake 4	179	152142	1337315421	/users/cn/jespinosa/phecomp/data/CRG/20120502_FDF_CRG/20120502_FDF_CRG/20120516_FDF_CRG_c12.mtb	6346	4	WWFF	food_fat	4	151963	1337315242	1	0.0599999999999987	0.00033519553072625	10842	1
4	Drink 1	Intake 1	24	152158	1337315437	/users/cn/jespinosa/phecomp/data/CRG/20120502_FDF_CRG/20120502_FDF_CRG/20120516_FDF_CRG_c12.mtb	1904	NA	WWFF	water	1	152134	1337315413	1	0.0600000000000001	0.0025	10843	1
4	Food 2	Intake 4	155	152301	1337315580	/users/cn/jespinosa/phecomp/data/CRG/20120502_FDF_CRG/20120502_FDF_CRG/20120516_FDF_CRG_c12.mtb	6347	276	WWFF	food_fat	4	152146	1337315425	1	0.140000000000001	0.000903225806451619	10844	1
4	Food 1	Intake 3	75	152652	1337315931	/users/cn/jespinosa/phecomp/data/CRG/20120502_FDF_CRG/20120502_FDF_CRG/20120516_FDF_CRG_c12.mtb	4822	155	WWFF	food_fat	3	152577	1337315856	1	0.0400000000000009	0.000533333333333345	10845	1
4	Drink 2	Intake 2	28	152736	1337316015	/users/cn/jespinosa/phecomp/data/CRG/20120502_FDF_CRG/20120502_FDF_CRG/20120516_FDF_CRG_c12.mtb	1778	NA	WWFF	water	2	152708	1337315987	1	0.1	0.00357142857142857	10846	1
4	Food 2	Intake 4	20	152827	1337316106	/users/cn/jespinosa/phecomp/data/CRG/20120502_FDF_CRG/20120502_FDF_CRG/20120516_FDF_CRG_c12.mtb	6353	643	WWFF	food_fat	4	152807	1337316086	1	0.0200000000000014	0.00100000000000007	10847	1
4	Drink 2	Intake 2	49	153391	1337316670	/users/cn/jespinosa/phecomp/data/CRG/20120502_FDF_CRG/20120502_FDF_CRG/20120516_FDF_CRG_c12.mtb	1779	NA	WWFF	water	2	153342	1337316621	1	0.06	0.00122448979591837	10848	1
4	Food 2	Intake 4	48	153518	1337316797	/users/cn/jespinosa/phecomp/data/CRG/20120502_FDF_CRG/20120502_FDF_CRG/20120516_FDF_CRG_c12.mtb	6363	496	WWFF	food_fat	4	153470	1337316749	1	0.0200000000000014	0.000416666666666696	10849	1
4	Food 2	Intake 4	23	154037	1337317316	/users/cn/jespinosa/phecomp/data/CRG/20120502_FDF_CRG/20120502_FDF_CRG/20120516_FDF_CRG_c12.mtb	6367	820	WWFF	food_fat	4	154014	1337317293	1	0.0400000000000009	0.00173913043478265	10850	1
4	Food 2	Intake 4	48	154905	1337318184	/users/cn/jespinosa/phecomp/data/CRG/20120502_FDF_CRG/20120502_FDF_CRG/20120516_FDF_CRG_c12.mtb	6369	1031	WWFF	food_fat	4	154857	1337318136	1	0.0399999999999991	0.000833333333333315	10851	1
4	Food 2	Intake 4	26	155962	1337319241	/users/cn/jespinosa/phecomp/data/CRG/20120502_FDF_CRG/20120502_FDF_CRG/20120516_FDF_CRG_c12.mtb	6372	10	WWFF	food_fat	4	155936	1337319215	1	0.0400000000000009	0.00153846153846157	10852	1
4	Food 2	Intake 4	20	155992	1337319271	/users/cn/jespinosa/phecomp/data/CRG/20120502_FDF_CRG/20120502_FDF_CRG/20120516_FDF_CRG_c12.mtb	6373	428	WWFF	food_fat	4	155972	1337319251	1	0.0399999999999991	0.00199999999999995	10853	1
4	Food 2	Intake 4	203	156623	1337319902	/users/cn/jespinosa/phecomp/data/CRG/20120502_FDF_CRG/20120502_FDF_CRG/20120516_FDF_CRG_c12.mtb	6379	455	WWFF	food_fat	4	156420	1337319699	1	0.0600000000000005	0.000295566502463057	10854	1
4	Drink 1	Intake 1	36	156944	1337320223	/users/cn/jespinosa/phecomp/data/CRG/20120502_FDF_CRG/20120502_FDF_CRG/20120516_FDF_CRG_c12.mtb	1905	NA	WWFF	water	1	156908	1337320187	1	0.1	0.00277777777777778	10855	1
4	Food 2	Intake 4	124	157202	1337320481	/users/cn/jespinosa/phecomp/data/CRG/20120502_FDF_CRG/20120502_FDF_CRG/20120516_FDF_CRG_c12.mtb	6384	729	WWFF	food_fat	4	157078	1337320357	1	0.0400000000000009	0.000322580645161298	10856	1
4	Food 2	Intake 4	12	157943	1337321222	/users/cn/jespinosa/phecomp/data/CRG/20120502_FDF_CRG/20120502_FDF_CRG/20120516_FDF_CRG_c12.mtb	6392	112	WWFF	food_fat	4	157931	1337321210	1	0.0400000000000009	0.00333333333333341	10857	1
4	Food 2	Intake 4	41	158096	1337321375	/users/cn/jespinosa/phecomp/data/CRG/20120502_FDF_CRG/20120502_FDF_CRG/20120516_FDF_CRG_c12.mtb	6395	11281	WWFF	food_fat	4	158055	1337321334	1	0.0599999999999987	0.00146341463414631	10858	1
4	Drink 2	Intake 2	28	158114	1337321393	/users/cn/jespinosa/phecomp/data/CRG/20120502_FDF_CRG/20120502_FDF_CRG/20120516_FDF_CRG_c12.mtb	1783	NA	WWFF	water	2	158086	1337321365	1	0.08	0.00285714285714286	10859	1
4	Drink 1	Intake 1	22	161664	1337324943	/users/cn/jespinosa/phecomp/data/CRG/20120502_FDF_CRG/20120502_FDF_CRG/20120516_FDF_CRG_c12.mtb	1907	NA	WWFF	water	1	161642	1337324921	1	0.12	0.00545454545454545	10860	1
4	Drink 1	Intake 1	12	162114	1337325393	/users/cn/jespinosa/phecomp/data/CRG/20120502_FDF_CRG/20120502_FDF_CRG/20120516_FDF_CRG_c12.mtb	1908	NA	WWFF	water	1	162102	1337325381	1	0.0600000000000001	0.00500000000000001	10861	1
4	Food 1	Intake 3	25	166	1337332681	/users/cn/jespinosa/phecomp/data/CRG/20120502_FDF_CRG/20120502_FDF_CRG/20120518_FDF_CRG_c12.mtb	4831	40	WWFF	food_fat	3	141	1337332656	1	0.24	0.0096	10862	1
4	Food 1	Intake 3	100	306	1337332821	/users/cn/jespinosa/phecomp/data/CRG/20120502_FDF_CRG/20120502_FDF_CRG/20120518_FDF_CRG_c12.mtb	4832	31	WWFF	food_fat	3	206	1337332721	1	1.72	0.0172	10863	1
4	Food 1	Intake 3	117	454	1337332969	/users/cn/jespinosa/phecomp/data/CRG/20120502_FDF_CRG/20120502_FDF_CRG/20120518_FDF_CRG_c12.mtb	4833	20	WWFF	food_fat	3	337	1337332852	1	3.02	0.0258119658119658	10864	1
4	Food 1	Intake 3	36	510	1337333025	/users/cn/jespinosa/phecomp/data/CRG/20120502_FDF_CRG/20120502_FDF_CRG/20120518_FDF_CRG_c12.mtb	4834	COLL	WWFF	food_fat	3	474	1337332989	1	0.0799999999999992	0.0022222222222222	10865	1
4	Food 2	Intake 4	13	515	1337333030	/users/cn/jespinosa/phecomp/data/CRG/20120502_FDF_CRG/20120502_FDF_CRG/20120518_FDF_CRG_c12.mtb	6403	4971	WWFF	food_fat	4	502	1337333017	1	0.04	0.00307692307692308	10866	1
4	Drink 1	Intake 1	21	3302	1337335817	/users/cn/jespinosa/phecomp/data/CRG/20120502_FDF_CRG/20120502_FDF_CRG/20120518_FDF_CRG_c12.mtb	1909	NA	WWFF	water	1	3281	1337335796	1	0.08	0.00380952380952381	10867	1
4	Food 1	Intake 3	18	5504	1337338019	/users/cn/jespinosa/phecomp/data/CRG/20120502_FDF_CRG/20120502_FDF_CRG/20120518_FDF_CRG_c12.mtb	4845	COLL	WWFF	food_fat	3	5486	1337338001	1	0.22	0.0122222222222222	10868	1
4	Food 2	Intake 4	15	5503	1337338018	/users/cn/jespinosa/phecomp/data/CRG/20120502_FDF_CRG/20120502_FDF_CRG/20120518_FDF_CRG_c12.mtb	6405	1323	WWFF	food_fat	4	5488	1337338003	1	0.1	0.00666666666666667	10869	1
4	Drink 1	Intake 1	26	6165	1337338680	/users/cn/jespinosa/phecomp/data/CRG/20120502_FDF_CRG/20120502_FDF_CRG/20120518_FDF_CRG_c12.mtb	1910	NA	WWFF	water	1	6139	1337338654	1	0.12	0.00461538461538461	10870	1
4	Food 1	Intake 3	14	6840	1337339355	/users/cn/jespinosa/phecomp/data/CRG/20120502_FDF_CRG/20120502_FDF_CRG/20120518_FDF_CRG_c12.mtb	4848	1916	WWFF	food_fat	3	6826	1337339341	1	0.04	0.00285714285714286	10871	1
4	Drink 1	Intake 1	21	8006	1337340521	/users/cn/jespinosa/phecomp/data/CRG/20120502_FDF_CRG/20120502_FDF_CRG/20120518_FDF_CRG_c12.mtb	1911	NA	WWFF	water	1	7985	1337340500	1	0.14	0.00666666666666667	10872	1
4	Food 2	Intake 4	13	8769	1337341284	/users/cn/jespinosa/phecomp/data/CRG/20120502_FDF_CRG/20120502_FDF_CRG/20120518_FDF_CRG_c12.mtb	6407	3869	WWFF	food_fat	4	8756	1337341271	1	0.1	0.00769230769230769	10873	1
4	Drink 1	Intake 1	13	9326	1337341841	/users/cn/jespinosa/phecomp/data/CRG/20120502_FDF_CRG/20120502_FDF_CRG/20120518_FDF_CRG_c12.mtb	1912	NA	WWFF	water	1	9313	1337341828	1	0.04	0.00307692307692308	10874	1
4	Food 1	Intake 3	26	12664	1337345179	/users/cn/jespinosa/phecomp/data/CRG/20120502_FDF_CRG/20120502_FDF_CRG/20120518_FDF_CRG_c12.mtb	4866	COLL	WWFF	food_fat	3	12638	1337345153	1	0.22	0.00846153846153846	10875	1
4	Food 2	Intake 4	13	12658	1337345173	/users/cn/jespinosa/phecomp/data/CRG/20120502_FDF_CRG/20120502_FDF_CRG/20120518_FDF_CRG_c12.mtb	6410	1245	WWFF	food_fat	4	12645	1337345160	1	0.04	0.00307692307692308	10876	1
4	Food 2	Intake 4	9	13912	1337346427	/users/cn/jespinosa/phecomp/data/CRG/20120502_FDF_CRG/20120502_FDF_CRG/20120518_FDF_CRG_c12.mtb	6411	1774	WWFF	food_fat	4	13903	1337346418	1	0.02	0.00222222222222222	10877	1
4	Food 2	Intake 4	15	15701	1337348216	/users/cn/jespinosa/phecomp/data/CRG/20120502_FDF_CRG/20120502_FDF_CRG/20120518_FDF_CRG_c12.mtb	6413	COLL	WWFF	food_fat	4	15686	1337348201	1	0.12	0.008	10878	1
4	Food 1	Intake 3	13	15701	1337348216	/users/cn/jespinosa/phecomp/data/CRG/20120502_FDF_CRG/20120502_FDF_CRG/20120518_FDF_CRG_c12.mtb	4873	2945	WWFF	food_fat	3	15688	1337348203	1	0.28	0.0215384615384615	10879	1
4	Drink 1	Intake 1	13	15970	1337348485	/users/cn/jespinosa/phecomp/data/CRG/20120502_FDF_CRG/20120502_FDF_CRG/20120518_FDF_CRG_c12.mtb	1913	NA	WWFF	water	1	15957	1337348472	1	0.04	0.00307692307692308	10880	1
4	Drink 1	Intake 1	23	16575	1337349090	/users/cn/jespinosa/phecomp/data/CRG/20120502_FDF_CRG/20120502_FDF_CRG/20120518_FDF_CRG_c12.mtb	1914	NA	WWFF	water	1	16552	1337349067	1	0.06	0.00260869565217391	10881	1
4	Food 1	Intake 3	17	18663	1337351178	/users/cn/jespinosa/phecomp/data/CRG/20120502_FDF_CRG/20120502_FDF_CRG/20120518_FDF_CRG_c12.mtb	4880	1663	WWFF	food_fat	3	18646	1337351161	1	0.0599999999999996	0.00352941176470586	10882	1
4	Drink 1	Intake 1	15	19279	1337351794	/users/cn/jespinosa/phecomp/data/CRG/20120502_FDF_CRG/20120502_FDF_CRG/20120518_FDF_CRG_c12.mtb	1915	NA	WWFF	water	1	19264	1337351779	1	0.04	0.00266666666666667	10883	1
4	Drink 1	Intake 1	17	19897	1337352412	/users/cn/jespinosa/phecomp/data/CRG/20120502_FDF_CRG/20120502_FDF_CRG/20120518_FDF_CRG_c12.mtb	1916	NA	WWFF	water	1	19880	1337352395	1	0.04	0.00235294117647059	10884	1
4	Food 1	Intake 3	15	20341	1337352856	/users/cn/jespinosa/phecomp/data/CRG/20120502_FDF_CRG/20120502_FDF_CRG/20120518_FDF_CRG_c12.mtb	4883	4411	WWFF	food_fat	3	20326	1337352841	1	0.04	0.00266666666666667	10885	1
4	Drink 1	Intake 1	28	21466	1337353981	/users/cn/jespinosa/phecomp/data/CRG/20120502_FDF_CRG/20120502_FDF_CRG/20120518_FDF_CRG_c12.mtb	1917	NA	WWFF	water	1	21438	1337353953	1	0.1	0.00357142857142857	10886	1
4	Food 1	Intake 3	44	24796	1337357311	/users/cn/jespinosa/phecomp/data/CRG/20120502_FDF_CRG/20120502_FDF_CRG/20120518_FDF_CRG_c12.mtb	4897	COLL	WWFF	food_fat	3	24752	1337357267	1	0.24	0.00545454545454545	10887	1
4	Food 2	Intake 4	28	24782	1337357297	/users/cn/jespinosa/phecomp/data/CRG/20120502_FDF_CRG/20120502_FDF_CRG/20120518_FDF_CRG_c12.mtb	6415	572	WWFF	food_fat	4	24754	1337357269	1	0.14	0.005	10888	1
4	Food 1	Intake 3	18	25372	1337357887	/users/cn/jespinosa/phecomp/data/CRG/20120502_FDF_CRG/20120502_FDF_CRG/20120518_FDF_CRG_c12.mtb	4904	3780	WWFF	food_fat	3	25354	1337357869	1	0.0200000000000005	0.00111111111111114	10889	1
4	Drink 1	Intake 1	16	28655	1337361170	/users/cn/jespinosa/phecomp/data/CRG/20120502_FDF_CRG/20120502_FDF_CRG/20120518_FDF_CRG_c12.mtb	1918	NA	WWFF	water	1	28639	1337361154	1	0.14	0.00875	10890	1
4	Food 2	Intake 4	19	29171	1337361686	/users/cn/jespinosa/phecomp/data/CRG/20120502_FDF_CRG/20120502_FDF_CRG/20120518_FDF_CRG_c12.mtb	6417	522	WWFF	food_fat	4	29152	1337361667	1	0.02	0.00105263157894737	10891	1
4	Food 1	Intake 3	40	29733	1337362248	/users/cn/jespinosa/phecomp/data/CRG/20120502_FDF_CRG/20120502_FDF_CRG/20120518_FDF_CRG_c12.mtb	4912	COLL	WWFF	food_fat	3	29693	1337362208	1	0.04	0.001	10892	1
4	Food 2	Intake 4	16	29731	1337362246	/users/cn/jespinosa/phecomp/data/CRG/20120502_FDF_CRG/20120502_FDF_CRG/20120518_FDF_CRG_c12.mtb	6418	752	WWFF	food_fat	4	29715	1337362230	1	0.02	0.00125	10893	1
4	Food 1	Intake 3	60	30543	1337363058	/users/cn/jespinosa/phecomp/data/CRG/20120502_FDF_CRG/20120502_FDF_CRG/20120518_FDF_CRG_c12.mtb	4918	COLL	WWFF	food_fat	3	30483	1337362998	1	0.28	0.00466666666666667	10894	1
4	Food 2	Intake 4	46	30537	1337363052	/users/cn/jespinosa/phecomp/data/CRG/20120502_FDF_CRG/20120502_FDF_CRG/20120518_FDF_CRG_c12.mtb	6420	648	WWFF	food_fat	4	30491	1337363006	1	0.12	0.00260869565217391	10895	1
4	Drink 1	Intake 1	25	31190	1337363705	/users/cn/jespinosa/phecomp/data/CRG/20120502_FDF_CRG/20120502_FDF_CRG/20120518_FDF_CRG_c12.mtb	1919	NA	WWFF	water	1	31165	1337363680	1	0.1	0.004	10896	1
4	Food 1	Intake 3	19	31204	1337363719	/users/cn/jespinosa/phecomp/data/CRG/20120502_FDF_CRG/20120502_FDF_CRG/20120518_FDF_CRG_c12.mtb	4920	1351	WWFF	food_fat	3	31185	1337363700	1	0.0600000000000005	0.00315789473684213	10897	1
4	Food 2	Intake 4	309	32864	1337365379	/users/cn/jespinosa/phecomp/data/CRG/20120502_FDF_CRG/20120502_FDF_CRG/20120518_FDF_CRG_c12.mtb	6422	COLL	WWFF	food_fat	4	32555	1337365070	1	1.08	0.00349514563106796	10898	1
4	Food 1	Intake 3	52	32745	1337365260	/users/cn/jespinosa/phecomp/data/CRG/20120502_FDF_CRG/20120502_FDF_CRG/20120518_FDF_CRG_c12.mtb	4932	63	WWFF	food_fat	3	32693	1337365208	1	0.42	0.00807692307692308	10899	1
4	Food 1	Intake 3	133	32941	1337365456	/users/cn/jespinosa/phecomp/data/CRG/20120502_FDF_CRG/20120502_FDF_CRG/20120518_FDF_CRG_c12.mtb	4933	77	WWFF	food_fat	3	32808	1337365323	1	0.180000000000001	0.00135338345864662	10900	1
4	Food 1	Intake 3	71	33089	1337365604	/users/cn/jespinosa/phecomp/data/CRG/20120502_FDF_CRG/20120502_FDF_CRG/20120518_FDF_CRG_c12.mtb	4934	COLL	WWFF	food_fat	3	33018	1337365533	1	0.54	0.0076056338028169	10901	1
4	Food 2	Intake 4	274	33319	1337365834	/users/cn/jespinosa/phecomp/data/CRG/20120502_FDF_CRG/20120502_FDF_CRG/20120518_FDF_CRG_c12.mtb	6425	COLL	WWFF	food_fat	4	33045	1337365560	1	0.14	0.000510948905109489	10902	1
4	Food 1	Intake 3	100	33195	1337365710	/users/cn/jespinosa/phecomp/data/CRG/20120502_FDF_CRG/20120502_FDF_CRG/20120518_FDF_CRG_c12.mtb	4935	161	WWFF	food_fat	3	33095	1337365610	1	1.02	0.0102	10903	1
4	Food 2	Intake 4	41	33397	1337365912	/users/cn/jespinosa/phecomp/data/CRG/20120502_FDF_CRG/20120502_FDF_CRG/20120518_FDF_CRG_c12.mtb	6426	23	WWFF	food_fat	4	33356	1337365871	1	0.38	0.00926829268292683	10904	1
4	Food 2	Intake 4	720	34140	1337366655	/users/cn/jespinosa/phecomp/data/CRG/20120502_FDF_CRG/20120502_FDF_CRG/20120518_FDF_CRG_c12.mtb	6427	30	WWFF	food_fat	4	33420	1337365935	1	0.04	5.55555555555556e-05	10905	1
4	Food 2	Intake 4	748	34918	1337367433	/users/cn/jespinosa/phecomp/data/CRG/20120502_FDF_CRG/20120502_FDF_CRG/20120518_FDF_CRG_c12.mtb	6428	507	WWFF	food_fat	4	34170	1337366685	1	2.66	0.00355614973262032	10906	1
4	Food 2	Intake 4	536	35961	1337368476	/users/cn/jespinosa/phecomp/data/CRG/20120502_FDF_CRG/20120502_FDF_CRG/20120518_FDF_CRG_c12.mtb	6430	COLL	WWFF	food_fat	4	35425	1337367940	1	1.44	0.0026865671641791	10907	1
4	Drink 1	Intake 1	25	35714	1337368229	/users/cn/jespinosa/phecomp/data/CRG/20120502_FDF_CRG/20120502_FDF_CRG/20120518_FDF_CRG_c12.mtb	1923	NA	WWFF	water	1	35689	1337368204	1	0.02	0.0008	10908	1
4	Food 1	Intake 3	66	35835	1337368350	/users/cn/jespinosa/phecomp/data/CRG/20120502_FDF_CRG/20120502_FDF_CRG/20120518_FDF_CRG_c12.mtb	4938	25	WWFF	food_fat	3	35769	1337368284	1	0.0599999999999996	0.000909090909090903	10909	1
4	Food 1	Intake 3	28	35888	1337368403	/users/cn/jespinosa/phecomp/data/CRG/20120502_FDF_CRG/20120502_FDF_CRG/20120518_FDF_CRG_c12.mtb	4939	35	WWFF	food_fat	3	35860	1337368375	1	0.0200000000000005	0.000714285714285732	10910	1
4	Food 1	Intake 3	31	35954	1337368469	/users/cn/jespinosa/phecomp/data/CRG/20120502_FDF_CRG/20120502_FDF_CRG/20120518_FDF_CRG_c12.mtb	4940	14	WWFF	food_fat	3	35923	1337368438	1	0.0599999999999996	0.00193548387096773	10911	1
4	Food 2	Intake 4	487	36455	1337368970	/users/cn/jespinosa/phecomp/data/CRG/20120502_FDF_CRG/20120502_FDF_CRG/20120518_FDF_CRG_c12.mtb	6431	26	WWFF	food_fat	4	35968	1337368483	1	0.0600000000000005	0.000123203285420946	10912	1
4	Food 2	Intake 4	99	36580	1337369095	/users/cn/jespinosa/phecomp/data/CRG/20120502_FDF_CRG/20120502_FDF_CRG/20120518_FDF_CRG_c12.mtb	6432	429	WWFF	food_fat	4	36481	1337368996	1	0.12	0.00121212121212121	10913	1
4	Drink 2	Intake 2	16	36809	1337369324	/users/cn/jespinosa/phecomp/data/CRG/20120502_FDF_CRG/20120502_FDF_CRG/20120518_FDF_CRG_c12.mtb	1795	NA	WWFF	water	2	36793	1337369308	1	0.02	0.00125	10914	1
4	Food 2	Intake 4	93	37102	1337369617	/users/cn/jespinosa/phecomp/data/CRG/20120502_FDF_CRG/20120502_FDF_CRG/20120518_FDF_CRG_c12.mtb	6435	233	WWFF	food_fat	4	37009	1337369524	1	0.38	0.00408602150537634	10915	1
4	Food 2	Intake 4	141	37476	1337369991	/users/cn/jespinosa/phecomp/data/CRG/20120502_FDF_CRG/20120502_FDF_CRG/20120518_FDF_CRG_c12.mtb	6440	COLL	WWFF	food_fat	4	37335	1337369850	1	0.04	0.000283687943262411	10916	1
4	Food 1	Intake 3	33	37429	1337369944	/users/cn/jespinosa/phecomp/data/CRG/20120502_FDF_CRG/20120502_FDF_CRG/20120518_FDF_CRG_c12.mtb	4942	24	WWFF	food_fat	3	37396	1337369911	1	0.0200000000000005	0.000606060606060621	10917	1
4	Food 1	Intake 3	79	37532	1337370047	/users/cn/jespinosa/phecomp/data/CRG/20120502_FDF_CRG/20120502_FDF_CRG/20120518_FDF_CRG_c12.mtb	4943	COLL	WWFF	food_fat	3	37453	1337369968	1	0.04	0.000506329113924051	10918	1
4	Food 2	Intake 4	41	37540	1337370055	/users/cn/jespinosa/phecomp/data/CRG/20120502_FDF_CRG/20120502_FDF_CRG/20120518_FDF_CRG_c12.mtb	6441	286	WWFF	food_fat	4	37499	1337370014	1	0.04	0.000975609756097561	10919	1
4	Food 2	Intake 4	144	37970	1337370485	/users/cn/jespinosa/phecomp/data/CRG/20120502_FDF_CRG/20120502_FDF_CRG/20120518_FDF_CRG_c12.mtb	6444	78	WWFF	food_fat	4	37826	1337370341	1	0.100000000000001	0.000694444444444451	10920	1
4	Drink 2	Intake 2	20	38046	1337370561	/users/cn/jespinosa/phecomp/data/CRG/20120502_FDF_CRG/20120502_FDF_CRG/20120518_FDF_CRG_c12.mtb	1796	NA	WWFF	water	2	38026	1337370541	1	0.04	0.002	10921	1
4	Food 2	Intake 4	137	38185	1337370700	/users/cn/jespinosa/phecomp/data/CRG/20120502_FDF_CRG/20120502_FDF_CRG/20120518_FDF_CRG_c12.mtb	6446	4	WWFF	food_fat	4	38048	1337370563	1	0.0800000000000001	0.000583941605839417	10922	1
4	Food 1	Intake 3	62	38251	1337370766	/users/cn/jespinosa/phecomp/data/CRG/20120502_FDF_CRG/20120502_FDF_CRG/20120518_FDF_CRG_c12.mtb	4946	COLL	WWFF	food_fat	3	38189	1337370704	1	0.0200000000000005	0.000322580645161298	10923	1
4	Food 2	Intake 4	84	38322	1337370837	/users/cn/jespinosa/phecomp/data/CRG/20120502_FDF_CRG/20120502_FDF_CRG/20120518_FDF_CRG_c12.mtb	6447	280	WWFF	food_fat	4	38238	1337370753	1	0.82	0.00976190476190476	10924	1
4	Food 2	Intake 4	139	38741	1337371256	/users/cn/jespinosa/phecomp/data/CRG/20120502_FDF_CRG/20120502_FDF_CRG/20120518_FDF_CRG_c12.mtb	6451	41	WWFF	food_fat	4	38602	1337371117	1	0.3	0.00215827338129496	10925	1
4	Food 2	Intake 4	308	39090	1337371605	/users/cn/jespinosa/phecomp/data/CRG/20120502_FDF_CRG/20120502_FDF_CRG/20120518_FDF_CRG_c12.mtb	6452	297	WWFF	food_fat	4	38782	1337371297	1	0.0600000000000005	0.000194805194805196	10926	1
4	Drink 2	Intake 2	23	39016	1337371531	/users/cn/jespinosa/phecomp/data/CRG/20120502_FDF_CRG/20120502_FDF_CRG/20120518_FDF_CRG_c12.mtb	1798	NA	WWFF	water	2	38993	1337371508	1	0.02	0.000869565217391304	10927	1
4	Food 2	Intake 4	56	39443	1337371958	/users/cn/jespinosa/phecomp/data/CRG/20120502_FDF_CRG/20120502_FDF_CRG/20120518_FDF_CRG_c12.mtb	6454	130	WWFF	food_fat	4	39387	1337371902	1	0.04	0.000714285714285714	10928	1
4	Food 2	Intake 4	224	39797	1337372312	/users/cn/jespinosa/phecomp/data/CRG/20120502_FDF_CRG/20120502_FDF_CRG/20120518_FDF_CRG_c12.mtb	6457	390	WWFF	food_fat	4	39573	1337372088	1	0.100000000000001	0.000446428571428576	10929	1
4	Food 1	Intake 3	70	40257	1337372772	/users/cn/jespinosa/phecomp/data/CRG/20120502_FDF_CRG/20120502_FDF_CRG/20120518_FDF_CRG_c12.mtb	4950	COLL	WWFF	food_fat	3	40187	1337372702	1	0.0800000000000001	0.00114285714285714	10930	1
4	Food 2	Intake 4	18	40270	1337372785	/users/cn/jespinosa/phecomp/data/CRG/20120502_FDF_CRG/20120502_FDF_CRG/20120518_FDF_CRG_c12.mtb	6460	198	WWFF	food_fat	4	40252	1337372767	1	0.04	0.00222222222222222	10931	1
4	Food 2	Intake 4	113	40581	1337373096	/users/cn/jespinosa/phecomp/data/CRG/20120502_FDF_CRG/20120502_FDF_CRG/20120518_FDF_CRG_c12.mtb	6462	27	WWFF	food_fat	4	40468	1337372983	1	0.0599999999999996	0.00053097345132743	10932	1
4	Food 2	Intake 4	262	40870	1337373385	/users/cn/jespinosa/phecomp/data/CRG/20120502_FDF_CRG/20120502_FDF_CRG/20120518_FDF_CRG_c12.mtb	6463	12	WWFF	food_fat	4	40608	1337373123	1	0.180000000000001	0.000687022900763363	10933	1
4	Drink 1	Intake 1	22	40845	1337373360	/users/cn/jespinosa/phecomp/data/CRG/20120502_FDF_CRG/20120502_FDF_CRG/20120518_FDF_CRG_c12.mtb	1928	NA	WWFF	water	1	40823	1337373338	1	0.04	0.00181818181818182	10934	1
4	Food 2	Intake 4	16	40898	1337373413	/users/cn/jespinosa/phecomp/data/CRG/20120502_FDF_CRG/20120502_FDF_CRG/20120518_FDF_CRG_c12.mtb	6464	555	WWFF	food_fat	4	40882	1337373397	1	0.04	0.0025	10935	1
4	Food 2	Intake 4	25	41478	1337373993	/users/cn/jespinosa/phecomp/data/CRG/20120502_FDF_CRG/20120502_FDF_CRG/20120518_FDF_CRG_c12.mtb	6468	8	WWFF	food_fat	4	41453	1337373968	1	0.04	0.0016	10936	1
4	Drink 1	Intake 1	19	41487	1337374002	/users/cn/jespinosa/phecomp/data/CRG/20120502_FDF_CRG/20120502_FDF_CRG/20120518_FDF_CRG_c12.mtb	1929	NA	WWFF	water	1	41468	1337373983	1	0.02	0.00105263157894737	10937	1
4	Food 2	Intake 4	18	41504	1337374019	/users/cn/jespinosa/phecomp/data/CRG/20120502_FDF_CRG/20120502_FDF_CRG/20120518_FDF_CRG_c12.mtb	6469	5491	WWFF	food_fat	4	41486	1337374001	1	0.0200000000000005	0.00111111111111114	10938	1
4	Drink 1	Intake 1	22	43076	1337375591	/users/cn/jespinosa/phecomp/data/CRG/20120502_FDF_CRG/20120502_FDF_CRG/20120518_FDF_CRG_c12.mtb	1930	NA	WWFF	water	1	43054	1337375569	1	0.0800000000000001	0.00363636363636364	10939	1
4	Drink 1	Intake 1	17	45602	1337378117	/users/cn/jespinosa/phecomp/data/CRG/20120502_FDF_CRG/20120502_FDF_CRG/20120518_FDF_CRG_c12.mtb	1931	NA	WWFF	water	1	45585	1337378100	1	0.02	0.00117647058823529	10940	1
4	Food 1	Intake 3	68	47063	1337379578	/users/cn/jespinosa/phecomp/data/CRG/20120502_FDF_CRG/20120502_FDF_CRG/20120518_FDF_CRG_c12.mtb	4953	133	WWFF	food_fat	3	46995	1337379510	1	0.0800000000000001	0.0011764705882353	10941	1
4	Food 2	Intake 4	265	47461	1337379976	/users/cn/jespinosa/phecomp/data/CRG/20120502_FDF_CRG/20120502_FDF_CRG/20120518_FDF_CRG_c12.mtb	6474	104	WWFF	food_fat	4	47196	1337379711	1	0.360000000000001	0.00135849056603774	10942	1
4	Drink 2	Intake 2	16	47566	1337380081	/users/cn/jespinosa/phecomp/data/CRG/20120502_FDF_CRG/20120502_FDF_CRG/20120518_FDF_CRG_c12.mtb	1800	NA	WWFF	water	2	47550	1337380065	1	0.02	0.00125	10943	1
4	Food 2	Intake 4	57	47622	1337380137	/users/cn/jespinosa/phecomp/data/CRG/20120502_FDF_CRG/20120502_FDF_CRG/20120518_FDF_CRG_c12.mtb	6475	68	WWFF	food_fat	4	47565	1337380080	1	0.0399999999999991	0.000701754385964897	10944	1
4	Food 2	Intake 4	310	48000	1337380515	/users/cn/jespinosa/phecomp/data/CRG/20120502_FDF_CRG/20120502_FDF_CRG/20120518_FDF_CRG_c12.mtb	6476	109	WWFF	food_fat	4	47690	1337380205	1	0.359999999999999	0.00116129032258064	10945	1
4	Food 2	Intake 4	184	48293	1337380808	/users/cn/jespinosa/phecomp/data/CRG/20120502_FDF_CRG/20120502_FDF_CRG/20120518_FDF_CRG_c12.mtb	6477	295	WWFF	food_fat	4	48109	1337380624	1	0.0400000000000009	0.000217391304347831	10946	1
4	Food 2	Intake 4	71	48659	1337381174	/users/cn/jespinosa/phecomp/data/CRG/20120502_FDF_CRG/20120502_FDF_CRG/20120518_FDF_CRG_c12.mtb	6479	192	WWFF	food_fat	4	48588	1337381103	1	0.0400000000000009	0.000563380281690154	10947	1
4	Drink 2	Intake 2	54	48789	1337381304	/users/cn/jespinosa/phecomp/data/CRG/20120502_FDF_CRG/20120502_FDF_CRG/20120518_FDF_CRG_c12.mtb	1802	NA	WWFF	water	2	48735	1337381250	1	0.06	0.00111111111111111	10948	1
4	Food 1	Intake 3	118	48969	1337381484	/users/cn/jespinosa/phecomp/data/CRG/20120502_FDF_CRG/20120502_FDF_CRG/20120518_FDF_CRG_c12.mtb	4958	156	WWFF	food_fat	3	48851	1337381366	1	0.0200000000000005	0.000169491525423733	10949	1
4	Food 2	Intake 4	326	49451	1337381966	/users/cn/jespinosa/phecomp/data/CRG/20120502_FDF_CRG/20120502_FDF_CRG/20120518_FDF_CRG_c12.mtb	6483	171	WWFF	food_fat	4	49125	1337381640	1	0.0600000000000005	0.000184049079754603	10950	1
4	Food 2	Intake 4	30	49652	1337382167	/users/cn/jespinosa/phecomp/data/CRG/20120502_FDF_CRG/20120502_FDF_CRG/20120518_FDF_CRG_c12.mtb	6485	33	WWFF	food_fat	4	49622	1337382137	1	0.24	0.008	10951	1
4	Food 2	Intake 4	131	49816	1337382331	/users/cn/jespinosa/phecomp/data/CRG/20120502_FDF_CRG/20120502_FDF_CRG/20120518_FDF_CRG_c12.mtb	6486	760	WWFF	food_fat	4	49685	1337382200	1	0.0800000000000001	0.000610687022900764	10952	1
4	Drink 1	Intake 1	45	50444	1337382959	/users/cn/jespinosa/phecomp/data/CRG/20120502_FDF_CRG/20120502_FDF_CRG/20120518_FDF_CRG_c12.mtb	1932	NA	WWFF	water	1	50399	1337382914	1	0.02	0.000444444444444444	10953	1
4	Food 2	Intake 4	224	50800	1337383315	/users/cn/jespinosa/phecomp/data/CRG/20120502_FDF_CRG/20120502_FDF_CRG/20120518_FDF_CRG_c12.mtb	6490	559	WWFF	food_fat	4	50576	1337383091	1	0.0200000000000014	8.92857142857205e-05	10954	1
4	Food 2	Intake 4	24	51383	1337383898	/users/cn/jespinosa/phecomp/data/CRG/20120502_FDF_CRG/20120502_FDF_CRG/20120518_FDF_CRG_c12.mtb	6493	2460	WWFF	food_fat	4	51359	1337383874	1	0.260000000000002	0.0108333333333334	10955	1
4	Drink 1	Intake 1	14	53844	1337386359	/users/cn/jespinosa/phecomp/data/CRG/20120502_FDF_CRG/20120502_FDF_CRG/20120518_FDF_CRG_c12.mtb	1934	NA	WWFF	water	1	53830	1337386345	1	0.0399999999999998	0.00285714285714284	10956	1
4	Food 2	Intake 4	9	53852	1337386367	/users/cn/jespinosa/phecomp/data/CRG/20120502_FDF_CRG/20120502_FDF_CRG/20120518_FDF_CRG_c12.mtb	6501	2087	WWFF	food_fat	4	53843	1337386358	1	0.0399999999999991	0.00444444444444434	10957	1
4	Drink 1	Intake 1	22	55612	1337388127	/users/cn/jespinosa/phecomp/data/CRG/20120502_FDF_CRG/20120502_FDF_CRG/20120518_FDF_CRG_c12.mtb	1935	NA	WWFF	water	1	55590	1337388105	1	0.0800000000000001	0.00363636363636364	10958	1
4	Food 2	Intake 4	33	55972	1337388487	/users/cn/jespinosa/phecomp/data/CRG/20120502_FDF_CRG/20120502_FDF_CRG/20120518_FDF_CRG_c12.mtb	6504	2773	WWFF	food_fat	4	55939	1337388454	1	0.0400000000000009	0.00121212121212124	10959	1
4	Drink 2	Intake 2	17	57771	1337390286	/users/cn/jespinosa/phecomp/data/CRG/20120502_FDF_CRG/20120502_FDF_CRG/20120518_FDF_CRG_c12.mtb	1807	NA	WWFF	water	2	57754	1337390269	1	0.02	0.00117647058823529	10960	1
4	Food 2	Intake 4	20	58765	1337391280	/users/cn/jespinosa/phecomp/data/CRG/20120502_FDF_CRG/20120502_FDF_CRG/20120518_FDF_CRG_c12.mtb	6511	2679	WWFF	food_fat	4	58745	1337391260	1	0.0200000000000014	0.00100000000000007	10961	1
4	Food 2	Intake 4	261	61705	1337394220	/users/cn/jespinosa/phecomp/data/CRG/20120502_FDF_CRG/20120502_FDF_CRG/20120518_FDF_CRG_c12.mtb	6522	20	WWFF	food_fat	4	61444	1337393959	1	0.620000000000001	0.00237547892720307	10962	1
4	Food 2	Intake 4	92	61817	1337394332	/users/cn/jespinosa/phecomp/data/CRG/20120502_FDF_CRG/20120502_FDF_CRG/20120518_FDF_CRG_c12.mtb	6523	27	WWFF	food_fat	4	61725	1337394240	1	0.18	0.00195652173913043	10963	1
4	Drink 1	Intake 1	16	61750	1337394265	/users/cn/jespinosa/phecomp/data/CRG/20120502_FDF_CRG/20120502_FDF_CRG/20120518_FDF_CRG_c12.mtb	1937	NA	WWFF	water	1	61734	1337394249	1	0.02	0.00125	10964	1
4	Food 2	Intake 4	109	61953	1337394468	/users/cn/jespinosa/phecomp/data/CRG/20120502_FDF_CRG/20120502_FDF_CRG/20120518_FDF_CRG_c12.mtb	6524	COLL	WWFF	food_fat	4	61844	1337394359	1	0.0999999999999996	0.000917431192660547	10965	1
4	Food 1	Intake 3	93	61953	1337394468	/users/cn/jespinosa/phecomp/data/CRG/20120502_FDF_CRG/20120502_FDF_CRG/20120518_FDF_CRG_c12.mtb	4964	31	WWFF	food_fat	3	61860	1337394375	1	0.0600000000000005	0.000645161290322586	10966	1
4	Drink 1	Intake 1	14	61990	1337394505	/users/cn/jespinosa/phecomp/data/CRG/20120502_FDF_CRG/20120502_FDF_CRG/20120518_FDF_CRG_c12.mtb	1938	NA	WWFF	water	1	61976	1337394491	1	0.02	0.00142857142857143	10967	1
4	Food 2	Intake 4	295	62279	1337394794	/users/cn/jespinosa/phecomp/data/CRG/20120502_FDF_CRG/20120502_FDF_CRG/20120518_FDF_CRG_c12.mtb	6525	2570	WWFF	food_fat	4	61984	1337394499	1	0.0999999999999996	0.000338983050847456	10968	1
4	Drink 2	Intake 2	11	62085	1337394600	/users/cn/jespinosa/phecomp/data/CRG/20120502_FDF_CRG/20120502_FDF_CRG/20120518_FDF_CRG_c12.mtb	1808	NA	WWFF	water	2	62074	1337394589	1	0.04	0.00363636363636364	10969	1
4	Drink 1	Intake 1	19	62183	1337394698	/users/cn/jespinosa/phecomp/data/CRG/20120502_FDF_CRG/20120502_FDF_CRG/20120518_FDF_CRG_c12.mtb	1939	NA	WWFF	water	1	62164	1337394679	1	0.04	0.00210526315789474	10970	1
4	Drink 2	Intake 2	19	62423	1337394938	/users/cn/jespinosa/phecomp/data/CRG/20120502_FDF_CRG/20120502_FDF_CRG/20120518_FDF_CRG_c12.mtb	1809	NA	WWFF	water	2	62404	1337394919	1	0.06	0.00315789473684211	10971	1
4	Drink 2	Intake 2	17	63013	1337395528	/users/cn/jespinosa/phecomp/data/CRG/20120502_FDF_CRG/20120502_FDF_CRG/20120518_FDF_CRG_c12.mtb	1810	NA	WWFF	water	2	62996	1337395511	1	0.04	0.00235294117647059	10972	1
4	Food 2	Intake 4	30	64879	1337397394	/users/cn/jespinosa/phecomp/data/CRG/20120502_FDF_CRG/20120502_FDF_CRG/20120518_FDF_CRG_c12.mtb	6531	906	WWFF	food_fat	4	64849	1337397364	1	0.0200000000000014	0.000666666666666713	10973	1
4	Food 2	Intake 4	18	65803	1337398318	/users/cn/jespinosa/phecomp/data/CRG/20120502_FDF_CRG/20120502_FDF_CRG/20120518_FDF_CRG_c12.mtb	6534	1204	WWFF	food_fat	4	65785	1337398300	1	0.0399999999999991	0.00222222222222217	10974	1
4	Food 2	Intake 4	32	67039	1337399554	/users/cn/jespinosa/phecomp/data/CRG/20120502_FDF_CRG/20120502_FDF_CRG/20120518_FDF_CRG_c12.mtb	6539	1973	WWFF	food_fat	4	67007	1337399522	1	0.0200000000000014	0.000625000000000044	10975	1
4	Drink 1	Intake 1	15	67327	1337399842	/users/cn/jespinosa/phecomp/data/CRG/20120502_FDF_CRG/20120502_FDF_CRG/20120518_FDF_CRG_c12.mtb	1940	NA	WWFF	water	1	67312	1337399827	1	0.02	0.00133333333333333	10976	1
4	Food 2	Intake 4	24	69036	1337401551	/users/cn/jespinosa/phecomp/data/CRG/20120502_FDF_CRG/20120502_FDF_CRG/20120518_FDF_CRG_c12.mtb	6546	1251	WWFF	food_fat	4	69012	1337401527	1	0.0200000000000014	0.000833333333333392	10977	1
4	Food 2	Intake 4	129	70416	1337402931	/users/cn/jespinosa/phecomp/data/CRG/20120502_FDF_CRG/20120502_FDF_CRG/20120518_FDF_CRG_c12.mtb	6552	159	WWFF	food_fat	4	70287	1337402802	1	0.0800000000000001	0.000620155038759691	10978	1
4	Drink 2	Intake 2	42	70420	1337402935	/users/cn/jespinosa/phecomp/data/CRG/20120502_FDF_CRG/20120502_FDF_CRG/20120518_FDF_CRG_c12.mtb	1811	NA	WWFF	water	2	70378	1337402893	1	0.02	0.000476190476190476	10979	1
4	Drink 2	Intake 2	30	70496	1337403011	/users/cn/jespinosa/phecomp/data/CRG/20120502_FDF_CRG/20120502_FDF_CRG/20120518_FDF_CRG_c12.mtb	1812	NA	WWFF	water	2	70466	1337402981	1	0.02	0.000666666666666667	10980	1
4	Food 2	Intake 4	25	70600	1337403115	/users/cn/jespinosa/phecomp/data/CRG/20120502_FDF_CRG/20120502_FDF_CRG/20120518_FDF_CRG_c12.mtb	6554	11	WWFF	food_fat	4	70575	1337403090	1	0.0599999999999987	0.00239999999999995	10981	1
4	Food 2	Intake 4	375	70986	1337403501	/users/cn/jespinosa/phecomp/data/CRG/20120502_FDF_CRG/20120502_FDF_CRG/20120518_FDF_CRG_c12.mtb	6555	42	WWFF	food_fat	4	70611	1337403126	1	0.200000000000001	0.000533333333333336	10982	1
4	Food 2	Intake 4	164	71192	1337403707	/users/cn/jespinosa/phecomp/data/CRG/20120502_FDF_CRG/20120502_FDF_CRG/20120518_FDF_CRG_c12.mtb	6556	29	WWFF	food_fat	4	71028	1337403543	1	0.0999999999999996	0.000609756097560973	10983	1
4	Food 2	Intake 4	65	71286	1337403801	/users/cn/jespinosa/phecomp/data/CRG/20120502_FDF_CRG/20120502_FDF_CRG/20120518_FDF_CRG_c12.mtb	6557	544	WWFF	food_fat	4	71221	1337403736	1	0.0600000000000005	0.000923076923076931	10984	1
4	Drink 1	Intake 1	23	71324	1337403839	/users/cn/jespinosa/phecomp/data/CRG/20120502_FDF_CRG/20120502_FDF_CRG/20120518_FDF_CRG_c12.mtb	1943	NA	WWFF	water	1	71301	1337403816	1	0.0800000000000001	0.00347826086956522	10985	1
4	Drink 1	Intake 1	16	71720	1337404235	/users/cn/jespinosa/phecomp/data/CRG/20120502_FDF_CRG/20120502_FDF_CRG/20120518_FDF_CRG_c12.mtb	1944	NA	WWFF	water	1	71704	1337404219	1	0.02	0.00125	10986	1
4	Food 2	Intake 4	134	71964	1337404479	/users/cn/jespinosa/phecomp/data/CRG/20120502_FDF_CRG/20120502_FDF_CRG/20120518_FDF_CRG_c12.mtb	6561	269	WWFF	food_fat	4	71830	1337404345	1	0.0599999999999987	0.000447761194029841	10987	1
4	Food 2	Intake 4	101	72334	1337404849	/users/cn/jespinosa/phecomp/data/CRG/20120502_FDF_CRG/20120502_FDF_CRG/20120518_FDF_CRG_c12.mtb	6564	916	WWFF	food_fat	4	72233	1337404748	1	0.140000000000001	0.0013861386138614	10988	1
4	Food 1	Intake 3	105	73355	1337405870	/users/cn/jespinosa/phecomp/data/CRG/20120502_FDF_CRG/20120502_FDF_CRG/20120518_FDF_CRG_c12.mtb	4974	COLL	WWFF	food_fat	3	73250	1337405765	1	0.0200000000000005	0.000190476190476195	10989	1
4	Food 2	Intake 4	28	73356	1337405871	/users/cn/jespinosa/phecomp/data/CRG/20120502_FDF_CRG/20120502_FDF_CRG/20120518_FDF_CRG_c12.mtb	6571	1236	WWFF	food_fat	4	73328	1337405843	1	0.0400000000000009	0.00142857142857146	10990	1
4	Food 2	Intake 4	9	74601	1337407116	/users/cn/jespinosa/phecomp/data/CRG/20120502_FDF_CRG/20120502_FDF_CRG/20120518_FDF_CRG_c12.mtb	6579	3479	WWFF	food_fat	4	74592	1337407107	1	0.0200000000000014	0.00222222222222238	10991	1
4	Drink 1	Intake 1	20	77055	1337409570	/users/cn/jespinosa/phecomp/data/CRG/20120502_FDF_CRG/20120502_FDF_CRG/20120518_FDF_CRG_c12.mtb	1945	NA	WWFF	water	1	77035	1337409550	1	0.04	0.002	10992	1
4	Food 2	Intake 4	12	78092	1337410607	/users/cn/jespinosa/phecomp/data/CRG/20120502_FDF_CRG/20120502_FDF_CRG/20120518_FDF_CRG_c12.mtb	6584	3462	WWFF	food_fat	4	78080	1337410595	1	0.0399999999999991	0.00333333333333326	10993	1
4	Drink 1	Intake 1	19	78299	1337410814	/users/cn/jespinosa/phecomp/data/CRG/20120502_FDF_CRG/20120502_FDF_CRG/20120518_FDF_CRG_c12.mtb	1946	NA	WWFF	water	1	78280	1337410795	1	0.0600000000000001	0.00315789473684211	10994	1
4	Drink 1	Intake 1	21	78989	1337411504	/users/cn/jespinosa/phecomp/data/CRG/20120502_FDF_CRG/20120502_FDF_CRG/20120518_FDF_CRG_c12.mtb	1947	NA	WWFF	water	1	78968	1337411483	1	0.04	0.0019047619047619	10995	1
4	Drink 1	Intake 1	22	80186	1337412701	/users/cn/jespinosa/phecomp/data/CRG/20120502_FDF_CRG/20120502_FDF_CRG/20120518_FDF_CRG_c12.mtb	1948	NA	WWFF	water	1	80164	1337412679	1	0.0999999999999999	0.00454545454545454	10996	1
4	Food 2	Intake 4	23	81577	1337414092	/users/cn/jespinosa/phecomp/data/CRG/20120502_FDF_CRG/20120502_FDF_CRG/20120518_FDF_CRG_c12.mtb	6587	10327	WWFF	food_fat	4	81554	1337414069	1	0.0200000000000014	0.000869565217391365	10997	1
4	Drink 1	Intake 1	23	86051	1337418566	/users/cn/jespinosa/phecomp/data/CRG/20120502_FDF_CRG/20120502_FDF_CRG/20120518_FDF_CRG_c12.mtb	1949	NA	WWFF	water	1	86028	1337418543	1	0.0800000000000001	0.00347826086956522	10998	1
4	Drink 1	Intake 1	23	86955	1337419470	/users/cn/jespinosa/phecomp/data/CRG/20120502_FDF_CRG/20120502_FDF_CRG/20120518_FDF_CRG_c12.mtb	1950	NA	WWFF	water	1	86932	1337419447	1	0.0599999999999998	0.0026086956521739	10999	1
4	Drink 1	Intake 1	25	87849	1337420364	/users/cn/jespinosa/phecomp/data/CRG/20120502_FDF_CRG/20120502_FDF_CRG/20120518_FDF_CRG_c12.mtb	1951	NA	WWFF	water	1	87824	1337420339	1	0.1	0.004	11000	1
4	Drink 1	Intake 1	41	91071	1337423586	/users/cn/jespinosa/phecomp/data/CRG/20120502_FDF_CRG/20120502_FDF_CRG/20120518_FDF_CRG_c12.mtb	1953	NA	WWFF	water	1	91030	1337423545	1	0.02	0.00048780487804878	11001	1
4	Drink 2	Intake 2	26	91302	1337423817	/users/cn/jespinosa/phecomp/data/CRG/20120502_FDF_CRG/20120502_FDF_CRG/20120518_FDF_CRG_c12.mtb	1815	NA	WWFF	water	2	91276	1337423791	1	0.04	0.00153846153846154	11002	1
4	Food 2	Intake 4	15	91919	1337424434	/users/cn/jespinosa/phecomp/data/CRG/20120502_FDF_CRG/20120502_FDF_CRG/20120518_FDF_CRG_c12.mtb	6606	201	WWFF	food_fat	4	91904	1337424419	1	0.0399999999999991	0.00266666666666661	11003	1
4	Food 2	Intake 4	18	92138	1337424653	/users/cn/jespinosa/phecomp/data/CRG/20120502_FDF_CRG/20120502_FDF_CRG/20120518_FDF_CRG_c12.mtb	6608	739	WWFF	food_fat	4	92120	1337424635	1	0.0200000000000014	0.00111111111111119	11004	1
4	Food 2	Intake 4	13	92890	1337425405	/users/cn/jespinosa/phecomp/data/CRG/20120502_FDF_CRG/20120502_FDF_CRG/20120518_FDF_CRG_c12.mtb	6617	397	WWFF	food_fat	4	92877	1337425392	1	0.0200000000000014	0.00153846153846165	11005	1
4	Drink 2	Intake 2	13	93243	1337425758	/users/cn/jespinosa/phecomp/data/CRG/20120502_FDF_CRG/20120502_FDF_CRG/20120518_FDF_CRG_c12.mtb	1817	NA	WWFF	water	2	93230	1337425745	1	0.02	0.00153846153846154	11006	1
4	Food 2	Intake 4	25	93312	1337425827	/users/cn/jespinosa/phecomp/data/CRG/20120502_FDF_CRG/20120502_FDF_CRG/20120518_FDF_CRG_c12.mtb	6622	266	WWFF	food_fat	4	93287	1337425802	1	0.0399999999999991	0.00159999999999996	11007	1
4	Food 2	Intake 4	15	93593	1337426108	/users/cn/jespinosa/phecomp/data/CRG/20120502_FDF_CRG/20120502_FDF_CRG/20120518_FDF_CRG_c12.mtb	6625	46	WWFF	food_fat	4	93578	1337426093	1	0.0200000000000014	0.00133333333333343	11008	1
4	Food 2	Intake 4	17	93656	1337426171	/users/cn/jespinosa/phecomp/data/CRG/20120502_FDF_CRG/20120502_FDF_CRG/20120518_FDF_CRG_c12.mtb	6626	3714	WWFF	food_fat	4	93639	1337426154	1	0.0599999999999987	0.00352941176470581	11009	1
4	Food 2	Intake 4	44	97414	1337429929	/users/cn/jespinosa/phecomp/data/CRG/20120502_FDF_CRG/20120502_FDF_CRG/20120518_FDF_CRG_c12.mtb	6628	10989	WWFF	food_fat	4	97370	1337429885	1	0.0200000000000014	0.000454545454545486	11010	1
4	Drink 1	Intake 1	31	99962	1337432477	/users/cn/jespinosa/phecomp/data/CRG/20120502_FDF_CRG/20120502_FDF_CRG/20120518_FDF_CRG_c12.mtb	1955	NA	WWFF	water	1	99931	1337432446	1	0.16	0.00516129032258065	11011	1
4	Drink 1	Intake 1	19	100995	1337433510	/users/cn/jespinosa/phecomp/data/CRG/20120502_FDF_CRG/20120502_FDF_CRG/20120518_FDF_CRG_c12.mtb	1956	NA	WWFF	water	1	100976	1337433491	1	0.0600000000000001	0.00315789473684211	11012	1
4	Drink 1	Intake 1	17	102018	1337434533	/users/cn/jespinosa/phecomp/data/CRG/20120502_FDF_CRG/20120502_FDF_CRG/20120518_FDF_CRG_c12.mtb	1957	NA	WWFF	water	1	102001	1337434516	1	0.04	0.00235294117647059	11013	1
4	Drink 1	Intake 1	30	104878	1337437393	/users/cn/jespinosa/phecomp/data/CRG/20120502_FDF_CRG/20120502_FDF_CRG/20120518_FDF_CRG_c12.mtb	1958	NA	WWFF	water	1	104848	1337437363	1	0.14	0.00466666666666667	11014	1
4	Drink 2	Intake 2	18	108177	1337440692	/users/cn/jespinosa/phecomp/data/CRG/20120502_FDF_CRG/20120502_FDF_CRG/20120518_FDF_CRG_c12.mtb	1820	NA	WWFF	water	2	108159	1337440674	1	0.04	0.00222222222222222	11015	1
4	Food 2	Intake 4	39	108442	1337440957	/users/cn/jespinosa/phecomp/data/CRG/20120502_FDF_CRG/20120502_FDF_CRG/20120518_FDF_CRG_c12.mtb	6640	2480	WWFF	food_fat	4	108403	1337440918	1	0.0399999999999991	0.001025641025641	11016	1
4	Food 2	Intake 4	18	110940	1337443455	/users/cn/jespinosa/phecomp/data/CRG/20120502_FDF_CRG/20120502_FDF_CRG/20120518_FDF_CRG_c12.mtb	6649	7853	WWFF	food_fat	4	110922	1337443437	1	0.0200000000000014	0.00111111111111119	11017	1
4	Drink 1	Intake 1	16	110942	1337443457	/users/cn/jespinosa/phecomp/data/CRG/20120502_FDF_CRG/20120502_FDF_CRG/20120518_FDF_CRG_c12.mtb	1959	NA	WWFF	water	1	110926	1337443441	1	0.04	0.0025	11018	1
4	Drink 1	Intake 1	25	112458	1337444973	/users/cn/jespinosa/phecomp/data/CRG/20120502_FDF_CRG/20120502_FDF_CRG/20120518_FDF_CRG_c12.mtb	1960	NA	WWFF	water	1	112433	1337444948	1	0.0800000000000001	0.0032	11019	1
4	Drink 1	Intake 1	23	115035	1337447550	/users/cn/jespinosa/phecomp/data/CRG/20120502_FDF_CRG/20120502_FDF_CRG/20120518_FDF_CRG_c12.mtb	1961	NA	WWFF	water	1	115012	1337447527	1	0.0800000000000001	0.00347826086956522	11020	1
4	Drink 1	Intake 1	17	116818	1337449333	/users/cn/jespinosa/phecomp/data/CRG/20120502_FDF_CRG/20120502_FDF_CRG/20120518_FDF_CRG_c12.mtb	1962	NA	WWFF	water	1	116801	1337449316	1	0.04	0.00235294117647059	11021	1
4	Drink 1	Intake 1	25	117415	1337449930	/users/cn/jespinosa/phecomp/data/CRG/20120502_FDF_CRG/20120502_FDF_CRG/20120518_FDF_CRG_c12.mtb	1963	NA	WWFF	water	1	117390	1337449905	1	0.0999999999999996	0.00399999999999998	11022	1
4	Food 1	Intake 3	17	118810	1337451325	/users/cn/jespinosa/phecomp/data/CRG/20120502_FDF_CRG/20120502_FDF_CRG/20120518_FDF_CRG_c12.mtb	4977	69	WWFF	food_fat	3	118793	1337451308	1	0.0200000000000005	0.00117647058823532	11023	1
4	Food 2	Intake 4	65	118944	1337451459	/users/cn/jespinosa/phecomp/data/CRG/20120502_FDF_CRG/20120502_FDF_CRG/20120518_FDF_CRG_c12.mtb	6658	7	WWFF	food_fat	4	118879	1337451394	1	0.0200000000000014	0.000307692307692329	11024	1
4	Food 2	Intake 4	224	119175	1337451690	/users/cn/jespinosa/phecomp/data/CRG/20120502_FDF_CRG/20120502_FDF_CRG/20120518_FDF_CRG_c12.mtb	6659	380	WWFF	food_fat	4	118951	1337451466	1	0.0800000000000001	0.000357142857142858	11025	1
4	Food 2	Intake 4	137	119692	1337452207	/users/cn/jespinosa/phecomp/data/CRG/20120502_FDF_CRG/20120502_FDF_CRG/20120518_FDF_CRG_c12.mtb	6663	171	WWFF	food_fat	4	119555	1337452070	1	0.0800000000000001	0.000583941605839417	11026	1
4	Food 2	Intake 4	39	119902	1337452417	/users/cn/jespinosa/phecomp/data/CRG/20120502_FDF_CRG/20120502_FDF_CRG/20120518_FDF_CRG_c12.mtb	6665	87	WWFF	food_fat	4	119863	1337452378	1	0.0200000000000014	0.000512820512820549	11027	1
4	Food 2	Intake 4	194	120183	1337452698	/users/cn/jespinosa/phecomp/data/CRG/20120502_FDF_CRG/20120502_FDF_CRG/20120518_FDF_CRG_c12.mtb	6667	COLL	WWFF	food_fat	4	119989	1337452504	1	0.0999999999999996	0.000515463917525771	11028	1
4	Food 1	Intake 3	118	120179	1337452694	/users/cn/jespinosa/phecomp/data/CRG/20120502_FDF_CRG/20120502_FDF_CRG/20120518_FDF_CRG_c12.mtb	4984	71	WWFF	food_fat	3	120061	1337452576	1	0.0399999999999991	0.00033898305084745	11029	1
4	Food 2	Intake 4	79	120329	1337452844	/users/cn/jespinosa/phecomp/data/CRG/20120502_FDF_CRG/20120502_FDF_CRG/20120518_FDF_CRG_c12.mtb	6668	382	WWFF	food_fat	4	120250	1337452765	1	0.0399999999999991	0.000506329113924039	11030	1
4	Drink 1	Intake 1	33	120460	1337452975	/users/cn/jespinosa/phecomp/data/CRG/20120502_FDF_CRG/20120502_FDF_CRG/20120518_FDF_CRG_c12.mtb	1967	NA	WWFF	water	1	120427	1337452942	1	0.0200000000000005	0.000606060606060621	11031	1
4	Food 2	Intake 4	210	120921	1337453436	/users/cn/jespinosa/phecomp/data/CRG/20120502_FDF_CRG/20120502_FDF_CRG/20120518_FDF_CRG_c12.mtb	6672	59	WWFF	food_fat	4	120711	1337453226	1	0.0200000000000014	9.52380952381019e-05	11032	1
4	Food 1	Intake 3	127	121107	1337453622	/users/cn/jespinosa/phecomp/data/CRG/20120502_FDF_CRG/20120502_FDF_CRG/20120518_FDF_CRG_c12.mtb	4985	859	WWFF	food_fat	3	120980	1337453495	1	0.0200000000000005	0.000157480314960634	11033	1
4	Food 2	Intake 4	348	122314	1337454829	/users/cn/jespinosa/phecomp/data/CRG/20120502_FDF_CRG/20120502_FDF_CRG/20120518_FDF_CRG_c12.mtb	6676	COLL	WWFF	food_fat	4	121966	1337454481	1	0.0600000000000005	0.00017241379310345	11034	1
4	Food 1	Intake 3	36	122301	1337454816	/users/cn/jespinosa/phecomp/data/CRG/20120502_FDF_CRG/20120502_FDF_CRG/20120518_FDF_CRG_c12.mtb	4987	138	WWFF	food_fat	3	122265	1337454780	1	0.0200000000000005	0.000555555555555569	11035	1
4	Food 2	Intake 4	147	122586	1337455101	/users/cn/jespinosa/phecomp/data/CRG/20120502_FDF_CRG/20120502_FDF_CRG/20120518_FDF_CRG_c12.mtb	6678	120	WWFF	food_fat	4	122439	1337454954	1	0.0599999999999987	0.000408163265306114	11036	1
4	Food 2	Intake 4	30	122736	1337455251	/users/cn/jespinosa/phecomp/data/CRG/20120502_FDF_CRG/20120502_FDF_CRG/20120518_FDF_CRG_c12.mtb	6680	18	WWFF	food_fat	4	122706	1337455221	1	0.0200000000000014	0.000666666666666713	11037	1
4	Food 2	Intake 4	91	122845	1337455360	/users/cn/jespinosa/phecomp/data/CRG/20120502_FDF_CRG/20120502_FDF_CRG/20120518_FDF_CRG_c12.mtb	6681	41	WWFF	food_fat	4	122754	1337455269	1	0.0399999999999991	0.00043956043956043	11038	1
4	Food 2	Intake 4	101	122987	1337455502	/users/cn/jespinosa/phecomp/data/CRG/20120502_FDF_CRG/20120502_FDF_CRG/20120518_FDF_CRG_c12.mtb	6682	1439	WWFF	food_fat	4	122886	1337455401	1	0.0400000000000009	0.000396039603960405	11039	1
4	Food 2	Intake 4	237	124663	1337457178	/users/cn/jespinosa/phecomp/data/CRG/20120502_FDF_CRG/20120502_FDF_CRG/20120518_FDF_CRG_c12.mtb	6693	648	WWFF	food_fat	4	124426	1337456941	1	0.26	0.00109704641350211	11040	1
4	Food 2	Intake 4	19	125330	1337457845	/users/cn/jespinosa/phecomp/data/CRG/20120502_FDF_CRG/20120502_FDF_CRG/20120518_FDF_CRG_c12.mtb	6697	2445	WWFF	food_fat	4	125311	1337457826	1	0.0200000000000014	0.00105263157894744	11041	1
4	Drink 1	Intake 1	19	127123	1337459638	/users/cn/jespinosa/phecomp/data/CRG/20120502_FDF_CRG/20120502_FDF_CRG/20120518_FDF_CRG_c12.mtb	1970	NA	WWFF	water	1	127104	1337459619	1	0.0599999999999996	0.00315789473684208	11042	1
4	Food 2	Intake 4	84	127859	1337460374	/users/cn/jespinosa/phecomp/data/CRG/20120502_FDF_CRG/20120502_FDF_CRG/20120518_FDF_CRG_c12.mtb	6707	61	WWFF	food_fat	4	127775	1337460290	1	0.0999999999999996	0.00119047619047619	11043	1
4	Food 2	Intake 4	191	128111	1337460626	/users/cn/jespinosa/phecomp/data/CRG/20120502_FDF_CRG/20120502_FDF_CRG/20120518_FDF_CRG_c12.mtb	6708	9	WWFF	food_fat	4	127920	1337460435	1	0.0800000000000001	0.000418848167539268	11044	1
4	Food 2	Intake 4	104	128224	1337460739	/users/cn/jespinosa/phecomp/data/CRG/20120502_FDF_CRG/20120502_FDF_CRG/20120518_FDF_CRG_c12.mtb	6709	270	WWFF	food_fat	4	128120	1337460635	1	0.140000000000001	0.00134615384615386	11045	1
4	Food 2	Intake 4	36	128530	1337461045	/users/cn/jespinosa/phecomp/data/CRG/20120502_FDF_CRG/20120502_FDF_CRG/20120518_FDF_CRG_c12.mtb	6712	21	WWFF	food_fat	4	128494	1337461009	1	0.120000000000001	0.00333333333333336	11046	1
4	Drink 1	Intake 1	53	128565	1337461080	/users/cn/jespinosa/phecomp/data/CRG/20120502_FDF_CRG/20120502_FDF_CRG/20120518_FDF_CRG_c12.mtb	1972	NA	WWFF	water	1	128512	1337461027	1	0.02	0.000377358490566038	11047	1
4	Food 2	Intake 4	323	128874	1337461389	/users/cn/jespinosa/phecomp/data/CRG/20120502_FDF_CRG/20120502_FDF_CRG/20120518_FDF_CRG_c12.mtb	6713	COLL	WWFF	food_fat	4	128551	1337461066	1	0.0800000000000001	0.000247678018575852	11048	1
4	Food 1	Intake 3	95	128651	1337461166	/users/cn/jespinosa/phecomp/data/CRG/20120502_FDF_CRG/20120502_FDF_CRG/20120518_FDF_CRG_c12.mtb	4998	259	WWFF	food_fat	3	128556	1337461071	1	0.04	0.000421052631578947	11049	1
4	Food 2	Intake 4	131	129041	1337461556	/users/cn/jespinosa/phecomp/data/CRG/20120502_FDF_CRG/20120502_FDF_CRG/20120518_FDF_CRG_c12.mtb	6714	6	WWFF	food_fat	4	128910	1337461425	1	0.0800000000000001	0.000610687022900764	11050	1
4	Food 2	Intake 4	208	129255	1337461770	/users/cn/jespinosa/phecomp/data/CRG/20120502_FDF_CRG/20120502_FDF_CRG/20120518_FDF_CRG_c12.mtb	6715	COLL	WWFF	food_fat	4	129047	1337461562	1	0.619999999999999	0.00298076923076923	11051	1
4	Food 1	Intake 3	28	129234	1337461749	/users/cn/jespinosa/phecomp/data/CRG/20120502_FDF_CRG/20120502_FDF_CRG/20120518_FDF_CRG_c12.mtb	5002	102	WWFF	food_fat	3	129206	1337461721	1	0.0200000000000005	0.000714285714285732	11052	1
4	Food 2	Intake 4	99	129435	1337461950	/users/cn/jespinosa/phecomp/data/CRG/20120502_FDF_CRG/20120502_FDF_CRG/20120518_FDF_CRG_c12.mtb	6716	COLL	WWFF	food_fat	4	129336	1337461851	1	0.0800000000000001	0.000808080808080809	11053	1
4	Food 1	Intake 3	109	129518	1337462033	/users/cn/jespinosa/phecomp/data/CRG/20120502_FDF_CRG/20120502_FDF_CRG/20120518_FDF_CRG_c12.mtb	5003	COLL	WWFF	food_fat	3	129409	1337461924	1	0.04	0.00036697247706422	11054	1
4	Food 2	Intake 4	21	129512	1337462027	/users/cn/jespinosa/phecomp/data/CRG/20120502_FDF_CRG/20120502_FDF_CRG/20120518_FDF_CRG_c12.mtb	6718	206	WWFF	food_fat	4	129491	1337462006	1	0.0400000000000009	0.00190476190476195	11055	1
4	Food 2	Intake 4	57	129775	1337462290	/users/cn/jespinosa/phecomp/data/CRG/20120502_FDF_CRG/20120502_FDF_CRG/20120518_FDF_CRG_c12.mtb	6722	46	WWFF	food_fat	4	129718	1337462233	1	0.0600000000000005	0.00105263157894738	11056	1
4	Food 2	Intake 4	13	129834	1337462349	/users/cn/jespinosa/phecomp/data/CRG/20120502_FDF_CRG/20120502_FDF_CRG/20120518_FDF_CRG_c12.mtb	6724	136	WWFF	food_fat	4	129821	1337462336	1	0.0400000000000009	0.00307692307692315	11057	1
4	Food 2	Intake 4	41	130011	1337462526	/users/cn/jespinosa/phecomp/data/CRG/20120502_FDF_CRG/20120502_FDF_CRG/20120518_FDF_CRG_c12.mtb	6727	18	WWFF	food_fat	4	129970	1337462485	1	0.16	0.00390243902439024	11058	1
4	Food 2	Intake 4	51	130080	1337462595	/users/cn/jespinosa/phecomp/data/CRG/20120502_FDF_CRG/20120502_FDF_CRG/20120518_FDF_CRG_c12.mtb	6728	791	WWFF	food_fat	4	130029	1337462544	1	0.0200000000000014	0.000392156862745125	11059	1
4	Drink 1	Intake 1	23	130166	1337462681	/users/cn/jespinosa/phecomp/data/CRG/20120502_FDF_CRG/20120502_FDF_CRG/20120518_FDF_CRG_c12.mtb	1973	NA	WWFF	water	1	130143	1337462658	1	0.0600000000000001	0.00260869565217392	11060	1
4	Drink 2	Intake 2	17	130176	1337462691	/users/cn/jespinosa/phecomp/data/CRG/20120502_FDF_CRG/20120502_FDF_CRG/20120518_FDF_CRG_c12.mtb	1835	NA	WWFF	water	2	130159	1337462674	1	0.02	0.00117647058823529	11061	1
4	Drink 2	Intake 2	57	130694	1337463209	/users/cn/jespinosa/phecomp/data/CRG/20120502_FDF_CRG/20120502_FDF_CRG/20120518_FDF_CRG_c12.mtb	1836	NA	WWFF	water	2	130637	1337463152	1	0.04	0.000701754385964912	11062	1
4	Drink 2	Intake 2	53	130752	1337463267	/users/cn/jespinosa/phecomp/data/CRG/20120502_FDF_CRG/20120502_FDF_CRG/20120518_FDF_CRG_c12.mtb	1837	NA	WWFF	water	2	130699	1337463214	1	0.02	0.000377358490566038	11063	1
4	Food 1	Intake 3	169	131040	1337463555	/users/cn/jespinosa/phecomp/data/CRG/20120502_FDF_CRG/20120502_FDF_CRG/20120518_FDF_CRG_c12.mtb	5008	37	WWFF	food_fat	3	130871	1337463386	1	0.2	0.00118343195266272	11064	1
4	Food 2	Intake 4	13	131090	1337463605	/users/cn/jespinosa/phecomp/data/CRG/20120502_FDF_CRG/20120502_FDF_CRG/20120518_FDF_CRG_c12.mtb	6735	1555	WWFF	food_fat	4	131077	1337463592	1	0.0400000000000009	0.00307692307692315	11065	1
4	Food 2	Intake 4	15	132660	1337465175	/users/cn/jespinosa/phecomp/data/CRG/20120502_FDF_CRG/20120502_FDF_CRG/20120518_FDF_CRG_c12.mtb	6739	3855	WWFF	food_fat	4	132645	1337465160	1	0.4	0.0266666666666667	11066	1
4	Drink 1	Intake 1	15	135419	1337467934	/users/cn/jespinosa/phecomp/data/CRG/20120502_FDF_CRG/20120502_FDF_CRG/20120518_FDF_CRG_c12.mtb	1975	NA	WWFF	water	1	135404	1337467919	1	0.02	0.00133333333333333	11067	1
4	Food 2	Intake 4	39	136554	1337469069	/users/cn/jespinosa/phecomp/data/CRG/20120502_FDF_CRG/20120502_FDF_CRG/20120518_FDF_CRG_c12.mtb	6749	516	WWFF	food_fat	4	136515	1337469030	1	0.26	0.00666666666666667	11068	1
4	Food 2	Intake 4	18	137088	1337469603	/users/cn/jespinosa/phecomp/data/CRG/20120502_FDF_CRG/20120502_FDF_CRG/20120518_FDF_CRG_c12.mtb	6751	2358	WWFF	food_fat	4	137070	1337469585	1	0.0800000000000001	0.00444444444444445	11069	1
4	Drink 1	Intake 1	14	137446	1337469961	/users/cn/jespinosa/phecomp/data/CRG/20120502_FDF_CRG/20120502_FDF_CRG/20120518_FDF_CRG_c12.mtb	1976	NA	WWFF	water	1	137432	1337469947	1	0.04	0.00285714285714286	11070	1
4	Food 2	Intake 4	173	139619	1337472134	/users/cn/jespinosa/phecomp/data/CRG/20120502_FDF_CRG/20120502_FDF_CRG/20120518_FDF_CRG_c12.mtb	6760	224	WWFF	food_fat	4	139446	1337471961	1	0.0600000000000005	0.000346820809248558	11071	1
4	Food 2	Intake 4	36	139879	1337472394	/users/cn/jespinosa/phecomp/data/CRG/20120502_FDF_CRG/20120502_FDF_CRG/20120518_FDF_CRG_c12.mtb	6763	117	WWFF	food_fat	4	139843	1337472358	1	0.0399999999999991	0.00111111111111109	11072	1
4	Drink 1	Intake 1	28	139984	1337472499	/users/cn/jespinosa/phecomp/data/CRG/20120502_FDF_CRG/20120502_FDF_CRG/20120518_FDF_CRG_c12.mtb	1977	NA	WWFF	water	1	139956	1337472471	1	0.0800000000000001	0.00285714285714286	11073	1
4	Food 2	Intake 4	64	140060	1337472575	/users/cn/jespinosa/phecomp/data/CRG/20120502_FDF_CRG/20120502_FDF_CRG/20120518_FDF_CRG_c12.mtb	6766	COLL	WWFF	food_fat	4	139996	1337472511	1	0.0399999999999991	0.000624999999999986	11074	1
4	Food 1	Intake 3	83	140106	1337472621	/users/cn/jespinosa/phecomp/data/CRG/20120502_FDF_CRG/20120502_FDF_CRG/20120518_FDF_CRG_c12.mtb	5014	COLL	WWFF	food_fat	3	140023	1337472538	1	0.56	0.00674698795180723	11075	1
4	Food 2	Intake 4	24	140105	1337472620	/users/cn/jespinosa/phecomp/data/CRG/20120502_FDF_CRG/20120502_FDF_CRG/20120518_FDF_CRG_c12.mtb	6767	7	WWFF	food_fat	4	140081	1337472596	1	0.0200000000000014	0.000833333333333392	11076	1
4	Food 2	Intake 4	221	140333	1337472848	/users/cn/jespinosa/phecomp/data/CRG/20120502_FDF_CRG/20120502_FDF_CRG/20120518_FDF_CRG_c12.mtb	6768	COLL	WWFF	food_fat	4	140112	1337472627	1	0.139999999999999	0.000633484162895923	11077	1
4	Food 1	Intake 3	39	140160	1337472675	/users/cn/jespinosa/phecomp/data/CRG/20120502_FDF_CRG/20120502_FDF_CRG/20120518_FDF_CRG_c12.mtb	5015	61	WWFF	food_fat	3	140121	1337472636	1	0.0800000000000001	0.00205128205128205	11078	1
4	Food 1	Intake 3	105	140326	1337472841	/users/cn/jespinosa/phecomp/data/CRG/20120502_FDF_CRG/20120502_FDF_CRG/20120518_FDF_CRG_c12.mtb	5016	50	WWFF	food_fat	3	140221	1337472736	1	0.0599999999999987	0.000571428571428559	11079	1
4	Food 2	Intake 4	137	140513	1337473028	/users/cn/jespinosa/phecomp/data/CRG/20120502_FDF_CRG/20120502_FDF_CRG/20120518_FDF_CRG_c12.mtb	6769	COLL	WWFF	food_fat	4	140376	1337472891	1	0.0200000000000014	0.000145985401459864	11080	1
4	Food 1	Intake 3	130	140513	1337473028	/users/cn/jespinosa/phecomp/data/CRG/20120502_FDF_CRG/20120502_FDF_CRG/20120518_FDF_CRG_c12.mtb	5017	22	WWFF	food_fat	3	140383	1337472898	1	0.56	0.00430769230769231	11081	1
4	Food 2	Intake 4	218	140753	1337473268	/users/cn/jespinosa/phecomp/data/CRG/20120502_FDF_CRG/20120502_FDF_CRG/20120518_FDF_CRG_c12.mtb	6770	COLL	WWFF	food_fat	4	140535	1337473050	1	0.0399999999999991	0.000183486238532106	11082	1
4	Food 1	Intake 3	118	140751	1337473266	/users/cn/jespinosa/phecomp/data/CRG/20120502_FDF_CRG/20120502_FDF_CRG/20120518_FDF_CRG_c12.mtb	5019	269	WWFF	food_fat	3	140633	1337473148	1	0.0600000000000005	0.000508474576271191	11083	1
4	Drink 1	Intake 1	20	140774	1337473289	/users/cn/jespinosa/phecomp/data/CRG/20120502_FDF_CRG/20120502_FDF_CRG/20120518_FDF_CRG_c12.mtb	1978	NA	WWFF	water	1	140754	1337473269	1	0.02	0.001	11084	1
4	Drink 1	Intake 1	13	141015	1337473530	/users/cn/jespinosa/phecomp/data/CRG/20120502_FDF_CRG/20120502_FDF_CRG/20120518_FDF_CRG_c12.mtb	1979	NA	WWFF	water	1	141002	1337473517	1	0.04	0.00307692307692308	11085	1
4	Food 1	Intake 3	46	141066	1337473581	/users/cn/jespinosa/phecomp/data/CRG/20120502_FDF_CRG/20120502_FDF_CRG/20120518_FDF_CRG_c12.mtb	5022	26	WWFF	food_fat	3	141020	1337473535	1	0.0200000000000014	0.000434782608695683	11086	1
4	Food 2	Intake 4	172	141264	1337473779	/users/cn/jespinosa/phecomp/data/CRG/20120502_FDF_CRG/20120502_FDF_CRG/20120518_FDF_CRG_c12.mtb	6774	COLL	WWFF	food_fat	4	141092	1337473607	1	0.32	0.00186046511627907	11087	1
4	Food 1	Intake 3	31	141230	1337473745	/users/cn/jespinosa/phecomp/data/CRG/20120502_FDF_CRG/20120502_FDF_CRG/20120518_FDF_CRG_c12.mtb	5023	331	WWFF	food_fat	3	141199	1337473714	1	0.0399999999999991	0.00129032258064513	11088	1
4	Drink 2	Intake 2	28	141426	1337473941	/users/cn/jespinosa/phecomp/data/CRG/20120502_FDF_CRG/20120502_FDF_CRG/20120518_FDF_CRG_c12.mtb	1841	NA	WWFF	water	2	141398	1337473913	1	0.02	0.000714285714285714	11089	1
4	Food 2	Intake 4	97	141658	1337474173	/users/cn/jespinosa/phecomp/data/CRG/20120502_FDF_CRG/20120502_FDF_CRG/20120518_FDF_CRG_c12.mtb	6776	59	WWFF	food_fat	4	141561	1337474076	1	0.140000000000001	0.00144329896907218	11090	1
4	Food 2	Intake 4	261	141978	1337474493	/users/cn/jespinosa/phecomp/data/CRG/20120502_FDF_CRG/20120502_FDF_CRG/20120518_FDF_CRG_c12.mtb	6779	1012	WWFF	food_fat	4	141717	1337474232	1	0.0800000000000001	0.000306513409961686	11091	1
4	Drink 2	Intake 2	48	142121	1337474636	/users/cn/jespinosa/phecomp/data/CRG/20120502_FDF_CRG/20120502_FDF_CRG/20120518_FDF_CRG_c12.mtb	1842	NA	WWFF	water	2	142073	1337474588	1	0.08	0.00166666666666667	11092	1
4	Food 2	Intake 4	36	143026	1337475541	/users/cn/jespinosa/phecomp/data/CRG/20120502_FDF_CRG/20120502_FDF_CRG/20120518_FDF_CRG_c12.mtb	6790	657	WWFF	food_fat	4	142990	1337475505	1	0.0400000000000009	0.00111111111111114	11093	1
4	Food 2	Intake 4	71	143754	1337476269	/users/cn/jespinosa/phecomp/data/CRG/20120502_FDF_CRG/20120502_FDF_CRG/20120518_FDF_CRG_c12.mtb	6796	1251	WWFF	food_fat	4	143683	1337476198	1	0.18	0.00253521126760563	11094	1
4	Drink 1	Intake 1	20	144960	1337477475	/users/cn/jespinosa/phecomp/data/CRG/20120502_FDF_CRG/20120502_FDF_CRG/20120518_FDF_CRG_c12.mtb	1980	NA	WWFF	water	1	144940	1337477455	1	0.04	0.002	11095	1
4	Food 2	Intake 4	121	145126	1337477641	/users/cn/jespinosa/phecomp/data/CRG/20120502_FDF_CRG/20120502_FDF_CRG/20120518_FDF_CRG_c12.mtb	6803	16	WWFF	food_fat	4	145005	1337477520	1	0.0400000000000009	0.000330578512396702	11096	1
4	Food 2	Intake 4	15	145157	1337477672	/users/cn/jespinosa/phecomp/data/CRG/20120502_FDF_CRG/20120502_FDF_CRG/20120518_FDF_CRG_c12.mtb	6804	72	WWFF	food_fat	4	145142	1337477657	1	0.479999999999999	0.0319999999999999	11097	1
4	Food 2	Intake 4	121	145350	1337477865	/users/cn/jespinosa/phecomp/data/CRG/20120502_FDF_CRG/20120502_FDF_CRG/20120518_FDF_CRG_c12.mtb	6805	421	WWFF	food_fat	4	145229	1337477744	1	0.0200000000000014	0.000165289256198359	11098	1
4	Food 2	Intake 4	227	145998	1337478513	/users/cn/jespinosa/phecomp/data/CRG/20120502_FDF_CRG/20120502_FDF_CRG/20120518_FDF_CRG_c12.mtb	6808	1780	WWFF	food_fat	4	145771	1337478286	1	0.140000000000001	0.000616740088105731	11099	1
4	Drink 1	Intake 1	15	146126	1337478641	/users/cn/jespinosa/phecomp/data/CRG/20120502_FDF_CRG/20120502_FDF_CRG/20120518_FDF_CRG_c12.mtb	1981	NA	WWFF	water	1	146111	1337478626	1	0.04	0.00266666666666667	11100	1
4	Food 2	Intake 4	49	147827	1337480342	/users/cn/jespinosa/phecomp/data/CRG/20120502_FDF_CRG/20120502_FDF_CRG/20120518_FDF_CRG_c12.mtb	6816	1175	WWFF	food_fat	4	147778	1337480293	1	0.0400000000000009	0.000816326530612263	11101	1
4	Food 2	Intake 4	21	149023	1337481538	/users/cn/jespinosa/phecomp/data/CRG/20120502_FDF_CRG/20120502_FDF_CRG/20120518_FDF_CRG_c12.mtb	6821	1505	WWFF	food_fat	4	149002	1337481517	1	0.0200000000000014	0.000952380952381019	11102	1
4	Food 2	Intake 4	24	150552	1337483067	/users/cn/jespinosa/phecomp/data/CRG/20120502_FDF_CRG/20120502_FDF_CRG/20120518_FDF_CRG_c12.mtb	6829	2164	WWFF	food_fat	4	150528	1337483043	1	0.18	0.0075	11103	1
4	Food 2	Intake 4	15	152731	1337485246	/users/cn/jespinosa/phecomp/data/CRG/20120502_FDF_CRG/20120502_FDF_CRG/20120518_FDF_CRG_c12.mtb	6837	316	WWFF	food_fat	4	152716	1337485231	1	0.399999999999999	0.0266666666666666	11104	1
4	Drink 1	Intake 1	14	153047	1337485562	/users/cn/jespinosa/phecomp/data/CRG/20120502_FDF_CRG/20120502_FDF_CRG/20120518_FDF_CRG_c12.mtb	1983	NA	WWFF	water	1	153033	1337485548	1	0.04	0.00285714285714286	11105	1
4	Food 2	Intake 4	23	153070	1337485585	/users/cn/jespinosa/phecomp/data/CRG/20120502_FDF_CRG/20120502_FDF_CRG/20120518_FDF_CRG_c12.mtb	6838	403	WWFF	food_fat	4	153047	1337485562	1	0.0200000000000014	0.000869565217391365	11106	1
4	Food 2	Intake 4	25	153498	1337486013	/users/cn/jespinosa/phecomp/data/CRG/20120502_FDF_CRG/20120502_FDF_CRG/20120518_FDF_CRG_c12.mtb	6840	265	WWFF	food_fat	4	153473	1337485988	1	0.0399999999999991	0.00159999999999996	11107	1
4	Food 2	Intake 4	30	153793	1337486308	/users/cn/jespinosa/phecomp/data/CRG/20120502_FDF_CRG/20120502_FDF_CRG/20120518_FDF_CRG_c12.mtb	6842	1179	WWFF	food_fat	4	153763	1337486278	1	0.0200000000000014	0.000666666666666713	11108	1
4	Food 2	Intake 4	27	154999	1337487514	/users/cn/jespinosa/phecomp/data/CRG/20120502_FDF_CRG/20120502_FDF_CRG/20120518_FDF_CRG_c12.mtb	6851	494	WWFF	food_fat	4	154972	1337487487	1	0.140000000000001	0.00518518518518522	11109	1
4	Drink 1	Intake 1	12	155485	1337488000	/users/cn/jespinosa/phecomp/data/CRG/20120502_FDF_CRG/20120502_FDF_CRG/20120518_FDF_CRG_c12.mtb	1984	NA	WWFF	water	1	155473	1337487988	1	0.0599999999999996	0.00499999999999997	11110	1
4	Food 2	Intake 4	228	155721	1337488236	/users/cn/jespinosa/phecomp/data/CRG/20120502_FDF_CRG/20120502_FDF_CRG/20120518_FDF_CRG_c12.mtb	6854	COLL	WWFF	food_fat	4	155493	1337488008	1	0.0999999999999996	0.000438596491228068	11111	1
4	Food 1	Intake 3	44	155680	1337488195	/users/cn/jespinosa/phecomp/data/CRG/20120502_FDF_CRG/20120502_FDF_CRG/20120518_FDF_CRG_c12.mtb	5035	444	WWFF	food_fat	3	155636	1337488151	1	0.0200000000000014	0.000454545454545486	11112	1
4	Drink 1	Intake 1	17	155784	1337488299	/users/cn/jespinosa/phecomp/data/CRG/20120502_FDF_CRG/20120502_FDF_CRG/20120518_FDF_CRG_c12.mtb	1985	NA	WWFF	water	1	155767	1337488282	1	0.02	0.00117647058823529	11113	1
4	Drink 2	Intake 2	91	155865	1337488380	/users/cn/jespinosa/phecomp/data/CRG/20120502_FDF_CRG/20120502_FDF_CRG/20120518_FDF_CRG_c12.mtb	1847	NA	WWFF	water	2	155774	1337488289	1	0.08	0.000879120879120879	11114	1
4	Drink 2	Intake 2	63	156006	1337488521	/users/cn/jespinosa/phecomp/data/CRG/20120502_FDF_CRG/20120502_FDF_CRG/20120518_FDF_CRG_c12.mtb	1849	NA	WWFF	water	2	155943	1337488458	1	0.02	0.000317460317460317	11115	1
4	Food 2	Intake 4	95	156219	1337488734	/users/cn/jespinosa/phecomp/data/CRG/20120502_FDF_CRG/20120502_FDF_CRG/20120518_FDF_CRG_c12.mtb	6857	394	WWFF	food_fat	4	156124	1337488639	1	0.0800000000000001	0.000842105263157896	11116	1
4	Food 2	Intake 4	245	156858	1337489373	/users/cn/jespinosa/phecomp/data/CRG/20120502_FDF_CRG/20120502_FDF_CRG/20120518_FDF_CRG_c12.mtb	6859	22	WWFF	food_fat	4	156613	1337489128	1	0.16	0.000653061224489796	11117	1
4	Food 2	Intake 4	23	156903	1337489418	/users/cn/jespinosa/phecomp/data/CRG/20120502_FDF_CRG/20120502_FDF_CRG/20120518_FDF_CRG_c12.mtb	6860	391	WWFF	food_fat	4	156880	1337489395	1	0.0600000000000005	0.00260869565217393	11118	1
4	Drink 1	Intake 1	20	156973	1337489488	/users/cn/jespinosa/phecomp/data/CRG/20120502_FDF_CRG/20120502_FDF_CRG/20120518_FDF_CRG_c12.mtb	1987	NA	WWFF	water	1	156953	1337489468	1	0.1	0.005	11119	1
4	Food 2	Intake 4	45	157339	1337489854	/users/cn/jespinosa/phecomp/data/CRG/20120502_FDF_CRG/20120502_FDF_CRG/20120518_FDF_CRG_c12.mtb	6866	1462	WWFF	food_fat	4	157294	1337489809	1	0.0200000000000014	0.000444444444444476	11120	1
4	Food 2	Intake 4	40	158841	1337491356	/users/cn/jespinosa/phecomp/data/CRG/20120502_FDF_CRG/20120502_FDF_CRG/20120518_FDF_CRG_c12.mtb	6870	884	WWFF	food_fat	4	158801	1337491316	1	0.540000000000001	0.0135	11121	1
4	Food 2	Intake 4	19	159744	1337492259	/users/cn/jespinosa/phecomp/data/CRG/20120502_FDF_CRG/20120502_FDF_CRG/20120518_FDF_CRG_c12.mtb	6875	1082	WWFF	food_fat	4	159725	1337492240	1	0.0200000000000014	0.00105263157894744	11122	1
4	Food 2	Intake 4	26	160852	1337493367	/users/cn/jespinosa/phecomp/data/CRG/20120502_FDF_CRG/20120502_FDF_CRG/20120518_FDF_CRG_c12.mtb	6881	907	WWFF	food_fat	4	160826	1337493341	1	0.0200000000000014	0.000769230769230823	11123	1
4	Food 2	Intake 4	232	161991	1337494506	/users/cn/jespinosa/phecomp/data/CRG/20120502_FDF_CRG/20120502_FDF_CRG/20120518_FDF_CRG_c12.mtb	6884	16	WWFF	food_fat	4	161759	1337494274	1	0.359999999999999	0.00155172413793103	11124	1
4	Drink 2	Intake 2	60	161979	1337494494	/users/cn/jespinosa/phecomp/data/CRG/20120502_FDF_CRG/20120502_FDF_CRG/20120518_FDF_CRG_c12.mtb	1853	NA	WWFF	water	2	161919	1337494434	1	0.0600000000000001	0.001	11125	1
4	Food 2	Intake 4	142	162149	1337494664	/users/cn/jespinosa/phecomp/data/CRG/20120502_FDF_CRG/20120502_FDF_CRG/20120518_FDF_CRG_c12.mtb	6885	318	WWFF	food_fat	4	162007	1337494522	1	0.0600000000000005	0.000422535211267609	11126	1
4	Food 2	Intake 4	161	162628	1337495143	/users/cn/jespinosa/phecomp/data/CRG/20120502_FDF_CRG/20120502_FDF_CRG/20120518_FDF_CRG_c12.mtb	6888	175	WWFF	food_fat	4	162467	1337494982	1	0.18	0.00111801242236025	11127	1
4	Food 1	Intake 3	198	163001	1337495516	/users/cn/jespinosa/phecomp/data/CRG/20120502_FDF_CRG/20120502_FDF_CRG/20120518_FDF_CRG_c12.mtb	5045	COLL	WWFF	food_fat	3	162803	1337495318	1	0.0399999999999991	0.000202020202020197	11128	1
4	Food 2	Intake 4	216	163113	1337495628	/users/cn/jespinosa/phecomp/data/CRG/20120502_FDF_CRG/20120502_FDF_CRG/20120518_FDF_CRG_c12.mtb	6891	173	WWFF	food_fat	4	162897	1337495412	1	0.0999999999999996	0.000462962962962961	11129	1
4	Drink 2	Intake 2	17	163133	1337495648	/users/cn/jespinosa/phecomp/data/CRG/20120502_FDF_CRG/20120502_FDF_CRG/20120518_FDF_CRG_c12.mtb	1858	NA	WWFF	water	2	163116	1337495631	1	0.02	0.00117647058823529	11130	1
4	Food 2	Intake 4	361	163647	1337496162	/users/cn/jespinosa/phecomp/data/CRG/20120502_FDF_CRG/20120502_FDF_CRG/20120518_FDF_CRG_c12.mtb	6893	308	WWFF	food_fat	4	163286	1337495801	1	0.0800000000000001	0.000221606648199446	11131	1
4	Food 2	Intake 4	15	163970	1337496485	/users/cn/jespinosa/phecomp/data/CRG/20120502_FDF_CRG/20120502_FDF_CRG/20120518_FDF_CRG_c12.mtb	6896	97	WWFF	food_fat	4	163955	1337496470	1	0.26	0.0173333333333333	11132	1
4	Food 2	Intake 4	35	164102	1337496617	/users/cn/jespinosa/phecomp/data/CRG/20120502_FDF_CRG/20120502_FDF_CRG/20120518_FDF_CRG_c12.mtb	6897	13635	WWFF	food_fat	4	164067	1337496582	1	0.0400000000000009	0.00114285714285717	11133	1
4	Drink 1	Intake 1	17	168040	1337500555	/users/cn/jespinosa/phecomp/data/CRG/20120502_FDF_CRG/20120502_FDF_CRG/20120518_FDF_CRG_c12.mtb	1990	NA	WWFF	water	1	168023	1337500538	1	0.0600000000000001	0.00352941176470589	11134	1
4	Drink 1	Intake 1	20	169439	1337501954	/users/cn/jespinosa/phecomp/data/CRG/20120502_FDF_CRG/20120502_FDF_CRG/20120518_FDF_CRG_c12.mtb	1991	NA	WWFF	water	1	169419	1337501934	1	0.1	0.005	11135	1
4	Drink 1	Intake 1	28	172196	1337504711	/users/cn/jespinosa/phecomp/data/CRG/20120502_FDF_CRG/20120502_FDF_CRG/20120518_FDF_CRG_c12.mtb	1992	NA	WWFF	water	1	172168	1337504683	1	0.1	0.00357142857142857	11136	1
4	Drink 1	Intake 1	21	173328	1337505843	/users/cn/jespinosa/phecomp/data/CRG/20120502_FDF_CRG/20120502_FDF_CRG/20120518_FDF_CRG_c12.mtb	1993	NA	WWFF	water	1	173307	1337505822	1	0.0799999999999996	0.00380952380952379	11137	1
4	Drink 1	Intake 1	25	175513	1337508028	/users/cn/jespinosa/phecomp/data/CRG/20120502_FDF_CRG/20120502_FDF_CRG/20120518_FDF_CRG_c12.mtb	1994	NA	WWFF	water	1	175488	1337508003	1	0.12	0.0048	11138	1
4	Drink 1	Intake 1	18	177722	1337510237	/users/cn/jespinosa/phecomp/data/CRG/20120502_FDF_CRG/20120502_FDF_CRG/20120518_FDF_CRG_c12.mtb	1995	NA	WWFF	water	1	177704	1337510219	1	0.12	0.00666666666666667	11139	1
4	Food 2	Intake 4	30	177767	1337510282	/users/cn/jespinosa/phecomp/data/CRG/20120502_FDF_CRG/20120502_FDF_CRG/20120518_FDF_CRG_c12.mtb	6910	1483	WWFF	food_fat	4	177737	1337510252	1	0.0200000000000014	0.000666666666666713	11140	1
4	Drink 1	Intake 1	19	179155	1337511670	/users/cn/jespinosa/phecomp/data/CRG/20120502_FDF_CRG/20120502_FDF_CRG/20120518_FDF_CRG_c12.mtb	1996	NA	WWFF	water	1	179136	1337511651	1	0.04	0.00210526315789474	11141	1
4	Food 1	Intake 3	16	179266	1337511781	/users/cn/jespinosa/phecomp/data/CRG/20120502_FDF_CRG/20120502_FDF_CRG/20120518_FDF_CRG_c12.mtb	5048	595	WWFF	food_fat	3	179250	1337511765	1	0.0200000000000014	0.00125000000000009	11142	1
4	Food 2	Intake 4	169	180030	1337512545	/users/cn/jespinosa/phecomp/data/CRG/20120502_FDF_CRG/20120502_FDF_CRG/20120518_FDF_CRG_c12.mtb	6917	8465	WWFF	food_fat	4	179861	1337512376	1	0.0600000000000005	0.00035502958579882	11143	1
4	Drink 2	Intake 2	27	179959	1337512474	/users/cn/jespinosa/phecomp/data/CRG/20120502_FDF_CRG/20120502_FDF_CRG/20120518_FDF_CRG_c12.mtb	1862	NA	WWFF	water	2	179932	1337512447	1	0.02	0.000740740740740741	11144	1
4	Drink 1	Intake 1	27	187940	1337520455	/users/cn/jespinosa/phecomp/data/CRG/20120502_FDF_CRG/20120502_FDF_CRG/20120518_FDF_CRG_c12.mtb	1997	NA	WWFF	water	1	187913	1337520428	1	0.0999999999999996	0.00370370370370369	11145	1
4	Food 2	Intake 4	16	188511	1337521026	/users/cn/jespinosa/phecomp/data/CRG/20120502_FDF_CRG/20120502_FDF_CRG/20120518_FDF_CRG_c12.mtb	6932	567	WWFF	food_fat	4	188495	1337521010	1	0.399999999999999	0.0249999999999999	11146	1
4	Food 2	Intake 4	14	189092	1337521607	/users/cn/jespinosa/phecomp/data/CRG/20120502_FDF_CRG/20120502_FDF_CRG/20120518_FDF_CRG_c12.mtb	6933	5669	WWFF	food_fat	4	189078	1337521593	1	0.0200000000000014	0.00142857142857153	11147	1
4	Drink 1	Intake 1	25	189872	1337522387	/users/cn/jespinosa/phecomp/data/CRG/20120502_FDF_CRG/20120502_FDF_CRG/20120518_FDF_CRG_c12.mtb	1998	NA	WWFF	water	1	189847	1337522362	1	0.12	0.0048	11148	1
4	Drink 1	Intake 1	22	192590	1337525105	/users/cn/jespinosa/phecomp/data/CRG/20120502_FDF_CRG/20120502_FDF_CRG/20120518_FDF_CRG_c12.mtb	1999	NA	WWFF	water	1	192568	1337525083	1	0.0600000000000005	0.00272727272727275	11149	1
4	Drink 1	Intake 1	27	194307	1337526822	/users/cn/jespinosa/phecomp/data/CRG/20120502_FDF_CRG/20120502_FDF_CRG/20120518_FDF_CRG_c12.mtb	2000	NA	WWFF	water	1	194280	1337526795	1	0.12	0.00444444444444444	11150	1
4	Food 2	Intake 4	58	194819	1337527334	/users/cn/jespinosa/phecomp/data/CRG/20120502_FDF_CRG/20120502_FDF_CRG/20120518_FDF_CRG_c12.mtb	6937	7731	WWFF	food_fat	4	194761	1337527276	1	0.42	0.00724137931034483	11151	1
4	Drink 1	Intake 1	22	195881	1337528396	/users/cn/jespinosa/phecomp/data/CRG/20120502_FDF_CRG/20120502_FDF_CRG/20120518_FDF_CRG_c12.mtb	2001	NA	WWFF	water	1	195859	1337528374	1	0.0599999999999996	0.00272727272727271	11152	1
4	Drink 1	Intake 1	15	199313	1337531828	/users/cn/jespinosa/phecomp/data/CRG/20120502_FDF_CRG/20120502_FDF_CRG/20120518_FDF_CRG_c12.mtb	2002	NA	WWFF	water	1	199298	1337531813	1	0.0600000000000005	0.00400000000000003	11153	1
4	Food 2	Intake 4	65	202615	1337535130	/users/cn/jespinosa/phecomp/data/CRG/20120502_FDF_CRG/20120502_FDF_CRG/20120518_FDF_CRG_c12.mtb	6940	3954	WWFF	food_fat	4	202550	1337535065	1	0.0399999999999991	0.000615384615384602	11154	1
4	Drink 1	Intake 1	23	204162	1337536677	/users/cn/jespinosa/phecomp/data/CRG/20120502_FDF_CRG/20120502_FDF_CRG/20120518_FDF_CRG_c12.mtb	2004	NA	WWFF	water	1	204139	1337536654	1	0.04	0.00173913043478261	11155	1
4	Drink 1	Intake 1	23	204768	1337537283	/users/cn/jespinosa/phecomp/data/CRG/20120502_FDF_CRG/20120502_FDF_CRG/20120518_FDF_CRG_c12.mtb	2005	NA	WWFF	water	1	204745	1337537260	1	0.0599999999999996	0.0026086956521739	11156	1
4	Drink 2	Intake 2	18	206033	1337538548	/users/cn/jespinosa/phecomp/data/CRG/20120502_FDF_CRG/20120502_FDF_CRG/20120518_FDF_CRG_c12.mtb	1866	NA	WWFF	water	2	206015	1337538530	1	0.02	0.00111111111111111	11157	1
4	Food 2	Intake 4	68	206637	1337539152	/users/cn/jespinosa/phecomp/data/CRG/20120502_FDF_CRG/20120502_FDF_CRG/20120518_FDF_CRG_c12.mtb	6951	114	WWFF	food_fat	4	206569	1337539084	1	0.0200000000000014	0.000294117647058844	11158	1
4	Food 2	Intake 4	67	206818	1337539333	/users/cn/jespinosa/phecomp/data/CRG/20120502_FDF_CRG/20120502_FDF_CRG/20120518_FDF_CRG_c12.mtb	6953	237	WWFF	food_fat	4	206751	1337539266	1	0.0399999999999991	0.000597014925373121	11159	1
4	Food 2	Intake 4	22	207077	1337539592	/users/cn/jespinosa/phecomp/data/CRG/20120502_FDF_CRG/20120502_FDF_CRG/20120518_FDF_CRG_c12.mtb	6955	227	WWFF	food_fat	4	207055	1337539570	1	0.0800000000000001	0.00363636363636364	11160	1
4	Food 2	Intake 4	17	207321	1337539836	/users/cn/jespinosa/phecomp/data/CRG/20120502_FDF_CRG/20120502_FDF_CRG/20120518_FDF_CRG_c12.mtb	6958	226	WWFF	food_fat	4	207304	1337539819	1	0.0800000000000001	0.00470588235294118	11161	1
4	Food 2	Intake 4	193	207740	1337540255	/users/cn/jespinosa/phecomp/data/CRG/20120502_FDF_CRG/20120502_FDF_CRG/20120518_FDF_CRG_c12.mtb	6960	102	WWFF	food_fat	4	207547	1337540062	1	0.100000000000001	0.000518134715025912	11162	1
4	Food 2	Intake 4	20	207862	1337540377	/users/cn/jespinosa/phecomp/data/CRG/20120502_FDF_CRG/20120502_FDF_CRG/20120518_FDF_CRG_c12.mtb	6962	194	WWFF	food_fat	4	207842	1337540357	1	0.0399999999999991	0.00199999999999995	11163	1
4	Drink 1	Intake 1	52	207959	1337540474	/users/cn/jespinosa/phecomp/data/CRG/20120502_FDF_CRG/20120502_FDF_CRG/20120518_FDF_CRG_c12.mtb	2009	NA	WWFF	water	1	207907	1337540422	1	0.0200000000000005	0.000384615384615394	11164	1
4	Food 2	Intake 4	50	208106	1337540621	/users/cn/jespinosa/phecomp/data/CRG/20120502_FDF_CRG/20120502_FDF_CRG/20120518_FDF_CRG_c12.mtb	6965	74	WWFF	food_fat	4	208056	1337540571	1	0.0399999999999991	0.000799999999999982	11165	1
4	Food 2	Intake 4	368	208548	1337541063	/users/cn/jespinosa/phecomp/data/CRG/20120502_FDF_CRG/20120502_FDF_CRG/20120518_FDF_CRG_c12.mtb	6966	133	WWFF	food_fat	4	208180	1337540695	1	0.520000000000001	0.00141304347826087	11166	1
4	Food 1	Intake 3	76	208757	1337541272	/users/cn/jespinosa/phecomp/data/CRG/20120502_FDF_CRG/20120502_FDF_CRG/20120518_FDF_CRG_c12.mtb	5066	64	WWFF	food_fat	3	208681	1337541196	1	0.0399999999999991	0.000526315789473672	11167	1
4	Drink 2	Intake 2	16	208771	1337541286	/users/cn/jespinosa/phecomp/data/CRG/20120502_FDF_CRG/20120502_FDF_CRG/20120518_FDF_CRG_c12.mtb	1870	NA	WWFF	water	2	208755	1337541270	1	0.04	0.0025	11168	1
4	Food 2	Intake 4	279	209100	1337541615	/users/cn/jespinosa/phecomp/data/CRG/20120502_FDF_CRG/20120502_FDF_CRG/20120518_FDF_CRG_c12.mtb	6968	5	WWFF	food_fat	4	208821	1337541336	1	0.34	0.00121863799283154	11169	1
4	Food 2	Intake 4	74	209179	1337541694	/users/cn/jespinosa/phecomp/data/CRG/20120502_FDF_CRG/20120502_FDF_CRG/20120518_FDF_CRG_c12.mtb	6969	369	WWFF	food_fat	4	209105	1337541620	1	0.0399999999999991	0.000540540540540528	11170	1
4	Food 1	Intake 3	202	209750	1337542265	/users/cn/jespinosa/phecomp/data/CRG/20120502_FDF_CRG/20120502_FDF_CRG/20120518_FDF_CRG_c12.mtb	5070	COLL	WWFF	food_fat	3	209548	1337542063	1	0.9	0.00445544554455446	11171	1
4	Food 2	Intake 4	60	209757	1337542272	/users/cn/jespinosa/phecomp/data/CRG/20120502_FDF_CRG/20120502_FDF_CRG/20120518_FDF_CRG_c12.mtb	6972	321	WWFF	food_fat	4	209697	1337542212	1	0.0999999999999979	0.00166666666666663	11172	1
4	Drink 1	Intake 1	22	209883	1337542398	/users/cn/jespinosa/phecomp/data/CRG/20120502_FDF_CRG/20120502_FDF_CRG/20120518_FDF_CRG_c12.mtb	2011	NA	WWFF	water	1	209861	1337542376	1	0.0599999999999996	0.00272727272727271	11173	1
4	Food 2	Intake 4	206	210284	1337542799	/users/cn/jespinosa/phecomp/data/CRG/20120502_FDF_CRG/20120502_FDF_CRG/20120518_FDF_CRG_c12.mtb	6974	474	WWFF	food_fat	4	210078	1337542593	1	0.140000000000001	0.000679611650485442	11174	1
4	Drink 2	Intake 2	46	210691	1337543206	/users/cn/jespinosa/phecomp/data/CRG/20120502_FDF_CRG/20120502_FDF_CRG/20120518_FDF_CRG_c12.mtb	1872	NA	WWFF	water	2	210645	1337543160	1	0.0399999999999999	0.000869565217391302	11175	1
4	Food 1	Intake 3	79	210837	1337543352	/users/cn/jespinosa/phecomp/data/CRG/20120502_FDF_CRG/20120502_FDF_CRG/20120518_FDF_CRG_c12.mtb	5076	349	WWFF	food_fat	3	210758	1337543273	1	0.0200000000000014	0.000253164556962043	11176	1
4	Food 2	Intake 4	35	211221	1337543736	/users/cn/jespinosa/phecomp/data/CRG/20120502_FDF_CRG/20120502_FDF_CRG/20120518_FDF_CRG_c12.mtb	6978	236	WWFF	food_fat	4	211186	1337543701	1	0.0799999999999983	0.00228571428571424	11177	1
4	Food 2	Intake 4	102	211559	1337544074	/users/cn/jespinosa/phecomp/data/CRG/20120502_FDF_CRG/20120502_FDF_CRG/20120518_FDF_CRG_c12.mtb	6981	118	WWFF	food_fat	4	211457	1337543972	1	0.399999999999999	0.00392156862745097	11178	1
4	Food 2	Intake 4	182	211859	1337544374	/users/cn/jespinosa/phecomp/data/CRG/20120502_FDF_CRG/20120502_FDF_CRG/20120518_FDF_CRG_c12.mtb	6983	COLL	WWFF	food_fat	4	211677	1337544192	1	0.0599999999999987	0.000329670329670323	11179	1
4	Food 1	Intake 3	118	211808	1337544323	/users/cn/jespinosa/phecomp/data/CRG/20120502_FDF_CRG/20120502_FDF_CRG/20120518_FDF_CRG_c12.mtb	5081	601	WWFF	food_fat	3	211690	1337544205	1	0.0399999999999991	0.00033898305084745	11180	1
4	Food 2	Intake 4	155	212564	1337545079	/users/cn/jespinosa/phecomp/data/CRG/20120502_FDF_CRG/20120502_FDF_CRG/20120518_FDF_CRG_c12.mtb	6987	9	WWFF	food_fat	4	212409	1337544924	1	0.0399999999999991	0.000258064516129026	11181	1
4	Food 2	Intake 4	342	212915	1337545430	/users/cn/jespinosa/phecomp/data/CRG/20120502_FDF_CRG/20120502_FDF_CRG/20120518_FDF_CRG_c12.mtb	6988	255	WWFF	food_fat	4	212573	1337545088	1	0.0200000000000031	5.84795321637518e-05	11182	1
4	Food 2	Intake 4	98	213268	1337545783	/users/cn/jespinosa/phecomp/data/CRG/20120502_FDF_CRG/20120502_FDF_CRG/20120518_FDF_CRG_c12.mtb	6991	393	WWFF	food_fat	4	213170	1337545685	1	0.0599999999999987	0.00061224489795917	11183	1
4	Food 2	Intake 4	39	213700	1337546215	/users/cn/jespinosa/phecomp/data/CRG/20120502_FDF_CRG/20120502_FDF_CRG/20120518_FDF_CRG_c12.mtb	6993	499	WWFF	food_fat	4	213661	1337546176	1	0.0200000000000031	0.000512820512820592	11184	1
4	Food 2	Intake 4	239	214438	1337546953	/users/cn/jespinosa/phecomp/data/CRG/20120502_FDF_CRG/20120502_FDF_CRG/20120518_FDF_CRG_c12.mtb	6998	254	WWFF	food_fat	4	214199	1337546714	1	0.0599999999999987	0.000251046025104597	11185	1
4	Food 2	Intake 4	217	214909	1337547424	/users/cn/jespinosa/phecomp/data/CRG/20120502_FDF_CRG/20120502_FDF_CRG/20120518_FDF_CRG_c12.mtb	7000	5	WWFF	food_fat	4	214692	1337547207	1	0.0399999999999991	0.000184331797235019	11186	1
4	Food 2	Intake 4	29	214943	1337547458	/users/cn/jespinosa/phecomp/data/CRG/20120502_FDF_CRG/20120502_FDF_CRG/20120518_FDF_CRG_c12.mtb	7001	233	WWFF	food_fat	4	214914	1337547429	1	0.100000000000001	0.003448275862069	11187	1
4	Drink 2	Intake 2	21	215021	1337547536	/users/cn/jespinosa/phecomp/data/CRG/20120502_FDF_CRG/20120502_FDF_CRG/20120518_FDF_CRG_c12.mtb	1877	NA	WWFF	water	2	215000	1337547515	1	0.1	0.00476190476190476	11188	1
4	Drink 2	Intake 2	49	215078	1337547593	/users/cn/jespinosa/phecomp/data/CRG/20120502_FDF_CRG/20120502_FDF_CRG/20120518_FDF_CRG_c12.mtb	1878	NA	WWFF	water	2	215029	1337547544	1	0.02	0.000408163265306122	11189	1
4	Food 2	Intake 4	137	215313	1337547828	/users/cn/jespinosa/phecomp/data/CRG/20120502_FDF_CRG/20120502_FDF_CRG/20120518_FDF_CRG_c12.mtb	7004	4442	WWFF	food_fat	4	215176	1337547691	1	0.0600000000000023	0.000437956204379579	11190	1
4	Drink 2	Intake 2	39	215217	1337547732	/users/cn/jespinosa/phecomp/data/CRG/20120502_FDF_CRG/20120502_FDF_CRG/20120518_FDF_CRG_c12.mtb	1879	NA	WWFF	water	2	215178	1337547693	1	0.02	0.000512820512820513	11191	1
4	Drink 1	Intake 1	29	216952	1337549467	/users/cn/jespinosa/phecomp/data/CRG/20120502_FDF_CRG/20120502_FDF_CRG/20120518_FDF_CRG_c12.mtb	2015	NA	WWFF	water	1	216923	1337549438	1	0.12	0.00413793103448276	11192	1
4	Drink 1	Intake 1	21	219538	1337552053	/users/cn/jespinosa/phecomp/data/CRG/20120502_FDF_CRG/20120502_FDF_CRG/20120518_FDF_CRG_c12.mtb	2016	NA	WWFF	water	1	219517	1337552032	1	0.0200000000000005	0.000952380952380976	11193	1
4	Drink 2	Intake 2	67	219591	1337552106	/users/cn/jespinosa/phecomp/data/CRG/20120502_FDF_CRG/20120502_FDF_CRG/20120518_FDF_CRG_c12.mtb	1881	NA	WWFF	water	2	219524	1337552039	1	0.04	0.000597014925373134	11194	1
4	Food 2	Intake 4	81	219836	1337552351	/users/cn/jespinosa/phecomp/data/CRG/20120502_FDF_CRG/20120502_FDF_CRG/20120518_FDF_CRG_c12.mtb	7013	14	WWFF	food_fat	4	219755	1337552270	1	0.0999999999999979	0.00123456790123454	11195	1
4	Food 2	Intake 4	327	220177	1337552692	/users/cn/jespinosa/phecomp/data/CRG/20120502_FDF_CRG/20120502_FDF_CRG/20120518_FDF_CRG_c12.mtb	7014	291	WWFF	food_fat	4	219850	1337552365	1	0.120000000000001	0.000366972477064223	11196	1
4	Food 2	Intake 4	28	220496	1337553011	/users/cn/jespinosa/phecomp/data/CRG/20120502_FDF_CRG/20120502_FDF_CRG/20120518_FDF_CRG_c12.mtb	7016	363	WWFF	food_fat	4	220468	1337552983	1	0.0800000000000018	0.00285714285714292	11197	1
4	Food 2	Intake 4	205	221064	1337553579	/users/cn/jespinosa/phecomp/data/CRG/20120502_FDF_CRG/20120502_FDF_CRG/20120518_FDF_CRG_c12.mtb	7019	165	WWFF	food_fat	4	220859	1337553374	1	0.18	0.000878048780487805	11198	1
4	Drink 1	Intake 1	15	221199	1337553714	/users/cn/jespinosa/phecomp/data/CRG/20120502_FDF_CRG/20120502_FDF_CRG/20120518_FDF_CRG_c12.mtb	2019	NA	WWFF	water	1	221184	1337553699	1	0.0600000000000005	0.00400000000000003	11199	1
4	Food 2	Intake 4	136	221365	1337553880	/users/cn/jespinosa/phecomp/data/CRG/20120502_FDF_CRG/20120502_FDF_CRG/20120518_FDF_CRG_c12.mtb	7021	655	WWFF	food_fat	4	221229	1337553744	1	0.0399999999999991	0.000294117647058817	11200	1
4	Food 2	Intake 4	14	222034	1337554549	/users/cn/jespinosa/phecomp/data/CRG/20120502_FDF_CRG/20120502_FDF_CRG/20120518_FDF_CRG_c12.mtb	7027	41	WWFF	food_fat	4	222020	1337554535	1	0.120000000000001	0.00857142857142864	11201	1
4	Food 2	Intake 4	21	222096	1337554611	/users/cn/jespinosa/phecomp/data/CRG/20120502_FDF_CRG/20120502_FDF_CRG/20120518_FDF_CRG_c12.mtb	7028	2871	WWFF	food_fat	4	222075	1337554590	1	0.0399999999999991	0.00190476190476186	11202	1
4	Food 2	Intake 4	37	225004	1337557519	/users/cn/jespinosa/phecomp/data/CRG/20120502_FDF_CRG/20120502_FDF_CRG/20120518_FDF_CRG_c12.mtb	7038	1409	WWFF	food_fat	4	224967	1337557482	1	0.0399999999999991	0.00108108108108106	11203	1
4	Food 2	Intake 4	70	226483	1337558998	/users/cn/jespinosa/phecomp/data/CRG/20120502_FDF_CRG/20120502_FDF_CRG/20120518_FDF_CRG_c12.mtb	7047	28	WWFF	food_fat	4	226413	1337558928	1	0.0399999999999991	0.000571428571428559	11204	1
4	Food 2	Intake 4	210	226721	1337559236	/users/cn/jespinosa/phecomp/data/CRG/20120502_FDF_CRG/20120502_FDF_CRG/20120518_FDF_CRG_c12.mtb	7048	49	WWFF	food_fat	4	226511	1337559026	1	0.0400000000000027	0.000190476190476203	11205	1
4	Food 2	Intake 4	165	226935	1337559450	/users/cn/jespinosa/phecomp/data/CRG/20120502_FDF_CRG/20120502_FDF_CRG/20120518_FDF_CRG_c12.mtb	7050	59	WWFF	food_fat	4	226770	1337559285	1	0.0799999999999983	0.000484848484848475	11206	1
4	Food 1	Intake 3	64	227058	1337559573	/users/cn/jespinosa/phecomp/data/CRG/20120502_FDF_CRG/20120502_FDF_CRG/20120518_FDF_CRG_c12.mtb	5099	COLL	WWFF	food_fat	3	226994	1337559509	1	0.0200000000000014	0.000312500000000022	11207	1
4	Food 2	Intake 4	64	227078	1337559593	/users/cn/jespinosa/phecomp/data/CRG/20120502_FDF_CRG/20120502_FDF_CRG/20120518_FDF_CRG_c12.mtb	7052	11	WWFF	food_fat	4	227014	1337559529	1	0.0600000000000023	0.000937500000000036	11208	1
4	Food 2	Intake 4	144	227233	1337559748	/users/cn/jespinosa/phecomp/data/CRG/20120502_FDF_CRG/20120502_FDF_CRG/20120518_FDF_CRG_c12.mtb	7053	501	WWFF	food_fat	4	227089	1337559604	1	0.0799999999999983	0.000555555555555544	11209	1
4	Drink 1	Intake 1	38	227275	1337559790	/users/cn/jespinosa/phecomp/data/CRG/20120502_FDF_CRG/20120502_FDF_CRG/20120518_FDF_CRG_c12.mtb	2021	NA	WWFF	water	1	227237	1337559752	1	0.0999999999999996	0.00263157894736841	11210	1
4	Food 2	Intake 4	13	227747	1337560262	/users/cn/jespinosa/phecomp/data/CRG/20120502_FDF_CRG/20120502_FDF_CRG/20120518_FDF_CRG_c12.mtb	7056	177	WWFF	food_fat	4	227734	1337560249	1	0.0399999999999991	0.00307692307692301	11211	1
4	Drink 1	Intake 1	30	227769	1337560284	/users/cn/jespinosa/phecomp/data/CRG/20120502_FDF_CRG/20120502_FDF_CRG/20120518_FDF_CRG_c12.mtb	2022	NA	WWFF	water	1	227739	1337560254	1	0.0800000000000001	0.00266666666666667	11212	1
4	Food 2	Intake 4	13	227937	1337560452	/users/cn/jespinosa/phecomp/data/CRG/20120502_FDF_CRG/20120502_FDF_CRG/20120518_FDF_CRG_c12.mtb	7060	93	WWFF	food_fat	4	227924	1337560439	1	0.0599999999999987	0.00461538461538452	11213	1
4	Food 2	Intake 4	14	228044	1337560559	/users/cn/jespinosa/phecomp/data/CRG/20120502_FDF_CRG/20120502_FDF_CRG/20120518_FDF_CRG_c12.mtb	7062	367	WWFF	food_fat	4	228030	1337560545	1	0.199999999999999	0.0142857142857142	11214	1
4	Food 2	Intake 4	56	228467	1337560982	/users/cn/jespinosa/phecomp/data/CRG/20120502_FDF_CRG/20120502_FDF_CRG/20120518_FDF_CRG_c12.mtb	7065	1008	WWFF	food_fat	4	228411	1337560926	1	0.0400000000000027	0.000714285714285763	11215	1
4	Food 2	Intake 4	142	229617	1337562132	/users/cn/jespinosa/phecomp/data/CRG/20120502_FDF_CRG/20120502_FDF_CRG/20120518_FDF_CRG_c12.mtb	7073	4	WWFF	food_fat	4	229475	1337561990	1	0.120000000000001	0.000845070422535218	11216	1
4	Food 2	Intake 4	99	229720	1337562235	/users/cn/jespinosa/phecomp/data/CRG/20120502_FDF_CRG/20120502_FDF_CRG/20120518_FDF_CRG_c12.mtb	7074	2021	WWFF	food_fat	4	229621	1337562136	1	0.0599999999999987	0.000606060606060593	11217	1
4	Food 2	Intake 4	21	231762	1337564277	/users/cn/jespinosa/phecomp/data/CRG/20120502_FDF_CRG/20120502_FDF_CRG/20120518_FDF_CRG_c12.mtb	7079	296	WWFF	food_fat	4	231741	1337564256	1	0.0399999999999991	0.00190476190476186	11218	1
4	Food 2	Intake 4	19	232077	1337564592	/users/cn/jespinosa/phecomp/data/CRG/20120502_FDF_CRG/20120502_FDF_CRG/20120518_FDF_CRG_c12.mtb	7080	3507	WWFF	food_fat	4	232058	1337564573	1	0.0200000000000031	0.00105263157894753	11219	1
4	Drink 1	Intake 1	21	232298	1337564813	/users/cn/jespinosa/phecomp/data/CRG/20120502_FDF_CRG/20120502_FDF_CRG/20120518_FDF_CRG_c12.mtb	2023	NA	WWFF	water	1	232277	1337564792	1	0.0600000000000005	0.00285714285714288	11220	1
4	Food 2	Intake 4	31	235615	1337568130	/users/cn/jespinosa/phecomp/data/CRG/20120502_FDF_CRG/20120502_FDF_CRG/20120518_FDF_CRG_c12.mtb	7099	14	WWFF	food_fat	4	235584	1337568099	1	0.0399999999999991	0.00129032258064513	11221	1
4	Food 2	Intake 4	17	235646	1337568161	/users/cn/jespinosa/phecomp/data/CRG/20120502_FDF_CRG/20120502_FDF_CRG/20120518_FDF_CRG_c12.mtb	7100	200	WWFF	food_fat	4	235629	1337568144	1	0.16	0.00941176470588235	11222	1
4	Food 2	Intake 4	22	235868	1337568383	/users/cn/jespinosa/phecomp/data/CRG/20120502_FDF_CRG/20120502_FDF_CRG/20120518_FDF_CRG_c12.mtb	7102	15	WWFF	food_fat	4	235846	1337568361	1	0.0400000000000027	0.00181818181818194	11223	1
4	Food 2	Intake 4	184	236067	1337568582	/users/cn/jespinosa/phecomp/data/CRG/20120502_FDF_CRG/20120502_FDF_CRG/20120518_FDF_CRG_c12.mtb	7103	368	WWFF	food_fat	4	235883	1337568398	1	0.0399999999999991	0.000217391304347821	11224	1
4	Drink 1	Intake 1	31	236272	1337568787	/users/cn/jespinosa/phecomp/data/CRG/20120502_FDF_CRG/20120502_FDF_CRG/20120518_FDF_CRG_c12.mtb	2024	NA	WWFF	water	1	236241	1337568756	1	0.0999999999999996	0.00322580645161289	11225	1
4	Food 2	Intake 4	13	236448	1337568963	/users/cn/jespinosa/phecomp/data/CRG/20120502_FDF_CRG/20120502_FDF_CRG/20120518_FDF_CRG_c12.mtb	7108	1828	WWFF	food_fat	4	236435	1337568950	1	0.0399999999999991	0.00307692307692301	11226	1
4	Drink 1	Intake 1	17	236545	1337569060	/users/cn/jespinosa/phecomp/data/CRG/20120502_FDF_CRG/20120502_FDF_CRG/20120518_FDF_CRG_c12.mtb	2025	NA	WWFF	water	1	236528	1337569043	1	0.04	0.00235294117647059	11227	1
4	Food 2	Intake 4	18	238294	1337570809	/users/cn/jespinosa/phecomp/data/CRG/20120502_FDF_CRG/20120502_FDF_CRG/20120518_FDF_CRG_c12.mtb	7112	109	WWFF	food_fat	4	238276	1337570791	1	0.0399999999999991	0.00222222222222217	11228	1
4	Drink 1	Intake 1	15	238410	1337570925	/users/cn/jespinosa/phecomp/data/CRG/20120502_FDF_CRG/20120502_FDF_CRG/20120518_FDF_CRG_c12.mtb	2026	NA	WWFF	water	1	238395	1337570910	1	0.04	0.00266666666666667	11229	1
4	Food 2	Intake 4	13	238416	1337570931	/users/cn/jespinosa/phecomp/data/CRG/20120502_FDF_CRG/20120502_FDF_CRG/20120518_FDF_CRG_c12.mtb	7113	2973	WWFF	food_fat	4	238403	1337570918	1	0.0400000000000027	0.00307692307692328	11230	1
4	Food 2	Intake 4	104	241493	1337574008	/users/cn/jespinosa/phecomp/data/CRG/20120502_FDF_CRG/20120502_FDF_CRG/20120518_FDF_CRG_c12.mtb	7129	56	WWFF	food_fat	4	241389	1337573904	1	0.0599999999999987	0.000576923076923064	11231	1
4	Food 2	Intake 4	235	241784	1337574299	/users/cn/jespinosa/phecomp/data/CRG/20120502_FDF_CRG/20120502_FDF_CRG/20120518_FDF_CRG_c12.mtb	7131	189	WWFF	food_fat	4	241549	1337574064	1	0.220000000000002	0.000936170212765966	11232	1
4	Drink 1	Intake 1	30	241949	1337574464	/users/cn/jespinosa/phecomp/data/CRG/20120502_FDF_CRG/20120502_FDF_CRG/20120518_FDF_CRG_c12.mtb	2027	NA	WWFF	water	1	241919	1337574434	1	0.0600000000000005	0.00200000000000002	11233	1
4	Food 2	Intake 4	56	242029	1337574544	/users/cn/jespinosa/phecomp/data/CRG/20120502_FDF_CRG/20120502_FDF_CRG/20120518_FDF_CRG_c12.mtb	7133	31	WWFF	food_fat	4	241973	1337574488	1	0.120000000000001	0.00214285714285716	11234	1
4	Food 1	Intake 3	111	242171	1337574686	/users/cn/jespinosa/phecomp/data/CRG/20120502_FDF_CRG/20120502_FDF_CRG/20120518_FDF_CRG_c12.mtb	5108	COLL	WWFF	food_fat	3	242060	1337574575	1	0.0399999999999991	0.000360360360360352	11235	1
4	Food 2	Intake 4	28	242175	1337574690	/users/cn/jespinosa/phecomp/data/CRG/20120502_FDF_CRG/20120502_FDF_CRG/20120518_FDF_CRG_c12.mtb	7135	316	WWFF	food_fat	4	242147	1337574662	1	0.0600000000000023	0.00214285714285722	11236	1
4	Drink 2	Intake 2	36	242308	1337574823	/users/cn/jespinosa/phecomp/data/CRG/20120502_FDF_CRG/20120502_FDF_CRG/20120518_FDF_CRG_c12.mtb	1887	NA	WWFF	water	2	242272	1337574787	1	0.0600000000000001	0.00166666666666667	11237	1
4	Food 2	Intake 4	57	242548	1337575063	/users/cn/jespinosa/phecomp/data/CRG/20120502_FDF_CRG/20120502_FDF_CRG/20120518_FDF_CRG_c12.mtb	7137	159	WWFF	food_fat	4	242491	1337575006	1	0.120000000000001	0.00210526315789475	11238	1
4	Drink 2	Intake 2	17	242554	1337575069	/users/cn/jespinosa/phecomp/data/CRG/20120502_FDF_CRG/20120502_FDF_CRG/20120518_FDF_CRG_c12.mtb	1888	NA	WWFF	water	2	242537	1337575052	1	0.1	0.00588235294117647	11239	1
4	Food 2	Intake 4	144	242851	1337575366	/users/cn/jespinosa/phecomp/data/CRG/20120502_FDF_CRG/20120502_FDF_CRG/20120518_FDF_CRG_c12.mtb	7140	430	WWFF	food_fat	4	242707	1337575222	1	0.120000000000001	0.00083333333333334	11240	1
4	Drink 1	Intake 1	17	242809	1337575324	/users/cn/jespinosa/phecomp/data/CRG/20120502_FDF_CRG/20120502_FDF_CRG/20120518_FDF_CRG_c12.mtb	2028	NA	WWFF	water	1	242792	1337575307	1	0.0399999999999991	0.00235294117647054	11241	1
4	Food 2	Intake 4	316	243597	1337576112	/users/cn/jespinosa/phecomp/data/CRG/20120502_FDF_CRG/20120502_FDF_CRG/20120518_FDF_CRG_c12.mtb	7143	1755	WWFF	food_fat	4	243281	1337575796	1	0.0800000000000018	0.000253164556962031	11242	1
4	Drink 1	Intake 1	15	243589	1337576104	/users/cn/jespinosa/phecomp/data/CRG/20120502_FDF_CRG/20120502_FDF_CRG/20120518_FDF_CRG_c12.mtb	2029	NA	WWFF	water	1	243574	1337576089	1	0.0200000000000005	0.00133333333333337	11243	1
4	Food 2	Intake 4	21	245373	1337577888	/users/cn/jespinosa/phecomp/data/CRG/20120502_FDF_CRG/20120502_FDF_CRG/20120518_FDF_CRG_c12.mtb	7150	56	WWFF	food_fat	4	245352	1337577867	1	0.0399999999999991	0.00190476190476186	11244	1
4	Food 2	Intake 4	327	245756	1337578271	/users/cn/jespinosa/phecomp/data/CRG/20120502_FDF_CRG/20120502_FDF_CRG/20120518_FDF_CRG_c12.mtb	7152	65	WWFF	food_fat	4	245429	1337577944	1	0.220000000000002	0.000672782874617743	11245	1
4	Food 2	Intake 4	86	245907	1337578422	/users/cn/jespinosa/phecomp/data/CRG/20120502_FDF_CRG/20120502_FDF_CRG/20120518_FDF_CRG_c12.mtb	7154	13	WWFF	food_fat	4	245821	1337578336	1	0.0399999999999991	0.000465116279069757	11246	1
4	Food 2	Intake 4	326	246246	1337578761	/users/cn/jespinosa/phecomp/data/CRG/20120502_FDF_CRG/20120502_FDF_CRG/20120518_FDF_CRG_c12.mtb	7155	11	WWFF	food_fat	4	245920	1337578435	1	1.84	0.0056441717791411	11247	1
4	Food 2	Intake 4	144	246401	1337578916	/users/cn/jespinosa/phecomp/data/CRG/20120502_FDF_CRG/20120502_FDF_CRG/20120518_FDF_CRG_c12.mtb	7156	8	WWFF	food_fat	4	246257	1337578772	1	0.100000000000001	0.000694444444444451	11248	1
4	Drink 1	Intake 1	23	246413	1337578928	/users/cn/jespinosa/phecomp/data/CRG/20120502_FDF_CRG/20120502_FDF_CRG/20120518_FDF_CRG_c12.mtb	2030	NA	WWFF	water	1	246390	1337578905	1	0.0800000000000001	0.00347826086956522	11249	1
4	Food 2	Intake 4	86	246495	1337579010	/users/cn/jespinosa/phecomp/data/CRG/20120502_FDF_CRG/20120502_FDF_CRG/20120518_FDF_CRG_c12.mtb	7157	14	WWFF	food_fat	4	246409	1337578924	1	0.120000000000001	0.00139534883720931	11250	1
4	Food 2	Intake 4	143	246652	1337579167	/users/cn/jespinosa/phecomp/data/CRG/20120502_FDF_CRG/20120502_FDF_CRG/20120518_FDF_CRG_c12.mtb	7158	COLL	WWFF	food_fat	4	246509	1337579024	1	0.120000000000001	0.000839160839160846	11251	1
4	Food 1	Intake 3	66	246696	1337579211	/users/cn/jespinosa/phecomp/data/CRG/20120502_FDF_CRG/20120502_FDF_CRG/20120518_FDF_CRG_c12.mtb	5113	COLL	WWFF	food_fat	3	246630	1337579145	1	0.0200000000000014	0.000303030303030324	11252	1
4	Food 2	Intake 4	192	246852	1337579367	/users/cn/jespinosa/phecomp/data/CRG/20120502_FDF_CRG/20120502_FDF_CRG/20120518_FDF_CRG_c12.mtb	7159	171	WWFF	food_fat	4	246660	1337579175	1	0.279999999999998	0.00145833333333332	11253	1
4	Drink 1	Intake 1	18	246931	1337579446	/users/cn/jespinosa/phecomp/data/CRG/20120502_FDF_CRG/20120502_FDF_CRG/20120518_FDF_CRG_c12.mtb	2031	NA	WWFF	water	1	246913	1337579428	1	0.04	0.00222222222222222	11254	1
4	Food 2	Intake 4	131	247154	1337579669	/users/cn/jespinosa/phecomp/data/CRG/20120502_FDF_CRG/20120502_FDF_CRG/20120518_FDF_CRG_c12.mtb	7161	306	WWFF	food_fat	4	247023	1337579538	1	0.260000000000002	0.0019847328244275	11255	1
4	Food 2	Intake 4	361	247821	1337580336	/users/cn/jespinosa/phecomp/data/CRG/20120502_FDF_CRG/20120502_FDF_CRG/20120518_FDF_CRG_c12.mtb	7164	124	WWFF	food_fat	4	247460	1337579975	1	0.120000000000001	0.000332409972299172	11256	1
4	Food 2	Intake 4	32	247977	1337580492	/users/cn/jespinosa/phecomp/data/CRG/20120502_FDF_CRG/20120502_FDF_CRG/20120518_FDF_CRG_c12.mtb	7166	9	WWFF	food_fat	4	247945	1337580460	1	0.16	0.005	11257	1
4	Food 2	Intake 4	206	248192	1337580707	/users/cn/jespinosa/phecomp/data/CRG/20120502_FDF_CRG/20120502_FDF_CRG/20120518_FDF_CRG_c12.mtb	7167	149	WWFF	food_fat	4	247986	1337580501	1	0.399999999999999	0.00194174757281553	11258	1
4	Food 2	Intake 4	14	248355	1337580870	/users/cn/jespinosa/phecomp/data/CRG/20120502_FDF_CRG/20120502_FDF_CRG/20120518_FDF_CRG_c12.mtb	7169	102	WWFF	food_fat	4	248341	1337580856	1	0.0599999999999987	0.00428571428571419	11259	1
4	Food 2	Intake 4	22	248479	1337580994	/users/cn/jespinosa/phecomp/data/CRG/20120502_FDF_CRG/20120502_FDF_CRG/20120518_FDF_CRG_c12.mtb	7170	1860	WWFF	food_fat	4	248457	1337580972	1	0.219999999999999	0.00999999999999996	11260	1
4	Drink 1	Intake 1	28	248502	1337581017	/users/cn/jespinosa/phecomp/data/CRG/20120502_FDF_CRG/20120502_FDF_CRG/20120518_FDF_CRG_c12.mtb	2032	NA	WWFF	water	1	248474	1337580989	1	0.0999999999999996	0.00357142857142856	11261	1
4	Food 2	Intake 4	22	250361	1337582876	/users/cn/jespinosa/phecomp/data/CRG/20120502_FDF_CRG/20120502_FDF_CRG/20120518_FDF_CRG_c12.mtb	7184	516	WWFF	food_fat	4	250339	1337582854	1	0.0200000000000031	0.00090909090909105	11262	1
4	Food 2	Intake 4	40	250917	1337583432	/users/cn/jespinosa/phecomp/data/CRG/20120502_FDF_CRG/20120502_FDF_CRG/20120518_FDF_CRG_c12.mtb	7187	405	WWFF	food_fat	4	250877	1337583392	1	0.620000000000001	0.0155	11263	1
4	Food 2	Intake 4	15	251337	1337583852	/users/cn/jespinosa/phecomp/data/CRG/20120502_FDF_CRG/20120502_FDF_CRG/20120518_FDF_CRG_c12.mtb	7190	339	WWFF	food_fat	4	251322	1337583837	1	0.0399999999999991	0.00266666666666661	11264	1
4	Food 2	Intake 4	28	251704	1337584219	/users/cn/jespinosa/phecomp/data/CRG/20120502_FDF_CRG/20120502_FDF_CRG/20120518_FDF_CRG_c12.mtb	7194	377	WWFF	food_fat	4	251676	1337584191	1	0.0599999999999987	0.0021428571428571	11265	1
4	Food 2	Intake 4	32	252113	1337584628	/users/cn/jespinosa/phecomp/data/CRG/20120502_FDF_CRG/20120502_FDF_CRG/20120518_FDF_CRG_c12.mtb	7195	604	WWFF	food_fat	4	252081	1337584596	1	0.0399999999999991	0.00124999999999997	11266	1
4	Drink 1	Intake 1	13	252386	1337584901	/users/cn/jespinosa/phecomp/data/CRG/20120502_FDF_CRG/20120502_FDF_CRG/20120518_FDF_CRG_c12.mtb	2033	NA	WWFF	water	1	252373	1337584888	1	0.04	0.00307692307692308	11267	1
4	Food 2	Intake 4	11	252728	1337585243	/users/cn/jespinosa/phecomp/data/CRG/20120502_FDF_CRG/20120502_FDF_CRG/20120518_FDF_CRG_c12.mtb	7199	2686	WWFF	food_fat	4	252717	1337585232	1	0.0200000000000031	0.0018181818181821	11268	1
4	Drink 1	Intake 1	20	254611	1337587126	/users/cn/jespinosa/phecomp/data/CRG/20120502_FDF_CRG/20120502_FDF_CRG/20120518_FDF_CRG_c12.mtb	2034	NA	WWFF	water	1	254591	1337587106	1	0.0800000000000001	0.00400000000000001	11269	1
4	Food 2	Intake 4	15	255429	1337587944	/users/cn/jespinosa/phecomp/data/CRG/20120502_FDF_CRG/20120502_FDF_CRG/20120518_FDF_CRG_c12.mtb	7213	2298	WWFF	food_fat	4	255414	1337587929	1	0.0399999999999991	0.00266666666666661	11270	1
4	Drink 1	Intake 1	19	256220	1337588735	/users/cn/jespinosa/phecomp/data/CRG/20120502_FDF_CRG/20120502_FDF_CRG/20120518_FDF_CRG_c12.mtb	2035	NA	WWFF	water	1	256201	1337588716	1	0.0800000000000001	0.00421052631578948	11271	1
4	Drink 1	Intake 1	25	257240	1337589755	/users/cn/jespinosa/phecomp/data/CRG/20120502_FDF_CRG/20120502_FDF_CRG/20120518_FDF_CRG_c12.mtb	2036	NA	WWFF	water	1	257215	1337589730	1	0.0999999999999996	0.00399999999999998	11272	1
4	Food 2	Intake 4	16	257743	1337590258	/users/cn/jespinosa/phecomp/data/CRG/20120502_FDF_CRG/20120502_FDF_CRG/20120518_FDF_CRG_c12.mtb	7219	1994	WWFF	food_fat	4	257727	1337590242	1	0.0600000000000023	0.00375000000000014	11273	1
4	Food 2	Intake 4	33	259770	1337592285	/users/cn/jespinosa/phecomp/data/CRG/20120502_FDF_CRG/20120502_FDF_CRG/20120518_FDF_CRG_c12.mtb	7225	1737	WWFF	food_fat	4	259737	1337592252	1	0.540000000000003	0.0163636363636365	11274	1
4	Drink 2	Intake 2	17	261343	1337593858	/users/cn/jespinosa/phecomp/data/CRG/20120502_FDF_CRG/20120502_FDF_CRG/20120518_FDF_CRG_c12.mtb	1891	NA	WWFF	water	2	261326	1337593841	1	0.02	0.00117647058823529	11275	1
4	Food 2	Intake 4	70	261577	1337594092	/users/cn/jespinosa/phecomp/data/CRG/20120502_FDF_CRG/20120502_FDF_CRG/20120518_FDF_CRG_c12.mtb	7234	8003	WWFF	food_fat	4	261507	1337594022	1	0.560000000000002	0.00800000000000003	11276	1
4	Food 1	Intake 3	71	222	1337602166	/users/cn/jespinosa/phecomp/data/CRG/20120502_FDF_CRG/20120502_FDF_CRG/20120521_FDF_CRG_c12.mtb	6917	9	WWFF	food_fat	3	151	1337602095	1	0.64	0.00901408450704225	11277	1
4	Food 1	Intake 3	77	308	1337602252	/users/cn/jespinosa/phecomp/data/CRG/20120502_FDF_CRG/20120502_FDF_CRG/20120521_FDF_CRG_c12.mtb	6918	COLL	WWFF	food_fat	3	231	1337602175	1	0.22	0.00285714285714286	11278	1
4	Food 2	Intake 4	20	276	1337602220	/users/cn/jespinosa/phecomp/data/CRG/20120502_FDF_CRG/20120502_FDF_CRG/20120521_FDF_CRG_c12.mtb	8894	20	WWFF	food_fat	4	256	1337602200	1	0.14	0.007	11279	1
4	Food 2	Intake 4	25	321	1337602265	/users/cn/jespinosa/phecomp/data/CRG/20120502_FDF_CRG/20120502_FDF_CRG/20120521_FDF_CRG_c12.mtb	8895	COLL	WWFF	food_fat	4	296	1337602240	1	0.08	0.0032	11280	1
4	Food 1	Intake 3	39	351	1337602295	/users/cn/jespinosa/phecomp/data/CRG/20120502_FDF_CRG/20120502_FDF_CRG/20120521_FDF_CRG_c12.mtb	6919	COLL	WWFF	food_fat	3	312	1337602256	1	0.02	0.000512820512820513	11281	1
4	Food 2	Intake 4	35	376	1337602320	/users/cn/jespinosa/phecomp/data/CRG/20120502_FDF_CRG/20120502_FDF_CRG/20120521_FDF_CRG_c12.mtb	8896	10	WWFF	food_fat	4	341	1337602285	1	0.46	0.0131428571428571	11282	1
4	Food 2	Intake 4	39	425	1337602369	/users/cn/jespinosa/phecomp/data/CRG/20120502_FDF_CRG/20120502_FDF_CRG/20120521_FDF_CRG_c12.mtb	8897	COLL	WWFF	food_fat	4	386	1337602330	1	0.82	0.021025641025641	11283	1
4	Food 1	Intake 3	35	454	1337602398	/users/cn/jespinosa/phecomp/data/CRG/20120502_FDF_CRG/20120502_FDF_CRG/20120521_FDF_CRG_c12.mtb	6921	7	WWFF	food_fat	3	419	1337602363	1	0.2	0.00571428571428571	11284	1
4	Food 1	Intake 3	134	595	1337602539	/users/cn/jespinosa/phecomp/data/CRG/20120502_FDF_CRG/20120502_FDF_CRG/20120521_FDF_CRG_c12.mtb	6922	34	WWFF	food_fat	3	461	1337602405	1	1.24	0.00925373134328358	11285	1
4	Food 1	Intake 3	126	755	1337602699	/users/cn/jespinosa/phecomp/data/CRG/20120502_FDF_CRG/20120502_FDF_CRG/20120521_FDF_CRG_c12.mtb	6923	COLL	WWFF	food_fat	3	629	1337602573	1	0.0800000000000001	0.000634920634920636	11286	1
4	Food 2	Intake 4	18	708	1337602652	/users/cn/jespinosa/phecomp/data/CRG/20120502_FDF_CRG/20120502_FDF_CRG/20120521_FDF_CRG_c12.mtb	8901	85	WWFF	food_fat	4	690	1337602634	1	0.0600000000000001	0.00333333333333334	11287	1
4	Food 1	Intake 3	76	869	1337602813	/users/cn/jespinosa/phecomp/data/CRG/20120502_FDF_CRG/20120502_FDF_CRG/20120521_FDF_CRG_c12.mtb	6924	6	WWFF	food_fat	3	793	1337602737	1	0.38	0.005	11288	1
4	Food 1	Intake 3	34	909	1337602853	/users/cn/jespinosa/phecomp/data/CRG/20120502_FDF_CRG/20120502_FDF_CRG/20120521_FDF_CRG_c12.mtb	6925	COLL	WWFF	food_fat	3	875	1337602819	1	0.26	0.00764705882352941	11289	1
4	Food 2	Intake 4	56	955	1337602899	/users/cn/jespinosa/phecomp/data/CRG/20120502_FDF_CRG/20120502_FDF_CRG/20120521_FDF_CRG_c12.mtb	8904	COLL	WWFF	food_fat	4	899	1337602843	1	0.72	0.0128571428571429	11290	1
4	Food 1	Intake 3	91	1022	1337602966	/users/cn/jespinosa/phecomp/data/CRG/20120502_FDF_CRG/20120502_FDF_CRG/20120521_FDF_CRG_c12.mtb	6926	31	WWFF	food_fat	3	931	1337602875	1	0.46	0.00505494505494506	11291	1
4	Food 1	Intake 3	165	1218	1337603162	/users/cn/jespinosa/phecomp/data/CRG/20120502_FDF_CRG/20120502_FDF_CRG/20120521_FDF_CRG_c12.mtb	6927	COLL	WWFF	food_fat	3	1053	1337602997	1	1.16	0.00703030303030303	11292	1
4	Food 2	Intake 4	29	1239	1337603183	/users/cn/jespinosa/phecomp/data/CRG/20120502_FDF_CRG/20120502_FDF_CRG/20120521_FDF_CRG_c12.mtb	8905	COLL	WWFF	food_fat	4	1210	1337603154	1	0.36	0.0124137931034483	11293	1
4	Food 1	Intake 3	210	1440	1337603384	/users/cn/jespinosa/phecomp/data/CRG/20120502_FDF_CRG/20120502_FDF_CRG/20120521_FDF_CRG_c12.mtb	6928	COLL	WWFF	food_fat	3	1230	1337603174	1	1.06	0.00504761904761905	11294	1
4	Food 2	Intake 4	38	1455	1337603399	/users/cn/jespinosa/phecomp/data/CRG/20120502_FDF_CRG/20120502_FDF_CRG/20120521_FDF_CRG_c12.mtb	8906	57	WWFF	food_fat	4	1417	1337603361	1	0.02	0.000526315789473684	11295	1
4	Food 1	Intake 3	95	1607	1337603551	/users/cn/jespinosa/phecomp/data/CRG/20120502_FDF_CRG/20120502_FDF_CRG/20120521_FDF_CRG_c12.mtb	6930	12	WWFF	food_fat	3	1512	1337603456	1	1.88	0.0197894736842105	11296	1
4	Food 1	Intake 3	94	1713	1337603657	/users/cn/jespinosa/phecomp/data/CRG/20120502_FDF_CRG/20120502_FDF_CRG/20120521_FDF_CRG_c12.mtb	6931	COLL	WWFF	food_fat	3	1619	1337603563	1	0.140000000000001	0.00148936170212767	11297	1
4	Food 2	Intake 4	50	1702	1337603646	/users/cn/jespinosa/phecomp/data/CRG/20120502_FDF_CRG/20120502_FDF_CRG/20120521_FDF_CRG_c12.mtb	8907	94	WWFF	food_fat	4	1652	1337603596	1	0.6	0.012	11298	1
4	Food 1	Intake 3	226	2022	1337603966	/users/cn/jespinosa/phecomp/data/CRG/20120502_FDF_CRG/20120502_FDF_CRG/20120521_FDF_CRG_c12.mtb	6933	516	WWFF	food_fat	3	1796	1337603740	1	0.7	0.00309734513274336	11299	1
4	Drink 2	Intake 2	16	2248	1337604192	/users/cn/jespinosa/phecomp/data/CRG/20120502_FDF_CRG/20120502_FDF_CRG/20120521_FDF_CRG_c12.mtb	2078	NA	WWFF	water	2	2232	1337604176	1	0.04	0.0025	11300	1
4	Food 2	Intake 4	94	2632	1337604576	/users/cn/jespinosa/phecomp/data/CRG/20120502_FDF_CRG/20120502_FDF_CRG/20120521_FDF_CRG_c12.mtb	8912	208	WWFF	food_fat	4	2538	1337604482	1	0.879999999999999	0.00936170212765956	11301	1
4	Food 1	Intake 3	59	2899	1337604843	/users/cn/jespinosa/phecomp/data/CRG/20120502_FDF_CRG/20120502_FDF_CRG/20120521_FDF_CRG_c12.mtb	6940	COLL	WWFF	food_fat	3	2840	1337604784	1	0.119999999999999	0.00203389830508473	11302	1
4	Food 2	Intake 4	67	2933	1337604877	/users/cn/jespinosa/phecomp/data/CRG/20120502_FDF_CRG/20120502_FDF_CRG/20120521_FDF_CRG_c12.mtb	8913	COLL	WWFF	food_fat	4	2866	1337604810	1	0.12	0.0017910447761194	11303	1
4	Food 1	Intake 3	33	2947	1337604891	/users/cn/jespinosa/phecomp/data/CRG/20120502_FDF_CRG/20120502_FDF_CRG/20120521_FDF_CRG_c12.mtb	6941	1864	WWFF	food_fat	3	2914	1337604858	1	0.0399999999999991	0.00121212121212118	11304	1
4	Food 1	Intake 3	44	4855	1337606799	/users/cn/jespinosa/phecomp/data/CRG/20120502_FDF_CRG/20120502_FDF_CRG/20120521_FDF_CRG_c12.mtb	6943	5481	WWFF	food_fat	3	4811	1337606755	1	0.0400000000000009	0.00090909090909093	11305	1
4	Drink 2	Intake 2	43	6911	1337608855	/users/cn/jespinosa/phecomp/data/CRG/20120502_FDF_CRG/20120502_FDF_CRG/20120521_FDF_CRG_c12.mtb	2080	NA	WWFF	water	2	6868	1337608812	1	0.12	0.0027906976744186	11306	1
4	Drink 2	Intake 2	28	7766	1337609710	/users/cn/jespinosa/phecomp/data/CRG/20120502_FDF_CRG/20120502_FDF_CRG/20120521_FDF_CRG_c12.mtb	2081	NA	WWFF	water	2	7738	1337609682	1	0.12	0.00428571428571429	11307	1
4	Drink 2	Intake 2	24	9215	1337611159	/users/cn/jespinosa/phecomp/data/CRG/20120502_FDF_CRG/20120502_FDF_CRG/20120521_FDF_CRG_c12.mtb	2082	NA	WWFF	water	2	9191	1337611135	1	0.06	0.0025	11308	1
4	Food 1	Intake 3	14	10350	1337612294	/users/cn/jespinosa/phecomp/data/CRG/20120502_FDF_CRG/20120502_FDF_CRG/20120521_FDF_CRG_c12.mtb	6949	1697	WWFF	food_fat	3	10336	1337612280	1	0.0399999999999991	0.00285714285714279	11309	1
4	Drink 2	Intake 2	21	10362	1337612306	/users/cn/jespinosa/phecomp/data/CRG/20120502_FDF_CRG/20120502_FDF_CRG/20120521_FDF_CRG_c12.mtb	2083	NA	WWFF	water	2	10341	1337612285	1	0.12	0.00571428571428571	11310	1
4	Food 1	Intake 3	29	12076	1337614020	/users/cn/jespinosa/phecomp/data/CRG/20120502_FDF_CRG/20120502_FDF_CRG/20120521_FDF_CRG_c12.mtb	6953	1592	WWFF	food_fat	3	12047	1337613991	1	0.0600000000000005	0.0020689655172414	11311	1
4	Food 1	Intake 3	45	13713	1337615657	/users/cn/jespinosa/phecomp/data/CRG/20120502_FDF_CRG/20120502_FDF_CRG/20120521_FDF_CRG_c12.mtb	6956	41	WWFF	food_fat	3	13668	1337615612	1	0.279999999999999	0.0062222222222222	11312	1
4	Food 2	Intake 4	8	13762	1337615706	/users/cn/jespinosa/phecomp/data/CRG/20120502_FDF_CRG/20120502_FDF_CRG/20120521_FDF_CRG_c12.mtb	8914	3591	WWFF	food_fat	4	13754	1337615698	1	0.0200000000000005	0.00250000000000006	11313	1
4	Drink 2	Intake 2	22	14623	1337616567	/users/cn/jespinosa/phecomp/data/CRG/20120502_FDF_CRG/20120502_FDF_CRG/20120521_FDF_CRG_c12.mtb	2085	NA	WWFF	water	2	14601	1337616545	1	0.1	0.00454545454545455	11314	1
4	Food 1	Intake 3	13	17366	1337619310	/users/cn/jespinosa/phecomp/data/CRG/20120502_FDF_CRG/20120502_FDF_CRG/20120521_FDF_CRG_c12.mtb	6960	5173	WWFF	food_fat	3	17353	1337619297	1	0.0400000000000009	0.00307692307692315	11315	1
4	Drink 2	Intake 2	15	19142	1337621086	/users/cn/jespinosa/phecomp/data/CRG/20120502_FDF_CRG/20120502_FDF_CRG/20120521_FDF_CRG_c12.mtb	2086	NA	WWFF	water	2	19127	1337621071	1	0.0599999999999999	0.00399999999999999	11316	1
4	Drink 2	Intake 2	19	19791	1337621735	/users/cn/jespinosa/phecomp/data/CRG/20120502_FDF_CRG/20120502_FDF_CRG/20120521_FDF_CRG_c12.mtb	2087	NA	WWFF	water	2	19772	1337621716	1	0.04	0.00210526315789474	11317	1
4	Drink 2	Intake 2	20	21295	1337623239	/users/cn/jespinosa/phecomp/data/CRG/20120502_FDF_CRG/20120502_FDF_CRG/20120521_FDF_CRG_c12.mtb	2088	NA	WWFF	water	2	21275	1337623219	1	0.0599999999999999	0.00299999999999999	11318	1
4	Food 2	Intake 4	14	22553	1337624497	/users/cn/jespinosa/phecomp/data/CRG/20120502_FDF_CRG/20120502_FDF_CRG/20120521_FDF_CRG_c12.mtb	8915	12	WWFF	food_fat	4	22539	1337624483	1	0.04	0.00285714285714286	11319	1
4	Food 2	Intake 4	45	22610	1337624554	/users/cn/jespinosa/phecomp/data/CRG/20120502_FDF_CRG/20120502_FDF_CRG/20120521_FDF_CRG_c12.mtb	8916	6	WWFF	food_fat	4	22565	1337624509	1	0.14	0.00311111111111111	11320	1
4	Food 1	Intake 3	35	22651	1337624595	/users/cn/jespinosa/phecomp/data/CRG/20120502_FDF_CRG/20120502_FDF_CRG/20120521_FDF_CRG_c12.mtb	6969	COLL	WWFF	food_fat	3	22616	1337624560	1	0.0600000000000005	0.00171428571428573	11321	1
4	Food 2	Intake 4	150	22788	1337624732	/users/cn/jespinosa/phecomp/data/CRG/20120502_FDF_CRG/20120502_FDF_CRG/20120521_FDF_CRG_c12.mtb	8917	COLL	WWFF	food_fat	4	22638	1337624582	1	0.58	0.00386666666666667	11322	1
4	Food 1	Intake 3	348	23040	1337624984	/users/cn/jespinosa/phecomp/data/CRG/20120502_FDF_CRG/20120502_FDF_CRG/20120521_FDF_CRG_c12.mtb	6970	COLL	WWFF	food_fat	3	22692	1337624636	1	1.86	0.0053448275862069	11323	1
4	Food 2	Intake 4	30	22823	1337624767	/users/cn/jespinosa/phecomp/data/CRG/20120502_FDF_CRG/20120502_FDF_CRG/20120521_FDF_CRG_c12.mtb	8918	69	WWFF	food_fat	4	22793	1337624737	1	0.04	0.00133333333333333	11324	1
4	Food 2	Intake 4	38	22930	1337624874	/users/cn/jespinosa/phecomp/data/CRG/20120502_FDF_CRG/20120502_FDF_CRG/20120521_FDF_CRG_c12.mtb	8919	142	WWFF	food_fat	4	22892	1337624836	1	0.22	0.00578947368421053	11325	1
4	Food 2	Intake 4	160	23232	1337625176	/users/cn/jespinosa/phecomp/data/CRG/20120502_FDF_CRG/20120502_FDF_CRG/20120521_FDF_CRG_c12.mtb	8920	75	WWFF	food_fat	4	23072	1337625016	1	2.02	0.012625	11326	1
4	Food 2	Intake 4	124	23431	1337625375	/users/cn/jespinosa/phecomp/data/CRG/20120502_FDF_CRG/20120502_FDF_CRG/20120521_FDF_CRG_c12.mtb	8922	67	WWFF	food_fat	4	23307	1337625251	1	0.28	0.00225806451612903	11327	1
4	Food 1	Intake 3	517	24015	1337625959	/users/cn/jespinosa/phecomp/data/CRG/20120502_FDF_CRG/20120502_FDF_CRG/20120521_FDF_CRG_c12.mtb	6972	COLL	WWFF	food_fat	3	23498	1337625442	1	0.18	0.00034816247582205	11328	1
4	Food 2	Intake 4	12	23650	1337625594	/users/cn/jespinosa/phecomp/data/CRG/20120502_FDF_CRG/20120502_FDF_CRG/20120521_FDF_CRG_c12.mtb	8925	136	WWFF	food_fat	4	23638	1337625582	1	0.04	0.00333333333333333	11329	1
4	Food 2	Intake 4	218	24004	1337625948	/users/cn/jespinosa/phecomp/data/CRG/20120502_FDF_CRG/20120502_FDF_CRG/20120521_FDF_CRG_c12.mtb	8928	107	WWFF	food_fat	4	23786	1337625730	1	0.14	0.000642201834862385	11330	1
4	Food 1	Intake 3	309	24420	1337626364	/users/cn/jespinosa/phecomp/data/CRG/20120502_FDF_CRG/20120502_FDF_CRG/20120521_FDF_CRG_c12.mtb	6974	COLL	WWFF	food_fat	3	24111	1337626055	1	0.199999999999999	0.000647249190938508	11331	1
4	Food 2	Intake 4	104	24218	1337626162	/users/cn/jespinosa/phecomp/data/CRG/20120502_FDF_CRG/20120502_FDF_CRG/20120521_FDF_CRG_c12.mtb	8930	25	WWFF	food_fat	4	24114	1337626058	1	0.38	0.00365384615384615	11332	1
4	Food 2	Intake 4	102	24345	1337626289	/users/cn/jespinosa/phecomp/data/CRG/20120502_FDF_CRG/20120502_FDF_CRG/20120521_FDF_CRG_c12.mtb	8931	365	WWFF	food_fat	4	24243	1337626187	1	0.0599999999999996	0.000588235294117643	11333	1
4	Food 1	Intake 3	236	24946	1337626890	/users/cn/jespinosa/phecomp/data/CRG/20120502_FDF_CRG/20120502_FDF_CRG/20120521_FDF_CRG_c12.mtb	6975	COLL	WWFF	food_fat	3	24710	1337626654	1	0.0800000000000001	0.000338983050847458	11334	1
4	Food 2	Intake 4	28	24942	1337626886	/users/cn/jespinosa/phecomp/data/CRG/20120502_FDF_CRG/20120502_FDF_CRG/20120521_FDF_CRG_c12.mtb	8936	150	WWFF	food_fat	4	24914	1337626858	1	0.0200000000000005	0.000714285714285732	11335	1
4	Food 1	Intake 3	617	25709	1337627653	/users/cn/jespinosa/phecomp/data/CRG/20120502_FDF_CRG/20120502_FDF_CRG/20120521_FDF_CRG_c12.mtb	6978	COLL	WWFF	food_fat	3	25092	1337627036	1	0.340000000000002	0.000551053484602921	11336	1
4	Food 2	Intake 4	147	25241	1337627185	/users/cn/jespinosa/phecomp/data/CRG/20120502_FDF_CRG/20120502_FDF_CRG/20120521_FDF_CRG_c12.mtb	8939	140	WWFF	food_fat	4	25094	1337627038	1	0.0600000000000005	0.000408163265306126	11337	1
4	Food 2	Intake 4	323	25704	1337627648	/users/cn/jespinosa/phecomp/data/CRG/20120502_FDF_CRG/20120502_FDF_CRG/20120521_FDF_CRG_c12.mtb	8941	58	WWFF	food_fat	4	25381	1337627325	1	1.34	0.00414860681114551	11338	1
4	Food 2	Intake 4	90	25852	1337627796	/users/cn/jespinosa/phecomp/data/CRG/20120502_FDF_CRG/20120502_FDF_CRG/20120521_FDF_CRG_c12.mtb	8942	258	WWFF	food_fat	4	25762	1337627706	1	1.38	0.0153333333333333	11339	1
4	Food 1	Intake 3	15	26125	1337628069	/users/cn/jespinosa/phecomp/data/CRG/20120502_FDF_CRG/20120502_FDF_CRG/20120521_FDF_CRG_c12.mtb	6980	36	WWFF	food_fat	3	26110	1337628054	1	0.0600000000000005	0.00400000000000003	11340	1
4	Food 2	Intake 4	73	26234	1337628178	/users/cn/jespinosa/phecomp/data/CRG/20120502_FDF_CRG/20120502_FDF_CRG/20120521_FDF_CRG_c12.mtb	8943	13	WWFF	food_fat	4	26161	1337628105	1	0.0999999999999996	0.00136986301369862	11341	1
4	Drink 2	Intake 2	38	26270	1337628214	/users/cn/jespinosa/phecomp/data/CRG/20120502_FDF_CRG/20120502_FDF_CRG/20120521_FDF_CRG_c12.mtb	2094	NA	WWFF	water	2	26232	1337628176	1	0.04	0.00105263157894737	11342	1
4	Food 1	Intake 3	445	26692	1337628636	/users/cn/jespinosa/phecomp/data/CRG/20120502_FDF_CRG/20120502_FDF_CRG/20120521_FDF_CRG_c12.mtb	6982	COLL	WWFF	food_fat	3	26247	1337628191	1	0.0800000000000001	0.000179775280898877	11343	1
4	Food 2	Intake 4	245	26515	1337628459	/users/cn/jespinosa/phecomp/data/CRG/20120502_FDF_CRG/20120502_FDF_CRG/20120521_FDF_CRG_c12.mtb	8944	70	WWFF	food_fat	4	26270	1337628214	1	2.38	0.00971428571428571	11344	1
4	Food 2	Intake 4	102	26687	1337628631	/users/cn/jespinosa/phecomp/data/CRG/20120502_FDF_CRG/20120502_FDF_CRG/20120521_FDF_CRG_c12.mtb	8946	227	WWFF	food_fat	4	26585	1337628529	1	2.1	0.0205882352941176	11345	1
4	Food 2	Intake 4	81	26995	1337628939	/users/cn/jespinosa/phecomp/data/CRG/20120502_FDF_CRG/20120502_FDF_CRG/20120521_FDF_CRG_c12.mtb	8949	161	WWFF	food_fat	4	26914	1337628858	1	0.620000000000001	0.00765432098765433	11346	1
4	Food 1	Intake 3	240	27396	1337629340	/users/cn/jespinosa/phecomp/data/CRG/20120502_FDF_CRG/20120502_FDF_CRG/20120521_FDF_CRG_c12.mtb	6985	COLL	WWFF	food_fat	3	27156	1337629100	1	0.0800000000000001	0.000333333333333334	11347	1
4	Drink 2	Intake 2	18	27246	1337629190	/users/cn/jespinosa/phecomp/data/CRG/20120502_FDF_CRG/20120502_FDF_CRG/20120521_FDF_CRG_c12.mtb	2096	NA	WWFF	water	2	27228	1337629172	1	0.04	0.00222222222222222	11348	1
4	Food 2	Intake 4	54	27397	1337629341	/users/cn/jespinosa/phecomp/data/CRG/20120502_FDF_CRG/20120502_FDF_CRG/20120521_FDF_CRG_c12.mtb	8954	688	WWFF	food_fat	4	27343	1337629287	1	0.0600000000000005	0.00111111111111112	11349	1
4	Food 1	Intake 3	13	28098	1337630042	/users/cn/jespinosa/phecomp/data/CRG/20120502_FDF_CRG/20120502_FDF_CRG/20120521_FDF_CRG_c12.mtb	6989	962	WWFF	food_fat	3	28085	1337630029	1	0.0600000000000005	0.00461538461538465	11350	1
4	Drink 2	Intake 2	39	28129	1337630073	/users/cn/jespinosa/phecomp/data/CRG/20120502_FDF_CRG/20120502_FDF_CRG/20120521_FDF_CRG_c12.mtb	2097	NA	WWFF	water	2	28090	1337630034	1	0.0399999999999999	0.00102564102564102	11351	1
4	Food 1	Intake 3	26	29086	1337631030	/users/cn/jespinosa/phecomp/data/CRG/20120502_FDF_CRG/20120502_FDF_CRG/20120521_FDF_CRG_c12.mtb	6993	COLL	WWFF	food_fat	3	29060	1337631004	1	0.140000000000001	0.00538461538461542	11352	1
4	Food 2	Intake 4	10	29082	1337631026	/users/cn/jespinosa/phecomp/data/CRG/20120502_FDF_CRG/20120502_FDF_CRG/20120521_FDF_CRG_c12.mtb	8969	309	WWFF	food_fat	4	29072	1337631016	1	0.0400000000000009	0.00400000000000009	11353	1
4	Food 1	Intake 3	210	29601	1337631545	/users/cn/jespinosa/phecomp/data/CRG/20120502_FDF_CRG/20120502_FDF_CRG/20120521_FDF_CRG_c12.mtb	6995	COLL	WWFF	food_fat	3	29391	1337631335	1	0.56	0.00266666666666667	11354	1
4	Food 2	Intake 4	130	29573	1337631517	/users/cn/jespinosa/phecomp/data/CRG/20120502_FDF_CRG/20120502_FDF_CRG/20120521_FDF_CRG_c12.mtb	8973	167	WWFF	food_fat	4	29443	1337631387	1	0.0800000000000001	0.000615384615384616	11355	1
4	Food 1	Intake 3	94	29834	1337631778	/users/cn/jespinosa/phecomp/data/CRG/20120502_FDF_CRG/20120502_FDF_CRG/20120521_FDF_CRG_c12.mtb	6997	6	WWFF	food_fat	3	29740	1337631684	1	0.0400000000000009	0.000425531914893627	11356	1
4	Drink 2	Intake 2	15	29813	1337631757	/users/cn/jespinosa/phecomp/data/CRG/20120502_FDF_CRG/20120502_FDF_CRG/20120521_FDF_CRG_c12.mtb	2100	NA	WWFF	water	2	29798	1337631742	1	0.0600000000000001	0.00400000000000001	11357	1
4	Food 1	Intake 3	261	30101	1337632045	/users/cn/jespinosa/phecomp/data/CRG/20120502_FDF_CRG/20120502_FDF_CRG/20120521_FDF_CRG_c12.mtb	6998	COLL	WWFF	food_fat	3	29840	1337631784	1	0.48	0.00183908045977011	11358	1
4	Food 2	Intake 4	66	30124	1337632068	/users/cn/jespinosa/phecomp/data/CRG/20120502_FDF_CRG/20120502_FDF_CRG/20120521_FDF_CRG_c12.mtb	8977	577	WWFF	food_fat	4	30058	1337632002	1	0.0999999999999996	0.00151515151515151	11359	1
4	Drink 1	Intake 1	32	30528	1337632472	/users/cn/jespinosa/phecomp/data/CRG/20120502_FDF_CRG/20120502_FDF_CRG/20120521_FDF_CRG_c12.mtb	2322	NA	WWFF	water	1	30496	1337632440	1	0.08	0.0025	11360	1
4	Food 1	Intake 3	139	30840	1337632784	/users/cn/jespinosa/phecomp/data/CRG/20120502_FDF_CRG/20120502_FDF_CRG/20120521_FDF_CRG_c12.mtb	7005	COLL	WWFF	food_fat	3	30701	1337632645	1	0.4	0.00287769784172662	11361	1
4	Food 2	Intake 4	14	30717	1337632661	/users/cn/jespinosa/phecomp/data/CRG/20120502_FDF_CRG/20120502_FDF_CRG/20120521_FDF_CRG_c12.mtb	8982	8	WWFF	food_fat	4	30703	1337632647	1	0.0200000000000014	0.00142857142857153	11362	1
4	Food 2	Intake 4	73	30798	1337632742	/users/cn/jespinosa/phecomp/data/CRG/20120502_FDF_CRG/20120502_FDF_CRG/20120521_FDF_CRG_c12.mtb	8983	91	WWFF	food_fat	4	30725	1337632669	1	0.0799999999999983	0.00109589041095888	11363	1
4	Drink 2	Intake 2	15	30823	1337632767	/users/cn/jespinosa/phecomp/data/CRG/20120502_FDF_CRG/20120502_FDF_CRG/20120521_FDF_CRG_c12.mtb	2101	NA	WWFF	water	2	30808	1337632752	1	0.02	0.00133333333333333	11364	1
4	Food 1	Intake 3	721	31610	1337633554	/users/cn/jespinosa/phecomp/data/CRG/20120502_FDF_CRG/20120502_FDF_CRG/20120521_FDF_CRG_c12.mtb	7006	COLL	WWFF	food_fat	3	30889	1337632833	1	0.0800000000000001	0.000110957004160888	11365	1
4	Food 2	Intake 4	149	31162	1337633106	/users/cn/jespinosa/phecomp/data/CRG/20120502_FDF_CRG/20120502_FDF_CRG/20120521_FDF_CRG_c12.mtb	8988	1097	WWFF	food_fat	4	31013	1337632957	1	0.0800000000000018	0.000536912751677864	11366	1
4	Food 1	Intake 3	12	32271	1337634215	/users/cn/jespinosa/phecomp/data/CRG/20120502_FDF_CRG/20120502_FDF_CRG/20120521_FDF_CRG_c12.mtb	7011	530	WWFF	food_fat	3	32259	1337634203	1	0.0399999999999991	0.00333333333333326	11367	1
4	Drink 1	Intake 1	13	32421	1337634365	/users/cn/jespinosa/phecomp/data/CRG/20120502_FDF_CRG/20120502_FDF_CRG/20120521_FDF_CRG_c12.mtb	2324	NA	WWFF	water	1	32408	1337634352	1	0.08	0.00615384615384615	11368	1
4	Food 1	Intake 3	18	32819	1337634763	/users/cn/jespinosa/phecomp/data/CRG/20120502_FDF_CRG/20120502_FDF_CRG/20120521_FDF_CRG_c12.mtb	7018	173	WWFF	food_fat	3	32801	1337634745	1	0.139999999999999	0.00777777777777772	11369	1
4	Food 1	Intake 3	14	33006	1337634950	/users/cn/jespinosa/phecomp/data/CRG/20120502_FDF_CRG/20120502_FDF_CRG/20120521_FDF_CRG_c12.mtb	7020	107	WWFF	food_fat	3	32992	1337634936	1	0.0399999999999991	0.00285714285714279	11370	1
4	Food 1	Intake 3	13	33126	1337635070	/users/cn/jespinosa/phecomp/data/CRG/20120502_FDF_CRG/20120502_FDF_CRG/20120521_FDF_CRG_c12.mtb	7021	278	WWFF	food_fat	3	33113	1337635057	1	0.0200000000000014	0.00153846153846165	11371	1
4	Food 1	Intake 3	82	33486	1337635430	/users/cn/jespinosa/phecomp/data/CRG/20120502_FDF_CRG/20120502_FDF_CRG/20120521_FDF_CRG_c12.mtb	7024	243	WWFF	food_fat	3	33404	1337635348	1	0.0600000000000005	0.000731707317073177	11372	1
4	Food 1	Intake 3	15	33744	1337635688	/users/cn/jespinosa/phecomp/data/CRG/20120502_FDF_CRG/20120502_FDF_CRG/20120521_FDF_CRG_c12.mtb	7029	390	WWFF	food_fat	3	33729	1337635673	1	0.0200000000000014	0.00133333333333343	11373	1
4	Drink 1	Intake 1	21	34096	1337636040	/users/cn/jespinosa/phecomp/data/CRG/20120502_FDF_CRG/20120502_FDF_CRG/20120521_FDF_CRG_c12.mtb	2325	NA	WWFF	water	1	34075	1337636019	1	0.04	0.0019047619047619	11374	1
4	Food 1	Intake 3	132	34266	1337636210	/users/cn/jespinosa/phecomp/data/CRG/20120502_FDF_CRG/20120502_FDF_CRG/20120521_FDF_CRG_c12.mtb	7032	COLL	WWFF	food_fat	3	34134	1337636078	1	0.74	0.00560606060606061	11375	1
4	Food 2	Intake 4	52	34214	1337636158	/users/cn/jespinosa/phecomp/data/CRG/20120502_FDF_CRG/20120502_FDF_CRG/20120521_FDF_CRG_c12.mtb	8997	351	WWFF	food_fat	4	34162	1337636106	1	0.0599999999999987	0.00115384615384613	11376	1
4	Food 1	Intake 3	34	34599	1337636543	/users/cn/jespinosa/phecomp/data/CRG/20120502_FDF_CRG/20120502_FDF_CRG/20120521_FDF_CRG_c12.mtb	7034	COLL	WWFF	food_fat	3	34565	1337636509	1	0.0400000000000009	0.00117647058823532	11377	1
4	Food 2	Intake 4	13	34598	1337636542	/users/cn/jespinosa/phecomp/data/CRG/20120502_FDF_CRG/20120502_FDF_CRG/20120521_FDF_CRG_c12.mtb	8998	469	WWFF	food_fat	4	34585	1337636529	1	0.0399999999999991	0.00307692307692301	11378	1
4	Food 1	Intake 3	31	35098	1337637042	/users/cn/jespinosa/phecomp/data/CRG/20120502_FDF_CRG/20120502_FDF_CRG/20120521_FDF_CRG_c12.mtb	7039	67	WWFF	food_fat	3	35067	1337637011	1	0.0400000000000009	0.00129032258064519	11379	1
4	Food 1	Intake 3	17	35182	1337637126	/users/cn/jespinosa/phecomp/data/CRG/20120502_FDF_CRG/20120502_FDF_CRG/20120521_FDF_CRG_c12.mtb	7042	689	WWFF	food_fat	3	35165	1337637109	1	0.18	0.0105882352941176	11380	1
4	Drink 1	Intake 1	26	35243	1337637187	/users/cn/jespinosa/phecomp/data/CRG/20120502_FDF_CRG/20120502_FDF_CRG/20120521_FDF_CRG_c12.mtb	2326	NA	WWFF	water	1	35217	1337637161	1	0.06	0.00230769230769231	11381	1
4	Food 1	Intake 3	14	35885	1337637829	/users/cn/jespinosa/phecomp/data/CRG/20120502_FDF_CRG/20120502_FDF_CRG/20120521_FDF_CRG_c12.mtb	7048	1107	WWFF	food_fat	3	35871	1337637815	1	0.0200000000000014	0.00142857142857153	11382	1
4	Drink 1	Intake 1	12	36488	1337638432	/users/cn/jespinosa/phecomp/data/CRG/20120502_FDF_CRG/20120502_FDF_CRG/20120521_FDF_CRG_c12.mtb	2327	NA	WWFF	water	1	36476	1337638420	1	0.04	0.00333333333333333	11383	1
4	Food 1	Intake 3	336	37328	1337639272	/users/cn/jespinosa/phecomp/data/CRG/20120502_FDF_CRG/20120502_FDF_CRG/20120521_FDF_CRG_c12.mtb	7054	COLL	WWFF	food_fat	3	36992	1337638936	1	0.84	0.0025	11384	1
4	Food 2	Intake 4	77	37079	1337639023	/users/cn/jespinosa/phecomp/data/CRG/20120502_FDF_CRG/20120502_FDF_CRG/20120521_FDF_CRG_c12.mtb	9004	132	WWFF	food_fat	4	37002	1337638946	1	0.120000000000001	0.00155844155844157	11385	1
4	Food 2	Intake 4	118	37329	1337639273	/users/cn/jespinosa/phecomp/data/CRG/20120502_FDF_CRG/20120502_FDF_CRG/20120521_FDF_CRG_c12.mtb	9007	647	WWFF	food_fat	4	37211	1337639155	1	0.0799999999999983	0.000677966101694901	11386	1
4	Food 1	Intake 3	17	37993	1337639937	/users/cn/jespinosa/phecomp/data/CRG/20120502_FDF_CRG/20120502_FDF_CRG/20120521_FDF_CRG_c12.mtb	7060	10	WWFF	food_fat	3	37976	1337639920	1	0.180000000000001	0.0105882352941177	11387	1
4	Food 1	Intake 3	43	38046	1337639990	/users/cn/jespinosa/phecomp/data/CRG/20120502_FDF_CRG/20120502_FDF_CRG/20120521_FDF_CRG_c12.mtb	7061	105	WWFF	food_fat	3	38003	1337639947	1	0.0599999999999987	0.00139534883720927	11388	1
4	Food 1	Intake 3	603	38754	1337640698	/users/cn/jespinosa/phecomp/data/CRG/20120502_FDF_CRG/20120502_FDF_CRG/20120521_FDF_CRG_c12.mtb	7063	COLL	WWFF	food_fat	3	38151	1337640095	1	0.26	0.000431177446102819	11389	1
4	Food 2	Intake 4	62	38513	1337640457	/users/cn/jespinosa/phecomp/data/CRG/20120502_FDF_CRG/20120502_FDF_CRG/20120521_FDF_CRG_c12.mtb	9018	115	WWFF	food_fat	4	38451	1337640395	1	0.0200000000000014	0.000322580645161313	11390	1
4	Food 2	Intake 4	113	38741	1337640685	/users/cn/jespinosa/phecomp/data/CRG/20120502_FDF_CRG/20120502_FDF_CRG/20120521_FDF_CRG_c12.mtb	9021	64	WWFF	food_fat	4	38628	1337640572	1	0.0599999999999987	0.000530973451327422	11391	1
4	Food 2	Intake 4	86	38891	1337640835	/users/cn/jespinosa/phecomp/data/CRG/20120502_FDF_CRG/20120502_FDF_CRG/20120521_FDF_CRG_c12.mtb	9022	COLL	WWFF	food_fat	4	38805	1337640749	1	0.100000000000001	0.00116279069767443	11392	1
4	Food 1	Intake 3	224	39030	1337640974	/users/cn/jespinosa/phecomp/data/CRG/20120502_FDF_CRG/20120502_FDF_CRG/20120521_FDF_CRG_c12.mtb	7064	249	WWFF	food_fat	3	38806	1337640750	1	0.16	0.000714285714285714	11393	1
4	Food 1	Intake 3	70	39349	1337641293	/users/cn/jespinosa/phecomp/data/CRG/20120502_FDF_CRG/20120502_FDF_CRG/20120521_FDF_CRG_c12.mtb	7066	11	WWFF	food_fat	3	39279	1337641223	1	0.0200000000000014	0.000285714285714306	11394	1
4	Food 1	Intake 3	216	39576	1337641520	/users/cn/jespinosa/phecomp/data/CRG/20120502_FDF_CRG/20120502_FDF_CRG/20120521_FDF_CRG_c12.mtb	7067	COLL	WWFF	food_fat	3	39360	1337641304	1	0.0399999999999991	0.000185185185185181	11395	1
4	Food 2	Intake 4	22	39501	1337641445	/users/cn/jespinosa/phecomp/data/CRG/20120502_FDF_CRG/20120502_FDF_CRG/20120521_FDF_CRG_c12.mtb	9031	964	WWFF	food_fat	4	39479	1337641423	1	0.0600000000000005	0.00272727272727275	11396	1
4	Drink 1	Intake 1	13	39509	1337641453	/users/cn/jespinosa/phecomp/data/CRG/20120502_FDF_CRG/20120502_FDF_CRG/20120521_FDF_CRG_c12.mtb	2330	NA	WWFF	water	1	39496	1337641440	1	0.06	0.00461538461538461	11397	1
4	Drink 2	Intake 2	20	39577	1337641521	/users/cn/jespinosa/phecomp/data/CRG/20120502_FDF_CRG/20120502_FDF_CRG/20120521_FDF_CRG_c12.mtb	2106	NA	WWFF	water	2	39557	1337641501	1	0.0399999999999999	0.00199999999999999	11398	1
4	Food 2	Intake 4	14	40479	1337642423	/users/cn/jespinosa/phecomp/data/CRG/20120502_FDF_CRG/20120502_FDF_CRG/20120521_FDF_CRG_c12.mtb	9037	303	WWFF	food_fat	4	40465	1337642409	1	0.0399999999999991	0.00285714285714279	11399	1
4	Drink 1	Intake 1	75	40616	1337642560	/users/cn/jespinosa/phecomp/data/CRG/20120502_FDF_CRG/20120502_FDF_CRG/20120521_FDF_CRG_c12.mtb	2331	NA	WWFF	water	1	40541	1337642485	1	0.06	0.0008	11400	1
4	Drink 1	Intake 1	27	40658	1337642602	/users/cn/jespinosa/phecomp/data/CRG/20120502_FDF_CRG/20120502_FDF_CRG/20120521_FDF_CRG_c12.mtb	2332	NA	WWFF	water	1	40631	1337642575	1	0.04	0.00148148148148148	11401	1
4	Food 2	Intake 4	14	40796	1337642740	/users/cn/jespinosa/phecomp/data/CRG/20120502_FDF_CRG/20120502_FDF_CRG/20120521_FDF_CRG_c12.mtb	9043	388	WWFF	food_fat	4	40782	1337642726	1	0.0599999999999987	0.00428571428571419	11402	1
4	Food 1	Intake 3	1184	42368	1337644312	/users/cn/jespinosa/phecomp/data/CRG/20120502_FDF_CRG/20120502_FDF_CRG/20120521_FDF_CRG_c12.mtb	7075	COLL	WWFF	food_fat	3	41184	1337643128	1	0.34	0.000287162162162162	11403	1
4	Food 2	Intake 4	18	42147	1337644091	/users/cn/jespinosa/phecomp/data/CRG/20120502_FDF_CRG/20120502_FDF_CRG/20120521_FDF_CRG_c12.mtb	9050	159	WWFF	food_fat	4	42129	1337644073	1	0.0399999999999991	0.00222222222222217	11404	1
4	Food 2	Intake 4	61	42367	1337644311	/users/cn/jespinosa/phecomp/data/CRG/20120502_FDF_CRG/20120502_FDF_CRG/20120521_FDF_CRG_c12.mtb	9052	551	WWFF	food_fat	4	42306	1337644250	1	0.0200000000000014	0.000327868852459039	11405	1
4	Food 2	Intake 4	200	43118	1337645062	/users/cn/jespinosa/phecomp/data/CRG/20120502_FDF_CRG/20120502_FDF_CRG/20120521_FDF_CRG_c12.mtb	9057	331	WWFF	food_fat	4	42918	1337644862	1	0.0399999999999991	0.000199999999999995	11406	1
4	Drink 2	Intake 2	47	43106	1337645050	/users/cn/jespinosa/phecomp/data/CRG/20120502_FDF_CRG/20120502_FDF_CRG/20120521_FDF_CRG_c12.mtb	2107	NA	WWFF	water	2	43059	1337645003	1	0.02	0.000425531914893617	11407	1
4	Food 1	Intake 3	142	43591	1337645535	/users/cn/jespinosa/phecomp/data/CRG/20120502_FDF_CRG/20120502_FDF_CRG/20120521_FDF_CRG_c12.mtb	7083	7	WWFF	food_fat	3	43449	1337645393	1	0.18	0.00126760563380282	11408	1
4	Food 1	Intake 3	128	43726	1337645670	/users/cn/jespinosa/phecomp/data/CRG/20120502_FDF_CRG/20120502_FDF_CRG/20120521_FDF_CRG_c12.mtb	7084	367	WWFF	food_fat	3	43598	1337645542	1	0.0400000000000009	0.000312500000000007	11409	1
4	Food 1	Intake 3	12	44105	1337646049	/users/cn/jespinosa/phecomp/data/CRG/20120502_FDF_CRG/20120502_FDF_CRG/20120521_FDF_CRG_c12.mtb	7090	690	WWFF	food_fat	3	44093	1337646037	1	0.0400000000000009	0.00333333333333341	11410	1
4	Food 1	Intake 3	10	44805	1337646749	/users/cn/jespinosa/phecomp/data/CRG/20120502_FDF_CRG/20120502_FDF_CRG/20120521_FDF_CRG_c12.mtb	7092	212	WWFF	food_fat	3	44795	1337646739	1	0.0200000000000014	0.00200000000000014	11411	1
4	Food 1	Intake 3	87	45104	1337647048	/users/cn/jespinosa/phecomp/data/CRG/20120502_FDF_CRG/20120502_FDF_CRG/20120521_FDF_CRG_c12.mtb	7094	123	WWFF	food_fat	3	45017	1337646961	1	0.0399999999999991	0.000459770114942518	11412	1
4	Drink 1	Intake 1	19	45052	1337646996	/users/cn/jespinosa/phecomp/data/CRG/20120502_FDF_CRG/20120502_FDF_CRG/20120521_FDF_CRG_c12.mtb	2333	NA	WWFF	water	1	45033	1337646977	1	0.04	0.00210526315789474	11413	1
4	Food 1	Intake 3	27	45254	1337647198	/users/cn/jespinosa/phecomp/data/CRG/20120502_FDF_CRG/20120502_FDF_CRG/20120521_FDF_CRG_c12.mtb	7096	568	WWFF	food_fat	3	45227	1337647171	1	0.0400000000000009	0.00148148148148152	11414	1
4	Food 1	Intake 3	83	45905	1337647849	/users/cn/jespinosa/phecomp/data/CRG/20120502_FDF_CRG/20120502_FDF_CRG/20120521_FDF_CRG_c12.mtb	7099	413	WWFF	food_fat	3	45822	1337647766	1	0.199999999999999	0.00240963855421686	11415	1
4	Food 1	Intake 3	13	46331	1337648275	/users/cn/jespinosa/phecomp/data/CRG/20120502_FDF_CRG/20120502_FDF_CRG/20120521_FDF_CRG_c12.mtb	7102	442	WWFF	food_fat	3	46318	1337648262	1	0.0600000000000005	0.00461538461538465	11416	1
4	Food 1	Intake 3	681	47454	1337649398	/users/cn/jespinosa/phecomp/data/CRG/20120502_FDF_CRG/20120502_FDF_CRG/20120521_FDF_CRG_c12.mtb	7105	COLL	WWFF	food_fat	3	46773	1337648717	1	0.0800000000000001	0.000117474302496329	11417	1
4	Food 2	Intake 4	16	47028	1337648972	/users/cn/jespinosa/phecomp/data/CRG/20120502_FDF_CRG/20120502_FDF_CRG/20120521_FDF_CRG_c12.mtb	9064	54	WWFF	food_fat	4	47012	1337648956	1	0.0599999999999987	0.00374999999999992	11418	1
4	Food 2	Intake 4	42	47124	1337649068	/users/cn/jespinosa/phecomp/data/CRG/20120502_FDF_CRG/20120502_FDF_CRG/20120521_FDF_CRG_c12.mtb	9066	479	WWFF	food_fat	4	47082	1337649026	1	0.0800000000000001	0.00190476190476191	11419	1
4	Drink 1	Intake 1	26	47144	1337649088	/users/cn/jespinosa/phecomp/data/CRG/20120502_FDF_CRG/20120502_FDF_CRG/20120521_FDF_CRG_c12.mtb	2334	NA	WWFF	water	1	47118	1337649062	1	0.0600000000000001	0.00230769230769231	11420	1
4	Drink 1	Intake 1	17	47432	1337649376	/users/cn/jespinosa/phecomp/data/CRG/20120502_FDF_CRG/20120502_FDF_CRG/20120521_FDF_CRG_c12.mtb	2335	NA	WWFF	water	1	47415	1337649359	1	0.0599999999999999	0.00352941176470588	11421	1
4	Food 1	Intake 3	16	47619	1337649563	/users/cn/jespinosa/phecomp/data/CRG/20120502_FDF_CRG/20120502_FDF_CRG/20120521_FDF_CRG_c12.mtb	7107	304	WWFF	food_fat	3	47603	1337649547	1	0.0200000000000014	0.00125000000000009	11422	1
4	Food 1	Intake 3	21	47944	1337649888	/users/cn/jespinosa/phecomp/data/CRG/20120502_FDF_CRG/20120502_FDF_CRG/20120521_FDF_CRG_c12.mtb	7110	173	WWFF	food_fat	3	47923	1337649867	1	0.0599999999999987	0.0028571428571428	11423	1
4	Food 1	Intake 3	44	48161	1337650105	/users/cn/jespinosa/phecomp/data/CRG/20120502_FDF_CRG/20120502_FDF_CRG/20120521_FDF_CRG_c12.mtb	7112	96	WWFF	food_fat	3	48117	1337650061	1	0.0599999999999987	0.00136363636363633	11424	1
4	Food 1	Intake 3	14	48271	1337650215	/users/cn/jespinosa/phecomp/data/CRG/20120502_FDF_CRG/20120502_FDF_CRG/20120521_FDF_CRG_c12.mtb	7113	401	WWFF	food_fat	3	48257	1337650201	1	0.0400000000000009	0.00285714285714292	11425	1
4	Food 1	Intake 3	17	48689	1337650633	/users/cn/jespinosa/phecomp/data/CRG/20120502_FDF_CRG/20120502_FDF_CRG/20120521_FDF_CRG_c12.mtb	7118	790	WWFF	food_fat	3	48672	1337650616	1	0.100000000000001	0.00588235294117653	11426	1
4	Drink 1	Intake 1	20	48762	1337650706	/users/cn/jespinosa/phecomp/data/CRG/20120502_FDF_CRG/20120502_FDF_CRG/20120521_FDF_CRG_c12.mtb	2336	NA	WWFF	water	1	48742	1337650686	1	0.08	0.004	11427	1
4	Food 1	Intake 3	49	49528	1337651472	/users/cn/jespinosa/phecomp/data/CRG/20120502_FDF_CRG/20120502_FDF_CRG/20120521_FDF_CRG_c12.mtb	7124	257	WWFF	food_fat	3	49479	1337651423	1	0.0999999999999996	0.0020408163265306	11428	1
4	Food 1	Intake 3	21	49806	1337651750	/users/cn/jespinosa/phecomp/data/CRG/20120502_FDF_CRG/20120502_FDF_CRG/20120521_FDF_CRG_c12.mtb	7128	161	WWFF	food_fat	3	49785	1337651729	1	0.0399999999999991	0.00190476190476186	11429	1
4	Food 2	Intake 4	20	49987	1337651931	/users/cn/jespinosa/phecomp/data/CRG/20120502_FDF_CRG/20120502_FDF_CRG/20120521_FDF_CRG_c12.mtb	9074	160	WWFF	food_fat	4	49967	1337651911	1	0.100000000000001	0.00500000000000005	11430	1
4	Food 1	Intake 3	13	50160	1337652104	/users/cn/jespinosa/phecomp/data/CRG/20120502_FDF_CRG/20120502_FDF_CRG/20120521_FDF_CRG_c12.mtb	7134	152	WWFF	food_fat	3	50147	1337652091	1	0.0599999999999987	0.00461538461538452	11431	1
4	Food 1	Intake 3	15	50327	1337652271	/users/cn/jespinosa/phecomp/data/CRG/20120502_FDF_CRG/20120502_FDF_CRG/20120521_FDF_CRG_c12.mtb	7136	252	WWFF	food_fat	3	50312	1337652256	1	0.0399999999999991	0.00266666666666661	11432	1
4	Drink 1	Intake 1	22	50390	1337652334	/users/cn/jespinosa/phecomp/data/CRG/20120502_FDF_CRG/20120502_FDF_CRG/20120521_FDF_CRG_c12.mtb	2337	NA	WWFF	water	1	50368	1337652312	1	0.04	0.00181818181818182	11433	1
4	Food 1	Intake 3	22	50601	1337652545	/users/cn/jespinosa/phecomp/data/CRG/20120502_FDF_CRG/20120502_FDF_CRG/20120521_FDF_CRG_c12.mtb	7141	92	WWFF	food_fat	3	50579	1337652523	1	0.0200000000000014	0.000909090909090973	11434	1
4	Food 1	Intake 3	14	50707	1337652651	/users/cn/jespinosa/phecomp/data/CRG/20120502_FDF_CRG/20120502_FDF_CRG/20120521_FDF_CRG_c12.mtb	7144	67	WWFF	food_fat	3	50693	1337652637	1	0.140000000000001	0.0100000000000001	11435	1
4	Food 1	Intake 3	24	50798	1337652742	/users/cn/jespinosa/phecomp/data/CRG/20120502_FDF_CRG/20120502_FDF_CRG/20120521_FDF_CRG_c12.mtb	7147	69	WWFF	food_fat	3	50774	1337652718	1	0.120000000000001	0.00500000000000004	11436	1
4	Food 1	Intake 3	39	50906	1337652850	/users/cn/jespinosa/phecomp/data/CRG/20120502_FDF_CRG/20120502_FDF_CRG/20120521_FDF_CRG_c12.mtb	7148	56	WWFF	food_fat	3	50867	1337652811	1	0.0399999999999991	0.001025641025641	11437	1
4	Food 1	Intake 3	21	50983	1337652927	/users/cn/jespinosa/phecomp/data/CRG/20120502_FDF_CRG/20120502_FDF_CRG/20120521_FDF_CRG_c12.mtb	7149	119	WWFF	food_fat	3	50962	1337652906	1	0.0600000000000005	0.00285714285714288	11438	1
4	Food 1	Intake 3	15	51117	1337653061	/users/cn/jespinosa/phecomp/data/CRG/20120502_FDF_CRG/20120502_FDF_CRG/20120521_FDF_CRG_c12.mtb	7150	305	WWFF	food_fat	3	51102	1337653046	1	0.0999999999999996	0.00666666666666664	11439	1
4	Food 1	Intake 3	232	51654	1337653598	/users/cn/jespinosa/phecomp/data/CRG/20120502_FDF_CRG/20120502_FDF_CRG/20120521_FDF_CRG_c12.mtb	7152	17	WWFF	food_fat	3	51422	1337653366	1	0.220000000000001	0.00094827586206897	11440	1
4	Food 1	Intake 3	467	52138	1337654082	/users/cn/jespinosa/phecomp/data/CRG/20120502_FDF_CRG/20120502_FDF_CRG/20120521_FDF_CRG_c12.mtb	7153	COLL	WWFF	food_fat	3	51671	1337653615	1	0.24	0.000513918629550321	11441	1
4	Food 2	Intake 4	34	51707	1337653651	/users/cn/jespinosa/phecomp/data/CRG/20120502_FDF_CRG/20120502_FDF_CRG/20120521_FDF_CRG_c12.mtb	9077	111	WWFF	food_fat	4	51673	1337653617	1	0.0999999999999996	0.00294117647058822	11442	1
4	Food 2	Intake 4	56	51874	1337653818	/users/cn/jespinosa/phecomp/data/CRG/20120502_FDF_CRG/20120502_FDF_CRG/20120521_FDF_CRG_c12.mtb	9079	61	WWFF	food_fat	4	51818	1337653762	1	0.0400000000000009	0.00071428571428573	11443	1
4	Drink 1	Intake 1	15	51878	1337653822	/users/cn/jespinosa/phecomp/data/CRG/20120502_FDF_CRG/20120502_FDF_CRG/20120521_FDF_CRG_c12.mtb	2338	NA	WWFF	water	1	51863	1337653807	1	0.0600000000000001	0.00400000000000001	11444	1
4	Food 2	Intake 4	41	51976	1337653920	/users/cn/jespinosa/phecomp/data/CRG/20120502_FDF_CRG/20120502_FDF_CRG/20120521_FDF_CRG_c12.mtb	9081	174	WWFF	food_fat	4	51935	1337653879	1	0.0200000000000014	0.000487804878048815	11445	1
4	Food 1	Intake 3	13	52163	1337654107	/users/cn/jespinosa/phecomp/data/CRG/20120502_FDF_CRG/20120502_FDF_CRG/20120521_FDF_CRG_c12.mtb	7154	417	WWFF	food_fat	3	52150	1337654094	1	0.0600000000000005	0.00461538461538465	11446	1
4	Food 2	Intake 4	39	52619	1337654563	/users/cn/jespinosa/phecomp/data/CRG/20120502_FDF_CRG/20120502_FDF_CRG/20120521_FDF_CRG_c12.mtb	9088	645	WWFF	food_fat	4	52580	1337654524	1	0.0399999999999991	0.001025641025641	11447	1
4	Drink 1	Intake 1	16	52754	1337654698	/users/cn/jespinosa/phecomp/data/CRG/20120502_FDF_CRG/20120502_FDF_CRG/20120521_FDF_CRG_c12.mtb	2339	NA	WWFF	water	1	52738	1337654682	1	0.0399999999999999	0.00249999999999999	11448	1
4	Drink 1	Intake 1	18	53203	1337655147	/users/cn/jespinosa/phecomp/data/CRG/20120502_FDF_CRG/20120502_FDF_CRG/20120521_FDF_CRG_c12.mtb	2340	NA	WWFF	water	1	53185	1337655129	1	0.0800000000000001	0.00444444444444445	11449	1
4	Food 1	Intake 3	17	53281	1337655225	/users/cn/jespinosa/phecomp/data/CRG/20120502_FDF_CRG/20120502_FDF_CRG/20120521_FDF_CRG_c12.mtb	7162	65	WWFF	food_fat	3	53264	1337655208	1	0.140000000000001	0.00823529411764712	11450	1
4	Food 1	Intake 3	19	53365	1337655309	/users/cn/jespinosa/phecomp/data/CRG/20120502_FDF_CRG/20120502_FDF_CRG/20120521_FDF_CRG_c12.mtb	7163	1039	WWFF	food_fat	3	53346	1337655290	1	0.0800000000000001	0.00421052631578948	11451	1
4	Drink 1	Intake 1	20	54105	1337656049	/users/cn/jespinosa/phecomp/data/CRG/20120502_FDF_CRG/20120502_FDF_CRG/20120521_FDF_CRG_c12.mtb	2341	NA	WWFF	water	1	54085	1337656029	1	0.0599999999999999	0.00299999999999999	11452	1
4	Food 1	Intake 3	19	54423	1337656367	/users/cn/jespinosa/phecomp/data/CRG/20120502_FDF_CRG/20120502_FDF_CRG/20120521_FDF_CRG_c12.mtb	7170	264	WWFF	food_fat	3	54404	1337656348	1	0.0399999999999991	0.00210526315789469	11453	1
4	Food 1	Intake 3	39	54726	1337656670	/users/cn/jespinosa/phecomp/data/CRG/20120502_FDF_CRG/20120502_FDF_CRG/20120521_FDF_CRG_c12.mtb	7171	220	WWFF	food_fat	3	54687	1337656631	1	0.0600000000000005	0.00153846153846155	11454	1
4	Food 1	Intake 3	54	55000	1337656944	/users/cn/jespinosa/phecomp/data/CRG/20120502_FDF_CRG/20120502_FDF_CRG/20120521_FDF_CRG_c12.mtb	7173	271	WWFF	food_fat	3	54946	1337656890	1	0.120000000000001	0.00222222222222224	11455	1
4	Food 1	Intake 3	13	55284	1337657228	/users/cn/jespinosa/phecomp/data/CRG/20120502_FDF_CRG/20120502_FDF_CRG/20120521_FDF_CRG_c12.mtb	7175	287	WWFF	food_fat	3	55271	1337657215	1	0.119999999999999	0.00923076923076915	11456	1
4	Food 1	Intake 3	19	55590	1337657534	/users/cn/jespinosa/phecomp/data/CRG/20120502_FDF_CRG/20120502_FDF_CRG/20120521_FDF_CRG_c12.mtb	7176	390	WWFF	food_fat	3	55571	1337657515	1	0.0600000000000005	0.00315789473684213	11457	1
4	Drink 1	Intake 1	18	55851	1337657795	/users/cn/jespinosa/phecomp/data/CRG/20120502_FDF_CRG/20120502_FDF_CRG/20120521_FDF_CRG_c12.mtb	2342	NA	WWFF	water	1	55833	1337657777	1	0.04	0.00222222222222222	11458	1
4	Food 1	Intake 3	13	55993	1337657937	/users/cn/jespinosa/phecomp/data/CRG/20120502_FDF_CRG/20120502_FDF_CRG/20120521_FDF_CRG_c12.mtb	7179	83	WWFF	food_fat	3	55980	1337657924	1	0.0400000000000009	0.00307692307692315	11459	1
4	Food 1	Intake 3	14	56090	1337658034	/users/cn/jespinosa/phecomp/data/CRG/20120502_FDF_CRG/20120502_FDF_CRG/20120521_FDF_CRG_c12.mtb	7180	433	WWFF	food_fat	3	56076	1337658020	1	0.0399999999999991	0.00285714285714279	11460	1
4	Food 1	Intake 3	19	56542	1337658486	/users/cn/jespinosa/phecomp/data/CRG/20120502_FDF_CRG/20120502_FDF_CRG/20120521_FDF_CRG_c12.mtb	7182	578	WWFF	food_fat	3	56523	1337658467	1	0.0600000000000005	0.00315789473684213	11461	1
4	Food 1	Intake 3	182	57302	1337659246	/users/cn/jespinosa/phecomp/data/CRG/20120502_FDF_CRG/20120502_FDF_CRG/20120521_FDF_CRG_c12.mtb	7187	419	WWFF	food_fat	3	57120	1337659064	1	0.0399999999999991	0.000219780219780215	11462	1
4	Food 1	Intake 3	212	57933	1337659877	/users/cn/jespinosa/phecomp/data/CRG/20120502_FDF_CRG/20120502_FDF_CRG/20120521_FDF_CRG_c12.mtb	7189	522	WWFF	food_fat	3	57721	1337659665	1	0.120000000000001	0.000566037735849061	11463	1
4	Food 1	Intake 3	76	58531	1337660475	/users/cn/jespinosa/phecomp/data/CRG/20120502_FDF_CRG/20120502_FDF_CRG/20120521_FDF_CRG_c12.mtb	7193	421	WWFF	food_fat	3	58455	1337660399	1	0.120000000000001	0.00157894736842107	11464	1
4	Drink 1	Intake 1	25	58488	1337660432	/users/cn/jespinosa/phecomp/data/CRG/20120502_FDF_CRG/20120502_FDF_CRG/20120521_FDF_CRG_c12.mtb	2343	NA	WWFF	water	1	58463	1337660407	1	0.04	0.0016	11465	1
4	Food 1	Intake 3	15	58967	1337660911	/users/cn/jespinosa/phecomp/data/CRG/20120502_FDF_CRG/20120502_FDF_CRG/20120521_FDF_CRG_c12.mtb	7195	128	WWFF	food_fat	3	58952	1337660896	1	0.0399999999999991	0.00266666666666661	11466	1
4	Food 1	Intake 3	12	59107	1337661051	/users/cn/jespinosa/phecomp/data/CRG/20120502_FDF_CRG/20120502_FDF_CRG/20120521_FDF_CRG_c12.mtb	7196	255	WWFF	food_fat	3	59095	1337661039	1	0.0400000000000009	0.00333333333333341	11467	1
4	Food 1	Intake 3	18	59380	1337661324	/users/cn/jespinosa/phecomp/data/CRG/20120502_FDF_CRG/20120502_FDF_CRG/20120521_FDF_CRG_c12.mtb	7198	90	WWFF	food_fat	3	59362	1337661306	1	0.0600000000000005	0.00333333333333336	11468	1
4	Drink 1	Intake 1	15	59431	1337661375	/users/cn/jespinosa/phecomp/data/CRG/20120502_FDF_CRG/20120502_FDF_CRG/20120521_FDF_CRG_c12.mtb	2344	NA	WWFF	water	1	59416	1337661360	1	0.04	0.00266666666666667	11469	1
4	Food 1	Intake 3	251	59721	1337661665	/users/cn/jespinosa/phecomp/data/CRG/20120502_FDF_CRG/20120502_FDF_CRG/20120521_FDF_CRG_c12.mtb	7200	360	WWFF	food_fat	3	59470	1337661414	1	0.180000000000001	0.00071713147410359	11470	1
4	Food 1	Intake 3	118	60199	1337662143	/users/cn/jespinosa/phecomp/data/CRG/20120502_FDF_CRG/20120502_FDF_CRG/20120521_FDF_CRG_c12.mtb	7203	COLL	WWFF	food_fat	3	60081	1337662025	1	0.16	0.00135593220338983	11471	1
4	Food 2	Intake 4	11	60094	1337662038	/users/cn/jespinosa/phecomp/data/CRG/20120502_FDF_CRG/20120502_FDF_CRG/20120521_FDF_CRG_c12.mtb	9106	295	WWFF	food_fat	4	60083	1337662027	1	0.0200000000000014	0.00181818181818195	11472	1
4	Food 1	Intake 3	15	60404	1337662348	/users/cn/jespinosa/phecomp/data/CRG/20120502_FDF_CRG/20120502_FDF_CRG/20120521_FDF_CRG_c12.mtb	7204	331	WWFF	food_fat	3	60389	1337662333	1	0.0600000000000005	0.00400000000000003	11473	1
4	Food 2	Intake 4	99	60834	1337662778	/users/cn/jespinosa/phecomp/data/CRG/20120502_FDF_CRG/20120502_FDF_CRG/20120521_FDF_CRG_c12.mtb	9109	71	WWFF	food_fat	4	60735	1337662679	1	0.0399999999999991	0.000404040404040395	11474	1
4	Food 1	Intake 3	715	61620	1337663564	/users/cn/jespinosa/phecomp/data/CRG/20120502_FDF_CRG/20120502_FDF_CRG/20120521_FDF_CRG_c12.mtb	7206	COLL	WWFF	food_fat	3	60905	1337662849	1	0.74	0.00103496503496503	11475	1
4	Food 2	Intake 4	304	61226	1337663170	/users/cn/jespinosa/phecomp/data/CRG/20120502_FDF_CRG/20120502_FDF_CRG/20120521_FDF_CRG_c12.mtb	9111	21	WWFF	food_fat	4	60922	1337662866	1	0.18	0.000592105263157895	11476	1
4	Drink 2	Intake 2	55	61243	1337663187	/users/cn/jespinosa/phecomp/data/CRG/20120502_FDF_CRG/20120502_FDF_CRG/20120521_FDF_CRG_c12.mtb	2111	NA	WWFF	water	2	61188	1337663132	1	0.02	0.000363636363636364	11477	1
4	Food 2	Intake 4	243	61490	1337663434	/users/cn/jespinosa/phecomp/data/CRG/20120502_FDF_CRG/20120502_FDF_CRG/20120521_FDF_CRG_c12.mtb	9112	43	WWFF	food_fat	4	61247	1337663191	1	0.139999999999999	0.000576131687242794	11478	1
4	Food 2	Intake 4	59	61592	1337663536	/users/cn/jespinosa/phecomp/data/CRG/20120502_FDF_CRG/20120502_FDF_CRG/20120521_FDF_CRG_c12.mtb	9113	420	WWFF	food_fat	4	61533	1337663477	1	0.0200000000000031	0.00033898305084751	11479	1
4	Food 1	Intake 3	105	62117	1337664061	/users/cn/jespinosa/phecomp/data/CRG/20120502_FDF_CRG/20120502_FDF_CRG/20120521_FDF_CRG_c12.mtb	7209	COLL	WWFF	food_fat	3	62012	1337663956	1	0.140000000000001	0.00133333333333334	11480	1
4	Food 2	Intake 4	12	62116	1337664060	/users/cn/jespinosa/phecomp/data/CRG/20120502_FDF_CRG/20120502_FDF_CRG/20120521_FDF_CRG_c12.mtb	9121	305	WWFF	food_fat	4	62104	1337664048	1	0.0399999999999991	0.00333333333333326	11481	1
4	Drink 2	Intake 2	30	62138	1337664082	/users/cn/jespinosa/phecomp/data/CRG/20120502_FDF_CRG/20120502_FDF_CRG/20120521_FDF_CRG_c12.mtb	2114	NA	WWFF	water	2	62108	1337664052	1	0.1	0.00333333333333333	11482	1
4	Food 2	Intake 4	14	62435	1337664379	/users/cn/jespinosa/phecomp/data/CRG/20120502_FDF_CRG/20120502_FDF_CRG/20120521_FDF_CRG_c12.mtb	9127	91	WWFF	food_fat	4	62421	1337664365	1	0.0400000000000009	0.00285714285714292	11483	1
4	Food 2	Intake 4	21	62547	1337664491	/users/cn/jespinosa/phecomp/data/CRG/20120502_FDF_CRG/20120502_FDF_CRG/20120521_FDF_CRG_c12.mtb	9129	164	WWFF	food_fat	4	62526	1337664470	1	0.0399999999999991	0.00190476190476186	11484	1
4	Food 2	Intake 4	15	62726	1337664670	/users/cn/jespinosa/phecomp/data/CRG/20120502_FDF_CRG/20120502_FDF_CRG/20120521_FDF_CRG_c12.mtb	9132	730	WWFF	food_fat	4	62711	1337664655	1	0.0399999999999991	0.00266666666666661	11485	1
4	Food 2	Intake 4	194	63650	1337665594	/users/cn/jespinosa/phecomp/data/CRG/20120502_FDF_CRG/20120502_FDF_CRG/20120521_FDF_CRG_c12.mtb	9140	253	WWFF	food_fat	4	63456	1337665400	1	0.0399999999999991	0.000206185567010305	11486	1
4	Food 2	Intake 4	28	63931	1337665875	/users/cn/jespinosa/phecomp/data/CRG/20120502_FDF_CRG/20120502_FDF_CRG/20120521_FDF_CRG_c12.mtb	9143	9	WWFF	food_fat	4	63903	1337665847	1	0.0400000000000009	0.00142857142857146	11487	1
4	Food 2	Intake 4	22	63962	1337665906	/users/cn/jespinosa/phecomp/data/CRG/20120502_FDF_CRG/20120502_FDF_CRG/20120521_FDF_CRG_c12.mtb	9144	91	WWFF	food_fat	4	63940	1337665884	1	0.0999999999999996	0.00454545454545453	11488	1
4	Food 2	Intake 4	20	64073	1337666017	/users/cn/jespinosa/phecomp/data/CRG/20120502_FDF_CRG/20120502_FDF_CRG/20120521_FDF_CRG_c12.mtb	9146	1555	WWFF	food_fat	4	64053	1337665997	1	0.0799999999999983	0.00399999999999992	11489	1
4	Food 1	Intake 3	39	65667	1337667611	/users/cn/jespinosa/phecomp/data/CRG/20120502_FDF_CRG/20120502_FDF_CRG/20120521_FDF_CRG_c12.mtb	7221	99	WWFF	food_fat	3	65628	1337667572	1	0.0399999999999991	0.001025641025641	11490	1
4	Food 1	Intake 3	29	65795	1337667739	/users/cn/jespinosa/phecomp/data/CRG/20120502_FDF_CRG/20120502_FDF_CRG/20120521_FDF_CRG_c12.mtb	7222	241	WWFF	food_fat	3	65766	1337667710	1	0.0400000000000009	0.00137931034482762	11491	1
4	Food 1	Intake 3	18	66054	1337667998	/users/cn/jespinosa/phecomp/data/CRG/20120502_FDF_CRG/20120502_FDF_CRG/20120521_FDF_CRG_c12.mtb	7224	135	WWFF	food_fat	3	66036	1337667980	1	0.0200000000000014	0.00111111111111119	11492	1
4	Food 1	Intake 3	13	66202	1337668146	/users/cn/jespinosa/phecomp/data/CRG/20120502_FDF_CRG/20120502_FDF_CRG/20120521_FDF_CRG_c12.mtb	7226	117	WWFF	food_fat	3	66189	1337668133	1	0.0600000000000005	0.00461538461538465	11493	1
4	Food 1	Intake 3	15	66334	1337668278	/users/cn/jespinosa/phecomp/data/CRG/20120502_FDF_CRG/20120502_FDF_CRG/20120521_FDF_CRG_c12.mtb	7227	164	WWFF	food_fat	3	66319	1337668263	1	0.0800000000000001	0.00533333333333334	11494	1
4	Food 1	Intake 3	18	66516	1337668460	/users/cn/jespinosa/phecomp/data/CRG/20120502_FDF_CRG/20120502_FDF_CRG/20120521_FDF_CRG_c12.mtb	7230	425	WWFF	food_fat	3	66498	1337668442	1	0.0800000000000001	0.00444444444444445	11495	1
4	Food 1	Intake 3	19	66960	1337668904	/users/cn/jespinosa/phecomp/data/CRG/20120502_FDF_CRG/20120502_FDF_CRG/20120521_FDF_CRG_c12.mtb	7232	245	WWFF	food_fat	3	66941	1337668885	1	0.0999999999999996	0.00526315789473682	11496	1
4	Drink 1	Intake 1	24	67212	1337669156	/users/cn/jespinosa/phecomp/data/CRG/20120502_FDF_CRG/20120502_FDF_CRG/20120521_FDF_CRG_c12.mtb	2346	NA	WWFF	water	1	67188	1337669132	1	0.14	0.00583333333333333	11497	1
4	Food 1	Intake 3	215	67420	1337669364	/users/cn/jespinosa/phecomp/data/CRG/20120502_FDF_CRG/20120502_FDF_CRG/20120521_FDF_CRG_c12.mtb	7236	1107	WWFF	food_fat	3	67205	1337669149	1	0.140000000000001	0.000651162790697679	11498	1
4	Food 1	Intake 3	21	68548	1337670492	/users/cn/jespinosa/phecomp/data/CRG/20120502_FDF_CRG/20120502_FDF_CRG/20120521_FDF_CRG_c12.mtb	7244	151	WWFF	food_fat	3	68527	1337670471	1	0.120000000000001	0.00571428571428576	11499	1
4	Food 1	Intake 3	14	68713	1337670657	/users/cn/jespinosa/phecomp/data/CRG/20120502_FDF_CRG/20120502_FDF_CRG/20120521_FDF_CRG_c12.mtb	7247	422	WWFF	food_fat	3	68699	1337670643	1	0.0399999999999991	0.00285714285714279	11500	1
4	Food 1	Intake 3	28	69163	1337671107	/users/cn/jespinosa/phecomp/data/CRG/20120502_FDF_CRG/20120502_FDF_CRG/20120521_FDF_CRG_c12.mtb	7249	COLL	WWFF	food_fat	3	69135	1337671079	1	0.0200000000000014	0.000714285714285764	11501	1
4	Food 2	Intake 4	15	69160	1337671104	/users/cn/jespinosa/phecomp/data/CRG/20120502_FDF_CRG/20120502_FDF_CRG/20120521_FDF_CRG_c12.mtb	9155	864	WWFF	food_fat	4	69145	1337671089	1	0.0200000000000031	0.00133333333333354	11502	1
4	Food 1	Intake 3	62	70086	1337672030	/users/cn/jespinosa/phecomp/data/CRG/20120502_FDF_CRG/20120502_FDF_CRG/20120521_FDF_CRG_c12.mtb	7254	390	WWFF	food_fat	3	70024	1337671968	1	0.0200000000000014	0.000322580645161313	11503	1
4	Food 1	Intake 3	13	70489	1337672433	/users/cn/jespinosa/phecomp/data/CRG/20120502_FDF_CRG/20120502_FDF_CRG/20120521_FDF_CRG_c12.mtb	7258	368	WWFF	food_fat	3	70476	1337672420	1	0.0600000000000005	0.00461538461538465	11504	1
4	Food 1	Intake 3	18	70875	1337672819	/users/cn/jespinosa/phecomp/data/CRG/20120502_FDF_CRG/20120502_FDF_CRG/20120521_FDF_CRG_c12.mtb	7262	193	WWFF	food_fat	3	70857	1337672801	1	0.0399999999999991	0.00222222222222217	11505	1
4	Food 1	Intake 3	18	71086	1337673030	/users/cn/jespinosa/phecomp/data/CRG/20120502_FDF_CRG/20120502_FDF_CRG/20120521_FDF_CRG_c12.mtb	7263	162	WWFF	food_fat	3	71068	1337673012	1	0.0400000000000009	0.00222222222222227	11506	1
4	Food 1	Intake 3	13	71261	1337673205	/users/cn/jespinosa/phecomp/data/CRG/20120502_FDF_CRG/20120502_FDF_CRG/20120521_FDF_CRG_c12.mtb	7266	281	WWFF	food_fat	3	71248	1337673192	1	0.0400000000000009	0.00307692307692315	11507	1
4	Food 1	Intake 3	15	71557	1337673501	/users/cn/jespinosa/phecomp/data/CRG/20120502_FDF_CRG/20120502_FDF_CRG/20120521_FDF_CRG_c12.mtb	7268	101	WWFF	food_fat	3	71542	1337673486	1	0.0399999999999991	0.00266666666666661	11508	1
4	Food 1	Intake 3	14	71672	1337673616	/users/cn/jespinosa/phecomp/data/CRG/20120502_FDF_CRG/20120502_FDF_CRG/20120521_FDF_CRG_c12.mtb	7269	108	WWFF	food_fat	3	71658	1337673602	1	0.0600000000000005	0.00428571428571432	11509	1
4	Food 1	Intake 3	616	72396	1337674340	/users/cn/jespinosa/phecomp/data/CRG/20120502_FDF_CRG/20120502_FDF_CRG/20120521_FDF_CRG_c12.mtb	7271	COLL	WWFF	food_fat	3	71780	1337673724	1	0.699999999999999	0.00113636363636363	11510	1
4	Food 2	Intake 4	17	71802	1337673746	/users/cn/jespinosa/phecomp/data/CRG/20120502_FDF_CRG/20120502_FDF_CRG/20120521_FDF_CRG_c12.mtb	9157	608	WWFF	food_fat	4	71785	1337673729	1	0.239999999999998	0.0141176470588234	11511	1
4	Drink 1	Intake 1	30	72108	1337674052	/users/cn/jespinosa/phecomp/data/CRG/20120502_FDF_CRG/20120502_FDF_CRG/20120521_FDF_CRG_c12.mtb	2347	NA	WWFF	water	1	72078	1337674022	1	0.1	0.00333333333333333	11512	1
4	Food 1	Intake 3	480	72890	1337674834	/users/cn/jespinosa/phecomp/data/CRG/20120502_FDF_CRG/20120502_FDF_CRG/20120521_FDF_CRG_c12.mtb	7272	COLL	WWFF	food_fat	3	72410	1337674354	1	0.220000000000001	0.000458333333333335	11513	1
4	Food 2	Intake 4	52	72710	1337674654	/users/cn/jespinosa/phecomp/data/CRG/20120502_FDF_CRG/20120502_FDF_CRG/20120521_FDF_CRG_c12.mtb	9161	193	WWFF	food_fat	4	72658	1337674602	1	0.0200000000000031	0.000384615384615444	11514	1
4	Food 2	Intake 4	79	72982	1337674926	/users/cn/jespinosa/phecomp/data/CRG/20120502_FDF_CRG/20120502_FDF_CRG/20120521_FDF_CRG_c12.mtb	9163	880	WWFF	food_fat	4	72903	1337674847	1	0.100000000000001	0.00126582278481014	11515	1
4	Drink 1	Intake 1	16	73186	1337675130	/users/cn/jespinosa/phecomp/data/CRG/20120502_FDF_CRG/20120502_FDF_CRG/20120521_FDF_CRG_c12.mtb	2348	NA	WWFF	water	1	73170	1337675114	1	0.0399999999999998	0.00249999999999999	11516	1
4	Food 1	Intake 3	341	74203	1337676147	/users/cn/jespinosa/phecomp/data/CRG/20120502_FDF_CRG/20120502_FDF_CRG/20120521_FDF_CRG_c12.mtb	7275	COLL	WWFF	food_fat	3	73862	1337675806	1	0.44	0.00129032258064516	11517	1
4	Food 2	Intake 4	244	74107	1337676051	/users/cn/jespinosa/phecomp/data/CRG/20120502_FDF_CRG/20120502_FDF_CRG/20120521_FDF_CRG_c12.mtb	9171	110	WWFF	food_fat	4	73863	1337675807	1	0.16	0.000655737704918033	11518	1
4	Food 1	Intake 3	33	74250	1337676194	/users/cn/jespinosa/phecomp/data/CRG/20120502_FDF_CRG/20120502_FDF_CRG/20120521_FDF_CRG_c12.mtb	7276	633	WWFF	food_fat	3	74217	1337676161	1	0.0400000000000009	0.00121212121212124	11519	1
4	Food 1	Intake 3	13	74896	1337676840	/users/cn/jespinosa/phecomp/data/CRG/20120502_FDF_CRG/20120502_FDF_CRG/20120521_FDF_CRG_c12.mtb	7278	446	WWFF	food_fat	3	74883	1337676827	1	0.0400000000000009	0.00307692307692315	11520	1
4	Food 1	Intake 3	34	75376	1337677320	/users/cn/jespinosa/phecomp/data/CRG/20120502_FDF_CRG/20120502_FDF_CRG/20120521_FDF_CRG_c12.mtb	7281	303	WWFF	food_fat	3	75342	1337677286	1	0.0600000000000005	0.00176470588235296	11521	1
4	Food 1	Intake 3	13	75692	1337677636	/users/cn/jespinosa/phecomp/data/CRG/20120502_FDF_CRG/20120502_FDF_CRG/20120521_FDF_CRG_c12.mtb	7285	510	WWFF	food_fat	3	75679	1337677623	1	0.0800000000000001	0.00615384615384616	11522	1
4	Food 1	Intake 3	13	76215	1337678159	/users/cn/jespinosa/phecomp/data/CRG/20120502_FDF_CRG/20120502_FDF_CRG/20120521_FDF_CRG_c12.mtb	7291	144	WWFF	food_fat	3	76202	1337678146	1	0.0399999999999991	0.00307692307692301	11523	1
4	Food 1	Intake 3	28	76387	1337678331	/users/cn/jespinosa/phecomp/data/CRG/20120502_FDF_CRG/20120502_FDF_CRG/20120521_FDF_CRG_c12.mtb	7292	229	WWFF	food_fat	3	76359	1337678303	1	0.0800000000000001	0.00285714285714286	11524	1
4	Food 1	Intake 3	12	76628	1337678572	/users/cn/jespinosa/phecomp/data/CRG/20120502_FDF_CRG/20120502_FDF_CRG/20120521_FDF_CRG_c12.mtb	7295	259	WWFF	food_fat	3	76616	1337678560	1	0.0399999999999991	0.00333333333333326	11525	1
4	Food 1	Intake 3	20	76907	1337678851	/users/cn/jespinosa/phecomp/data/CRG/20120502_FDF_CRG/20120502_FDF_CRG/20120521_FDF_CRG_c12.mtb	7297	306	WWFF	food_fat	3	76887	1337678831	1	0.0600000000000005	0.00300000000000002	11526	1
4	Food 1	Intake 3	12	77225	1337679169	/users/cn/jespinosa/phecomp/data/CRG/20120502_FDF_CRG/20120502_FDF_CRG/20120521_FDF_CRG_c12.mtb	7298	102	WWFF	food_fat	3	77213	1337679157	1	0.0399999999999991	0.00333333333333326	11527	1
4	Food 1	Intake 3	10	77337	1337679281	/users/cn/jespinosa/phecomp/data/CRG/20120502_FDF_CRG/20120502_FDF_CRG/20120521_FDF_CRG_c12.mtb	7300	56	WWFF	food_fat	3	77327	1337679271	1	0.0200000000000014	0.00200000000000014	11528	1
4	Food 1	Intake 3	12	77405	1337679349	/users/cn/jespinosa/phecomp/data/CRG/20120502_FDF_CRG/20120502_FDF_CRG/20120521_FDF_CRG_c12.mtb	7301	1328	WWFF	food_fat	3	77393	1337679337	1	0.0599999999999987	0.00499999999999989	11529	1
4	Drink 1	Intake 1	20	78707	1337680651	/users/cn/jespinosa/phecomp/data/CRG/20120502_FDF_CRG/20120502_FDF_CRG/20120521_FDF_CRG_c12.mtb	2349	NA	WWFF	water	1	78687	1337680631	1	0.0800000000000001	0.00400000000000001	11530	1
4	Food 2	Intake 4	28	78761	1337680705	/users/cn/jespinosa/phecomp/data/CRG/20120502_FDF_CRG/20120502_FDF_CRG/20120521_FDF_CRG_c12.mtb	9178	459	WWFF	food_fat	4	78733	1337680677	1	0.220000000000001	0.00785714285714289	11531	1
4	Food 1	Intake 3	37	79257	1337681201	/users/cn/jespinosa/phecomp/data/CRG/20120502_FDF_CRG/20120502_FDF_CRG/20120521_FDF_CRG_c12.mtb	7309	1123	WWFF	food_fat	3	79220	1337681164	1	0.0400000000000009	0.00108108108108111	11532	1
4	Food 1	Intake 3	64	80444	1337682388	/users/cn/jespinosa/phecomp/data/CRG/20120502_FDF_CRG/20120502_FDF_CRG/20120521_FDF_CRG_c12.mtb	7318	350	WWFF	food_fat	3	80380	1337682324	1	0.0400000000000009	0.000625000000000014	11533	1
4	Drink 1	Intake 1	14	80410	1337682354	/users/cn/jespinosa/phecomp/data/CRG/20120502_FDF_CRG/20120502_FDF_CRG/20120521_FDF_CRG_c12.mtb	2350	NA	WWFF	water	1	80396	1337682340	1	0.0800000000000001	0.00571428571428572	11534	1
4	Food 1	Intake 3	14	80808	1337682752	/users/cn/jespinosa/phecomp/data/CRG/20120502_FDF_CRG/20120502_FDF_CRG/20120521_FDF_CRG_c12.mtb	7320	99	WWFF	food_fat	3	80794	1337682738	1	0.0999999999999996	0.00714285714285711	11535	1
4	Food 1	Intake 3	26	80933	1337682877	/users/cn/jespinosa/phecomp/data/CRG/20120502_FDF_CRG/20120502_FDF_CRG/20120521_FDF_CRG_c12.mtb	7321	498	WWFF	food_fat	3	80907	1337682851	1	0.18	0.00692307692307692	11536	1
4	Food 1	Intake 3	34	81465	1337683409	/users/cn/jespinosa/phecomp/data/CRG/20120502_FDF_CRG/20120502_FDF_CRG/20120521_FDF_CRG_c12.mtb	7323	1069	WWFF	food_fat	3	81431	1337683375	1	0.0400000000000009	0.00117647058823532	11537	1
4	Drink 1	Intake 1	16	82250	1337684194	/users/cn/jespinosa/phecomp/data/CRG/20120502_FDF_CRG/20120502_FDF_CRG/20120521_FDF_CRG_c12.mtb	2351	NA	WWFF	water	1	82234	1337684178	1	0.0800000000000001	0.00500000000000001	11538	1
4	Food 1	Intake 3	71	82605	1337684549	/users/cn/jespinosa/phecomp/data/CRG/20120502_FDF_CRG/20120502_FDF_CRG/20120521_FDF_CRG_c12.mtb	7327	562	WWFF	food_fat	3	82534	1337684478	1	0.0200000000000014	0.00028169014084509	11539	1
4	Food 1	Intake 3	89	83256	1337685200	/users/cn/jespinosa/phecomp/data/CRG/20120502_FDF_CRG/20120502_FDF_CRG/20120521_FDF_CRG_c12.mtb	7331	373	WWFF	food_fat	3	83167	1337685111	1	0.0399999999999991	0.000449438202247181	11540	1
4	Food 1	Intake 3	56	83685	1337685629	/users/cn/jespinosa/phecomp/data/CRG/20120502_FDF_CRG/20120502_FDF_CRG/20120521_FDF_CRG_c12.mtb	7336	358	WWFF	food_fat	3	83629	1337685573	1	0.0600000000000005	0.00107142857142858	11541	1
4	Drink 1	Intake 1	25	83664	1337685608	/users/cn/jespinosa/phecomp/data/CRG/20120502_FDF_CRG/20120502_FDF_CRG/20120521_FDF_CRG_c12.mtb	2352	NA	WWFF	water	1	83639	1337685583	1	0.0999999999999999	0.004	11542	1
4	Food 1	Intake 3	25	84068	1337686012	/users/cn/jespinosa/phecomp/data/CRG/20120502_FDF_CRG/20120502_FDF_CRG/20120521_FDF_CRG_c12.mtb	7341	181	WWFF	food_fat	3	84043	1337685987	1	0.0399999999999991	0.00159999999999996	11543	1
4	Food 1	Intake 3	17	84266	1337686210	/users/cn/jespinosa/phecomp/data/CRG/20120502_FDF_CRG/20120502_FDF_CRG/20120521_FDF_CRG_c12.mtb	7342	99	WWFF	food_fat	3	84249	1337686193	1	0.0200000000000014	0.00117647058823538	11544	1
4	Food 1	Intake 3	16	84381	1337686325	/users/cn/jespinosa/phecomp/data/CRG/20120502_FDF_CRG/20120502_FDF_CRG/20120521_FDF_CRG_c12.mtb	7343	606	WWFF	food_fat	3	84365	1337686309	1	0.0399999999999991	0.00249999999999994	11545	1
4	Food 1	Intake 3	20	85007	1337686951	/users/cn/jespinosa/phecomp/data/CRG/20120502_FDF_CRG/20120502_FDF_CRG/20120521_FDF_CRG_c12.mtb	7348	57	WWFF	food_fat	3	84987	1337686931	1	0.0400000000000009	0.00200000000000005	11546	1
4	Food 1	Intake 3	13	85077	1337687021	/users/cn/jespinosa/phecomp/data/CRG/20120502_FDF_CRG/20120502_FDF_CRG/20120521_FDF_CRG_c12.mtb	7349	762	WWFF	food_fat	3	85064	1337687008	1	0.0599999999999987	0.00461538461538452	11547	1
4	Food 1	Intake 3	15	85854	1337687798	/users/cn/jespinosa/phecomp/data/CRG/20120502_FDF_CRG/20120502_FDF_CRG/20120521_FDF_CRG_c12.mtb	7355	292	WWFF	food_fat	3	85839	1337687783	1	0.0399999999999991	0.00266666666666661	11548	1
4	Food 1	Intake 3	13	86159	1337688103	/users/cn/jespinosa/phecomp/data/CRG/20120502_FDF_CRG/20120502_FDF_CRG/20120521_FDF_CRG_c12.mtb	7357	702	WWFF	food_fat	3	86146	1337688090	1	0.0399999999999991	0.00307692307692301	11549	1
4	Food 1	Intake 3	14	86875	1337688819	/users/cn/jespinosa/phecomp/data/CRG/20120502_FDF_CRG/20120502_FDF_CRG/20120521_FDF_CRG_c12.mtb	7361	1279	WWFF	food_fat	3	86861	1337688805	1	0.0399999999999991	0.00285714285714279	11550	1
4	Drink 1	Intake 1	20	87043	1337688987	/users/cn/jespinosa/phecomp/data/CRG/20120502_FDF_CRG/20120502_FDF_CRG/20120521_FDF_CRG_c12.mtb	2353	NA	WWFF	water	1	87023	1337688967	1	0.04	0.002	11551	1
4	Food 1	Intake 3	18	88172	1337690116	/users/cn/jespinosa/phecomp/data/CRG/20120502_FDF_CRG/20120502_FDF_CRG/20120521_FDF_CRG_c12.mtb	7367	180	WWFF	food_fat	3	88154	1337690098	1	0.0600000000000005	0.00333333333333336	11552	1
4	Food 1	Intake 3	62	88414	1337690358	/users/cn/jespinosa/phecomp/data/CRG/20120502_FDF_CRG/20120502_FDF_CRG/20120521_FDF_CRG_c12.mtb	7368	1708	WWFF	food_fat	3	88352	1337690296	1	0.0600000000000005	0.000967741935483879	11553	1
4	Food 1	Intake 3	140	90262	1337692206	/users/cn/jespinosa/phecomp/data/CRG/20120502_FDF_CRG/20120502_FDF_CRG/20120521_FDF_CRG_c12.mtb	7378	632	WWFF	food_fat	3	90122	1337692066	1	0.0400000000000009	0.000285714285714292	11554	1
4	Food 2	Intake 4	89	90983	1337692927	/users/cn/jespinosa/phecomp/data/CRG/20120502_FDF_CRG/20120502_FDF_CRG/20120521_FDF_CRG_c12.mtb	9190	65	WWFF	food_fat	4	90894	1337692838	1	0.140000000000001	0.00157303370786518	11555	1
4	Food 2	Intake 4	101	91149	1337693093	/users/cn/jespinosa/phecomp/data/CRG/20120502_FDF_CRG/20120502_FDF_CRG/20120521_FDF_CRG_c12.mtb	9192	103	WWFF	food_fat	4	91048	1337692992	1	0.0399999999999991	0.000396039603960387	11556	1
4	Drink 1	Intake 1	13	91155	1337693099	/users/cn/jespinosa/phecomp/data/CRG/20120502_FDF_CRG/20120502_FDF_CRG/20120521_FDF_CRG_c12.mtb	2354	NA	WWFF	water	1	91142	1337693086	1	0.0799999999999998	0.00615384615384614	11557	1
4	Food 2	Intake 4	49	91301	1337693245	/users/cn/jespinosa/phecomp/data/CRG/20120502_FDF_CRG/20120502_FDF_CRG/20120521_FDF_CRG_c12.mtb	9195	411	WWFF	food_fat	4	91252	1337693196	1	0.0399999999999991	0.000816326530612226	11558	1
4	Drink 2	Intake 2	14	91270	1337693214	/users/cn/jespinosa/phecomp/data/CRG/20120502_FDF_CRG/20120502_FDF_CRG/20120521_FDF_CRG_c12.mtb	2119	NA	WWFF	water	2	91256	1337693200	1	0.02	0.00142857142857143	11559	1
4	Food 1	Intake 3	1750	93462	1337695406	/users/cn/jespinosa/phecomp/data/CRG/20120502_FDF_CRG/20120502_FDF_CRG/20120521_FDF_CRG_c12.mtb	7382	COLL	WWFF	food_fat	3	91712	1337693656	1	0.68	0.000388571428571429	11560	1
4	Food 2	Intake 4	43	91760	1337693704	/users/cn/jespinosa/phecomp/data/CRG/20120502_FDF_CRG/20120502_FDF_CRG/20120521_FDF_CRG_c12.mtb	9201	156	WWFF	food_fat	4	91717	1337693661	1	0.140000000000001	0.0032558139534884	11561	1
4	Drink 1	Intake 1	26	91785	1337693729	/users/cn/jespinosa/phecomp/data/CRG/20120502_FDF_CRG/20120502_FDF_CRG/20120521_FDF_CRG_c12.mtb	2355	NA	WWFF	water	1	91759	1337693703	1	0.0600000000000001	0.00230769230769231	11562	1
4	Food 2	Intake 4	25	91941	1337693885	/users/cn/jespinosa/phecomp/data/CRG/20120502_FDF_CRG/20120502_FDF_CRG/20120521_FDF_CRG_c12.mtb	9203	202	WWFF	food_fat	4	91916	1337693860	1	0.0400000000000027	0.00160000000000011	11563	1
4	Food 2	Intake 4	14	92157	1337694101	/users/cn/jespinosa/phecomp/data/CRG/20120502_FDF_CRG/20120502_FDF_CRG/20120521_FDF_CRG_c12.mtb	9206	1836	WWFF	food_fat	4	92143	1337694087	1	0.0400000000000027	0.00285714285714305	11564	1
4	Food 1	Intake 3	15	94008	1337695952	/users/cn/jespinosa/phecomp/data/CRG/20120502_FDF_CRG/20120502_FDF_CRG/20120521_FDF_CRG_c12.mtb	7386	235	WWFF	food_fat	3	93993	1337695937	1	0.0600000000000005	0.00400000000000003	11565	1
4	Food 1	Intake 3	18	94261	1337696205	/users/cn/jespinosa/phecomp/data/CRG/20120502_FDF_CRG/20120502_FDF_CRG/20120521_FDF_CRG_c12.mtb	7389	1038	WWFF	food_fat	3	94243	1337696187	1	0.0400000000000009	0.00222222222222227	11566	1
4	Food 1	Intake 3	51	95350	1337697294	/users/cn/jespinosa/phecomp/data/CRG/20120502_FDF_CRG/20120502_FDF_CRG/20120521_FDF_CRG_c12.mtb	7396	214	WWFF	food_fat	3	95299	1337697243	1	0.140000000000001	0.00274509803921571	11567	1
4	Food 1	Intake 3	17	95581	1337697525	/users/cn/jespinosa/phecomp/data/CRG/20120502_FDF_CRG/20120502_FDF_CRG/20120521_FDF_CRG_c12.mtb	7399	91	WWFF	food_fat	3	95564	1337697508	1	0.0399999999999991	0.00235294117647054	11568	1
4	Food 1	Intake 3	12	95684	1337697628	/users/cn/jespinosa/phecomp/data/CRG/20120502_FDF_CRG/20120502_FDF_CRG/20120521_FDF_CRG_c12.mtb	7400	54	WWFF	food_fat	3	95672	1337697616	1	0.0200000000000014	0.00166666666666678	11569	1
4	Food 1	Intake 3	26	95764	1337697708	/users/cn/jespinosa/phecomp/data/CRG/20120502_FDF_CRG/20120502_FDF_CRG/20120521_FDF_CRG_c12.mtb	7401	1381	WWFF	food_fat	3	95738	1337697682	1	0.0800000000000001	0.00307692307692308	11570	1
4	Food 1	Intake 3	18	97163	1337699107	/users/cn/jespinosa/phecomp/data/CRG/20120502_FDF_CRG/20120502_FDF_CRG/20120521_FDF_CRG_c12.mtb	7409	42	WWFF	food_fat	3	97145	1337699089	1	0.100000000000001	0.00555555555555561	11571	1
4	Food 1	Intake 3	13	97218	1337699162	/users/cn/jespinosa/phecomp/data/CRG/20120502_FDF_CRG/20120502_FDF_CRG/20120521_FDF_CRG_c12.mtb	7411	289	WWFF	food_fat	3	97205	1337699149	1	0.0400000000000009	0.00307692307692315	11572	1
4	Food 1	Intake 3	60	97567	1337699511	/users/cn/jespinosa/phecomp/data/CRG/20120502_FDF_CRG/20120502_FDF_CRG/20120521_FDF_CRG_c12.mtb	7414	127	WWFF	food_fat	3	97507	1337699451	1	0.0999999999999996	0.00166666666666666	11573	1
4	Food 1	Intake 3	56	97750	1337699694	/users/cn/jespinosa/phecomp/data/CRG/20120502_FDF_CRG/20120502_FDF_CRG/20120521_FDF_CRG_c12.mtb	7417	1354	WWFF	food_fat	3	97694	1337699638	1	0.0599999999999987	0.00107142857142855	11574	1
4	Drink 1	Intake 1	23	97851	1337699795	/users/cn/jespinosa/phecomp/data/CRG/20120502_FDF_CRG/20120502_FDF_CRG/20120521_FDF_CRG_c12.mtb	2356	NA	WWFF	water	1	97828	1337699772	1	0.0800000000000001	0.00347826086956522	11575	1
4	Food 1	Intake 3	18	99122	1337701066	/users/cn/jespinosa/phecomp/data/CRG/20120502_FDF_CRG/20120502_FDF_CRG/20120521_FDF_CRG_c12.mtb	7428	409	WWFF	food_fat	3	99104	1337701048	1	0.0400000000000009	0.00222222222222227	11576	1
4	Food 1	Intake 3	36	99567	1337701511	/users/cn/jespinosa/phecomp/data/CRG/20120502_FDF_CRG/20120502_FDF_CRG/20120521_FDF_CRG_c12.mtb	7432	143	WWFF	food_fat	3	99531	1337701475	1	0.0600000000000005	0.00166666666666668	11577	1
4	Food 1	Intake 3	172	99882	1337701826	/users/cn/jespinosa/phecomp/data/CRG/20120502_FDF_CRG/20120502_FDF_CRG/20120521_FDF_CRG_c12.mtb	7434	1450	WWFF	food_fat	3	99710	1337701654	1	0.18	0.00104651162790698	11578	1
4	Drink 1	Intake 1	15	100838	1337702782	/users/cn/jespinosa/phecomp/data/CRG/20120502_FDF_CRG/20120502_FDF_CRG/20120521_FDF_CRG_c12.mtb	2357	NA	WWFF	water	1	100823	1337702767	1	0.1	0.00666666666666667	11579	1
4	Food 2	Intake 4	171	101503	1337703447	/users/cn/jespinosa/phecomp/data/CRG/20120502_FDF_CRG/20120502_FDF_CRG/20120521_FDF_CRG_c12.mtb	9221	353	WWFF	food_fat	4	101332	1337703276	1	0.0599999999999987	0.000350877192982449	11580	1
4	Food 1	Intake 3	401	102257	1337704201	/users/cn/jespinosa/phecomp/data/CRG/20120502_FDF_CRG/20120502_FDF_CRG/20120521_FDF_CRG_c12.mtb	7436	602	WWFF	food_fat	3	101856	1337703800	1	0.18	0.000448877805486284	11581	1
4	Food 1	Intake 3	38	102897	1337704841	/users/cn/jespinosa/phecomp/data/CRG/20120502_FDF_CRG/20120502_FDF_CRG/20120521_FDF_CRG_c12.mtb	7440	197	WWFF	food_fat	3	102859	1337704803	1	0.279999999999999	0.00736842105263155	11582	1
4	Food 1	Intake 3	28	103122	1337705066	/users/cn/jespinosa/phecomp/data/CRG/20120502_FDF_CRG/20120502_FDF_CRG/20120521_FDF_CRG_c12.mtb	7441	97	WWFF	food_fat	3	103094	1337705038	1	0.0600000000000005	0.00214285714285716	11583	1
4	Food 1	Intake 3	17	103236	1337705180	/users/cn/jespinosa/phecomp/data/CRG/20120502_FDF_CRG/20120502_FDF_CRG/20120521_FDF_CRG_c12.mtb	7442	969	WWFF	food_fat	3	103219	1337705163	1	0.0400000000000009	0.00235294117647064	11584	1
4	Food 1	Intake 3	42	104247	1337706191	/users/cn/jespinosa/phecomp/data/CRG/20120502_FDF_CRG/20120502_FDF_CRG/20120521_FDF_CRG_c12.mtb	7446	1968	WWFF	food_fat	3	104205	1337706149	1	0.0399999999999991	0.000952380952380931	11585	1
4	Food 1	Intake 3	74	106289	1337708233	/users/cn/jespinosa/phecomp/data/CRG/20120502_FDF_CRG/20120502_FDF_CRG/20120521_FDF_CRG_c12.mtb	7461	461	WWFF	food_fat	3	106215	1337708159	1	0.4	0.00540540540540541	11586	1
4	Drink 1	Intake 1	34	106253	1337708197	/users/cn/jespinosa/phecomp/data/CRG/20120502_FDF_CRG/20120502_FDF_CRG/20120521_FDF_CRG_c12.mtb	2358	NA	WWFF	water	1	106219	1337708163	1	0.12	0.00352941176470588	11587	1
4	Food 1	Intake 3	101	106851	1337708795	/users/cn/jespinosa/phecomp/data/CRG/20120502_FDF_CRG/20120502_FDF_CRG/20120521_FDF_CRG_c12.mtb	7465	250	WWFF	food_fat	3	106750	1337708694	1	0.0400000000000009	0.000396039603960405	11588	1
4	Drink 1	Intake 1	23	106996	1337708940	/users/cn/jespinosa/phecomp/data/CRG/20120502_FDF_CRG/20120502_FDF_CRG/20120521_FDF_CRG_c12.mtb	2359	NA	WWFF	water	1	106973	1337708917	1	0.04	0.00173913043478261	11589	1
4	Food 1	Intake 3	15	107116	1337709060	/users/cn/jespinosa/phecomp/data/CRG/20120502_FDF_CRG/20120502_FDF_CRG/20120521_FDF_CRG_c12.mtb	7468	25	WWFF	food_fat	3	107101	1337709045	1	0.0399999999999991	0.00266666666666661	11590	1
4	Food 1	Intake 3	15	107156	1337709100	/users/cn/jespinosa/phecomp/data/CRG/20120502_FDF_CRG/20120502_FDF_CRG/20120521_FDF_CRG_c12.mtb	7469	56	WWFF	food_fat	3	107141	1337709085	1	0.0600000000000005	0.00400000000000003	11591	1
4	Food 1	Intake 3	32	107244	1337709188	/users/cn/jespinosa/phecomp/data/CRG/20120502_FDF_CRG/20120502_FDF_CRG/20120521_FDF_CRG_c12.mtb	7470	103	WWFF	food_fat	3	107212	1337709156	1	0.0600000000000005	0.00187500000000002	11592	1
4	Food 1	Intake 3	85	107432	1337709376	/users/cn/jespinosa/phecomp/data/CRG/20120502_FDF_CRG/20120502_FDF_CRG/20120521_FDF_CRG_c12.mtb	7473	381	WWFF	food_fat	3	107347	1337709291	1	0.199999999999999	0.00235294117647058	11593	1
4	Food 1	Intake 3	16	107829	1337709773	/users/cn/jespinosa/phecomp/data/CRG/20120502_FDF_CRG/20120502_FDF_CRG/20120521_FDF_CRG_c12.mtb	7477	172	WWFF	food_fat	3	107813	1337709757	1	0.16	0.01	11594	1
4	Food 1	Intake 3	12	108013	1337709957	/users/cn/jespinosa/phecomp/data/CRG/20120502_FDF_CRG/20120502_FDF_CRG/20120521_FDF_CRG_c12.mtb	7479	207	WWFF	food_fat	3	108001	1337709945	1	0.0399999999999991	0.00333333333333326	11595	1
4	Food 1	Intake 3	346	108566	1337710510	/users/cn/jespinosa/phecomp/data/CRG/20120502_FDF_CRG/20120502_FDF_CRG/20120521_FDF_CRG_c12.mtb	7484	4	WWFF	food_fat	3	108220	1337710164	1	0.0399999999999991	0.000115606936416182	11596	1
4	Food 1	Intake 3	1621	110191	1337712135	/users/cn/jespinosa/phecomp/data/CRG/20120502_FDF_CRG/20120502_FDF_CRG/20120521_FDF_CRG_c12.mtb	7485	COLL	WWFF	food_fat	3	108570	1337710514	1	0.16	9.87045033929673e-05	11597	1
4	Food 2	Intake 4	47	109604	1337711548	/users/cn/jespinosa/phecomp/data/CRG/20120502_FDF_CRG/20120502_FDF_CRG/20120521_FDF_CRG_c12.mtb	9239	62	WWFF	food_fat	4	109557	1337711501	1	0.0600000000000023	0.0012765957446809	11598	1
4	Food 2	Intake 4	203	109869	1337711813	/users/cn/jespinosa/phecomp/data/CRG/20120502_FDF_CRG/20120502_FDF_CRG/20120521_FDF_CRG_c12.mtb	9241	290	WWFF	food_fat	4	109666	1337711610	1	0.0399999999999991	0.000197044334975365	11599	1
4	Food 2	Intake 4	9	110168	1337712112	/users/cn/jespinosa/phecomp/data/CRG/20120502_FDF_CRG/20120502_FDF_CRG/20120521_FDF_CRG_c12.mtb	9245	150	WWFF	food_fat	4	110159	1337712103	1	0.0399999999999991	0.00444444444444434	11600	1
4	Food 2	Intake 4	53	110371	1337712315	/users/cn/jespinosa/phecomp/data/CRG/20120502_FDF_CRG/20120502_FDF_CRG/20120521_FDF_CRG_c12.mtb	9247	333	WWFF	food_fat	4	110318	1337712262	1	0.0599999999999987	0.00113207547169809	11601	1
4	Drink 2	Intake 2	37	110444	1337712388	/users/cn/jespinosa/phecomp/data/CRG/20120502_FDF_CRG/20120502_FDF_CRG/20120521_FDF_CRG_c12.mtb	2126	NA	WWFF	water	2	110407	1337712351	1	0.0999999999999999	0.0027027027027027	11602	1
4	Food 2	Intake 4	47	110751	1337712695	/users/cn/jespinosa/phecomp/data/CRG/20120502_FDF_CRG/20120502_FDF_CRG/20120521_FDF_CRG_c12.mtb	9251	27	WWFF	food_fat	4	110704	1337712648	1	0.119999999999997	0.00255319148936164	11603	1
4	Food 2	Intake 4	21	110799	1337712743	/users/cn/jespinosa/phecomp/data/CRG/20120502_FDF_CRG/20120502_FDF_CRG/20120521_FDF_CRG_c12.mtb	9253	41	WWFF	food_fat	4	110778	1337712722	1	0.0599999999999987	0.0028571428571428	11604	1
4	Food 2	Intake 4	35	110875	1337712819	/users/cn/jespinosa/phecomp/data/CRG/20120502_FDF_CRG/20120502_FDF_CRG/20120521_FDF_CRG_c12.mtb	9254	499	WWFF	food_fat	4	110840	1337712784	1	0.0400000000000027	0.00114285714285722	11605	1
4	Food 2	Intake 4	231	111605	1337713549	/users/cn/jespinosa/phecomp/data/CRG/20120502_FDF_CRG/20120502_FDF_CRG/20120521_FDF_CRG_c12.mtb	9261	911	WWFF	food_fat	4	111374	1337713318	1	0.120000000000001	0.000519480519480524	11606	1
4	Food 1	Intake 3	33	112549	1337714493	/users/cn/jespinosa/phecomp/data/CRG/20120502_FDF_CRG/20120502_FDF_CRG/20120521_FDF_CRG_c12.mtb	7487	COLL	WWFF	food_fat	3	112516	1337714460	1	0.0600000000000005	0.00181818181818183	11607	1
4	Food 2	Intake 4	33	112550	1337714494	/users/cn/jespinosa/phecomp/data/CRG/20120502_FDF_CRG/20120502_FDF_CRG/20120521_FDF_CRG_c12.mtb	9267	39	WWFF	food_fat	4	112517	1337714461	1	0.0400000000000027	0.00121212121212129	11608	1
4	Food 1	Intake 3	455	113044	1337714988	/users/cn/jespinosa/phecomp/data/CRG/20120502_FDF_CRG/20120502_FDF_CRG/20120521_FDF_CRG_c12.mtb	7489	COLL	WWFF	food_fat	3	112589	1337714533	1	0.460000000000001	0.00101098901098901	11609	1
4	Food 2	Intake 4	60	112654	1337714598	/users/cn/jespinosa/phecomp/data/CRG/20120502_FDF_CRG/20120502_FDF_CRG/20120521_FDF_CRG_c12.mtb	9268	20	WWFF	food_fat	4	112594	1337714538	1	0.0799999999999983	0.0013333333333333	11610	1
4	Food 2	Intake 4	65	112739	1337714683	/users/cn/jespinosa/phecomp/data/CRG/20120502_FDF_CRG/20120502_FDF_CRG/20120521_FDF_CRG_c12.mtb	9269	726	WWFF	food_fat	4	112674	1337714618	1	0.100000000000001	0.00153846153846155	11611	1
4	Food 1	Intake 3	44	113509	1337715453	/users/cn/jespinosa/phecomp/data/CRG/20120502_FDF_CRG/20120502_FDF_CRG/20120521_FDF_CRG_c12.mtb	7494	918	WWFF	food_fat	3	113465	1337715409	1	0.0800000000000001	0.00181818181818182	11612	1
4	Food 1	Intake 3	134	114561	1337716505	/users/cn/jespinosa/phecomp/data/CRG/20120502_FDF_CRG/20120502_FDF_CRG/20120521_FDF_CRG_c12.mtb	7500	329	WWFF	food_fat	3	114427	1337716371	1	0.0800000000000001	0.000597014925373135	11613	1
4	Food 1	Intake 3	14	114904	1337716848	/users/cn/jespinosa/phecomp/data/CRG/20120502_FDF_CRG/20120502_FDF_CRG/20120521_FDF_CRG_c12.mtb	7504	224	WWFF	food_fat	3	114890	1337716834	1	0.0400000000000009	0.00285714285714292	11614	1
4	Food 1	Intake 3	41	115169	1337717113	/users/cn/jespinosa/phecomp/data/CRG/20120502_FDF_CRG/20120502_FDF_CRG/20120521_FDF_CRG_c12.mtb	7507	284	WWFF	food_fat	3	115128	1337717072	1	0.220000000000001	0.00536585365853661	11615	1
4	Food 1	Intake 3	265	115718	1337717662	/users/cn/jespinosa/phecomp/data/CRG/20120502_FDF_CRG/20120502_FDF_CRG/20120521_FDF_CRG_c12.mtb	7512	662	WWFF	food_fat	3	115453	1337717397	1	0.0400000000000009	0.000150943396226418	11616	1
4	Food 2	Intake 4	92	116472	1337718416	/users/cn/jespinosa/phecomp/data/CRG/20120502_FDF_CRG/20120502_FDF_CRG/20120521_FDF_CRG_c12.mtb	9280	16	WWFF	food_fat	4	116380	1337718324	1	0.0400000000000027	0.000434782608695682	11617	1
4	Food 2	Intake 4	190	116678	1337718622	/users/cn/jespinosa/phecomp/data/CRG/20120502_FDF_CRG/20120502_FDF_CRG/20120521_FDF_CRG_c12.mtb	9281	106	WWFF	food_fat	4	116488	1337718432	1	0.0799999999999983	0.000421052631578938	11618	1
4	Drink 1	Intake 1	28	116760	1337718704	/users/cn/jespinosa/phecomp/data/CRG/20120502_FDF_CRG/20120502_FDF_CRG/20120521_FDF_CRG_c12.mtb	2367	NA	WWFF	water	1	116732	1337718676	1	0.0599999999999996	0.00214285714285713	11619	1
4	Food 2	Intake 4	18	116802	1337718746	/users/cn/jespinosa/phecomp/data/CRG/20120502_FDF_CRG/20120502_FDF_CRG/20120521_FDF_CRG_c12.mtb	9284	COLL	WWFF	food_fat	4	116784	1337718728	1	0.0799999999999983	0.00444444444444435	11620	1
4	Food 1	Intake 3	66	116851	1337718795	/users/cn/jespinosa/phecomp/data/CRG/20120502_FDF_CRG/20120502_FDF_CRG/20120521_FDF_CRG_c12.mtb	7514	22	WWFF	food_fat	3	116785	1337718729	1	0.0200000000000014	0.000303030303030324	11621	1
4	Food 1	Intake 3	78	116951	1337718895	/users/cn/jespinosa/phecomp/data/CRG/20120502_FDF_CRG/20120502_FDF_CRG/20120521_FDF_CRG_c12.mtb	7515	4	WWFF	food_fat	3	116873	1337718817	1	0.0399999999999991	0.000512820512820501	11622	1
4	Food 1	Intake 3	271	117226	1337719170	/users/cn/jespinosa/phecomp/data/CRG/20120502_FDF_CRG/20120502_FDF_CRG/20120521_FDF_CRG_c12.mtb	7516	COLL	WWFF	food_fat	3	116955	1337718899	1	0.220000000000001	0.000811808118081184	11623	1
4	Food 2	Intake 4	79	117046	1337718990	/users/cn/jespinosa/phecomp/data/CRG/20120502_FDF_CRG/20120502_FDF_CRG/20120521_FDF_CRG_c12.mtb	9286	516	WWFF	food_fat	4	116967	1337718911	1	0.18	0.00227848101265823	11624	1
4	Food 1	Intake 3	28	117590	1337719534	/users/cn/jespinosa/phecomp/data/CRG/20120502_FDF_CRG/20120502_FDF_CRG/20120521_FDF_CRG_c12.mtb	7518	123	WWFF	food_fat	3	117562	1337719506	1	0.120000000000001	0.00428571428571432	11625	1
4	Food 2	Intake 4	9	117722	1337719666	/users/cn/jespinosa/phecomp/data/CRG/20120502_FDF_CRG/20120502_FDF_CRG/20120521_FDF_CRG_c12.mtb	9294	102	WWFF	food_fat	4	117713	1337719657	1	0.0400000000000027	0.00444444444444474	11626	1
4	Food 2	Intake 4	111	117935	1337719879	/users/cn/jespinosa/phecomp/data/CRG/20120502_FDF_CRG/20120502_FDF_CRG/20120521_FDF_CRG_c12.mtb	9296	COLL	WWFF	food_fat	4	117824	1337719768	1	0.0600000000000023	0.000540540540540561	11627	1
4	Food 1	Intake 3	111	117937	1337719881	/users/cn/jespinosa/phecomp/data/CRG/20120502_FDF_CRG/20120502_FDF_CRG/20120521_FDF_CRG_c12.mtb	7522	93	WWFF	food_fat	3	117826	1337719770	1	0.34	0.00306306306306306	11628	1
4	Food 2	Intake 4	139	118169	1337720113	/users/cn/jespinosa/phecomp/data/CRG/20120502_FDF_CRG/20120502_FDF_CRG/20120521_FDF_CRG_c12.mtb	9298	358	WWFF	food_fat	4	118030	1337719974	1	0.279999999999998	0.00201438848920862	11629	1
4	Drink 1	Intake 1	25	118197	1337720141	/users/cn/jespinosa/phecomp/data/CRG/20120502_FDF_CRG/20120502_FDF_CRG/20120521_FDF_CRG_c12.mtb	2368	NA	WWFF	water	1	118172	1337720116	1	0.0800000000000001	0.0032	11630	1
4	Food 2	Intake 4	106	118633	1337720577	/users/cn/jespinosa/phecomp/data/CRG/20120502_FDF_CRG/20120502_FDF_CRG/20120521_FDF_CRG_c12.mtb	9300	858	WWFF	food_fat	4	118527	1337720471	1	0.100000000000001	0.000943396226415104	11631	1
4	Food 2	Intake 4	168	119659	1337721603	/users/cn/jespinosa/phecomp/data/CRG/20120502_FDF_CRG/20120502_FDF_CRG/20120521_FDF_CRG_c12.mtb	9306	396	WWFF	food_fat	4	119491	1337721435	1	0.120000000000001	0.00071428571428572	11632	1
4	Food 2	Intake 4	14	120069	1337722013	/users/cn/jespinosa/phecomp/data/CRG/20120502_FDF_CRG/20120502_FDF_CRG/20120521_FDF_CRG_c12.mtb	9312	126	WWFF	food_fat	4	120055	1337721999	1	0.0799999999999983	0.00571428571428559	11633	1
4	Drink 1	Intake 1	24	120081	1337722025	/users/cn/jespinosa/phecomp/data/CRG/20120502_FDF_CRG/20120502_FDF_CRG/20120521_FDF_CRG_c12.mtb	2369	NA	WWFF	water	1	120057	1337722001	1	0.04	0.00166666666666667	11634	1
4	Food 2	Intake 4	168	120363	1337722307	/users/cn/jespinosa/phecomp/data/CRG/20120502_FDF_CRG/20120502_FDF_CRG/20120521_FDF_CRG_c12.mtb	9314	613	WWFF	food_fat	4	120195	1337722139	1	0.100000000000001	0.000595238095238101	11635	1
4	Food 1	Intake 3	16	120992	1337722936	/users/cn/jespinosa/phecomp/data/CRG/20120502_FDF_CRG/20120502_FDF_CRG/20120521_FDF_CRG_c12.mtb	7528	33	WWFF	food_fat	3	120976	1337722920	1	0.0200000000000014	0.00125000000000009	11636	1
4	Food 1	Intake 3	584	121609	1337723553	/users/cn/jespinosa/phecomp/data/CRG/20120502_FDF_CRG/20120502_FDF_CRG/20120521_FDF_CRG_c12.mtb	7529	73	WWFF	food_fat	3	121025	1337722969	1	0.0799999999999983	0.00013698630136986	11637	1
4	Drink 2	Intake 2	16	121131	1337723075	/users/cn/jespinosa/phecomp/data/CRG/20120502_FDF_CRG/20120502_FDF_CRG/20120521_FDF_CRG_c12.mtb	2135	NA	WWFF	water	2	121115	1337723059	1	0.0600000000000001	0.00375000000000001	11638	1
4	Food 1	Intake 3	36	121718	1337723662	/users/cn/jespinosa/phecomp/data/CRG/20120502_FDF_CRG/20120502_FDF_CRG/20120521_FDF_CRG_c12.mtb	7531	402	WWFF	food_fat	3	121682	1337723626	1	0.0399999999999991	0.00111111111111109	11639	1
4	Food 1	Intake 3	18	122138	1337724082	/users/cn/jespinosa/phecomp/data/CRG/20120502_FDF_CRG/20120502_FDF_CRG/20120521_FDF_CRG_c12.mtb	7534	1357	WWFF	food_fat	3	122120	1337724064	1	0.0400000000000009	0.00222222222222227	11640	1
4	Food 1	Intake 3	16	123511	1337725455	/users/cn/jespinosa/phecomp/data/CRG/20120502_FDF_CRG/20120502_FDF_CRG/20120521_FDF_CRG_c12.mtb	7539	88	WWFF	food_fat	3	123495	1337725439	1	0.0200000000000014	0.00125000000000009	11641	1
4	Food 1	Intake 3	33	123632	1337725576	/users/cn/jespinosa/phecomp/data/CRG/20120502_FDF_CRG/20120502_FDF_CRG/20120521_FDF_CRG_c12.mtb	7541	COLL	WWFF	food_fat	3	123599	1337725543	1	0.199999999999999	0.00606060606060603	11642	1
4	Food 2	Intake 4	24	123624	1337725568	/users/cn/jespinosa/phecomp/data/CRG/20120502_FDF_CRG/20120502_FDF_CRG/20120521_FDF_CRG_c12.mtb	9337	157	WWFF	food_fat	4	123600	1337725544	1	0.0399999999999991	0.00166666666666663	11643	1
4	Food 1	Intake 3	32	123813	1337725757	/users/cn/jespinosa/phecomp/data/CRG/20120502_FDF_CRG/20120502_FDF_CRG/20120521_FDF_CRG_c12.mtb	7542	975	WWFF	food_fat	3	123781	1337725725	1	0.0600000000000005	0.00187500000000002	11644	1
4	Drink 1	Intake 1	19	124669	1337726613	/users/cn/jespinosa/phecomp/data/CRG/20120502_FDF_CRG/20120502_FDF_CRG/20120521_FDF_CRG_c12.mtb	2370	NA	WWFF	water	1	124650	1337726594	1	0.02	0.00105263157894737	11645	1
4	Food 2	Intake 4	28	124816	1337726760	/users/cn/jespinosa/phecomp/data/CRG/20120502_FDF_CRG/20120502_FDF_CRG/20120521_FDF_CRG_c12.mtb	9348	COLL	WWFF	food_fat	4	124788	1337726732	1	0.360000000000003	0.012857142857143	11646	1
4	Food 1	Intake 3	110	124901	1337726845	/users/cn/jespinosa/phecomp/data/CRG/20120502_FDF_CRG/20120502_FDF_CRG/20120521_FDF_CRG_c12.mtb	7548	250	WWFF	food_fat	3	124791	1337726735	1	0.719999999999999	0.00654545454545454	11647	1
4	Food 1	Intake 3	40	125191	1337727135	/users/cn/jespinosa/phecomp/data/CRG/20120502_FDF_CRG/20120502_FDF_CRG/20120521_FDF_CRG_c12.mtb	7550	233	WWFF	food_fat	3	125151	1337727095	1	0.0400000000000009	0.00100000000000002	11648	1
4	Drink 1	Intake 1	15	125175	1337727119	/users/cn/jespinosa/phecomp/data/CRG/20120502_FDF_CRG/20120502_FDF_CRG/20120521_FDF_CRG_c12.mtb	2371	NA	WWFF	water	1	125160	1337727104	1	0.0600000000000001	0.00400000000000001	11649	1
4	Food 1	Intake 3	26	125450	1337727394	/users/cn/jespinosa/phecomp/data/CRG/20120502_FDF_CRG/20120502_FDF_CRG/20120521_FDF_CRG_c12.mtb	7553	96	WWFF	food_fat	3	125424	1337727368	1	0.0399999999999991	0.0015384615384615	11650	1
4	Food 1	Intake 3	21	125567	1337727511	/users/cn/jespinosa/phecomp/data/CRG/20120502_FDF_CRG/20120502_FDF_CRG/20120521_FDF_CRG_c12.mtb	7555	1314	WWFF	food_fat	3	125546	1337727490	1	0.0400000000000009	0.00190476190476195	11651	1
4	Drink 1	Intake 1	17	125978	1337727922	/users/cn/jespinosa/phecomp/data/CRG/20120502_FDF_CRG/20120502_FDF_CRG/20120521_FDF_CRG_c12.mtb	2372	NA	WWFF	water	1	125961	1337727905	1	0.02	0.00117647058823529	11652	1
4	Food 2	Intake 4	274	127155	1337729099	/users/cn/jespinosa/phecomp/data/CRG/20120502_FDF_CRG/20120502_FDF_CRG/20120521_FDF_CRG_c12.mtb	9356	COLL	WWFF	food_fat	4	126881	1337728825	1	0.52	0.0018978102189781	11653	1
4	Food 1	Intake 3	576	127459	1337729403	/users/cn/jespinosa/phecomp/data/CRG/20120502_FDF_CRG/20120502_FDF_CRG/20120521_FDF_CRG_c12.mtb	7559	COLL	WWFF	food_fat	3	126883	1337728827	1	0.700000000000001	0.00121527777777778	11654	1
4	Drink 1	Intake 1	19	127242	1337729186	/users/cn/jespinosa/phecomp/data/CRG/20120502_FDF_CRG/20120502_FDF_CRG/20120521_FDF_CRG_c12.mtb	2373	NA	WWFF	water	1	127223	1337729167	1	0.04	0.00210526315789474	11655	1
4	Food 2	Intake 4	99	127331	1337729275	/users/cn/jespinosa/phecomp/data/CRG/20120502_FDF_CRG/20120502_FDF_CRG/20120521_FDF_CRG_c12.mtb	9358	212	WWFF	food_fat	4	127232	1337729176	1	0.0799999999999983	0.000808080808080791	11656	1
4	Food 1	Intake 3	405	127948	1337729892	/users/cn/jespinosa/phecomp/data/CRG/20120502_FDF_CRG/20120502_FDF_CRG/20120521_FDF_CRG_c12.mtb	7560	COLL	WWFF	food_fat	3	127543	1337729487	1	0.0399999999999991	9.87654320987632e-05	11657	1
4	Drink 2	Intake 2	83	127716	1337729660	/users/cn/jespinosa/phecomp/data/CRG/20120502_FDF_CRG/20120502_FDF_CRG/20120521_FDF_CRG_c12.mtb	2138	NA	WWFF	water	2	127633	1337729577	1	0.0600000000000001	0.000722891566265061	11658	1
4	Food 2	Intake 4	40	127747	1337729691	/users/cn/jespinosa/phecomp/data/CRG/20120502_FDF_CRG/20120502_FDF_CRG/20120521_FDF_CRG_c12.mtb	9363	8	WWFF	food_fat	4	127707	1337729651	1	0.0399999999999991	0.000999999999999977	11659	1
4	Food 2	Intake 4	148	127903	1337729847	/users/cn/jespinosa/phecomp/data/CRG/20120502_FDF_CRG/20120502_FDF_CRG/20120521_FDF_CRG_c12.mtb	9364	56	WWFF	food_fat	4	127755	1337729699	1	0.0399999999999991	0.000270270270270264	11660	1
4	Drink 1	Intake 1	26	127857	1337729801	/users/cn/jespinosa/phecomp/data/CRG/20120502_FDF_CRG/20120502_FDF_CRG/20120521_FDF_CRG_c12.mtb	2375	NA	WWFF	water	1	127831	1337729775	1	0.02	0.000769230769230769	11661	1
4	Food 1	Intake 3	314	128273	1337730217	/users/cn/jespinosa/phecomp/data/CRG/20120502_FDF_CRG/20120502_FDF_CRG/20120521_FDF_CRG_c12.mtb	7561	COLL	WWFF	food_fat	3	127959	1337729903	1	0.16	0.000509554140127389	11662	1
4	Drink 2	Intake 2	22	128067	1337730011	/users/cn/jespinosa/phecomp/data/CRG/20120502_FDF_CRG/20120502_FDF_CRG/20120521_FDF_CRG_c12.mtb	2139	NA	WWFF	water	2	128045	1337729989	1	0.0599999999999998	0.00272727272727272	11663	1
4	Food 2	Intake 4	33	128106	1337730050	/users/cn/jespinosa/phecomp/data/CRG/20120502_FDF_CRG/20120502_FDF_CRG/20120521_FDF_CRG_c12.mtb	9368	53	WWFF	food_fat	4	128073	1337730017	1	0.0399999999999991	0.00121212121212118	11664	1
4	Food 2	Intake 4	37	128196	1337730140	/users/cn/jespinosa/phecomp/data/CRG/20120502_FDF_CRG/20120502_FDF_CRG/20120521_FDF_CRG_c12.mtb	9370	247	WWFF	food_fat	4	128159	1337730103	1	0.0400000000000027	0.00108108108108115	11665	1
4	Drink 1	Intake 1	22	128409	1337730353	/users/cn/jespinosa/phecomp/data/CRG/20120502_FDF_CRG/20120502_FDF_CRG/20120521_FDF_CRG_c12.mtb	2376	NA	WWFF	water	1	128387	1337730331	1	0.0600000000000001	0.00272727272727273	11666	1
4	Food 2	Intake 4	81	128524	1337730468	/users/cn/jespinosa/phecomp/data/CRG/20120502_FDF_CRG/20120502_FDF_CRG/20120521_FDF_CRG_c12.mtb	9373	191	WWFF	food_fat	4	128443	1337730387	1	0.0399999999999991	0.000493827160493816	11667	1
4	Food 1	Intake 3	25	128740	1337730684	/users/cn/jespinosa/phecomp/data/CRG/20120502_FDF_CRG/20120502_FDF_CRG/20120521_FDF_CRG_c12.mtb	7564	9	WWFF	food_fat	3	128715	1337730659	1	0.0399999999999991	0.00159999999999996	11668	1
4	Food 1	Intake 3	15	128764	1337730708	/users/cn/jespinosa/phecomp/data/CRG/20120502_FDF_CRG/20120502_FDF_CRG/20120521_FDF_CRG_c12.mtb	7565	COLL	WWFF	food_fat	3	128749	1337730693	1	0.120000000000001	0.00800000000000007	11669	1
4	Food 2	Intake 4	11	128762	1337730706	/users/cn/jespinosa/phecomp/data/CRG/20120502_FDF_CRG/20120502_FDF_CRG/20120521_FDF_CRG_c12.mtb	9376	398	WWFF	food_fat	4	128751	1337730695	1	0.0400000000000027	0.00363636363636388	11670	1
4	Drink 2	Intake 2	25	128778	1337730722	/users/cn/jespinosa/phecomp/data/CRG/20120502_FDF_CRG/20120502_FDF_CRG/20120521_FDF_CRG_c12.mtb	2140	NA	WWFF	water	2	128753	1337730697	1	0.1	0.004	11671	1
4	Food 1	Intake 3	603	129763	1337731707	/users/cn/jespinosa/phecomp/data/CRG/20120502_FDF_CRG/20120502_FDF_CRG/20120521_FDF_CRG_c12.mtb	7568	COLL	WWFF	food_fat	3	129160	1337731104	1	0.200000000000001	0.000331674958540632	11672	1
4	Food 2	Intake 4	83	129596	1337731540	/users/cn/jespinosa/phecomp/data/CRG/20120502_FDF_CRG/20120502_FDF_CRG/20120521_FDF_CRG_c12.mtb	9386	179	WWFF	food_fat	4	129513	1337731457	1	0.0399999999999991	0.000481927710843363	11673	1
4	Food 1	Intake 3	123	129898	1337731842	/users/cn/jespinosa/phecomp/data/CRG/20120502_FDF_CRG/20120502_FDF_CRG/20120521_FDF_CRG_c12.mtb	7569	COLL	WWFF	food_fat	3	129775	1337731719	1	0.0800000000000001	0.000650406504065041	11674	1
4	Food 2	Intake 4	64	129871	1337731815	/users/cn/jespinosa/phecomp/data/CRG/20120502_FDF_CRG/20120502_FDF_CRG/20120521_FDF_CRG_c12.mtb	9390	154	WWFF	food_fat	4	129807	1337731751	1	0.0399999999999991	0.000624999999999986	11675	1
4	Food 2	Intake 4	18	130043	1337731987	/users/cn/jespinosa/phecomp/data/CRG/20120502_FDF_CRG/20120502_FDF_CRG/20120521_FDF_CRG_c12.mtb	9392	1871	WWFF	food_fat	4	130025	1337731969	1	0.0200000000000031	0.00111111111111128	11676	1
4	Drink 1	Intake 1	25	130238	1337732182	/users/cn/jespinosa/phecomp/data/CRG/20120502_FDF_CRG/20120502_FDF_CRG/20120521_FDF_CRG_c12.mtb	2378	NA	WWFF	water	1	130213	1337732157	1	0.1	0.004	11677	1
4	Food 1	Intake 3	38	131952	1337733896	/users/cn/jespinosa/phecomp/data/CRG/20120502_FDF_CRG/20120502_FDF_CRG/20120521_FDF_CRG_c12.mtb	7577	1161	WWFF	food_fat	3	131914	1337733858	1	0.0599999999999987	0.00157894736842102	11678	1
4	Food 1	Intake 3	17	133130	1337735074	/users/cn/jespinosa/phecomp/data/CRG/20120502_FDF_CRG/20120502_FDF_CRG/20120521_FDF_CRG_c12.mtb	7593	567	WWFF	food_fat	3	133113	1337735057	1	0.0400000000000009	0.00235294117647064	11679	1
4	Food 1	Intake 3	21	133718	1337735662	/users/cn/jespinosa/phecomp/data/CRG/20120502_FDF_CRG/20120502_FDF_CRG/20120521_FDF_CRG_c12.mtb	7597	154	WWFF	food_fat	3	133697	1337735641	1	0.0200000000000014	0.000952380952381019	11680	1
4	Food 1	Intake 3	1202	135074	1337737018	/users/cn/jespinosa/phecomp/data/CRG/20120502_FDF_CRG/20120502_FDF_CRG/20120521_FDF_CRG_c12.mtb	7599	403	WWFF	food_fat	3	133872	1337735816	1	0.16	0.000133111480865225	11681	1
4	Drink 1	Intake 1	16	134849	1337736793	/users/cn/jespinosa/phecomp/data/CRG/20120502_FDF_CRG/20120502_FDF_CRG/20120521_FDF_CRG_c12.mtb	2380	NA	WWFF	water	1	134833	1337736777	1	0.0599999999999996	0.00374999999999998	11682	1
4	Food 1	Intake 3	15	135492	1337737436	/users/cn/jespinosa/phecomp/data/CRG/20120502_FDF_CRG/20120502_FDF_CRG/20120521_FDF_CRG_c12.mtb	7604	340	WWFF	food_fat	3	135477	1337737421	1	0.0200000000000014	0.00133333333333343	11683	1
4	Food 1	Intake 3	22	135854	1337737798	/users/cn/jespinosa/phecomp/data/CRG/20120502_FDF_CRG/20120502_FDF_CRG/20120521_FDF_CRG_c12.mtb	7610	54	WWFF	food_fat	3	135832	1337737776	1	0.0399999999999991	0.00181818181818178	11684	1
4	Food 1	Intake 3	16	135924	1337737868	/users/cn/jespinosa/phecomp/data/CRG/20120502_FDF_CRG/20120502_FDF_CRG/20120521_FDF_CRG_c12.mtb	7611	693	WWFF	food_fat	3	135908	1337737852	1	0.0400000000000009	0.00250000000000006	11685	1
4	Food 1	Intake 3	13	136630	1337738574	/users/cn/jespinosa/phecomp/data/CRG/20120502_FDF_CRG/20120502_FDF_CRG/20120521_FDF_CRG_c12.mtb	7615	77	WWFF	food_fat	3	136617	1337738561	1	0.0600000000000005	0.00461538461538465	11686	1
4	Food 1	Intake 3	15	136722	1337738666	/users/cn/jespinosa/phecomp/data/CRG/20120502_FDF_CRG/20120502_FDF_CRG/20120521_FDF_CRG_c12.mtb	7616	142	WWFF	food_fat	3	136707	1337738651	1	0.0399999999999991	0.00266666666666661	11687	1
4	Food 1	Intake 3	15	136879	1337738823	/users/cn/jespinosa/phecomp/data/CRG/20120502_FDF_CRG/20120502_FDF_CRG/20120521_FDF_CRG_c12.mtb	7617	128	WWFF	food_fat	3	136864	1337738808	1	0.0600000000000005	0.00400000000000003	11688	1
4	Food 1	Intake 3	28	137035	1337738979	/users/cn/jespinosa/phecomp/data/CRG/20120502_FDF_CRG/20120502_FDF_CRG/20120521_FDF_CRG_c12.mtb	7620	214	WWFF	food_fat	3	137007	1337738951	1	0.199999999999999	0.00714285714285711	11689	1
4	Food 1	Intake 3	32	137281	1337739225	/users/cn/jespinosa/phecomp/data/CRG/20120502_FDF_CRG/20120502_FDF_CRG/20120521_FDF_CRG_c12.mtb	7623	654	WWFF	food_fat	3	137249	1337739193	1	0.100000000000001	0.00312500000000003	11690	1
4	Food 1	Intake 3	28	137963	1337739907	/users/cn/jespinosa/phecomp/data/CRG/20120502_FDF_CRG/20120502_FDF_CRG/20120521_FDF_CRG_c12.mtb	7626	3	WWFF	food_fat	3	137935	1337739879	1	0.640000000000001	0.0228571428571429	11691	1
4	Food 2	Intake 4	20	137986	1337739930	/users/cn/jespinosa/phecomp/data/CRG/20120502_FDF_CRG/20120502_FDF_CRG/20120521_FDF_CRG_c12.mtb	9420	38	WWFF	food_fat	4	137966	1337739910	1	0.219999999999999	0.011	11692	1
4	Food 1	Intake 3	483	138507	1337740451	/users/cn/jespinosa/phecomp/data/CRG/20120502_FDF_CRG/20120502_FDF_CRG/20120521_FDF_CRG_c12.mtb	7628	COLL	WWFF	food_fat	3	138024	1337739968	1	0.140000000000001	0.00028985507246377	11693	1
4	Food 2	Intake 4	107	138224	1337740168	/users/cn/jespinosa/phecomp/data/CRG/20120502_FDF_CRG/20120502_FDF_CRG/20120521_FDF_CRG_c12.mtb	9422	20	WWFF	food_fat	4	138117	1337740061	1	0.0400000000000027	0.00037383177570096	11694	1
4	Food 2	Intake 4	154	138398	1337740342	/users/cn/jespinosa/phecomp/data/CRG/20120502_FDF_CRG/20120502_FDF_CRG/20120521_FDF_CRG_c12.mtb	9423	617	WWFF	food_fat	4	138244	1337740188	1	0.0599999999999987	0.000389610389610381	11695	1
4	Drink 2	Intake 2	10	138553	1337740497	/users/cn/jespinosa/phecomp/data/CRG/20120502_FDF_CRG/20120502_FDF_CRG/20120521_FDF_CRG_c12.mtb	2142	NA	WWFF	water	2	138543	1337740487	1	0.04	0.004	11696	1
4	Drink 1	Intake 1	21	138658	1337740602	/users/cn/jespinosa/phecomp/data/CRG/20120502_FDF_CRG/20120502_FDF_CRG/20120521_FDF_CRG_c12.mtb	2382	NA	WWFF	water	1	138637	1337740581	1	0.0600000000000001	0.00285714285714286	11697	1
4	Food 2	Intake 4	24	139039	1337740983	/users/cn/jespinosa/phecomp/data/CRG/20120502_FDF_CRG/20120502_FDF_CRG/20120521_FDF_CRG_c12.mtb	9429	673	WWFF	food_fat	4	139015	1337740959	1	0.0599999999999987	0.00249999999999995	11698	1
4	Drink 1	Intake 1	15	139090	1337741034	/users/cn/jespinosa/phecomp/data/CRG/20120502_FDF_CRG/20120502_FDF_CRG/20120521_FDF_CRG_c12.mtb	2383	NA	WWFF	water	1	139075	1337741019	1	0.0600000000000001	0.00400000000000001	11699	1
4	Food 2	Intake 4	45	139757	1337741701	/users/cn/jespinosa/phecomp/data/CRG/20120502_FDF_CRG/20120502_FDF_CRG/20120521_FDF_CRG_c12.mtb	9434	179	WWFF	food_fat	4	139712	1337741656	1	0.100000000000001	0.00222222222222224	11700	1
4	Food 1	Intake 3	74	140010	1337741954	/users/cn/jespinosa/phecomp/data/CRG/20120502_FDF_CRG/20120502_FDF_CRG/20120521_FDF_CRG_c12.mtb	7632	68	WWFF	food_fat	3	139936	1337741880	1	0.0400000000000009	0.000540540540540553	11701	1
4	Food 2	Intake 4	18	140096	1337742040	/users/cn/jespinosa/phecomp/data/CRG/20120502_FDF_CRG/20120502_FDF_CRG/20120521_FDF_CRG_c12.mtb	9437	285	WWFF	food_fat	4	140078	1337742022	1	0.0599999999999987	0.00333333333333326	11702	1
4	Food 1	Intake 3	60	140441	1337742385	/users/cn/jespinosa/phecomp/data/CRG/20120502_FDF_CRG/20120502_FDF_CRG/20120521_FDF_CRG_c12.mtb	7636	33	WWFF	food_fat	3	140381	1337742325	1	0.119999999999999	0.00199999999999998	11703	1
4	Food 1	Intake 3	67	140541	1337742485	/users/cn/jespinosa/phecomp/data/CRG/20120502_FDF_CRG/20120502_FDF_CRG/20120521_FDF_CRG_c12.mtb	7637	721	WWFF	food_fat	3	140474	1337742418	1	0.0400000000000009	0.000597014925373148	11704	1
4	Food 1	Intake 3	405	141667	1337743611	/users/cn/jespinosa/phecomp/data/CRG/20120502_FDF_CRG/20120502_FDF_CRG/20120521_FDF_CRG_c12.mtb	7639	475	WWFF	food_fat	3	141262	1337743206	1	0.24	0.000592592592592593	11705	1
4	Drink 1	Intake 1	18	141437	1337743381	/users/cn/jespinosa/phecomp/data/CRG/20120502_FDF_CRG/20120502_FDF_CRG/20120521_FDF_CRG_c12.mtb	2384	NA	WWFF	water	1	141419	1337743363	1	0.0800000000000001	0.00444444444444445	11706	1
4	Food 1	Intake 3	35	142177	1337744121	/users/cn/jespinosa/phecomp/data/CRG/20120502_FDF_CRG/20120502_FDF_CRG/20120521_FDF_CRG_c12.mtb	7644	60	WWFF	food_fat	3	142142	1337744086	1	0.0800000000000001	0.00228571428571429	11707	1
4	Food 1	Intake 3	129	142366	1337744310	/users/cn/jespinosa/phecomp/data/CRG/20120502_FDF_CRG/20120502_FDF_CRG/20120521_FDF_CRG_c12.mtb	7646	349	WWFF	food_fat	3	142237	1337744181	1	0.139999999999999	0.00108527131782945	11708	1
4	Food 1	Intake 3	44	142759	1337744703	/users/cn/jespinosa/phecomp/data/CRG/20120502_FDF_CRG/20120502_FDF_CRG/20120521_FDF_CRG_c12.mtb	7648	493	WWFF	food_fat	3	142715	1337744659	1	0.239999999999998	0.00545454545454541	11709	1
4	Food 1	Intake 3	89	143341	1337745285	/users/cn/jespinosa/phecomp/data/CRG/20120502_FDF_CRG/20120502_FDF_CRG/20120521_FDF_CRG_c12.mtb	7652	COLL	WWFF	food_fat	3	143252	1337745196	1	0.0800000000000001	0.000898876404494383	11710	1
4	Food 2	Intake 4	31	143296	1337745240	/users/cn/jespinosa/phecomp/data/CRG/20120502_FDF_CRG/20120502_FDF_CRG/20120521_FDF_CRG_c12.mtb	9456	321	WWFF	food_fat	4	143265	1337745209	1	0.18	0.00580645161290323	11711	1
4	Drink 1	Intake 1	22	143311	1337745255	/users/cn/jespinosa/phecomp/data/CRG/20120502_FDF_CRG/20120502_FDF_CRG/20120521_FDF_CRG_c12.mtb	2385	NA	WWFF	water	1	143289	1337745233	1	0.0600000000000001	0.00272727272727273	11712	1
4	Food 1	Intake 3	20	143637	1337745581	/users/cn/jespinosa/phecomp/data/CRG/20120502_FDF_CRG/20120502_FDF_CRG/20120521_FDF_CRG_c12.mtb	7653	625	WWFF	food_fat	3	143617	1337745561	1	0.0399999999999991	0.00199999999999995	11713	1
4	Food 1	Intake 3	32	144294	1337746238	/users/cn/jespinosa/phecomp/data/CRG/20120502_FDF_CRG/20120502_FDF_CRG/20120521_FDF_CRG_c12.mtb	7656	189	WWFF	food_fat	3	144262	1337746206	1	0.0800000000000001	0.0025	11714	1
4	Food 1	Intake 3	33	144516	1337746460	/users/cn/jespinosa/phecomp/data/CRG/20120502_FDF_CRG/20120502_FDF_CRG/20120521_FDF_CRG_c12.mtb	7659	17	WWFF	food_fat	3	144483	1337746427	1	0.0999999999999996	0.00303030303030302	11715	1
4	Food 1	Intake 3	43	144576	1337746520	/users/cn/jespinosa/phecomp/data/CRG/20120502_FDF_CRG/20120502_FDF_CRG/20120521_FDF_CRG_c12.mtb	7660	1010	WWFF	food_fat	3	144533	1337746477	1	0.0800000000000001	0.00186046511627907	11716	1
4	Food 1	Intake 3	89	145675	1337747619	/users/cn/jespinosa/phecomp/data/CRG/20120502_FDF_CRG/20120502_FDF_CRG/20120521_FDF_CRG_c12.mtb	7665	110	WWFF	food_fat	3	145586	1337747530	1	0.139999999999999	0.00157303370786516	11717	1
4	Food 1	Intake 3	73	145858	1337747802	/users/cn/jespinosa/phecomp/data/CRG/20120502_FDF_CRG/20120502_FDF_CRG/20120521_FDF_CRG_c12.mtb	7667	443	WWFF	food_fat	3	145785	1337747729	1	0.100000000000001	0.00136986301369864	11718	1
4	Food 1	Intake 3	14	146315	1337748259	/users/cn/jespinosa/phecomp/data/CRG/20120502_FDF_CRG/20120502_FDF_CRG/20120521_FDF_CRG_c12.mtb	7672	49	WWFF	food_fat	3	146301	1337748245	1	0.0600000000000005	0.00428571428571432	11719	1
4	Food 1	Intake 3	101	146465	1337748409	/users/cn/jespinosa/phecomp/data/CRG/20120502_FDF_CRG/20120502_FDF_CRG/20120521_FDF_CRG_c12.mtb	7673	98	WWFF	food_fat	3	146364	1337748308	1	0.139999999999999	0.00138613861386138	11720	1
4	Drink 1	Intake 1	19	146395	1337748339	/users/cn/jespinosa/phecomp/data/CRG/20120502_FDF_CRG/20120502_FDF_CRG/20120521_FDF_CRG_c12.mtb	2386	NA	WWFF	water	1	146376	1337748320	1	0.02	0.00105263157894737	11721	1
4	Food 1	Intake 3	18	146581	1337748525	/users/cn/jespinosa/phecomp/data/CRG/20120502_FDF_CRG/20120502_FDF_CRG/20120521_FDF_CRG_c12.mtb	7675	57	WWFF	food_fat	3	146563	1337748507	1	0.0800000000000001	0.00444444444444445	11722	1
4	Food 2	Intake 4	18	146656	1337748600	/users/cn/jespinosa/phecomp/data/CRG/20120502_FDF_CRG/20120502_FDF_CRG/20120521_FDF_CRG_c12.mtb	9463	481	WWFF	food_fat	4	146638	1337748582	1	0.0400000000000027	0.00222222222222237	11723	1
4	Food 1	Intake 3	630	147767	1337749711	/users/cn/jespinosa/phecomp/data/CRG/20120502_FDF_CRG/20120502_FDF_CRG/20120521_FDF_CRG_c12.mtb	7681	COLL	WWFF	food_fat	3	147137	1337749081	1	0.479999999999999	0.00076190476190476	11724	1
4	Food 2	Intake 4	97	147413	1337749357	/users/cn/jespinosa/phecomp/data/CRG/20120502_FDF_CRG/20120502_FDF_CRG/20120521_FDF_CRG_c12.mtb	9465	169	WWFF	food_fat	4	147316	1337749260	1	0.120000000000001	0.00123711340206187	11725	1
4	Food 2	Intake 4	63	147645	1337749589	/users/cn/jespinosa/phecomp/data/CRG/20120502_FDF_CRG/20120502_FDF_CRG/20120521_FDF_CRG_c12.mtb	9467	168	WWFF	food_fat	4	147582	1337749526	1	0.0599999999999987	0.000952380952380932	11726	1
4	Food 1	Intake 3	79	147892	1337749836	/users/cn/jespinosa/phecomp/data/CRG/20120502_FDF_CRG/20120502_FDF_CRG/20120521_FDF_CRG_c12.mtb	7682	468	WWFF	food_fat	3	147813	1337749757	1	0.0800000000000001	0.0010126582278481	11727	1
4	Drink 2	Intake 2	23	147913	1337749857	/users/cn/jespinosa/phecomp/data/CRG/20120502_FDF_CRG/20120502_FDF_CRG/20120521_FDF_CRG_c12.mtb	2144	NA	WWFF	water	2	147890	1337749834	1	0.0600000000000001	0.00260869565217392	11728	1
4	Drink 2	Intake 2	35	147955	1337749899	/users/cn/jespinosa/phecomp/data/CRG/20120502_FDF_CRG/20120502_FDF_CRG/20120521_FDF_CRG_c12.mtb	2145	NA	WWFF	water	2	147920	1337749864	1	0.02	0.000571428571428571	11729	1
4	Drink 1	Intake 1	19	147969	1337749913	/users/cn/jespinosa/phecomp/data/CRG/20120502_FDF_CRG/20120502_FDF_CRG/20120521_FDF_CRG_c12.mtb	2387	NA	WWFF	water	1	147950	1337749894	1	0.04	0.00210526315789474	11730	1
4	Food 1	Intake 3	242	148602	1337750546	/users/cn/jespinosa/phecomp/data/CRG/20120502_FDF_CRG/20120502_FDF_CRG/20120521_FDF_CRG_c12.mtb	7685	4	WWFF	food_fat	3	148360	1337750304	1	0.0800000000000001	0.000330578512396695	11731	1
4	Drink 2	Intake 2	19	148494	1337750438	/users/cn/jespinosa/phecomp/data/CRG/20120502_FDF_CRG/20120502_FDF_CRG/20120521_FDF_CRG_c12.mtb	2146	NA	WWFF	water	2	148475	1337750419	1	0.0600000000000001	0.00315789473684211	11732	1
4	Food 1	Intake 3	138	148744	1337750688	/users/cn/jespinosa/phecomp/data/CRG/20120502_FDF_CRG/20120502_FDF_CRG/20120521_FDF_CRG_c12.mtb	7686	7	WWFF	food_fat	3	148606	1337750550	1	0.120000000000001	0.000869565217391312	11733	1
4	Food 1	Intake 3	36	148787	1337750731	/users/cn/jespinosa/phecomp/data/CRG/20120502_FDF_CRG/20120502_FDF_CRG/20120521_FDF_CRG_c12.mtb	7687	118	WWFF	food_fat	3	148751	1337750695	1	0.0599999999999987	0.00166666666666663	11734	1
4	Food 1	Intake 3	413	149318	1337751262	/users/cn/jespinosa/phecomp/data/CRG/20120502_FDF_CRG/20120502_FDF_CRG/20120521_FDF_CRG_c12.mtb	7690	COLL	WWFF	food_fat	3	148905	1337750849	1	0.459999999999999	0.0011138014527845	11735	1
4	Drink 1	Intake 1	22	149129	1337751073	/users/cn/jespinosa/phecomp/data/CRG/20120502_FDF_CRG/20120502_FDF_CRG/20120521_FDF_CRG_c12.mtb	2388	NA	WWFF	water	1	149107	1337751051	1	0.0800000000000001	0.00363636363636364	11736	1
4	Food 2	Intake 4	12	149162	1337751106	/users/cn/jespinosa/phecomp/data/CRG/20120502_FDF_CRG/20120502_FDF_CRG/20120521_FDF_CRG_c12.mtb	9492	29	WWFF	food_fat	4	149150	1337751094	1	0.0599999999999987	0.00499999999999989	11737	1
4	Food 2	Intake 4	65	149256	1337751200	/users/cn/jespinosa/phecomp/data/CRG/20120502_FDF_CRG/20120502_FDF_CRG/20120521_FDF_CRG_c12.mtb	9494	116	WWFF	food_fat	4	149191	1337751135	1	0.0400000000000027	0.000615384615384657	11738	1
4	Food 2	Intake 4	28	149400	1337751344	/users/cn/jespinosa/phecomp/data/CRG/20120502_FDF_CRG/20120502_FDF_CRG/20120521_FDF_CRG_c12.mtb	9495	78	WWFF	food_fat	4	149372	1337751316	1	0.0399999999999991	0.0014285714285714	11739	1
4	Food 1	Intake 3	60	149538	1337751482	/users/cn/jespinosa/phecomp/data/CRG/20120502_FDF_CRG/20120502_FDF_CRG/20120521_FDF_CRG_c12.mtb	7693	280	WWFF	food_fat	3	149478	1337751422	1	0.0600000000000005	0.00100000000000001	11740	1
4	Food 1	Intake 3	16	149834	1337751778	/users/cn/jespinosa/phecomp/data/CRG/20120502_FDF_CRG/20120502_FDF_CRG/20120521_FDF_CRG_c12.mtb	7697	285	WWFF	food_fat	3	149818	1337751762	1	0.0200000000000014	0.00125000000000009	11741	1
4	Food 2	Intake 4	12	150131	1337752075	/users/cn/jespinosa/phecomp/data/CRG/20120502_FDF_CRG/20120502_FDF_CRG/20120521_FDF_CRG_c12.mtb	9503	99	WWFF	food_fat	4	150119	1337752063	1	0.0599999999999987	0.00499999999999989	11742	1
4	Food 2	Intake 4	34	150264	1337752208	/users/cn/jespinosa/phecomp/data/CRG/20120502_FDF_CRG/20120502_FDF_CRG/20120521_FDF_CRG_c12.mtb	9505	1454	WWFF	food_fat	4	150230	1337752174	1	0.0800000000000018	0.00235294117647064	11743	1
4	Food 1	Intake 3	8	151726	1337753670	/users/cn/jespinosa/phecomp/data/CRG/20120502_FDF_CRG/20120502_FDF_CRG/20120521_FDF_CRG_c12.mtb	7711	1465	WWFF	food_fat	3	151718	1337753662	1	0.0200000000000014	0.00250000000000017	11744	1
4	Food 1	Intake 3	12	153203	1337755147	/users/cn/jespinosa/phecomp/data/CRG/20120502_FDF_CRG/20120502_FDF_CRG/20120521_FDF_CRG_c12.mtb	7719	335	WWFF	food_fat	3	153191	1337755135	1	0.0200000000000014	0.00166666666666678	11745	1
4	Food 1	Intake 3	168	153706	1337755650	/users/cn/jespinosa/phecomp/data/CRG/20120502_FDF_CRG/20120502_FDF_CRG/20120521_FDF_CRG_c12.mtb	7723	COLL	WWFF	food_fat	3	153538	1337755482	1	0.119999999999999	0.000714285714285708	11746	1
4	Food 2	Intake 4	57	153607	1337755551	/users/cn/jespinosa/phecomp/data/CRG/20120502_FDF_CRG/20120502_FDF_CRG/20120521_FDF_CRG_c12.mtb	9525	131	WWFF	food_fat	4	153550	1337755494	1	0.200000000000003	0.00350877192982461	11747	1
4	Drink 2	Intake 2	15	153741	1337755685	/users/cn/jespinosa/phecomp/data/CRG/20120502_FDF_CRG/20120502_FDF_CRG/20120521_FDF_CRG_c12.mtb	2149	NA	WWFF	water	2	153726	1337755670	1	0.04	0.00266666666666667	11748	1
4	Food 1	Intake 3	123	153861	1337755805	/users/cn/jespinosa/phecomp/data/CRG/20120502_FDF_CRG/20120502_FDF_CRG/20120521_FDF_CRG_c12.mtb	7725	101	WWFF	food_fat	3	153738	1337755682	1	0.0600000000000005	0.000487804878048785	11749	1
4	Food 2	Intake 4	31	153993	1337755937	/users/cn/jespinosa/phecomp/data/CRG/20120502_FDF_CRG/20120502_FDF_CRG/20120521_FDF_CRG_c12.mtb	9528	388	WWFF	food_fat	4	153962	1337755906	1	0.0600000000000023	0.00193548387096782	11750	1
4	Drink 1	Intake 1	45	154332	1337756276	/users/cn/jespinosa/phecomp/data/CRG/20120502_FDF_CRG/20120502_FDF_CRG/20120521_FDF_CRG_c12.mtb	2389	NA	WWFF	water	1	154287	1337756231	1	0.0800000000000001	0.00177777777777778	11751	1
4	Food 1	Intake 3	51	154432	1337756376	/users/cn/jespinosa/phecomp/data/CRG/20120502_FDF_CRG/20120502_FDF_CRG/20120521_FDF_CRG_c12.mtb	7731	4767	WWFF	food_fat	3	154381	1337756325	1	0.0200000000000014	0.000392156862745125	11752	1
4	Drink 1	Intake 1	23	155659	1337757603	/users/cn/jespinosa/phecomp/data/CRG/20120502_FDF_CRG/20120502_FDF_CRG/20120521_FDF_CRG_c12.mtb	2390	NA	WWFF	water	1	155636	1337757580	1	0.0799999999999996	0.0034782608695652	11753	1
4	Drink 1	Intake 1	26	158771	1337760715	/users/cn/jespinosa/phecomp/data/CRG/20120502_FDF_CRG/20120502_FDF_CRG/20120521_FDF_CRG_c12.mtb	2391	NA	WWFF	water	1	158745	1337760689	1	0.1	0.00384615384615385	11754	1
4	Food 1	Intake 3	19	159218	1337761162	/users/cn/jespinosa/phecomp/data/CRG/20120502_FDF_CRG/20120502_FDF_CRG/20120521_FDF_CRG_c12.mtb	7753	789	WWFF	food_fat	3	159199	1337761143	1	0.0200000000000014	0.00105263157894744	11755	1
4	Drink 1	Intake 1	16	159977	1337761921	/users/cn/jespinosa/phecomp/data/CRG/20120502_FDF_CRG/20120502_FDF_CRG/20120521_FDF_CRG_c12.mtb	2392	NA	WWFF	water	1	159961	1337761905	1	0.04	0.0025	11756	1
4	Food 1	Intake 3	37	160044	1337761988	/users/cn/jespinosa/phecomp/data/CRG/20120502_FDF_CRG/20120502_FDF_CRG/20120521_FDF_CRG_c12.mtb	7760	1659	WWFF	food_fat	3	160007	1337761951	1	0.0400000000000009	0.00108108108108111	11757	1
4	Food 2	Intake 4	14	161717	1337763661	/users/cn/jespinosa/phecomp/data/CRG/20120502_FDF_CRG/20120502_FDF_CRG/20120521_FDF_CRG_c12.mtb	9549	41	WWFF	food_fat	4	161703	1337763647	1	0.0799999999999983	0.00571428571428559	11758	1
4	Food 2	Intake 4	13	161771	1337763715	/users/cn/jespinosa/phecomp/data/CRG/20120502_FDF_CRG/20120502_FDF_CRG/20120521_FDF_CRG_c12.mtb	9550	59	WWFF	food_fat	4	161758	1337763702	1	0.0200000000000031	0.00153846153846178	11759	1
4	Food 1	Intake 3	49	161879	1337763823	/users/cn/jespinosa/phecomp/data/CRG/20120502_FDF_CRG/20120502_FDF_CRG/20120521_FDF_CRG_c12.mtb	7772	239	WWFF	food_fat	3	161830	1337763774	1	0.0400000000000009	0.000816326530612263	11760	1
4	Food 1	Intake 3	624	162742	1337764686	/users/cn/jespinosa/phecomp/data/CRG/20120502_FDF_CRG/20120502_FDF_CRG/20120521_FDF_CRG_c12.mtb	7774	1070	WWFF	food_fat	3	162118	1337764062	1	0.0600000000000005	9.6153846153847e-05	11761	1
4	Drink 1	Intake 1	27	162729	1337764673	/users/cn/jespinosa/phecomp/data/CRG/20120502_FDF_CRG/20120502_FDF_CRG/20120521_FDF_CRG_c12.mtb	2393	LAST	WWFF	water	1	162702	1337764646	1	0.1	0.0037037037037037	11762	1
4	Food 1	Intake 3	22	163834	1337765778	/users/cn/jespinosa/phecomp/data/CRG/20120502_FDF_CRG/20120502_FDF_CRG/20120521_FDF_CRG_c12.mtb	7784	139	WWFF	food_fat	3	163812	1337765756	1	0.0399999999999991	0.00181818181818178	11763	1
4	Food 1	Intake 3	60	164033	1337765977	/users/cn/jespinosa/phecomp/data/CRG/20120502_FDF_CRG/20120502_FDF_CRG/20120521_FDF_CRG_c12.mtb	7785	LAST	WWFF	food_fat	3	163973	1337765917	1	0.0200000000000014	0.000333333333333357	11764	1
4	Drink 2	Intake 2	20	330	1335958338	/users/cn/jespinosa/phecomp/data/CRG/20120502_FDF_CRG/20120502_FDF_CRG/20120502_FDF_CRG_c12.mtb	144	NA	WWSS	water	2	310	1335958318	1	0.02	0.001	8641	1
4	Food 1	Intake 3	147	19487	1335977495	/users/cn/jespinosa/phecomp/data/CRG/20120502_FDF_CRG/20120502_FDF_CRG/20120502_FDF_CRG_c12.mtb	133	24	WWSS	food_sc	3	19340	1335977348	1	0.02	0.000136054421768707	8642	1
4	Food 1	Intake 3	110	19621	1335977629	/users/cn/jespinosa/phecomp/data/CRG/20120502_FDF_CRG/20120502_FDF_CRG/20120502_FDF_CRG_c12.mtb	134	12	WWSS	food_sc	3	19511	1335977519	1	0.02	0.000181818181818182	8643	1
4	Food 1	Intake 3	269	19902	1335977910	/users/cn/jespinosa/phecomp/data/CRG/20120502_FDF_CRG/20120502_FDF_CRG/20120502_FDF_CRG_c12.mtb	135	6903	WWSS	food_sc	3	19633	1335977641	1	0.08	0.000297397769516729	8644	1
4	Drink 1	Intake 1	40	20413	1335978421	/users/cn/jespinosa/phecomp/data/CRG/20120502_FDF_CRG/20120502_FDF_CRG/20120502_FDF_CRG_c12.mtb	232	NA	WWSS	water	1	20373	1335978381	1	0.04	0.001	8645	1
4	Food 1	Intake 3	393	27198	1335985206	/users/cn/jespinosa/phecomp/data/CRG/20120502_FDF_CRG/20120502_FDF_CRG/20120502_FDF_CRG_c12.mtb	149	886	WWSS	food_sc	3	26805	1335984813	1	0.1	0.000254452926208651	8646	1
4	Drink 2	Intake 2	23	27941	1335985949	/users/cn/jespinosa/phecomp/data/CRG/20120502_FDF_CRG/20120502_FDF_CRG/20120502_FDF_CRG_c12.mtb	162	NA	WWSS	water	2	27918	1335985926	1	0.02	0.000869565217391304	8647	1
4	Food 2	Intake 4	218	28302	1335986310	/users/cn/jespinosa/phecomp/data/CRG/20120502_FDF_CRG/20120502_FDF_CRG/20120502_FDF_CRG_c12.mtb	302	19	WWSS	food_sc	4	28084	1335986092	1	0.04	0.00018348623853211	8648	1
4	Food 2	Intake 4	257	28578	1335986586	/users/cn/jespinosa/phecomp/data/CRG/20120502_FDF_CRG/20120502_FDF_CRG/20120502_FDF_CRG_c12.mtb	303	604	WWSS	food_sc	4	28321	1335986329	1	0.08	0.000311284046692607	8649	1
4	Drink 2	Intake 2	46	28648	1335986656	/users/cn/jespinosa/phecomp/data/CRG/20120502_FDF_CRG/20120502_FDF_CRG/20120502_FDF_CRG_c12.mtb	166	NA	WWSS	water	2	28602	1335986610	1	0.08	0.00173913043478261	8650	1
4	Drink 2	Intake 2	24	28698	1335986706	/users/cn/jespinosa/phecomp/data/CRG/20120502_FDF_CRG/20120502_FDF_CRG/20120502_FDF_CRG_c12.mtb	167	NA	WWSS	water	2	28674	1335986682	1	0.04	0.00166666666666667	8651	1
4	Drink 2	Intake 2	15	28914	1335986922	/users/cn/jespinosa/phecomp/data/CRG/20120502_FDF_CRG/20120502_FDF_CRG/20120502_FDF_CRG_c12.mtb	171	NA	WWSS	water	2	28899	1335986907	1	0.02	0.00133333333333333	8652	1
4	Food 2	Intake 4	285	29467	1335987475	/users/cn/jespinosa/phecomp/data/CRG/20120502_FDF_CRG/20120502_FDF_CRG/20120502_FDF_CRG_c12.mtb	309	80	WWSS	food_sc	4	29182	1335987190	1	0.08	0.000280701754385965	8653	1
4	Drink 2	Intake 2	34	29529	1335987537	/users/cn/jespinosa/phecomp/data/CRG/20120502_FDF_CRG/20120502_FDF_CRG/20120502_FDF_CRG_c12.mtb	174	NA	WWSS	water	2	29495	1335987503	1	0.06	0.00176470588235294	8654	1
4	Food 2	Intake 4	147	29694	1335987702	/users/cn/jespinosa/phecomp/data/CRG/20120502_FDF_CRG/20120502_FDF_CRG/20120502_FDF_CRG_c12.mtb	310	1036	WWSS	food_sc	4	29547	1335987555	1	0.06	0.000408163265306122	8655	1
4	Drink 2	Intake 2	27	29724	1335987732	/users/cn/jespinosa/phecomp/data/CRG/20120502_FDF_CRG/20120502_FDF_CRG/20120502_FDF_CRG_c12.mtb	175	NA	WWSS	water	2	29697	1335987705	1	0.1	0.0037037037037037	8656	1
4	Food 2	Intake 4	164	30894	1335988902	/users/cn/jespinosa/phecomp/data/CRG/20120502_FDF_CRG/20120502_FDF_CRG/20120502_FDF_CRG_c12.mtb	321	415	WWSS	food_sc	4	30730	1335988738	1	0.06	0.000365853658536585	8657	1
4	Drink 1	Intake 1	17	30919	1335988927	/users/cn/jespinosa/phecomp/data/CRG/20120502_FDF_CRG/20120502_FDF_CRG/20120502_FDF_CRG_c12.mtb	236	NA	WWSS	water	1	30902	1335988910	1	0.02	0.00117647058823529	8658	1
4	Food 2	Intake 4	273	31582	1335989590	/users/cn/jespinosa/phecomp/data/CRG/20120502_FDF_CRG/20120502_FDF_CRG/20120502_FDF_CRG_c12.mtb	324	1132	WWSS	food_sc	4	31309	1335989317	1	0.1	0.000366300366300366	8659	1
4	Drink 2	Intake 2	42	31627	1335989635	/users/cn/jespinosa/phecomp/data/CRG/20120502_FDF_CRG/20120502_FDF_CRG/20120502_FDF_CRG_c12.mtb	185	NA	WWSS	water	2	31585	1335989593	1	0.06	0.00142857142857143	8660	1
4	Drink 1	Intake 1	17	32181	1335990189	/users/cn/jespinosa/phecomp/data/CRG/20120502_FDF_CRG/20120502_FDF_CRG/20120502_FDF_CRG_c12.mtb	238	NA	WWSS	water	1	32164	1335990172	1	0.02	0.00117647058823529	8661	1
4	Drink 2	Intake 2	22	32310	1335990318	/users/cn/jespinosa/phecomp/data/CRG/20120502_FDF_CRG/20120502_FDF_CRG/20120502_FDF_CRG_c12.mtb	188	NA	WWSS	water	2	32288	1335990296	1	0.02	0.000909090909090909	8662	1
4	Food 2	Intake 4	32	32746	1335990754	/users/cn/jespinosa/phecomp/data/CRG/20120502_FDF_CRG/20120502_FDF_CRG/20120502_FDF_CRG_c12.mtb	337	548	WWSS	food_sc	4	32714	1335990722	1	0.02	0.000625	8663	1
4	Food 1	Intake 3	149	33443	1335991451	/users/cn/jespinosa/phecomp/data/CRG/20120502_FDF_CRG/20120502_FDF_CRG/20120502_FDF_CRG_c12.mtb	185	3	WWSS	food_sc	3	33294	1335991302	1	0.02	0.000134228187919463	8664	1
4	Food 2	Intake 4	230	33676	1335991684	/users/cn/jespinosa/phecomp/data/CRG/20120502_FDF_CRG/20120502_FDF_CRG/20120502_FDF_CRG_c12.mtb	345	38	WWSS	food_sc	4	33446	1335991454	1	0.04	0.000173913043478261	8665	1
4	Drink 1	Intake 1	20	33707	1335991715	/users/cn/jespinosa/phecomp/data/CRG/20120502_FDF_CRG/20120502_FDF_CRG/20120502_FDF_CRG_c12.mtb	242	NA	WWSS	water	1	33687	1335991695	1	0.04	0.002	8666	1
4	Food 1	Intake 3	126	33840	1335991848	/users/cn/jespinosa/phecomp/data/CRG/20120502_FDF_CRG/20120502_FDF_CRG/20120502_FDF_CRG_c12.mtb	186	28	WWSS	food_sc	3	33714	1335991722	1	0.08	0.000634920634920635	8667	1
4	Food 1	Intake 3	59	33927	1335991935	/users/cn/jespinosa/phecomp/data/CRG/20120502_FDF_CRG/20120502_FDF_CRG/20120502_FDF_CRG_c12.mtb	187	7	WWSS	food_sc	3	33868	1335991876	1	0.04	0.000677966101694915	8668	1
4	Food 1	Intake 3	208	34142	1335992150	/users/cn/jespinosa/phecomp/data/CRG/20120502_FDF_CRG/20120502_FDF_CRG/20120502_FDF_CRG_c12.mtb	188	1493	WWSS	food_sc	3	33934	1335991942	1	0.08	0.000384615384615385	8669	1
4	Drink 2	Intake 2	45	34186	1335992194	/users/cn/jespinosa/phecomp/data/CRG/20120502_FDF_CRG/20120502_FDF_CRG/20120502_FDF_CRG_c12.mtb	196	NA	WWSS	water	2	34141	1335992149	1	0.14	0.00311111111111111	8670	1
4	Drink 1	Intake 1	18	34238	1335992246	/users/cn/jespinosa/phecomp/data/CRG/20120502_FDF_CRG/20120502_FDF_CRG/20120502_FDF_CRG_c12.mtb	243	NA	WWSS	water	1	34220	1335992228	1	0.04	0.00222222222222222	8671	1
4	Food 1	Intake 3	218	35853	1335993861	/users/cn/jespinosa/phecomp/data/CRG/20120502_FDF_CRG/20120502_FDF_CRG/20120502_FDF_CRG_c12.mtb	196	515	WWSS	food_sc	3	35635	1335993643	1	0.1	0.000458715596330275	8672	1
4	Drink 2	Intake 2	43	35925	1335993933	/users/cn/jespinosa/phecomp/data/CRG/20120502_FDF_CRG/20120502_FDF_CRG/20120502_FDF_CRG_c12.mtb	210	NA	WWSS	water	2	35882	1335993890	1	0.1	0.00232558139534884	8673	1
4	Drink 1	Intake 1	16	36202	1335994210	/users/cn/jespinosa/phecomp/data/CRG/20120502_FDF_CRG/20120502_FDF_CRG/20120502_FDF_CRG_c12.mtb	250	NA	WWSS	water	1	36186	1335994194	1	0.02	0.00125	8674	1
4	Food 1	Intake 3	178	36546	1335994554	/users/cn/jespinosa/phecomp/data/CRG/20120502_FDF_CRG/20120502_FDF_CRG/20120502_FDF_CRG_c12.mtb	202	255	WWSS	food_sc	3	36368	1335994376	1	0.02	0.000112359550561798	8675	1
4	Drink 1	Intake 1	19	36637	1335994645	/users/cn/jespinosa/phecomp/data/CRG/20120502_FDF_CRG/20120502_FDF_CRG/20120502_FDF_CRG_c12.mtb	251	NA	WWSS	water	1	36618	1335994626	1	0.06	0.00315789473684211	8676	1
4	Food 2	Intake 4	214	37015	1335995023	/users/cn/jespinosa/phecomp/data/CRG/20120502_FDF_CRG/20120502_FDF_CRG/20120502_FDF_CRG_c12.mtb	361	804	WWSS	food_sc	4	36801	1335994809	1	0.04	0.000186915887850467	8677	1
4	Drink 2	Intake 2	24	37035	1335995043	/users/cn/jespinosa/phecomp/data/CRG/20120502_FDF_CRG/20120502_FDF_CRG/20120502_FDF_CRG_c12.mtb	216	NA	WWSS	water	2	37011	1335995019	1	0.04	0.00166666666666667	8678	1
4	Drink 1	Intake 1	16	37402	1335995410	/users/cn/jespinosa/phecomp/data/CRG/20120502_FDF_CRG/20120502_FDF_CRG/20120502_FDF_CRG_c12.mtb	252	NA	WWSS	water	1	37386	1335995394	1	0.02	0.00125	8679	1
4	Food 1	Intake 3	199	38018	1335996026	/users/cn/jespinosa/phecomp/data/CRG/20120502_FDF_CRG/20120502_FDF_CRG/20120502_FDF_CRG_c12.mtb	209	7	WWSS	food_sc	3	37819	1335995827	1	0.0600000000000001	0.000301507537688443	8680	1
4	Food 1	Intake 3	305	38330	1335996338	/users/cn/jespinosa/phecomp/data/CRG/20120502_FDF_CRG/20120502_FDF_CRG/20120502_FDF_CRG_c12.mtb	210	55	WWSS	food_sc	3	38025	1335996033	1	0.1	0.000327868852459016	8681	1
4	Drink 2	Intake 2	31	38355	1335996363	/users/cn/jespinosa/phecomp/data/CRG/20120502_FDF_CRG/20120502_FDF_CRG/20120502_FDF_CRG_c12.mtb	222	NA	WWSS	water	2	38324	1335996332	1	0.12	0.00387096774193548	8682	1
4	Drink 2	Intake 2	28	38390	1335996398	/users/cn/jespinosa/phecomp/data/CRG/20120502_FDF_CRG/20120502_FDF_CRG/20120502_FDF_CRG_c12.mtb	223	NA	WWSS	water	2	38362	1335996370	1	0.02	0.000714285714285714	8683	1
4	Food 1	Intake 3	109	38494	1335996502	/users/cn/jespinosa/phecomp/data/CRG/20120502_FDF_CRG/20120502_FDF_CRG/20120502_FDF_CRG_c12.mtb	211	712	WWSS	food_sc	3	38385	1335996393	1	0.02	0.00018348623853211	8684	1
4	Drink 1	Intake 1	26	38517	1335996525	/users/cn/jespinosa/phecomp/data/CRG/20120502_FDF_CRG/20120502_FDF_CRG/20120502_FDF_CRG_c12.mtb	253	NA	WWSS	water	1	38491	1335996499	1	0.06	0.00230769230769231	8685	1
4	Drink 1	Intake 1	18	38733	1335996741	/users/cn/jespinosa/phecomp/data/CRG/20120502_FDF_CRG/20120502_FDF_CRG/20120502_FDF_CRG_c12.mtb	254	NA	WWSS	water	1	38715	1335996723	1	0.02	0.00111111111111111	8686	1
4	Food 1	Intake 3	95	39301	1335997309	/users/cn/jespinosa/phecomp/data/CRG/20120502_FDF_CRG/20120502_FDF_CRG/20120502_FDF_CRG_c12.mtb	216	58	WWSS	food_sc	3	39206	1335997214	1	0.02	0.000210526315789474	8687	1
4	Drink 1	Intake 1	21	39334	1335997342	/users/cn/jespinosa/phecomp/data/CRG/20120502_FDF_CRG/20120502_FDF_CRG/20120502_FDF_CRG_c12.mtb	256	NA	WWSS	water	1	39313	1335997321	1	0.06	0.00285714285714286	8688	1
4	Food 2	Intake 4	430	39789	1335997797	/users/cn/jespinosa/phecomp/data/CRG/20120502_FDF_CRG/20120502_FDF_CRG/20120502_FDF_CRG_c12.mtb	373	666	WWSS	food_sc	4	39359	1335997367	1	0.12	0.00027906976744186	8689	1
4	Drink 2	Intake 2	30	39816	1335997824	/users/cn/jespinosa/phecomp/data/CRG/20120502_FDF_CRG/20120502_FDF_CRG/20120502_FDF_CRG_c12.mtb	231	NA	WWSS	water	2	39786	1335997794	1	0.08	0.00266666666666667	8690	1
4	Food 2	Intake 4	621	41076	1335999084	/users/cn/jespinosa/phecomp/data/CRG/20120502_FDF_CRG/20120502_FDF_CRG/20120502_FDF_CRG_c12.mtb	376	818	WWSS	food_sc	4	40455	1335998463	1	0.24	0.000386473429951691	8691	1
4	Drink 2	Intake 2	52	41130	1335999138	/users/cn/jespinosa/phecomp/data/CRG/20120502_FDF_CRG/20120502_FDF_CRG/20120502_FDF_CRG_c12.mtb	236	NA	WWSS	water	2	41078	1335999086	1	0.12	0.00230769230769231	8692	1
4	Drink 1	Intake 1	19	41237	1335999245	/users/cn/jespinosa/phecomp/data/CRG/20120502_FDF_CRG/20120502_FDF_CRG/20120502_FDF_CRG_c12.mtb	258	NA	WWSS	water	1	41218	1335999226	1	0.02	0.00105263157894737	8693	1
4	Drink 2	Intake 2	49	41697	1335999705	/users/cn/jespinosa/phecomp/data/CRG/20120502_FDF_CRG/20120502_FDF_CRG/20120502_FDF_CRG_c12.mtb	240	NA	WWSS	water	2	41648	1335999656	1	0.0999999999999999	0.00204081632653061	8694	1
4	Food 2	Intake 4	413	42307	1336000315	/users/cn/jespinosa/phecomp/data/CRG/20120502_FDF_CRG/20120502_FDF_CRG/20120502_FDF_CRG_c12.mtb	380	7634	WWSS	food_sc	4	41894	1335999902	1	0.12	0.000290556900726392	8695	1
4	Drink 2	Intake 2	21	42327	1336000335	/users/cn/jespinosa/phecomp/data/CRG/20120502_FDF_CRG/20120502_FDF_CRG/20120502_FDF_CRG_c12.mtb	242	NA	WWSS	water	2	42306	1336000314	1	0.04	0.0019047619047619	8696	1
4	Drink 1	Intake 1	21	42378	1336000386	/users/cn/jespinosa/phecomp/data/CRG/20120502_FDF_CRG/20120502_FDF_CRG/20120502_FDF_CRG_c12.mtb	262	NA	WWSS	water	1	42357	1336000365	1	0.08	0.00380952380952381	8697	1
4	Drink 2	Intake 2	41	49869	1336007877	/users/cn/jespinosa/phecomp/data/CRG/20120502_FDF_CRG/20120502_FDF_CRG/20120502_FDF_CRG_c12.mtb	250	NA	WWSS	water	2	49828	1336007836	1	0.04	0.000975609756097561	8698	1
4	Food 1	Intake 3	29	49970	1336007978	/users/cn/jespinosa/phecomp/data/CRG/20120502_FDF_CRG/20120502_FDF_CRG/20120502_FDF_CRG_c12.mtb	244	68	WWSS	food_sc	3	49941	1336007949	1	0.02	0.000689655172413793	8699	1
4	Food 2	Intake 4	65	50103	1336008111	/users/cn/jespinosa/phecomp/data/CRG/20120502_FDF_CRG/20120502_FDF_CRG/20120502_FDF_CRG_c12.mtb	388	172	WWSS	food_sc	4	50038	1336008046	1	0.02	0.000307692307692308	8700	1
4	Food 2	Intake 4	248	50523	1336008531	/users/cn/jespinosa/phecomp/data/CRG/20120502_FDF_CRG/20120502_FDF_CRG/20120502_FDF_CRG_c12.mtb	390	696	WWSS	food_sc	4	50275	1336008283	1	0.0600000000000001	0.000241935483870968	8701	1
4	Drink 2	Intake 2	51	50574	1336008582	/users/cn/jespinosa/phecomp/data/CRG/20120502_FDF_CRG/20120502_FDF_CRG/20120502_FDF_CRG_c12.mtb	254	NA	WWSS	water	2	50523	1336008531	1	0.0999999999999999	0.00196078431372549	8702	1
4	Drink 2	Intake 2	80	50865	1336008873	/users/cn/jespinosa/phecomp/data/CRG/20120502_FDF_CRG/20120502_FDF_CRG/20120502_FDF_CRG_c12.mtb	257	NA	WWSS	water	2	50785	1336008793	1	0.02	0.00025	8703	1
4	Drink 2	Intake 2	39	51188	1336009196	/users/cn/jespinosa/phecomp/data/CRG/20120502_FDF_CRG/20120502_FDF_CRG/20120502_FDF_CRG_c12.mtb	259	NA	WWSS	water	2	51149	1336009157	1	0.02	0.000512820512820513	8704	1
4	Food 2	Intake 4	219	51438	1336009446	/users/cn/jespinosa/phecomp/data/CRG/20120502_FDF_CRG/20120502_FDF_CRG/20120502_FDF_CRG_c12.mtb	396	62	WWSS	food_sc	4	51219	1336009227	1	0.04	0.000182648401826484	8705	1
4	Food 2	Intake 4	215	51715	1336009723	/users/cn/jespinosa/phecomp/data/CRG/20120502_FDF_CRG/20120502_FDF_CRG/20120502_FDF_CRG_c12.mtb	397	14	WWSS	food_sc	4	51500	1336009508	1	0.0399999999999998	0.000186046511627906	8706	1
4	Food 2	Intake 4	113	51842	1336009850	/users/cn/jespinosa/phecomp/data/CRG/20120502_FDF_CRG/20120502_FDF_CRG/20120502_FDF_CRG_c12.mtb	398	23	WWSS	food_sc	4	51729	1336009737	1	0.02	0.000176991150442478	8707	1
4	Food 2	Intake 4	400	52265	1336010273	/users/cn/jespinosa/phecomp/data/CRG/20120502_FDF_CRG/20120502_FDF_CRG/20120502_FDF_CRG_c12.mtb	399	9385	WWSS	food_sc	4	51865	1336009873	1	0.14	0.00035	8708	1
4	Drink 2	Intake 2	60	52319	1336010327	/users/cn/jespinosa/phecomp/data/CRG/20120502_FDF_CRG/20120502_FDF_CRG/20120502_FDF_CRG_c12.mtb	262	NA	WWSS	water	2	52259	1336010267	1	0.22	0.00366666666666667	8709	1
4	Drink 1	Intake 1	21	53131	1336011139	/users/cn/jespinosa/phecomp/data/CRG/20120502_FDF_CRG/20120502_FDF_CRG/20120502_FDF_CRG_c12.mtb	266	NA	WWSS	water	1	53110	1336011118	1	0.04	0.0019047619047619	8710	1
4	Food 1	Intake 3	277	61927	1336019935	/users/cn/jespinosa/phecomp/data/CRG/20120502_FDF_CRG/20120502_FDF_CRG/20120502_FDF_CRG_c12.mtb	269	41	WWSS	food_sc	3	61650	1336019658	1	0.0399999999999999	0.000144404332129964	8711	1
4	Food 1	Intake 3	182	62150	1336020158	/users/cn/jespinosa/phecomp/data/CRG/20120502_FDF_CRG/20120502_FDF_CRG/20120502_FDF_CRG_c12.mtb	270	5733	WWSS	food_sc	3	61968	1336019976	1	0.02	0.00010989010989011	8712	1
4	Drink 2	Intake 2	31	63059	1336021067	/users/cn/jespinosa/phecomp/data/CRG/20120502_FDF_CRG/20120502_FDF_CRG/20120502_FDF_CRG_c12.mtb	290	NA	WWSS	water	2	63028	1336021036	1	0.12	0.00387096774193548	8713	1
4	Drink 2	Intake 2	23	65081	1336023089	/users/cn/jespinosa/phecomp/data/CRG/20120502_FDF_CRG/20120502_FDF_CRG/20120502_FDF_CRG_c12.mtb	291	NA	WWSS	water	2	65058	1336023066	1	0.02	0.000869565217391304	8714	1
4	Food 2	Intake 4	352	68235	1336026243	/users/cn/jespinosa/phecomp/data/CRG/20120502_FDF_CRG/20120502_FDF_CRG/20120502_FDF_CRG_c12.mtb	424	13	WWSS	food_sc	4	67883	1336025891	1	0.0599999999999998	0.000170454545454545	8715	1
4	Food 2	Intake 4	574	68822	1336026830	/users/cn/jespinosa/phecomp/data/CRG/20120502_FDF_CRG/20120502_FDF_CRG/20120502_FDF_CRG_c12.mtb	425	507	WWSS	food_sc	4	68248	1336026256	1	0.14	0.00024390243902439	8716	1
4	Drink 2	Intake 2	44	68888	1336026896	/users/cn/jespinosa/phecomp/data/CRG/20120502_FDF_CRG/20120502_FDF_CRG/20120502_FDF_CRG_c12.mtb	295	NA	WWSS	water	2	68844	1336026852	1	0.12	0.00272727272727273	8717	1
4	Drink 2	Intake 2	20	69031	1336027039	/users/cn/jespinosa/phecomp/data/CRG/20120502_FDF_CRG/20120502_FDF_CRG/20120502_FDF_CRG_c12.mtb	296	NA	WWSS	water	2	69011	1336027019	1	0.04	0.002	8718	1
4	Drink 1	Intake 1	33	69203	1336027211	/users/cn/jespinosa/phecomp/data/CRG/20120502_FDF_CRG/20120502_FDF_CRG/20120502_FDF_CRG_c12.mtb	271	NA	WWSS	water	1	69170	1336027178	1	0.02	0.000606060606060606	8719	1
4	Drink 2	Intake 2	11	69281	1336027289	/users/cn/jespinosa/phecomp/data/CRG/20120502_FDF_CRG/20120502_FDF_CRG/20120502_FDF_CRG_c12.mtb	301	NA	WWSS	water	2	69270	1336027278	1	0.02	0.00181818181818182	8720	1
4	Drink 1	Intake 1	15	69293	1336027301	/users/cn/jespinosa/phecomp/data/CRG/20120502_FDF_CRG/20120502_FDF_CRG/20120502_FDF_CRG_c12.mtb	273	NA	WWSS	water	1	69278	1336027286	1	0.0399999999999999	0.00266666666666666	8721	1
4	Food 2	Intake 4	197	69526	1336027534	/users/cn/jespinosa/phecomp/data/CRG/20120502_FDF_CRG/20120502_FDF_CRG/20120502_FDF_CRG_c12.mtb	428	30	WWSS	food_sc	4	69329	1336027337	1	0.02	0.000101522842639594	8722	1
4	Food 2	Intake 4	443	69999	1336028007	/users/cn/jespinosa/phecomp/data/CRG/20120502_FDF_CRG/20120502_FDF_CRG/20120502_FDF_CRG_c12.mtb	429	5577	WWSS	food_sc	4	69556	1336027564	1	0.0600000000000001	0.000135440180586908	8723	1
4	Drink 2	Intake 2	25	70017	1336028025	/users/cn/jespinosa/phecomp/data/CRG/20120502_FDF_CRG/20120502_FDF_CRG/20120502_FDF_CRG_c12.mtb	303	NA	WWSS	water	2	69992	1336028000	1	0.12	0.0048	8724	1
4	Food 1	Intake 3	16	75592	1336033600	/users/cn/jespinosa/phecomp/data/CRG/20120502_FDF_CRG/20120502_FDF_CRG/20120502_FDF_CRG_c12.mtb	285	175	WWSS	food_sc	3	75576	1336033584	1	0.02	0.00125	8725	1
4	Food 2	Intake 4	19	75786	1336033794	/users/cn/jespinosa/phecomp/data/CRG/20120502_FDF_CRG/20120502_FDF_CRG/20120502_FDF_CRG_c12.mtb	436	35266	WWSS	food_sc	4	75767	1336033775	1	0.02	0.00105263157894737	8726	1
4	Drink 2	Intake 2	19	105767	1336063775	/users/cn/jespinosa/phecomp/data/CRG/20120502_FDF_CRG/20120502_FDF_CRG/20120502_FDF_CRG_c12.mtb	313	NA	WWSS	water	2	105748	1336063756	1	0.02	0.00105263157894737	8727	1
4	Food 2	Intake 4	461	111513	1336069521	/users/cn/jespinosa/phecomp/data/CRG/20120502_FDF_CRG/20120502_FDF_CRG/20120502_FDF_CRG_c12.mtb	460	60	WWSS	food_sc	4	111052	1336069060	1	0.0600000000000001	0.000130151843817788	8728	1
4	Food 2	Intake 4	340	111913	1336069921	/users/cn/jespinosa/phecomp/data/CRG/20120502_FDF_CRG/20120502_FDF_CRG/20120502_FDF_CRG_c12.mtb	461	78	WWSS	food_sc	4	111573	1336069581	1	0.0399999999999998	0.000117647058823529	8729	1
4	Food 2	Intake 4	680	112671	1336070679	/users/cn/jespinosa/phecomp/data/CRG/20120502_FDF_CRG/20120502_FDF_CRG/20120502_FDF_CRG_c12.mtb	462	475	WWSS	food_sc	4	111991	1336069999	1	0.12	0.000176470588235294	8730	1
4	Drink 2	Intake 2	44	112707	1336070715	/users/cn/jespinosa/phecomp/data/CRG/20120502_FDF_CRG/20120502_FDF_CRG/20120502_FDF_CRG_c12.mtb	320	NA	WWSS	water	2	112663	1336070671	1	0.12	0.00272727272727273	8731	1
4	Food 2	Intake 4	85	113231	1336071239	/users/cn/jespinosa/phecomp/data/CRG/20120502_FDF_CRG/20120502_FDF_CRG/20120502_FDF_CRG_c12.mtb	465	297	WWSS	food_sc	4	113146	1336071154	1	0.02	0.000235294117647059	8732	1
4	Food 2	Intake 4	227	113755	1336071763	/users/cn/jespinosa/phecomp/data/CRG/20120502_FDF_CRG/20120502_FDF_CRG/20120502_FDF_CRG_c12.mtb	466	49	WWSS	food_sc	4	113528	1336071536	1	0.02	8.81057268722467e-05	8733	1
4	Drink 2	Intake 2	24	113794	1336071802	/users/cn/jespinosa/phecomp/data/CRG/20120502_FDF_CRG/20120502_FDF_CRG/20120502_FDF_CRG_c12.mtb	327	NA	WWSS	water	2	113770	1336071778	1	0.04	0.00166666666666667	8734	1
4	Food 2	Intake 4	601	114405	1336072413	/users/cn/jespinosa/phecomp/data/CRG/20120502_FDF_CRG/20120502_FDF_CRG/20120502_FDF_CRG_c12.mtb	468	114	WWSS	food_sc	4	113804	1336071812	1	0.0800000000000001	0.000133111480865225	8735	1
4	Drink 2	Intake 2	26	114424	1336072432	/users/cn/jespinosa/phecomp/data/CRG/20120502_FDF_CRG/20120502_FDF_CRG/20120502_FDF_CRG_c12.mtb	328	NA	WWSS	water	2	114398	1336072406	1	0.0599999999999996	0.00230769230769229	8736	1
4	Food 2	Intake 4	18	114537	1336072545	/users/cn/jespinosa/phecomp/data/CRG/20120502_FDF_CRG/20120502_FDF_CRG/20120502_FDF_CRG_c12.mtb	469	62	WWSS	food_sc	4	114519	1336072527	1	0.02	0.00111111111111111	8737	1
4	Food 2	Intake 4	385	114984	1336072992	/users/cn/jespinosa/phecomp/data/CRG/20120502_FDF_CRG/20120502_FDF_CRG/20120502_FDF_CRG_c12.mtb	470	2038	WWSS	food_sc	4	114599	1336072607	1	0.04	0.000103896103896104	8738	1
4	Drink 2	Intake 2	20	115003	1336073011	/users/cn/jespinosa/phecomp/data/CRG/20120502_FDF_CRG/20120502_FDF_CRG/20120502_FDF_CRG_c12.mtb	331	NA	WWSS	water	2	114983	1336072991	1	0.0800000000000001	0.00400000000000001	8739	1
4	Food 2	Intake 4	797	117819	1336075827	/users/cn/jespinosa/phecomp/data/CRG/20120502_FDF_CRG/20120502_FDF_CRG/20120502_FDF_CRG_c12.mtb	473	816	WWSS	food_sc	4	117022	1336075030	1	0.16	0.000200752823086575	8740	1
4	Drink 2	Intake 2	31	117856	1336075864	/users/cn/jespinosa/phecomp/data/CRG/20120502_FDF_CRG/20120502_FDF_CRG/20120502_FDF_CRG_c12.mtb	335	NA	WWSS	water	2	117825	1336075833	1	0.12	0.00387096774193548	8741	1
4	Food 2	Intake 4	285	118920	1336076928	/users/cn/jespinosa/phecomp/data/CRG/20120502_FDF_CRG/20120502_FDF_CRG/20120502_FDF_CRG_c12.mtb	481	38	WWSS	food_sc	4	118635	1336076643	1	0.0600000000000001	0.000210526315789474	8742	1
4	Drink 2	Intake 2	39	118963	1336076971	/users/cn/jespinosa/phecomp/data/CRG/20120502_FDF_CRG/20120502_FDF_CRG/20120502_FDF_CRG_c12.mtb	343	NA	WWSS	water	2	118924	1336076932	1	0.12	0.00307692307692308	8743	1
4	Food 2	Intake 4	575	119533	1336077541	/users/cn/jespinosa/phecomp/data/CRG/20120502_FDF_CRG/20120502_FDF_CRG/20120502_FDF_CRG_c12.mtb	482	66	WWSS	food_sc	4	118958	1336076966	1	0.14	0.000243478260869565	8744	1
4	Drink 1	Intake 1	28	119580	1336077588	/users/cn/jespinosa/phecomp/data/CRG/20120502_FDF_CRG/20120502_FDF_CRG/20120502_FDF_CRG_c12.mtb	283	NA	WWSS	water	1	119552	1336077560	1	0.14	0.005	8745	1
4	Food 2	Intake 4	63	119662	1336077670	/users/cn/jespinosa/phecomp/data/CRG/20120502_FDF_CRG/20120502_FDF_CRG/20120502_FDF_CRG_c12.mtb	483	540	WWSS	food_sc	4	119599	1336077607	1	0.02	0.000317460317460317	8746	1
4	Food 2	Intake 4	47	120249	1336078257	/users/cn/jespinosa/phecomp/data/CRG/20120502_FDF_CRG/20120502_FDF_CRG/20120502_FDF_CRG_c12.mtb	487	91	WWSS	food_sc	4	120202	1336078210	1	0.02	0.000425531914893617	8747	1
4	Food 2	Intake 4	86	120426	1336078434	/users/cn/jespinosa/phecomp/data/CRG/20120502_FDF_CRG/20120502_FDF_CRG/20120502_FDF_CRG_c12.mtb	489	870	WWSS	food_sc	4	120340	1336078348	1	0.02	0.000232558139534884	8748	1
4	Drink 1	Intake 1	19	120438	1336078446	/users/cn/jespinosa/phecomp/data/CRG/20120502_FDF_CRG/20120502_FDF_CRG/20120502_FDF_CRG_c12.mtb	285	NA	WWSS	water	1	120419	1336078427	1	0.04	0.00210526315789474	8749	1
4	Drink 1	Intake 1	18	120793	1336078801	/users/cn/jespinosa/phecomp/data/CRG/20120502_FDF_CRG/20120502_FDF_CRG/20120502_FDF_CRG_c12.mtb	287	NA	WWSS	water	1	120775	1336078783	1	0.02	0.00111111111111111	8750	1
4	Food 2	Intake 4	58	121354	1336079362	/users/cn/jespinosa/phecomp/data/CRG/20120502_FDF_CRG/20120502_FDF_CRG/20120502_FDF_CRG_c12.mtb	496	823	WWSS	food_sc	4	121296	1336079304	1	0.02	0.000344827586206897	8751	1
4	Food 1	Intake 3	212	122389	1336080397	/users/cn/jespinosa/phecomp/data/CRG/20120502_FDF_CRG/20120502_FDF_CRG/20120502_FDF_CRG_c12.mtb	333	34	WWSS	food_sc	3	122177	1336080185	1	0.04	0.000188679245283019	8752	1
4	Food 1	Intake 3	273	122696	1336080704	/users/cn/jespinosa/phecomp/data/CRG/20120502_FDF_CRG/20120502_FDF_CRG/20120502_FDF_CRG_c12.mtb	334	14	WWSS	food_sc	3	122423	1336080431	1	0.0599999999999999	0.000219780219780219	8753	1
4	Drink 2	Intake 2	24	122716	1336080724	/users/cn/jespinosa/phecomp/data/CRG/20120502_FDF_CRG/20120502_FDF_CRG/20120502_FDF_CRG_c12.mtb	355	NA	WWSS	water	2	122692	1336080700	1	0.0600000000000001	0.0025	8754	1
4	Food 1	Intake 3	300	123010	1336081018	/users/cn/jespinosa/phecomp/data/CRG/20120502_FDF_CRG/20120502_FDF_CRG/20120502_FDF_CRG_c12.mtb	335	55	WWSS	food_sc	3	122710	1336080718	1	0.0600000000000001	0.0002	8755	1
4	Drink 1	Intake 1	29	123057	1336081065	/users/cn/jespinosa/phecomp/data/CRG/20120502_FDF_CRG/20120502_FDF_CRG/20120502_FDF_CRG_c12.mtb	290	NA	WWSS	water	1	123028	1336081036	1	0.08	0.00275862068965517	8756	1
4	Food 1	Intake 3	180	123245	1336081253	/users/cn/jespinosa/phecomp/data/CRG/20120502_FDF_CRG/20120502_FDF_CRG/20120502_FDF_CRG_c12.mtb	336	245	WWSS	food_sc	3	123065	1336081073	1	0.02	0.000111111111111111	8757	1
4	Drink 2	Intake 2	17	123402	1336081410	/users/cn/jespinosa/phecomp/data/CRG/20120502_FDF_CRG/20120502_FDF_CRG/20120502_FDF_CRG_c12.mtb	356	NA	WWSS	water	2	123385	1336081393	1	0.02	0.00117647058823529	8758	1
4	Food 1	Intake 3	324	123814	1336081822	/users/cn/jespinosa/phecomp/data/CRG/20120502_FDF_CRG/20120502_FDF_CRG/20120502_FDF_CRG_c12.mtb	339	57	WWSS	food_sc	3	123490	1336081498	1	0.04	0.000123456790123457	8759	1
4	Drink 1	Intake 1	20	123826	1336081834	/users/cn/jespinosa/phecomp/data/CRG/20120502_FDF_CRG/20120502_FDF_CRG/20120502_FDF_CRG_c12.mtb	293	NA	WWSS	water	1	123806	1336081814	1	0.0599999999999999	0.00299999999999999	8760	1
4	Food 1	Intake 3	427	124298	1336082306	/users/cn/jespinosa/phecomp/data/CRG/20120502_FDF_CRG/20120502_FDF_CRG/20120502_FDF_CRG_c12.mtb	340	212	WWSS	food_sc	3	123871	1336081879	1	0.0799999999999998	0.00018735362997658	8761	1
4	Drink 1	Intake 1	23	124312	1336082320	/users/cn/jespinosa/phecomp/data/CRG/20120502_FDF_CRG/20120502_FDF_CRG/20120502_FDF_CRG_c12.mtb	294	NA	WWSS	water	1	124289	1336082297	1	0.0800000000000001	0.00347826086956522	8762	1
4	Food 1	Intake 3	81	124591	1336082599	/users/cn/jespinosa/phecomp/data/CRG/20120502_FDF_CRG/20120502_FDF_CRG/20120502_FDF_CRG_c12.mtb	342	483	WWSS	food_sc	3	124510	1336082518	1	0.02	0.000246913580246914	8763	1
4	Food 1	Intake 3	301	125375	1336083383	/users/cn/jespinosa/phecomp/data/CRG/20120502_FDF_CRG/20120502_FDF_CRG/20120502_FDF_CRG_c12.mtb	346	960	WWSS	food_sc	3	125074	1336083082	1	0.0600000000000001	0.000199335548172758	8764	1
4	Drink 2	Intake 2	28	125394	1336083402	/users/cn/jespinosa/phecomp/data/CRG/20120502_FDF_CRG/20120502_FDF_CRG/20120502_FDF_CRG_c12.mtb	364	NA	WWSS	water	2	125366	1336083374	1	0.0599999999999996	0.00214285714285713	8765	1
4	Drink 1	Intake 1	15	126079	1336084087	/users/cn/jespinosa/phecomp/data/CRG/20120502_FDF_CRG/20120502_FDF_CRG/20120502_FDF_CRG_c12.mtb	297	NA	WWSS	water	1	126064	1336084072	1	0.02	0.00133333333333333	8766	1
4	Drink 2	Intake 2	17	126287	1336084295	/users/cn/jespinosa/phecomp/data/CRG/20120502_FDF_CRG/20120502_FDF_CRG/20120502_FDF_CRG_c12.mtb	368	NA	WWSS	water	2	126270	1336084278	1	0.0200000000000005	0.00117647058823532	8767	1
4	Food 1	Intake 3	1106	127441	1336085449	/users/cn/jespinosa/phecomp/data/CRG/20120502_FDF_CRG/20120502_FDF_CRG/20120502_FDF_CRG_c12.mtb	355	498	WWSS	food_sc	3	126335	1336084343	1	0.28	0.000253164556962025	8768	1
4	Drink 1	Intake 1	58	127492	1336085500	/users/cn/jespinosa/phecomp/data/CRG/20120502_FDF_CRG/20120502_FDF_CRG/20120502_FDF_CRG_c12.mtb	299	NA	WWSS	water	1	127434	1336085442	1	0.14	0.00241379310344828	8769	1
4	Drink 1	Intake 1	24	127680	1336085688	/users/cn/jespinosa/phecomp/data/CRG/20120502_FDF_CRG/20120502_FDF_CRG/20120502_FDF_CRG_c12.mtb	301	NA	WWSS	water	1	127656	1336085664	1	0.04	0.00166666666666667	8770	1
4	Drink 1	Intake 1	15	127881	1336085889	/users/cn/jespinosa/phecomp/data/CRG/20120502_FDF_CRG/20120502_FDF_CRG/20120502_FDF_CRG_c12.mtb	302	NA	WWSS	water	1	127866	1336085874	1	0.04	0.00266666666666667	8771	1
4	Food 1	Intake 3	446	128385	1336086393	/users/cn/jespinosa/phecomp/data/CRG/20120502_FDF_CRG/20120502_FDF_CRG/20120502_FDF_CRG_c12.mtb	359	59	WWSS	food_sc	3	127939	1336085947	1	0.04	8.96860986547085e-05	8772	1
4	Drink 1	Intake 1	38	128415	1336086423	/users/cn/jespinosa/phecomp/data/CRG/20120502_FDF_CRG/20120502_FDF_CRG/20120502_FDF_CRG_c12.mtb	304	NA	WWSS	water	1	128377	1336086385	1	0.12	0.00315789473684211	8773	1
4	Food 1	Intake 3	66	128510	1336086518	/users/cn/jespinosa/phecomp/data/CRG/20120502_FDF_CRG/20120502_FDF_CRG/20120502_FDF_CRG_c12.mtb	360	5	WWSS	food_sc	3	128444	1336086452	1	0.02	0.000303030303030303	8774	1
4	Food 1	Intake 3	198	128713	1336086721	/users/cn/jespinosa/phecomp/data/CRG/20120502_FDF_CRG/20120502_FDF_CRG/20120502_FDF_CRG_c12.mtb	361	1163	WWSS	food_sc	3	128515	1336086523	1	0.04	0.000202020202020202	8775	1
4	Drink 1	Intake 1	41	128751	1336086759	/users/cn/jespinosa/phecomp/data/CRG/20120502_FDF_CRG/20120502_FDF_CRG/20120502_FDF_CRG_c12.mtb	305	NA	WWSS	water	1	128710	1336086718	1	0.12	0.00292682926829268	8776	1
4	Food 2	Intake 4	22	129898	1336087906	/users/cn/jespinosa/phecomp/data/CRG/20120502_FDF_CRG/20120502_FDF_CRG/20120502_FDF_CRG_c12.mtb	526	162	WWSS	food_sc	4	129876	1336087884	1	0.02	0.000909090909090909	8777	1
4	Food 2	Intake 4	16	130076	1336088084	/users/cn/jespinosa/phecomp/data/CRG/20120502_FDF_CRG/20120502_FDF_CRG/20120502_FDF_CRG_c12.mtb	529	376	WWSS	food_sc	4	130060	1336088068	1	0.02	0.00125	8778	1
4	Food 1	Intake 3	669	131121	1336089129	/users/cn/jespinosa/phecomp/data/CRG/20120502_FDF_CRG/20120502_FDF_CRG/20120502_FDF_CRG_c12.mtb	368	441	WWSS	food_sc	3	130452	1336088460	1	0.18	0.000269058295964126	8779	1
4	Drink 2	Intake 2	27	131144	1336089152	/users/cn/jespinosa/phecomp/data/CRG/20120502_FDF_CRG/20120502_FDF_CRG/20120502_FDF_CRG_c12.mtb	380	NA	WWSS	water	2	131117	1336089125	1	0.12	0.00444444444444444	8780	1
4	Drink 2	Intake 2	23	131179	1336089187	/users/cn/jespinosa/phecomp/data/CRG/20120502_FDF_CRG/20120502_FDF_CRG/20120502_FDF_CRG_c12.mtb	381	NA	WWSS	water	2	131156	1336089164	1	0.04	0.00173913043478261	8781	1
4	Food 1	Intake 3	71	131633	1336089641	/users/cn/jespinosa/phecomp/data/CRG/20120502_FDF_CRG/20120502_FDF_CRG/20120502_FDF_CRG_c12.mtb	370	19	WWSS	food_sc	3	131562	1336089570	1	0.02	0.00028169014084507	8782	1
4	Drink 2	Intake 2	17	131657	1336089665	/users/cn/jespinosa/phecomp/data/CRG/20120502_FDF_CRG/20120502_FDF_CRG/20120502_FDF_CRG_c12.mtb	382	NA	WWSS	water	2	131640	1336089648	1	0.0600000000000001	0.00352941176470589	8783	1
4	Food 1	Intake 3	86	131738	1336089746	/users/cn/jespinosa/phecomp/data/CRG/20120502_FDF_CRG/20120502_FDF_CRG/20120502_FDF_CRG_c12.mtb	371	1312	WWSS	food_sc	3	131652	1336089660	1	0.02	0.000232558139534884	8784	1
4	Drink 2	Intake 2	17	132810	1336090818	/users/cn/jespinosa/phecomp/data/CRG/20120502_FDF_CRG/20120502_FDF_CRG/20120502_FDF_CRG_c12.mtb	383	NA	WWSS	water	2	132793	1336090801	1	0.04	0.00235294117647059	8785	1
4	Food 1	Intake 3	44	133094	1336091102	/users/cn/jespinosa/phecomp/data/CRG/20120502_FDF_CRG/20120502_FDF_CRG/20120502_FDF_CRG_c12.mtb	374	5532	WWSS	food_sc	3	133050	1336091058	1	0.02	0.000454545454545455	8786	1
4	Food 1	Intake 3	177	138803	1336096811	/users/cn/jespinosa/phecomp/data/CRG/20120502_FDF_CRG/20120502_FDF_CRG/20120502_FDF_CRG_c12.mtb	376	5	WWSS	food_sc	3	138626	1336096634	1	0.02	0.000112994350282486	8787	1
4	Food 1	Intake 3	377	139185	1336097193	/users/cn/jespinosa/phecomp/data/CRG/20120502_FDF_CRG/20120502_FDF_CRG/20120502_FDF_CRG_c12.mtb	377	314	WWSS	food_sc	3	138808	1336096816	1	0.12	0.000318302387267905	8788	1
4	Drink 1	Intake 1	23	139490	1336097498	/users/cn/jespinosa/phecomp/data/CRG/20120502_FDF_CRG/20120502_FDF_CRG/20120502_FDF_CRG_c12.mtb	309	NA	WWSS	water	1	139467	1336097475	1	0.1	0.00434782608695652	8789	1
4	Food 2	Intake 4	851	140350	1336098358	/users/cn/jespinosa/phecomp/data/CRG/20120502_FDF_CRG/20120502_FDF_CRG/20120502_FDF_CRG_c12.mtb	536	2327	WWSS	food_sc	4	139499	1336097507	1	0.36	0.000423031727379553	8790	1
4	Drink 1	Intake 1	57	140445	1336098453	/users/cn/jespinosa/phecomp/data/CRG/20120502_FDF_CRG/20120502_FDF_CRG/20120502_FDF_CRG_c12.mtb	310	NA	WWSS	water	1	140388	1336098396	1	0.32	0.0056140350877193	8791	1
4	Drink 1	Intake 1	27	140798	1336098806	/users/cn/jespinosa/phecomp/data/CRG/20120502_FDF_CRG/20120502_FDF_CRG/20120502_FDF_CRG_c12.mtb	313	NA	WWSS	water	1	140771	1336098779	1	0.0600000000000001	0.00222222222222223	8792	1
4	Drink 1	Intake 1	21	141108	1336099116	/users/cn/jespinosa/phecomp/data/CRG/20120502_FDF_CRG/20120502_FDF_CRG/20120502_FDF_CRG_c12.mtb	314	NA	WWSS	water	1	141087	1336099095	1	0.1	0.00476190476190476	8793	1
4	Food 2	Intake 4	732	143409	1336101417	/users/cn/jespinosa/phecomp/data/CRG/20120502_FDF_CRG/20120502_FDF_CRG/20120502_FDF_CRG_c12.mtb	540	5422	WWSS	food_sc	4	142677	1336100685	1	0.36	0.000491803278688525	8794	1
4	Drink 2	Intake 2	49	143473	1336101481	/users/cn/jespinosa/phecomp/data/CRG/20120502_FDF_CRG/20120502_FDF_CRG/20120502_FDF_CRG_c12.mtb	394	NA	WWSS	water	2	143424	1336101432	1	0.16	0.00326530612244898	8795	1
4	Food 2	Intake 4	17	148848	1336106856	/users/cn/jespinosa/phecomp/data/CRG/20120502_FDF_CRG/20120502_FDF_CRG/20120502_FDF_CRG_c12.mtb	542	87	WWSS	food_sc	4	148831	1336106839	1	0.02	0.00117647058823529	8796	1
4	Food 2	Intake 4	279	149214	1336107222	/users/cn/jespinosa/phecomp/data/CRG/20120502_FDF_CRG/20120502_FDF_CRG/20120502_FDF_CRG_c12.mtb	543	7	WWSS	food_sc	4	148935	1336106943	1	0.04	0.00014336917562724	8797	1
4	Food 2	Intake 4	229	149450	1336107458	/users/cn/jespinosa/phecomp/data/CRG/20120502_FDF_CRG/20120502_FDF_CRG/20120502_FDF_CRG_c12.mtb	544	9989	WWSS	food_sc	4	149221	1336107229	1	0.34	0.00148471615720524	8798	1
4	Drink 1	Intake 1	35	149814	1336107822	/users/cn/jespinosa/phecomp/data/CRG/20120502_FDF_CRG/20120502_FDF_CRG/20120502_FDF_CRG_c12.mtb	315	NA	WWSS	water	1	149779	1336107787	1	0.18	0.00514285714285714	8799	1
4	Drink 1	Intake 1	21	150054	1336108062	/users/cn/jespinosa/phecomp/data/CRG/20120502_FDF_CRG/20120502_FDF_CRG/20120502_FDF_CRG_c12.mtb	317	NA	WWSS	water	1	150033	1336108041	1	0.0800000000000001	0.00380952380952381	8800	1
4	Drink 1	Intake 1	17	151283	1336109291	/users/cn/jespinosa/phecomp/data/CRG/20120502_FDF_CRG/20120502_FDF_CRG/20120502_FDF_CRG_c12.mtb	319	NA	WWSS	water	1	151266	1336109274	1	0.02	0.00117647058823529	8801	1
4	Drink 1	Intake 1	28	151317	1336109325	/users/cn/jespinosa/phecomp/data/CRG/20120502_FDF_CRG/20120502_FDF_CRG/20120502_FDF_CRG_c12.mtb	320	NA	WWSS	water	1	151289	1336109297	1	0.0800000000000001	0.00285714285714286	8802	1
4	Food 2	Intake 4	58	159497	1336117505	/users/cn/jespinosa/phecomp/data/CRG/20120502_FDF_CRG/20120502_FDF_CRG/20120502_FDF_CRG_c12.mtb	558	65	WWSS	food_sc	4	159439	1336117447	1	0.02	0.000344827586206897	8803	1
4	Food 1	Intake 3	59	159621	1336117629	/users/cn/jespinosa/phecomp/data/CRG/20120502_FDF_CRG/20120502_FDF_CRG/20120502_FDF_CRG_c12.mtb	397	31804	WWSS	food_sc	3	159562	1336117570	1	0.02	0.000338983050847458	8804	1
4	Food 1	Intake 3	658	27905	1336150091	/users/cn/jespinosa/phecomp/data/CRG/20120502_FDF_CRG/20120502_FDF_CRG/20120504_FDF_CRG_c12.mtb	530	7	WWSS	food_sc	3	27247	1336149433	1	0.12	0.000182370820668693	8805	1
4	Food 1	Intake 3	191	28103	1336150289	/users/cn/jespinosa/phecomp/data/CRG/20120502_FDF_CRG/20120502_FDF_CRG/20120504_FDF_CRG_c12.mtb	531	4473	WWSS	food_sc	3	27912	1336150098	1	0.04	0.000209424083769634	8806	1
4	Drink 2	Intake 2	23	28123	1336150309	/users/cn/jespinosa/phecomp/data/CRG/20120502_FDF_CRG/20120502_FDF_CRG/20120504_FDF_CRG_c12.mtb	539	NA	WWSS	water	2	28100	1336150286	1	0.06	0.00260869565217391	8807	1
4	Drink 1	Intake 1	17	28271	1336150457	/users/cn/jespinosa/phecomp/data/CRG/20120502_FDF_CRG/20120502_FDF_CRG/20120504_FDF_CRG_c12.mtb	545	NA	WWSS	water	1	28254	1336150440	1	0.02	0.00117647058823529	8808	1
4	Drink 1	Intake 1	19	28686	1336150872	/users/cn/jespinosa/phecomp/data/CRG/20120502_FDF_CRG/20120502_FDF_CRG/20120504_FDF_CRG_c12.mtb	546	NA	WWSS	water	1	28667	1336150853	1	0.04	0.00210526315789474	8809	1
4	Food 2	Intake 4	316	32892	1336155078	/users/cn/jespinosa/phecomp/data/CRG/20120502_FDF_CRG/20120502_FDF_CRG/20120504_FDF_CRG_c12.mtb	835	293	WWSS	food_sc	4	32576	1336154762	1	0.04	0.000126582278481013	8810	1
4	Food 1	Intake 3	18	33203	1336155389	/users/cn/jespinosa/phecomp/data/CRG/20120502_FDF_CRG/20120502_FDF_CRG/20120504_FDF_CRG_c12.mtb	534	241	WWSS	food_sc	3	33185	1336155371	1	0.02	0.00111111111111111	8811	1
4	Food 1	Intake 3	858	34302	1336156488	/users/cn/jespinosa/phecomp/data/CRG/20120502_FDF_CRG/20120502_FDF_CRG/20120504_FDF_CRG_c12.mtb	538	1434	WWSS	food_sc	3	33444	1336155630	1	0.22	0.000256410256410256	8812	1
4	Drink 1	Intake 1	28	34327	1336156513	/users/cn/jespinosa/phecomp/data/CRG/20120502_FDF_CRG/20120502_FDF_CRG/20120504_FDF_CRG_c12.mtb	548	NA	WWSS	water	1	34299	1336156485	1	0.12	0.00428571428571429	8813	1
4	Drink 1	Intake 1	15	35456	1336157642	/users/cn/jespinosa/phecomp/data/CRG/20120502_FDF_CRG/20120502_FDF_CRG/20120504_FDF_CRG_c12.mtb	549	NA	WWSS	water	1	35441	1336157627	1	0.1	0.00666666666666667	8814	1
4	Food 1	Intake 3	797	36533	1336158719	/users/cn/jespinosa/phecomp/data/CRG/20120502_FDF_CRG/20120502_FDF_CRG/20120504_FDF_CRG_c12.mtb	539	867	WWSS	food_sc	3	35736	1336157922	1	0.22	0.00027603513174404	8815	1
4	Drink 1	Intake 1	22	36551	1336158737	/users/cn/jespinosa/phecomp/data/CRG/20120502_FDF_CRG/20120502_FDF_CRG/20120504_FDF_CRG_c12.mtb	550	NA	WWSS	water	1	36529	1336158715	1	0.1	0.00454545454545455	8816	1
4	Food 2	Intake 4	227	37627	1336159813	/users/cn/jespinosa/phecomp/data/CRG/20120502_FDF_CRG/20120502_FDF_CRG/20120504_FDF_CRG_c12.mtb	845	14	WWSS	food_sc	4	37400	1336159586	1	0.08	0.000352422907488987	8817	1
4	Food 2	Intake 4	87	37728	1336159914	/users/cn/jespinosa/phecomp/data/CRG/20120502_FDF_CRG/20120502_FDF_CRG/20120504_FDF_CRG_c12.mtb	846	5	WWSS	food_sc	4	37641	1336159827	1	0.06	0.000689655172413793	8818	1
4	Food 2	Intake 4	224	37957	1336160143	/users/cn/jespinosa/phecomp/data/CRG/20120502_FDF_CRG/20120502_FDF_CRG/20120504_FDF_CRG_c12.mtb	847	2214	WWSS	food_sc	4	37733	1336159919	1	0.06	0.000267857142857143	8819	1
4	Drink 1	Intake 1	37	37996	1336160182	/users/cn/jespinosa/phecomp/data/CRG/20120502_FDF_CRG/20120502_FDF_CRG/20120504_FDF_CRG_c12.mtb	554	NA	WWSS	water	1	37959	1336160145	1	0.14	0.00378378378378378	8820	1
4	Drink 1	Intake 1	17	38757	1336160943	/users/cn/jespinosa/phecomp/data/CRG/20120502_FDF_CRG/20120502_FDF_CRG/20120504_FDF_CRG_c12.mtb	557	NA	WWSS	water	1	38740	1336160926	1	0.02	0.00117647058823529	8821	1
4	Drink 1	Intake 1	20	39358	1336161544	/users/cn/jespinosa/phecomp/data/CRG/20120502_FDF_CRG/20120502_FDF_CRG/20120504_FDF_CRG_c12.mtb	558	NA	WWSS	water	1	39338	1336161524	1	0.08	0.004	8822	1
4	Food 1	Intake 3	341	40512	1336162698	/users/cn/jespinosa/phecomp/data/CRG/20120502_FDF_CRG/20120502_FDF_CRG/20120504_FDF_CRG_c12.mtb	549	10	WWSS	food_sc	3	40171	1336162357	1	0.1	0.000293255131964809	8823	1
4	Food 2	Intake 4	108	40630	1336162816	/users/cn/jespinosa/phecomp/data/CRG/20120502_FDF_CRG/20120502_FDF_CRG/20120504_FDF_CRG_c12.mtb	856	82	WWSS	food_sc	4	40522	1336162708	1	0.02	0.000185185185185185	8824	1
4	Food 2	Intake 4	139	40851	1336163037	/users/cn/jespinosa/phecomp/data/CRG/20120502_FDF_CRG/20120502_FDF_CRG/20120504_FDF_CRG_c12.mtb	858	75	WWSS	food_sc	4	40712	1336162898	1	0.02	0.000143884892086331	8825	1
4	Food 2	Intake 4	32	40958	1336163144	/users/cn/jespinosa/phecomp/data/CRG/20120502_FDF_CRG/20120502_FDF_CRG/20120504_FDF_CRG_c12.mtb	859	6	WWSS	food_sc	4	40926	1336163112	1	0.02	0.000625	8826	1
4	Food 1	Intake 3	78	41042	1336163228	/users/cn/jespinosa/phecomp/data/CRG/20120502_FDF_CRG/20120502_FDF_CRG/20120504_FDF_CRG_c12.mtb	551	203	WWSS	food_sc	3	40964	1336163150	1	0.02	0.000256410256410256	8827	1
4	Drink 1	Intake 1	17	41051	1336163237	/users/cn/jespinosa/phecomp/data/CRG/20120502_FDF_CRG/20120502_FDF_CRG/20120504_FDF_CRG_c12.mtb	562	NA	WWSS	water	1	41034	1336163220	1	0.0600000000000001	0.00352941176470589	8828	1
4	Food 1	Intake 3	192	41437	1336163623	/users/cn/jespinosa/phecomp/data/CRG/20120502_FDF_CRG/20120502_FDF_CRG/20120504_FDF_CRG_c12.mtb	553	169	WWSS	food_sc	3	41245	1336163431	1	0.02	0.000104166666666667	8829	1
4	Food 1	Intake 3	193	41799	1336163985	/users/cn/jespinosa/phecomp/data/CRG/20120502_FDF_CRG/20120502_FDF_CRG/20120504_FDF_CRG_c12.mtb	557	1560	WWSS	food_sc	3	41606	1336163792	1	0.04	0.000207253886010363	8830	1
4	Drink 1	Intake 1	17	41814	1336164000	/users/cn/jespinosa/phecomp/data/CRG/20120502_FDF_CRG/20120502_FDF_CRG/20120504_FDF_CRG_c12.mtb	564	NA	WWSS	water	1	41797	1336163983	1	0.04	0.00235294117647059	8831	1
4	Drink 2	Intake 2	64	41911	1336164097	/users/cn/jespinosa/phecomp/data/CRG/20120502_FDF_CRG/20120502_FDF_CRG/20120504_FDF_CRG_c12.mtb	552	NA	WWSS	water	2	41847	1336164033	1	0.02	0.0003125	8832	1
4	Drink 2	Intake 2	18	42275	1336164461	/users/cn/jespinosa/phecomp/data/CRG/20120502_FDF_CRG/20120502_FDF_CRG/20120504_FDF_CRG_c12.mtb	555	NA	WWSS	water	2	42257	1336164443	1	0.02	0.00111111111111111	8833	1
4	Drink 2	Intake 2	17	42357	1336164543	/users/cn/jespinosa/phecomp/data/CRG/20120502_FDF_CRG/20120502_FDF_CRG/20120504_FDF_CRG_c12.mtb	556	NA	WWSS	water	2	42340	1336164526	1	0.02	0.00117647058823529	8834	1
4	Food 2	Intake 4	654	44013	1336166199	/users/cn/jespinosa/phecomp/data/CRG/20120502_FDF_CRG/20120502_FDF_CRG/20120504_FDF_CRG_c12.mtb	877	451	WWSS	food_sc	4	43359	1336165545	1	0.16	0.000244648318042813	8835	1
4	Drink 2	Intake 2	36	44049	1336166235	/users/cn/jespinosa/phecomp/data/CRG/20120502_FDF_CRG/20120502_FDF_CRG/20120504_FDF_CRG_c12.mtb	560	NA	WWSS	water	2	44013	1336166199	1	0.12	0.00333333333333333	8836	1
4	Drink 2	Intake 2	36	44255	1336166441	/users/cn/jespinosa/phecomp/data/CRG/20120502_FDF_CRG/20120502_FDF_CRG/20120504_FDF_CRG_c12.mtb	562	NA	WWSS	water	2	44219	1336166405	1	0.02	0.000555555555555556	8837	1
4	Food 1	Intake 3	693	45157	1336167343	/users/cn/jespinosa/phecomp/data/CRG/20120502_FDF_CRG/20120502_FDF_CRG/20120504_FDF_CRG_c12.mtb	571	569	WWSS	food_sc	3	44464	1336166650	1	0.26	0.000375180375180375	8838	1
4	Drink 1	Intake 1	36	45189	1336167375	/users/cn/jespinosa/phecomp/data/CRG/20120502_FDF_CRG/20120502_FDF_CRG/20120504_FDF_CRG_c12.mtb	573	NA	WWSS	water	1	45153	1336167339	1	0.18	0.005	8839	1
4	Drink 2	Intake 2	23	45664	1336167850	/users/cn/jespinosa/phecomp/data/CRG/20120502_FDF_CRG/20120502_FDF_CRG/20120504_FDF_CRG_c12.mtb	564	NA	WWSS	water	2	45641	1336167827	1	0.02	0.000869565217391304	8840	1
4	Food 1	Intake 3	566	46292	1336168478	/users/cn/jespinosa/phecomp/data/CRG/20120502_FDF_CRG/20120502_FDF_CRG/20120504_FDF_CRG_c12.mtb	574	487	WWSS	food_sc	3	45726	1336167912	1	0.22	0.0003886925795053	8841	1
4	Drink 1	Intake 1	45	46334	1336168520	/users/cn/jespinosa/phecomp/data/CRG/20120502_FDF_CRG/20120502_FDF_CRG/20120504_FDF_CRG_c12.mtb	575	NA	WWSS	water	1	46289	1336168475	1	0.2	0.00444444444444444	8842	1
4	Food 2	Intake 4	158	46937	1336169123	/users/cn/jespinosa/phecomp/data/CRG/20120502_FDF_CRG/20120502_FDF_CRG/20120504_FDF_CRG_c12.mtb	889	224	WWSS	food_sc	4	46779	1336168965	1	0.02	0.000126582278481013	8843	1
4	Drink 1	Intake 1	28	47160	1336169346	/users/cn/jespinosa/phecomp/data/CRG/20120502_FDF_CRG/20120502_FDF_CRG/20120504_FDF_CRG_c12.mtb	579	NA	WWSS	water	1	47132	1336169318	1	0.0599999999999998	0.00214285714285714	8844	1
4	Food 1	Intake 3	85	47246	1336169432	/users/cn/jespinosa/phecomp/data/CRG/20120502_FDF_CRG/20120502_FDF_CRG/20120504_FDF_CRG_c12.mtb	576	15	WWSS	food_sc	3	47161	1336169347	1	0.02	0.000235294117647059	8845	1
4	Food 1	Intake 3	374	47635	1336169821	/users/cn/jespinosa/phecomp/data/CRG/20120502_FDF_CRG/20120502_FDF_CRG/20120504_FDF_CRG_c12.mtb	577	2872	WWSS	food_sc	3	47261	1336169447	1	0.2	0.00053475935828877	8846	1
4	Drink 2	Intake 2	31	47705	1336169891	/users/cn/jespinosa/phecomp/data/CRG/20120502_FDF_CRG/20120502_FDF_CRG/20120504_FDF_CRG_c12.mtb	565	NA	WWSS	water	2	47674	1336169860	1	0.18	0.00580645161290323	8847	1
4	Food 1	Intake 3	639	51146	1336173332	/users/cn/jespinosa/phecomp/data/CRG/20120502_FDF_CRG/20120502_FDF_CRG/20120504_FDF_CRG_c12.mtb	580	669	WWSS	food_sc	3	50507	1336172693	1	0.26	0.000406885758998435	8848	1
4	Drink 2	Intake 2	33	51172	1336173358	/users/cn/jespinosa/phecomp/data/CRG/20120502_FDF_CRG/20120502_FDF_CRG/20120504_FDF_CRG_c12.mtb	568	NA	WWSS	water	2	51139	1336173325	1	0.16	0.00484848484848485	8849	1
4	Drink 1	Intake 1	17	51542	1336173728	/users/cn/jespinosa/phecomp/data/CRG/20120502_FDF_CRG/20120502_FDF_CRG/20120504_FDF_CRG_c12.mtb	583	NA	WWSS	water	1	51525	1336173711	1	0.02	0.00117647058823529	8850	1
4	Drink 1	Intake 1	16	51583	1336173769	/users/cn/jespinosa/phecomp/data/CRG/20120502_FDF_CRG/20120502_FDF_CRG/20120504_FDF_CRG_c12.mtb	584	NA	WWSS	water	1	51567	1336173753	1	0.04	0.0025	8851	1
4	Food 1	Intake 3	75	51890	1336174076	/users/cn/jespinosa/phecomp/data/CRG/20120502_FDF_CRG/20120502_FDF_CRG/20120504_FDF_CRG_c12.mtb	584	329	WWSS	food_sc	3	51815	1336174001	1	0.02	0.000266666666666667	8852	1
4	Drink 2	Intake 2	40	51923	1336174109	/users/cn/jespinosa/phecomp/data/CRG/20120502_FDF_CRG/20120502_FDF_CRG/20120504_FDF_CRG_c12.mtb	572	NA	WWSS	water	2	51883	1336174069	1	0.0600000000000001	0.0015	8853	1
4	Food 1	Intake 3	152	52371	1336174557	/users/cn/jespinosa/phecomp/data/CRG/20120502_FDF_CRG/20120502_FDF_CRG/20120504_FDF_CRG_c12.mtb	588	5881	WWSS	food_sc	3	52219	1336174405	1	0.28	0.00184210526315789	8854	1
4	Drink 1	Intake 1	24	52777	1336174963	/users/cn/jespinosa/phecomp/data/CRG/20120502_FDF_CRG/20120502_FDF_CRG/20120504_FDF_CRG_c12.mtb	586	NA	WWSS	water	1	52753	1336174939	1	0.0600000000000001	0.0025	8855	1
4	Drink 1	Intake 1	23	52804	1336174990	/users/cn/jespinosa/phecomp/data/CRG/20120502_FDF_CRG/20120502_FDF_CRG/20120504_FDF_CRG_c12.mtb	587	NA	WWSS	water	1	52781	1336174967	1	0.0599999999999998	0.0026086956521739	8856	1
4	Drink 2	Intake 2	13	52892	1336175078	/users/cn/jespinosa/phecomp/data/CRG/20120502_FDF_CRG/20120502_FDF_CRG/20120504_FDF_CRG_c12.mtb	574	NA	WWSS	water	2	52879	1336175065	1	0.0599999999999999	0.00461538461538461	8857	1
4	Drink 1	Intake 1	17	53536	1336175722	/users/cn/jespinosa/phecomp/data/CRG/20120502_FDF_CRG/20120502_FDF_CRG/20120504_FDF_CRG_c12.mtb	588	NA	WWSS	water	1	53519	1336175705	1	0.02	0.00117647058823529	8858	1
4	Drink 1	Intake 1	20	53570	1336175756	/users/cn/jespinosa/phecomp/data/CRG/20120502_FDF_CRG/20120502_FDF_CRG/20120504_FDF_CRG_c12.mtb	589	NA	WWSS	water	1	53550	1336175736	1	0.04	0.002	8859	1
4	Drink 1	Intake 1	20	53705	1336175891	/users/cn/jespinosa/phecomp/data/CRG/20120502_FDF_CRG/20120502_FDF_CRG/20120504_FDF_CRG_c12.mtb	590	NA	WWSS	water	1	53685	1336175871	1	0.02	0.001	8860	1
4	Drink 1	Intake 1	19	55244	1336177430	/users/cn/jespinosa/phecomp/data/CRG/20120502_FDF_CRG/20120502_FDF_CRG/20120504_FDF_CRG_c12.mtb	592	NA	WWSS	water	1	55225	1336177411	1	0.02	0.00105263157894737	8861	1
4	Food 1	Intake 3	62	58314	1336180500	/users/cn/jespinosa/phecomp/data/CRG/20120502_FDF_CRG/20120502_FDF_CRG/20120504_FDF_CRG_c12.mtb	592	222	WWSS	food_sc	3	58252	1336180438	1	0.02	0.00032258064516129	8862	1
4	Food 2	Intake 4	78	58614	1336180800	/users/cn/jespinosa/phecomp/data/CRG/20120502_FDF_CRG/20120502_FDF_CRG/20120504_FDF_CRG_c12.mtb	906	COLL	WWSS	food_sc	4	58536	1336180722	1	0.02	0.000256410256410256	8863	1
4	Food 1	Intake 3	96	58702	1336180888	/users/cn/jespinosa/phecomp/data/CRG/20120502_FDF_CRG/20120502_FDF_CRG/20120504_FDF_CRG_c12.mtb	595	403	WWSS	food_sc	3	58606	1336180792	1	0.02	0.000208333333333333	8864	1
4	Drink 2	Intake 2	13	58775	1336180961	/users/cn/jespinosa/phecomp/data/CRG/20120502_FDF_CRG/20120502_FDF_CRG/20120504_FDF_CRG_c12.mtb	579	NA	WWSS	water	2	58762	1336180948	1	0.0600000000000001	0.00461538461538462	8865	1
4	Food 2	Intake 4	285	59390	1336181576	/users/cn/jespinosa/phecomp/data/CRG/20120502_FDF_CRG/20120502_FDF_CRG/20120504_FDF_CRG_c12.mtb	910	11596	WWSS	food_sc	4	59105	1336181291	1	0.04	0.000140350877192982	8866	1
4	Drink 1	Intake 1	15	59407	1336181593	/users/cn/jespinosa/phecomp/data/CRG/20120502_FDF_CRG/20120502_FDF_CRG/20120504_FDF_CRG_c12.mtb	595	NA	WWSS	water	1	59392	1336181578	1	0.04	0.00266666666666667	8867	1
4	Drink 1	Intake 1	18	59447	1336181633	/users/cn/jespinosa/phecomp/data/CRG/20120502_FDF_CRG/20120502_FDF_CRG/20120504_FDF_CRG_c12.mtb	596	NA	WWSS	water	1	59429	1336181615	1	0.04	0.00222222222222222	8868	1
4	Drink 2	Intake 2	54	70625	1336192811	/users/cn/jespinosa/phecomp/data/CRG/20120502_FDF_CRG/20120502_FDF_CRG/20120504_FDF_CRG_c12.mtb	583	NA	WWSS	water	2	70571	1336192757	1	0.02	0.00037037037037037	8869	1
4	Drink 2	Intake 2	20	70863	1336193049	/users/cn/jespinosa/phecomp/data/CRG/20120502_FDF_CRG/20120502_FDF_CRG/20120504_FDF_CRG_c12.mtb	584	NA	WWSS	water	2	70843	1336193029	1	0.02	0.001	8870	1
4	Food 1	Intake 3	381	71367	1336193553	/users/cn/jespinosa/phecomp/data/CRG/20120502_FDF_CRG/20120502_FDF_CRG/20120504_FDF_CRG_c12.mtb	606	60	WWSS	food_sc	3	70986	1336193172	1	0.04	0.00010498687664042	8871	1
4	Food 1	Intake 3	278	71705	1336193891	/users/cn/jespinosa/phecomp/data/CRG/20120502_FDF_CRG/20120502_FDF_CRG/20120504_FDF_CRG_c12.mtb	607	1431	WWSS	food_sc	3	71427	1336193613	1	0.0600000000000001	0.000215827338129497	8872	1
4	Drink 1	Intake 1	8	71829	1336194015	/users/cn/jespinosa/phecomp/data/CRG/20120502_FDF_CRG/20120502_FDF_CRG/20120504_FDF_CRG_c12.mtb	601	NA	WWSS	water	1	71821	1336194007	1	0.02	0.0025	8873	1
4	Drink 1	Intake 1	20	72528	1336194714	/users/cn/jespinosa/phecomp/data/CRG/20120502_FDF_CRG/20120502_FDF_CRG/20120504_FDF_CRG_c12.mtb	603	NA	WWSS	water	1	72508	1336194694	1	0.0600000000000001	0.00300000000000001	8874	1
4	Drink 1	Intake 1	22	72600	1336194786	/users/cn/jespinosa/phecomp/data/CRG/20120502_FDF_CRG/20120502_FDF_CRG/20120504_FDF_CRG_c12.mtb	604	NA	WWSS	water	1	72578	1336194764	1	0.04	0.00181818181818182	8875	1
4	Food 1	Intake 3	491	73627	1336195813	/users/cn/jespinosa/phecomp/data/CRG/20120502_FDF_CRG/20120502_FDF_CRG/20120504_FDF_CRG_c12.mtb	618	109	WWSS	food_sc	3	73136	1336195322	1	0.14	0.000285132382892057	8876	1
4	Drink 2	Intake 2	27	73722	1336195908	/users/cn/jespinosa/phecomp/data/CRG/20120502_FDF_CRG/20120502_FDF_CRG/20120504_FDF_CRG_c12.mtb	595	NA	WWSS	water	2	73695	1336195881	1	0.02	0.000740740740740741	8877	1
4	Food 1	Intake 3	556	74292	1336196478	/users/cn/jespinosa/phecomp/data/CRG/20120502_FDF_CRG/20120502_FDF_CRG/20120504_FDF_CRG_c12.mtb	620	47	WWSS	food_sc	3	73736	1336195922	1	0.24	0.000431654676258993	8878	1
4	Food 1	Intake 3	38	74377	1336196563	/users/cn/jespinosa/phecomp/data/CRG/20120502_FDF_CRG/20120502_FDF_CRG/20120504_FDF_CRG_c12.mtb	621	9	WWSS	food_sc	3	74339	1336196525	1	0.02	0.000526315789473684	8879	1
4	Food 1	Intake 3	49	74435	1336196621	/users/cn/jespinosa/phecomp/data/CRG/20120502_FDF_CRG/20120502_FDF_CRG/20120504_FDF_CRG_c12.mtb	622	677	WWSS	food_sc	3	74386	1336196572	1	0.02	0.000408163265306122	8880	1
4	Drink 2	Intake 2	44	74475	1336196661	/users/cn/jespinosa/phecomp/data/CRG/20120502_FDF_CRG/20120502_FDF_CRG/20120504_FDF_CRG_c12.mtb	596	NA	WWSS	water	2	74431	1336196617	1	0.14	0.00318181818181818	8881	1
4	Drink 2	Intake 2	23	74542	1336196728	/users/cn/jespinosa/phecomp/data/CRG/20120502_FDF_CRG/20120502_FDF_CRG/20120504_FDF_CRG_c12.mtb	597	NA	WWSS	water	2	74519	1336196705	1	0.02	0.000869565217391304	8882	1
4	Drink 2	Intake 2	18	74624	1336196810	/users/cn/jespinosa/phecomp/data/CRG/20120502_FDF_CRG/20120502_FDF_CRG/20120504_FDF_CRG_c12.mtb	598	NA	WWSS	water	2	74606	1336196792	1	0.04	0.00222222222222222	8883	1
4	Drink 2	Intake 2	23	74759	1336196945	/users/cn/jespinosa/phecomp/data/CRG/20120502_FDF_CRG/20120502_FDF_CRG/20120504_FDF_CRG_c12.mtb	599	NA	WWSS	water	2	74736	1336196922	1	0.0600000000000001	0.00260869565217392	8884	1
4	Food 1	Intake 3	612	75724	1336197910	/users/cn/jespinosa/phecomp/data/CRG/20120502_FDF_CRG/20120502_FDF_CRG/20120504_FDF_CRG_c12.mtb	624	COLL	WWSS	food_sc	3	75112	1336197298	1	0.22	0.000359477124183007	8885	1
4	Food 2	Intake 4	19	75743	1336197929	/users/cn/jespinosa/phecomp/data/CRG/20120502_FDF_CRG/20120502_FDF_CRG/20120504_FDF_CRG_c12.mtb	932	3847	WWSS	food_sc	4	75724	1336197910	1	0.02	0.00105263157894737	8886	1
4	Drink 1	Intake 1	28	75769	1336197955	/users/cn/jespinosa/phecomp/data/CRG/20120502_FDF_CRG/20120502_FDF_CRG/20120504_FDF_CRG_c12.mtb	609	NA	WWSS	water	1	75741	1336197927	1	0.2	0.00714285714285714	8887	1
4	Drink 1	Intake 1	17	76022	1336198208	/users/cn/jespinosa/phecomp/data/CRG/20120502_FDF_CRG/20120502_FDF_CRG/20120504_FDF_CRG_c12.mtb	610	NA	WWSS	water	1	76005	1336198191	1	0.04	0.00235294117647059	8888	1
4	Food 1	Intake 3	382	79972	1336202158	/users/cn/jespinosa/phecomp/data/CRG/20120502_FDF_CRG/20120502_FDF_CRG/20120504_FDF_CRG_c12.mtb	627	4153	WWSS	food_sc	3	79590	1336201776	1	0.12	0.00031413612565445	8889	1
4	Drink 1	Intake 1	28	80013	1336202199	/users/cn/jespinosa/phecomp/data/CRG/20120502_FDF_CRG/20120502_FDF_CRG/20120504_FDF_CRG_c12.mtb	611	NA	WWSS	water	1	79985	1336202171	1	0.1	0.00357142857142857	8890	1
4	Food 1	Intake 3	76	84201	1336206387	/users/cn/jespinosa/phecomp/data/CRG/20120502_FDF_CRG/20120502_FDF_CRG/20120504_FDF_CRG_c12.mtb	629	952	WWSS	food_sc	3	84125	1336206311	1	0.02	0.000263157894736842	8891	1
4	Food 1	Intake 3	357	85510	1336207696	/users/cn/jespinosa/phecomp/data/CRG/20120502_FDF_CRG/20120502_FDF_CRG/20120504_FDF_CRG_c12.mtb	632	32879	WWSS	food_sc	3	85153	1336207339	1	0.38	0.00106442577030812	8892	1
4	Drink 1	Intake 1	33	85936	1336208122	/users/cn/jespinosa/phecomp/data/CRG/20120502_FDF_CRG/20120502_FDF_CRG/20120504_FDF_CRG_c12.mtb	613	NA	WWSS	water	1	85903	1336208089	1	0.2	0.00606060606060606	8893	1
4	Drink 1	Intake 1	15	86077	1336208263	/users/cn/jespinosa/phecomp/data/CRG/20120502_FDF_CRG/20120502_FDF_CRG/20120504_FDF_CRG_c12.mtb	614	NA	WWSS	water	1	86062	1336208248	1	0.04	0.00266666666666667	8894	1
4	Drink 2	Intake 2	44	92345	1336214531	/users/cn/jespinosa/phecomp/data/CRG/20120502_FDF_CRG/20120502_FDF_CRG/20120504_FDF_CRG_c12.mtb	611	NA	WWSS	water	2	92301	1336214487	1	0.02	0.000454545454545455	8895	1
4	Drink 2	Intake 2	76	93401	1336215587	/users/cn/jespinosa/phecomp/data/CRG/20120502_FDF_CRG/20120502_FDF_CRG/20120504_FDF_CRG_c12.mtb	618	NA	WWSS	water	2	93325	1336215511	1	0.02	0.000263157894736842	8896	1
4	Drink 2	Intake 2	65	93494	1336215680	/users/cn/jespinosa/phecomp/data/CRG/20120502_FDF_CRG/20120502_FDF_CRG/20120504_FDF_CRG_c12.mtb	620	NA	WWSS	water	2	93429	1336215615	1	0.02	0.000307692307692308	8897	1
4	Drink 2	Intake 2	28	93597	1336215783	/users/cn/jespinosa/phecomp/data/CRG/20120502_FDF_CRG/20120502_FDF_CRG/20120504_FDF_CRG_c12.mtb	621	NA	WWSS	water	2	93569	1336215755	1	0.02	0.000714285714285714	8898	1
4	Drink 2	Intake 2	78	95583	1336217769	/users/cn/jespinosa/phecomp/data/CRG/20120502_FDF_CRG/20120502_FDF_CRG/20120504_FDF_CRG_c12.mtb	630	NA	WWSS	water	2	95505	1336217691	1	0.02	0.000256410256410256	8899	1
4	Drink 2	Intake 2	332	95956	1336218142	/users/cn/jespinosa/phecomp/data/CRG/20120502_FDF_CRG/20120502_FDF_CRG/20120504_FDF_CRG_c12.mtb	631	NA	WWSS	water	2	95624	1336217810	1	0.04	0.000120481927710843	8900	1
4	Drink 2	Intake 2	26	96263	1336218449	/users/cn/jespinosa/phecomp/data/CRG/20120502_FDF_CRG/20120502_FDF_CRG/20120504_FDF_CRG_c12.mtb	633	NA	WWSS	water	2	96237	1336218423	1	0.02	0.000769230769230769	8901	1
4	Drink 2	Intake 2	290	96808	1336218994	/users/cn/jespinosa/phecomp/data/CRG/20120502_FDF_CRG/20120502_FDF_CRG/20120504_FDF_CRG_c12.mtb	635	NA	WWSS	water	2	96518	1336218704	1	0.04	0.000137931034482759	8902	1
4	Drink 2	Intake 2	14	97003	1336219189	/users/cn/jespinosa/phecomp/data/CRG/20120502_FDF_CRG/20120502_FDF_CRG/20120504_FDF_CRG_c12.mtb	636	NA	WWSS	water	2	96989	1336219175	1	0.02	0.00142857142857143	8903	1
4	Drink 2	Intake 2	288	98168	1336220354	/users/cn/jespinosa/phecomp/data/CRG/20120502_FDF_CRG/20120502_FDF_CRG/20120504_FDF_CRG_c12.mtb	639	NA	WWSS	water	2	97880	1336220066	1	0.04	0.000138888888888889	8904	1
4	Drink 2	Intake 2	56	98432	1336220618	/users/cn/jespinosa/phecomp/data/CRG/20120502_FDF_CRG/20120502_FDF_CRG/20120504_FDF_CRG_c12.mtb	641	NA	WWSS	water	2	98376	1336220562	1	0.02	0.000357142857142857	8905	1
4	Drink 2	Intake 2	23	98472	1336220658	/users/cn/jespinosa/phecomp/data/CRG/20120502_FDF_CRG/20120502_FDF_CRG/20120504_FDF_CRG_c12.mtb	642	NA	WWSS	water	2	98449	1336220635	1	0.02	0.000869565217391304	8906	1
4	Drink 2	Intake 2	12	99495	1336221681	/users/cn/jespinosa/phecomp/data/CRG/20120502_FDF_CRG/20120502_FDF_CRG/20120504_FDF_CRG_c12.mtb	646	NA	WWSS	water	2	99483	1336221669	1	0.02	0.00166666666666667	8907	1
4	Drink 2	Intake 2	17	100716	1336222902	/users/cn/jespinosa/phecomp/data/CRG/20120502_FDF_CRG/20120502_FDF_CRG/20120504_FDF_CRG_c12.mtb	648	NA	WWSS	water	2	100699	1336222885	1	0.02	0.00117647058823529	8908	1
4	Food 1	Intake 3	170	118559	1336240745	/users/cn/jespinosa/phecomp/data/CRG/20120502_FDF_CRG/20120502_FDF_CRG/20120504_FDF_CRG_c12.mtb	642	181	WWSS	food_sc	3	118389	1336240575	1	0.02	0.000117647058823529	8909	1
4	Food 1	Intake 3	588	119328	1336241514	/users/cn/jespinosa/phecomp/data/CRG/20120502_FDF_CRG/20120502_FDF_CRG/20120504_FDF_CRG_c12.mtb	644	1931	WWSS	food_sc	3	118740	1336240926	1	0.16	0.000272108843537415	8910	1
4	Drink 1	Intake 1	21	120762	1336242948	/users/cn/jespinosa/phecomp/data/CRG/20120502_FDF_CRG/20120502_FDF_CRG/20120504_FDF_CRG_c12.mtb	617	NA	WWSS	water	1	120741	1336242927	1	0.0999999999999996	0.00476190476190474	8911	1
4	Food 1	Intake 3	739	121998	1336244184	/users/cn/jespinosa/phecomp/data/CRG/20120502_FDF_CRG/20120502_FDF_CRG/20120504_FDF_CRG_c12.mtb	645	404	WWSS	food_sc	3	121259	1336243445	1	0.26	0.000351826792963464	8912	1
4	Drink 2	Intake 2	32	122033	1336244219	/users/cn/jespinosa/phecomp/data/CRG/20120502_FDF_CRG/20120502_FDF_CRG/20120504_FDF_CRG_c12.mtb	655	NA	WWSS	water	2	122001	1336244187	1	0.0800000000000001	0.0025	8913	1
4	Food 1	Intake 3	407	122809	1336244995	/users/cn/jespinosa/phecomp/data/CRG/20120502_FDF_CRG/20120502_FDF_CRG/20120504_FDF_CRG_c12.mtb	646	217	WWSS	food_sc	3	122402	1336244588	1	0.14	0.000343980343980344	8914	1
4	Drink 2	Intake 2	37	122839	1336245025	/users/cn/jespinosa/phecomp/data/CRG/20120502_FDF_CRG/20120502_FDF_CRG/20120504_FDF_CRG_c12.mtb	656	NA	WWSS	water	2	122802	1336244988	1	0.14	0.00378378378378378	8915	1
4	Food 1	Intake 3	277	123303	1336245489	/users/cn/jespinosa/phecomp/data/CRG/20120502_FDF_CRG/20120502_FDF_CRG/20120504_FDF_CRG_c12.mtb	648	1267	WWSS	food_sc	3	123026	1336245212	1	0.12	0.000433212996389892	8916	1
4	Drink 2	Intake 2	24	123328	1336245514	/users/cn/jespinosa/phecomp/data/CRG/20120502_FDF_CRG/20120502_FDF_CRG/20120504_FDF_CRG_c12.mtb	659	NA	WWSS	water	2	123304	1336245490	1	0.12	0.005	8917	1
4	Food 1	Intake 3	495	125065	1336247251	/users/cn/jespinosa/phecomp/data/CRG/20120502_FDF_CRG/20120502_FDF_CRG/20120504_FDF_CRG_c12.mtb	650	4502	WWSS	food_sc	3	124570	1336246756	1	0.460000000000001	0.000929292929292931	8918	1
4	Drink 2	Intake 2	40	125368	1336247554	/users/cn/jespinosa/phecomp/data/CRG/20120502_FDF_CRG/20120502_FDF_CRG/20120504_FDF_CRG_c12.mtb	661	NA	WWSS	water	2	125328	1336247514	1	0.18	0.0045	8919	1
4	Drink 2	Intake 2	31	126041	1336248227	/users/cn/jespinosa/phecomp/data/CRG/20120502_FDF_CRG/20120502_FDF_CRG/20120504_FDF_CRG_c12.mtb	666	NA	WWSS	water	2	126010	1336248196	1	0.02	0.000645161290322581	8920	1
4	Drink 1	Intake 1	41	126427	1336248613	/users/cn/jespinosa/phecomp/data/CRG/20120502_FDF_CRG/20120502_FDF_CRG/20120504_FDF_CRG_c12.mtb	620	NA	WWSS	water	1	126386	1336248572	1	0.2	0.0048780487804878	8921	1
4	Drink 1	Intake 1	19	127965	1336250151	/users/cn/jespinosa/phecomp/data/CRG/20120502_FDF_CRG/20120502_FDF_CRG/20120504_FDF_CRG_c12.mtb	623	NA	WWSS	water	1	127946	1336250132	1	0.0800000000000001	0.00421052631578948	8922	1
4	Drink 2	Intake 2	24	128482	1336250668	/users/cn/jespinosa/phecomp/data/CRG/20120502_FDF_CRG/20120502_FDF_CRG/20120504_FDF_CRG_c12.mtb	674	NA	WWSS	water	2	128458	1336250644	1	0.02	0.000833333333333333	8923	1
4	Food 1	Intake 3	172	129739	1336251925	/users/cn/jespinosa/phecomp/data/CRG/20120502_FDF_CRG/20120502_FDF_CRG/20120504_FDF_CRG_c12.mtb	672	6	WWSS	food_sc	3	129567	1336251753	1	0.0600000000000005	0.000348837209302328	8924	1
4	Food 1	Intake 3	190	129935	1336252121	/users/cn/jespinosa/phecomp/data/CRG/20120502_FDF_CRG/20120502_FDF_CRG/20120504_FDF_CRG_c12.mtb	673	54	WWSS	food_sc	3	129745	1336251931	1	0.0599999999999996	0.000315789473684208	8925	1
4	Drink 1	Intake 1	19	129948	1336252134	/users/cn/jespinosa/phecomp/data/CRG/20120502_FDF_CRG/20120502_FDF_CRG/20120504_FDF_CRG_c12.mtb	626	NA	WWSS	water	1	129929	1336252115	1	0.0800000000000001	0.00421052631578948	8926	1
4	Food 1	Intake 3	79	130068	1336252254	/users/cn/jespinosa/phecomp/data/CRG/20120502_FDF_CRG/20120502_FDF_CRG/20120504_FDF_CRG_c12.mtb	674	98	WWSS	food_sc	3	129989	1336252175	1	0.0200000000000005	0.000253164556962032	8927	1
4	Food 1	Intake 3	489	130655	1336252841	/users/cn/jespinosa/phecomp/data/CRG/20120502_FDF_CRG/20120502_FDF_CRG/20120504_FDF_CRG_c12.mtb	676	1599	WWSS	food_sc	3	130166	1336252352	1	0.18	0.000368098159509202	8928	1
4	Drink 1	Intake 1	25	130682	1336252868	/users/cn/jespinosa/phecomp/data/CRG/20120502_FDF_CRG/20120502_FDF_CRG/20120504_FDF_CRG_c12.mtb	627	NA	WWSS	water	1	130657	1336252843	1	0.14	0.0056	8929	1
4	Drink 2	Intake 2	37	131371	1336253557	/users/cn/jespinosa/phecomp/data/CRG/20120502_FDF_CRG/20120502_FDF_CRG/20120504_FDF_CRG_c12.mtb	684	NA	WWSS	water	2	131334	1336253520	1	0.02	0.000540540540540541	8930	1
4	Food 1	Intake 3	221	132475	1336254661	/users/cn/jespinosa/phecomp/data/CRG/20120502_FDF_CRG/20120502_FDF_CRG/20120504_FDF_CRG_c12.mtb	682	319	WWSS	food_sc	3	132254	1336254440	1	0.0800000000000001	0.000361990950226245	8931	1
4	Drink 2	Intake 2	41	132515	1336254701	/users/cn/jespinosa/phecomp/data/CRG/20120502_FDF_CRG/20120502_FDF_CRG/20120504_FDF_CRG_c12.mtb	685	NA	WWSS	water	2	132474	1336254660	1	0.04	0.000975609756097561	8932	1
4	Drink 2	Intake 2	15	132595	1336254781	/users/cn/jespinosa/phecomp/data/CRG/20120502_FDF_CRG/20120502_FDF_CRG/20120504_FDF_CRG_c12.mtb	686	NA	WWSS	water	2	132580	1336254766	1	0.02	0.00133333333333333	8933	1
4	Food 1	Intake 3	191	132985	1336255171	/users/cn/jespinosa/phecomp/data/CRG/20120502_FDF_CRG/20120502_FDF_CRG/20120504_FDF_CRG_c12.mtb	684	2957	WWSS	food_sc	3	132794	1336254980	1	0.0800000000000001	0.000418848167539268	8934	1
4	Drink 2	Intake 2	18	133013	1336255199	/users/cn/jespinosa/phecomp/data/CRG/20120502_FDF_CRG/20120502_FDF_CRG/20120504_FDF_CRG_c12.mtb	687	NA	WWSS	water	2	132995	1336255181	1	0.0800000000000001	0.00444444444444445	8935	1
4	Food 1	Intake 3	167	136109	1336258295	/users/cn/jespinosa/phecomp/data/CRG/20120502_FDF_CRG/20120502_FDF_CRG/20120504_FDF_CRG_c12.mtb	688	17	WWSS	food_sc	3	135942	1336258128	1	0.0599999999999996	0.000359281437125746	8936	1
4	Food 1	Intake 3	156	136282	1336258468	/users/cn/jespinosa/phecomp/data/CRG/20120502_FDF_CRG/20120502_FDF_CRG/20120504_FDF_CRG_c12.mtb	689	565	WWSS	food_sc	3	136126	1336258312	1	0.0600000000000005	0.000384615384615388	8937	1
4	Drink 1	Intake 1	20	136766	1336258952	/users/cn/jespinosa/phecomp/data/CRG/20120502_FDF_CRG/20120502_FDF_CRG/20120504_FDF_CRG_c12.mtb	631	NA	WWSS	water	1	136746	1336258932	1	0.02	0.001	8938	1
4	Food 1	Intake 3	396	137243	1336259429	/users/cn/jespinosa/phecomp/data/CRG/20120502_FDF_CRG/20120502_FDF_CRG/20120504_FDF_CRG_c12.mtb	691	971	WWSS	food_sc	3	136847	1336259033	1	0.2	0.000505050505050505	8939	1
4	Drink 2	Intake 2	33	137276	1336259462	/users/cn/jespinosa/phecomp/data/CRG/20120502_FDF_CRG/20120502_FDF_CRG/20120504_FDF_CRG_c12.mtb	692	NA	WWSS	water	2	137243	1336259429	1	0.16	0.00484848484848485	8940	1
4	Drink 2	Intake 2	75	137904	1336260090	/users/cn/jespinosa/phecomp/data/CRG/20120502_FDF_CRG/20120502_FDF_CRG/20120504_FDF_CRG_c12.mtb	695	NA	WWSS	water	2	137829	1336260015	1	0.02	0.000266666666666667	8941	1
4	Drink 1	Intake 1	25	138214	1336260400	/users/cn/jespinosa/phecomp/data/CRG/20120502_FDF_CRG/20120502_FDF_CRG/20120504_FDF_CRG_c12.mtb	634	NA	WWSS	water	1	138189	1336260375	1	0.02	0.0008	8942	1
4	Food 1	Intake 3	108	138322	1336260508	/users/cn/jespinosa/phecomp/data/CRG/20120502_FDF_CRG/20120502_FDF_CRG/20120504_FDF_CRG_c12.mtb	693	743	WWSS	food_sc	3	138214	1336260400	1	0.0600000000000005	0.00055555555555556	8943	1
4	Drink 1	Intake 1	12	138384	1336260570	/users/cn/jespinosa/phecomp/data/CRG/20120502_FDF_CRG/20120502_FDF_CRG/20120504_FDF_CRG_c12.mtb	635	NA	WWSS	water	1	138372	1336260558	1	0.0600000000000001	0.00500000000000001	8944	1
4	Food 1	Intake 3	398	139463	1336261649	/users/cn/jespinosa/phecomp/data/CRG/20120502_FDF_CRG/20120502_FDF_CRG/20120504_FDF_CRG_c12.mtb	694	3454	WWSS	food_sc	3	139065	1336261251	1	0.18	0.000452261306532663	8945	1
4	Drink 2	Intake 2	37	139515	1336261701	/users/cn/jespinosa/phecomp/data/CRG/20120502_FDF_CRG/20120502_FDF_CRG/20120504_FDF_CRG_c12.mtb	697	NA	WWSS	water	2	139478	1336261664	1	0.14	0.00378378378378378	8946	1
4	Food 1	Intake 3	34	142951	1336265137	/users/cn/jespinosa/phecomp/data/CRG/20120502_FDF_CRG/20120502_FDF_CRG/20120504_FDF_CRG_c12.mtb	697	500	WWSS	food_sc	3	142917	1336265103	1	0.279999999999999	0.00823529411764703	8947	1
4	Drink 1	Intake 1	20	143441	1336265627	/users/cn/jespinosa/phecomp/data/CRG/20120502_FDF_CRG/20120502_FDF_CRG/20120504_FDF_CRG_c12.mtb	636	NA	WWSS	water	1	143421	1336265607	1	0.02	0.001	8948	1
4	Food 1	Intake 3	18	143469	1336265655	/users/cn/jespinosa/phecomp/data/CRG/20120502_FDF_CRG/20120502_FDF_CRG/20120504_FDF_CRG_c12.mtb	698	6025	WWSS	food_sc	3	143451	1336265637	1	0.0200000000000005	0.00111111111111114	8949	1
4	Drink 2	Intake 2	17	144283	1336266469	/users/cn/jespinosa/phecomp/data/CRG/20120502_FDF_CRG/20120502_FDF_CRG/20120504_FDF_CRG_c12.mtb	704	NA	WWSS	water	2	144266	1336266452	1	0.02	0.00117647058823529	8950	1
4	Drink 1	Intake 1	21	144758	1336266944	/users/cn/jespinosa/phecomp/data/CRG/20120502_FDF_CRG/20120502_FDF_CRG/20120504_FDF_CRG_c12.mtb	640	NA	WWSS	water	1	144737	1336266923	1	0.1	0.00476190476190476	8951	1
4	Food 1	Intake 3	107	149601	1336271787	/users/cn/jespinosa/phecomp/data/CRG/20120502_FDF_CRG/20120502_FDF_CRG/20120504_FDF_CRG_c12.mtb	714	129	WWSS	food_sc	3	149494	1336271680	1	0.04	0.000373831775700935	8952	1
4	Food 1	Intake 3	165	149895	1336272081	/users/cn/jespinosa/phecomp/data/CRG/20120502_FDF_CRG/20120502_FDF_CRG/20120504_FDF_CRG_c12.mtb	717	6	WWSS	food_sc	3	149730	1336271916	1	0.0599999999999996	0.000363636363636361	8953	1
4	Food 1	Intake 3	153	150054	1336272240	/users/cn/jespinosa/phecomp/data/CRG/20120502_FDF_CRG/20120502_FDF_CRG/20120504_FDF_CRG_c12.mtb	718	648	WWSS	food_sc	3	149901	1336272087	1	0.04	0.000261437908496732	8954	1
4	Drink 1	Intake 1	23	150202	1336272388	/users/cn/jespinosa/phecomp/data/CRG/20120502_FDF_CRG/20120502_FDF_CRG/20120504_FDF_CRG_c12.mtb	644	NA	WWSS	water	1	150179	1336272365	1	0.0800000000000001	0.00347826086956522	8955	1
4	Food 1	Intake 3	242	150944	1336273130	/users/cn/jespinosa/phecomp/data/CRG/20120502_FDF_CRG/20120502_FDF_CRG/20120504_FDF_CRG_c12.mtb	723	355	WWSS	food_sc	3	150702	1336272888	1	0.0800000000000001	0.000330578512396695	8956	1
4	Drink 1	Intake 1	28	150962	1336273148	/users/cn/jespinosa/phecomp/data/CRG/20120502_FDF_CRG/20120502_FDF_CRG/20120504_FDF_CRG_c12.mtb	646	NA	WWSS	water	1	150934	1336273120	1	0.16	0.00571428571428571	8957	1
4	Drink 1	Intake 1	17	151286	1336273472	/users/cn/jespinosa/phecomp/data/CRG/20120502_FDF_CRG/20120502_FDF_CRG/20120504_FDF_CRG_c12.mtb	647	NA	WWSS	water	1	151269	1336273455	1	0.02	0.00117647058823529	8958	1
4	Food 1	Intake 3	29	151328	1336273514	/users/cn/jespinosa/phecomp/data/CRG/20120502_FDF_CRG/20120502_FDF_CRG/20120504_FDF_CRG_c12.mtb	726	5504	WWSS	food_sc	3	151299	1336273485	1	0.0200000000000005	0.00068965517241381	8959	1
4	Food 1	Intake 3	180	157012	1336279198	/users/cn/jespinosa/phecomp/data/CRG/20120502_FDF_CRG/20120502_FDF_CRG/20120504_FDF_CRG_c12.mtb	730	20	WWSS	food_sc	3	156832	1336279018	1	0.04	0.000222222222222222	8960	1
4	Food 1	Intake 3	242	157274	1336279460	/users/cn/jespinosa/phecomp/data/CRG/20120502_FDF_CRG/20120502_FDF_CRG/20120504_FDF_CRG_c12.mtb	731	21	WWSS	food_sc	3	157032	1336279218	1	0.0599999999999996	0.000247933884297519	8961	1
4	Food 1	Intake 3	180	157475	1336279661	/users/cn/jespinosa/phecomp/data/CRG/20120502_FDF_CRG/20120502_FDF_CRG/20120504_FDF_CRG_c12.mtb	732	33	WWSS	food_sc	3	157295	1336279481	1	0.100000000000001	0.000555555555555561	8962	1
4	Food 1	Intake 3	170	157678	1336279864	/users/cn/jespinosa/phecomp/data/CRG/20120502_FDF_CRG/20120502_FDF_CRG/20120504_FDF_CRG_c12.mtb	733	648	WWSS	food_sc	3	157508	1336279694	1	0.0800000000000001	0.000470588235294118	8963	1
4	Drink 2	Intake 2	26	157706	1336279892	/users/cn/jespinosa/phecomp/data/CRG/20120502_FDF_CRG/20120502_FDF_CRG/20120504_FDF_CRG_c12.mtb	722	NA	WWSS	water	2	157680	1336279866	1	0.0800000000000001	0.00307692307692308	8964	1
4	Drink 2	Intake 2	27	157862	1336280048	/users/cn/jespinosa/phecomp/data/CRG/20120502_FDF_CRG/20120502_FDF_CRG/20120504_FDF_CRG_c12.mtb	723	NA	WWSS	water	2	157835	1336280021	1	0.0800000000000001	0.00296296296296297	8965	1
4	Food 1	Intake 3	343	158669	1336280855	/users/cn/jespinosa/phecomp/data/CRG/20120502_FDF_CRG/20120502_FDF_CRG/20120504_FDF_CRG_c12.mtb	736	88	WWSS	food_sc	3	158326	1336280512	1	0.0999999999999996	0.000291545189504372	8966	1
4	Drink 2	Intake 2	31	158694	1336280880	/users/cn/jespinosa/phecomp/data/CRG/20120502_FDF_CRG/20120502_FDF_CRG/20120504_FDF_CRG_c12.mtb	726	NA	WWSS	water	2	158663	1336280849	1	0.2	0.00645161290322581	8967	1
4	Food 1	Intake 3	123	158880	1336281066	/users/cn/jespinosa/phecomp/data/CRG/20120502_FDF_CRG/20120502_FDF_CRG/20120504_FDF_CRG_c12.mtb	737	3404	WWSS	food_sc	3	158757	1336280943	1	0.04	0.00032520325203252	8968	1
4	Drink 1	Intake 1	13	159713	1336281899	/users/cn/jespinosa/phecomp/data/CRG/20120502_FDF_CRG/20120502_FDF_CRG/20120504_FDF_CRG_c12.mtb	649	NA	WWSS	water	1	159700	1336281886	1	0.02	0.00153846153846154	8969	1
4	Food 1	Intake 3	48	162332	1336284518	/users/cn/jespinosa/phecomp/data/CRG/20120502_FDF_CRG/20120502_FDF_CRG/20120504_FDF_CRG_c12.mtb	738	433	WWSS	food_sc	3	162284	1336284470	1	0.0200000000000005	0.000416666666666677	8970	1
4	Food 1	Intake 3	169	162934	1336285120	/users/cn/jespinosa/phecomp/data/CRG/20120502_FDF_CRG/20120502_FDF_CRG/20120504_FDF_CRG_c12.mtb	740	9	WWSS	food_sc	3	162765	1336284951	1	0.04	0.000236686390532544	8971	1
4	Food 1	Intake 3	85	163028	1336285214	/users/cn/jespinosa/phecomp/data/CRG/20120502_FDF_CRG/20120502_FDF_CRG/20120504_FDF_CRG_c12.mtb	741	5	WWSS	food_sc	3	162943	1336285129	1	0.0599999999999996	0.000705882352941172	8972	1
4	Food 1	Intake 3	96	163129	1336285315	/users/cn/jespinosa/phecomp/data/CRG/20120502_FDF_CRG/20120502_FDF_CRG/20120504_FDF_CRG_c12.mtb	742	4	WWSS	food_sc	3	163033	1336285219	1	0.04	0.000416666666666667	8973	1
4	Food 1	Intake 3	152	163285	1336285471	/users/cn/jespinosa/phecomp/data/CRG/20120502_FDF_CRG/20120502_FDF_CRG/20120504_FDF_CRG_c12.mtb	743	10586	WWSS	food_sc	3	163133	1336285319	1	0.0600000000000005	0.000394736842105266	8974	1
4	Drink 2	Intake 2	20	164087	1336286273	/users/cn/jespinosa/phecomp/data/CRG/20120502_FDF_CRG/20120502_FDF_CRG/20120504_FDF_CRG_c12.mtb	731	NA	WWSS	water	2	164067	1336286253	1	0.0800000000000001	0.00400000000000001	8975	1
4	Food 1	Intake 3	30	173901	1336296087	/users/cn/jespinosa/phecomp/data/CRG/20120502_FDF_CRG/20120502_FDF_CRG/20120504_FDF_CRG_c12.mtb	749	18846	WWSS	food_sc	3	173871	1336296057	1	0.0200000000000005	0.000666666666666683	8976	1
4	Food 1	Intake 3	295	193042	1336315228	/users/cn/jespinosa/phecomp/data/CRG/20120502_FDF_CRG/20120502_FDF_CRG/20120504_FDF_CRG_c12.mtb	755	10115	WWSS	food_sc	3	192747	1336314933	1	0.0800000000000001	0.000271186440677966	8977	1
4	Food 1	Intake 3	61	203218	1336325404	/users/cn/jespinosa/phecomp/data/CRG/20120502_FDF_CRG/20120502_FDF_CRG/20120504_FDF_CRG_c12.mtb	758	1820	WWSS	food_sc	3	203157	1336325343	1	0.0200000000000005	0.000327868852459025	8978	1
4	Food 1	Intake 3	146	205184	1336327370	/users/cn/jespinosa/phecomp/data/CRG/20120502_FDF_CRG/20120502_FDF_CRG/20120504_FDF_CRG_c12.mtb	766	110	WWSS	food_sc	3	205038	1336327224	1	0.0200000000000005	0.000136986301369866	8979	1
4	Food 1	Intake 3	433	205727	1336327913	/users/cn/jespinosa/phecomp/data/CRG/20120502_FDF_CRG/20120502_FDF_CRG/20120504_FDF_CRG_c12.mtb	767	2266	WWSS	food_sc	3	205294	1336327480	1	0.12	0.000277136258660508	8980	1
4	Drink 1	Intake 1	23	206922	1336329108	/users/cn/jespinosa/phecomp/data/CRG/20120502_FDF_CRG/20120502_FDF_CRG/20120504_FDF_CRG_c12.mtb	651	NA	WWSS	water	1	206899	1336329085	1	0.0800000000000001	0.00347826086956522	8981	1
4	Drink 1	Intake 1	18	207980	1336330166	/users/cn/jespinosa/phecomp/data/CRG/20120502_FDF_CRG/20120502_FDF_CRG/20120504_FDF_CRG_c12.mtb	652	NA	WWSS	water	1	207962	1336330148	1	0.02	0.00111111111111111	8982	1
4	Food 1	Intake 3	429	208422	1336330608	/users/cn/jespinosa/phecomp/data/CRG/20120502_FDF_CRG/20120502_FDF_CRG/20120504_FDF_CRG_c12.mtb	770	44	WWSS	food_sc	3	207993	1336330179	1	0.18	0.00041958041958042	8983	1
4	Drink 2	Intake 2	33	208462	1336330648	/users/cn/jespinosa/phecomp/data/CRG/20120502_FDF_CRG/20120502_FDF_CRG/20120504_FDF_CRG_c12.mtb	739	NA	WWSS	water	2	208429	1336330615	1	0.1	0.00303030303030303	8984	1
4	Food 1	Intake 3	29	208495	1336330681	/users/cn/jespinosa/phecomp/data/CRG/20120502_FDF_CRG/20120502_FDF_CRG/20120504_FDF_CRG_c12.mtb	771	599	WWSS	food_sc	3	208466	1336330652	1	0.0200000000000005	0.00068965517241381	8985	1
4	Food 1	Intake 3	181	209275	1336331461	/users/cn/jespinosa/phecomp/data/CRG/20120502_FDF_CRG/20120502_FDF_CRG/20120504_FDF_CRG_c12.mtb	773	1123	WWSS	food_sc	3	209094	1336331280	1	0.0800000000000001	0.000441988950276244	8986	1
4	Drink 1	Intake 1	48	209316	1336331502	/users/cn/jespinosa/phecomp/data/CRG/20120502_FDF_CRG/20120502_FDF_CRG/20120504_FDF_CRG_c12.mtb	653	NA	WWSS	water	1	209268	1336331454	1	0.1	0.00208333333333333	8987	1
4	Drink 2	Intake 2	17	209776	1336331962	/users/cn/jespinosa/phecomp/data/CRG/20120502_FDF_CRG/20120502_FDF_CRG/20120504_FDF_CRG_c12.mtb	745	NA	WWSS	water	2	209759	1336331945	1	0.02	0.00117647058823529	8988	1
4	Drink 1	Intake 1	20	210139	1336332325	/users/cn/jespinosa/phecomp/data/CRG/20120502_FDF_CRG/20120502_FDF_CRG/20120504_FDF_CRG_c12.mtb	655	NA	WWSS	water	1	210119	1336332305	1	0.1	0.005	8989	1
4	Food 1	Intake 3	110	210508	1336332694	/users/cn/jespinosa/phecomp/data/CRG/20120502_FDF_CRG/20120502_FDF_CRG/20120504_FDF_CRG_c12.mtb	781	556	WWSS	food_sc	3	210398	1336332584	1	0.0200000000000005	0.000181818181818186	8990	1
4	Food 1	Intake 3	191	211255	1336333441	/users/cn/jespinosa/phecomp/data/CRG/20120502_FDF_CRG/20120502_FDF_CRG/20120504_FDF_CRG_c12.mtb	785	9	WWSS	food_sc	3	211064	1336333250	1	0.0999999999999996	0.000523560209424082	8991	1
4	Food 1	Intake 3	129	211393	1336333579	/users/cn/jespinosa/phecomp/data/CRG/20120502_FDF_CRG/20120502_FDF_CRG/20120504_FDF_CRG_c12.mtb	786	408	WWSS	food_sc	3	211264	1336333450	1	0.0600000000000005	0.000465116279069771	8992	1
4	Drink 1	Intake 1	22	211404	1336333590	/users/cn/jespinosa/phecomp/data/CRG/20120502_FDF_CRG/20120502_FDF_CRG/20120504_FDF_CRG_c12.mtb	656	NA	WWSS	water	1	211382	1336333568	1	0.1	0.00454545454545455	8993	1
4	Food 1	Intake 3	43	211844	1336334030	/users/cn/jespinosa/phecomp/data/CRG/20120502_FDF_CRG/20120502_FDF_CRG/20120504_FDF_CRG_c12.mtb	788	3515	WWSS	food_sc	3	211801	1336333987	1	0.3	0.00697674418604651	8994	1
4	Drink 2	Intake 2	56	212309	1336334495	/users/cn/jespinosa/phecomp/data/CRG/20120502_FDF_CRG/20120502_FDF_CRG/20120504_FDF_CRG_c12.mtb	750	NA	WWSS	water	2	212253	1336334439	1	0.14	0.0025	8995	1
4	Drink 2	Intake 2	15	213383	1336335569	/users/cn/jespinosa/phecomp/data/CRG/20120502_FDF_CRG/20120502_FDF_CRG/20120504_FDF_CRG_c12.mtb	758	NA	WWSS	water	2	213368	1336335554	1	0.0599999999999996	0.00399999999999997	8996	1
4	Food 2	Intake 4	344	215703	1336337889	/users/cn/jespinosa/phecomp/data/CRG/20120502_FDF_CRG/20120502_FDF_CRG/20120504_FDF_CRG_c12.mtb	1111	206	WWSS	food_sc	4	215359	1336337545	1	0.12	0.000348837209302326	8997	1
4	Drink 2	Intake 2	31	215729	1336337915	/users/cn/jespinosa/phecomp/data/CRG/20120502_FDF_CRG/20120502_FDF_CRG/20120504_FDF_CRG_c12.mtb	766	NA	WWSS	water	2	215698	1336337884	1	0.0800000000000001	0.00258064516129033	8998	1
4	Food 2	Intake 4	142	216051	1336338237	/users/cn/jespinosa/phecomp/data/CRG/20120502_FDF_CRG/20120502_FDF_CRG/20120504_FDF_CRG_c12.mtb	1114	716	WWSS	food_sc	4	215909	1336338095	1	0.02	0.000140845070422535	8999	1
4	Drink 2	Intake 2	13	216060	1336338246	/users/cn/jespinosa/phecomp/data/CRG/20120502_FDF_CRG/20120502_FDF_CRG/20120504_FDF_CRG_c12.mtb	768	NA	WWSS	water	2	216047	1336338233	1	0.02	0.00153846153846154	9000	1
4	Drink 1	Intake 1	14	216411	1336338597	/users/cn/jespinosa/phecomp/data/CRG/20120502_FDF_CRG/20120502_FDF_CRG/20120504_FDF_CRG_c12.mtb	660	NA	WWSS	water	1	216397	1336338583	1	0.0799999999999996	0.00571428571428569	9001	1
4	Food 2	Intake 4	89	216856	1336339042	/users/cn/jespinosa/phecomp/data/CRG/20120502_FDF_CRG/20120502_FDF_CRG/20120504_FDF_CRG_c12.mtb	1116	3390	WWSS	food_sc	4	216767	1336338953	1	0.02	0.000224719101123596	9002	1
4	Food 2	Intake 4	519	220765	1336342951	/users/cn/jespinosa/phecomp/data/CRG/20120502_FDF_CRG/20120502_FDF_CRG/20120504_FDF_CRG_c12.mtb	1118	541	WWSS	food_sc	4	220246	1336342432	1	0.26	0.000500963391136802	9003	1
4	Drink 2	Intake 2	25	220790	1336342976	/users/cn/jespinosa/phecomp/data/CRG/20120502_FDF_CRG/20120502_FDF_CRG/20120504_FDF_CRG_c12.mtb	770	NA	WWSS	water	2	220765	1336342951	1	0.0600000000000001	0.0024	9004	1
4	Drink 1	Intake 1	21	221101	1336343287	/users/cn/jespinosa/phecomp/data/CRG/20120502_FDF_CRG/20120502_FDF_CRG/20120504_FDF_CRG_c12.mtb	664	NA	WWSS	water	1	221080	1336343266	1	0.0800000000000001	0.00380952380952381	9005	1
4	Food 2	Intake 4	118	221424	1336343610	/users/cn/jespinosa/phecomp/data/CRG/20120502_FDF_CRG/20120502_FDF_CRG/20120504_FDF_CRG_c12.mtb	1122	220	WWSS	food_sc	4	221306	1336343492	1	0.02	0.000169491525423729	9006	1
4	Drink 1	Intake 1	17	221468	1336343654	/users/cn/jespinosa/phecomp/data/CRG/20120502_FDF_CRG/20120502_FDF_CRG/20120504_FDF_CRG_c12.mtb	665	NA	WWSS	water	1	221451	1336343637	1	0.0800000000000001	0.00470588235294118	9007	1
4	Food 2	Intake 4	129	221773	1336343959	/users/cn/jespinosa/phecomp/data/CRG/20120502_FDF_CRG/20120502_FDF_CRG/20120504_FDF_CRG_c12.mtb	1123	589	WWSS	food_sc	4	221644	1336343830	1	0.04	0.000310077519379845	9008	1
4	Drink 2	Intake 2	41	222012	1336344198	/users/cn/jespinosa/phecomp/data/CRG/20120502_FDF_CRG/20120502_FDF_CRG/20120504_FDF_CRG_c12.mtb	776	NA	WWSS	water	2	221971	1336344157	1	0.0800000000000001	0.00195121951219512	9009	1
4	Food 2	Intake 4	21	222383	1336344569	/users/cn/jespinosa/phecomp/data/CRG/20120502_FDF_CRG/20120502_FDF_CRG/20120504_FDF_CRG_c12.mtb	1125	53	WWSS	food_sc	4	222362	1336344548	1	0.02	0.000952380952380952	9010	1
4	Food 2	Intake 4	171	222607	1336344793	/users/cn/jespinosa/phecomp/data/CRG/20120502_FDF_CRG/20120502_FDF_CRG/20120504_FDF_CRG_c12.mtb	1126	977	WWSS	food_sc	4	222436	1336344622	1	0.0799999999999998	0.00046783625730994	9011	1
4	Drink 2	Intake 2	23	222895	1336345081	/users/cn/jespinosa/phecomp/data/CRG/20120502_FDF_CRG/20120502_FDF_CRG/20120504_FDF_CRG_c12.mtb	778	NA	WWSS	water	2	222872	1336345058	1	0.0600000000000001	0.00260869565217392	9012	1
4	Drink 1	Intake 1	28	223442	1336345628	/users/cn/jespinosa/phecomp/data/CRG/20120502_FDF_CRG/20120502_FDF_CRG/20120504_FDF_CRG_c12.mtb	666	NA	WWSS	water	1	223414	1336345600	1	0.02	0.000714285714285714	9013	1
4	Food 2	Intake 4	286	223870	1336346056	/users/cn/jespinosa/phecomp/data/CRG/20120502_FDF_CRG/20120502_FDF_CRG/20120504_FDF_CRG_c12.mtb	1131	2237	WWSS	food_sc	4	223584	1336345770	1	0.12	0.00041958041958042	9014	1
4	Drink 1	Intake 1	23	223946	1336346132	/users/cn/jespinosa/phecomp/data/CRG/20120502_FDF_CRG/20120502_FDF_CRG/20120504_FDF_CRG_c12.mtb	667	NA	WWSS	water	1	223923	1336346109	1	0.14	0.00608695652173913	9015	1
4	Food 2	Intake 4	136	226243	1336348429	/users/cn/jespinosa/phecomp/data/CRG/20120502_FDF_CRG/20120502_FDF_CRG/20120504_FDF_CRG_c12.mtb	1137	9517	WWSS	food_sc	4	226107	1336348293	1	0.28	0.00205882352941176	9016	1
4	Drink 2	Intake 2	31	226593	1336348779	/users/cn/jespinosa/phecomp/data/CRG/20120502_FDF_CRG/20120502_FDF_CRG/20120504_FDF_CRG_c12.mtb	787	NA	WWSS	water	2	226562	1336348748	1	0.14	0.00451612903225806	9017	1
4	Drink 2	Intake 2	22	227463	1336349649	/users/cn/jespinosa/phecomp/data/CRG/20120502_FDF_CRG/20120502_FDF_CRG/20120504_FDF_CRG_c12.mtb	790	NA	WWSS	water	2	227441	1336349627	1	0.0599999999999996	0.00272727272727271	9018	1
4	Drink 2	Intake 2	23	229933	1336352119	/users/cn/jespinosa/phecomp/data/CRG/20120502_FDF_CRG/20120502_FDF_CRG/20120504_FDF_CRG_c12.mtb	793	NA	WWSS	water	2	229910	1336352096	1	0.02	0.000869565217391304	9019	1
4	Drink 1	Intake 1	26	230024	1336352210	/users/cn/jespinosa/phecomp/data/CRG/20120502_FDF_CRG/20120502_FDF_CRG/20120504_FDF_CRG_c12.mtb	673	NA	WWSS	water	1	229998	1336352184	1	0.0200000000000005	0.000769230769230788	9020	1
4	Food 2	Intake 4	415	236175	1336358361	/users/cn/jespinosa/phecomp/data/CRG/20120502_FDF_CRG/20120502_FDF_CRG/20120504_FDF_CRG_c12.mtb	1151	59	WWSS	food_sc	4	235760	1336357946	1	0.04	9.63855421686747e-05	9021	1
4	Food 2	Intake 4	210	236444	1336358630	/users/cn/jespinosa/phecomp/data/CRG/20120502_FDF_CRG/20120502_FDF_CRG/20120504_FDF_CRG_c12.mtb	1153	5908	WWSS	food_sc	4	236234	1336358420	1	0.04	0.00019047619047619	9022	1
4	Drink 1	Intake 1	17	237099	1336359285	/users/cn/jespinosa/phecomp/data/CRG/20120502_FDF_CRG/20120502_FDF_CRG/20120504_FDF_CRG_c12.mtb	679	NA	WWSS	water	1	237082	1336359268	1	0.0200000000000005	0.00117647058823532	9023	1
4	Food 2	Intake 4	539	242891	1336365077	/users/cn/jespinosa/phecomp/data/CRG/20120502_FDF_CRG/20120502_FDF_CRG/20120504_FDF_CRG_c12.mtb	1165	190	WWSS	food_sc	4	242352	1336364538	1	0.18	0.000333951762523191	9024	1
4	Drink 2	Intake 2	15	242915	1336365101	/users/cn/jespinosa/phecomp/data/CRG/20120502_FDF_CRG/20120502_FDF_CRG/20120504_FDF_CRG_c12.mtb	807	NA	WWSS	water	2	242900	1336365086	1	0.04	0.00266666666666667	9025	1
4	Food 2	Intake 4	79	243160	1336365346	/users/cn/jespinosa/phecomp/data/CRG/20120502_FDF_CRG/20120502_FDF_CRG/20120504_FDF_CRG_c12.mtb	1167	6620	WWSS	food_sc	4	243081	1336365267	1	0.02	0.000253164556962025	9026	1
4	Drink 1	Intake 1	20	243247	1336365433	/users/cn/jespinosa/phecomp/data/CRG/20120502_FDF_CRG/20120502_FDF_CRG/20120504_FDF_CRG_c12.mtb	684	NA	WWSS	water	1	243227	1336365413	1	0.0999999999999996	0.00499999999999998	9027	1
4	Drink 2	Intake 2	58	243408	1336365594	/users/cn/jespinosa/phecomp/data/CRG/20120502_FDF_CRG/20120502_FDF_CRG/20120504_FDF_CRG_c12.mtb	810	NA	WWSS	water	2	243350	1336365536	1	0.02	0.000344827586206897	9028	1
4	Drink 2	Intake 2	32	243507	1336365693	/users/cn/jespinosa/phecomp/data/CRG/20120502_FDF_CRG/20120502_FDF_CRG/20120504_FDF_CRG_c12.mtb	811	NA	WWSS	water	2	243475	1336365661	1	0.0800000000000001	0.0025	9029	1
4	Drink 2	Intake 2	47	244317	1336366503	/users/cn/jespinosa/phecomp/data/CRG/20120502_FDF_CRG/20120502_FDF_CRG/20120504_FDF_CRG_c12.mtb	814	NA	WWSS	water	2	244270	1336366456	1	0.02	0.000425531914893617	9030	1
4	Food 2	Intake 4	17	249797	1336371983	/users/cn/jespinosa/phecomp/data/CRG/20120502_FDF_CRG/20120502_FDF_CRG/20120504_FDF_CRG_c12.mtb	1175	4494	WWSS	food_sc	4	249780	1336371966	1	0.02	0.00117647058823529	9031	1
4	Food 2	Intake 4	406	254697	1336376883	/users/cn/jespinosa/phecomp/data/CRG/20120502_FDF_CRG/20120502_FDF_CRG/20120504_FDF_CRG_c12.mtb	1182	8601	WWSS	food_sc	4	254291	1336376477	1	0.1	0.000246305418719212	9032	1
4	Food 1	Intake 3	262	3235	1336385746	/users/cn/jespinosa/phecomp/data/CRG/20120502_FDF_CRG/20120502_FDF_CRG/20120507_FDF_CRG_c12.mtb	924	2930	WWSS	food_sc	3	2973	1336385484	1	0.08	0.000305343511450382	9033	1
4	Drink 2	Intake 2	43	3339	1336385850	/users/cn/jespinosa/phecomp/data/CRG/20120502_FDF_CRG/20120502_FDF_CRG/20120507_FDF_CRG_c12.mtb	921	NA	WWSS	water	2	3296	1336385807	1	0.02	0.000465116279069767	9034	1
4	Food 1	Intake 3	207	6372	1336388883	/users/cn/jespinosa/phecomp/data/CRG/20120502_FDF_CRG/20120502_FDF_CRG/20120507_FDF_CRG_c12.mtb	927	7	WWSS	food_sc	3	6165	1336388676	1	0.06	0.000289855072463768	9035	1
4	Food 1	Intake 3	362	6741	1336389252	/users/cn/jespinosa/phecomp/data/CRG/20120502_FDF_CRG/20120502_FDF_CRG/20120507_FDF_CRG_c12.mtb	928	10336	WWSS	food_sc	3	6379	1336388890	1	0.14	0.000386740331491713	9036	1
4	Drink 2	Intake 2	28	6765	1336389276	/users/cn/jespinosa/phecomp/data/CRG/20120502_FDF_CRG/20120502_FDF_CRG/20120507_FDF_CRG_c12.mtb	922	NA	WWSS	water	2	6737	1336389248	1	0.08	0.00285714285714286	9037	1
4	Drink 1	Intake 1	13	7353	1336389864	/users/cn/jespinosa/phecomp/data/CRG/20120502_FDF_CRG/20120502_FDF_CRG/20120507_FDF_CRG_c12.mtb	917	NA	WWSS	water	1	7340	1336389851	1	0.06	0.00461538461538461	9038	1
4	Food 1	Intake 3	25	17102	1336399613	/users/cn/jespinosa/phecomp/data/CRG/20120502_FDF_CRG/20120502_FDF_CRG/20120507_FDF_CRG_c12.mtb	929	746	WWSS	food_sc	3	17077	1336399588	1	0.02	0.0008	9039	1
4	Food 2	Intake 4	63	17911	1336400422	/users/cn/jespinosa/phecomp/data/CRG/20120502_FDF_CRG/20120502_FDF_CRG/20120507_FDF_CRG_c12.mtb	1353	7617	WWSS	food_sc	4	17848	1336400359	1	0.02	0.000317460317460317	9040	1
4	Food 1	Intake 3	229	25757	1336408268	/users/cn/jespinosa/phecomp/data/CRG/20120502_FDF_CRG/20120502_FDF_CRG/20120507_FDF_CRG_c12.mtb	931	3962	WWSS	food_sc	3	25528	1336408039	1	0.04	0.000174672489082969	9041	1
4	Drink 2	Intake 2	16	25838	1336408349	/users/cn/jespinosa/phecomp/data/CRG/20120502_FDF_CRG/20120502_FDF_CRG/20120507_FDF_CRG_c12.mtb	923	NA	WWSS	water	2	25822	1336408333	1	0.02	0.00125	9042	1
4	Food 1	Intake 3	636	30355	1336412866	/users/cn/jespinosa/phecomp/data/CRG/20120502_FDF_CRG/20120502_FDF_CRG/20120507_FDF_CRG_c12.mtb	932	2005	WWSS	food_sc	3	29719	1336412230	1	0.14	0.000220125786163522	9043	1
4	Drink 1	Intake 1	20	31768	1336414279	/users/cn/jespinosa/phecomp/data/CRG/20120502_FDF_CRG/20120502_FDF_CRG/20120507_FDF_CRG_c12.mtb	918	NA	WWSS	water	1	31748	1336414259	1	0.06	0.003	9044	1
4	Food 1	Intake 3	206	32566	1336415077	/users/cn/jespinosa/phecomp/data/CRG/20120502_FDF_CRG/20120502_FDF_CRG/20120507_FDF_CRG_c12.mtb	934	83	WWSS	food_sc	3	32360	1336414871	1	0.02	9.70873786407767e-05	9045	1
4	Food 1	Intake 3	141	32790	1336415301	/users/cn/jespinosa/phecomp/data/CRG/20120502_FDF_CRG/20120502_FDF_CRG/20120507_FDF_CRG_c12.mtb	935	196	WWSS	food_sc	3	32649	1336415160	1	0.02	0.000141843971631206	9046	1
4	Food 2	Intake 4	215	33201	1336415712	/users/cn/jespinosa/phecomp/data/CRG/20120502_FDF_CRG/20120502_FDF_CRG/20120507_FDF_CRG_c12.mtb	1361	95	WWSS	food_sc	4	32986	1336415497	1	0.1	0.000465116279069767	9047	1
4	Drink 2	Intake 2	20	33261	1336415772	/users/cn/jespinosa/phecomp/data/CRG/20120502_FDF_CRG/20120502_FDF_CRG/20120507_FDF_CRG_c12.mtb	925	NA	WWSS	water	2	33241	1336415752	1	0.02	0.001	9048	1
4	Food 2	Intake 4	167	33463	1336415974	/users/cn/jespinosa/phecomp/data/CRG/20120502_FDF_CRG/20120502_FDF_CRG/20120507_FDF_CRG_c12.mtb	1363	554	WWSS	food_sc	4	33296	1336415807	1	0.08	0.000479041916167665	9049	1
4	Drink 1	Intake 1	21	33480	1336415991	/users/cn/jespinosa/phecomp/data/CRG/20120502_FDF_CRG/20120502_FDF_CRG/20120507_FDF_CRG_c12.mtb	921	NA	WWSS	water	1	33459	1336415970	1	0.06	0.00285714285714286	9050	1
4	Food 2	Intake 4	107	34124	1336416635	/users/cn/jespinosa/phecomp/data/CRG/20120502_FDF_CRG/20120502_FDF_CRG/20120507_FDF_CRG_c12.mtb	1364	115	WWSS	food_sc	4	34017	1336416528	1	0.02	0.000186915887850467	9051	1
4	Drink 2	Intake 2	18	34147	1336416658	/users/cn/jespinosa/phecomp/data/CRG/20120502_FDF_CRG/20120502_FDF_CRG/20120507_FDF_CRG_c12.mtb	926	NA	WWSS	water	2	34129	1336416640	1	0.04	0.00222222222222222	9052	1
4	Food 2	Intake 4	71	34310	1336416821	/users/cn/jespinosa/phecomp/data/CRG/20120502_FDF_CRG/20120502_FDF_CRG/20120507_FDF_CRG_c12.mtb	1365	370	WWSS	food_sc	4	34239	1336416750	1	0.02	0.00028169014084507	9053	1
4	Drink 1	Intake 1	23	34351	1336416862	/users/cn/jespinosa/phecomp/data/CRG/20120502_FDF_CRG/20120502_FDF_CRG/20120507_FDF_CRG_c12.mtb	922	NA	WWSS	water	1	34328	1336416839	1	0.02	0.000869565217391304	9054	1
4	Drink 2	Intake 2	18	34570	1336417081	/users/cn/jespinosa/phecomp/data/CRG/20120502_FDF_CRG/20120502_FDF_CRG/20120507_FDF_CRG_c12.mtb	929	NA	WWSS	water	2	34552	1336417063	1	0.04	0.00222222222222222	9055	1
4	Food 2	Intake 4	89	34769	1336417280	/users/cn/jespinosa/phecomp/data/CRG/20120502_FDF_CRG/20120502_FDF_CRG/20120507_FDF_CRG_c12.mtb	1367	286	WWSS	food_sc	4	34680	1336417191	1	0.02	0.000224719101123596	9056	1
4	Drink 1	Intake 1	17	35064	1336417575	/users/cn/jespinosa/phecomp/data/CRG/20120502_FDF_CRG/20120502_FDF_CRG/20120507_FDF_CRG_c12.mtb	924	NA	WWSS	water	1	35047	1336417558	1	0.04	0.00235294117647059	9057	1
4	Food 2	Intake 4	217	35272	1336417783	/users/cn/jespinosa/phecomp/data/CRG/20120502_FDF_CRG/20120502_FDF_CRG/20120507_FDF_CRG_c12.mtb	1368	154	WWSS	food_sc	4	35055	1336417566	1	0.06	0.000276497695852535	9058	1
4	Food 2	Intake 4	297	35723	1336418234	/users/cn/jespinosa/phecomp/data/CRG/20120502_FDF_CRG/20120502_FDF_CRG/20120507_FDF_CRG_c12.mtb	1370	83	WWSS	food_sc	4	35426	1336417937	1	0.1	0.000336700336700337	9059	1
4	Drink 1	Intake 1	36	35765	1336418276	/users/cn/jespinosa/phecomp/data/CRG/20120502_FDF_CRG/20120502_FDF_CRG/20120507_FDF_CRG_c12.mtb	925	NA	WWSS	water	1	35729	1336418240	1	0.12	0.00333333333333333	9060	1
4	Drink 2	Intake 2	27	35817	1336418328	/users/cn/jespinosa/phecomp/data/CRG/20120502_FDF_CRG/20120502_FDF_CRG/20120507_FDF_CRG_c12.mtb	931	NA	WWSS	water	2	35790	1336418301	1	0.02	0.000740740740740741	9061	1
4	Food 2	Intake 4	171	35977	1336418488	/users/cn/jespinosa/phecomp/data/CRG/20120502_FDF_CRG/20120502_FDF_CRG/20120507_FDF_CRG_c12.mtb	1371	344	WWSS	food_sc	4	35806	1336418317	1	0.06	0.000350877192982456	9062	1
4	Drink 2	Intake 2	33	36060	1336418571	/users/cn/jespinosa/phecomp/data/CRG/20120502_FDF_CRG/20120502_FDF_CRG/20120507_FDF_CRG_c12.mtb	932	NA	WWSS	water	2	36027	1336418538	1	0.06	0.00181818181818182	9063	1
4	Drink 1	Intake 1	16	36183	1336418694	/users/cn/jespinosa/phecomp/data/CRG/20120502_FDF_CRG/20120502_FDF_CRG/20120507_FDF_CRG_c12.mtb	927	NA	WWSS	water	1	36167	1336418678	1	0.02	0.00125	9064	1
4	Food 2	Intake 4	90	36411	1336418922	/users/cn/jespinosa/phecomp/data/CRG/20120502_FDF_CRG/20120502_FDF_CRG/20120507_FDF_CRG_c12.mtb	1373	112	WWSS	food_sc	4	36321	1336418832	1	0.02	0.000222222222222222	9065	1
4	Drink 2	Intake 2	16	36513	1336419024	/users/cn/jespinosa/phecomp/data/CRG/20120502_FDF_CRG/20120502_FDF_CRG/20120507_FDF_CRG_c12.mtb	934	NA	WWSS	water	2	36497	1336419008	1	0.02	0.00125	9066	1
4	Food 2	Intake 4	80	36603	1336419114	/users/cn/jespinosa/phecomp/data/CRG/20120502_FDF_CRG/20120502_FDF_CRG/20120507_FDF_CRG_c12.mtb	1374	541	WWSS	food_sc	4	36523	1336419034	1	0.02	0.00025	9067	1
4	Drink 1	Intake 1	33	37065	1336419576	/users/cn/jespinosa/phecomp/data/CRG/20120502_FDF_CRG/20120502_FDF_CRG/20120507_FDF_CRG_c12.mtb	928	NA	WWSS	water	1	37032	1336419543	1	0.04	0.00121212121212121	9068	1
4	Drink 2	Intake 2	15	37089	1336419600	/users/cn/jespinosa/phecomp/data/CRG/20120502_FDF_CRG/20120502_FDF_CRG/20120507_FDF_CRG_c12.mtb	937	NA	WWSS	water	2	37074	1336419585	1	0.04	0.00266666666666667	9069	1
4	Food 2	Intake 4	239	37383	1336419894	/users/cn/jespinosa/phecomp/data/CRG/20120502_FDF_CRG/20120502_FDF_CRG/20120507_FDF_CRG_c12.mtb	1377	1378	WWSS	food_sc	4	37144	1336419655	1	0.1	0.000418410041841004	9070	1
4	Drink 2	Intake 2	21	37403	1336419914	/users/cn/jespinosa/phecomp/data/CRG/20120502_FDF_CRG/20120502_FDF_CRG/20120507_FDF_CRG_c12.mtb	938	NA	WWSS	water	2	37382	1336419893	1	0.06	0.00285714285714286	9071	1
4	Drink 1	Intake 1	23	37977	1336420488	/users/cn/jespinosa/phecomp/data/CRG/20120502_FDF_CRG/20120502_FDF_CRG/20120507_FDF_CRG_c12.mtb	929	NA	WWSS	water	1	37954	1336420465	1	0.08	0.00347826086956522	9072	1
4	Drink 2	Intake 2	17	38589	1336421100	/users/cn/jespinosa/phecomp/data/CRG/20120502_FDF_CRG/20120502_FDF_CRG/20120507_FDF_CRG_c12.mtb	940	NA	WWSS	water	2	38572	1336421083	1	0.02	0.00117647058823529	9073	1
4	Food 2	Intake 4	124	38885	1336421396	/users/cn/jespinosa/phecomp/data/CRG/20120502_FDF_CRG/20120502_FDF_CRG/20120507_FDF_CRG_c12.mtb	1381	8	WWSS	food_sc	4	38761	1336421272	1	0.0600000000000001	0.000483870967741936	9074	1
4	Food 2	Intake 4	189	39082	1336421593	/users/cn/jespinosa/phecomp/data/CRG/20120502_FDF_CRG/20120502_FDF_CRG/20120507_FDF_CRG_c12.mtb	1382	14	WWSS	food_sc	4	38893	1336421404	1	0.08	0.000423280423280423	9075	1
4	Food 2	Intake 4	18	39114	1336421625	/users/cn/jespinosa/phecomp/data/CRG/20120502_FDF_CRG/20120502_FDF_CRG/20120507_FDF_CRG_c12.mtb	1383	5	WWSS	food_sc	4	39096	1336421607	1	0.02	0.00111111111111111	9076	1
4	Food 2	Intake 4	83	39202	1336421713	/users/cn/jespinosa/phecomp/data/CRG/20120502_FDF_CRG/20120502_FDF_CRG/20120507_FDF_CRG_c12.mtb	1384	685	WWSS	food_sc	4	39119	1336421630	1	0.0399999999999999	0.000481927710843372	9077	1
4	Drink 2	Intake 2	26	39232	1336421743	/users/cn/jespinosa/phecomp/data/CRG/20120502_FDF_CRG/20120502_FDF_CRG/20120507_FDF_CRG_c12.mtb	941	NA	WWSS	water	2	39206	1336421717	1	0.12	0.00461538461538461	9078	1
4	Drink 1	Intake 1	48	39824	1336422335	/users/cn/jespinosa/phecomp/data/CRG/20120502_FDF_CRG/20120502_FDF_CRG/20120507_FDF_CRG_c12.mtb	933	NA	WWSS	water	1	39776	1336422287	1	0.02	0.000416666666666667	9079	1
4	Food 2	Intake 4	89	39976	1336422487	/users/cn/jespinosa/phecomp/data/CRG/20120502_FDF_CRG/20120502_FDF_CRG/20120507_FDF_CRG_c12.mtb	1388	24	WWSS	food_sc	4	39887	1336422398	1	0.04	0.000449438202247191	9080	1
4	Drink 1	Intake 1	16	39985	1336422496	/users/cn/jespinosa/phecomp/data/CRG/20120502_FDF_CRG/20120502_FDF_CRG/20120507_FDF_CRG_c12.mtb	934	NA	WWSS	water	1	39969	1336422480	1	0.0599999999999999	0.00374999999999999	9081	1
4	Food 2	Intake 4	118	40118	1336422629	/users/cn/jespinosa/phecomp/data/CRG/20120502_FDF_CRG/20120502_FDF_CRG/20120507_FDF_CRG_c12.mtb	1389	844	WWSS	food_sc	4	40000	1336422511	1	0.02	0.000169491525423729	9082	1
4	Food 2	Intake 4	185	41147	1336423658	/users/cn/jespinosa/phecomp/data/CRG/20120502_FDF_CRG/20120502_FDF_CRG/20120507_FDF_CRG_c12.mtb	1393	918	WWSS	food_sc	4	40962	1336423473	1	0.0599999999999999	0.000324324324324324	9083	1
4	Drink 2	Intake 2	23	41172	1336423683	/users/cn/jespinosa/phecomp/data/CRG/20120502_FDF_CRG/20120502_FDF_CRG/20120507_FDF_CRG_c12.mtb	945	NA	WWSS	water	2	41149	1336423660	1	0.0600000000000001	0.00260869565217392	9084	1
4	Drink 1	Intake 1	25	41327	1336423838	/users/cn/jespinosa/phecomp/data/CRG/20120502_FDF_CRG/20120502_FDF_CRG/20120507_FDF_CRG_c12.mtb	937	NA	WWSS	water	1	41302	1336423813	1	0.02	0.0008	9085	1
4	Drink 2	Intake 2	20	41332	1336423843	/users/cn/jespinosa/phecomp/data/CRG/20120502_FDF_CRG/20120502_FDF_CRG/20120507_FDF_CRG_c12.mtb	947	NA	WWSS	water	2	41312	1336423823	1	0.02	0.001	9086	1
4	Food 2	Intake 4	139	42204	1336424715	/users/cn/jespinosa/phecomp/data/CRG/20120502_FDF_CRG/20120502_FDF_CRG/20120507_FDF_CRG_c12.mtb	1395	32	WWSS	food_sc	4	42065	1336424576	1	0.04	0.000287769784172662	9087	1
4	Food 2	Intake 4	261	42497	1336425008	/users/cn/jespinosa/phecomp/data/CRG/20120502_FDF_CRG/20120502_FDF_CRG/20120507_FDF_CRG_c12.mtb	1396	6	WWSS	food_sc	4	42236	1336424747	1	0.12	0.000459770114942529	9088	1
4	Food 2	Intake 4	147	42650	1336425161	/users/cn/jespinosa/phecomp/data/CRG/20120502_FDF_CRG/20120502_FDF_CRG/20120507_FDF_CRG_c12.mtb	1397	2622	WWSS	food_sc	4	42503	1336425014	1	0.0799999999999998	0.000544217687074829	9089	1
4	Drink 1	Intake 1	30	42678	1336425189	/users/cn/jespinosa/phecomp/data/CRG/20120502_FDF_CRG/20120502_FDF_CRG/20120507_FDF_CRG_c12.mtb	944	NA	WWSS	water	1	42648	1336425159	1	0.1	0.00333333333333333	9090	1
4	Drink 2	Intake 2	15	43001	1336425512	/users/cn/jespinosa/phecomp/data/CRG/20120502_FDF_CRG/20120502_FDF_CRG/20120507_FDF_CRG_c12.mtb	950	NA	WWSS	water	2	42986	1336425497	1	0.02	0.00133333333333333	9091	1
4	Drink 1	Intake 1	21	43573	1336426084	/users/cn/jespinosa/phecomp/data/CRG/20120502_FDF_CRG/20120502_FDF_CRG/20120507_FDF_CRG_c12.mtb	946	NA	WWSS	water	1	43552	1336426063	1	0.04	0.0019047619047619	9092	1
4	Food 2	Intake 4	57	45329	1336427840	/users/cn/jespinosa/phecomp/data/CRG/20120502_FDF_CRG/20120502_FDF_CRG/20120507_FDF_CRG_c12.mtb	1402	759	WWSS	food_sc	4	45272	1336427783	1	0.02	0.000350877192982456	9093	1
4	Food 2	Intake 4	20	46108	1336428619	/users/cn/jespinosa/phecomp/data/CRG/20120502_FDF_CRG/20120502_FDF_CRG/20120507_FDF_CRG_c12.mtb	1404	120	WWSS	food_sc	4	46088	1336428599	1	0.02	0.001	9094	1
4	Food 2	Intake 4	153	46381	1336428892	/users/cn/jespinosa/phecomp/data/CRG/20120502_FDF_CRG/20120502_FDF_CRG/20120507_FDF_CRG_c12.mtb	1405	1316	WWSS	food_sc	4	46228	1336428739	1	0.02	0.000130718954248366	9095	1
4	Food 2	Intake 4	328	48025	1336430536	/users/cn/jespinosa/phecomp/data/CRG/20120502_FDF_CRG/20120502_FDF_CRG/20120507_FDF_CRG_c12.mtb	1408	335	WWSS	food_sc	4	47697	1336430208	1	0.0600000000000001	0.000182926829268293	9096	1
4	Drink 2	Intake 2	25	48371	1336430882	/users/cn/jespinosa/phecomp/data/CRG/20120502_FDF_CRG/20120502_FDF_CRG/20120507_FDF_CRG_c12.mtb	954	NA	WWSS	water	2	48346	1336430857	1	0.0800000000000001	0.0032	9097	1
4	Food 2	Intake 4	245	48605	1336431116	/users/cn/jespinosa/phecomp/data/CRG/20120502_FDF_CRG/20120502_FDF_CRG/20120507_FDF_CRG_c12.mtb	1411	342	WWSS	food_sc	4	48360	1336430871	1	0.0599999999999998	0.000244897959183673	9098	1
4	Drink 2	Intake 2	26	48897	1336431408	/users/cn/jespinosa/phecomp/data/CRG/20120502_FDF_CRG/20120502_FDF_CRG/20120507_FDF_CRG_c12.mtb	955	NA	WWSS	water	2	48871	1336431382	1	0.0399999999999999	0.00153846153846153	9099	1
4	Food 2	Intake 4	59	49006	1336431517	/users/cn/jespinosa/phecomp/data/CRG/20120502_FDF_CRG/20120502_FDF_CRG/20120507_FDF_CRG_c12.mtb	1415	847	WWSS	food_sc	4	48947	1336431458	1	0.02	0.000338983050847458	9100	1
4	Drink 1	Intake 1	41	49177	1336431688	/users/cn/jespinosa/phecomp/data/CRG/20120502_FDF_CRG/20120502_FDF_CRG/20120507_FDF_CRG_c12.mtb	953	NA	WWSS	water	1	49136	1336431647	1	0.0600000000000001	0.00146341463414634	9101	1
4	Food 2	Intake 4	249	50102	1336432613	/users/cn/jespinosa/phecomp/data/CRG/20120502_FDF_CRG/20120502_FDF_CRG/20120507_FDF_CRG_c12.mtb	1421	195	WWSS	food_sc	4	49853	1336432364	1	0.04	0.000160642570281124	9102	1
4	Drink 1	Intake 1	32	50297	1336432808	/users/cn/jespinosa/phecomp/data/CRG/20120502_FDF_CRG/20120502_FDF_CRG/20120507_FDF_CRG_c12.mtb	954	NA	WWSS	water	1	50265	1336432776	1	0.12	0.00375	9103	1
4	Food 2	Intake 4	392	50689	1336433200	/users/cn/jespinosa/phecomp/data/CRG/20120502_FDF_CRG/20120502_FDF_CRG/20120507_FDF_CRG_c12.mtb	1423	153	WWSS	food_sc	4	50297	1336432808	1	0.14	0.000357142857142857	9104	1
4	Drink 2	Intake 2	14	50699	1336433210	/users/cn/jespinosa/phecomp/data/CRG/20120502_FDF_CRG/20120502_FDF_CRG/20120507_FDF_CRG_c12.mtb	960	NA	WWSS	water	2	50685	1336433196	1	0.0600000000000001	0.00428571428571429	9105	1
4	Food 2	Intake 4	170	51012	1336433523	/users/cn/jespinosa/phecomp/data/CRG/20120502_FDF_CRG/20120502_FDF_CRG/20120507_FDF_CRG_c12.mtb	1425	20	WWSS	food_sc	4	50842	1336433353	1	0.04	0.000235294117647059	9106	1
4	Drink 2	Intake 2	23	51035	1336433546	/users/cn/jespinosa/phecomp/data/CRG/20120502_FDF_CRG/20120502_FDF_CRG/20120507_FDF_CRG_c12.mtb	961	NA	WWSS	water	2	51012	1336433523	1	0.04	0.00173913043478261	9107	1
4	Food 2	Intake 4	165	51197	1336433708	/users/cn/jespinosa/phecomp/data/CRG/20120502_FDF_CRG/20120502_FDF_CRG/20120507_FDF_CRG_c12.mtb	1426	2637	WWSS	food_sc	4	51032	1336433543	1	0.0800000000000001	0.000484848484848485	9108	1
4	Drink 2	Intake 2	29	51224	1336433735	/users/cn/jespinosa/phecomp/data/CRG/20120502_FDF_CRG/20120502_FDF_CRG/20120507_FDF_CRG_c12.mtb	962	NA	WWSS	water	2	51195	1336433706	1	0.0599999999999999	0.00206896551724138	9109	1
4	Drink 1	Intake 1	33	51559	1336434070	/users/cn/jespinosa/phecomp/data/CRG/20120502_FDF_CRG/20120502_FDF_CRG/20120507_FDF_CRG_c12.mtb	956	NA	WWSS	water	1	51526	1336434037	1	0.08	0.00242424242424242	9110	1
4	Drink 2	Intake 2	17	51565	1336434076	/users/cn/jespinosa/phecomp/data/CRG/20120502_FDF_CRG/20120502_FDF_CRG/20120507_FDF_CRG_c12.mtb	963	NA	WWSS	water	2	51548	1336434059	1	0.04	0.00235294117647059	9111	1
4	Drink 1	Intake 1	16	52011	1336434522	/users/cn/jespinosa/phecomp/data/CRG/20120502_FDF_CRG/20120502_FDF_CRG/20120507_FDF_CRG_c12.mtb	957	NA	WWSS	water	1	51995	1336434506	1	0.02	0.00125	9112	1
4	Food 1	Intake 3	218	54052	1336436563	/users/cn/jespinosa/phecomp/data/CRG/20120502_FDF_CRG/20120502_FDF_CRG/20120507_FDF_CRG_c12.mtb	988	981	WWSS	food_sc	3	53834	1336436345	1	0.08	0.00036697247706422	9113	1
4	Drink 1	Intake 1	18	54368	1336436879	/users/cn/jespinosa/phecomp/data/CRG/20120502_FDF_CRG/20120502_FDF_CRG/20120507_FDF_CRG_c12.mtb	963	NA	WWSS	water	1	54350	1336436861	1	0.02	0.00111111111111111	9114	1
4	Drink 1	Intake 1	21	54683	1336437194	/users/cn/jespinosa/phecomp/data/CRG/20120502_FDF_CRG/20120502_FDF_CRG/20120507_FDF_CRG_c12.mtb	964	NA	WWSS	water	1	54662	1336437173	1	0.02	0.000952380952380952	9115	1
4	Food 1	Intake 3	158	55191	1336437702	/users/cn/jespinosa/phecomp/data/CRG/20120502_FDF_CRG/20120502_FDF_CRG/20120507_FDF_CRG_c12.mtb	991	1186	WWSS	food_sc	3	55033	1336437544	1	0.0600000000000001	0.000379746835443039	9116	1
4	Drink 1	Intake 1	17	55232	1336437743	/users/cn/jespinosa/phecomp/data/CRG/20120502_FDF_CRG/20120502_FDF_CRG/20120507_FDF_CRG_c12.mtb	966	NA	WWSS	water	1	55215	1336437726	1	0.02	0.00117647058823529	9117	1
4	Drink 1	Intake 1	18	55351	1336437862	/users/cn/jespinosa/phecomp/data/CRG/20120502_FDF_CRG/20120502_FDF_CRG/20120507_FDF_CRG_c12.mtb	967	NA	WWSS	water	1	55333	1336437844	1	0.0600000000000001	0.00333333333333334	9118	1
4	Food 1	Intake 3	31	56408	1336438919	/users/cn/jespinosa/phecomp/data/CRG/20120502_FDF_CRG/20120502_FDF_CRG/20120507_FDF_CRG_c12.mtb	994	4593	WWSS	food_sc	3	56377	1336438888	1	0.02	0.000645161290322581	9119	1
4	Food 2	Intake 4	410	61411	1336443922	/users/cn/jespinosa/phecomp/data/CRG/20120502_FDF_CRG/20120502_FDF_CRG/20120507_FDF_CRG_c12.mtb	1447	6302	WWSS	food_sc	4	61001	1336443512	1	0.16	0.000390243902439024	9120	1
4	Drink 1	Intake 1	28	61493	1336444004	/users/cn/jespinosa/phecomp/data/CRG/20120502_FDF_CRG/20120502_FDF_CRG/20120507_FDF_CRG_c12.mtb	973	NA	WWSS	water	1	61465	1336443976	1	0.04	0.00142857142857143	9121	1
4	Drink 2	Intake 2	19	61740	1336444251	/users/cn/jespinosa/phecomp/data/CRG/20120502_FDF_CRG/20120502_FDF_CRG/20120507_FDF_CRG_c12.mtb	971	NA	WWSS	water	2	61721	1336444232	1	0.02	0.00105263157894737	9122	1
4	Drink 1	Intake 1	42	61834	1336444345	/users/cn/jespinosa/phecomp/data/CRG/20120502_FDF_CRG/20120502_FDF_CRG/20120507_FDF_CRG_c12.mtb	975	NA	WWSS	water	1	61792	1336444303	1	0.0800000000000001	0.00190476190476191	9123	1
4	Drink 2	Intake 2	16	62138	1336444649	/users/cn/jespinosa/phecomp/data/CRG/20120502_FDF_CRG/20120502_FDF_CRG/20120507_FDF_CRG_c12.mtb	973	NA	WWSS	water	2	62122	1336444633	1	0.02	0.00125	9124	1
4	Drink 2	Intake 2	15	62442	1336444953	/users/cn/jespinosa/phecomp/data/CRG/20120502_FDF_CRG/20120502_FDF_CRG/20120507_FDF_CRG_c12.mtb	974	NA	WWSS	water	2	62427	1336444938	1	0.02	0.00133333333333333	9125	1
4	Food 2	Intake 4	76	67789	1336450300	/users/cn/jespinosa/phecomp/data/CRG/20120502_FDF_CRG/20120502_FDF_CRG/20120507_FDF_CRG_c12.mtb	1455	COLL	WWSS	food_sc	4	67713	1336450224	1	0.02	0.000263157894736842	9126	1
4	Food 1	Intake 3	102	67881	1336450392	/users/cn/jespinosa/phecomp/data/CRG/20120502_FDF_CRG/20120502_FDF_CRG/20120507_FDF_CRG_c12.mtb	1003	76	WWSS	food_sc	3	67779	1336450290	1	0.0599999999999999	0.000588235294117646	9127	1
4	Food 1	Intake 3	220	68177	1336450688	/users/cn/jespinosa/phecomp/data/CRG/20120502_FDF_CRG/20120502_FDF_CRG/20120507_FDF_CRG_c12.mtb	1004	4	WWSS	food_sc	3	67957	1336450468	1	0.12	0.000545454545454545	9128	1
4	Food 1	Intake 3	39	68220	1336450731	/users/cn/jespinosa/phecomp/data/CRG/20120502_FDF_CRG/20120502_FDF_CRG/20120507_FDF_CRG_c12.mtb	1005	858	WWSS	food_sc	3	68181	1336450692	1	0.02	0.000512820512820513	9129	1
4	Drink 2	Intake 2	19	68730	1336451241	/users/cn/jespinosa/phecomp/data/CRG/20120502_FDF_CRG/20120502_FDF_CRG/20120507_FDF_CRG_c12.mtb	975	NA	WWSS	water	2	68711	1336451222	1	0.02	0.00105263157894737	9130	1
4	Drink 2	Intake 2	36	68833	1336451344	/users/cn/jespinosa/phecomp/data/CRG/20120502_FDF_CRG/20120502_FDF_CRG/20120507_FDF_CRG_c12.mtb	976	NA	WWSS	water	2	68797	1336451308	1	0.02	0.000555555555555556	9131	1
4	Drink 2	Intake 2	16	69088	1336451599	/users/cn/jespinosa/phecomp/data/CRG/20120502_FDF_CRG/20120502_FDF_CRG/20120507_FDF_CRG_c12.mtb	977	NA	WWSS	water	2	69072	1336451583	1	0.02	0.00125	9132	1
4	Food 2	Intake 4	121	69199	1336451710	/users/cn/jespinosa/phecomp/data/CRG/20120502_FDF_CRG/20120502_FDF_CRG/20120507_FDF_CRG_c12.mtb	1458	92	WWSS	food_sc	4	69078	1336451589	1	0.04	0.000330578512396694	9133	1
4	Drink 2	Intake 2	18	69247	1336451758	/users/cn/jespinosa/phecomp/data/CRG/20120502_FDF_CRG/20120502_FDF_CRG/20120507_FDF_CRG_c12.mtb	979	NA	WWSS	water	2	69229	1336451740	1	0.12	0.00666666666666667	9134	1
4	Food 1	Intake 3	57	69348	1336451859	/users/cn/jespinosa/phecomp/data/CRG/20120502_FDF_CRG/20120502_FDF_CRG/20120507_FDF_CRG_c12.mtb	1007	2919	WWSS	food_sc	3	69291	1336451802	1	0.02	0.000350877192982456	9135	1
4	Drink 1	Intake 1	26	69455	1336451966	/users/cn/jespinosa/phecomp/data/CRG/20120502_FDF_CRG/20120502_FDF_CRG/20120507_FDF_CRG_c12.mtb	979	NA	WWSS	water	1	69429	1336451940	1	0.02	0.000769230769230769	9136	1
4	Food 2	Intake 4	458	72725	1336455236	/users/cn/jespinosa/phecomp/data/CRG/20120502_FDF_CRG/20120502_FDF_CRG/20120507_FDF_CRG_c12.mtb	1463	22	WWSS	food_sc	4	72267	1336454778	1	0.16	0.000349344978165939	9137	1
4	Food 2	Intake 4	20	72767	1336455278	/users/cn/jespinosa/phecomp/data/CRG/20120502_FDF_CRG/20120502_FDF_CRG/20120507_FDF_CRG_c12.mtb	1464	843	WWSS	food_sc	4	72747	1336455258	1	0.02	0.001	9138	1
4	Drink 2	Intake 2	20	72783	1336455294	/users/cn/jespinosa/phecomp/data/CRG/20120502_FDF_CRG/20120502_FDF_CRG/20120507_FDF_CRG_c12.mtb	984	NA	WWSS	water	2	72763	1336455274	1	0.0999999999999999	0.00499999999999999	9139	1
4	Food 1	Intake 3	17	73627	1336456138	/users/cn/jespinosa/phecomp/data/CRG/20120502_FDF_CRG/20120502_FDF_CRG/20120507_FDF_CRG_c12.mtb	1013	12187	WWSS	food_sc	3	73610	1336456121	1	0.02	0.00117647058823529	9140	1
4	Food 1	Intake 3	105	85919	1336468430	/users/cn/jespinosa/phecomp/data/CRG/20120502_FDF_CRG/20120502_FDF_CRG/20120507_FDF_CRG_c12.mtb	1019	717	WWSS	food_sc	3	85814	1336468325	1	0.0399999999999999	0.00038095238095238	9141	1
4	Food 2	Intake 4	333	86969	1336469480	/users/cn/jespinosa/phecomp/data/CRG/20120502_FDF_CRG/20120502_FDF_CRG/20120507_FDF_CRG_c12.mtb	1474	26465	WWSS	food_sc	4	86636	1336469147	1	0.0800000000000001	0.000240240240240241	9142	1
4	Drink 1	Intake 1	23	87253	1336469764	/users/cn/jespinosa/phecomp/data/CRG/20120502_FDF_CRG/20120502_FDF_CRG/20120507_FDF_CRG_c12.mtb	983	NA	WWSS	water	1	87230	1336469741	1	0.0599999999999998	0.0026086956521739	9143	1
4	Food 2	Intake 4	97	113531	1336496042	/users/cn/jespinosa/phecomp/data/CRG/20120502_FDF_CRG/20120502_FDF_CRG/20120507_FDF_CRG_c12.mtb	1479	COLL	WWSS	food_sc	4	113434	1336495945	1	0.02	0.000206185567010309	9144	1
4	Food 1	Intake 3	34	113561	1336496072	/users/cn/jespinosa/phecomp/data/CRG/20120502_FDF_CRG/20120502_FDF_CRG/20120507_FDF_CRG_c12.mtb	1030	251	WWSS	food_sc	3	113527	1336496038	1	0.02	0.000588235294117647	9145	1
4	Food 2	Intake 4	601	114413	1336496924	/users/cn/jespinosa/phecomp/data/CRG/20120502_FDF_CRG/20120502_FDF_CRG/20120507_FDF_CRG_c12.mtb	1481	3813	WWSS	food_sc	4	113812	1336496323	1	0.18	0.000299500831946755	9146	1
4	Drink 2	Intake 2	22	114436	1336496947	/users/cn/jespinosa/phecomp/data/CRG/20120502_FDF_CRG/20120502_FDF_CRG/20120507_FDF_CRG_c12.mtb	991	NA	WWSS	water	2	114414	1336496925	1	0.0600000000000001	0.00272727272727273	9147	1
4	Drink 1	Intake 1	16	114887	1336497398	/users/cn/jespinosa/phecomp/data/CRG/20120502_FDF_CRG/20120502_FDF_CRG/20120507_FDF_CRG_c12.mtb	987	NA	WWSS	water	1	114871	1336497382	1	0.04	0.0025	9148	1
4	Food 1	Intake 3	17	118243	1336500754	/users/cn/jespinosa/phecomp/data/CRG/20120502_FDF_CRG/20120502_FDF_CRG/20120507_FDF_CRG_c12.mtb	1032	75	WWSS	food_sc	3	118226	1336500737	1	0.02	0.00117647058823529	9149	1
4	Food 2	Intake 4	217	118535	1336501046	/users/cn/jespinosa/phecomp/data/CRG/20120502_FDF_CRG/20120502_FDF_CRG/20120507_FDF_CRG_c12.mtb	1484	71	WWSS	food_sc	4	118318	1336500829	1	0.0600000000000001	0.000276497695852535	9150	1
4	Food 2	Intake 4	271	118877	1336501388	/users/cn/jespinosa/phecomp/data/CRG/20120502_FDF_CRG/20120502_FDF_CRG/20120507_FDF_CRG_c12.mtb	1486	527	WWSS	food_sc	4	118606	1336501117	1	0.1	0.0003690036900369	9151	1
4	Drink 2	Intake 2	20	118907	1336501418	/users/cn/jespinosa/phecomp/data/CRG/20120502_FDF_CRG/20120502_FDF_CRG/20120507_FDF_CRG_c12.mtb	994	NA	WWSS	water	2	118887	1336501398	1	0.0600000000000001	0.00300000000000001	9152	1
4	Drink 2	Intake 2	15	119205	1336501716	/users/cn/jespinosa/phecomp/data/CRG/20120502_FDF_CRG/20120502_FDF_CRG/20120507_FDF_CRG_c12.mtb	995	NA	WWSS	water	2	119190	1336501701	1	0.02	0.00133333333333333	9153	1
4	Food 2	Intake 4	228	119632	1336502143	/users/cn/jespinosa/phecomp/data/CRG/20120502_FDF_CRG/20120502_FDF_CRG/20120507_FDF_CRG_c12.mtb	1490	573	WWSS	food_sc	4	119404	1336501915	1	0.04	0.000175438596491228	9154	1
4	Drink 2	Intake 2	36	119747	1336502258	/users/cn/jespinosa/phecomp/data/CRG/20120502_FDF_CRG/20120502_FDF_CRG/20120507_FDF_CRG_c12.mtb	998	NA	WWSS	water	2	119711	1336502222	1	0.1	0.00277777777777778	9155	1
4	Food 1	Intake 3	108	120313	1336502824	/users/cn/jespinosa/phecomp/data/CRG/20120502_FDF_CRG/20120502_FDF_CRG/20120507_FDF_CRG_c12.mtb	1039	106	WWSS	food_sc	3	120205	1336502716	1	0.0600000000000001	0.000555555555555557	9156	1
4	Food 1	Intake 3	128	120547	1336503058	/users/cn/jespinosa/phecomp/data/CRG/20120502_FDF_CRG/20120502_FDF_CRG/20120507_FDF_CRG_c12.mtb	1041	2122	WWSS	food_sc	3	120419	1336502930	1	0.0600000000000001	0.000468750000000001	9157	1
4	Food 1	Intake 3	144	122813	1336505324	/users/cn/jespinosa/phecomp/data/CRG/20120502_FDF_CRG/20120502_FDF_CRG/20120507_FDF_CRG_c12.mtb	1044	4	WWSS	food_sc	3	122669	1336505180	1	0.0599999999999998	0.000416666666666665	9158	1
4	Food 1	Intake 3	184	123001	1336505512	/users/cn/jespinosa/phecomp/data/CRG/20120502_FDF_CRG/20120502_FDF_CRG/20120507_FDF_CRG_c12.mtb	1045	648	WWSS	food_sc	3	122817	1336505328	1	0.0600000000000001	0.00032608695652174	9159	1
4	Drink 2	Intake 2	33	123247	1336505758	/users/cn/jespinosa/phecomp/data/CRG/20120502_FDF_CRG/20120502_FDF_CRG/20120507_FDF_CRG_c12.mtb	1003	NA	WWSS	water	2	123214	1336505725	1	0.02	0.000606060606060606	9160	1
4	Food 1	Intake 3	68	123717	1336506228	/users/cn/jespinosa/phecomp/data/CRG/20120502_FDF_CRG/20120502_FDF_CRG/20120507_FDF_CRG_c12.mtb	1048	363	WWSS	food_sc	3	123649	1336506160	1	0.02	0.000294117647058824	9161	1
4	Drink 1	Intake 1	34	123816	1336506327	/users/cn/jespinosa/phecomp/data/CRG/20120502_FDF_CRG/20120502_FDF_CRG/20120507_FDF_CRG_c12.mtb	990	NA	WWSS	water	1	123782	1336506293	1	0.12	0.00352941176470588	9162	1
4	Food 1	Intake 3	115	124195	1336506706	/users/cn/jespinosa/phecomp/data/CRG/20120502_FDF_CRG/20120502_FDF_CRG/20120507_FDF_CRG_c12.mtb	1050	161	WWSS	food_sc	3	124080	1336506591	1	0.02	0.000173913043478261	9163	1
4	Food 2	Intake 4	137	124493	1336507004	/users/cn/jespinosa/phecomp/data/CRG/20120502_FDF_CRG/20120502_FDF_CRG/20120507_FDF_CRG_c12.mtb	1508	61	WWSS	food_sc	4	124356	1336506867	1	0.04	0.000291970802919708	9164	1
4	Drink 2	Intake 2	24	124521	1336507032	/users/cn/jespinosa/phecomp/data/CRG/20120502_FDF_CRG/20120502_FDF_CRG/20120507_FDF_CRG_c12.mtb	1006	NA	WWSS	water	2	124497	1336507008	1	0.0799999999999998	0.00333333333333332	9165	1
4	Food 2	Intake 4	76	124630	1336507141	/users/cn/jespinosa/phecomp/data/CRG/20120502_FDF_CRG/20120502_FDF_CRG/20120507_FDF_CRG_c12.mtb	1509	22	WWSS	food_sc	4	124554	1336507065	1	0.02	0.000263157894736842	9166	1
4	Food 2	Intake 4	129	124781	1336507292	/users/cn/jespinosa/phecomp/data/CRG/20120502_FDF_CRG/20120502_FDF_CRG/20120507_FDF_CRG_c12.mtb	1510	165	WWSS	food_sc	4	124652	1336507163	1	0.04	0.000310077519379845	9167	1
4	Food 2	Intake 4	73	125019	1336507530	/users/cn/jespinosa/phecomp/data/CRG/20120502_FDF_CRG/20120502_FDF_CRG/20120507_FDF_CRG_c12.mtb	1511	256	WWSS	food_sc	4	124946	1336507457	1	0.02	0.000273972602739726	9168	1
4	Drink 1	Intake 1	21	125032	1336507543	/users/cn/jespinosa/phecomp/data/CRG/20120502_FDF_CRG/20120502_FDF_CRG/20120507_FDF_CRG_c12.mtb	992	NA	WWSS	water	1	125011	1336507522	1	0.0600000000000001	0.00285714285714286	9169	1
4	Food 1	Intake 3	42	125317	1336507828	/users/cn/jespinosa/phecomp/data/CRG/20120502_FDF_CRG/20120502_FDF_CRG/20120507_FDF_CRG_c12.mtb	1056	21	WWSS	food_sc	3	125275	1336507786	1	0.02	0.000476190476190476	9170	1
4	Food 1	Intake 3	97	125435	1336507946	/users/cn/jespinosa/phecomp/data/CRG/20120502_FDF_CRG/20120502_FDF_CRG/20120507_FDF_CRG_c12.mtb	1057	680	WWSS	food_sc	3	125338	1336507849	1	0.02	0.000206185567010309	9171	1
4	Drink 1	Intake 1	16	125862	1336508373	/users/cn/jespinosa/phecomp/data/CRG/20120502_FDF_CRG/20120502_FDF_CRG/20120507_FDF_CRG_c12.mtb	993	NA	WWSS	water	1	125846	1336508357	1	0.02	0.00125	9172	1
4	Food 1	Intake 3	313	126428	1336508939	/users/cn/jespinosa/phecomp/data/CRG/20120502_FDF_CRG/20120502_FDF_CRG/20120507_FDF_CRG_c12.mtb	1063	500	WWSS	food_sc	3	126115	1336508626	1	0.14	0.000447284345047923	9173	1
4	Drink 2	Intake 2	31	126461	1336508972	/users/cn/jespinosa/phecomp/data/CRG/20120502_FDF_CRG/20120502_FDF_CRG/20120507_FDF_CRG_c12.mtb	1012	NA	WWSS	water	2	126430	1336508941	1	0.14	0.00451612903225806	9174	1
4	Food 2	Intake 4	155	127083	1336509594	/users/cn/jespinosa/phecomp/data/CRG/20120502_FDF_CRG/20120502_FDF_CRG/20120507_FDF_CRG_c12.mtb	1523	338	WWSS	food_sc	4	126928	1336509439	1	0.04	0.000258064516129032	9175	1
4	Drink 1	Intake 1	16	127091	1336509602	/users/cn/jespinosa/phecomp/data/CRG/20120502_FDF_CRG/20120502_FDF_CRG/20120507_FDF_CRG_c12.mtb	995	NA	WWSS	water	1	127075	1336509586	1	0.02	0.00125	9176	1
4	Drink 1	Intake 1	17	127220	1336509731	/users/cn/jespinosa/phecomp/data/CRG/20120502_FDF_CRG/20120502_FDF_CRG/20120507_FDF_CRG_c12.mtb	996	NA	WWSS	water	1	127203	1336509714	1	0.0600000000000001	0.00352941176470589	9177	1
4	Drink 1	Intake 1	16	127366	1336509877	/users/cn/jespinosa/phecomp/data/CRG/20120502_FDF_CRG/20120502_FDF_CRG/20120507_FDF_CRG_c12.mtb	997	NA	WWSS	water	1	127350	1336509861	1	0.0399999999999998	0.00249999999999999	9178	1
4	Food 1	Intake 3	260	127681	1336510192	/users/cn/jespinosa/phecomp/data/CRG/20120502_FDF_CRG/20120502_FDF_CRG/20120507_FDF_CRG_c12.mtb	1069	1189	WWSS	food_sc	3	127421	1336509932	1	0.12	0.000461538461538462	9179	1
4	Drink 1	Intake 1	26	127701	1336510212	/users/cn/jespinosa/phecomp/data/CRG/20120502_FDF_CRG/20120502_FDF_CRG/20120507_FDF_CRG_c12.mtb	998	NA	WWSS	water	1	127675	1336510186	1	0.0800000000000001	0.00307692307692308	9180	1
4	Food 2	Intake 4	71	128941	1336511452	/users/cn/jespinosa/phecomp/data/CRG/20120502_FDF_CRG/20120502_FDF_CRG/20120507_FDF_CRG_c12.mtb	1530	273	WWSS	food_sc	4	128870	1336511381	1	0.0200000000000005	0.000281690140845077	9181	1
4	Food 1	Intake 3	113	129327	1336511838	/users/cn/jespinosa/phecomp/data/CRG/20120502_FDF_CRG/20120502_FDF_CRG/20120507_FDF_CRG_c12.mtb	1074	86	WWSS	food_sc	3	129214	1336511725	1	0.04	0.000353982300884956	9182	1
4	Food 1	Intake 3	68	129481	1336511992	/users/cn/jespinosa/phecomp/data/CRG/20120502_FDF_CRG/20120502_FDF_CRG/20120507_FDF_CRG_c12.mtb	1075	9	WWSS	food_sc	3	129413	1336511924	1	0.02	0.000294117647058824	9183	1
4	Food 1	Intake 3	191	129681	1336512192	/users/cn/jespinosa/phecomp/data/CRG/20120502_FDF_CRG/20120502_FDF_CRG/20120507_FDF_CRG_c12.mtb	1076	185	WWSS	food_sc	3	129490	1336512001	1	0.0799999999999998	0.000418848167539266	9184	1
4	Drink 2	Intake 2	29	129701	1336512212	/users/cn/jespinosa/phecomp/data/CRG/20120502_FDF_CRG/20120502_FDF_CRG/20120507_FDF_CRG_c12.mtb	1016	NA	WWSS	water	2	129672	1336512183	1	0.14	0.00482758620689655	9185	1
4	Food 1	Intake 3	170	130036	1336512547	/users/cn/jespinosa/phecomp/data/CRG/20120502_FDF_CRG/20120502_FDF_CRG/20120507_FDF_CRG_c12.mtb	1077	922	WWSS	food_sc	3	129866	1336512377	1	0.0600000000000001	0.000352941176470589	9186	1
4	Drink 1	Intake 1	20	130052	1336512563	/users/cn/jespinosa/phecomp/data/CRG/20120502_FDF_CRG/20120502_FDF_CRG/20120507_FDF_CRG_c12.mtb	1000	NA	WWSS	water	1	130032	1336512543	1	0.04	0.002	9187	1
4	Drink 2	Intake 2	16	130092	1336512603	/users/cn/jespinosa/phecomp/data/CRG/20120502_FDF_CRG/20120502_FDF_CRG/20120507_FDF_CRG_c12.mtb	1018	NA	WWSS	water	2	130076	1336512587	1	0.0600000000000001	0.00375000000000001	9188	1
4	Drink 2	Intake 2	121	130739	1336513250	/users/cn/jespinosa/phecomp/data/CRG/20120502_FDF_CRG/20120502_FDF_CRG/20120507_FDF_CRG_c12.mtb	1020	NA	WWSS	water	2	130618	1336513129	1	0.02	0.000165289256198347	9189	1
4	Food 1	Intake 3	114	131072	1336513583	/users/cn/jespinosa/phecomp/data/CRG/20120502_FDF_CRG/20120502_FDF_CRG/20120507_FDF_CRG_c12.mtb	1080	2666	WWSS	food_sc	3	130958	1336513469	1	0.0599999999999998	0.000526315789473682	9190	1
4	Drink 1	Intake 1	15	131393	1336513904	/users/cn/jespinosa/phecomp/data/CRG/20120502_FDF_CRG/20120502_FDF_CRG/20120507_FDF_CRG_c12.mtb	1003	NA	WWSS	water	1	131378	1336513889	1	0.02	0.00133333333333333	9191	1
4	Drink 1	Intake 1	17	132964	1336515475	/users/cn/jespinosa/phecomp/data/CRG/20120502_FDF_CRG/20120502_FDF_CRG/20120507_FDF_CRG_c12.mtb	1006	NA	WWSS	water	1	132947	1336515458	1	0.02	0.00117647058823529	9192	1
4	Drink 1	Intake 1	20	133699	1336516210	/users/cn/jespinosa/phecomp/data/CRG/20120502_FDF_CRG/20120502_FDF_CRG/20120507_FDF_CRG_c12.mtb	1007	NA	WWSS	water	1	133679	1336516190	1	0.02	0.001	9193	1
4	Food 1	Intake 3	287	134025	1336516536	/users/cn/jespinosa/phecomp/data/CRG/20120502_FDF_CRG/20120502_FDF_CRG/20120507_FDF_CRG_c12.mtb	1086	2699	WWSS	food_sc	3	133738	1336516249	1	0.0800000000000001	0.000278745644599303	9194	1
4	Food 1	Intake 3	29	136753	1336519264	/users/cn/jespinosa/phecomp/data/CRG/20120502_FDF_CRG/20120502_FDF_CRG/20120507_FDF_CRG_c12.mtb	1088	2146	WWSS	food_sc	3	136724	1336519235	1	0.02	0.000689655172413793	9195	1
4	Food 1	Intake 3	234	139133	1336521644	/users/cn/jespinosa/phecomp/data/CRG/20120502_FDF_CRG/20120502_FDF_CRG/20120507_FDF_CRG_c12.mtb	1096	22	WWSS	food_sc	3	138899	1336521410	1	0.1	0.000427350427350427	9196	1
4	Food 1	Intake 3	159	139314	1336521825	/users/cn/jespinosa/phecomp/data/CRG/20120502_FDF_CRG/20120502_FDF_CRG/20120507_FDF_CRG_c12.mtb	1097	11	WWSS	food_sc	3	139155	1336521666	1	0.1	0.000628930817610063	9197	1
4	Food 1	Intake 3	104	139429	1336521940	/users/cn/jespinosa/phecomp/data/CRG/20120502_FDF_CRG/20120502_FDF_CRG/20120507_FDF_CRG_c12.mtb	1098	272	WWSS	food_sc	3	139325	1336521836	1	0.0600000000000001	0.000576923076923078	9198	1
4	Drink 2	Intake 2	34	139465	1336521976	/users/cn/jespinosa/phecomp/data/CRG/20120502_FDF_CRG/20120502_FDF_CRG/20120507_FDF_CRG_c12.mtb	1026	NA	WWSS	water	2	139431	1336521942	1	0.0600000000000001	0.00176470588235294	9199	1
4	Food 1	Intake 3	136	139837	1336522348	/users/cn/jespinosa/phecomp/data/CRG/20120502_FDF_CRG/20120502_FDF_CRG/20120507_FDF_CRG_c12.mtb	1100	7471	WWSS	food_sc	3	139701	1336522212	1	0.04	0.000294117647058824	9200	1
4	Drink 1	Intake 1	20	139870	1336522381	/users/cn/jespinosa/phecomp/data/CRG/20120502_FDF_CRG/20120502_FDF_CRG/20120507_FDF_CRG_c12.mtb	1013	NA	WWSS	water	1	139850	1336522361	1	0.12	0.006	9201	1
4	Drink 2	Intake 2	19	140027	1336522538	/users/cn/jespinosa/phecomp/data/CRG/20120502_FDF_CRG/20120502_FDF_CRG/20120507_FDF_CRG_c12.mtb	1029	NA	WWSS	water	2	140008	1336522519	1	0.02	0.00105263157894737	9202	1
4	Drink 2	Intake 2	24	140221	1336522732	/users/cn/jespinosa/phecomp/data/CRG/20120502_FDF_CRG/20120502_FDF_CRG/20120507_FDF_CRG_c12.mtb	1030	NA	WWSS	water	2	140197	1336522708	1	0.0800000000000001	0.00333333333333334	9203	1
4	Drink 1	Intake 1	25	140966	1336523477	/users/cn/jespinosa/phecomp/data/CRG/20120502_FDF_CRG/20120502_FDF_CRG/20120507_FDF_CRG_c12.mtb	1015	NA	WWSS	water	1	140941	1336523452	1	0.0600000000000001	0.0024	9204	1
4	Food 1	Intake 3	340	147648	1336530159	/users/cn/jespinosa/phecomp/data/CRG/20120502_FDF_CRG/20120502_FDF_CRG/20120507_FDF_CRG_c12.mtb	1117	210	WWSS	food_sc	3	147308	1336529819	1	0.14	0.000411764705882353	9205	1
4	Drink 1	Intake 1	22	147795	1336530306	/users/cn/jespinosa/phecomp/data/CRG/20120502_FDF_CRG/20120502_FDF_CRG/20120507_FDF_CRG_c12.mtb	1021	NA	WWSS	water	1	147773	1336530284	1	0.1	0.00454545454545455	9206	1
4	Food 1	Intake 3	86	147944	1336530455	/users/cn/jespinosa/phecomp/data/CRG/20120502_FDF_CRG/20120502_FDF_CRG/20120507_FDF_CRG_c12.mtb	1119	195	WWSS	food_sc	3	147858	1336530369	1	0.02	0.000232558139534884	9207	1
4	Drink 2	Intake 2	17	148072	1336530583	/users/cn/jespinosa/phecomp/data/CRG/20120502_FDF_CRG/20120502_FDF_CRG/20120507_FDF_CRG_c12.mtb	1038	NA	WWSS	water	2	148055	1336530566	1	0.02	0.00117647058823529	9208	1
4	Food 1	Intake 3	290	148429	1336530940	/users/cn/jespinosa/phecomp/data/CRG/20120502_FDF_CRG/20120502_FDF_CRG/20120507_FDF_CRG_c12.mtb	1122	6491	WWSS	food_sc	3	148139	1336530650	1	0.12	0.000413793103448276	9209	1
4	Drink 1	Intake 1	30	148461	1336530972	/users/cn/jespinosa/phecomp/data/CRG/20120502_FDF_CRG/20120502_FDF_CRG/20120507_FDF_CRG_c12.mtb	1023	NA	WWSS	water	1	148431	1336530942	1	0.14	0.00466666666666667	9210	1
4	Drink 1	Intake 1	129	149340	1336531851	/users/cn/jespinosa/phecomp/data/CRG/20120502_FDF_CRG/20120502_FDF_CRG/20120507_FDF_CRG_c12.mtb	1026	NA	WWSS	water	1	149211	1336531722	1	0.04	0.000310077519379845	9211	1
4	Food 1	Intake 3	453	155373	1336537884	/users/cn/jespinosa/phecomp/data/CRG/20120502_FDF_CRG/20120502_FDF_CRG/20120507_FDF_CRG_c12.mtb	1127	114	WWSS	food_sc	3	154920	1336537431	1	0.16	0.000353200883002208	9212	1
4	Food 1	Intake 3	71	155558	1336538069	/users/cn/jespinosa/phecomp/data/CRG/20120502_FDF_CRG/20120502_FDF_CRG/20120507_FDF_CRG_c12.mtb	1129	57	WWSS	food_sc	3	155487	1336537998	1	0.04	0.000563380281690141	9213	1
4	Drink 1	Intake 1	24	155579	1336538090	/users/cn/jespinosa/phecomp/data/CRG/20120502_FDF_CRG/20120502_FDF_CRG/20120507_FDF_CRG_c12.mtb	1029	NA	WWSS	water	1	155555	1336538066	1	0.12	0.005	9214	1
4	Food 1	Intake 3	176	155791	1336538302	/users/cn/jespinosa/phecomp/data/CRG/20120502_FDF_CRG/20120502_FDF_CRG/20120507_FDF_CRG_c12.mtb	1130	1992	WWSS	food_sc	3	155615	1336538126	1	0.04	0.000227272727272727	9215	1
4	Drink 1	Intake 1	28	156092	1336538603	/users/cn/jespinosa/phecomp/data/CRG/20120502_FDF_CRG/20120502_FDF_CRG/20120507_FDF_CRG_c12.mtb	1030	NA	WWSS	water	1	156064	1336538575	1	0.1	0.00357142857142857	9216	1
4	Food 1	Intake 3	286	158069	1336540580	/users/cn/jespinosa/phecomp/data/CRG/20120502_FDF_CRG/20120502_FDF_CRG/20120507_FDF_CRG_c12.mtb	1133	4169	WWSS	food_sc	3	157783	1336540294	1	0.12	0.00041958041958042	9217	1
4	Drink 2	Intake 2	26	158179	1336540690	/users/cn/jespinosa/phecomp/data/CRG/20120502_FDF_CRG/20120502_FDF_CRG/20120507_FDF_CRG_c12.mtb	1046	NA	WWSS	water	2	158153	1336540664	1	0.0800000000000001	0.00307692307692308	9218	1
4	Drink 1	Intake 1	25	158198	1336540709	/users/cn/jespinosa/phecomp/data/CRG/20120502_FDF_CRG/20120502_FDF_CRG/20120507_FDF_CRG_c12.mtb	1031	NA	WWSS	water	1	158173	1336540684	1	0.02	0.0008	9219	1
4	Food 1	Intake 3	264	162502	1336545013	/users/cn/jespinosa/phecomp/data/CRG/20120502_FDF_CRG/20120502_FDF_CRG/20120507_FDF_CRG_c12.mtb	1142	2567	WWSS	food_sc	3	162238	1336544749	1	0.12	0.000454545454545455	9220	1
4	Food 1	Intake 3	22	165091	1336547602	/users/cn/jespinosa/phecomp/data/CRG/20120502_FDF_CRG/20120502_FDF_CRG/20120507_FDF_CRG_c12.mtb	1144	LAST	WWSS	food_sc	3	165069	1336547580	1	0.3	0.0136363636363636	9221	1
4	Drink 2	Intake 2	44	165634	1336548145	/users/cn/jespinosa/phecomp/data/CRG/20120502_FDF_CRG/20120502_FDF_CRG/20120507_FDF_CRG_c12.mtb	1050	NA	WWSS	water	2	165590	1336548101	1	0.02	0.000454545454545455	9222	1
4	Drink 1	Intake 1	37	165872	1336548383	/users/cn/jespinosa/phecomp/data/CRG/20120502_FDF_CRG/20120502_FDF_CRG/20120507_FDF_CRG_c12.mtb	1036	NA	WWSS	water	1	165835	1336548346	1	0.0999999999999996	0.00270270270270269	9223	1
4	Food 1	Intake 3	53	345	1336554033	/users/cn/jespinosa/phecomp/data/CRG/20120502_FDF_CRG/20120502_FDF_CRG/20120509_FDF_CRG_c12.mtb	1569	COLL	WWFF	food_fat	3	292	1336553980	1	0.02	0.000377358490566038	9224	1
4	Food 2	Intake 4	16	358	1336554046	/users/cn/jespinosa/phecomp/data/CRG/20120502_FDF_CRG/20120502_FDF_CRG/20120509_FDF_CRG_c12.mtb	2077	75	WWFF	food_fat	4	342	1336554030	1	0.04	0.0025	9225	1
4	Food 1	Intake 3	80	513	1336554201	/users/cn/jespinosa/phecomp/data/CRG/20120502_FDF_CRG/20120502_FDF_CRG/20120509_FDF_CRG_c12.mtb	1571	81	WWFF	food_fat	3	433	1336554121	1	0.24	0.003	9226	1
4	Food 1	Intake 3	94	688	1336554376	/users/cn/jespinosa/phecomp/data/CRG/20120502_FDF_CRG/20120502_FDF_CRG/20120509_FDF_CRG_c12.mtb	1572	COLL	WWFF	food_fat	3	594	1336554282	1	0.26	0.00276595744680851	9227	1
4	Food 2	Intake 4	70	746	1336554434	/users/cn/jespinosa/phecomp/data/CRG/20120502_FDF_CRG/20120502_FDF_CRG/20120509_FDF_CRG_c12.mtb	2079	COLL	WWFF	food_fat	4	676	1336554364	1	0.22	0.00314285714285714	9228	1
4	Food 1	Intake 3	84	820	1336554508	/users/cn/jespinosa/phecomp/data/CRG/20120502_FDF_CRG/20120502_FDF_CRG/20120509_FDF_CRG_c12.mtb	1573	48	WWFF	food_fat	3	736	1336554424	1	0.46	0.00547619047619048	9229	1
4	Food 2	Intake 4	105	973	1336554661	/users/cn/jespinosa/phecomp/data/CRG/20120502_FDF_CRG/20120502_FDF_CRG/20120509_FDF_CRG_c12.mtb	2081	COLL	WWFF	food_fat	4	868	1336554556	1	0.04	0.000380952380952381	9230	1
4	Food 1	Intake 3	16	900	1336554588	/users/cn/jespinosa/phecomp/data/CRG/20120502_FDF_CRG/20120502_FDF_CRG/20120509_FDF_CRG_c12.mtb	1575	64	WWFF	food_fat	3	884	1336554572	1	0.24	0.015	9231	1
4	Food 1	Intake 3	31	995	1336554683	/users/cn/jespinosa/phecomp/data/CRG/20120502_FDF_CRG/20120502_FDF_CRG/20120509_FDF_CRG_c12.mtb	1576	35	WWFF	food_fat	3	964	1336554652	1	0.18	0.00580645161290323	9232	1
4	Food 1	Intake 3	91	1121	1336554809	/users/cn/jespinosa/phecomp/data/CRG/20120502_FDF_CRG/20120502_FDF_CRG/20120509_FDF_CRG_c12.mtb	1577	COLL	WWFF	food_fat	3	1030	1336554718	1	0.1	0.0010989010989011	9233	1
4	Food 2	Intake 4	17	1073	1336554761	/users/cn/jespinosa/phecomp/data/CRG/20120502_FDF_CRG/20120502_FDF_CRG/20120509_FDF_CRG_c12.mtb	2082	35	WWFF	food_fat	4	1056	1336554744	1	0.04	0.00235294117647059	9234	1
4	Food 2	Intake 4	61	1169	1336554857	/users/cn/jespinosa/phecomp/data/CRG/20120502_FDF_CRG/20120502_FDF_CRG/20120509_FDF_CRG_c12.mtb	2083	COLL	WWFF	food_fat	4	1108	1336554796	1	0.04	0.000655737704918033	9235	1
4	Food 1	Intake 3	65	1203	1336554891	/users/cn/jespinosa/phecomp/data/CRG/20120502_FDF_CRG/20120502_FDF_CRG/20120509_FDF_CRG_c12.mtb	1578	COLL	WWFF	food_fat	3	1138	1336554826	1	0.12	0.00184615384615385	9236	1
4	Food 2	Intake 4	71	1262	1336554950	/users/cn/jespinosa/phecomp/data/CRG/20120502_FDF_CRG/20120502_FDF_CRG/20120509_FDF_CRG_c12.mtb	2084	208	WWFF	food_fat	4	1191	1336554879	1	0.02	0.00028169014084507	9237	1
4	Food 2	Intake 4	69	1539	1336555227	/users/cn/jespinosa/phecomp/data/CRG/20120502_FDF_CRG/20120502_FDF_CRG/20120509_FDF_CRG_c12.mtb	2085	3	WWFF	food_fat	4	1470	1336555158	1	0.12	0.00173913043478261	9238	1
4	Food 1	Intake 3	21	1563	1336555251	/users/cn/jespinosa/phecomp/data/CRG/20120502_FDF_CRG/20120502_FDF_CRG/20120509_FDF_CRG_c12.mtb	1580	COLL	WWFF	food_fat	3	1542	1336555230	1	0.0799999999999998	0.0038095238095238	9239	1
4	Food 2	Intake 4	51	1604	1336555292	/users/cn/jespinosa/phecomp/data/CRG/20120502_FDF_CRG/20120502_FDF_CRG/20120509_FDF_CRG_c12.mtb	2086	COLL	WWFF	food_fat	4	1553	1336555241	1	0.12	0.00235294117647059	9240	1
4	Food 1	Intake 3	68	1650	1336555338	/users/cn/jespinosa/phecomp/data/CRG/20120502_FDF_CRG/20120502_FDF_CRG/20120509_FDF_CRG_c12.mtb	1581	COLL	WWFF	food_fat	3	1582	1336555270	1	0.04	0.000588235294117647	9241	1
4	Food 2	Intake 4	33	1652	1336555340	/users/cn/jespinosa/phecomp/data/CRG/20120502_FDF_CRG/20120502_FDF_CRG/20120509_FDF_CRG_c12.mtb	2087	102	WWFF	food_fat	4	1619	1336555307	1	0.0599999999999999	0.00181818181818182	9242	1
4	Food 1	Intake 3	23	1777	1336555465	/users/cn/jespinosa/phecomp/data/CRG/20120502_FDF_CRG/20120502_FDF_CRG/20120509_FDF_CRG_c12.mtb	1582	16	WWFF	food_fat	3	1754	1336555442	1	0.04	0.00173913043478261	9243	1
4	Food 2	Intake 4	84	1877	1336555565	/users/cn/jespinosa/phecomp/data/CRG/20120502_FDF_CRG/20120502_FDF_CRG/20120509_FDF_CRG_c12.mtb	2089	217	WWFF	food_fat	4	1793	1336555481	1	0.16	0.0019047619047619	9244	1
4	Food 2	Intake 4	98	2192	1336555880	/users/cn/jespinosa/phecomp/data/CRG/20120502_FDF_CRG/20120502_FDF_CRG/20120509_FDF_CRG_c12.mtb	2093	133	WWFF	food_fat	4	2094	1336555782	1	0.08	0.000816326530612245	9245	1
4	Food 1	Intake 3	112	2437	1336556125	/users/cn/jespinosa/phecomp/data/CRG/20120502_FDF_CRG/20120502_FDF_CRG/20120509_FDF_CRG_c12.mtb	1586	282	WWFF	food_fat	3	2325	1336556013	1	0.2	0.00178571428571429	9246	1
4	Food 1	Intake 3	86	2805	1336556493	/users/cn/jespinosa/phecomp/data/CRG/20120502_FDF_CRG/20120502_FDF_CRG/20120509_FDF_CRG_c12.mtb	1588	COLL	WWFF	food_fat	3	2719	1336556407	1	0.02	0.000232558139534884	9247	1
4	Food 2	Intake 4	89	2876	1336556564	/users/cn/jespinosa/phecomp/data/CRG/20120502_FDF_CRG/20120502_FDF_CRG/20120509_FDF_CRG_c12.mtb	2098	COLL	WWFF	food_fat	4	2787	1336556475	1	0.02	0.000224719101123596	9248	1
4	Food 1	Intake 3	13	2827	1336556515	/users/cn/jespinosa/phecomp/data/CRG/20120502_FDF_CRG/20120502_FDF_CRG/20120509_FDF_CRG_c12.mtb	1589	8	WWFF	food_fat	3	2814	1336556502	1	0.02	0.00153846153846154	9249	1
4	Food 1	Intake 3	86	2921	1336556609	/users/cn/jespinosa/phecomp/data/CRG/20120502_FDF_CRG/20120502_FDF_CRG/20120509_FDF_CRG_c12.mtb	1590	40	WWFF	food_fat	3	2835	1336556523	1	0.3	0.00348837209302326	9250	1
4	Food 2	Intake 4	28	2989	1336556677	/users/cn/jespinosa/phecomp/data/CRG/20120502_FDF_CRG/20120502_FDF_CRG/20120509_FDF_CRG_c12.mtb	2099	353	WWFF	food_fat	4	2961	1336556649	1	0.02	0.000714285714285714	9251	1
4	Food 2	Intake 4	121	3463	1336557151	/users/cn/jespinosa/phecomp/data/CRG/20120502_FDF_CRG/20120502_FDF_CRG/20120509_FDF_CRG_c12.mtb	2101	COLL	WWFF	food_fat	4	3342	1336557030	1	0.0600000000000001	0.000495867768595042	9252	1
4	Food 1	Intake 3	73	3459	1336557147	/users/cn/jespinosa/phecomp/data/CRG/20120502_FDF_CRG/20120502_FDF_CRG/20120509_FDF_CRG_c12.mtb	1592	3769	WWFF	food_fat	3	3386	1336557074	1	0.04	0.000547945205479452	9253	1
4	Food 2	Intake 4	20	7248	1336560936	/users/cn/jespinosa/phecomp/data/CRG/20120502_FDF_CRG/20120502_FDF_CRG/20120509_FDF_CRG_c12.mtb	2104	2377	WWFF	food_fat	4	7228	1336560916	1	0.02	0.001	9254	1
4	Food 2	Intake 4	24	9649	1336563337	/users/cn/jespinosa/phecomp/data/CRG/20120502_FDF_CRG/20120502_FDF_CRG/20120509_FDF_CRG_c12.mtb	2105	4837	WWFF	food_fat	4	9625	1336563313	1	0.02	0.000833333333333333	9255	1
4	Food 2	Intake 4	31	14517	1336568205	/users/cn/jespinosa/phecomp/data/CRG/20120502_FDF_CRG/20120502_FDF_CRG/20120509_FDF_CRG_c12.mtb	2110	COLL	WWFF	food_fat	4	14486	1336568174	1	0.02	0.000645161290322581	9256	1
4	Food 1	Intake 3	12	14515	1336568203	/users/cn/jespinosa/phecomp/data/CRG/20120502_FDF_CRG/20120502_FDF_CRG/20120509_FDF_CRG_c12.mtb	1598	185	WWFF	food_fat	3	14503	1336568191	1	0.04	0.00333333333333333	9257	1
4	Food 2	Intake 4	10	14710	1336568398	/users/cn/jespinosa/phecomp/data/CRG/20120502_FDF_CRG/20120502_FDF_CRG/20120509_FDF_CRG_c12.mtb	2112	15	WWFF	food_fat	4	14700	1336568388	1	0.02	0.002	9258	1
4	Food 2	Intake 4	14	14739	1336568427	/users/cn/jespinosa/phecomp/data/CRG/20120502_FDF_CRG/20120502_FDF_CRG/20120509_FDF_CRG_c12.mtb	2113	105	WWFF	food_fat	4	14725	1336568413	1	0.04	0.00285714285714286	9259	1
4	Food 2	Intake 4	14	14858	1336568546	/users/cn/jespinosa/phecomp/data/CRG/20120502_FDF_CRG/20120502_FDF_CRG/20120509_FDF_CRG_c12.mtb	2115	COLL	WWFF	food_fat	4	14844	1336568532	1	0.0600000000000001	0.00428571428571429	9260	1
4	Food 1	Intake 3	11	14857	1336568545	/users/cn/jespinosa/phecomp/data/CRG/20120502_FDF_CRG/20120502_FDF_CRG/20120509_FDF_CRG_c12.mtb	1600	394	WWFF	food_fat	3	14846	1336568534	1	0.0600000000000001	0.00545454545454546	9261	1
4	Food 1	Intake 3	33	15284	1336568972	/users/cn/jespinosa/phecomp/data/CRG/20120502_FDF_CRG/20120502_FDF_CRG/20120509_FDF_CRG_c12.mtb	1601	136	WWFF	food_fat	3	15251	1336568939	1	0.02	0.000606060606060606	9262	1
4	Food 2	Intake 4	9	15429	1336569117	/users/cn/jespinosa/phecomp/data/CRG/20120502_FDF_CRG/20120502_FDF_CRG/20120509_FDF_CRG_c12.mtb	2119	769	WWFF	food_fat	4	15420	1336569108	1	0.02	0.00222222222222222	9263	1
4	Drink 2	Intake 2	32	15847	1336569535	/users/cn/jespinosa/phecomp/data/CRG/20120502_FDF_CRG/20120502_FDF_CRG/20120509_FDF_CRG_c12.mtb	1150	NA	WWFF	water	2	15815	1336569503	1	0.16	0.005	9264	1
4	Food 2	Intake 4	22	16220	1336569908	/users/cn/jespinosa/phecomp/data/CRG/20120502_FDF_CRG/20120502_FDF_CRG/20120509_FDF_CRG_c12.mtb	2126	COLL	WWFF	food_fat	4	16198	1336569886	1	0.02	0.000909090909090909	9265	1
4	Food 1	Intake 3	13	16219	1336569907	/users/cn/jespinosa/phecomp/data/CRG/20120502_FDF_CRG/20120502_FDF_CRG/20120509_FDF_CRG_c12.mtb	1604	53	WWFF	food_fat	3	16206	1336569894	1	0.02	0.00153846153846154	9266	1
4	Food 2	Intake 4	12	16284	1336569972	/users/cn/jespinosa/phecomp/data/CRG/20120502_FDF_CRG/20120502_FDF_CRG/20120509_FDF_CRG_c12.mtb	2127	2208	WWFF	food_fat	4	16272	1336569960	1	0.04	0.00333333333333333	9267	1
4	Drink 2	Intake 2	21	16297	1336569985	/users/cn/jespinosa/phecomp/data/CRG/20120502_FDF_CRG/20120502_FDF_CRG/20120509_FDF_CRG_c12.mtb	1151	NA	WWFF	water	2	16276	1336569964	1	0.04	0.0019047619047619	9268	1
4	Food 1	Intake 3	22	18514	1336572202	/users/cn/jespinosa/phecomp/data/CRG/20120502_FDF_CRG/20120502_FDF_CRG/20120509_FDF_CRG_c12.mtb	1606	163	WWFF	food_fat	3	18492	1336572180	1	0.04	0.00181818181818182	9269	1
4	Food 2	Intake 4	33	18710	1336572398	/users/cn/jespinosa/phecomp/data/CRG/20120502_FDF_CRG/20120502_FDF_CRG/20120509_FDF_CRG_c12.mtb	2133	COLL	WWFF	food_fat	4	18677	1336572365	1	0.04	0.00121212121212121	9270	1
4	Food 1	Intake 3	9	18707	1336572395	/users/cn/jespinosa/phecomp/data/CRG/20120502_FDF_CRG/20120502_FDF_CRG/20120509_FDF_CRG_c12.mtb	1608	10291	WWFF	food_fat	3	18698	1336572386	1	0.04	0.00444444444444444	9271	1
4	Drink 1	Intake 1	26	18726	1336572414	/users/cn/jespinosa/phecomp/data/CRG/20120502_FDF_CRG/20120502_FDF_CRG/20120509_FDF_CRG_c12.mtb	1220	NA	WWFF	water	1	18700	1336572388	1	0.12	0.00461538461538461	9272	1
4	Food 2	Intake 4	12	29010	1336582698	/users/cn/jespinosa/phecomp/data/CRG/20120502_FDF_CRG/20120502_FDF_CRG/20120509_FDF_CRG_c12.mtb	2142	750	WWFF	food_fat	4	28998	1336582686	1	0.02	0.00166666666666667	9273	1
4	Drink 1	Intake 1	17	29022	1336582710	/users/cn/jespinosa/phecomp/data/CRG/20120502_FDF_CRG/20120502_FDF_CRG/20120509_FDF_CRG_c12.mtb	1221	NA	WWFF	water	1	29005	1336582693	1	0.06	0.00352941176470588	9274	1
4	Food 2	Intake 4	9	29769	1336583457	/users/cn/jespinosa/phecomp/data/CRG/20120502_FDF_CRG/20120502_FDF_CRG/20120509_FDF_CRG_c12.mtb	2144	2184	WWFF	food_fat	4	29760	1336583448	1	0.02	0.00222222222222222	9275	1
4	Food 2	Intake 4	31	31984	1336585672	/users/cn/jespinosa/phecomp/data/CRG/20120502_FDF_CRG/20120502_FDF_CRG/20120509_FDF_CRG_c12.mtb	2148	COLL	WWFF	food_fat	4	31953	1336585641	1	0.04	0.00129032258064516	9276	1
4	Food 1	Intake 3	12	31982	1336585670	/users/cn/jespinosa/phecomp/data/CRG/20120502_FDF_CRG/20120502_FDF_CRG/20120509_FDF_CRG_c12.mtb	1615	1949	WWFF	food_fat	3	31970	1336585658	1	0.0600000000000001	0.00500000000000001	9277	1
4	Drink 1	Intake 1	21	32711	1336586399	/users/cn/jespinosa/phecomp/data/CRG/20120502_FDF_CRG/20120502_FDF_CRG/20120509_FDF_CRG_c12.mtb	1222	NA	WWFF	water	1	32690	1336586378	1	0.06	0.00285714285714286	9278	1
4	Food 1	Intake 3	76	34007	1336587695	/users/cn/jespinosa/phecomp/data/CRG/20120502_FDF_CRG/20120502_FDF_CRG/20120509_FDF_CRG_c12.mtb	1617	14	WWFF	food_fat	3	33931	1336587619	1	0.04	0.000526315789473684	9279	1
4	Food 2	Intake 4	46	34067	1336587755	/users/cn/jespinosa/phecomp/data/CRG/20120502_FDF_CRG/20120502_FDF_CRG/20120509_FDF_CRG_c12.mtb	2151	50	WWFF	food_fat	4	34021	1336587709	1	0.02	0.000434782608695652	9280	1
4	Drink 1	Intake 1	44	34101	1336587789	/users/cn/jespinosa/phecomp/data/CRG/20120502_FDF_CRG/20120502_FDF_CRG/20120509_FDF_CRG_c12.mtb	1223	NA	WWFF	water	1	34057	1336587745	1	0.02	0.000454545454545455	9281	1
4	Food 2	Intake 4	43	34160	1336587848	/users/cn/jespinosa/phecomp/data/CRG/20120502_FDF_CRG/20120502_FDF_CRG/20120509_FDF_CRG_c12.mtb	2153	COLL	WWFF	food_fat	4	34117	1336587805	1	0.04	0.000930232558139535	9282	1
4	Food 1	Intake 3	12	34160	1336587848	/users/cn/jespinosa/phecomp/data/CRG/20120502_FDF_CRG/20120502_FDF_CRG/20120509_FDF_CRG_c12.mtb	1620	138	WWFF	food_fat	3	34148	1336587836	1	0.02	0.00166666666666667	9283	1
4	Food 2	Intake 4	47	34345	1336588033	/users/cn/jespinosa/phecomp/data/CRG/20120502_FDF_CRG/20120502_FDF_CRG/20120509_FDF_CRG_c12.mtb	2155	COLL	WWFF	food_fat	4	34298	1336587986	1	0.04	0.000851063829787234	9284	1
4	Food 1	Intake 3	43	34348	1336588036	/users/cn/jespinosa/phecomp/data/CRG/20120502_FDF_CRG/20120502_FDF_CRG/20120509_FDF_CRG_c12.mtb	1623	448	WWFF	food_fat	3	34305	1336587993	1	0.02	0.000465116279069767	9285	1
4	Food 1	Intake 3	98	34894	1336588582	/users/cn/jespinosa/phecomp/data/CRG/20120502_FDF_CRG/20120502_FDF_CRG/20120509_FDF_CRG_c12.mtb	1625	COLL	WWFF	food_fat	3	34796	1336588484	1	0.02	0.000204081632653061	9286	1
4	Food 2	Intake 4	52	34917	1336588605	/users/cn/jespinosa/phecomp/data/CRG/20120502_FDF_CRG/20120502_FDF_CRG/20120509_FDF_CRG_c12.mtb	2157	17	WWFF	food_fat	4	34865	1336588553	1	0.02	0.000384615384615385	9287	1
4	Food 2	Intake 4	24	34958	1336588646	/users/cn/jespinosa/phecomp/data/CRG/20120502_FDF_CRG/20120502_FDF_CRG/20120509_FDF_CRG_c12.mtb	2158	708	WWFF	food_fat	4	34934	1336588622	1	0.04	0.00166666666666667	9288	1
4	Food 1	Intake 3	16	35682	1336589370	/users/cn/jespinosa/phecomp/data/CRG/20120502_FDF_CRG/20120502_FDF_CRG/20120509_FDF_CRG_c12.mtb	1629	COLL	WWFF	food_fat	3	35666	1336589354	1	0.02	0.00125	9289	1
4	Food 2	Intake 4	9	35678	1336589366	/users/cn/jespinosa/phecomp/data/CRG/20120502_FDF_CRG/20120502_FDF_CRG/20120509_FDF_CRG_c12.mtb	2161	68	WWFF	food_fat	4	35669	1336589357	1	0.02	0.00222222222222222	9290	1
4	Food 1	Intake 3	73	35819	1336589507	/users/cn/jespinosa/phecomp/data/CRG/20120502_FDF_CRG/20120502_FDF_CRG/20120509_FDF_CRG_c12.mtb	1630	COLL	WWFF	food_fat	3	35746	1336589434	1	0.04	0.000547945205479452	9291	1
4	Food 2	Intake 4	129	35914	1336589602	/users/cn/jespinosa/phecomp/data/CRG/20120502_FDF_CRG/20120502_FDF_CRG/20120509_FDF_CRG_c12.mtb	2163	COLL	WWFF	food_fat	4	35785	1336589473	1	0.0399999999999998	0.000310077519379843	9292	1
4	Food 1	Intake 3	31	35933	1336589621	/users/cn/jespinosa/phecomp/data/CRG/20120502_FDF_CRG/20120502_FDF_CRG/20120509_FDF_CRG_c12.mtb	1631	COLL	WWFF	food_fat	3	35902	1336589590	1	0.02	0.000645161290322581	9293	1
4	Food 2	Intake 4	121	36043	1336589731	/users/cn/jespinosa/phecomp/data/CRG/20120502_FDF_CRG/20120502_FDF_CRG/20120509_FDF_CRG_c12.mtb	2164	126	WWFF	food_fat	4	35922	1336589610	1	0.16	0.00132231404958678	9294	1
4	Food 1	Intake 3	20	36189	1336589877	/users/cn/jespinosa/phecomp/data/CRG/20120502_FDF_CRG/20120502_FDF_CRG/20120509_FDF_CRG_c12.mtb	1633	11	WWFF	food_fat	3	36169	1336589857	1	0.0200000000000005	0.00100000000000002	9295	1
4	Food 1	Intake 3	39	36239	1336589927	/users/cn/jespinosa/phecomp/data/CRG/20120502_FDF_CRG/20120502_FDF_CRG/20120509_FDF_CRG_c12.mtb	1634	19	WWFF	food_fat	3	36200	1336589888	1	0.14	0.00358974358974359	9296	1
4	Food 1	Intake 3	31	36289	1336589977	/users/cn/jespinosa/phecomp/data/CRG/20120502_FDF_CRG/20120502_FDF_CRG/20120509_FDF_CRG_c12.mtb	1635	COLL	WWFF	food_fat	3	36258	1336589946	1	0.16	0.00516129032258065	9297	1
4	Food 2	Intake 4	18	36281	1336589969	/users/cn/jespinosa/phecomp/data/CRG/20120502_FDF_CRG/20120502_FDF_CRG/20120509_FDF_CRG_c12.mtb	2166	27	WWFF	food_fat	4	36263	1336589951	1	0.0599999999999998	0.00333333333333332	9298	1
4	Food 2	Intake 4	26	36334	1336590022	/users/cn/jespinosa/phecomp/data/CRG/20120502_FDF_CRG/20120502_FDF_CRG/20120509_FDF_CRG_c12.mtb	2167	COLL	WWFF	food_fat	4	36308	1336589996	1	0.0800000000000001	0.00307692307692308	9299	1
4	Food 1	Intake 3	23	36334	1336590022	/users/cn/jespinosa/phecomp/data/CRG/20120502_FDF_CRG/20120502_FDF_CRG/20120509_FDF_CRG_c12.mtb	1636	204	WWFF	food_fat	3	36311	1336589999	1	0.0600000000000001	0.00260869565217392	9300	1
4	Food 2	Intake 4	263	36801	1336590489	/users/cn/jespinosa/phecomp/data/CRG/20120502_FDF_CRG/20120502_FDF_CRG/20120509_FDF_CRG_c12.mtb	2168	COLL	WWFF	food_fat	4	36538	1336590226	1	0.18	0.000684410646387833	9301	1
4	Food 1	Intake 3	59	36598	1336590286	/users/cn/jespinosa/phecomp/data/CRG/20120502_FDF_CRG/20120502_FDF_CRG/20120509_FDF_CRG_c12.mtb	1637	160	WWFF	food_fat	3	36539	1336590227	1	0.02	0.000338983050847458	9302	1
4	Food 1	Intake 3	12	36770	1336590458	/users/cn/jespinosa/phecomp/data/CRG/20120502_FDF_CRG/20120502_FDF_CRG/20120509_FDF_CRG_c12.mtb	1641	437	WWFF	food_fat	3	36758	1336590446	1	0.04	0.00333333333333333	9303	1
4	Food 2	Intake 4	57	37264	1336590952	/users/cn/jespinosa/phecomp/data/CRG/20120502_FDF_CRG/20120502_FDF_CRG/20120509_FDF_CRG_c12.mtb	2170	COLL	WWFF	food_fat	4	37207	1336590895	1	0.02	0.000350877192982456	9304	1
4	Food 1	Intake 3	28	37262	1336590950	/users/cn/jespinosa/phecomp/data/CRG/20120502_FDF_CRG/20120502_FDF_CRG/20120509_FDF_CRG_c12.mtb	1642	765	WWFF	food_fat	3	37234	1336590922	1	0.02	0.000714285714285714	9305	1
4	Food 1	Intake 3	66	38093	1336591781	/users/cn/jespinosa/phecomp/data/CRG/20120502_FDF_CRG/20120502_FDF_CRG/20120509_FDF_CRG_c12.mtb	1643	29	WWFF	food_fat	3	38027	1336591715	1	0.0800000000000001	0.00121212121212121	9306	1
4	Food 1	Intake 3	41	38163	1336591851	/users/cn/jespinosa/phecomp/data/CRG/20120502_FDF_CRG/20120502_FDF_CRG/20120509_FDF_CRG_c12.mtb	1644	12	WWFF	food_fat	3	38122	1336591810	1	0.0399999999999996	0.000975609756097551	9307	1
4	Food 2	Intake 4	54	38229	1336591917	/users/cn/jespinosa/phecomp/data/CRG/20120502_FDF_CRG/20120502_FDF_CRG/20120509_FDF_CRG_c12.mtb	2173	39	WWFF	food_fat	4	38175	1336591863	1	0.0999999999999999	0.00185185185185185	9308	1
4	Food 2	Intake 4	238	38506	1336592194	/users/cn/jespinosa/phecomp/data/CRG/20120502_FDF_CRG/20120502_FDF_CRG/20120509_FDF_CRG_c12.mtb	2174	COLL	WWFF	food_fat	4	38268	1336591956	1	0.52	0.00218487394957983	9309	1
4	Food 1	Intake 3	211	38502	1336592190	/users/cn/jespinosa/phecomp/data/CRG/20120502_FDF_CRG/20120502_FDF_CRG/20120509_FDF_CRG_c12.mtb	1646	83	WWFF	food_fat	3	38291	1336591979	1	0.28	0.00132701421800948	9310	1
4	Food 1	Intake 3	36	38621	1336592309	/users/cn/jespinosa/phecomp/data/CRG/20120502_FDF_CRG/20120502_FDF_CRG/20120509_FDF_CRG_c12.mtb	1647	11	WWFF	food_fat	3	38585	1336592273	1	0.02	0.000555555555555556	9311	1
4	Food 2	Intake 4	192	38824	1336592512	/users/cn/jespinosa/phecomp/data/CRG/20120502_FDF_CRG/20120502_FDF_CRG/20120509_FDF_CRG_c12.mtb	2176	COLL	WWFF	food_fat	4	38632	1336592320	1	0.12	0.000625	9312	1
4	Food 1	Intake 3	163	38819	1336592507	/users/cn/jespinosa/phecomp/data/CRG/20120502_FDF_CRG/20120502_FDF_CRG/20120509_FDF_CRG_c12.mtb	1648	143	WWFF	food_fat	3	38656	1336592344	1	0.02	0.000122699386503067	9313	1
4	Food 2	Intake 4	506	39468	1336593156	/users/cn/jespinosa/phecomp/data/CRG/20120502_FDF_CRG/20120502_FDF_CRG/20120509_FDF_CRG_c12.mtb	2177	COLL	WWFF	food_fat	4	38962	1336592650	1	0.7	0.00138339920948617	9314	1
4	Food 1	Intake 3	482	39461	1336593149	/users/cn/jespinosa/phecomp/data/CRG/20120502_FDF_CRG/20120502_FDF_CRG/20120509_FDF_CRG_c12.mtb	1649	344	WWFF	food_fat	3	38979	1336592667	1	1	0.0020746887966805	9315	1
4	Food 2	Intake 4	28	39833	1336593521	/users/cn/jespinosa/phecomp/data/CRG/20120502_FDF_CRG/20120502_FDF_CRG/20120509_FDF_CRG_c12.mtb	2178	COLL	WWFF	food_fat	4	39805	1336593493	1	0.02	0.000714285714285714	9316	1
4	Food 1	Intake 3	18	39824	1336593512	/users/cn/jespinosa/phecomp/data/CRG/20120502_FDF_CRG/20120502_FDF_CRG/20120509_FDF_CRG_c12.mtb	1650	269	WWFF	food_fat	3	39806	1336593494	1	0.04	0.00222222222222222	9317	1
4	Drink 1	Intake 1	19	39832	1336593520	/users/cn/jespinosa/phecomp/data/CRG/20120502_FDF_CRG/20120502_FDF_CRG/20120509_FDF_CRG_c12.mtb	1227	NA	WWFF	water	1	39813	1336593501	1	0.08	0.00421052631578947	9318	1
4	Food 2	Intake 4	163	40256	1336593944	/users/cn/jespinosa/phecomp/data/CRG/20120502_FDF_CRG/20120502_FDF_CRG/20120509_FDF_CRG_c12.mtb	2180	419	WWFF	food_fat	4	40093	1336593781	1	0.1	0.000613496932515337	9319	1
4	Food 2	Intake 4	122	40797	1336594485	/users/cn/jespinosa/phecomp/data/CRG/20120502_FDF_CRG/20120502_FDF_CRG/20120509_FDF_CRG_c12.mtb	2181	70	WWFF	food_fat	4	40675	1336594363	1	0.04	0.000327868852459016	9320	1
4	Food 2	Intake 4	101	40968	1336594656	/users/cn/jespinosa/phecomp/data/CRG/20120502_FDF_CRG/20120502_FDF_CRG/20120509_FDF_CRG_c12.mtb	2182	113	WWFF	food_fat	4	40867	1336594555	1	0.02	0.000198019801980198	9321	1
4	Food 2	Intake 4	20	41101	1336594789	/users/cn/jespinosa/phecomp/data/CRG/20120502_FDF_CRG/20120502_FDF_CRG/20120509_FDF_CRG_c12.mtb	2183	30	WWFF	food_fat	4	41081	1336594769	1	0.02	0.001	9322	1
4	Food 2	Intake 4	224	41355	1336595043	/users/cn/jespinosa/phecomp/data/CRG/20120502_FDF_CRG/20120502_FDF_CRG/20120509_FDF_CRG_c12.mtb	2184	400	WWFF	food_fat	4	41131	1336594819	1	0.14	0.000625	9323	1
4	Food 1	Intake 3	21	41776	1336595464	/users/cn/jespinosa/phecomp/data/CRG/20120502_FDF_CRG/20120502_FDF_CRG/20120509_FDF_CRG_c12.mtb	1658	95	WWFF	food_fat	3	41755	1336595443	1	0.04	0.0019047619047619	9324	1
4	Food 2	Intake 4	208	42079	1336595767	/users/cn/jespinosa/phecomp/data/CRG/20120502_FDF_CRG/20120502_FDF_CRG/20120509_FDF_CRG_c12.mtb	2186	COLL	WWFF	food_fat	4	41871	1336595559	1	0.0600000000000001	0.000288461538461539	9325	1
4	Food 1	Intake 3	198	42075	1336595763	/users/cn/jespinosa/phecomp/data/CRG/20120502_FDF_CRG/20120502_FDF_CRG/20120509_FDF_CRG_c12.mtb	1660	77	WWFF	food_fat	3	41877	1336595565	1	0.0399999999999991	0.000202020202020197	9326	1
4	Food 2	Intake 4	207	42359	1336596047	/users/cn/jespinosa/phecomp/data/CRG/20120502_FDF_CRG/20120502_FDF_CRG/20120509_FDF_CRG_c12.mtb	2187	COLL	WWFF	food_fat	4	42152	1336595840	1	0.28	0.00135265700483092	9327	1
4	Food 1	Intake 3	44	42198	1336595886	/users/cn/jespinosa/phecomp/data/CRG/20120502_FDF_CRG/20120502_FDF_CRG/20120509_FDF_CRG_c12.mtb	1661	468	WWFF	food_fat	3	42154	1336595842	1	0.0200000000000005	0.000454545454545466	9328	1
4	Drink 1	Intake 1	22	42215	1336595903	/users/cn/jespinosa/phecomp/data/CRG/20120502_FDF_CRG/20120502_FDF_CRG/20120509_FDF_CRG_c12.mtb	1231	NA	WWFF	water	1	42193	1336595881	1	0.08	0.00363636363636364	9329	1
4	Food 2	Intake 4	13	42679	1336596367	/users/cn/jespinosa/phecomp/data/CRG/20120502_FDF_CRG/20120502_FDF_CRG/20120509_FDF_CRG_c12.mtb	2188	424	WWFF	food_fat	4	42666	1336596354	1	0.02	0.00153846153846154	9330	1
4	Food 2	Intake 4	117	43220	1336596908	/users/cn/jespinosa/phecomp/data/CRG/20120502_FDF_CRG/20120502_FDF_CRG/20120509_FDF_CRG_c12.mtb	2192	COLL	WWFF	food_fat	4	43103	1336596791	1	0.22	0.00188034188034188	9331	1
4	Food 1	Intake 3	40	43145	1336596833	/users/cn/jespinosa/phecomp/data/CRG/20120502_FDF_CRG/20120502_FDF_CRG/20120509_FDF_CRG_c12.mtb	1664	51	WWFF	food_fat	3	43105	1336596793	1	0.0800000000000001	0.002	9332	1
4	Food 1	Intake 3	24	43220	1336596908	/users/cn/jespinosa/phecomp/data/CRG/20120502_FDF_CRG/20120502_FDF_CRG/20120509_FDF_CRG_c12.mtb	1666	151	WWFF	food_fat	3	43196	1336596884	1	0.12	0.005	9333	1
4	Food 2	Intake 4	15	43386	1336597074	/users/cn/jespinosa/phecomp/data/CRG/20120502_FDF_CRG/20120502_FDF_CRG/20120509_FDF_CRG_c12.mtb	2194	868	WWFF	food_fat	4	43371	1336597059	1	0.04	0.00266666666666667	9334	1
4	Drink 1	Intake 1	20	44256	1336597944	/users/cn/jespinosa/phecomp/data/CRG/20120502_FDF_CRG/20120502_FDF_CRG/20120509_FDF_CRG_c12.mtb	1232	NA	WWFF	water	1	44236	1336597924	1	0.1	0.005	9335	1
4	Food 2	Intake 4	23	44277	1336597965	/users/cn/jespinosa/phecomp/data/CRG/20120502_FDF_CRG/20120502_FDF_CRG/20120509_FDF_CRG_c12.mtb	2196	384	WWFF	food_fat	4	44254	1336597942	1	0.02	0.000869565217391304	9336	1
4	Food 2	Intake 4	111	44772	1336598460	/users/cn/jespinosa/phecomp/data/CRG/20120502_FDF_CRG/20120502_FDF_CRG/20120509_FDF_CRG_c12.mtb	2198	COLL	WWFF	food_fat	4	44661	1336598349	1	0.0800000000000001	0.000720720720720722	9337	1
4	Food 1	Intake 3	78	44759	1336598447	/users/cn/jespinosa/phecomp/data/CRG/20120502_FDF_CRG/20120502_FDF_CRG/20120509_FDF_CRG_c12.mtb	1669	611	WWFF	food_fat	3	44681	1336598369	1	0.0200000000000005	0.000256410256410263	9338	1
4	Food 2	Intake 4	226	45596	1336599284	/users/cn/jespinosa/phecomp/data/CRG/20120502_FDF_CRG/20120502_FDF_CRG/20120509_FDF_CRG_c12.mtb	2201	60	WWFF	food_fat	4	45370	1336599058	1	0.0800000000000001	0.000353982300884956	9339	1
4	Drink 2	Intake 2	31	45468	1336599156	/users/cn/jespinosa/phecomp/data/CRG/20120502_FDF_CRG/20120502_FDF_CRG/20120509_FDF_CRG_c12.mtb	1167	NA	WWFF	water	2	45437	1336599125	1	0.04	0.00129032258064516	9340	1
4	Food 1	Intake 3	187	45843	1336599531	/users/cn/jespinosa/phecomp/data/CRG/20120502_FDF_CRG/20120502_FDF_CRG/20120509_FDF_CRG_c12.mtb	1672	64	WWFF	food_fat	3	45656	1336599344	1	0.159999999999999	0.000855614973262027	9341	1
4	Food 2	Intake 4	414	46321	1336600009	/users/cn/jespinosa/phecomp/data/CRG/20120502_FDF_CRG/20120502_FDF_CRG/20120509_FDF_CRG_c12.mtb	2203	COLL	WWFF	food_fat	4	45907	1336599595	1	0.16	0.000386473429951691	9342	1
4	Food 1	Intake 3	410	46318	1336600006	/users/cn/jespinosa/phecomp/data/CRG/20120502_FDF_CRG/20120502_FDF_CRG/20120509_FDF_CRG_c12.mtb	1673	64	WWFF	food_fat	3	45908	1336599596	1	0.54	0.00131707317073171	9343	1
4	Food 2	Intake 4	110	46492	1336600180	/users/cn/jespinosa/phecomp/data/CRG/20120502_FDF_CRG/20120502_FDF_CRG/20120509_FDF_CRG_c12.mtb	2204	COLL	WWFF	food_fat	4	46382	1336600070	1	0.0200000000000005	0.000181818181818186	9344	1
4	Food 1	Intake 3	84	46488	1336600176	/users/cn/jespinosa/phecomp/data/CRG/20120502_FDF_CRG/20120502_FDF_CRG/20120509_FDF_CRG_c12.mtb	1674	33	WWFF	food_fat	3	46404	1336600092	1	0.12	0.00142857142857143	9345	1
4	Food 1	Intake 3	62	46583	1336600271	/users/cn/jespinosa/phecomp/data/CRG/20120502_FDF_CRG/20120502_FDF_CRG/20120509_FDF_CRG_c12.mtb	1675	COLL	WWFF	food_fat	3	46521	1336600209	1	0.12	0.00193548387096774	9346	1
4	Food 2	Intake 4	68	46590	1336600278	/users/cn/jespinosa/phecomp/data/CRG/20120502_FDF_CRG/20120502_FDF_CRG/20120509_FDF_CRG_c12.mtb	2205	7	WWFF	food_fat	4	46522	1336600210	1	0.0799999999999996	0.00117647058823529	9347	1
4	Drink 1	Intake 1	31	46613	1336600301	/users/cn/jespinosa/phecomp/data/CRG/20120502_FDF_CRG/20120502_FDF_CRG/20120509_FDF_CRG_c12.mtb	1234	NA	WWFF	water	1	46582	1336600270	1	0.12	0.00387096774193548	9348	1
4	Food 2	Intake 4	369	46966	1336600654	/users/cn/jespinosa/phecomp/data/CRG/20120502_FDF_CRG/20120502_FDF_CRG/20120509_FDF_CRG_c12.mtb	2206	COLL	WWFF	food_fat	4	46597	1336600285	1	0.16	0.00043360433604336	9349	1
4	Food 1	Intake 3	98	46713	1336600401	/users/cn/jespinosa/phecomp/data/CRG/20120502_FDF_CRG/20120502_FDF_CRG/20120509_FDF_CRG_c12.mtb	1676	9	WWFF	food_fat	3	46615	1336600303	1	0.58	0.00591836734693878	9350	1
4	Food 1	Intake 3	241	46963	1336600651	/users/cn/jespinosa/phecomp/data/CRG/20120502_FDF_CRG/20120502_FDF_CRG/20120509_FDF_CRG_c12.mtb	1677	106	WWFF	food_fat	3	46722	1336600410	1	0.2	0.000829875518672199	9351	1
4	Food 2	Intake 4	18	47087	1336600775	/users/cn/jespinosa/phecomp/data/CRG/20120502_FDF_CRG/20120502_FDF_CRG/20120509_FDF_CRG_c12.mtb	2208	184	WWFF	food_fat	4	47069	1336600757	1	0.1	0.00555555555555556	9352	1
4	Food 2	Intake 4	184	47455	1336601143	/users/cn/jespinosa/phecomp/data/CRG/20120502_FDF_CRG/20120502_FDF_CRG/20120509_FDF_CRG_c12.mtb	2210	COLL	WWFF	food_fat	4	47271	1336600959	1	0.12	0.000652173913043478	9353	1
4	Food 1	Intake 3	169	47453	1336601141	/users/cn/jespinosa/phecomp/data/CRG/20120502_FDF_CRG/20120502_FDF_CRG/20120509_FDF_CRG_c12.mtb	1680	154	WWFF	food_fat	3	47284	1336600972	1	0.0599999999999996	0.000355029585798814	9354	1
4	Drink 1	Intake 1	36	47560	1336601248	/users/cn/jespinosa/phecomp/data/CRG/20120502_FDF_CRG/20120502_FDF_CRG/20120509_FDF_CRG_c12.mtb	1236	NA	WWFF	water	1	47524	1336601212	1	0.02	0.000555555555555556	9355	1
4	Food 1	Intake 3	112	47719	1336601407	/users/cn/jespinosa/phecomp/data/CRG/20120502_FDF_CRG/20120502_FDF_CRG/20120509_FDF_CRG_c12.mtb	1682	COLL	WWFF	food_fat	3	47607	1336601295	1	0.34	0.00303571428571429	9356	1
4	Food 2	Intake 4	119	47727	1336601415	/users/cn/jespinosa/phecomp/data/CRG/20120502_FDF_CRG/20120502_FDF_CRG/20120509_FDF_CRG_c12.mtb	2212	12	WWFF	food_fat	4	47608	1336601296	1	0.0800000000000001	0.000672268907563026	9357	1
4	Food 1	Intake 3	196	47935	1336601623	/users/cn/jespinosa/phecomp/data/CRG/20120502_FDF_CRG/20120502_FDF_CRG/20120509_FDF_CRG_c12.mtb	1683	COLL	WWFF	food_fat	3	47739	1336601427	1	0.94	0.00479591836734694	9358	1
4	Food 2	Intake 4	198	47938	1336601626	/users/cn/jespinosa/phecomp/data/CRG/20120502_FDF_CRG/20120502_FDF_CRG/20120509_FDF_CRG_c12.mtb	2213	290	WWFF	food_fat	4	47740	1336601428	1	0.16	0.000808080808080808	9359	1
4	Food 1	Intake 3	52	48280	1336601968	/users/cn/jespinosa/phecomp/data/CRG/20120502_FDF_CRG/20120502_FDF_CRG/20120509_FDF_CRG_c12.mtb	1684	COLL	WWFF	food_fat	3	48228	1336601916	1	0.140000000000001	0.00269230769230771	9360	1
4	Food 2	Intake 4	271	48500	1336602188	/users/cn/jespinosa/phecomp/data/CRG/20120502_FDF_CRG/20120502_FDF_CRG/20120509_FDF_CRG_c12.mtb	2214	666	WWFF	food_fat	4	48229	1336601917	1	0.0800000000000001	0.000295202952029521	9361	1
4	Drink 2	Intake 2	14	48335	1336602023	/users/cn/jespinosa/phecomp/data/CRG/20120502_FDF_CRG/20120502_FDF_CRG/20120509_FDF_CRG_c12.mtb	1174	NA	WWFF	water	2	48321	1336602009	1	0.06	0.00428571428571429	9362	1
4	Food 2	Intake 4	104	49270	1336602958	/users/cn/jespinosa/phecomp/data/CRG/20120502_FDF_CRG/20120502_FDF_CRG/20120509_FDF_CRG_c12.mtb	2218	27	WWFF	food_fat	4	49166	1336602854	1	0.0800000000000001	0.00076923076923077	9363	1
4	Food 2	Intake 4	81	49378	1336603066	/users/cn/jespinosa/phecomp/data/CRG/20120502_FDF_CRG/20120502_FDF_CRG/20120509_FDF_CRG_c12.mtb	2219	13	WWFF	food_fat	4	49297	1336602985	1	0.12	0.00148148148148148	9364	1
4	Food 1	Intake 3	62	49453	1336603141	/users/cn/jespinosa/phecomp/data/CRG/20120502_FDF_CRG/20120502_FDF_CRG/20120509_FDF_CRG_c12.mtb	1688	COLL	WWFF	food_fat	3	49391	1336603079	1	0.100000000000001	0.00161290322580647	9365	1
4	Food 2	Intake 4	63	49455	1336603143	/users/cn/jespinosa/phecomp/data/CRG/20120502_FDF_CRG/20120502_FDF_CRG/20120509_FDF_CRG_c12.mtb	2220	4	WWFF	food_fat	4	49392	1336603080	1	0.04	0.000634920634920635	9366	1
4	Food 1	Intake 3	106	49565	1336603253	/users/cn/jespinosa/phecomp/data/CRG/20120502_FDF_CRG/20120502_FDF_CRG/20120509_FDF_CRG_c12.mtb	1689	COLL	WWFF	food_fat	3	49459	1336603147	1	0.32	0.0030188679245283	9367	1
4	Food 2	Intake 4	330	49790	1336603478	/users/cn/jespinosa/phecomp/data/CRG/20120502_FDF_CRG/20120502_FDF_CRG/20120509_FDF_CRG_c12.mtb	2221	COLL	WWFF	food_fat	4	49460	1336603148	1	0.14	0.000424242424242424	9368	1
4	Food 1	Intake 3	199	49788	1336603476	/users/cn/jespinosa/phecomp/data/CRG/20120502_FDF_CRG/20120502_FDF_CRG/20120509_FDF_CRG_c12.mtb	1690	699	WWFF	food_fat	3	49589	1336603277	1	0.119999999999999	0.000603015075376879	9369	1
4	Drink 1	Intake 1	20	49935	1336603623	/users/cn/jespinosa/phecomp/data/CRG/20120502_FDF_CRG/20120502_FDF_CRG/20120509_FDF_CRG_c12.mtb	1238	NA	WWFF	water	1	49915	1336603603	1	0.08	0.004	9370	1
4	Drink 2	Intake 2	24	49980	1336603668	/users/cn/jespinosa/phecomp/data/CRG/20120502_FDF_CRG/20120502_FDF_CRG/20120509_FDF_CRG_c12.mtb	1175	NA	WWFF	water	2	49956	1336603644	1	0.02	0.000833333333333333	9371	1
4	Food 2	Intake 4	450	50937	1336604625	/users/cn/jespinosa/phecomp/data/CRG/20120502_FDF_CRG/20120502_FDF_CRG/20120509_FDF_CRG_c12.mtb	2226	COLL	WWFF	food_fat	4	50487	1336604175	1	0.0999999999999996	0.000222222222222221	9372	1
4	Food 1	Intake 3	110	50658	1336604346	/users/cn/jespinosa/phecomp/data/CRG/20120502_FDF_CRG/20120502_FDF_CRG/20120509_FDF_CRG_c12.mtb	1695	294	WWFF	food_fat	3	50548	1336604236	1	0.0399999999999991	0.000363636363636355	9373	1
4	Food 1	Intake 3	250	51202	1336604890	/users/cn/jespinosa/phecomp/data/CRG/20120502_FDF_CRG/20120502_FDF_CRG/20120509_FDF_CRG_c12.mtb	1699	9	WWFF	food_fat	3	50952	1336604640	1	0.0400000000000009	0.000160000000000004	9374	1
4	Food 2	Intake 4	498	51709	1336605397	/users/cn/jespinosa/phecomp/data/CRG/20120502_FDF_CRG/20120502_FDF_CRG/20120509_FDF_CRG_c12.mtb	2228	38	WWFF	food_fat	4	51211	1336604899	1	0.12	0.000240963855421687	9375	1
4	Food 2	Intake 4	144	51891	1336605579	/users/cn/jespinosa/phecomp/data/CRG/20120502_FDF_CRG/20120502_FDF_CRG/20120509_FDF_CRG_c12.mtb	2229	4	WWFF	food_fat	4	51747	1336605435	1	0.0399999999999991	0.000277777777777772	9376	1
4	Drink 2	Intake 2	44	51884	1336605572	/users/cn/jespinosa/phecomp/data/CRG/20120502_FDF_CRG/20120502_FDF_CRG/20120509_FDF_CRG_c12.mtb	1177	NA	WWFF	water	2	51840	1336605528	1	0.12	0.00272727272727273	9377	1
4	Food 2	Intake 4	56	51951	1336605639	/users/cn/jespinosa/phecomp/data/CRG/20120502_FDF_CRG/20120502_FDF_CRG/20120509_FDF_CRG_c12.mtb	2230	COLL	WWFF	food_fat	4	51895	1336605583	1	0.0200000000000005	0.000357142857142866	9378	1
4	Food 1	Intake 3	54	51950	1336605638	/users/cn/jespinosa/phecomp/data/CRG/20120502_FDF_CRG/20120502_FDF_CRG/20120509_FDF_CRG_c12.mtb	1704	470	WWFF	food_fat	3	51896	1336605584	1	0.0200000000000014	0.000370370370370396	9379	1
4	Food 2	Intake 4	246	52666	1336606354	/users/cn/jespinosa/phecomp/data/CRG/20120502_FDF_CRG/20120502_FDF_CRG/20120509_FDF_CRG_c12.mtb	2233	COLL	WWFF	food_fat	4	52420	1336606108	1	0.16	0.000650406504065041	9380	1
4	Food 1	Intake 3	242	52663	1336606351	/users/cn/jespinosa/phecomp/data/CRG/20120502_FDF_CRG/20120502_FDF_CRG/20120509_FDF_CRG_c12.mtb	1709	9	WWFF	food_fat	3	52421	1336606109	1	0.180000000000001	0.000743801652892566	9381	1
4	Food 2	Intake 4	377	53049	1336606737	/users/cn/jespinosa/phecomp/data/CRG/20120502_FDF_CRG/20120502_FDF_CRG/20120509_FDF_CRG_c12.mtb	2234	431	WWFF	food_fat	4	52672	1336606360	1	0.04	0.000106100795755968	9382	1
4	Food 2	Intake 4	13	53493	1336607181	/users/cn/jespinosa/phecomp/data/CRG/20120502_FDF_CRG/20120502_FDF_CRG/20120509_FDF_CRG_c12.mtb	2237	2265	WWFF	food_fat	4	53480	1336607168	1	0.04	0.00307692307692308	9383	1
4	Drink 1	Intake 1	13	54611	1336608299	/users/cn/jespinosa/phecomp/data/CRG/20120502_FDF_CRG/20120502_FDF_CRG/20120509_FDF_CRG_c12.mtb	1240	NA	WWFF	water	1	54598	1336608286	1	0.08	0.00615384615384615	9384	1
4	Food 1	Intake 3	14	55772	1336609460	/users/cn/jespinosa/phecomp/data/CRG/20120502_FDF_CRG/20120502_FDF_CRG/20120509_FDF_CRG_c12.mtb	1716	27	WWFF	food_fat	3	55758	1336609446	1	0.0999999999999996	0.00714285714285711	9385	1
4	Food 2	Intake 4	52	55851	1336609539	/users/cn/jespinosa/phecomp/data/CRG/20120502_FDF_CRG/20120502_FDF_CRG/20120509_FDF_CRG_c12.mtb	2244	155	WWFF	food_fat	4	55799	1336609487	1	0.18	0.00346153846153846	9386	1
4	Food 2	Intake 4	90	56096	1336609784	/users/cn/jespinosa/phecomp/data/CRG/20120502_FDF_CRG/20120502_FDF_CRG/20120509_FDF_CRG_c12.mtb	2246	528	WWFF	food_fat	4	56006	1336609694	1	0.180000000000001	0.00200000000000001	9387	1
4	Drink 1	Intake 1	13	56362	1336610050	/users/cn/jespinosa/phecomp/data/CRG/20120502_FDF_CRG/20120502_FDF_CRG/20120509_FDF_CRG_c12.mtb	1241	NA	WWFF	water	1	56349	1336610037	1	0.04	0.00307692307692308	9388	1
4	Food 2	Intake 4	17	56641	1336610329	/users/cn/jespinosa/phecomp/data/CRG/20120502_FDF_CRG/20120502_FDF_CRG/20120509_FDF_CRG_c12.mtb	2248	1096	WWFF	food_fat	4	56624	1336610312	1	0.04	0.00235294117647059	9389	1
4	Drink 1	Intake 1	13	57453	1336611141	/users/cn/jespinosa/phecomp/data/CRG/20120502_FDF_CRG/20120502_FDF_CRG/20120509_FDF_CRG_c12.mtb	1242	NA	WWFF	water	1	57440	1336611128	1	0.02	0.00153846153846154	9390	1
4	Food 1	Intake 3	136	57873	1336611561	/users/cn/jespinosa/phecomp/data/CRG/20120502_FDF_CRG/20120502_FDF_CRG/20120509_FDF_CRG_c12.mtb	1723	COLL	WWFF	food_fat	3	57737	1336611425	1	0.0200000000000014	0.000147058823529422	9391	1
4	Food 2	Intake 4	137	57875	1336611563	/users/cn/jespinosa/phecomp/data/CRG/20120502_FDF_CRG/20120502_FDF_CRG/20120509_FDF_CRG_c12.mtb	2253	143	WWFF	food_fat	4	57738	1336611426	1	0.100000000000001	0.000729927007299277	9392	1
4	Food 1	Intake 3	118	58136	1336611824	/users/cn/jespinosa/phecomp/data/CRG/20120502_FDF_CRG/20120502_FDF_CRG/20120509_FDF_CRG_c12.mtb	1725	257	WWFF	food_fat	3	58018	1336611706	1	0.0999999999999996	0.000847457627118641	9393	1
4	Food 2	Intake 4	150	58543	1336612231	/users/cn/jespinosa/phecomp/data/CRG/20120502_FDF_CRG/20120502_FDF_CRG/20120509_FDF_CRG_c12.mtb	2257	22	WWFF	food_fat	4	58393	1336612081	1	0.24	0.0016	9394	1
4	Food 1	Intake 3	369	58934	1336612622	/users/cn/jespinosa/phecomp/data/CRG/20120502_FDF_CRG/20120502_FDF_CRG/20120509_FDF_CRG_c12.mtb	1728	148	WWFF	food_fat	3	58565	1336612253	1	0.100000000000001	0.000271002710027103	9395	1
4	Drink 1	Intake 1	13	58878	1336612566	/users/cn/jespinosa/phecomp/data/CRG/20120502_FDF_CRG/20120502_FDF_CRG/20120509_FDF_CRG_c12.mtb	1243	NA	WWFF	water	1	58865	1336612553	1	0.02	0.00153846153846154	9396	1
4	Food 2	Intake 4	11	59093	1336612781	/users/cn/jespinosa/phecomp/data/CRG/20120502_FDF_CRG/20120502_FDF_CRG/20120509_FDF_CRG_c12.mtb	2261	10	WWFF	food_fat	4	59082	1336612770	1	0.0600000000000005	0.0054545454545455	9397	1
4	Drink 2	Intake 2	38	59122	1336612810	/users/cn/jespinosa/phecomp/data/CRG/20120502_FDF_CRG/20120502_FDF_CRG/20120509_FDF_CRG_c12.mtb	1183	NA	WWFF	water	2	59084	1336612772	1	0.08	0.00210526315789474	9398	1
4	Food 2	Intake 4	256	59359	1336613047	/users/cn/jespinosa/phecomp/data/CRG/20120502_FDF_CRG/20120502_FDF_CRG/20120509_FDF_CRG_c12.mtb	2262	108	WWFF	food_fat	4	59103	1336612791	1	0.26	0.001015625	9399	1
4	Drink 2	Intake 2	38	59212	1336612900	/users/cn/jespinosa/phecomp/data/CRG/20120502_FDF_CRG/20120502_FDF_CRG/20120509_FDF_CRG_c12.mtb	1184	NA	WWFF	water	2	59174	1336612862	1	0.02	0.000526315789473684	9400	1
4	Drink 2	Intake 2	25	59251	1336612939	/users/cn/jespinosa/phecomp/data/CRG/20120502_FDF_CRG/20120502_FDF_CRG/20120509_FDF_CRG_c12.mtb	1185	NA	WWFF	water	2	59226	1336612914	1	0.02	0.0008	9401	1
4	Food 1	Intake 3	43	59510	1336613198	/users/cn/jespinosa/phecomp/data/CRG/20120502_FDF_CRG/20120502_FDF_CRG/20120509_FDF_CRG_c12.mtb	1733	353	WWFF	food_fat	3	59467	1336613155	1	0.0399999999999991	0.000930232558139514	9402	1
4	Food 2	Intake 4	615	60478	1336614166	/users/cn/jespinosa/phecomp/data/CRG/20120502_FDF_CRG/20120502_FDF_CRG/20120509_FDF_CRG_c12.mtb	2264	COLL	WWFF	food_fat	4	59863	1336613551	1	0.0999999999999996	0.00016260162601626	9403	1
4	Food 1	Intake 3	354	60481	1336614169	/users/cn/jespinosa/phecomp/data/CRG/20120502_FDF_CRG/20120502_FDF_CRG/20120509_FDF_CRG_c12.mtb	1736	24	WWFF	food_fat	3	60127	1336613815	1	0.239999999999998	0.00067796610169491	9404	1
4	Food 2	Intake 4	364	60869	1336614557	/users/cn/jespinosa/phecomp/data/CRG/20120502_FDF_CRG/20120502_FDF_CRG/20120509_FDF_CRG_c12.mtb	2265	COLL	WWFF	food_fat	4	60505	1336614193	1	0.3	0.000824175824175824	9405	1
4	Food 1	Intake 3	353	60866	1336614554	/users/cn/jespinosa/phecomp/data/CRG/20120502_FDF_CRG/20120502_FDF_CRG/20120509_FDF_CRG_c12.mtb	1737	77	WWFF	food_fat	3	60513	1336614201	1	0.9	0.00254957507082153	9406	1
4	Food 2	Intake 4	37	60980	1336614668	/users/cn/jespinosa/phecomp/data/CRG/20120502_FDF_CRG/20120502_FDF_CRG/20120509_FDF_CRG_c12.mtb	2266	COLL	WWFF	food_fat	4	60943	1336614631	1	0.12	0.00324324324324324	9407	1
4	Food 1	Intake 3	13	60962	1336614650	/users/cn/jespinosa/phecomp/data/CRG/20120502_FDF_CRG/20120502_FDF_CRG/20120509_FDF_CRG_c12.mtb	1738	426	WWFF	food_fat	3	60949	1336614637	1	0.0400000000000009	0.00307692307692315	9408	1
4	Drink 1	Intake 1	23	60974	1336614662	/users/cn/jespinosa/phecomp/data/CRG/20120502_FDF_CRG/20120502_FDF_CRG/20120509_FDF_CRG_c12.mtb	1246	NA	WWFF	water	1	60951	1336614639	1	0.1	0.00434782608695652	9409	1
4	Food 2	Intake 4	15	61403	1336615091	/users/cn/jespinosa/phecomp/data/CRG/20120502_FDF_CRG/20120502_FDF_CRG/20120509_FDF_CRG_c12.mtb	2267	519	WWFF	food_fat	4	61388	1336615076	1	0.0200000000000005	0.00133333333333337	9410	1
4	Food 2	Intake 4	14	61936	1336615624	/users/cn/jespinosa/phecomp/data/CRG/20120502_FDF_CRG/20120502_FDF_CRG/20120509_FDF_CRG_c12.mtb	2270	2073	WWFF	food_fat	4	61922	1336615610	1	0.0200000000000005	0.00142857142857146	9411	1
4	Drink 1	Intake 1	13	63042	1336616730	/users/cn/jespinosa/phecomp/data/CRG/20120502_FDF_CRG/20120502_FDF_CRG/20120509_FDF_CRG_c12.mtb	1247	NA	WWFF	water	1	63029	1336616717	1	0.0800000000000001	0.00615384615384616	9412	1
4	Food 2	Intake 4	28	64037	1336617725	/users/cn/jespinosa/phecomp/data/CRG/20120502_FDF_CRG/20120502_FDF_CRG/20120509_FDF_CRG_c12.mtb	2274	439	WWFF	food_fat	4	64009	1336617697	1	0.0200000000000005	0.000714285714285732	9413	1
4	Food 2	Intake 4	24	64500	1336618188	/users/cn/jespinosa/phecomp/data/CRG/20120502_FDF_CRG/20120502_FDF_CRG/20120509_FDF_CRG_c12.mtb	2276	596	WWFF	food_fat	4	64476	1336618164	1	0.0200000000000005	0.000833333333333354	9414	1
4	Food 2	Intake 4	38	65134	1336618822	/users/cn/jespinosa/phecomp/data/CRG/20120502_FDF_CRG/20120502_FDF_CRG/20120509_FDF_CRG_c12.mtb	2279	486	WWFF	food_fat	4	65096	1336618784	1	0.0800000000000001	0.00210526315789474	9415	1
4	Food 2	Intake 4	12	65632	1336619320	/users/cn/jespinosa/phecomp/data/CRG/20120502_FDF_CRG/20120502_FDF_CRG/20120509_FDF_CRG_c12.mtb	2282	28	WWFF	food_fat	4	65620	1336619308	1	0.0600000000000005	0.00500000000000004	9416	1
4	Food 2	Intake 4	223	65883	1336619571	/users/cn/jespinosa/phecomp/data/CRG/20120502_FDF_CRG/20120502_FDF_CRG/20120509_FDF_CRG_c12.mtb	2283	COLL	WWFF	food_fat	4	65660	1336619348	1	0.12	0.000538116591928251	9417	1
4	Food 1	Intake 3	123	65785	1336619473	/users/cn/jespinosa/phecomp/data/CRG/20120502_FDF_CRG/20120502_FDF_CRG/20120509_FDF_CRG_c12.mtb	1742	122	WWFF	food_fat	3	65662	1336619350	1	0.16	0.00130081300813008	9418	1
4	Food 2	Intake 4	150	66057	1336619745	/users/cn/jespinosa/phecomp/data/CRG/20120502_FDF_CRG/20120502_FDF_CRG/20120509_FDF_CRG_c12.mtb	2284	969	WWFF	food_fat	4	65907	1336619595	1	0.04	0.000266666666666667	9419	1
4	Food 2	Intake 4	17	67043	1336620731	/users/cn/jespinosa/phecomp/data/CRG/20120502_FDF_CRG/20120502_FDF_CRG/20120509_FDF_CRG_c12.mtb	2286	503	WWFF	food_fat	4	67026	1336620714	1	0.0200000000000005	0.00117647058823532	9420	1
4	Food 2	Intake 4	47	67593	1336621281	/users/cn/jespinosa/phecomp/data/CRG/20120502_FDF_CRG/20120502_FDF_CRG/20120509_FDF_CRG_c12.mtb	2287	1585	WWFF	food_fat	4	67546	1336621234	1	0.04	0.000851063829787234	9421	1
4	Food 2	Intake 4	44	69222	1336622910	/users/cn/jespinosa/phecomp/data/CRG/20120502_FDF_CRG/20120502_FDF_CRG/20120509_FDF_CRG_c12.mtb	2297	257	WWFF	food_fat	4	69178	1336622866	1	0.0600000000000005	0.00136363636363638	9422	1
4	Food 2	Intake 4	13	69492	1336623180	/users/cn/jespinosa/phecomp/data/CRG/20120502_FDF_CRG/20120502_FDF_CRG/20120509_FDF_CRG_c12.mtb	2298	292	WWFF	food_fat	4	69479	1336623167	1	0.04	0.00307692307692308	9423	1
4	Food 2	Intake 4	171	69955	1336623643	/users/cn/jespinosa/phecomp/data/CRG/20120502_FDF_CRG/20120502_FDF_CRG/20120509_FDF_CRG_c12.mtb	2301	COLL	WWFF	food_fat	4	69784	1336623472	1	0.0800000000000001	0.000467836257309942	9424	1
4	Food 1	Intake 3	73	69953	1336623641	/users/cn/jespinosa/phecomp/data/CRG/20120502_FDF_CRG/20120502_FDF_CRG/20120509_FDF_CRG_c12.mtb	1754	285	WWFF	food_fat	3	69880	1336623568	1	0.0400000000000009	0.000547945205479464	9425	1
4	Drink 2	Intake 2	31	70249	1336623937	/users/cn/jespinosa/phecomp/data/CRG/20120502_FDF_CRG/20120502_FDF_CRG/20120509_FDF_CRG_c12.mtb	1188	NA	WWFF	water	2	70218	1336623906	1	0.08	0.00258064516129032	9426	1
4	Food 2	Intake 4	13	70251	1336623939	/users/cn/jespinosa/phecomp/data/CRG/20120502_FDF_CRG/20120502_FDF_CRG/20120509_FDF_CRG_c12.mtb	2304	183	WWFF	food_fat	4	70238	1336623926	1	0.12	0.00923076923076923	9427	1
4	Food 2	Intake 4	12	70446	1336624134	/users/cn/jespinosa/phecomp/data/CRG/20120502_FDF_CRG/20120502_FDF_CRG/20120509_FDF_CRG_c12.mtb	2305	802	WWFF	food_fat	4	70434	1336624122	1	0.04	0.00333333333333333	9428	1
4	Food 2	Intake 4	15	71263	1336624951	/users/cn/jespinosa/phecomp/data/CRG/20120502_FDF_CRG/20120502_FDF_CRG/20120509_FDF_CRG_c12.mtb	2308	95	WWFF	food_fat	4	71248	1336624936	1	0.04	0.00266666666666667	9429	1
4	Food 2	Intake 4	13	71371	1336625059	/users/cn/jespinosa/phecomp/data/CRG/20120502_FDF_CRG/20120502_FDF_CRG/20120509_FDF_CRG_c12.mtb	2310	321	WWFF	food_fat	4	71358	1336625046	1	0.0600000000000005	0.00461538461538465	9430	1
4	Food 2	Intake 4	116	71808	1336625496	/users/cn/jespinosa/phecomp/data/CRG/20120502_FDF_CRG/20120502_FDF_CRG/20120509_FDF_CRG_c12.mtb	2311	587	WWFF	food_fat	4	71692	1336625380	1	0.0999999999999996	0.000862068965517238	9431	1
4	Food 2	Intake 4	36	72431	1336626119	/users/cn/jespinosa/phecomp/data/CRG/20120502_FDF_CRG/20120502_FDF_CRG/20120509_FDF_CRG_c12.mtb	2313	182	WWFF	food_fat	4	72395	1336626083	1	0.04	0.00111111111111111	9432	1
4	Food 2	Intake 4	90	72703	1336626391	/users/cn/jespinosa/phecomp/data/CRG/20120502_FDF_CRG/20120502_FDF_CRG/20120509_FDF_CRG_c12.mtb	2314	758	WWFF	food_fat	4	72613	1336626301	1	0.0200000000000005	0.000222222222222228	9433	1
4	Food 1	Intake 3	95	73556	1336627244	/users/cn/jespinosa/phecomp/data/CRG/20120502_FDF_CRG/20120502_FDF_CRG/20120509_FDF_CRG_c12.mtb	1764	22	WWFF	food_fat	3	73461	1336627149	1	0.0800000000000001	0.000842105263157896	9434	1
4	Food 1	Intake 3	83	73661	1336627349	/users/cn/jespinosa/phecomp/data/CRG/20120502_FDF_CRG/20120502_FDF_CRG/20120509_FDF_CRG_c12.mtb	1765	19	WWFF	food_fat	3	73578	1336627266	1	0.0800000000000001	0.000963855421686748	9435	1
4	Food 2	Intake 4	139	73819	1336627507	/users/cn/jespinosa/phecomp/data/CRG/20120502_FDF_CRG/20120502_FDF_CRG/20120509_FDF_CRG_c12.mtb	2316	COLL	WWFF	food_fat	4	73680	1336627368	1	0.26	0.0018705035971223	9436	1
4	Food 1	Intake 3	129	73817	1336627505	/users/cn/jespinosa/phecomp/data/CRG/20120502_FDF_CRG/20120502_FDF_CRG/20120509_FDF_CRG_c12.mtb	1766	8	WWFF	food_fat	3	73688	1336627376	1	0.5	0.00387596899224806	9437	1
4	Food 1	Intake 3	229	74054	1336627742	/users/cn/jespinosa/phecomp/data/CRG/20120502_FDF_CRG/20120502_FDF_CRG/20120509_FDF_CRG_c12.mtb	1767	46	WWFF	food_fat	3	73825	1336627513	1	0.539999999999999	0.00235807860262008	9438	1
4	Drink 1	Intake 1	21	74051	1336627739	/users/cn/jespinosa/phecomp/data/CRG/20120502_FDF_CRG/20120502_FDF_CRG/20120509_FDF_CRG_c12.mtb	1249	NA	WWFF	water	1	74030	1336627718	1	0.12	0.00571428571428571	9439	1
4	Food 2	Intake 4	80	74180	1336627868	/users/cn/jespinosa/phecomp/data/CRG/20120502_FDF_CRG/20120502_FDF_CRG/20120509_FDF_CRG_c12.mtb	2318	20	WWFF	food_fat	4	74100	1336627788	1	0.14	0.00175	9440	1
4	Food 2	Intake 4	247	74447	1336628135	/users/cn/jespinosa/phecomp/data/CRG/20120502_FDF_CRG/20120502_FDF_CRG/20120509_FDF_CRG_c12.mtb	2319	COLL	WWFF	food_fat	4	74200	1336627888	1	0.04	0.000161943319838057	9441	1
4	Food 1	Intake 3	242	74443	1336628131	/users/cn/jespinosa/phecomp/data/CRG/20120502_FDF_CRG/20120502_FDF_CRG/20120509_FDF_CRG_c12.mtb	1769	79	WWFF	food_fat	3	74201	1336627889	1	0.0999999999999996	0.000413223140495866	9442	1
4	Food 2	Intake 4	285	74807	1336628495	/users/cn/jespinosa/phecomp/data/CRG/20120502_FDF_CRG/20120502_FDF_CRG/20120509_FDF_CRG_c12.mtb	2320	COLL	WWFF	food_fat	4	74522	1336628210	1	0.0200000000000005	7.0175438596493e-05	9443	1
4	Food 1	Intake 3	141	74805	1336628493	/users/cn/jespinosa/phecomp/data/CRG/20120502_FDF_CRG/20120502_FDF_CRG/20120509_FDF_CRG_c12.mtb	1771	14	WWFF	food_fat	3	74664	1336628352	1	0.0600000000000005	0.000425531914893621	9444	1
4	Food 2	Intake 4	255	75074	1336628762	/users/cn/jespinosa/phecomp/data/CRG/20120502_FDF_CRG/20120502_FDF_CRG/20120509_FDF_CRG_c12.mtb	2321	COLL	WWFF	food_fat	4	74819	1336628507	1	0.0599999999999996	0.000235294117647057	9445	1
4	Food 1	Intake 3	252	75074	1336628762	/users/cn/jespinosa/phecomp/data/CRG/20120502_FDF_CRG/20120502_FDF_CRG/20120509_FDF_CRG_c12.mtb	1772	37	WWFF	food_fat	3	74822	1336628510	1	0.0599999999999987	0.000238095238095233	9446	1
4	Food 2	Intake 4	121	75232	1336628920	/users/cn/jespinosa/phecomp/data/CRG/20120502_FDF_CRG/20120502_FDF_CRG/20120509_FDF_CRG_c12.mtb	2322	COLL	WWFF	food_fat	4	75111	1336628799	1	0.14	0.00115702479338843	9447	1
4	Food 1	Intake 3	113	75225	1336628913	/users/cn/jespinosa/phecomp/data/CRG/20120502_FDF_CRG/20120502_FDF_CRG/20120509_FDF_CRG_c12.mtb	1773	62	WWFF	food_fat	3	75112	1336628800	1	0.5	0.00442477876106195	9448	1
4	Drink 1	Intake 1	20	75232	1336628920	/users/cn/jespinosa/phecomp/data/CRG/20120502_FDF_CRG/20120502_FDF_CRG/20120509_FDF_CRG_c12.mtb	1251	NA	WWFF	water	1	75212	1336628900	1	0.0600000000000001	0.00300000000000001	9449	1
4	Food 1	Intake 3	20	75307	1336628995	/users/cn/jespinosa/phecomp/data/CRG/20120502_FDF_CRG/20120502_FDF_CRG/20120509_FDF_CRG_c12.mtb	1774	106	WWFF	food_fat	3	75287	1336628975	1	0.0200000000000014	0.00100000000000007	9450	1
4	Food 1	Intake 3	161	75574	1336629262	/users/cn/jespinosa/phecomp/data/CRG/20120502_FDF_CRG/20120502_FDF_CRG/20120509_FDF_CRG_c12.mtb	1775	26	WWFF	food_fat	3	75413	1336629101	1	0.84	0.00521739130434783	9451	1
4	Food 2	Intake 4	116	75716	1336629404	/users/cn/jespinosa/phecomp/data/CRG/20120502_FDF_CRG/20120502_FDF_CRG/20120509_FDF_CRG_c12.mtb	2325	COLL	WWFF	food_fat	4	75600	1336629288	1	0.0999999999999996	0.000862068965517238	9452	1
4	Food 1	Intake 3	100	75707	1336629395	/users/cn/jespinosa/phecomp/data/CRG/20120502_FDF_CRG/20120502_FDF_CRG/20120509_FDF_CRG_c12.mtb	1776	57	WWFF	food_fat	3	75607	1336629295	1	0.799999999999999	0.00799999999999999	9453	1
4	Food 2	Intake 4	405	76169	1336629857	/users/cn/jespinosa/phecomp/data/CRG/20120502_FDF_CRG/20120502_FDF_CRG/20120509_FDF_CRG_c12.mtb	2326	COLL	WWFF	food_fat	4	75764	1336629452	1	0.14	0.000345679012345679	9454	1
4	Food 1	Intake 3	400	76165	1336629853	/users/cn/jespinosa/phecomp/data/CRG/20120502_FDF_CRG/20120502_FDF_CRG/20120509_FDF_CRG_c12.mtb	1777	104	WWFF	food_fat	3	75765	1336629453	1	0.440000000000001	0.0011	9455	1
4	Food 2	Intake 4	8	76277	1336629965	/users/cn/jespinosa/phecomp/data/CRG/20120502_FDF_CRG/20120502_FDF_CRG/20120509_FDF_CRG_c12.mtb	2327	33	WWFF	food_fat	4	76269	1336629957	1	0.0200000000000005	0.00250000000000006	9456	1
4	Drink 1	Intake 1	27	76307	1336629995	/users/cn/jespinosa/phecomp/data/CRG/20120502_FDF_CRG/20120502_FDF_CRG/20120509_FDF_CRG_c12.mtb	1252	NA	WWFF	water	1	76280	1336629968	1	0.12	0.00444444444444444	9457	1
4	Food 1	Intake 3	215	76525	1336630213	/users/cn/jespinosa/phecomp/data/CRG/20120502_FDF_CRG/20120502_FDF_CRG/20120509_FDF_CRG_c12.mtb	1778	2448	WWFF	food_fat	3	76310	1336629998	1	0.719999999999999	0.00334883720930232	9458	1
4	Drink 1	Intake 1	16	78076	1336631764	/users/cn/jespinosa/phecomp/data/CRG/20120502_FDF_CRG/20120502_FDF_CRG/20120509_FDF_CRG_c12.mtb	1253	NA	WWFF	water	1	78060	1336631748	1	0.0600000000000001	0.00375000000000001	9459	1
4	Food 2	Intake 4	14	78987	1336632675	/users/cn/jespinosa/phecomp/data/CRG/20120502_FDF_CRG/20120502_FDF_CRG/20120509_FDF_CRG_c12.mtb	2330	434	WWFF	food_fat	4	78973	1336632661	1	0.04	0.00285714285714286	9460	1
4	Food 2	Intake 4	19	79440	1336633128	/users/cn/jespinosa/phecomp/data/CRG/20120502_FDF_CRG/20120502_FDF_CRG/20120509_FDF_CRG_c12.mtb	2332	1779	WWFF	food_fat	4	79421	1336633109	1	0.0200000000000005	0.00105263157894739	9461	1
4	Drink 1	Intake 1	15	79437	1336633125	/users/cn/jespinosa/phecomp/data/CRG/20120502_FDF_CRG/20120502_FDF_CRG/20120509_FDF_CRG_c12.mtb	1254	NA	WWFF	water	1	79422	1336633110	1	0.0600000000000001	0.00400000000000001	9462	1
4	Drink 1	Intake 1	26	80680	1336634368	/users/cn/jespinosa/phecomp/data/CRG/20120502_FDF_CRG/20120502_FDF_CRG/20120509_FDF_CRG_c12.mtb	1255	NA	WWFF	water	1	80654	1336634342	1	0.12	0.00461538461538461	9463	1
4	Food 2	Intake 4	14	81233	1336634921	/users/cn/jespinosa/phecomp/data/CRG/20120502_FDF_CRG/20120502_FDF_CRG/20120509_FDF_CRG_c12.mtb	2336	237	WWFF	food_fat	4	81219	1336634907	1	0.0599999999999996	0.00428571428571426	9464	1
4	Food 2	Intake 4	84	81554	1336635242	/users/cn/jespinosa/phecomp/data/CRG/20120502_FDF_CRG/20120502_FDF_CRG/20120509_FDF_CRG_c12.mtb	2337	705	WWFF	food_fat	4	81470	1336635158	1	0.100000000000001	0.0011904761904762	9465	1
4	Food 2	Intake 4	32	82291	1336635979	/users/cn/jespinosa/phecomp/data/CRG/20120502_FDF_CRG/20120502_FDF_CRG/20120509_FDF_CRG_c12.mtb	2339	772	WWFF	food_fat	4	82259	1336635947	1	0.0200000000000005	0.000625000000000016	9466	1
4	Food 1	Intake 3	34	83097	1336636785	/users/cn/jespinosa/phecomp/data/CRG/20120502_FDF_CRG/20120502_FDF_CRG/20120509_FDF_CRG_c12.mtb	1787	13	WWFF	food_fat	3	83063	1336636751	1	0.0600000000000005	0.00176470588235296	9467	1
4	Food 2	Intake 4	14	83124	1336636812	/users/cn/jespinosa/phecomp/data/CRG/20120502_FDF_CRG/20120502_FDF_CRG/20120509_FDF_CRG_c12.mtb	2341	785	WWFF	food_fat	4	83110	1336636798	1	0.04	0.00285714285714286	9468	1
4	Food 1	Intake 3	12	83921	1336637609	/users/cn/jespinosa/phecomp/data/CRG/20120502_FDF_CRG/20120502_FDF_CRG/20120509_FDF_CRG_c12.mtb	1788	485	WWFF	food_fat	3	83909	1336637597	1	0.0399999999999991	0.00333333333333326	9469	1
4	Drink 1	Intake 1	21	83931	1336637619	/users/cn/jespinosa/phecomp/data/CRG/20120502_FDF_CRG/20120502_FDF_CRG/20120509_FDF_CRG_c12.mtb	1256	NA	WWFF	water	1	83910	1336637598	1	0.0799999999999998	0.0038095238095238	9470	1
4	Food 2	Intake 4	16	84422	1336638110	/users/cn/jespinosa/phecomp/data/CRG/20120502_FDF_CRG/20120502_FDF_CRG/20120509_FDF_CRG_c12.mtb	2343	711	WWFF	food_fat	4	84406	1336638094	1	0.0200000000000005	0.00125000000000003	9471	1
4	Drink 1	Intake 1	8	84630	1336638318	/users/cn/jespinosa/phecomp/data/CRG/20120502_FDF_CRG/20120502_FDF_CRG/20120509_FDF_CRG_c12.mtb	1257	NA	WWFF	water	1	84622	1336638310	1	0.04	0.005	9472	1
4	Food 1	Intake 3	76	85209	1336638897	/users/cn/jespinosa/phecomp/data/CRG/20120502_FDF_CRG/20120502_FDF_CRG/20120509_FDF_CRG_c12.mtb	1789	COLL	WWFF	food_fat	3	85133	1336638821	1	0.0200000000000014	0.000263157894736861	9473	1
4	Food 2	Intake 4	75	85209	1336638897	/users/cn/jespinosa/phecomp/data/CRG/20120502_FDF_CRG/20120502_FDF_CRG/20120509_FDF_CRG_c12.mtb	2344	834	WWFF	food_fat	4	85134	1336638822	1	0.0599999999999996	0.000799999999999995	9474	1
4	Food 2	Intake 4	39	86082	1336639770	/users/cn/jespinosa/phecomp/data/CRG/20120502_FDF_CRG/20120502_FDF_CRG/20120509_FDF_CRG_c12.mtb	2346	COLL	WWFF	food_fat	4	86043	1336639731	1	0.42	0.0107692307692308	9475	1
4	Food 1	Intake 3	16	86071	1336639759	/users/cn/jespinosa/phecomp/data/CRG/20120502_FDF_CRG/20120502_FDF_CRG/20120509_FDF_CRG_c12.mtb	1792	1833	WWFF	food_fat	3	86055	1336639743	1	0.180000000000001	0.0112500000000001	9476	1
4	Food 2	Intake 4	79	87983	1336641671	/users/cn/jespinosa/phecomp/data/CRG/20120502_FDF_CRG/20120502_FDF_CRG/20120509_FDF_CRG_c12.mtb	2350	1363	WWFF	food_fat	4	87904	1336641592	1	0.0799999999999992	0.00101265822784809	9477	1
4	Food 2	Intake 4	17	89363	1336643051	/users/cn/jespinosa/phecomp/data/CRG/20120502_FDF_CRG/20120502_FDF_CRG/20120509_FDF_CRG_c12.mtb	2351	1319	WWFF	food_fat	4	89346	1336643034	1	0.0200000000000005	0.00117647058823532	9478	1
4	Food 1	Intake 3	207	90889	1336644577	/users/cn/jespinosa/phecomp/data/CRG/20120502_FDF_CRG/20120502_FDF_CRG/20120509_FDF_CRG_c12.mtb	1798	COLL	WWFF	food_fat	3	90682	1336644370	1	0.32	0.00154589371980676	9479	1
4	Food 2	Intake 4	399	91082	1336644770	/users/cn/jespinosa/phecomp/data/CRG/20120502_FDF_CRG/20120502_FDF_CRG/20120509_FDF_CRG_c12.mtb	2356	COLL	WWFF	food_fat	4	90683	1336644371	1	0.04	0.000100250626566416	9480	1
4	Food 1	Intake 3	143	91081	1336644769	/users/cn/jespinosa/phecomp/data/CRG/20120502_FDF_CRG/20120502_FDF_CRG/20120509_FDF_CRG_c12.mtb	1800	696	WWFF	food_fat	3	90938	1336644626	1	0.700000000000001	0.0048951048951049	9481	1
4	Food 2	Intake 4	12	91789	1336645477	/users/cn/jespinosa/phecomp/data/CRG/20120502_FDF_CRG/20120502_FDF_CRG/20120509_FDF_CRG_c12.mtb	2360	1062	WWFF	food_fat	4	91777	1336645465	1	0.04	0.00333333333333333	9482	1
4	Drink 1	Intake 1	28	92129	1336645817	/users/cn/jespinosa/phecomp/data/CRG/20120502_FDF_CRG/20120502_FDF_CRG/20120509_FDF_CRG_c12.mtb	1258	NA	WWFF	water	1	92101	1336645789	1	0.12	0.00428571428571429	9483	1
4	Food 2	Intake 4	20	92871	1336646559	/users/cn/jespinosa/phecomp/data/CRG/20120502_FDF_CRG/20120502_FDF_CRG/20120509_FDF_CRG_c12.mtb	2361	913	WWFF	food_fat	4	92851	1336646539	1	0.04	0.002	9484	1
4	Food 1	Intake 3	23	93807	1336647495	/users/cn/jespinosa/phecomp/data/CRG/20120502_FDF_CRG/20120502_FDF_CRG/20120509_FDF_CRG_c12.mtb	1802	COLL	WWFF	food_fat	3	93784	1336647472	1	0.140000000000001	0.00608695652173917	9485	1
4	Food 2	Intake 4	33	93820	1336647508	/users/cn/jespinosa/phecomp/data/CRG/20120502_FDF_CRG/20120502_FDF_CRG/20120509_FDF_CRG_c12.mtb	2363	1396	WWFF	food_fat	4	93787	1336647475	1	0.2	0.00606060606060606	9486	1
4	Drink 1	Intake 1	14	94665	1336648353	/users/cn/jespinosa/phecomp/data/CRG/20120502_FDF_CRG/20120502_FDF_CRG/20120509_FDF_CRG_c12.mtb	1259	NA	WWFF	water	1	94651	1336648339	1	0.0800000000000001	0.00571428571428572	9487	1
4	Food 2	Intake 4	13	95229	1336648917	/users/cn/jespinosa/phecomp/data/CRG/20120502_FDF_CRG/20120502_FDF_CRG/20120509_FDF_CRG_c12.mtb	2365	1971	WWFF	food_fat	4	95216	1336648904	1	0.04	0.00307692307692308	9488	1
4	Drink 1	Intake 1	23	96112	1336649800	/users/cn/jespinosa/phecomp/data/CRG/20120502_FDF_CRG/20120502_FDF_CRG/20120509_FDF_CRG_c12.mtb	1260	NA	WWFF	water	1	96089	1336649777	1	0.0600000000000001	0.00260869565217392	9489	1
4	Food 2	Intake 4	36	97236	1336650924	/users/cn/jespinosa/phecomp/data/CRG/20120502_FDF_CRG/20120502_FDF_CRG/20120509_FDF_CRG_c12.mtb	2367	2292	WWFF	food_fat	4	97200	1336650888	1	0.04	0.00111111111111111	9490	1
4	Food 2	Intake 4	12	99540	1336653228	/users/cn/jespinosa/phecomp/data/CRG/20120502_FDF_CRG/20120502_FDF_CRG/20120509_FDF_CRG_c12.mtb	2370	201	WWFF	food_fat	4	99528	1336653216	1	0.04	0.00333333333333333	9491	1
4	Food 2	Intake 4	65	99806	1336653494	/users/cn/jespinosa/phecomp/data/CRG/20120502_FDF_CRG/20120502_FDF_CRG/20120509_FDF_CRG_c12.mtb	2371	COLL	WWFF	food_fat	4	99741	1336653429	1	0.26	0.004	9492	1
4	Drink 1	Intake 1	14	99761	1336653449	/users/cn/jespinosa/phecomp/data/CRG/20120502_FDF_CRG/20120502_FDF_CRG/20120509_FDF_CRG_c12.mtb	1261	NA	WWFF	water	1	99747	1336653435	1	0.1	0.00714285714285714	9493	1
4	Food 1	Intake 3	49	99805	1336653493	/users/cn/jespinosa/phecomp/data/CRG/20120502_FDF_CRG/20120502_FDF_CRG/20120509_FDF_CRG_c12.mtb	1804	462	WWFF	food_fat	3	99756	1336653444	1	0.18	0.0036734693877551	9494	1
4	Food 2	Intake 4	39	100306	1336653994	/users/cn/jespinosa/phecomp/data/CRG/20120502_FDF_CRG/20120502_FDF_CRG/20120509_FDF_CRG_c12.mtb	2372	1157	WWFF	food_fat	4	100267	1336653955	1	0.0200000000000005	0.000512820512820526	9495	1
4	Food 2	Intake 4	40	101503	1336655191	/users/cn/jespinosa/phecomp/data/CRG/20120502_FDF_CRG/20120502_FDF_CRG/20120509_FDF_CRG_c12.mtb	2375	COLL	WWFF	food_fat	4	101463	1336655151	1	0.22	0.0055	9496	1
4	Food 1	Intake 3	15	101479	1336655167	/users/cn/jespinosa/phecomp/data/CRG/20120502_FDF_CRG/20120502_FDF_CRG/20120509_FDF_CRG_c12.mtb	1807	288	WWFF	food_fat	3	101464	1336655152	1	0.0999999999999996	0.00666666666666664	9497	1
4	Drink 1	Intake 1	25	101790	1336655478	/users/cn/jespinosa/phecomp/data/CRG/20120502_FDF_CRG/20120502_FDF_CRG/20120509_FDF_CRG_c12.mtb	1262	NA	WWFF	water	1	101765	1336655453	1	0.0600000000000001	0.0024	9498	1
4	Food 2	Intake 4	9	101776	1336655464	/users/cn/jespinosa/phecomp/data/CRG/20120502_FDF_CRG/20120502_FDF_CRG/20120509_FDF_CRG_c12.mtb	2376	1272	WWFF	food_fat	4	101767	1336655455	1	0.0200000000000005	0.00222222222222228	9499	1
4	Food 2	Intake 4	36	103084	1336656772	/users/cn/jespinosa/phecomp/data/CRG/20120502_FDF_CRG/20120502_FDF_CRG/20120509_FDF_CRG_c12.mtb	2378	3021	WWFF	food_fat	4	103048	1336656736	1	0.0200000000000005	0.000555555555555569	9500	1
4	Drink 1	Intake 1	34	105460	1336659148	/users/cn/jespinosa/phecomp/data/CRG/20120502_FDF_CRG/20120502_FDF_CRG/20120509_FDF_CRG_c12.mtb	1264	NA	WWFF	water	1	105426	1336659114	1	0.12	0.00352941176470588	9501	1
4	Food 2	Intake 4	315	106420	1336660108	/users/cn/jespinosa/phecomp/data/CRG/20120502_FDF_CRG/20120502_FDF_CRG/20120509_FDF_CRG_c12.mtb	2382	COLL	WWFF	food_fat	4	106105	1336659793	1	0.16	0.000507936507936508	9502	1
4	Food 1	Intake 3	246	106419	1336660107	/users/cn/jespinosa/phecomp/data/CRG/20120502_FDF_CRG/20120502_FDF_CRG/20120509_FDF_CRG_c12.mtb	1810	49	WWFF	food_fat	3	106173	1336659861	1	0.0400000000000009	0.000162601626016264	9503	1
4	Food 1	Intake 3	166	106634	1336660322	/users/cn/jespinosa/phecomp/data/CRG/20120502_FDF_CRG/20120502_FDF_CRG/20120509_FDF_CRG_c12.mtb	1811	151	WWFF	food_fat	3	106468	1336660156	1	0.0399999999999991	0.000240963855421681	9504	1
4	Food 1	Intake 3	194	106979	1336660667	/users/cn/jespinosa/phecomp/data/CRG/20120502_FDF_CRG/20120502_FDF_CRG/20120509_FDF_CRG_c12.mtb	1814	364	WWFF	food_fat	3	106785	1336660473	1	0.0399999999999991	0.000206185567010305	9505	1
4	Food 1	Intake 3	51	107394	1336661082	/users/cn/jespinosa/phecomp/data/CRG/20120502_FDF_CRG/20120502_FDF_CRG/20120509_FDF_CRG_c12.mtb	1817	145	WWFF	food_fat	3	107343	1336661031	1	0.0400000000000009	0.000784313725490214	9506	1
4	Food 1	Intake 3	457	107996	1336661684	/users/cn/jespinosa/phecomp/data/CRG/20120502_FDF_CRG/20120502_FDF_CRG/20120509_FDF_CRG_c12.mtb	1820	COLL	WWFF	food_fat	3	107539	1336661227	1	0.0799999999999983	0.000175054704595182	9507	1
4	Food 2	Intake 4	459	108000	1336661688	/users/cn/jespinosa/phecomp/data/CRG/20120502_FDF_CRG/20120502_FDF_CRG/20120509_FDF_CRG_c12.mtb	2387	42	WWFF	food_fat	4	107541	1336661229	1	0.2	0.000435729847494553	9508	1
4	Food 1	Intake 3	75	108117	1336661805	/users/cn/jespinosa/phecomp/data/CRG/20120502_FDF_CRG/20120502_FDF_CRG/20120509_FDF_CRG_c12.mtb	1821	COLL	WWFF	food_fat	3	108042	1336661730	1	0.0400000000000009	0.000533333333333345	9509	1
4	Food 2	Intake 4	74	108117	1336661805	/users/cn/jespinosa/phecomp/data/CRG/20120502_FDF_CRG/20120502_FDF_CRG/20120509_FDF_CRG_c12.mtb	2388	204	WWFF	food_fat	4	108043	1336661731	1	0.0599999999999996	0.000810810810810805	9510	1
4	Drink 2	Intake 2	51	108331	1336662019	/users/cn/jespinosa/phecomp/data/CRG/20120502_FDF_CRG/20120502_FDF_CRG/20120509_FDF_CRG_c12.mtb	1196	NA	WWFF	water	2	108280	1336661968	1	0.04	0.000784313725490196	9511	1
4	Food 2	Intake 4	14	108335	1336662023	/users/cn/jespinosa/phecomp/data/CRG/20120502_FDF_CRG/20120502_FDF_CRG/20120509_FDF_CRG_c12.mtb	2390	390	WWFF	food_fat	4	108321	1336662009	1	0.12	0.00857142857142857	9512	1
4	Food 2	Intake 4	12	108737	1336662425	/users/cn/jespinosa/phecomp/data/CRG/20120502_FDF_CRG/20120502_FDF_CRG/20120509_FDF_CRG_c12.mtb	2391	2078	WWFF	food_fat	4	108725	1336662413	1	0.04	0.00333333333333333	9513	1
4	Food 2	Intake 4	21	110836	1336664524	/users/cn/jespinosa/phecomp/data/CRG/20120502_FDF_CRG/20120502_FDF_CRG/20120509_FDF_CRG_c12.mtb	2394	COLL	WWFF	food_fat	4	110815	1336664503	1	0.220000000000001	0.0104761904761905	9514	1
4	Food 1	Intake 3	18	110836	1336664524	/users/cn/jespinosa/phecomp/data/CRG/20120502_FDF_CRG/20120502_FDF_CRG/20120509_FDF_CRG_c12.mtb	1825	1635	WWFF	food_fat	3	110818	1336664506	1	0.0600000000000005	0.00333333333333336	9515	1
4	Drink 1	Intake 1	29	112472	1336666160	/users/cn/jespinosa/phecomp/data/CRG/20120502_FDF_CRG/20120502_FDF_CRG/20120509_FDF_CRG_c12.mtb	1265	NA	WWFF	water	1	112443	1336666131	1	0.0999999999999996	0.00344827586206895	9516	1
4	Food 2	Intake 4	15	112486	1336666174	/users/cn/jespinosa/phecomp/data/CRG/20120502_FDF_CRG/20120502_FDF_CRG/20120509_FDF_CRG_c12.mtb	2396	1226	WWFF	food_fat	4	112471	1336666159	1	0.0200000000000005	0.00133333333333337	9517	1
4	Food 1	Intake 3	19	113731	1336667419	/users/cn/jespinosa/phecomp/data/CRG/20120502_FDF_CRG/20120502_FDF_CRG/20120509_FDF_CRG_c12.mtb	1827	1955	WWFF	food_fat	3	113712	1336667400	1	0.139999999999999	0.00736842105263153	9518	1
4	Drink 1	Intake 1	20	114322	1336668010	/users/cn/jespinosa/phecomp/data/CRG/20120502_FDF_CRG/20120502_FDF_CRG/20120509_FDF_CRG_c12.mtb	1266	NA	WWFF	water	1	114302	1336667990	1	0.0600000000000001	0.00300000000000001	9519	1
4	Food 2	Intake 4	19	115705	1336669393	/users/cn/jespinosa/phecomp/data/CRG/20120502_FDF_CRG/20120502_FDF_CRG/20120509_FDF_CRG_c12.mtb	2399	785	WWFF	food_fat	4	115686	1336669374	1	0.0200000000000005	0.00105263157894739	9520	1
4	Food 1	Intake 3	18	116508	1336670196	/users/cn/jespinosa/phecomp/data/CRG/20120502_FDF_CRG/20120502_FDF_CRG/20120509_FDF_CRG_c12.mtb	1830	1073	WWFF	food_fat	3	116490	1336670178	1	0.0200000000000014	0.00111111111111119	9521	1
4	Food 2	Intake 4	19	117600	1336671288	/users/cn/jespinosa/phecomp/data/CRG/20120502_FDF_CRG/20120502_FDF_CRG/20120509_FDF_CRG_c12.mtb	2403	22	WWFF	food_fat	4	117581	1336671269	1	0.0599999999999996	0.00315789473684208	9522	1
4	Food 2	Intake 4	34	117656	1336671344	/users/cn/jespinosa/phecomp/data/CRG/20120502_FDF_CRG/20120502_FDF_CRG/20120509_FDF_CRG_c12.mtb	2404	COLL	WWFF	food_fat	4	117622	1336671310	1	0.28	0.00823529411764706	9523	1
4	Food 1	Intake 3	28	117651	1336671339	/users/cn/jespinosa/phecomp/data/CRG/20120502_FDF_CRG/20120502_FDF_CRG/20120509_FDF_CRG_c12.mtb	1832	4559	WWFF	food_fat	3	117623	1336671311	1	0.119999999999999	0.00428571428571425	9524	1
4	Drink 1	Intake 1	26	120716	1336674404	/users/cn/jespinosa/phecomp/data/CRG/20120502_FDF_CRG/20120502_FDF_CRG/20120509_FDF_CRG_c12.mtb	1267	NA	WWFF	water	1	120690	1336674378	1	0.1	0.00384615384615385	9525	1
4	Food 1	Intake 3	215	122425	1336676113	/users/cn/jespinosa/phecomp/data/CRG/20120502_FDF_CRG/20120502_FDF_CRG/20120509_FDF_CRG_c12.mtb	1833	COLL	WWFF	food_fat	3	122210	1336675898	1	0.140000000000001	0.000651162790697679	9526	1
4	Food 2	Intake 4	221	122432	1336676120	/users/cn/jespinosa/phecomp/data/CRG/20120502_FDF_CRG/20120502_FDF_CRG/20120509_FDF_CRG_c12.mtb	2409	1018	WWFF	food_fat	4	122211	1336675899	1	0.0800000000000001	0.000361990950226245	9527	1
4	Food 2	Intake 4	83	123533	1336677221	/users/cn/jespinosa/phecomp/data/CRG/20120502_FDF_CRG/20120502_FDF_CRG/20120509_FDF_CRG_c12.mtb	2415	348	WWFF	food_fat	4	123450	1336677138	1	0.0200000000000005	0.000240963855421693	9528	1
4	Food 1	Intake 3	27	123908	1336677596	/users/cn/jespinosa/phecomp/data/CRG/20120502_FDF_CRG/20120502_FDF_CRG/20120509_FDF_CRG_c12.mtb	1838	COLL	WWFF	food_fat	3	123881	1336677569	1	0.0600000000000005	0.00222222222222224	9529	1
4	Food 2	Intake 4	27	123909	1336677597	/users/cn/jespinosa/phecomp/data/CRG/20120502_FDF_CRG/20120502_FDF_CRG/20120509_FDF_CRG_c12.mtb	2418	2354	WWFF	food_fat	4	123882	1336677570	1	0.2	0.00740740740740741	9530	1
4	Drink 1	Intake 1	20	124746	1336678434	/users/cn/jespinosa/phecomp/data/CRG/20120502_FDF_CRG/20120502_FDF_CRG/20120509_FDF_CRG_c12.mtb	1269	NA	WWFF	water	1	124726	1336678414	1	0.1	0.005	9531	1
4	Food 2	Intake 4	302	126565	1336680253	/users/cn/jespinosa/phecomp/data/CRG/20120502_FDF_CRG/20120502_FDF_CRG/20120509_FDF_CRG_c12.mtb	2422	COLL	WWFF	food_fat	4	126263	1336679951	1	0.119999999999999	0.00039735099337748	9532	1
4	Food 1	Intake 3	125	126563	1336680251	/users/cn/jespinosa/phecomp/data/CRG/20120502_FDF_CRG/20120502_FDF_CRG/20120509_FDF_CRG_c12.mtb	1841	22	WWFF	food_fat	3	126438	1336680126	1	0.0800000000000001	0.000640000000000001	9533	1
4	Food 1	Intake 3	275	126860	1336680548	/users/cn/jespinosa/phecomp/data/CRG/20120502_FDF_CRG/20120502_FDF_CRG/20120509_FDF_CRG_c12.mtb	1842	COLL	WWFF	food_fat	3	126585	1336680273	1	0.300000000000001	0.00109090909090909	9534	1
4	Food 2	Intake 4	276	126862	1336680550	/users/cn/jespinosa/phecomp/data/CRG/20120502_FDF_CRG/20120502_FDF_CRG/20120509_FDF_CRG_c12.mtb	2423	316	WWFF	food_fat	4	126586	1336680274	1	0.100000000000001	0.000362318840579714	9535	1
4	Food 1	Intake 3	75	127253	1336680941	/users/cn/jespinosa/phecomp/data/CRG/20120502_FDF_CRG/20120502_FDF_CRG/20120509_FDF_CRG_c12.mtb	1845	117	WWFF	food_fat	3	127178	1336680866	1	0.0999999999999979	0.00133333333333331	9536	1
4	Food 2	Intake 4	20	127390	1336681078	/users/cn/jespinosa/phecomp/data/CRG/20120502_FDF_CRG/20120502_FDF_CRG/20120509_FDF_CRG_c12.mtb	2425	20	WWFF	food_fat	4	127370	1336681058	1	0.140000000000001	0.00700000000000005	9537	1
4	Food 2	Intake 4	207	127617	1336681305	/users/cn/jespinosa/phecomp/data/CRG/20120502_FDF_CRG/20120502_FDF_CRG/20120509_FDF_CRG_c12.mtb	2426	COLL	WWFF	food_fat	4	127410	1336681098	1	0.0800000000000001	0.000386473429951691	9538	1
4	Food 1	Intake 3	205	127617	1336681305	/users/cn/jespinosa/phecomp/data/CRG/20120502_FDF_CRG/20120502_FDF_CRG/20120509_FDF_CRG_c12.mtb	1847	41	WWFF	food_fat	3	127412	1336681100	1	0.220000000000002	0.00107317073170733	9539	1
4	Food 1	Intake 3	95	127753	1336681441	/users/cn/jespinosa/phecomp/data/CRG/20120502_FDF_CRG/20120502_FDF_CRG/20120509_FDF_CRG_c12.mtb	1848	221	WWFF	food_fat	3	127658	1336681346	1	0.0599999999999987	0.000631578947368407	9540	1
4	Food 2	Intake 4	129	128103	1336681791	/users/cn/jespinosa/phecomp/data/CRG/20120502_FDF_CRG/20120502_FDF_CRG/20120509_FDF_CRG_c12.mtb	2431	COLL	WWFF	food_fat	4	127974	1336681662	1	0.18	0.0013953488372093	9541	1
4	Food 1	Intake 3	106	128103	1336681791	/users/cn/jespinosa/phecomp/data/CRG/20120502_FDF_CRG/20120502_FDF_CRG/20120509_FDF_CRG_c12.mtb	1851	125	WWFF	food_fat	3	127997	1336681685	1	0.140000000000001	0.00132075471698114	9542	1
4	Food 2	Intake 4	144	128372	1336682060	/users/cn/jespinosa/phecomp/data/CRG/20120502_FDF_CRG/20120502_FDF_CRG/20120509_FDF_CRG_c12.mtb	2433	COLL	WWFF	food_fat	4	128228	1336681916	1	0.38	0.00263888888888889	9543	1
4	Food 1	Intake 3	61	128368	1336682056	/users/cn/jespinosa/phecomp/data/CRG/20120502_FDF_CRG/20120502_FDF_CRG/20120509_FDF_CRG_c12.mtb	1853	462	WWFF	food_fat	3	128307	1336681995	1	0.100000000000001	0.0016393442622951	9544	1
4	Drink 1	Intake 1	62	128472	1336682160	/users/cn/jespinosa/phecomp/data/CRG/20120502_FDF_CRG/20120502_FDF_CRG/20120509_FDF_CRG_c12.mtb	1272	NA	WWFF	water	1	128410	1336682098	1	0.02	0.00032258064516129	9545	1
4	Food 2	Intake 4	237	129067	1336682755	/users/cn/jespinosa/phecomp/data/CRG/20120502_FDF_CRG/20120502_FDF_CRG/20120509_FDF_CRG_c12.mtb	2437	COLL	WWFF	food_fat	4	128830	1336682518	1	0.119999999999999	0.000506329113924046	9546	1
4	Food 1	Intake 3	148	129065	1336682753	/users/cn/jespinosa/phecomp/data/CRG/20120502_FDF_CRG/20120502_FDF_CRG/20120509_FDF_CRG_c12.mtb	1858	104	WWFF	food_fat	3	128917	1336682605	1	0.0399999999999991	0.000270270270270264	9547	1
4	Food 2	Intake 4	28	129197	1336682885	/users/cn/jespinosa/phecomp/data/CRG/20120502_FDF_CRG/20120502_FDF_CRG/20120509_FDF_CRG_c12.mtb	2439	COLL	WWFF	food_fat	4	129169	1336682857	1	0.0999999999999996	0.00357142857142856	9548	1
4	Food 1	Intake 3	22	129192	1336682880	/users/cn/jespinosa/phecomp/data/CRG/20120502_FDF_CRG/20120502_FDF_CRG/20120509_FDF_CRG_c12.mtb	1860	25	WWFF	food_fat	3	129170	1336682858	1	0.0599999999999987	0.00272727272727267	9549	1
4	Food 1	Intake 3	243	129460	1336683148	/users/cn/jespinosa/phecomp/data/CRG/20120502_FDF_CRG/20120502_FDF_CRG/20120509_FDF_CRG_c12.mtb	1861	14	WWFF	food_fat	3	129217	1336682905	1	0.100000000000001	0.00041152263374486	9550	1
4	Food 1	Intake 3	107	129581	1336683269	/users/cn/jespinosa/phecomp/data/CRG/20120502_FDF_CRG/20120502_FDF_CRG/20120509_FDF_CRG_c12.mtb	1862	206	WWFF	food_fat	3	129474	1336683162	1	0.119999999999997	0.00112149532710278	9551	1
4	Food 2	Intake 4	60	129847	1336683535	/users/cn/jespinosa/phecomp/data/CRG/20120502_FDF_CRG/20120502_FDF_CRG/20120509_FDF_CRG_c12.mtb	2443	78	WWFF	food_fat	4	129787	1336683475	1	0.0800000000000001	0.00133333333333334	9552	1
4	Drink 2	Intake 2	26	129867	1336683555	/users/cn/jespinosa/phecomp/data/CRG/20120502_FDF_CRG/20120502_FDF_CRG/20120509_FDF_CRG_c12.mtb	1206	NA	WWFF	water	2	129841	1336683529	1	0.0399999999999999	0.00153846153846153	9553	1
4	Drink 1	Intake 1	47	129902	1336683590	/users/cn/jespinosa/phecomp/data/CRG/20120502_FDF_CRG/20120502_FDF_CRG/20120509_FDF_CRG_c12.mtb	1275	NA	WWFF	water	1	129855	1336683543	1	0.02	0.000425531914893617	9554	1
4	Food 1	Intake 3	26	129951	1336683639	/users/cn/jespinosa/phecomp/data/CRG/20120502_FDF_CRG/20120502_FDF_CRG/20120509_FDF_CRG_c12.mtb	1865	27	WWFF	food_fat	3	129925	1336683613	1	0.0200000000000031	0.000769230769230888	9555	1
4	Food 2	Intake 4	389	130367	1336684055	/users/cn/jespinosa/phecomp/data/CRG/20120502_FDF_CRG/20120502_FDF_CRG/20120509_FDF_CRG_c12.mtb	2445	COLL	WWFF	food_fat	4	129978	1336683666	1	0.380000000000001	0.00097686375321337	9556	1
4	Food 1	Intake 3	157	130136	1336683824	/users/cn/jespinosa/phecomp/data/CRG/20120502_FDF_CRG/20120502_FDF_CRG/20120509_FDF_CRG_c12.mtb	1866	59	WWFF	food_fat	3	129979	1336683667	1	0.0399999999999991	0.000254777070063689	9557	1
4	Food 1	Intake 3	170	130365	1336684053	/users/cn/jespinosa/phecomp/data/CRG/20120502_FDF_CRG/20120502_FDF_CRG/20120509_FDF_CRG_c12.mtb	1867	78	WWFF	food_fat	3	130195	1336683883	1	0.120000000000001	0.000705882352941182	9558	1
4	Food 2	Intake 4	139	130582	1336684270	/users/cn/jespinosa/phecomp/data/CRG/20120502_FDF_CRG/20120502_FDF_CRG/20120509_FDF_CRG_c12.mtb	2446	229	WWFF	food_fat	4	130443	1336684131	1	0.199999999999999	0.0014388489208633	9559	1
4	Food 1	Intake 3	250	131061	1336684749	/users/cn/jespinosa/phecomp/data/CRG/20120502_FDF_CRG/20120502_FDF_CRG/20120509_FDF_CRG_c12.mtb	1870	COLL	WWFF	food_fat	3	130811	1336684499	1	0.16	0.00064	9560	1
4	Food 2	Intake 4	251	131063	1336684751	/users/cn/jespinosa/phecomp/data/CRG/20120502_FDF_CRG/20120502_FDF_CRG/20120509_FDF_CRG_c12.mtb	2448	127	WWFF	food_fat	4	130812	1336684500	1	0.559999999999999	0.00223107569721115	9561	1
4	Food 2	Intake 4	134	131324	1336685012	/users/cn/jespinosa/phecomp/data/CRG/20120502_FDF_CRG/20120502_FDF_CRG/20120509_FDF_CRG_c12.mtb	2449	6	WWFF	food_fat	4	131190	1336684878	1	0.0600000000000005	0.000447761194029854	9562	1
4	Drink 2	Intake 2	78	131391	1336685079	/users/cn/jespinosa/phecomp/data/CRG/20120502_FDF_CRG/20120502_FDF_CRG/20120509_FDF_CRG_c12.mtb	1209	NA	WWFF	water	2	131313	1336685001	1	0.1	0.00128205128205128	9563	1
4	Food 2	Intake 4	340	131670	1336685358	/users/cn/jespinosa/phecomp/data/CRG/20120502_FDF_CRG/20120502_FDF_CRG/20120509_FDF_CRG_c12.mtb	2450	COLL	WWFF	food_fat	4	131330	1336685018	1	0.200000000000001	0.00058823529411765	9564	1
4	Drink 1	Intake 1	19	131398	1336685086	/users/cn/jespinosa/phecomp/data/CRG/20120502_FDF_CRG/20120502_FDF_CRG/20120509_FDF_CRG_c12.mtb	1277	NA	WWFF	water	1	131379	1336685067	1	0.02	0.00105263157894737	9565	1
4	Food 1	Intake 3	144	131670	1336685358	/users/cn/jespinosa/phecomp/data/CRG/20120502_FDF_CRG/20120502_FDF_CRG/20120509_FDF_CRG_c12.mtb	1873	156	WWFF	food_fat	3	131526	1336685214	1	0.0599999999999987	0.000416666666666658	9566	1
4	Food 1	Intake 3	127	131953	1336685641	/users/cn/jespinosa/phecomp/data/CRG/20120502_FDF_CRG/20120502_FDF_CRG/20120509_FDF_CRG_c12.mtb	1875	213	WWFF	food_fat	3	131826	1336685514	1	0.0400000000000027	0.000314960629921281	9567	1
4	Food 1	Intake 3	159	132325	1336686013	/users/cn/jespinosa/phecomp/data/CRG/20120502_FDF_CRG/20120502_FDF_CRG/20120509_FDF_CRG_c12.mtb	1878	COLL	WWFF	food_fat	3	132166	1336685854	1	0.0799999999999983	0.00050314465408804	9568	1
4	Food 2	Intake 4	159	132326	1336686014	/users/cn/jespinosa/phecomp/data/CRG/20120502_FDF_CRG/20120502_FDF_CRG/20120509_FDF_CRG_c12.mtb	2452	63	WWFF	food_fat	4	132167	1336685855	1	0.4	0.00251572327044025	9569	1
4	Food 2	Intake 4	192	132581	1336686269	/users/cn/jespinosa/phecomp/data/CRG/20120502_FDF_CRG/20120502_FDF_CRG/20120509_FDF_CRG_c12.mtb	2453	36	WWFF	food_fat	4	132389	1336686077	1	1	0.00520833333333333	9570	1
4	Food 2	Intake 4	263	132880	1336686568	/users/cn/jespinosa/phecomp/data/CRG/20120502_FDF_CRG/20120502_FDF_CRG/20120509_FDF_CRG_c12.mtb	2454	110	WWFF	food_fat	4	132617	1336686305	1	1.82	0.00692015209125475	9571	1
4	Drink 2	Intake 2	49	133003	1336686691	/users/cn/jespinosa/phecomp/data/CRG/20120502_FDF_CRG/20120502_FDF_CRG/20120509_FDF_CRG_c12.mtb	1211	NA	WWFF	water	2	132954	1336686642	1	0.0800000000000001	0.00163265306122449	9572	1
4	Food 2	Intake 4	363	133353	1336687041	/users/cn/jespinosa/phecomp/data/CRG/20120502_FDF_CRG/20120502_FDF_CRG/20120509_FDF_CRG_c12.mtb	2456	269	WWFF	food_fat	4	132990	1336686678	1	3.5	0.00964187327823691	9573	1
4	Food 2	Intake 4	397	134019	1336687707	/users/cn/jespinosa/phecomp/data/CRG/20120502_FDF_CRG/20120502_FDF_CRG/20120509_FDF_CRG_c12.mtb	2457	12	WWFF	food_fat	4	133622	1336687310	1	1.02	0.00256926952141058	9574	1
4	Food 2	Intake 4	30	134061	1336687749	/users/cn/jespinosa/phecomp/data/CRG/20120502_FDF_CRG/20120502_FDF_CRG/20120509_FDF_CRG_c12.mtb	2458	57	WWFF	food_fat	4	134031	1336687719	1	0.18	0.006	9575	1
4	Food 2	Intake 4	142	134260	1336687948	/users/cn/jespinosa/phecomp/data/CRG/20120502_FDF_CRG/20120502_FDF_CRG/20120509_FDF_CRG_c12.mtb	2460	25	WWFF	food_fat	4	134118	1336687806	1	0.0200000000000031	0.000140845070422557	9576	1
4	Food 2	Intake 4	51	134336	1336688024	/users/cn/jespinosa/phecomp/data/CRG/20120502_FDF_CRG/20120502_FDF_CRG/20120509_FDF_CRG_c12.mtb	2461	229	WWFF	food_fat	4	134285	1336687973	1	0.0799999999999983	0.00156862745098036	9577	1
4	Food 2	Intake 4	725	135290	1336688978	/users/cn/jespinosa/phecomp/data/CRG/20120502_FDF_CRG/20120502_FDF_CRG/20120509_FDF_CRG_c12.mtb	2463	COLL	WWFF	food_fat	4	134565	1336688253	1	0.640000000000001	0.000882758620689657	9578	1
4	Food 1	Intake 3	366	135085	1336688773	/users/cn/jespinosa/phecomp/data/CRG/20120502_FDF_CRG/20120502_FDF_CRG/20120509_FDF_CRG_c12.mtb	1887	62	WWFF	food_fat	3	134719	1336688407	1	0.0399999999999991	0.000109289617486336	9579	1
4	Food 1	Intake 3	137	135284	1336688972	/users/cn/jespinosa/phecomp/data/CRG/20120502_FDF_CRG/20120502_FDF_CRG/20120509_FDF_CRG_c12.mtb	1890	1006	WWFF	food_fat	3	135147	1336688835	1	0.0600000000000023	0.000437956204379579	9580	1
4	Food 2	Intake 4	21	136311	1336689999	/users/cn/jespinosa/phecomp/data/CRG/20120502_FDF_CRG/20120502_FDF_CRG/20120509_FDF_CRG_c12.mtb	2471	165	WWFF	food_fat	4	136290	1336689978	1	0.0400000000000027	0.00190476190476203	9581	1
4	Food 2	Intake 4	80	136556	1336690244	/users/cn/jespinosa/phecomp/data/CRG/20120502_FDF_CRG/20120502_FDF_CRG/20120509_FDF_CRG_c12.mtb	2473	490	WWFF	food_fat	4	136476	1336690164	1	0.0799999999999983	0.000999999999999979	9582	1
4	Food 2	Intake 4	86	137132	1336690820	/users/cn/jespinosa/phecomp/data/CRG/20120502_FDF_CRG/20120502_FDF_CRG/20120509_FDF_CRG_c12.mtb	2481	261	WWFF	food_fat	4	137046	1336690734	1	0.0399999999999991	0.000465116279069757	9583	1
4	Food 1	Intake 3	31	137424	1336691112	/users/cn/jespinosa/phecomp/data/CRG/20120502_FDF_CRG/20120502_FDF_CRG/20120509_FDF_CRG_c12.mtb	1896	50	WWFF	food_fat	3	137393	1336691081	1	0.0399999999999991	0.00129032258064513	9584	1
4	Food 2	Intake 4	60	137534	1336691222	/users/cn/jespinosa/phecomp/data/CRG/20120502_FDF_CRG/20120502_FDF_CRG/20120509_FDF_CRG_c12.mtb	2483	COLL	WWFF	food_fat	4	137474	1336691162	1	0.48	0.008	9585	1
4	Food 1	Intake 3	30	137506	1336691194	/users/cn/jespinosa/phecomp/data/CRG/20120502_FDF_CRG/20120502_FDF_CRG/20120509_FDF_CRG_c12.mtb	1898	43	WWFF	food_fat	3	137476	1336691164	1	0.140000000000001	0.0046666666666667	9586	1
4	Food 1	Intake 3	50	137599	1336691287	/users/cn/jespinosa/phecomp/data/CRG/20120502_FDF_CRG/20120502_FDF_CRG/20120509_FDF_CRG_c12.mtb	1899	COLL	WWFF	food_fat	3	137549	1336691237	1	0.0599999999999987	0.00119999999999997	9587	1
4	Food 2	Intake 4	327	137877	1336691565	/users/cn/jespinosa/phecomp/data/CRG/20120502_FDF_CRG/20120502_FDF_CRG/20120509_FDF_CRG_c12.mtb	2484	COLL	WWFF	food_fat	4	137550	1336691238	1	0.120000000000001	0.000366972477064223	9588	1
4	Drink 1	Intake 1	17	137591	1336691279	/users/cn/jespinosa/phecomp/data/CRG/20120502_FDF_CRG/20120502_FDF_CRG/20120509_FDF_CRG_c12.mtb	1285	NA	WWFF	water	1	137574	1336691262	1	0.0600000000000005	0.00352941176470591	9589	1
4	Food 1	Intake 3	72	137746	1336691434	/users/cn/jespinosa/phecomp/data/CRG/20120502_FDF_CRG/20120502_FDF_CRG/20120509_FDF_CRG_c12.mtb	1901	260	WWFF	food_fat	3	137674	1336691362	1	0.0799999999999983	0.00111111111111109	9590	1
4	Food 2	Intake 4	22	138028	1336691716	/users/cn/jespinosa/phecomp/data/CRG/20120502_FDF_CRG/20120502_FDF_CRG/20120509_FDF_CRG_c12.mtb	2486	1656	WWFF	food_fat	4	138006	1336691694	1	0.0200000000000031	0.00090909090909105	9591	1
4	Drink 1	Intake 1	26	139176	1336692864	/users/cn/jespinosa/phecomp/data/CRG/20120502_FDF_CRG/20120502_FDF_CRG/20120509_FDF_CRG_c12.mtb	1287	NA	WWFF	water	1	139150	1336692838	1	0.0800000000000001	0.00307692307692308	9592	1
4	Food 2	Intake 4	38	139722	1336693410	/users/cn/jespinosa/phecomp/data/CRG/20120502_FDF_CRG/20120502_FDF_CRG/20120509_FDF_CRG_c12.mtb	2495	COLL	WWFF	food_fat	4	139684	1336693372	1	0.0399999999999991	0.00105263157894734	9593	1
4	Food 1	Intake 3	27	139712	1336693400	/users/cn/jespinosa/phecomp/data/CRG/20120502_FDF_CRG/20120502_FDF_CRG/20120509_FDF_CRG_c12.mtb	1904	308	WWFF	food_fat	3	139685	1336693373	1	0.0200000000000031	0.000740740740740856	9594	1
4	Food 2	Intake 4	28	140048	1336693736	/users/cn/jespinosa/phecomp/data/CRG/20120502_FDF_CRG/20120502_FDF_CRG/20120509_FDF_CRG_c12.mtb	2500	1038	WWFF	food_fat	4	140020	1336693708	1	0.16	0.00571428571428571	9595	1
4	Drink 1	Intake 1	18	140856	1336694544	/users/cn/jespinosa/phecomp/data/CRG/20120502_FDF_CRG/20120502_FDF_CRG/20120509_FDF_CRG_c12.mtb	1288	NA	WWFF	water	1	140838	1336694526	1	0.0800000000000001	0.00444444444444445	9596	1
4	Food 2	Intake 4	14	141100	1336694788	/users/cn/jespinosa/phecomp/data/CRG/20120502_FDF_CRG/20120502_FDF_CRG/20120509_FDF_CRG_c12.mtb	2503	299	WWFF	food_fat	4	141086	1336694774	1	0.0400000000000027	0.00285714285714305	9597	1
4	Food 2	Intake 4	24	141423	1336695111	/users/cn/jespinosa/phecomp/data/CRG/20120502_FDF_CRG/20120502_FDF_CRG/20120509_FDF_CRG_c12.mtb	2505	516	WWFF	food_fat	4	141399	1336695087	1	0.0400000000000027	0.00166666666666678	9598	1
4	Food 2	Intake 4	52	141991	1336695679	/users/cn/jespinosa/phecomp/data/CRG/20120502_FDF_CRG/20120502_FDF_CRG/20120509_FDF_CRG_c12.mtb	2510	86	WWFF	food_fat	4	141939	1336695627	1	0.0200000000000031	0.000384615384615444	9599	1
4	Food 2	Intake 4	43	142120	1336695808	/users/cn/jespinosa/phecomp/data/CRG/20120502_FDF_CRG/20120502_FDF_CRG/20120509_FDF_CRG_c12.mtb	2511	63	WWFF	food_fat	4	142077	1336695765	1	0.0999999999999979	0.00232558139534879	9600	1
4	Food 1	Intake 3	116	142299	1336695987	/users/cn/jespinosa/phecomp/data/CRG/20120502_FDF_CRG/20120502_FDF_CRG/20120509_FDF_CRG_c12.mtb	1908	COLL	WWFF	food_fat	3	142183	1336695871	1	0.0600000000000023	0.000517241379310365	9601	1
4	Food 2	Intake 4	120	142305	1336695993	/users/cn/jespinosa/phecomp/data/CRG/20120502_FDF_CRG/20120502_FDF_CRG/20120509_FDF_CRG_c12.mtb	2513	363	WWFF	food_fat	4	142185	1336695873	1	0.84	0.007	9602	1
4	Food 2	Intake 4	319	142987	1336696675	/users/cn/jespinosa/phecomp/data/CRG/20120502_FDF_CRG/20120502_FDF_CRG/20120509_FDF_CRG_c12.mtb	2515	COLL	WWFF	food_fat	4	142668	1336696356	1	0.18	0.000564263322884013	9603	1
4	Food 1	Intake 3	108	142777	1336696465	/users/cn/jespinosa/phecomp/data/CRG/20120502_FDF_CRG/20120502_FDF_CRG/20120509_FDF_CRG_c12.mtb	1910	234	WWFF	food_fat	3	142669	1336696357	1	0.120000000000001	0.00111111111111112	9604	1
4	Drink 1	Intake 1	16	142813	1336696501	/users/cn/jespinosa/phecomp/data/CRG/20120502_FDF_CRG/20120502_FDF_CRG/20120509_FDF_CRG_c12.mtb	1290	NA	WWFF	water	1	142797	1336696485	1	0.02	0.00125	9605	1
4	Food 2	Intake 4	80	143091	1336696779	/users/cn/jespinosa/phecomp/data/CRG/20120502_FDF_CRG/20120502_FDF_CRG/20120509_FDF_CRG_c12.mtb	2516	297	WWFF	food_fat	4	143011	1336696699	1	0.16	0.002	9606	1
4	Drink 2	Intake 2	36	143152	1336696840	/users/cn/jespinosa/phecomp/data/CRG/20120502_FDF_CRG/20120502_FDF_CRG/20120509_FDF_CRG_c12.mtb	1219	NA	WWFF	water	2	143116	1336696804	1	0.02	0.000555555555555556	9607	1
4	Food 2	Intake 4	743	144131	1336697819	/users/cn/jespinosa/phecomp/data/CRG/20120502_FDF_CRG/20120502_FDF_CRG/20120509_FDF_CRG_c12.mtb	2518	COLL	WWFF	food_fat	4	143388	1336697076	1	0.399999999999999	0.000538358008075369	9608	1
4	Food 1	Intake 3	65	143471	1336697159	/users/cn/jespinosa/phecomp/data/CRG/20120502_FDF_CRG/20120502_FDF_CRG/20120509_FDF_CRG_c12.mtb	1915	41	WWFF	food_fat	3	143406	1336697094	1	0.119999999999997	0.0018461538461538	9609	1
4	Drink 2	Intake 2	24	143496	1336697184	/users/cn/jespinosa/phecomp/data/CRG/20120502_FDF_CRG/20120502_FDF_CRG/20120509_FDF_CRG_c12.mtb	1222	NA	WWFF	water	2	143472	1336697160	1	0.02	0.000833333333333333	9610	1
4	Food 1	Intake 3	17	143529	1336697217	/users/cn/jespinosa/phecomp/data/CRG/20120502_FDF_CRG/20120502_FDF_CRG/20120509_FDF_CRG_c12.mtb	1916	707	WWFF	food_fat	3	143512	1336697200	1	0.0400000000000027	0.00235294117647075	9611	1
4	Food 2	Intake 4	639	144875	1336698563	/users/cn/jespinosa/phecomp/data/CRG/20120502_FDF_CRG/20120502_FDF_CRG/20120509_FDF_CRG_c12.mtb	2519	COLL	WWFF	food_fat	4	144236	1336697924	1	0.0599999999999987	9.38967136150214e-05	9612	1
4	Food 1	Intake 3	113	144354	1336698042	/users/cn/jespinosa/phecomp/data/CRG/20120502_FDF_CRG/20120502_FDF_CRG/20120509_FDF_CRG_c12.mtb	1920	210	WWFF	food_fat	3	144241	1336697929	1	0.0400000000000027	0.00035398230088498	9613	1
4	Drink 2	Intake 2	17	144394	1336698082	/users/cn/jespinosa/phecomp/data/CRG/20120502_FDF_CRG/20120502_FDF_CRG/20120509_FDF_CRG_c12.mtb	1224	NA	WWFF	water	2	144377	1336698065	1	0.0800000000000001	0.00470588235294118	9614	1
4	Food 1	Intake 3	182	144746	1336698434	/users/cn/jespinosa/phecomp/data/CRG/20120502_FDF_CRG/20120502_FDF_CRG/20120509_FDF_CRG_c12.mtb	1926	172	WWFF	food_fat	3	144564	1336698252	1	0.0399999999999991	0.000219780219780215	9615	1
4	Food 2	Intake 4	242	145160	1336698848	/users/cn/jespinosa/phecomp/data/CRG/20120502_FDF_CRG/20120502_FDF_CRG/20120509_FDF_CRG_c12.mtb	2520	851	WWFF	food_fat	4	144918	1336698606	1	0.0600000000000023	0.00024793388429753	9616	1
4	Food 1	Intake 3	133	146144	1336699832	/users/cn/jespinosa/phecomp/data/CRG/20120502_FDF_CRG/20120502_FDF_CRG/20120509_FDF_CRG_c12.mtb	1931	107	WWFF	food_fat	3	146011	1336699699	1	0.0400000000000027	0.000300751879699268	9617	1
4	Food 2	Intake 4	856	147107	1336700795	/users/cn/jespinosa/phecomp/data/CRG/20120502_FDF_CRG/20120502_FDF_CRG/20120509_FDF_CRG_c12.mtb	2527	COLL	WWFF	food_fat	4	146251	1336699939	1	0.18	0.000210280373831776	9618	1
4	Food 1	Intake 3	158	146451	1336700139	/users/cn/jespinosa/phecomp/data/CRG/20120502_FDF_CRG/20120502_FDF_CRG/20120509_FDF_CRG_c12.mtb	1935	170	WWFF	food_fat	3	146293	1336699981	1	0.0800000000000018	0.000506329113924062	9619	1
4	Food 1	Intake 3	78	146699	1336700387	/users/cn/jespinosa/phecomp/data/CRG/20120502_FDF_CRG/20120502_FDF_CRG/20120509_FDF_CRG_c12.mtb	1938	790	WWFF	food_fat	3	146621	1336700309	1	0.0399999999999991	0.000512820512820501	9620	1
4	Food 2	Intake 4	307	147796	1336701484	/users/cn/jespinosa/phecomp/data/CRG/20120502_FDF_CRG/20120502_FDF_CRG/20120509_FDF_CRG_c12.mtb	2528	280	WWFF	food_fat	4	147489	1336701177	1	0.0399999999999991	0.000130293159609118	9621	1
4	Drink 2	Intake 2	42	147679	1336701367	/users/cn/jespinosa/phecomp/data/CRG/20120502_FDF_CRG/20120502_FDF_CRG/20120509_FDF_CRG_c12.mtb	1227	NA	WWFF	water	2	147637	1336701325	1	0.0800000000000001	0.00190476190476191	9622	1
4	Food 2	Intake 4	590	148666	1336702354	/users/cn/jespinosa/phecomp/data/CRG/20120502_FDF_CRG/20120502_FDF_CRG/20120509_FDF_CRG_c12.mtb	2530	966	WWFF	food_fat	4	148076	1336701764	1	0.0400000000000027	6.77966101694961e-05	9623	1
4	Food 2	Intake 4	19	149651	1336703339	/users/cn/jespinosa/phecomp/data/CRG/20120502_FDF_CRG/20120502_FDF_CRG/20120509_FDF_CRG_c12.mtb	2532	1724	WWFF	food_fat	4	149632	1336703320	1	0.0600000000000023	0.00315789473684223	9624	1
4	Food 2	Intake 4	151	151526	1336705214	/users/cn/jespinosa/phecomp/data/CRG/20120502_FDF_CRG/20120502_FDF_CRG/20120509_FDF_CRG_c12.mtb	2537	COLL	WWFF	food_fat	4	151375	1336705063	1	0.0399999999999991	0.00026490066225165	9625	1
4	Drink 2	Intake 2	23	151405	1336705093	/users/cn/jespinosa/phecomp/data/CRG/20120502_FDF_CRG/20120502_FDF_CRG/20120509_FDF_CRG_c12.mtb	1228	NA	WWFF	water	2	151382	1336705070	1	0.02	0.000869565217391304	9626	1
4	Food 1	Intake 3	100	151521	1336705209	/users/cn/jespinosa/phecomp/data/CRG/20120502_FDF_CRG/20120502_FDF_CRG/20120509_FDF_CRG_c12.mtb	1953	352	WWFF	food_fat	3	151421	1336705109	1	0.100000000000001	0.00100000000000001	9627	1
4	Food 2	Intake 4	301	152174	1336705862	/users/cn/jespinosa/phecomp/data/CRG/20120502_FDF_CRG/20120502_FDF_CRG/20120509_FDF_CRG_c12.mtb	2539	COLL	WWFF	food_fat	4	151873	1336705561	1	0.280000000000001	0.000930232558139538	9628	1
4	Food 1	Intake 3	25	152142	1336705830	/users/cn/jespinosa/phecomp/data/CRG/20120502_FDF_CRG/20120502_FDF_CRG/20120509_FDF_CRG_c12.mtb	1957	14	WWFF	food_fat	3	152117	1336705805	1	0.0399999999999991	0.00159999999999996	9629	1
4	Food 1	Intake 3	15	152171	1336705859	/users/cn/jespinosa/phecomp/data/CRG/20120502_FDF_CRG/20120502_FDF_CRG/20120509_FDF_CRG_c12.mtb	1958	8	WWFF	food_fat	3	152156	1336705844	1	0.0800000000000018	0.00533333333333345	9630	1
4	Food 2	Intake 4	152	152331	1336706019	/users/cn/jespinosa/phecomp/data/CRG/20120502_FDF_CRG/20120502_FDF_CRG/20120509_FDF_CRG_c12.mtb	2540	COLL	WWFF	food_fat	4	152179	1336705867	1	0.100000000000001	0.000657894736842112	9631	1
4	Food 1	Intake 3	126	152324	1336706012	/users/cn/jespinosa/phecomp/data/CRG/20120502_FDF_CRG/20120502_FDF_CRG/20120509_FDF_CRG_c12.mtb	1959	541	WWFF	food_fat	3	152198	1336705886	1	0.0399999999999991	0.00031746031746031	9632	1
4	Drink 1	Intake 1	23	152250	1336705938	/users/cn/jespinosa/phecomp/data/CRG/20120502_FDF_CRG/20120502_FDF_CRG/20120509_FDF_CRG_c12.mtb	1297	NA	WWFF	water	1	152227	1336705915	1	0.02	0.000869565217391304	9633	1
4	Drink 1	Intake 1	22	152555	1336706243	/users/cn/jespinosa/phecomp/data/CRG/20120502_FDF_CRG/20120502_FDF_CRG/20120509_FDF_CRG_c12.mtb	1298	NA	WWFF	water	1	152533	1336706221	1	0.12	0.00545454545454545	9634	1
4	Food 2	Intake 4	209	153074	1336706762	/users/cn/jespinosa/phecomp/data/CRG/20120502_FDF_CRG/20120502_FDF_CRG/20120509_FDF_CRG_c12.mtb	2543	COLL	WWFF	food_fat	4	152865	1336706553	1	0.0800000000000018	0.000382775119617234	9635	1
4	Food 1	Intake 3	23	152899	1336706587	/users/cn/jespinosa/phecomp/data/CRG/20120502_FDF_CRG/20120502_FDF_CRG/20120509_FDF_CRG_c12.mtb	1960	3235	WWFF	food_fat	3	152876	1336706564	1	0.0399999999999991	0.00173913043478257	9636	1
4	Drink 1	Intake 1	17	155415	1336709103	/users/cn/jespinosa/phecomp/data/CRG/20120502_FDF_CRG/20120502_FDF_CRG/20120509_FDF_CRG_c12.mtb	1300	NA	WWFF	water	1	155398	1336709086	1	0.0800000000000001	0.00470588235294118	9637	1
4	Food 2	Intake 4	110	156244	1336709932	/users/cn/jespinosa/phecomp/data/CRG/20120502_FDF_CRG/20120502_FDF_CRG/20120509_FDF_CRG_c12.mtb	2554	155	WWFF	food_fat	4	156134	1336709822	1	0.0600000000000023	0.000545454545454566	9638	1
4	Food 1	Intake 3	102	156501	1336710189	/users/cn/jespinosa/phecomp/data/CRG/20120502_FDF_CRG/20120502_FDF_CRG/20120509_FDF_CRG_c12.mtb	1968	310	WWFF	food_fat	3	156399	1336710087	1	0.16	0.00156862745098039	9639	1
4	Drink 2	Intake 2	39	156541	1336710229	/users/cn/jespinosa/phecomp/data/CRG/20120502_FDF_CRG/20120502_FDF_CRG/20120509_FDF_CRG_c12.mtb	1232	NA	WWFF	water	2	156502	1336710190	1	0.04	0.00102564102564103	9640	1
4	Food 2	Intake 4	91	156902	1336710590	/users/cn/jespinosa/phecomp/data/CRG/20120502_FDF_CRG/20120502_FDF_CRG/20120509_FDF_CRG_c12.mtb	2558	COLL	WWFF	food_fat	4	156811	1336710499	1	0.140000000000001	0.00153846153846155	9641	1
4	Food 1	Intake 3	78	156890	1336710578	/users/cn/jespinosa/phecomp/data/CRG/20120502_FDF_CRG/20120502_FDF_CRG/20120509_FDF_CRG_c12.mtb	1972	79	WWFF	food_fat	3	156812	1336710500	1	0.0999999999999979	0.00128205128205126	9642	1
4	Food 1	Intake 3	13	156982	1336710670	/users/cn/jespinosa/phecomp/data/CRG/20120502_FDF_CRG/20120502_FDF_CRG/20120509_FDF_CRG_c12.mtb	1973	64	WWFF	food_fat	3	156969	1336710657	1	0.0600000000000023	0.00461538461538479	9643	1
4	Food 1	Intake 3	20	157066	1336710754	/users/cn/jespinosa/phecomp/data/CRG/20120502_FDF_CRG/20120502_FDF_CRG/20120509_FDF_CRG_c12.mtb	1975	14	WWFF	food_fat	3	157046	1336710734	1	0.0599999999999987	0.00299999999999994	9644	1
4	Food 1	Intake 3	48	157128	1336710816	/users/cn/jespinosa/phecomp/data/CRG/20120502_FDF_CRG/20120502_FDF_CRG/20120509_FDF_CRG_c12.mtb	1976	56	WWFF	food_fat	3	157080	1336710768	1	0.0600000000000023	0.00125000000000005	9645	1
4	Food 1	Intake 3	54	157238	1336710926	/users/cn/jespinosa/phecomp/data/CRG/20120502_FDF_CRG/20120502_FDF_CRG/20120509_FDF_CRG_c12.mtb	1977	874	WWFF	food_fat	3	157184	1336710872	1	0.0399999999999991	0.000740740740740724	9646	1
4	Drink 1	Intake 1	18	157760	1336711448	/users/cn/jespinosa/phecomp/data/CRG/20120502_FDF_CRG/20120502_FDF_CRG/20120509_FDF_CRG_c12.mtb	1301	NA	WWFF	water	1	157742	1336711430	1	0.0599999999999996	0.00333333333333331	9647	1
4	Food 1	Intake 3	14	158126	1336711814	/users/cn/jespinosa/phecomp/data/CRG/20120502_FDF_CRG/20120502_FDF_CRG/20120509_FDF_CRG_c12.mtb	1979	614	WWFF	food_fat	3	158112	1336711800	1	0.120000000000001	0.00857142857142864	9648	1
4	Food 2	Intake 4	28	158768	1336712456	/users/cn/jespinosa/phecomp/data/CRG/20120502_FDF_CRG/20120502_FDF_CRG/20120509_FDF_CRG_c12.mtb	2564	624	WWFF	food_fat	4	158740	1336712428	1	0.0599999999999987	0.0021428571428571	9649	1
4	Food 2	Intake 4	100	159492	1336713180	/users/cn/jespinosa/phecomp/data/CRG/20120502_FDF_CRG/20120502_FDF_CRG/20120509_FDF_CRG_c12.mtb	2567	COLL	WWFF	food_fat	4	159392	1336713080	1	0.0400000000000027	0.000400000000000027	9650	1
4	Food 1	Intake 3	60	159461	1336713149	/users/cn/jespinosa/phecomp/data/CRG/20120502_FDF_CRG/20120502_FDF_CRG/20120509_FDF_CRG_c12.mtb	1982	48	WWFF	food_fat	3	159401	1336713089	1	0.0399999999999991	0.000666666666666652	9651	1
4	Food 1	Intake 3	13	159522	1336713210	/users/cn/jespinosa/phecomp/data/CRG/20120502_FDF_CRG/20120502_FDF_CRG/20120509_FDF_CRG_c12.mtb	1983	341	WWFF	food_fat	3	159509	1336713197	1	0.0200000000000031	0.00153846153846178	9652	1
4	Food 2	Intake 4	20	159883	1336713571	/users/cn/jespinosa/phecomp/data/CRG/20120502_FDF_CRG/20120502_FDF_CRG/20120509_FDF_CRG_c12.mtb	2569	6	WWFF	food_fat	4	159863	1336713551	1	0.140000000000001	0.00700000000000005	9653	1
4	Food 2	Intake 4	306	160195	1336713883	/users/cn/jespinosa/phecomp/data/CRG/20120502_FDF_CRG/20120502_FDF_CRG/20120509_FDF_CRG_c12.mtb	2570	18	WWFF	food_fat	4	159889	1336713577	1	0.0600000000000023	0.000196078431372557	9654	1
4	Drink 2	Intake 2	19	160165	1336713853	/users/cn/jespinosa/phecomp/data/CRG/20120502_FDF_CRG/20120502_FDF_CRG/20120509_FDF_CRG_c12.mtb	1234	NA	WWFF	water	2	160146	1336713834	1	0.0600000000000001	0.00315789473684211	9655	1
4	Food 2	Intake 4	12	160225	1336713913	/users/cn/jespinosa/phecomp/data/CRG/20120502_FDF_CRG/20120502_FDF_CRG/20120509_FDF_CRG_c12.mtb	2571	232	WWFF	food_fat	4	160213	1336713901	1	0.0399999999999991	0.00333333333333326	9656	1
4	Food 1	Intake 3	73	160530	1336714218	/users/cn/jespinosa/phecomp/data/CRG/20120502_FDF_CRG/20120502_FDF_CRG/20120509_FDF_CRG_c12.mtb	1989	COLL	WWFF	food_fat	3	160457	1336714145	1	0.0799999999999983	0.00109589041095888	9657	1
4	Food 2	Intake 4	175	160633	1336714321	/users/cn/jespinosa/phecomp/data/CRG/20120502_FDF_CRG/20120502_FDF_CRG/20120509_FDF_CRG_c12.mtb	2574	43	WWFF	food_fat	4	160458	1336714146	1	0.16	0.000914285714285714	9658	1
4	Food 2	Intake 4	363	161039	1336714727	/users/cn/jespinosa/phecomp/data/CRG/20120502_FDF_CRG/20120502_FDF_CRG/20120509_FDF_CRG_c12.mtb	2575	364	WWFF	food_fat	4	160676	1336714364	1	0.199999999999999	0.000550964187327821	9659	1
4	Drink 2	Intake 2	22	160726	1336714414	/users/cn/jespinosa/phecomp/data/CRG/20120502_FDF_CRG/20120502_FDF_CRG/20120509_FDF_CRG_c12.mtb	1236	NA	WWFF	water	2	160704	1336714392	1	0.0600000000000001	0.00272727272727273	9660	1
4	Drink 2	Intake 2	20	160830	1336714518	/users/cn/jespinosa/phecomp/data/CRG/20120502_FDF_CRG/20120502_FDF_CRG/20120509_FDF_CRG_c12.mtb	1238	NA	WWFF	water	2	160810	1336714498	1	0.0399999999999998	0.00199999999999999	9661	1
4	Food 2	Intake 4	28	161431	1336715119	/users/cn/jespinosa/phecomp/data/CRG/20120502_FDF_CRG/20120502_FDF_CRG/20120509_FDF_CRG_c12.mtb	2577	153	WWFF	food_fat	4	161403	1336715091	1	0.100000000000001	0.00357142857142861	9662	1
4	Food 2	Intake 4	24	161608	1336715296	/users/cn/jespinosa/phecomp/data/CRG/20120502_FDF_CRG/20120502_FDF_CRG/20120509_FDF_CRG_c12.mtb	2579	COLL	WWFF	food_fat	4	161584	1336715272	1	0.0999999999999979	0.00416666666666658	9663	1
4	Food 1	Intake 3	12	161605	1336715293	/users/cn/jespinosa/phecomp/data/CRG/20120502_FDF_CRG/20120502_FDF_CRG/20120509_FDF_CRG_c12.mtb	2005	88	WWFF	food_fat	3	161593	1336715281	1	0.0599999999999987	0.00499999999999989	9664	1
4	Food 2	Intake 4	141	161834	1336715522	/users/cn/jespinosa/phecomp/data/CRG/20120502_FDF_CRG/20120502_FDF_CRG/20120509_FDF_CRG_c12.mtb	2581	COLL	WWFF	food_fat	4	161693	1336715381	1	0.0399999999999991	0.000283687943262405	9665	1
4	Food 1	Intake 3	51	161800	1336715488	/users/cn/jespinosa/phecomp/data/CRG/20120502_FDF_CRG/20120502_FDF_CRG/20120509_FDF_CRG_c12.mtb	2008	2179	WWFF	food_fat	3	161749	1336715437	1	0.0200000000000031	0.000392156862745159	9666	1
4	Drink 1	Intake 1	15	163526	1336717214	/users/cn/jespinosa/phecomp/data/CRG/20120502_FDF_CRG/20120502_FDF_CRG/20120509_FDF_CRG_c12.mtb	1304	NA	WWFF	water	1	163511	1336717199	1	0.04	0.00266666666666667	9667	1
4	Food 2	Intake 4	13	163992	1336717680	/users/cn/jespinosa/phecomp/data/CRG/20120502_FDF_CRG/20120502_FDF_CRG/20120509_FDF_CRG_c12.mtb	2587	212	WWFF	food_fat	4	163979	1336717667	1	0.0800000000000018	0.00615384615384629	9668	1
4	Food 2	Intake 4	30	164234	1336717922	/users/cn/jespinosa/phecomp/data/CRG/20120502_FDF_CRG/20120502_FDF_CRG/20120509_FDF_CRG_c12.mtb	2588	1171	WWFF	food_fat	4	164204	1336717892	1	0.0599999999999987	0.00199999999999996	9669	1
4	Food 2	Intake 4	316	165721	1336719409	/users/cn/jespinosa/phecomp/data/CRG/20120502_FDF_CRG/20120502_FDF_CRG/20120509_FDF_CRG_c12.mtb	2592	COLL	WWFF	food_fat	4	165405	1336719093	1	0.0600000000000023	0.000189873417721526	9670	1
4	Food 1	Intake 3	65	165536	1336719224	/users/cn/jespinosa/phecomp/data/CRG/20120502_FDF_CRG/20120502_FDF_CRG/20120509_FDF_CRG_c12.mtb	2014	17	WWFF	food_fat	3	165471	1336719159	1	0.120000000000001	0.00184615384615386	9671	1
4	Food 1	Intake 3	147	165700	1336719388	/users/cn/jespinosa/phecomp/data/CRG/20120502_FDF_CRG/20120502_FDF_CRG/20120509_FDF_CRG_c12.mtb	2015	950	WWFF	food_fat	3	165553	1336719241	1	0.0399999999999991	0.000272108843537409	9672	1
4	Drink 1	Intake 1	26	166659	1336720347	/users/cn/jespinosa/phecomp/data/CRG/20120502_FDF_CRG/20120502_FDF_CRG/20120509_FDF_CRG_c12.mtb	1305	NA	WWFF	water	1	166633	1336720321	1	0.14	0.00538461538461539	9673	1
4	Food 2	Intake 4	13	166663	1336720351	/users/cn/jespinosa/phecomp/data/CRG/20120502_FDF_CRG/20120502_FDF_CRG/20120509_FDF_CRG_c12.mtb	2598	574	WWFF	food_fat	4	166650	1336720338	1	0.0399999999999991	0.00307692307692301	9674	1
4	Food 2	Intake 4	19	167256	1336720944	/users/cn/jespinosa/phecomp/data/CRG/20120502_FDF_CRG/20120502_FDF_CRG/20120509_FDF_CRG_c12.mtb	2599	625	WWFF	food_fat	4	167237	1336720925	1	0.0399999999999991	0.00210526315789469	9675	1
4	Food 2	Intake 4	14	167895	1336721583	/users/cn/jespinosa/phecomp/data/CRG/20120502_FDF_CRG/20120502_FDF_CRG/20120509_FDF_CRG_c12.mtb	2601	285	WWFF	food_fat	4	167881	1336721569	1	0.0399999999999991	0.00285714285714279	9676	1
4	Food 2	Intake 4	23	168203	1336721891	/users/cn/jespinosa/phecomp/data/CRG/20120502_FDF_CRG/20120502_FDF_CRG/20120509_FDF_CRG_c12.mtb	2602	386	WWFF	food_fat	4	168180	1336721868	1	0.0200000000000031	0.000869565217391439	9677	1
4	Food 2	Intake 4	24	168613	1336722301	/users/cn/jespinosa/phecomp/data/CRG/20120502_FDF_CRG/20120502_FDF_CRG/20120509_FDF_CRG_c12.mtb	2605	8911	WWFF	food_fat	4	168589	1336722277	1	0.0599999999999987	0.00249999999999995	9678	1
4	Food 1	Intake 3	16	363	1336731228	/users/cn/jespinosa/phecomp/data/CRG/20120502_FDF_CRG/20120502_FDF_CRG/20120511_FDF_CRG_c12.mtb	2703	COLL	WWFF	food_fat	3	347	1336731212	1	0.32	0.02	9679	1
4	Food 2	Intake 4	77	430	1336731295	/users/cn/jespinosa/phecomp/data/CRG/20120502_FDF_CRG/20120502_FDF_CRG/20120511_FDF_CRG_c12.mtb	3402	COLL	WWFF	food_fat	4	353	1336731218	1	0.3	0.0038961038961039	9680	1
4	Food 1	Intake 3	42	450	1336731315	/users/cn/jespinosa/phecomp/data/CRG/20120502_FDF_CRG/20120502_FDF_CRG/20120511_FDF_CRG_c12.mtb	2704	COLL	WWFF	food_fat	3	408	1336731273	1	0.88	0.020952380952381	9681	1
4	Food 2	Intake 4	65	504	1336731369	/users/cn/jespinosa/phecomp/data/CRG/20120502_FDF_CRG/20120502_FDF_CRG/20120511_FDF_CRG_c12.mtb	3403	COLL	WWFF	food_fat	4	439	1336731304	1	0.1	0.00153846153846154	9682	1
4	Food 1	Intake 3	21	487	1336731352	/users/cn/jespinosa/phecomp/data/CRG/20120502_FDF_CRG/20120502_FDF_CRG/20120511_FDF_CRG_c12.mtb	2705	5	WWFF	food_fat	3	466	1336731331	1	0.0800000000000001	0.00380952380952381	9683	1
4	Food 1	Intake 3	77	569	1336731434	/users/cn/jespinosa/phecomp/data/CRG/20120502_FDF_CRG/20120502_FDF_CRG/20120511_FDF_CRG_c12.mtb	2706	COLL	WWFF	food_fat	3	492	1336731357	1	0.76	0.00987012987012987	9684	1
4	Food 2	Intake 4	28	542	1336731407	/users/cn/jespinosa/phecomp/data/CRG/20120502_FDF_CRG/20120502_FDF_CRG/20120511_FDF_CRG_c12.mtb	3404	43	WWFF	food_fat	4	514	1336731379	1	0.02	0.000714285714285714	9685	1
4	Food 2	Intake 4	93	678	1336731543	/users/cn/jespinosa/phecomp/data/CRG/20120502_FDF_CRG/20120502_FDF_CRG/20120511_FDF_CRG_c12.mtb	3405	COLL	WWFF	food_fat	4	585	1336731450	1	0.0800000000000001	0.000860215053763442	9686	1
4	Food 1	Intake 3	16	606	1336731471	/users/cn/jespinosa/phecomp/data/CRG/20120502_FDF_CRG/20120502_FDF_CRG/20120511_FDF_CRG_c12.mtb	2707	90	WWFF	food_fat	3	590	1336731455	1	0.02	0.00125	9687	1
4	Food 2	Intake 4	186	882	1336731747	/users/cn/jespinosa/phecomp/data/CRG/20120502_FDF_CRG/20120502_FDF_CRG/20120511_FDF_CRG_c12.mtb	3406	COLL	WWFF	food_fat	4	696	1336731561	1	0.14	0.000752688172043011	9688	1
4	Food 1	Intake 3	209	906	1336731771	/users/cn/jespinosa/phecomp/data/CRG/20120502_FDF_CRG/20120502_FDF_CRG/20120511_FDF_CRG_c12.mtb	2709	113	WWFF	food_fat	3	697	1336731562	1	0.88	0.00421052631578947	9689	1
4	Food 2	Intake 4	149	1168	1336732033	/users/cn/jespinosa/phecomp/data/CRG/20120502_FDF_CRG/20120502_FDF_CRG/20120511_FDF_CRG_c12.mtb	3408	155	WWFF	food_fat	4	1019	1336731884	1	0.02	0.000134228187919463	9690	1
4	Drink 1	Intake 1	19	1161	1336732026	/users/cn/jespinosa/phecomp/data/CRG/20120502_FDF_CRG/20120502_FDF_CRG/20120511_FDF_CRG_c12.mtb	1480	NA	WWFF	water	1	1142	1336732007	1	0.08	0.00421052631578947	9691	1
4	Food 2	Intake 4	619	1942	1336732807	/users/cn/jespinosa/phecomp/data/CRG/20120502_FDF_CRG/20120502_FDF_CRG/20120511_FDF_CRG_c12.mtb	3410	COLL	WWFF	food_fat	4	1323	1336732188	1	0.36	0.000581583198707593	9692	1
4	Food 1	Intake 3	89	1893	1336732758	/users/cn/jespinosa/phecomp/data/CRG/20120502_FDF_CRG/20120502_FDF_CRG/20120511_FDF_CRG_c12.mtb	2716	277	WWFF	food_fat	3	1804	1336732669	1	0.12	0.00134831460674157	9693	1
4	Food 1	Intake 3	32	2202	1336733067	/users/cn/jespinosa/phecomp/data/CRG/20120502_FDF_CRG/20120502_FDF_CRG/20120511_FDF_CRG_c12.mtb	2721	578	WWFF	food_fat	3	2170	1336733035	1	0.04	0.00125	9694	1
4	Food 1	Intake 3	8	2788	1336733653	/users/cn/jespinosa/phecomp/data/CRG/20120502_FDF_CRG/20120502_FDF_CRG/20120511_FDF_CRG_c12.mtb	2723	337	WWFF	food_fat	3	2780	1336733645	1	0.02	0.0025	9695	1
4	Food 1	Intake 3	16	3141	1336734006	/users/cn/jespinosa/phecomp/data/CRG/20120502_FDF_CRG/20120502_FDF_CRG/20120511_FDF_CRG_c12.mtb	2724	809	WWFF	food_fat	3	3125	1336733990	1	0.04	0.0025	9696	1
4	Food 1	Intake 3	12	3962	1336734827	/users/cn/jespinosa/phecomp/data/CRG/20120502_FDF_CRG/20120502_FDF_CRG/20120511_FDF_CRG_c12.mtb	2732	184	WWFF	food_fat	3	3950	1336734815	1	0.02	0.00166666666666667	9697	1
4	Food 1	Intake 3	25	4171	1336735036	/users/cn/jespinosa/phecomp/data/CRG/20120502_FDF_CRG/20120502_FDF_CRG/20120511_FDF_CRG_c12.mtb	2733	72	WWFF	food_fat	3	4146	1336735011	1	0.02	0.0008	9698	1
4	Food 1	Intake 3	13	4256	1336735121	/users/cn/jespinosa/phecomp/data/CRG/20120502_FDF_CRG/20120502_FDF_CRG/20120511_FDF_CRG_c12.mtb	2734	1416	WWFF	food_fat	3	4243	1336735108	1	0.02	0.00153846153846154	9699	1
4	Food 1	Intake 3	12	5684	1336736549	/users/cn/jespinosa/phecomp/data/CRG/20120502_FDF_CRG/20120502_FDF_CRG/20120511_FDF_CRG_c12.mtb	2736	38	WWFF	food_fat	3	5672	1336736537	1	0.02	0.00166666666666667	9700	1
4	Food 1	Intake 3	13	5735	1336736600	/users/cn/jespinosa/phecomp/data/CRG/20120502_FDF_CRG/20120502_FDF_CRG/20120511_FDF_CRG_c12.mtb	2737	1815	WWFF	food_fat	3	5722	1336736587	1	0.04	0.00307692307692308	9701	1
4	Drink 1	Intake 1	18	6593	1336737458	/users/cn/jespinosa/phecomp/data/CRG/20120502_FDF_CRG/20120502_FDF_CRG/20120511_FDF_CRG_c12.mtb	1481	NA	WWFF	water	1	6575	1336737440	1	0.06	0.00333333333333333	9702	1
4	Food 1	Intake 3	19	7569	1336738434	/users/cn/jespinosa/phecomp/data/CRG/20120502_FDF_CRG/20120502_FDF_CRG/20120511_FDF_CRG_c12.mtb	2743	2195	WWFF	food_fat	3	7550	1336738415	1	0.02	0.00105263157894737	9703	1
4	Drink 1	Intake 1	26	7580	1336738445	/users/cn/jespinosa/phecomp/data/CRG/20120502_FDF_CRG/20120502_FDF_CRG/20120511_FDF_CRG_c12.mtb	1482	NA	WWFF	water	1	7554	1336738419	1	0.08	0.00307692307692308	9704	1
4	Food 2	Intake 4	14	9778	1336740643	/users/cn/jespinosa/phecomp/data/CRG/20120502_FDF_CRG/20120502_FDF_CRG/20120511_FDF_CRG_c12.mtb	3431	804	WWFF	food_fat	4	9764	1336740629	1	0.0600000000000001	0.00428571428571429	9705	1
4	Food 1	Intake 3	12	10594	1336741459	/users/cn/jespinosa/phecomp/data/CRG/20120502_FDF_CRG/20120502_FDF_CRG/20120511_FDF_CRG_c12.mtb	2753	3222	WWFF	food_fat	3	10582	1336741447	1	0.04	0.00333333333333333	9706	1
4	Drink 1	Intake 1	18	11611	1336742476	/users/cn/jespinosa/phecomp/data/CRG/20120502_FDF_CRG/20120502_FDF_CRG/20120511_FDF_CRG_c12.mtb	1483	NA	WWFF	water	1	11593	1336742458	1	0.02	0.00111111111111111	9707	1
4	Drink 1	Intake 1	17	13743	1336744608	/users/cn/jespinosa/phecomp/data/CRG/20120502_FDF_CRG/20120502_FDF_CRG/20120511_FDF_CRG_c12.mtb	1484	NA	WWFF	water	1	13726	1336744591	1	0.02	0.00117647058823529	9708	1
4	Food 2	Intake 4	34	13850	1336744715	/users/cn/jespinosa/phecomp/data/CRG/20120502_FDF_CRG/20120502_FDF_CRG/20120511_FDF_CRG_c12.mtb	3436	409	WWFF	food_fat	4	13816	1336744681	1	0.12	0.00352941176470588	9709	1
4	Food 1	Intake 3	18	14277	1336745142	/users/cn/jespinosa/phecomp/data/CRG/20120502_FDF_CRG/20120502_FDF_CRG/20120511_FDF_CRG_c12.mtb	2770	COLL	WWFF	food_fat	3	14259	1336745124	1	0.02	0.00111111111111111	9710	1
4	Food 2	Intake 4	10	14275	1336745140	/users/cn/jespinosa/phecomp/data/CRG/20120502_FDF_CRG/20120502_FDF_CRG/20120511_FDF_CRG_c12.mtb	3437	528	WWFF	food_fat	4	14265	1336745130	1	0.02	0.002	9711	1
4	Drink 2	Intake 2	25	14816	1336745681	/users/cn/jespinosa/phecomp/data/CRG/20120502_FDF_CRG/20120502_FDF_CRG/20120511_FDF_CRG_c12.mtb	1362	NA	WWFF	water	2	14791	1336745656	1	0.14	0.0056	9712	1
4	Food 2	Intake 4	14	14817	1336745682	/users/cn/jespinosa/phecomp/data/CRG/20120502_FDF_CRG/20120502_FDF_CRG/20120511_FDF_CRG_c12.mtb	3439	738	WWFF	food_fat	4	14803	1336745668	1	0.1	0.00714285714285714	9713	1
4	Food 1	Intake 3	15	15570	1336746435	/users/cn/jespinosa/phecomp/data/CRG/20120502_FDF_CRG/20120502_FDF_CRG/20120511_FDF_CRG_c12.mtb	2776	2213	WWFF	food_fat	3	15555	1336746420	1	0.02	0.00133333333333333	9714	1
4	Food 1	Intake 3	14	17797	1336748662	/users/cn/jespinosa/phecomp/data/CRG/20120502_FDF_CRG/20120502_FDF_CRG/20120511_FDF_CRG_c12.mtb	2781	858	WWFF	food_fat	3	17783	1336748648	1	0.0600000000000001	0.00428571428571429	9715	1
4	Food 1	Intake 3	13	18668	1336749533	/users/cn/jespinosa/phecomp/data/CRG/20120502_FDF_CRG/20120502_FDF_CRG/20120511_FDF_CRG_c12.mtb	2783	299	WWFF	food_fat	3	18655	1336749520	1	0.02	0.00153846153846154	9716	1
4	Food 2	Intake 4	28	18995	1336749860	/users/cn/jespinosa/phecomp/data/CRG/20120502_FDF_CRG/20120502_FDF_CRG/20120511_FDF_CRG_c12.mtb	3443	COLL	WWFF	food_fat	4	18967	1336749832	1	0.26	0.00928571428571429	9717	1
4	Food 1	Intake 3	44	19012	1336749877	/users/cn/jespinosa/phecomp/data/CRG/20120502_FDF_CRG/20120502_FDF_CRG/20120511_FDF_CRG_c12.mtb	2785	125	WWFF	food_fat	3	18968	1336749833	1	0.36	0.00818181818181818	9718	1
4	Food 1	Intake 3	54	19191	1336750056	/users/cn/jespinosa/phecomp/data/CRG/20120502_FDF_CRG/20120502_FDF_CRG/20120511_FDF_CRG_c12.mtb	2786	296	WWFF	food_fat	3	19137	1336750002	1	0.02	0.00037037037037037	9719	1
4	Food 1	Intake 3	30	19517	1336750382	/users/cn/jespinosa/phecomp/data/CRG/20120502_FDF_CRG/20120502_FDF_CRG/20120511_FDF_CRG_c12.mtb	2792	269	WWFF	food_fat	3	19487	1336750352	1	0.02	0.000666666666666667	9720	1
4	Food 2	Intake 4	45	19831	1336750696	/users/cn/jespinosa/phecomp/data/CRG/20120502_FDF_CRG/20120502_FDF_CRG/20120511_FDF_CRG_c12.mtb	3445	181	WWFF	food_fat	4	19786	1336750651	1	0.02	0.000444444444444444	9721	1
4	Drink 2	Intake 2	26	19817	1336750682	/users/cn/jespinosa/phecomp/data/CRG/20120502_FDF_CRG/20120502_FDF_CRG/20120511_FDF_CRG_c12.mtb	1363	NA	WWFF	water	2	19791	1336750656	1	0.1	0.00384615384615385	9722	1
4	Food 1	Intake 3	100	20112	1336750977	/users/cn/jespinosa/phecomp/data/CRG/20120502_FDF_CRG/20120502_FDF_CRG/20120511_FDF_CRG_c12.mtb	2800	COLL	WWFF	food_fat	3	20012	1336750877	1	0.02	0.0002	9723	1
4	Food 2	Intake 4	76	20115	1336750980	/users/cn/jespinosa/phecomp/data/CRG/20120502_FDF_CRG/20120502_FDF_CRG/20120511_FDF_CRG_c12.mtb	3447	177	WWFF	food_fat	4	20039	1336750904	1	0.12	0.00157894736842105	9724	1
4	Food 2	Intake 4	139	20431	1336751296	/users/cn/jespinosa/phecomp/data/CRG/20120502_FDF_CRG/20120502_FDF_CRG/20120511_FDF_CRG_c12.mtb	3450	142	WWFF	food_fat	4	20292	1336751157	1	0.02	0.000143884892086331	9725	1
4	Drink 2	Intake 2	21	20359	1336751224	/users/cn/jespinosa/phecomp/data/CRG/20120502_FDF_CRG/20120502_FDF_CRG/20120511_FDF_CRG_c12.mtb	1364	NA	WWFF	water	2	20338	1336751203	1	0.02	0.000952380952380952	9726	1
4	Food 2	Intake 4	22	20595	1336751460	/users/cn/jespinosa/phecomp/data/CRG/20120502_FDF_CRG/20120502_FDF_CRG/20120511_FDF_CRG_c12.mtb	3453	145	WWFF	food_fat	4	20573	1336751438	1	0.1	0.00454545454545455	9727	1
4	Food 2	Intake 4	27	20767	1336751632	/users/cn/jespinosa/phecomp/data/CRG/20120502_FDF_CRG/20120502_FDF_CRG/20120511_FDF_CRG_c12.mtb	3455	32	WWFF	food_fat	4	20740	1336751605	1	0.26	0.00962962962962963	9728	1
4	Food 1	Intake 3	19	20818	1336751683	/users/cn/jespinosa/phecomp/data/CRG/20120502_FDF_CRG/20120502_FDF_CRG/20120511_FDF_CRG_c12.mtb	2807	128	WWFF	food_fat	3	20799	1336751664	1	0.02	0.00105263157894737	9729	1
4	Food 2	Intake 4	15	20961	1336751826	/users/cn/jespinosa/phecomp/data/CRG/20120502_FDF_CRG/20120502_FDF_CRG/20120511_FDF_CRG_c12.mtb	3459	COLL	WWFF	food_fat	4	20946	1336751811	1	0.24	0.016	9730	1
4	Food 1	Intake 3	20	20967	1336751832	/users/cn/jespinosa/phecomp/data/CRG/20120502_FDF_CRG/20120502_FDF_CRG/20120511_FDF_CRG_c12.mtb	2809	532	WWFF	food_fat	3	20947	1336751812	1	0.26	0.013	9731	1
4	Food 2	Intake 4	12	21511	1336752376	/users/cn/jespinosa/phecomp/data/CRG/20120502_FDF_CRG/20120502_FDF_CRG/20120511_FDF_CRG_c12.mtb	3461	1235	WWFF	food_fat	4	21499	1336752364	1	0.02	0.00166666666666667	9732	1
4	Food 1	Intake 3	12	22758	1336753623	/users/cn/jespinosa/phecomp/data/CRG/20120502_FDF_CRG/20120502_FDF_CRG/20120511_FDF_CRG_c12.mtb	2816	156	WWFF	food_fat	3	22746	1336753611	1	0.04	0.00333333333333333	9733	1
4	Food 1	Intake 3	19	22933	1336753798	/users/cn/jespinosa/phecomp/data/CRG/20120502_FDF_CRG/20120502_FDF_CRG/20120511_FDF_CRG_c12.mtb	2817	811	WWFF	food_fat	3	22914	1336753779	1	0.02	0.00105263157894737	9734	1
4	Food 1	Intake 3	45	23789	1336754654	/users/cn/jespinosa/phecomp/data/CRG/20120502_FDF_CRG/20120502_FDF_CRG/20120511_FDF_CRG_c12.mtb	2819	2903	WWFF	food_fat	3	23744	1336754609	1	0.0600000000000001	0.00133333333333334	9735	1
4	Food 1	Intake 3	55	26747	1336757612	/users/cn/jespinosa/phecomp/data/CRG/20120502_FDF_CRG/20120502_FDF_CRG/20120511_FDF_CRG_c12.mtb	2826	442	WWFF	food_fat	3	26692	1336757557	1	0.02	0.000363636363636364	9736	1
4	Drink 1	Intake 1	21	26730	1336757595	/users/cn/jespinosa/phecomp/data/CRG/20120502_FDF_CRG/20120502_FDF_CRG/20120511_FDF_CRG_c12.mtb	1485	NA	WWFF	water	1	26709	1336757574	1	0.1	0.00476190476190476	9737	1
4	Food 2	Intake 4	22	27211	1336758076	/users/cn/jespinosa/phecomp/data/CRG/20120502_FDF_CRG/20120502_FDF_CRG/20120511_FDF_CRG_c12.mtb	3468	839	WWFF	food_fat	4	27189	1336758054	1	0.0599999999999998	0.00272727272727272	9738	1
4	Drink 1	Intake 1	19	27577	1336758442	/users/cn/jespinosa/phecomp/data/CRG/20120502_FDF_CRG/20120502_FDF_CRG/20120511_FDF_CRG_c12.mtb	1486	NA	WWFF	water	1	27558	1336758423	1	0.1	0.00526315789473684	9739	1
4	Food 1	Intake 3	15	28065	1336758930	/users/cn/jespinosa/phecomp/data/CRG/20120502_FDF_CRG/20120502_FDF_CRG/20120511_FDF_CRG_c12.mtb	2831	1364	WWFF	food_fat	3	28050	1336758915	1	0.02	0.00133333333333333	9740	1
4	Food 1	Intake 3	13	29442	1336760307	/users/cn/jespinosa/phecomp/data/CRG/20120502_FDF_CRG/20120502_FDF_CRG/20120511_FDF_CRG_c12.mtb	2838	635	WWFF	food_fat	3	29429	1336760294	1	0.02	0.00153846153846154	9741	1
4	Drink 2	Intake 2	28	30088	1336760953	/users/cn/jespinosa/phecomp/data/CRG/20120502_FDF_CRG/20120502_FDF_CRG/20120511_FDF_CRG_c12.mtb	1365	NA	WWFF	water	2	30060	1336760925	1	0.1	0.00357142857142857	9742	1
4	Food 1	Intake 3	18	30095	1336760960	/users/cn/jespinosa/phecomp/data/CRG/20120502_FDF_CRG/20120502_FDF_CRG/20120511_FDF_CRG_c12.mtb	2842	842	WWFF	food_fat	3	30077	1336760942	1	0.28	0.0155555555555556	9743	1
4	Food 2	Intake 4	20	30957	1336761822	/users/cn/jespinosa/phecomp/data/CRG/20120502_FDF_CRG/20120502_FDF_CRG/20120511_FDF_CRG_c12.mtb	3478	727	WWFF	food_fat	4	30937	1336761802	1	0.02	0.001	9744	1
4	Food 2	Intake 4	240	31924	1336762789	/users/cn/jespinosa/phecomp/data/CRG/20120502_FDF_CRG/20120502_FDF_CRG/20120511_FDF_CRG_c12.mtb	3485	COLL	WWFF	food_fat	4	31684	1336762549	1	0.0600000000000001	0.00025	9745	1
4	Drink 2	Intake 2	20	31727	1336762592	/users/cn/jespinosa/phecomp/data/CRG/20120502_FDF_CRG/20120502_FDF_CRG/20120511_FDF_CRG_c12.mtb	1366	NA	WWFF	water	2	31707	1336762572	1	0.06	0.003	9746	1
4	Food 1	Intake 3	87	31923	1336762788	/users/cn/jespinosa/phecomp/data/CRG/20120502_FDF_CRG/20120502_FDF_CRG/20120511_FDF_CRG_c12.mtb	2852	676	WWFF	food_fat	3	31836	1336762701	1	0.22	0.00252873563218391	9747	1
4	Food 2	Intake 4	110	32709	1336763574	/users/cn/jespinosa/phecomp/data/CRG/20120502_FDF_CRG/20120502_FDF_CRG/20120511_FDF_CRG_c12.mtb	3493	18	WWFF	food_fat	4	32599	1336763464	1	0.72	0.00654545454545455	9748	1
4	Food 2	Intake 4	93	32820	1336763685	/users/cn/jespinosa/phecomp/data/CRG/20120502_FDF_CRG/20120502_FDF_CRG/20120511_FDF_CRG_c12.mtb	3494	COLL	WWFF	food_fat	4	32727	1336763592	1	0.12	0.00129032258064516	9749	1
4	Food 1	Intake 3	73	32816	1336763681	/users/cn/jespinosa/phecomp/data/CRG/20120502_FDF_CRG/20120502_FDF_CRG/20120511_FDF_CRG_c12.mtb	2860	1667	WWFF	food_fat	3	32743	1336763608	1	0.0200000000000005	0.000273972602739733	9750	1
4	Drink 2	Intake 2	22	34183	1336765048	/users/cn/jespinosa/phecomp/data/CRG/20120502_FDF_CRG/20120502_FDF_CRG/20120511_FDF_CRG_c12.mtb	1369	NA	WWFF	water	2	34161	1336765026	1	0.04	0.00181818181818182	9751	1
4	Food 1	Intake 3	27	34510	1336765375	/users/cn/jespinosa/phecomp/data/CRG/20120502_FDF_CRG/20120502_FDF_CRG/20120511_FDF_CRG_c12.mtb	2867	COLL	WWFF	food_fat	3	34483	1336765348	1	0.0200000000000005	0.000740740740740759	9752	1
4	Food 2	Intake 4	25	34509	1336765374	/users/cn/jespinosa/phecomp/data/CRG/20120502_FDF_CRG/20120502_FDF_CRG/20120511_FDF_CRG_c12.mtb	3504	436	WWFF	food_fat	4	34484	1336765349	1	0.02	0.0008	9753	1
4	Food 1	Intake 3	83	35028	1336765893	/users/cn/jespinosa/phecomp/data/CRG/20120502_FDF_CRG/20120502_FDF_CRG/20120511_FDF_CRG_c12.mtb	2869	COLL	WWFF	food_fat	3	34945	1336765810	1	0.22	0.00265060240963855	9754	1
4	Food 2	Intake 4	48	34998	1336765863	/users/cn/jespinosa/phecomp/data/CRG/20120502_FDF_CRG/20120502_FDF_CRG/20120511_FDF_CRG_c12.mtb	3506	7	WWFF	food_fat	4	34950	1336765815	1	0.26	0.00541666666666667	9755	1
4	Food 2	Intake 4	25	35030	1336765895	/users/cn/jespinosa/phecomp/data/CRG/20120502_FDF_CRG/20120502_FDF_CRG/20120511_FDF_CRG_c12.mtb	3507	297	WWFF	food_fat	4	35005	1336765870	1	0.02	0.0008	9756	1
4	Food 2	Intake 4	15	35342	1336766207	/users/cn/jespinosa/phecomp/data/CRG/20120502_FDF_CRG/20120502_FDF_CRG/20120511_FDF_CRG_c12.mtb	3513	18	WWFF	food_fat	4	35327	1336766192	1	0.02	0.00133333333333333	9757	1
4	Food 2	Intake 4	280	35640	1336766505	/users/cn/jespinosa/phecomp/data/CRG/20120502_FDF_CRG/20120502_FDF_CRG/20120511_FDF_CRG_c12.mtb	3514	COLL	WWFF	food_fat	4	35360	1336766225	1	0.42	0.0015	9758	1
4	Food 1	Intake 3	13	35539	1336766404	/users/cn/jespinosa/phecomp/data/CRG/20120502_FDF_CRG/20120502_FDF_CRG/20120511_FDF_CRG_c12.mtb	2874	9	WWFF	food_fat	3	35526	1336766391	1	0.04	0.00307692307692308	9759	1
4	Food 1	Intake 3	329	35877	1336766742	/users/cn/jespinosa/phecomp/data/CRG/20120502_FDF_CRG/20120502_FDF_CRG/20120511_FDF_CRG_c12.mtb	2875	COLL	WWFF	food_fat	3	35548	1336766413	1	0.86	0.00261398176291793	9760	1
4	Food 2	Intake 4	249	35902	1336766767	/users/cn/jespinosa/phecomp/data/CRG/20120502_FDF_CRG/20120502_FDF_CRG/20120511_FDF_CRG_c12.mtb	3515	50	WWFF	food_fat	4	35653	1336766518	1	0.38	0.00152610441767068	9761	1
4	Food 1	Intake 3	77	36029	1336766894	/users/cn/jespinosa/phecomp/data/CRG/20120502_FDF_CRG/20120502_FDF_CRG/20120511_FDF_CRG_c12.mtb	2876	COLL	WWFF	food_fat	3	35952	1336766817	1	0.02	0.00025974025974026	9762	1
4	Food 2	Intake 4	87	36040	1336766905	/users/cn/jespinosa/phecomp/data/CRG/20120502_FDF_CRG/20120502_FDF_CRG/20120511_FDF_CRG_c12.mtb	3516	54	WWFF	food_fat	4	35953	1336766818	1	0.04	0.000459770114942529	9763	1
4	Food 1	Intake 3	157	36251	1336767116	/users/cn/jespinosa/phecomp/data/CRG/20120502_FDF_CRG/20120502_FDF_CRG/20120511_FDF_CRG_c12.mtb	2877	312	WWFF	food_fat	3	36094	1336766959	1	0.5	0.00318471337579618	9764	1
4	Drink 2	Intake 2	36	36583	1336767448	/users/cn/jespinosa/phecomp/data/CRG/20120502_FDF_CRG/20120502_FDF_CRG/20120511_FDF_CRG_c12.mtb	1371	NA	WWFF	water	2	36547	1336767412	1	0.06	0.00166666666666667	9765	1
4	Food 2	Intake 4	376	36939	1336767804	/users/cn/jespinosa/phecomp/data/CRG/20120502_FDF_CRG/20120502_FDF_CRG/20120511_FDF_CRG_c12.mtb	3520	COLL	WWFF	food_fat	4	36563	1336767428	1	0.48	0.00127659574468085	9766	1
4	Food 1	Intake 3	161	36725	1336767590	/users/cn/jespinosa/phecomp/data/CRG/20120502_FDF_CRG/20120502_FDF_CRG/20120511_FDF_CRG_c12.mtb	2881	12	WWFF	food_fat	3	36564	1336767429	1	0.300000000000001	0.00186335403726709	9767	1
4	Food 1	Intake 3	202	36939	1336767804	/users/cn/jespinosa/phecomp/data/CRG/20120502_FDF_CRG/20120502_FDF_CRG/20120511_FDF_CRG_c12.mtb	2882	151	WWFF	food_fat	3	36737	1336767602	1	1.02	0.00504950495049505	9768	1
4	Food 2	Intake 4	14	37104	1336767969	/users/cn/jespinosa/phecomp/data/CRG/20120502_FDF_CRG/20120502_FDF_CRG/20120511_FDF_CRG_c12.mtb	3523	15	WWFF	food_fat	4	37090	1336767955	1	0.1	0.00714285714285714	9769	1
4	Food 2	Intake 4	84	37203	1336768068	/users/cn/jespinosa/phecomp/data/CRG/20120502_FDF_CRG/20120502_FDF_CRG/20120511_FDF_CRG_c12.mtb	3524	COLL	WWFF	food_fat	4	37119	1336767984	1	0.0800000000000001	0.000952380952380954	9770	1
4	Food 1	Intake 3	36	37216	1336768081	/users/cn/jespinosa/phecomp/data/CRG/20120502_FDF_CRG/20120502_FDF_CRG/20120511_FDF_CRG_c12.mtb	2886	286	WWFF	food_fat	3	37180	1336768045	1	0.100000000000001	0.00277777777777781	9771	1
4	Food 2	Intake 4	123	37625	1336768490	/users/cn/jespinosa/phecomp/data/CRG/20120502_FDF_CRG/20120502_FDF_CRG/20120511_FDF_CRG_c12.mtb	3528	COLL	WWFF	food_fat	4	37502	1336768367	1	0.16	0.00130081300813008	9772	1
4	Food 1	Intake 3	128	37631	1336768496	/users/cn/jespinosa/phecomp/data/CRG/20120502_FDF_CRG/20120502_FDF_CRG/20120511_FDF_CRG_c12.mtb	2890	112	WWFF	food_fat	3	37503	1336768368	1	0.28	0.0021875	9773	1
4	Food 2	Intake 4	62	37805	1336768670	/users/cn/jespinosa/phecomp/data/CRG/20120502_FDF_CRG/20120502_FDF_CRG/20120511_FDF_CRG_c12.mtb	3530	54	WWFF	food_fat	4	37743	1336768608	1	0.02	0.00032258064516129	9774	1
4	Food 2	Intake 4	189	38048	1336768913	/users/cn/jespinosa/phecomp/data/CRG/20120502_FDF_CRG/20120502_FDF_CRG/20120511_FDF_CRG_c12.mtb	3532	COLL	WWFF	food_fat	4	37859	1336768724	1	0.24	0.00126984126984127	9775	1
4	Food 1	Intake 3	20	38052	1336768917	/users/cn/jespinosa/phecomp/data/CRG/20120502_FDF_CRG/20120502_FDF_CRG/20120511_FDF_CRG_c12.mtb	2894	162	WWFF	food_fat	3	38032	1336768897	1	0.12	0.006	9776	1
4	Food 2	Intake 4	96	38310	1336769175	/users/cn/jespinosa/phecomp/data/CRG/20120502_FDF_CRG/20120502_FDF_CRG/20120511_FDF_CRG_c12.mtb	3535	44	WWFF	food_fat	4	38214	1336769079	1	0.22	0.00229166666666667	9777	1
4	Food 1	Intake 3	267	38621	1336769486	/users/cn/jespinosa/phecomp/data/CRG/20120502_FDF_CRG/20120502_FDF_CRG/20120511_FDF_CRG_c12.mtb	2898	COLL	WWFF	food_fat	3	38354	1336769219	1	0.56	0.00209737827715356	9778	1
4	Food 2	Intake 4	106	38463	1336769328	/users/cn/jespinosa/phecomp/data/CRG/20120502_FDF_CRG/20120502_FDF_CRG/20120511_FDF_CRG_c12.mtb	3536	6	WWFF	food_fat	4	38357	1336769222	1	0.0999999999999996	0.000943396226415091	9779	1
4	Food 2	Intake 4	68	38537	1336769402	/users/cn/jespinosa/phecomp/data/CRG/20120502_FDF_CRG/20120502_FDF_CRG/20120511_FDF_CRG_c12.mtb	3537	23	WWFF	food_fat	4	38469	1336769334	1	0.02	0.000294117647058824	9780	1
4	Food 2	Intake 4	63	38623	1336769488	/users/cn/jespinosa/phecomp/data/CRG/20120502_FDF_CRG/20120502_FDF_CRG/20120511_FDF_CRG_c12.mtb	3538	22	WWFF	food_fat	4	38560	1336769425	1	0.0800000000000001	0.00126984126984127	9781	1
4	Food 2	Intake 4	213	38858	1336769723	/users/cn/jespinosa/phecomp/data/CRG/20120502_FDF_CRG/20120502_FDF_CRG/20120511_FDF_CRG_c12.mtb	3539	COLL	WWFF	food_fat	4	38645	1336769510	1	0.56	0.00262910798122066	9782	1
4	Food 1	Intake 3	185	38832	1336769697	/users/cn/jespinosa/phecomp/data/CRG/20120502_FDF_CRG/20120502_FDF_CRG/20120511_FDF_CRG_c12.mtb	2899	4	WWFF	food_fat	3	38647	1336769512	1	0.0599999999999996	0.000324324324324322	9783	1
4	Food 1	Intake 3	23	38859	1336769724	/users/cn/jespinosa/phecomp/data/CRG/20120502_FDF_CRG/20120502_FDF_CRG/20120511_FDF_CRG_c12.mtb	2900	252	WWFF	food_fat	3	38836	1336769701	1	0.0600000000000005	0.00260869565217393	9784	1
4	Food 1	Intake 3	31	39142	1336770007	/users/cn/jespinosa/phecomp/data/CRG/20120502_FDF_CRG/20120502_FDF_CRG/20120511_FDF_CRG_c12.mtb	2903	251	WWFF	food_fat	3	39111	1336769976	1	0.04	0.00129032258064516	9785	1
4	Food 1	Intake 3	18	39411	1336770276	/users/cn/jespinosa/phecomp/data/CRG/20120502_FDF_CRG/20120502_FDF_CRG/20120511_FDF_CRG_c12.mtb	2906	255	WWFF	food_fat	3	39393	1336770258	1	0.0200000000000005	0.00111111111111114	9786	1
4	Drink 1	Intake 1	24	39532	1336770397	/users/cn/jespinosa/phecomp/data/CRG/20120502_FDF_CRG/20120502_FDF_CRG/20120511_FDF_CRG_c12.mtb	1491	NA	WWFF	water	1	39508	1336770373	1	0.1	0.00416666666666667	9787	1
4	Food 2	Intake 4	62	39728	1336770593	/users/cn/jespinosa/phecomp/data/CRG/20120502_FDF_CRG/20120502_FDF_CRG/20120511_FDF_CRG_c12.mtb	3542	361	WWFF	food_fat	4	39666	1336770531	1	0.0600000000000005	0.000967741935483879	9788	1
4	Food 1	Intake 3	38	40127	1336770992	/users/cn/jespinosa/phecomp/data/CRG/20120502_FDF_CRG/20120502_FDF_CRG/20120511_FDF_CRG_c12.mtb	2911	265	WWFF	food_fat	3	40089	1336770954	1	0.0600000000000005	0.00157894736842107	9789	1
4	Food 1	Intake 3	16	40408	1336771273	/users/cn/jespinosa/phecomp/data/CRG/20120502_FDF_CRG/20120502_FDF_CRG/20120511_FDF_CRG_c12.mtb	2914	74	WWFF	food_fat	3	40392	1336771257	1	0.0200000000000005	0.00125000000000003	9790	1
4	Food 2	Intake 4	14	40496	1336771361	/users/cn/jespinosa/phecomp/data/CRG/20120502_FDF_CRG/20120502_FDF_CRG/20120511_FDF_CRG_c12.mtb	3549	112	WWFF	food_fat	4	40482	1336771347	1	0.0200000000000005	0.00142857142857146	9791	1
4	Food 1	Intake 3	19	40627	1336771492	/users/cn/jespinosa/phecomp/data/CRG/20120502_FDF_CRG/20120502_FDF_CRG/20120511_FDF_CRG_c12.mtb	2917	236	WWFF	food_fat	3	40608	1336771473	1	0.0200000000000005	0.00105263157894739	9792	1
4	Food 1	Intake 3	165	41028	1336771893	/users/cn/jespinosa/phecomp/data/CRG/20120502_FDF_CRG/20120502_FDF_CRG/20120511_FDF_CRG_c12.mtb	2920	COLL	WWFF	food_fat	3	40863	1336771728	1	0.44	0.00266666666666667	9793	1
4	Food 2	Intake 4	92	40957	1336771822	/users/cn/jespinosa/phecomp/data/CRG/20120502_FDF_CRG/20120502_FDF_CRG/20120511_FDF_CRG_c12.mtb	3553	59	WWFF	food_fat	4	40865	1336771730	1	0.279999999999999	0.00304347826086955	9794	1
4	Food 2	Intake 4	46	41062	1336771927	/users/cn/jespinosa/phecomp/data/CRG/20120502_FDF_CRG/20120502_FDF_CRG/20120511_FDF_CRG_c12.mtb	3555	COLL	WWFF	food_fat	4	41016	1336771881	1	0.0600000000000005	0.00130434782608697	9795	1
4	Food 1	Intake 3	13	41061	1336771926	/users/cn/jespinosa/phecomp/data/CRG/20120502_FDF_CRG/20120502_FDF_CRG/20120511_FDF_CRG_c12.mtb	2921	228	WWFF	food_fat	3	41048	1336771913	1	0.0599999999999996	0.00461538461538458	9796	1
4	Drink 2	Intake 2	47	41312	1336772177	/users/cn/jespinosa/phecomp/data/CRG/20120502_FDF_CRG/20120502_FDF_CRG/20120511_FDF_CRG_c12.mtb	1374	NA	WWFF	water	2	41265	1336772130	1	0.0600000000000001	0.00127659574468085	9797	1
4	Food 2	Intake 4	108	41397	1336772262	/users/cn/jespinosa/phecomp/data/CRG/20120502_FDF_CRG/20120502_FDF_CRG/20120511_FDF_CRG_c12.mtb	3557	COLL	WWFF	food_fat	4	41289	1336772154	1	0.0800000000000001	0.000740740740740742	9798	1
4	Food 1	Intake 3	111	41402	1336772267	/users/cn/jespinosa/phecomp/data/CRG/20120502_FDF_CRG/20120502_FDF_CRG/20120511_FDF_CRG_c12.mtb	2926	329	WWFF	food_fat	3	41291	1336772156	1	0.16	0.00144144144144144	9799	1
4	Food 1	Intake 3	26	41757	1336772622	/users/cn/jespinosa/phecomp/data/CRG/20120502_FDF_CRG/20120502_FDF_CRG/20120511_FDF_CRG_c12.mtb	2931	COLL	WWFF	food_fat	3	41731	1336772596	1	0.260000000000001	0.01	9800	1
4	Food 2	Intake 4	13	41753	1336772618	/users/cn/jespinosa/phecomp/data/CRG/20120502_FDF_CRG/20120502_FDF_CRG/20120511_FDF_CRG_c12.mtb	3559	131	WWFF	food_fat	4	41740	1336772605	1	0.0800000000000001	0.00615384615384616	9801	1
4	Food 1	Intake 3	34	41918	1336772783	/users/cn/jespinosa/phecomp/data/CRG/20120502_FDF_CRG/20120502_FDF_CRG/20120511_FDF_CRG_c12.mtb	2933	COLL	WWFF	food_fat	3	41884	1336772749	1	0.0200000000000005	0.000588235294117662	9802	1
4	Food 2	Intake 4	29	41917	1336772782	/users/cn/jespinosa/phecomp/data/CRG/20120502_FDF_CRG/20120502_FDF_CRG/20120511_FDF_CRG_c12.mtb	3560	302	WWFF	food_fat	4	41888	1336772753	1	0.0200000000000005	0.00068965517241381	9803	1
4	Food 1	Intake 3	17	42236	1336773101	/users/cn/jespinosa/phecomp/data/CRG/20120502_FDF_CRG/20120502_FDF_CRG/20120511_FDF_CRG_c12.mtb	2936	26	WWFF	food_fat	3	42219	1336773084	1	0.0599999999999996	0.00352941176470586	9804	1
4	Food 1	Intake 3	67	42329	1336773194	/users/cn/jespinosa/phecomp/data/CRG/20120502_FDF_CRG/20120502_FDF_CRG/20120511_FDF_CRG_c12.mtb	2938	COLL	WWFF	food_fat	3	42262	1336773127	1	0.16	0.00238805970149254	9805	1
4	Food 2	Intake 4	75	42394	1336773259	/users/cn/jespinosa/phecomp/data/CRG/20120502_FDF_CRG/20120502_FDF_CRG/20120511_FDF_CRG_c12.mtb	3568	COLL	WWFF	food_fat	4	42319	1336773184	1	0.0600000000000005	0.000800000000000007	9806	1
4	Food 1	Intake 3	13	42393	1336773258	/users/cn/jespinosa/phecomp/data/CRG/20120502_FDF_CRG/20120502_FDF_CRG/20120511_FDF_CRG_c12.mtb	2940	436	WWFF	food_fat	3	42380	1336773245	1	0.0599999999999996	0.00461538461538458	9807	1
4	Food 1	Intake 3	15	42844	1336773709	/users/cn/jespinosa/phecomp/data/CRG/20120502_FDF_CRG/20120502_FDF_CRG/20120511_FDF_CRG_c12.mtb	2943	2149	WWFF	food_fat	3	42829	1336773694	1	0.0200000000000005	0.00133333333333337	9808	1
4	Food 1	Intake 3	14	45007	1336775872	/users/cn/jespinosa/phecomp/data/CRG/20120502_FDF_CRG/20120502_FDF_CRG/20120511_FDF_CRG_c12.mtb	2951	345	WWFF	food_fat	3	44993	1336775858	1	0.0200000000000005	0.00142857142857146	9809	1
4	Food 1	Intake 3	20	45372	1336776237	/users/cn/jespinosa/phecomp/data/CRG/20120502_FDF_CRG/20120502_FDF_CRG/20120511_FDF_CRG_c12.mtb	2953	556	WWFF	food_fat	3	45352	1336776217	1	0.0200000000000005	0.00100000000000002	9810	1
4	Food 2	Intake 4	15	45943	1336776808	/users/cn/jespinosa/phecomp/data/CRG/20120502_FDF_CRG/20120502_FDF_CRG/20120511_FDF_CRG_c12.mtb	3572	463	WWFF	food_fat	4	45928	1336776793	1	0.0800000000000001	0.00533333333333334	9811	1
4	Food 1	Intake 3	22	46428	1336777293	/users/cn/jespinosa/phecomp/data/CRG/20120502_FDF_CRG/20120502_FDF_CRG/20120511_FDF_CRG_c12.mtb	2961	688	WWFF	food_fat	3	46406	1336777271	1	0.0200000000000005	0.000909090909090932	9812	1
4	Food 1	Intake 3	56	47172	1336778037	/users/cn/jespinosa/phecomp/data/CRG/20120502_FDF_CRG/20120502_FDF_CRG/20120511_FDF_CRG_c12.mtb	2969	204	WWFF	food_fat	3	47116	1336777981	1	0.0200000000000005	0.000357142857142866	9813	1
4	Food 2	Intake 4	31	47407	1336778272	/users/cn/jespinosa/phecomp/data/CRG/20120502_FDF_CRG/20120502_FDF_CRG/20120511_FDF_CRG_c12.mtb	3575	COLL	WWFF	food_fat	4	47376	1336778241	1	0.0800000000000001	0.00258064516129033	9814	1
4	Food 1	Intake 3	12	47389	1336778254	/users/cn/jespinosa/phecomp/data/CRG/20120502_FDF_CRG/20120502_FDF_CRG/20120511_FDF_CRG_c12.mtb	2972	28	WWFF	food_fat	3	47377	1336778242	1	0.0200000000000005	0.00166666666666671	9815	1
4	Food 1	Intake 3	199	47616	1336778481	/users/cn/jespinosa/phecomp/data/CRG/20120502_FDF_CRG/20120502_FDF_CRG/20120511_FDF_CRG_c12.mtb	2973	COLL	WWFF	food_fat	3	47417	1336778282	1	0.279999999999999	0.00140703517587939	9816	1
4	Food 2	Intake 4	108	47617	1336778482	/users/cn/jespinosa/phecomp/data/CRG/20120502_FDF_CRG/20120502_FDF_CRG/20120511_FDF_CRG_c12.mtb	3577	62	WWFF	food_fat	4	47509	1336778374	1	0.0800000000000001	0.000740740740740742	9817	1
4	Food 1	Intake 3	61	47740	1336778605	/users/cn/jespinosa/phecomp/data/CRG/20120502_FDF_CRG/20120502_FDF_CRG/20120511_FDF_CRG_c12.mtb	2975	COLL	WWFF	food_fat	3	47679	1336778544	1	0.0800000000000001	0.00131147540983607	9818	1
4	Food 2	Intake 4	56	47737	1336778602	/users/cn/jespinosa/phecomp/data/CRG/20120502_FDF_CRG/20120502_FDF_CRG/20120511_FDF_CRG_c12.mtb	3579	12	WWFF	food_fat	4	47681	1336778546	1	0.2	0.00357142857142857	9819	1
4	Food 2	Intake 4	101	47850	1336778715	/users/cn/jespinosa/phecomp/data/CRG/20120502_FDF_CRG/20120502_FDF_CRG/20120511_FDF_CRG_c12.mtb	3580	50	WWFF	food_fat	4	47749	1336778614	1	0.22	0.00217821782178218	9820	1
4	Food 2	Intake 4	101	48001	1336778866	/users/cn/jespinosa/phecomp/data/CRG/20120502_FDF_CRG/20120502_FDF_CRG/20120511_FDF_CRG_c12.mtb	3581	141	WWFF	food_fat	4	47900	1336778765	1	0.36	0.00356435643564356	9821	1
4	Drink 2	Intake 2	27	48047	1336778912	/users/cn/jespinosa/phecomp/data/CRG/20120502_FDF_CRG/20120502_FDF_CRG/20120511_FDF_CRG_c12.mtb	1377	NA	WWFF	water	2	48020	1336778885	1	0.12	0.00444444444444444	9822	1
4	Food 2	Intake 4	70	48212	1336779077	/users/cn/jespinosa/phecomp/data/CRG/20120502_FDF_CRG/20120502_FDF_CRG/20120511_FDF_CRG_c12.mtb	3585	COLL	WWFF	food_fat	4	48142	1336779007	1	0.14	0.002	9823	1
4	Food 1	Intake 3	57	48213	1336779078	/users/cn/jespinosa/phecomp/data/CRG/20120502_FDF_CRG/20120502_FDF_CRG/20120511_FDF_CRG_c12.mtb	2980	25	WWFF	food_fat	3	48156	1336779021	1	0.199999999999999	0.00350877192982454	9824	1
4	Food 2	Intake 4	186	48424	1336779289	/users/cn/jespinosa/phecomp/data/CRG/20120502_FDF_CRG/20120502_FDF_CRG/20120511_FDF_CRG_c12.mtb	3586	COLL	WWFF	food_fat	4	48238	1336779103	1	0.2	0.0010752688172043	9825	1
4	Food 1	Intake 3	33	48314	1336779179	/users/cn/jespinosa/phecomp/data/CRG/20120502_FDF_CRG/20120502_FDF_CRG/20120511_FDF_CRG_c12.mtb	2982	19	WWFF	food_fat	3	48281	1336779146	1	0.0200000000000005	0.000606060606060621	9826	1
4	Food 1	Intake 3	44	48377	1336779242	/users/cn/jespinosa/phecomp/data/CRG/20120502_FDF_CRG/20120502_FDF_CRG/20120511_FDF_CRG_c12.mtb	2983	146	WWFF	food_fat	3	48333	1336779198	1	0.0399999999999991	0.000909090909090889	9827	1
4	Drink 2	Intake 2	73	48505	1336779370	/users/cn/jespinosa/phecomp/data/CRG/20120502_FDF_CRG/20120502_FDF_CRG/20120511_FDF_CRG_c12.mtb	1378	NA	WWFF	water	2	48432	1336779297	1	0.02	0.000273972602739726	9828	1
4	Food 1	Intake 3	12	48535	1336779400	/users/cn/jespinosa/phecomp/data/CRG/20120502_FDF_CRG/20120502_FDF_CRG/20120511_FDF_CRG_c12.mtb	2986	14	WWFF	food_fat	3	48523	1336779388	1	0.04	0.00333333333333333	9829	1
4	Food 2	Intake 4	12	48561	1336779426	/users/cn/jespinosa/phecomp/data/CRG/20120502_FDF_CRG/20120502_FDF_CRG/20120511_FDF_CRG_c12.mtb	3588	179	WWFF	food_fat	4	48549	1336779414	1	0.04	0.00333333333333333	9830	1
4	Food 1	Intake 3	114	48854	1336779719	/users/cn/jespinosa/phecomp/data/CRG/20120502_FDF_CRG/20120502_FDF_CRG/20120511_FDF_CRG_c12.mtb	2990	COLL	WWFF	food_fat	3	48740	1336779605	1	0.0800000000000001	0.000701754385964913	9831	1
4	Food 2	Intake 4	153	48897	1336779762	/users/cn/jespinosa/phecomp/data/CRG/20120502_FDF_CRG/20120502_FDF_CRG/20120511_FDF_CRG_c12.mtb	3592	COLL	WWFF	food_fat	4	48744	1336779609	1	0.44	0.00287581699346405	9832	1
4	Food 1	Intake 3	28	48895	1336779760	/users/cn/jespinosa/phecomp/data/CRG/20120502_FDF_CRG/20120502_FDF_CRG/20120511_FDF_CRG_c12.mtb	2991	124	WWFF	food_fat	3	48867	1336779732	1	0.0999999999999996	0.00357142857142856	9833	1
4	Food 1	Intake 3	13	49032	1336779897	/users/cn/jespinosa/phecomp/data/CRG/20120502_FDF_CRG/20120502_FDF_CRG/20120511_FDF_CRG_c12.mtb	2993	51	WWFF	food_fat	3	49019	1336779884	1	0.04	0.00307692307692308	9834	1
4	Food 1	Intake 3	215	49298	1336780163	/users/cn/jespinosa/phecomp/data/CRG/20120502_FDF_CRG/20120502_FDF_CRG/20120511_FDF_CRG_c12.mtb	2995	COLL	WWFF	food_fat	3	49083	1336779948	1	0.28	0.00130232558139535	9835	1
4	Food 2	Intake 4	186	49297	1336780162	/users/cn/jespinosa/phecomp/data/CRG/20120502_FDF_CRG/20120502_FDF_CRG/20120511_FDF_CRG_c12.mtb	3595	115	WWFF	food_fat	4	49111	1336779976	1	0.24	0.00129032258064516	9836	1
4	Food 2	Intake 4	18	49430	1336780295	/users/cn/jespinosa/phecomp/data/CRG/20120502_FDF_CRG/20120502_FDF_CRG/20120511_FDF_CRG_c12.mtb	3597	COLL	WWFF	food_fat	4	49412	1336780277	1	0.04	0.00222222222222222	9837	1
4	Food 1	Intake 3	177	49600	1336780465	/users/cn/jespinosa/phecomp/data/CRG/20120502_FDF_CRG/20120502_FDF_CRG/20120511_FDF_CRG_c12.mtb	2997	25	WWFF	food_fat	3	49423	1336780288	1	0.539999999999999	0.00305084745762711	9838	1
4	Food 1	Intake 3	69	49694	1336780559	/users/cn/jespinosa/phecomp/data/CRG/20120502_FDF_CRG/20120502_FDF_CRG/20120511_FDF_CRG_c12.mtb	2998	55	WWFF	food_fat	3	49625	1336780490	1	0.220000000000001	0.00318840579710146	9839	1
4	Food 1	Intake 3	16	49765	1336780630	/users/cn/jespinosa/phecomp/data/CRG/20120502_FDF_CRG/20120502_FDF_CRG/20120511_FDF_CRG_c12.mtb	2999	46	WWFF	food_fat	3	49749	1336780614	1	0.0400000000000009	0.00250000000000006	9840	1
4	Food 1	Intake 3	58	49869	1336780734	/users/cn/jespinosa/phecomp/data/CRG/20120502_FDF_CRG/20120502_FDF_CRG/20120511_FDF_CRG_c12.mtb	3001	20	WWFF	food_fat	3	49811	1336780676	1	0.159999999999998	0.00275862068965514	9841	1
4	Food 1	Intake 3	98	49987	1336780852	/users/cn/jespinosa/phecomp/data/CRG/20120502_FDF_CRG/20120502_FDF_CRG/20120511_FDF_CRG_c12.mtb	3002	COLL	WWFF	food_fat	3	49889	1336780754	1	0.0800000000000001	0.000816326530612246	9842	1
4	Food 2	Intake 4	47	49988	1336780853	/users/cn/jespinosa/phecomp/data/CRG/20120502_FDF_CRG/20120502_FDF_CRG/20120511_FDF_CRG_c12.mtb	3604	239	WWFF	food_fat	4	49941	1336780806	1	0.04	0.000851063829787234	9843	1
4	Food 1	Intake 3	428	50655	1336781520	/users/cn/jespinosa/phecomp/data/CRG/20120502_FDF_CRG/20120502_FDF_CRG/20120511_FDF_CRG_c12.mtb	3004	COLL	WWFF	food_fat	3	50227	1336781092	1	1.54	0.0035981308411215	9844	1
4	Food 2	Intake 4	12	50653	1336781518	/users/cn/jespinosa/phecomp/data/CRG/20120502_FDF_CRG/20120502_FDF_CRG/20120511_FDF_CRG_c12.mtb	3608	44	WWFF	food_fat	4	50641	1336781506	1	0.04	0.00333333333333333	9845	1
4	Food 1	Intake 3	637	51334	1336782199	/users/cn/jespinosa/phecomp/data/CRG/20120502_FDF_CRG/20120502_FDF_CRG/20120511_FDF_CRG_c12.mtb	3005	COLL	WWFF	food_fat	3	50697	1336781562	1	1.26	0.00197802197802198	9846	1
4	Food 2	Intake 4	15	50922	1336781787	/users/cn/jespinosa/phecomp/data/CRG/20120502_FDF_CRG/20120502_FDF_CRG/20120511_FDF_CRG_c12.mtb	3612	331	WWFF	food_fat	4	50907	1336781772	1	0.04	0.00266666666666667	9847	1
4	Drink 1	Intake 1	18	51144	1336782009	/users/cn/jespinosa/phecomp/data/CRG/20120502_FDF_CRG/20120502_FDF_CRG/20120511_FDF_CRG_c12.mtb	1493	NA	WWFF	water	1	51126	1336781991	1	0.0599999999999999	0.00333333333333333	9848	1
4	Food 2	Intake 4	17	51270	1336782135	/users/cn/jespinosa/phecomp/data/CRG/20120502_FDF_CRG/20120502_FDF_CRG/20120511_FDF_CRG_c12.mtb	3614	274	WWFF	food_fat	4	51253	1336782118	1	0.04	0.00235294117647059	9849	1
4	Food 1	Intake 3	123	51667	1336782532	/users/cn/jespinosa/phecomp/data/CRG/20120502_FDF_CRG/20120502_FDF_CRG/20120511_FDF_CRG_c12.mtb	3008	372	WWFF	food_fat	3	51544	1336782409	1	0.0400000000000009	0.000325203252032528	9850	1
4	Food 1	Intake 3	27	52066	1336782931	/users/cn/jespinosa/phecomp/data/CRG/20120502_FDF_CRG/20120502_FDF_CRG/20120511_FDF_CRG_c12.mtb	3014	152	WWFF	food_fat	3	52039	1336782904	1	0.0399999999999991	0.00148148148148145	9851	1
4	Food 1	Intake 3	45	52263	1336783128	/users/cn/jespinosa/phecomp/data/CRG/20120502_FDF_CRG/20120502_FDF_CRG/20120511_FDF_CRG_c12.mtb	3016	214	WWFF	food_fat	3	52218	1336783083	1	0.0600000000000005	0.00133333333333334	9852	1
4	Food 1	Intake 3	528	53005	1336783870	/users/cn/jespinosa/phecomp/data/CRG/20120502_FDF_CRG/20120502_FDF_CRG/20120511_FDF_CRG_c12.mtb	3019	COLL	WWFF	food_fat	3	52477	1336783342	1	1.1	0.00208333333333333	9853	1
4	Food 2	Intake 4	33	52597	1336783462	/users/cn/jespinosa/phecomp/data/CRG/20120502_FDF_CRG/20120502_FDF_CRG/20120511_FDF_CRG_c12.mtb	3617	141	WWFF	food_fat	4	52564	1336783429	1	0.0200000000000005	0.000606060606060621	9854	1
4	Drink 1	Intake 1	23	52613	1336783478	/users/cn/jespinosa/phecomp/data/CRG/20120502_FDF_CRG/20120502_FDF_CRG/20120511_FDF_CRG_c12.mtb	1495	NA	WWFF	water	1	52590	1336783455	1	0.0600000000000001	0.00260869565217392	9855	1
4	Food 2	Intake 4	23	52761	1336783626	/users/cn/jespinosa/phecomp/data/CRG/20120502_FDF_CRG/20120502_FDF_CRG/20120511_FDF_CRG_c12.mtb	3621	231	WWFF	food_fat	4	52738	1336783603	1	0.0200000000000005	0.000869565217391326	9856	1
4	Food 2	Intake 4	14	53006	1336783871	/users/cn/jespinosa/phecomp/data/CRG/20120502_FDF_CRG/20120502_FDF_CRG/20120511_FDF_CRG_c12.mtb	3625	1810	WWFF	food_fat	4	52992	1336783857	1	0.04	0.00285714285714286	9857	1
4	Food 1	Intake 3	21	54837	1336785702	/users/cn/jespinosa/phecomp/data/CRG/20120502_FDF_CRG/20120502_FDF_CRG/20120511_FDF_CRG_c12.mtb	3025	1011	WWFF	food_fat	3	54816	1336785681	1	0.0200000000000014	0.000952380952381019	9858	1
4	Food 1	Intake 3	260	56108	1336786973	/users/cn/jespinosa/phecomp/data/CRG/20120502_FDF_CRG/20120502_FDF_CRG/20120511_FDF_CRG_c12.mtb	3034	COLL	WWFF	food_fat	3	55848	1336786713	1	0.299999999999999	0.00115384615384615	9859	1
4	Food 2	Intake 4	136	55986	1336786851	/users/cn/jespinosa/phecomp/data/CRG/20120502_FDF_CRG/20120502_FDF_CRG/20120511_FDF_CRG_c12.mtb	3628	104	WWFF	food_fat	4	55850	1336786715	1	0.0800000000000001	0.000588235294117648	9860	1
4	Drink 1	Intake 1	16	55987	1336786852	/users/cn/jespinosa/phecomp/data/CRG/20120502_FDF_CRG/20120502_FDF_CRG/20120511_FDF_CRG_c12.mtb	1497	NA	WWFF	water	1	55971	1336786836	1	0.02	0.00125	9861	1
4	Drink 2	Intake 2	23	56009	1336786874	/users/cn/jespinosa/phecomp/data/CRG/20120502_FDF_CRG/20120502_FDF_CRG/20120511_FDF_CRG_c12.mtb	1383	NA	WWFF	water	2	55986	1336786851	1	0.02	0.000869565217391304	9862	1
4	Drink 1	Intake 1	27	56077	1336786942	/users/cn/jespinosa/phecomp/data/CRG/20120502_FDF_CRG/20120502_FDF_CRG/20120511_FDF_CRG_c12.mtb	1500	NA	WWFF	water	1	56050	1336786915	1	0.02	0.000740740740740741	9863	1
4	Food 2	Intake 4	17	56107	1336786972	/users/cn/jespinosa/phecomp/data/CRG/20120502_FDF_CRG/20120502_FDF_CRG/20120511_FDF_CRG_c12.mtb	3630	39	WWFF	food_fat	4	56090	1336786955	1	0.0800000000000001	0.00470588235294118	9864	1
4	Food 2	Intake 4	33	56179	1336787044	/users/cn/jespinosa/phecomp/data/CRG/20120502_FDF_CRG/20120502_FDF_CRG/20120511_FDF_CRG_c12.mtb	3631	9	WWFF	food_fat	4	56146	1336787011	1	0.0200000000000005	0.000606060606060621	9865	1
4	Food 2	Intake 4	83	56271	1336787136	/users/cn/jespinosa/phecomp/data/CRG/20120502_FDF_CRG/20120502_FDF_CRG/20120511_FDF_CRG_c12.mtb	3632	4	WWFF	food_fat	4	56188	1336787053	1	0.04	0.000481927710843374	9866	1
4	Food 2	Intake 4	96	56371	1336787236	/users/cn/jespinosa/phecomp/data/CRG/20120502_FDF_CRG/20120502_FDF_CRG/20120511_FDF_CRG_c12.mtb	3633	COLL	WWFF	food_fat	4	56275	1336787140	1	0.0599999999999996	0.000624999999999996	9867	1
4	Food 1	Intake 3	55	56397	1336787262	/users/cn/jespinosa/phecomp/data/CRG/20120502_FDF_CRG/20120502_FDF_CRG/20120511_FDF_CRG_c12.mtb	3037	34	WWFF	food_fat	3	56342	1336787207	1	0.199999999999999	0.00363636363636362	9868	1
4	Food 2	Intake 4	141	56572	1336787437	/users/cn/jespinosa/phecomp/data/CRG/20120502_FDF_CRG/20120502_FDF_CRG/20120511_FDF_CRG_c12.mtb	3634	COLL	WWFF	food_fat	4	56431	1336787296	1	0.16	0.00113475177304965	9869	1
4	Food 1	Intake 3	36	56576	1336787441	/users/cn/jespinosa/phecomp/data/CRG/20120502_FDF_CRG/20120502_FDF_CRG/20120511_FDF_CRG_c12.mtb	3039	6	WWFF	food_fat	3	56540	1336787405	1	0.0999999999999996	0.00277777777777777	9870	1
4	Food 1	Intake 3	25	56607	1336787472	/users/cn/jespinosa/phecomp/data/CRG/20120502_FDF_CRG/20120502_FDF_CRG/20120511_FDF_CRG_c12.mtb	3040	69	WWFF	food_fat	3	56582	1336787447	1	0.0600000000000005	0.00240000000000002	9871	1
4	Food 2	Intake 4	87	56763	1336787628	/users/cn/jespinosa/phecomp/data/CRG/20120502_FDF_CRG/20120502_FDF_CRG/20120511_FDF_CRG_c12.mtb	3636	COLL	WWFF	food_fat	4	56676	1336787541	1	0.0800000000000001	0.000919540229885059	9872	1
4	Food 1	Intake 3	13	56764	1336787629	/users/cn/jespinosa/phecomp/data/CRG/20120502_FDF_CRG/20120502_FDF_CRG/20120511_FDF_CRG_c12.mtb	3043	83	WWFF	food_fat	3	56751	1336787616	1	0.0599999999999987	0.00461538461538452	9873	1
4	Drink 1	Intake 1	23	56799	1336787664	/users/cn/jespinosa/phecomp/data/CRG/20120502_FDF_CRG/20120502_FDF_CRG/20120511_FDF_CRG_c12.mtb	1501	NA	WWFF	water	1	56776	1336787641	1	0.12	0.00521739130434783	9874	1
4	Food 1	Intake 3	136	56983	1336787848	/users/cn/jespinosa/phecomp/data/CRG/20120502_FDF_CRG/20120502_FDF_CRG/20120511_FDF_CRG_c12.mtb	3045	COLL	WWFF	food_fat	3	56847	1336787712	1	0.220000000000001	0.00161764705882354	9875	1
4	Food 2	Intake 4	55	56906	1336787771	/users/cn/jespinosa/phecomp/data/CRG/20120502_FDF_CRG/20120502_FDF_CRG/20120511_FDF_CRG_c12.mtb	3638	61	WWFF	food_fat	4	56851	1336787716	1	0.04	0.000727272727272727	9876	1
4	Food 2	Intake 4	12	56979	1336787844	/users/cn/jespinosa/phecomp/data/CRG/20120502_FDF_CRG/20120502_FDF_CRG/20120511_FDF_CRG_c12.mtb	3639	26	WWFF	food_fat	4	56967	1336787832	1	0.04	0.00333333333333333	9877	1
4	Food 2	Intake 4	73	57078	1336787943	/users/cn/jespinosa/phecomp/data/CRG/20120502_FDF_CRG/20120502_FDF_CRG/20120511_FDF_CRG_c12.mtb	3640	17	WWFF	food_fat	4	57005	1336787870	1	0.18	0.00246575342465753	9878	1
4	Food 1	Intake 3	13	57108	1336787973	/users/cn/jespinosa/phecomp/data/CRG/20120502_FDF_CRG/20120502_FDF_CRG/20120511_FDF_CRG_c12.mtb	3047	293	WWFF	food_fat	3	57095	1336787960	1	0.0800000000000001	0.00615384615384616	9879	1
4	Food 1	Intake 3	124	57525	1336788390	/users/cn/jespinosa/phecomp/data/CRG/20120502_FDF_CRG/20120502_FDF_CRG/20120511_FDF_CRG_c12.mtb	3050	1241	WWFF	food_fat	3	57401	1336788266	1	0.0400000000000009	0.000322580645161298	9880	1
4	Food 2	Intake 4	16	58782	1336789647	/users/cn/jespinosa/phecomp/data/CRG/20120502_FDF_CRG/20120502_FDF_CRG/20120511_FDF_CRG_c12.mtb	3643	1153	WWFF	food_fat	4	58766	1336789631	1	0.0200000000000005	0.00125000000000003	9881	1
4	Food 1	Intake 3	17	59952	1336790817	/users/cn/jespinosa/phecomp/data/CRG/20120502_FDF_CRG/20120502_FDF_CRG/20120511_FDF_CRG_c12.mtb	3062	1091	WWFF	food_fat	3	59935	1336790800	1	0.0200000000000014	0.00117647058823538	9882	1
4	Food 1	Intake 3	248	61291	1336792156	/users/cn/jespinosa/phecomp/data/CRG/20120502_FDF_CRG/20120502_FDF_CRG/20120511_FDF_CRG_c12.mtb	3074	COLL	WWFF	food_fat	3	61043	1336791908	1	0.24	0.000967741935483871	9883	1
4	Food 2	Intake 4	61	61110	1336791975	/users/cn/jespinosa/phecomp/data/CRG/20120502_FDF_CRG/20120502_FDF_CRG/20120511_FDF_CRG_c12.mtb	3646	74	WWFF	food_fat	4	61049	1336791914	1	0.0200000000000005	0.000327868852459025	9884	1
4	Food 2	Intake 4	106	61290	1336792155	/users/cn/jespinosa/phecomp/data/CRG/20120502_FDF_CRG/20120502_FDF_CRG/20120511_FDF_CRG_c12.mtb	3648	48	WWFF	food_fat	4	61184	1336792049	1	0.0999999999999996	0.000943396226415091	9885	1
4	Drink 2	Intake 2	36	61360	1336792225	/users/cn/jespinosa/phecomp/data/CRG/20120502_FDF_CRG/20120502_FDF_CRG/20120511_FDF_CRG_c12.mtb	1385	NA	WWFF	water	2	61324	1336792189	1	0.02	0.000555555555555556	9886	1
4	Food 2	Intake 4	32	61370	1336792235	/users/cn/jespinosa/phecomp/data/CRG/20120502_FDF_CRG/20120502_FDF_CRG/20120511_FDF_CRG_c12.mtb	3650	63	WWFF	food_fat	4	61338	1336792203	1	0.0600000000000005	0.00187500000000002	9887	1
4	Food 1	Intake 3	89	61522	1336792387	/users/cn/jespinosa/phecomp/data/CRG/20120502_FDF_CRG/20120502_FDF_CRG/20120511_FDF_CRG_c12.mtb	3077	COLL	WWFF	food_fat	3	61433	1336792298	1	0.18	0.00202247191011236	9888	1
4	Food 2	Intake 4	69	61504	1336792369	/users/cn/jespinosa/phecomp/data/CRG/20120502_FDF_CRG/20120502_FDF_CRG/20120511_FDF_CRG_c12.mtb	3651	752	WWFF	food_fat	4	61435	1336792300	1	0.0599999999999996	0.000869565217391299	9889	1
4	Drink 2	Intake 2	34	62118	1336792983	/users/cn/jespinosa/phecomp/data/CRG/20120502_FDF_CRG/20120502_FDF_CRG/20120511_FDF_CRG_c12.mtb	1386	NA	WWFF	water	2	62084	1336792949	1	0.14	0.00411764705882353	9890	1
4	Food 1	Intake 3	23	62279	1336793144	/users/cn/jespinosa/phecomp/data/CRG/20120502_FDF_CRG/20120502_FDF_CRG/20120511_FDF_CRG_c12.mtb	3087	312	WWFF	food_fat	3	62256	1336793121	1	0.0999999999999996	0.0043478260869565	9891	1
4	Food 1	Intake 3	110	62701	1336793566	/users/cn/jespinosa/phecomp/data/CRG/20120502_FDF_CRG/20120502_FDF_CRG/20120511_FDF_CRG_c12.mtb	3090	467	WWFF	food_fat	3	62591	1336793456	1	0.0200000000000014	0.000181818181818195	9892	1
4	Food 1	Intake 3	18	63186	1336794051	/users/cn/jespinosa/phecomp/data/CRG/20120502_FDF_CRG/20120502_FDF_CRG/20120511_FDF_CRG_c12.mtb	3097	648	WWFF	food_fat	3	63168	1336794033	1	0.0399999999999991	0.00222222222222217	9893	1
4	Food 1	Intake 3	15	63849	1336794714	/users/cn/jespinosa/phecomp/data/CRG/20120502_FDF_CRG/20120502_FDF_CRG/20120511_FDF_CRG_c12.mtb	3102	504	WWFF	food_fat	3	63834	1336794699	1	0.0200000000000014	0.00133333333333343	9894	1
4	Food 1	Intake 3	33	64386	1336795251	/users/cn/jespinosa/phecomp/data/CRG/20120502_FDF_CRG/20120502_FDF_CRG/20120511_FDF_CRG_c12.mtb	3105	COLL	WWFF	food_fat	3	64353	1336795218	1	0.0200000000000014	0.000606060606060648	9895	1
4	Food 2	Intake 4	22	64377	1336795242	/users/cn/jespinosa/phecomp/data/CRG/20120502_FDF_CRG/20120502_FDF_CRG/20120511_FDF_CRG_c12.mtb	3655	1617	WWFF	food_fat	4	64355	1336795220	1	0.0200000000000005	0.000909090909090932	9896	1
4	Food 1	Intake 3	16	66010	1336796875	/users/cn/jespinosa/phecomp/data/CRG/20120502_FDF_CRG/20120502_FDF_CRG/20120511_FDF_CRG_c12.mtb	3114	51	WWFF	food_fat	3	65994	1336796859	1	0.140000000000001	0.00875000000000006	9897	1
4	Food 1	Intake 3	80	66141	1336797006	/users/cn/jespinosa/phecomp/data/CRG/20120502_FDF_CRG/20120502_FDF_CRG/20120511_FDF_CRG_c12.mtb	3116	536	WWFF	food_fat	3	66061	1336796926	1	0.159999999999998	0.00199999999999997	9898	1
4	Food 1	Intake 3	33	66710	1336797575	/users/cn/jespinosa/phecomp/data/CRG/20120502_FDF_CRG/20120502_FDF_CRG/20120511_FDF_CRG_c12.mtb	3120	177	WWFF	food_fat	3	66677	1336797542	1	0.0200000000000014	0.000606060606060648	9899	1
4	Food 2	Intake 4	18	66905	1336797770	/users/cn/jespinosa/phecomp/data/CRG/20120502_FDF_CRG/20120502_FDF_CRG/20120511_FDF_CRG_c12.mtb	3665	1763	WWFF	food_fat	4	66887	1336797752	1	0.0200000000000005	0.00111111111111114	9900	1
4	Food 2	Intake 4	73	68741	1336799606	/users/cn/jespinosa/phecomp/data/CRG/20120502_FDF_CRG/20120502_FDF_CRG/20120511_FDF_CRG_c12.mtb	3669	107	WWFF	food_fat	4	68668	1336799533	1	0.0599999999999996	0.000821917808219173	9901	1
4	Food 2	Intake 4	123	68971	1336799836	/users/cn/jespinosa/phecomp/data/CRG/20120502_FDF_CRG/20120502_FDF_CRG/20120511_FDF_CRG_c12.mtb	3672	129	WWFF	food_fat	4	68848	1336799713	1	0.04	0.00032520325203252	9902	1
4	Food 1	Intake 3	284	69384	1336800249	/users/cn/jespinosa/phecomp/data/CRG/20120502_FDF_CRG/20120502_FDF_CRG/20120511_FDF_CRG_c12.mtb	3138	COLL	WWFF	food_fat	3	69100	1336799965	1	0.0999999999999996	0.000352112676056337	9903	1
4	Food 2	Intake 4	237	69378	1336800243	/users/cn/jespinosa/phecomp/data/CRG/20120502_FDF_CRG/20120502_FDF_CRG/20120511_FDF_CRG_c12.mtb	3674	130	WWFF	food_fat	4	69141	1336800006	1	0.4	0.00168776371308017	9904	1
4	Drink 1	Intake 1	31	69454	1336800319	/users/cn/jespinosa/phecomp/data/CRG/20120502_FDF_CRG/20120502_FDF_CRG/20120511_FDF_CRG_c12.mtb	1504	NA	WWFF	water	1	69423	1336800288	1	0.1	0.0032258064516129	9905	1
4	Food 1	Intake 3	343	69851	1336800716	/users/cn/jespinosa/phecomp/data/CRG/20120502_FDF_CRG/20120502_FDF_CRG/20120511_FDF_CRG_c12.mtb	3140	89	WWFF	food_fat	3	69508	1336800373	1	1.9	0.00553935860058309	9906	1
4	Food 1	Intake 3	199	70139	1336801004	/users/cn/jespinosa/phecomp/data/CRG/20120502_FDF_CRG/20120502_FDF_CRG/20120511_FDF_CRG_c12.mtb	3142	635	WWFF	food_fat	3	69940	1336800805	1	0.459999999999999	0.00231155778894472	9907	1
4	Drink 2	Intake 2	24	70698	1336801563	/users/cn/jespinosa/phecomp/data/CRG/20120502_FDF_CRG/20120502_FDF_CRG/20120511_FDF_CRG_c12.mtb	1389	NA	WWFF	water	2	70674	1336801539	1	0.0600000000000001	0.0025	9908	1
4	Food 1	Intake 3	29	70803	1336801668	/users/cn/jespinosa/phecomp/data/CRG/20120502_FDF_CRG/20120502_FDF_CRG/20120511_FDF_CRG_c12.mtb	3146	212	WWFF	food_fat	3	70774	1336801639	1	0.0200000000000014	0.000689655172413841	9909	1
4	Food 1	Intake 3	99	71114	1336801979	/users/cn/jespinosa/phecomp/data/CRG/20120502_FDF_CRG/20120502_FDF_CRG/20120511_FDF_CRG_c12.mtb	3148	COLL	WWFF	food_fat	3	71015	1336801880	1	0.220000000000001	0.00222222222222223	9910	1
4	Food 2	Intake 4	86	71113	1336801978	/users/cn/jespinosa/phecomp/data/CRG/20120502_FDF_CRG/20120502_FDF_CRG/20120511_FDF_CRG_c12.mtb	3685	8	WWFF	food_fat	4	71027	1336801892	1	0.04	0.000465116279069767	9911	1
4	Food 1	Intake 3	123	71244	1336802109	/users/cn/jespinosa/phecomp/data/CRG/20120502_FDF_CRG/20120502_FDF_CRG/20120511_FDF_CRG_c12.mtb	3149	COLL	WWFF	food_fat	3	71121	1336801986	1	0.0599999999999987	0.00048780487804877	9912	1
4	Food 2	Intake 4	18	71230	1336802095	/users/cn/jespinosa/phecomp/data/CRG/20120502_FDF_CRG/20120502_FDF_CRG/20120511_FDF_CRG_c12.mtb	3688	555	WWFF	food_fat	4	71212	1336802077	1	0.04	0.00222222222222222	9913	1
4	Food 2	Intake 4	116	71901	1336802766	/users/cn/jespinosa/phecomp/data/CRG/20120502_FDF_CRG/20120502_FDF_CRG/20120511_FDF_CRG_c12.mtb	3692	COLL	WWFF	food_fat	4	71785	1336802650	1	0.04	0.000344827586206897	9914	1
4	Food 1	Intake 3	102	71954	1336802819	/users/cn/jespinosa/phecomp/data/CRG/20120502_FDF_CRG/20120502_FDF_CRG/20120511_FDF_CRG_c12.mtb	3156	121	WWFF	food_fat	3	71852	1336802717	1	0.0800000000000001	0.000784313725490197	9915	1
4	Food 1	Intake 3	75	72150	1336803015	/users/cn/jespinosa/phecomp/data/CRG/20120502_FDF_CRG/20120502_FDF_CRG/20120511_FDF_CRG_c12.mtb	3159	363	WWFF	food_fat	3	72075	1336802940	1	0.159999999999998	0.00213333333333331	9916	1
4	Drink 1	Intake 1	20	72162	1336803027	/users/cn/jespinosa/phecomp/data/CRG/20120502_FDF_CRG/20120502_FDF_CRG/20120511_FDF_CRG_c12.mtb	1507	NA	WWFF	water	1	72142	1336803007	1	0.0600000000000001	0.00300000000000001	9917	1
4	Food 1	Intake 3	13	72526	1336803391	/users/cn/jespinosa/phecomp/data/CRG/20120502_FDF_CRG/20120502_FDF_CRG/20120511_FDF_CRG_c12.mtb	3161	1378	WWFF	food_fat	3	72513	1336803378	1	0.0200000000000014	0.00153846153846165	9918	1
4	Food 1	Intake 3	19	73923	1336804788	/users/cn/jespinosa/phecomp/data/CRG/20120502_FDF_CRG/20120502_FDF_CRG/20120511_FDF_CRG_c12.mtb	3165	1054	WWFF	food_fat	3	73904	1336804769	1	0.0400000000000009	0.00210526315789478	9919	1
4	Food 1	Intake 3	55	75032	1336805897	/users/cn/jespinosa/phecomp/data/CRG/20120502_FDF_CRG/20120502_FDF_CRG/20120511_FDF_CRG_c12.mtb	3170	923	WWFF	food_fat	3	74977	1336805842	1	0.220000000000001	0.00400000000000002	9920	1
4	Drink 1	Intake 1	23	75659	1336806524	/users/cn/jespinosa/phecomp/data/CRG/20120502_FDF_CRG/20120502_FDF_CRG/20120511_FDF_CRG_c12.mtb	1508	NA	WWFF	water	1	75636	1336806501	1	0.0600000000000001	0.00260869565217392	9921	1
4	Food 1	Intake 3	25	75980	1336806845	/users/cn/jespinosa/phecomp/data/CRG/20120502_FDF_CRG/20120502_FDF_CRG/20120511_FDF_CRG_c12.mtb	3175	COLL	WWFF	food_fat	3	75955	1336806820	1	0.299999999999999	0.012	9922	1
4	Food 2	Intake 4	13	75978	1336806843	/users/cn/jespinosa/phecomp/data/CRG/20120502_FDF_CRG/20120502_FDF_CRG/20120511_FDF_CRG_c12.mtb	3699	233	WWFF	food_fat	4	75965	1336806830	1	0.0600000000000005	0.00461538461538465	9923	1
4	Food 1	Intake 3	20	76231	1336807096	/users/cn/jespinosa/phecomp/data/CRG/20120502_FDF_CRG/20120502_FDF_CRG/20120511_FDF_CRG_c12.mtb	3176	440	WWFF	food_fat	3	76211	1336807076	1	0.0400000000000009	0.00200000000000005	9924	1
4	Food 1	Intake 3	26	76697	1336807562	/users/cn/jespinosa/phecomp/data/CRG/20120502_FDF_CRG/20120502_FDF_CRG/20120511_FDF_CRG_c12.mtb	3179	83	WWFF	food_fat	3	76671	1336807536	1	0.0399999999999991	0.0015384615384615	9925	1
4	Food 1	Intake 3	28	76808	1336807673	/users/cn/jespinosa/phecomp/data/CRG/20120502_FDF_CRG/20120502_FDF_CRG/20120511_FDF_CRG_c12.mtb	3180	243	WWFF	food_fat	3	76780	1336807645	1	0.0200000000000014	0.000714285714285764	9926	1
4	Food 1	Intake 3	19	77070	1336807935	/users/cn/jespinosa/phecomp/data/CRG/20120502_FDF_CRG/20120502_FDF_CRG/20120511_FDF_CRG_c12.mtb	3182	348	WWFF	food_fat	3	77051	1336807916	1	0.0399999999999991	0.00210526315789469	9927	1
4	Drink 2	Intake 2	26	77425	1336808290	/users/cn/jespinosa/phecomp/data/CRG/20120502_FDF_CRG/20120502_FDF_CRG/20120511_FDF_CRG_c12.mtb	1390	NA	WWFF	water	2	77399	1336808264	1	0.12	0.00461538461538461	9928	1
4	Food 1	Intake 3	17	77435	1336808300	/users/cn/jespinosa/phecomp/data/CRG/20120502_FDF_CRG/20120502_FDF_CRG/20120511_FDF_CRG_c12.mtb	3184	149	WWFF	food_fat	3	77418	1336808283	1	0.26	0.0152941176470588	9929	1
4	Food 1	Intake 3	26	77610	1336808475	/users/cn/jespinosa/phecomp/data/CRG/20120502_FDF_CRG/20120502_FDF_CRG/20120511_FDF_CRG_c12.mtb	3185	5132	WWFF	food_fat	3	77584	1336808449	1	0.0200000000000014	0.000769230769230823	9930	1
4	Drink 2	Intake 2	15	82266	1336813131	/users/cn/jespinosa/phecomp/data/CRG/20120502_FDF_CRG/20120502_FDF_CRG/20120511_FDF_CRG_c12.mtb	1391	NA	WWFF	water	2	82251	1336813116	1	0.04	0.00266666666666667	9931	1
4	Food 1	Intake 3	13	82755	1336813620	/users/cn/jespinosa/phecomp/data/CRG/20120502_FDF_CRG/20120502_FDF_CRG/20120511_FDF_CRG_c12.mtb	3205	853	WWFF	food_fat	3	82742	1336813607	1	0.0399999999999991	0.00307692307692301	9932	1
4	Food 1	Intake 3	39	83647	1336814512	/users/cn/jespinosa/phecomp/data/CRG/20120502_FDF_CRG/20120502_FDF_CRG/20120511_FDF_CRG_c12.mtb	3210	COLL	WWFF	food_fat	3	83608	1336814473	1	0.32	0.00820512820512821	9933	1
4	Food 2	Intake 4	13	83633	1336814498	/users/cn/jespinosa/phecomp/data/CRG/20120502_FDF_CRG/20120502_FDF_CRG/20120511_FDF_CRG_c12.mtb	3706	1120	WWFF	food_fat	4	83620	1336814485	1	0.0600000000000005	0.00461538461538465	9934	1
4	Food 1	Intake 3	17	84770	1336815635	/users/cn/jespinosa/phecomp/data/CRG/20120502_FDF_CRG/20120502_FDF_CRG/20120511_FDF_CRG_c12.mtb	3211	627	WWFF	food_fat	3	84753	1336815618	1	0.0200000000000014	0.00117647058823538	9935	1
4	Drink 1	Intake 1	26	84978	1336815843	/users/cn/jespinosa/phecomp/data/CRG/20120502_FDF_CRG/20120502_FDF_CRG/20120511_FDF_CRG_c12.mtb	1509	NA	WWFF	water	1	84952	1336815817	1	0.12	0.00461538461538461	9936	1
4	Food 1	Intake 3	34	85431	1336816296	/users/cn/jespinosa/phecomp/data/CRG/20120502_FDF_CRG/20120502_FDF_CRG/20120511_FDF_CRG_c12.mtb	3213	383	WWFF	food_fat	3	85397	1336816262	1	0.0399999999999991	0.00117647058823527	9937	1
4	Drink 2	Intake 2	13	85706	1336816571	/users/cn/jespinosa/phecomp/data/CRG/20120502_FDF_CRG/20120502_FDF_CRG/20120511_FDF_CRG_c12.mtb	1392	NA	WWFF	water	2	85693	1336816558	1	0.04	0.00307692307692308	9938	1
4	Food 1	Intake 3	28	85842	1336816707	/users/cn/jespinosa/phecomp/data/CRG/20120502_FDF_CRG/20120502_FDF_CRG/20120511_FDF_CRG_c12.mtb	3215	321	WWFF	food_fat	3	85814	1336816679	1	0.0200000000000014	0.000714285714285764	9939	1
4	Food 1	Intake 3	20	86183	1336817048	/users/cn/jespinosa/phecomp/data/CRG/20120502_FDF_CRG/20120502_FDF_CRG/20120511_FDF_CRG_c12.mtb	3218	62	WWFF	food_fat	3	86163	1336817028	1	0.0400000000000009	0.00200000000000005	9940	1
4	Food 1	Intake 3	13	86258	1336817123	/users/cn/jespinosa/phecomp/data/CRG/20120502_FDF_CRG/20120502_FDF_CRG/20120511_FDF_CRG_c12.mtb	3219	624	WWFF	food_fat	3	86245	1336817110	1	0.0600000000000005	0.00461538461538465	9941	1
4	Food 1	Intake 3	11	86893	1336817758	/users/cn/jespinosa/phecomp/data/CRG/20120502_FDF_CRG/20120502_FDF_CRG/20120511_FDF_CRG_c12.mtb	3224	1058	WWFF	food_fat	3	86882	1336817747	1	0.0399999999999991	0.00363636363636355	9942	1
4	Drink 1	Intake 1	27	87946	1336818811	/users/cn/jespinosa/phecomp/data/CRG/20120502_FDF_CRG/20120502_FDF_CRG/20120511_FDF_CRG_c12.mtb	1510	NA	WWFF	water	1	87919	1336818784	1	0.12	0.00444444444444444	9943	1
4	Food 1	Intake 3	24	87975	1336818840	/users/cn/jespinosa/phecomp/data/CRG/20120502_FDF_CRG/20120502_FDF_CRG/20120511_FDF_CRG_c12.mtb	3236	1290	WWFF	food_fat	3	87951	1336818816	1	0.0200000000000014	0.000833333333333392	9944	1
4	Food 2	Intake 4	16	89281	1336820146	/users/cn/jespinosa/phecomp/data/CRG/20120502_FDF_CRG/20120502_FDF_CRG/20120511_FDF_CRG_c12.mtb	3711	3521	WWFF	food_fat	4	89265	1336820130	1	0.12	0.0075	9945	1
4	Drink 1	Intake 1	20	91200	1336822065	/users/cn/jespinosa/phecomp/data/CRG/20120502_FDF_CRG/20120502_FDF_CRG/20120511_FDF_CRG_c12.mtb	1511	NA	WWFF	water	1	91180	1336822045	1	0.0599999999999998	0.00299999999999999	9946	1
4	Food 1	Intake 3	21	92823	1336823688	/users/cn/jespinosa/phecomp/data/CRG/20120502_FDF_CRG/20120502_FDF_CRG/20120511_FDF_CRG_c12.mtb	3250	COLL	WWFF	food_fat	3	92802	1336823667	1	0.42	0.02	9947	1
4	Food 2	Intake 4	18	92822	1336823687	/users/cn/jespinosa/phecomp/data/CRG/20120502_FDF_CRG/20120502_FDF_CRG/20120511_FDF_CRG_c12.mtb	3713	2522	WWFF	food_fat	4	92804	1336823669	1	0.0999999999999996	0.00555555555555553	9948	1
4	Drink 1	Intake 1	16	93985	1336824850	/users/cn/jespinosa/phecomp/data/CRG/20120502_FDF_CRG/20120502_FDF_CRG/20120511_FDF_CRG_c12.mtb	1512	NA	WWFF	water	1	93969	1336824834	1	0.04	0.0025	9949	1
4	Food 1	Intake 3	14	95358	1336826223	/users/cn/jespinosa/phecomp/data/CRG/20120502_FDF_CRG/20120502_FDF_CRG/20120511_FDF_CRG_c12.mtb	3260	3233	WWFF	food_fat	3	95344	1336826209	1	0.0399999999999991	0.00285714285714279	9950	1
4	Drink 1	Intake 1	28	95407	1336826272	/users/cn/jespinosa/phecomp/data/CRG/20120502_FDF_CRG/20120502_FDF_CRG/20120511_FDF_CRG_c12.mtb	1513	NA	WWFF	water	1	95379	1336826244	1	0.14	0.005	9951	1
4	Food 2	Intake 4	44	98635	1336829500	/users/cn/jespinosa/phecomp/data/CRG/20120502_FDF_CRG/20120502_FDF_CRG/20120511_FDF_CRG_c12.mtb	3715	226	WWFF	food_fat	4	98591	1336829456	1	0.0200000000000005	0.000454545454545466	9952	1
4	Food 2	Intake 4	13	98874	1336829739	/users/cn/jespinosa/phecomp/data/CRG/20120502_FDF_CRG/20120502_FDF_CRG/20120511_FDF_CRG_c12.mtb	3717	56	WWFF	food_fat	4	98861	1336829726	1	0.0600000000000005	0.00461538461538465	9953	1
4	Food 2	Intake 4	12	98942	1336829807	/users/cn/jespinosa/phecomp/data/CRG/20120502_FDF_CRG/20120502_FDF_CRG/20120511_FDF_CRG_c12.mtb	3719	14	WWFF	food_fat	4	98930	1336829795	1	0.04	0.00333333333333333	9954	1
4	Food 2	Intake 4	44	99000	1336829865	/users/cn/jespinosa/phecomp/data/CRG/20120502_FDF_CRG/20120502_FDF_CRG/20120511_FDF_CRG_c12.mtb	3720	365	WWFF	food_fat	4	98956	1336829821	1	0.0200000000000005	0.000454545454545466	9955	1
4	Food 1	Intake 3	25	99390	1336830255	/users/cn/jespinosa/phecomp/data/CRG/20120502_FDF_CRG/20120502_FDF_CRG/20120511_FDF_CRG_c12.mtb	3278	COLL	WWFF	food_fat	3	99365	1336830230	1	0.219999999999999	0.00879999999999996	9956	1
4	Food 2	Intake 4	23	99389	1336830254	/users/cn/jespinosa/phecomp/data/CRG/20120502_FDF_CRG/20120502_FDF_CRG/20120511_FDF_CRG_c12.mtb	3723	39	WWFF	food_fat	4	99366	1336830231	1	0.04	0.00173913043478261	9957	1
4	Food 2	Intake 4	19	99447	1336830312	/users/cn/jespinosa/phecomp/data/CRG/20120502_FDF_CRG/20120502_FDF_CRG/20120511_FDF_CRG_c12.mtb	3725	378	WWFF	food_fat	4	99428	1336830293	1	0.0200000000000005	0.00105263157894739	9958	1
4	Drink 1	Intake 1	18	99521	1336830386	/users/cn/jespinosa/phecomp/data/CRG/20120502_FDF_CRG/20120502_FDF_CRG/20120511_FDF_CRG_c12.mtb	1516	NA	WWFF	water	1	99503	1336830368	1	0.04	0.00222222222222222	9959	1
4	Drink 2	Intake 2	21	99534	1336830399	/users/cn/jespinosa/phecomp/data/CRG/20120502_FDF_CRG/20120502_FDF_CRG/20120511_FDF_CRG_c12.mtb	1395	NA	WWFF	water	2	99513	1336830378	1	0.04	0.0019047619047619	9960	1
4	Food 2	Intake 4	77	99902	1336830767	/users/cn/jespinosa/phecomp/data/CRG/20120502_FDF_CRG/20120502_FDF_CRG/20120511_FDF_CRG_c12.mtb	3731	44	WWFF	food_fat	4	99825	1336830690	1	0.04	0.000519480519480519	9961	1
4	Food 1	Intake 3	175	100121	1336830986	/users/cn/jespinosa/phecomp/data/CRG/20120502_FDF_CRG/20120502_FDF_CRG/20120511_FDF_CRG_c12.mtb	3282	COLL	WWFF	food_fat	3	99946	1336830811	1	0.140000000000001	0.000800000000000006	9962	1
4	Food 2	Intake 4	44	100123	1336830988	/users/cn/jespinosa/phecomp/data/CRG/20120502_FDF_CRG/20120502_FDF_CRG/20120511_FDF_CRG_c12.mtb	3734	80	WWFF	food_fat	4	100079	1336830944	1	0.0200000000000005	0.000454545454545466	9963	1
4	Food 1	Intake 3	31	100234	1336831099	/users/cn/jespinosa/phecomp/data/CRG/20120502_FDF_CRG/20120502_FDF_CRG/20120511_FDF_CRG_c12.mtb	3284	32	WWFF	food_fat	3	100203	1336831068	1	0.0399999999999991	0.00129032258064513	9964	1
4	Food 1	Intake 3	135	100401	1336831266	/users/cn/jespinosa/phecomp/data/CRG/20120502_FDF_CRG/20120502_FDF_CRG/20120511_FDF_CRG_c12.mtb	3285	COLL	WWFF	food_fat	3	100266	1336831131	1	0.139999999999999	0.00103703703703703	9965	1
4	Food 2	Intake 4	11	100278	1336831143	/users/cn/jespinosa/phecomp/data/CRG/20120502_FDF_CRG/20120502_FDF_CRG/20120511_FDF_CRG_c12.mtb	3737	799	WWFF	food_fat	4	100267	1336831132	1	0.04	0.00363636363636364	9966	1
4	Drink 1	Intake 1	17	100389	1336831254	/users/cn/jespinosa/phecomp/data/CRG/20120502_FDF_CRG/20120502_FDF_CRG/20120511_FDF_CRG_c12.mtb	1517	NA	WWFF	water	1	100372	1336831237	1	0.02	0.00117647058823529	9967	1
4	Food 1	Intake 3	67	101144	1336832009	/users/cn/jespinosa/phecomp/data/CRG/20120502_FDF_CRG/20120502_FDF_CRG/20120511_FDF_CRG_c12.mtb	3293	167	WWFF	food_fat	3	101077	1336831942	1	0.0200000000000031	0.000298507462686613	9968	1
4	Food 2	Intake 4	10	101321	1336832186	/users/cn/jespinosa/phecomp/data/CRG/20120502_FDF_CRG/20120502_FDF_CRG/20120511_FDF_CRG_c12.mtb	3742	308	WWFF	food_fat	4	101311	1336832176	1	0.04	0.004	9969	1
4	Food 1	Intake 3	20	101649	1336832514	/users/cn/jespinosa/phecomp/data/CRG/20120502_FDF_CRG/20120502_FDF_CRG/20120511_FDF_CRG_c12.mtb	3298	471	WWFF	food_fat	3	101629	1336832494	1	0.0800000000000001	0.00400000000000001	9970	1
4	Food 2	Intake 4	29	102149	1336833014	/users/cn/jespinosa/phecomp/data/CRG/20120502_FDF_CRG/20120502_FDF_CRG/20120511_FDF_CRG_c12.mtb	3745	1914	WWFF	food_fat	4	102120	1336832985	1	0.0200000000000005	0.00068965517241381	9971	1
4	Food 1	Intake 3	38	104101	1336834966	/users/cn/jespinosa/phecomp/data/CRG/20120502_FDF_CRG/20120502_FDF_CRG/20120511_FDF_CRG_c12.mtb	3315	1387	WWFF	food_fat	3	104063	1336834928	1	0.0600000000000005	0.00157894736842107	9972	1
4	Food 1	Intake 3	12	105500	1336836365	/users/cn/jespinosa/phecomp/data/CRG/20120502_FDF_CRG/20120502_FDF_CRG/20120511_FDF_CRG_c12.mtb	3318	36	WWFF	food_fat	3	105488	1336836353	1	0.0399999999999991	0.00333333333333326	9973	1
4	Food 1	Intake 3	80	105616	1336836481	/users/cn/jespinosa/phecomp/data/CRG/20120502_FDF_CRG/20120502_FDF_CRG/20120511_FDF_CRG_c12.mtb	3319	8871	WWFF	food_fat	3	105536	1336836401	1	0.0200000000000014	0.000250000000000017	9974	1
4	Drink 2	Intake 2	27	110411	1336841276	/users/cn/jespinosa/phecomp/data/CRG/20120502_FDF_CRG/20120502_FDF_CRG/20120511_FDF_CRG_c12.mtb	1398	NA	WWFF	water	2	110384	1336841249	1	0.0999999999999999	0.0037037037037037	9975	1
4	Drink 2	Intake 2	16	112044	1336842909	/users/cn/jespinosa/phecomp/data/CRG/20120502_FDF_CRG/20120502_FDF_CRG/20120511_FDF_CRG_c12.mtb	1399	NA	WWFF	water	2	112028	1336842893	1	0.04	0.0025	9976	1
4	Drink 2	Intake 2	21	113001	1336843866	/users/cn/jespinosa/phecomp/data/CRG/20120502_FDF_CRG/20120502_FDF_CRG/20120511_FDF_CRG_c12.mtb	1400	NA	WWFF	water	2	112980	1336843845	1	0.0800000000000001	0.00380952380952381	9977	1
4	Food 2	Intake 4	20	114507	1336845372	/users/cn/jespinosa/phecomp/data/CRG/20120502_FDF_CRG/20120502_FDF_CRG/20120511_FDF_CRG_c12.mtb	3758	1411	WWFF	food_fat	4	114487	1336845352	1	0.04	0.002	9978	1
4	Food 1	Intake 3	12	115930	1336846795	/users/cn/jespinosa/phecomp/data/CRG/20120502_FDF_CRG/20120502_FDF_CRG/20120511_FDF_CRG_c12.mtb	3327	282	WWFF	food_fat	3	115918	1336846783	1	0.0600000000000005	0.00500000000000004	9979	1
4	Food 1	Intake 3	12	116224	1336847089	/users/cn/jespinosa/phecomp/data/CRG/20120502_FDF_CRG/20120502_FDF_CRG/20120511_FDF_CRG_c12.mtb	3328	109	WWFF	food_fat	3	116212	1336847077	1	0.0399999999999991	0.00333333333333326	9980	1
4	Food 1	Intake 3	12	116345	1336847210	/users/cn/jespinosa/phecomp/data/CRG/20120502_FDF_CRG/20120502_FDF_CRG/20120511_FDF_CRG_c12.mtb	3329	153	WWFF	food_fat	3	116333	1336847198	1	0.0200000000000014	0.00166666666666678	9981	1
4	Food 2	Intake 4	34	116532	1336847397	/users/cn/jespinosa/phecomp/data/CRG/20120502_FDF_CRG/20120502_FDF_CRG/20120511_FDF_CRG_c12.mtb	3760	904	WWFF	food_fat	4	116498	1336847363	1	0.0200000000000005	0.000588235294117662	9982	1
4	Drink 2	Intake 2	38	116856	1336847721	/users/cn/jespinosa/phecomp/data/CRG/20120502_FDF_CRG/20120502_FDF_CRG/20120511_FDF_CRG_c12.mtb	1404	NA	WWFF	water	2	116818	1336847683	1	0.04	0.00105263157894737	9983	1
4	Food 1	Intake 3	20	117456	1336848321	/users/cn/jespinosa/phecomp/data/CRG/20120502_FDF_CRG/20120502_FDF_CRG/20120511_FDF_CRG_c12.mtb	3335	326	WWFF	food_fat	3	117436	1336848301	1	0.0400000000000009	0.00200000000000005	9984	1
4	Food 1	Intake 3	23	117805	1336848670	/users/cn/jespinosa/phecomp/data/CRG/20120502_FDF_CRG/20120502_FDF_CRG/20120511_FDF_CRG_c12.mtb	3338	112	WWFF	food_fat	3	117782	1336848647	1	0.100000000000001	0.00434782608695657	9985	1
4	Food 1	Intake 3	33	117950	1336848815	/users/cn/jespinosa/phecomp/data/CRG/20120502_FDF_CRG/20120502_FDF_CRG/20120511_FDF_CRG_c12.mtb	3340	95	WWFF	food_fat	3	117917	1336848782	1	0.0800000000000001	0.00242424242424243	9986	1
4	Food 2	Intake 4	29	118074	1336848939	/users/cn/jespinosa/phecomp/data/CRG/20120502_FDF_CRG/20120502_FDF_CRG/20120511_FDF_CRG_c12.mtb	3769	144	WWFF	food_fat	4	118045	1336848910	1	0.0200000000000005	0.00068965517241381	9987	1
4	Food 1	Intake 3	41	118259	1336849124	/users/cn/jespinosa/phecomp/data/CRG/20120502_FDF_CRG/20120502_FDF_CRG/20120511_FDF_CRG_c12.mtb	3345	374	WWFF	food_fat	3	118218	1336849083	1	0.140000000000001	0.00341463414634149	9988	1
4	Food 1	Intake 3	57	118690	1336849555	/users/cn/jespinosa/phecomp/data/CRG/20120502_FDF_CRG/20120502_FDF_CRG/20120511_FDF_CRG_c12.mtb	3349	230	WWFF	food_fat	3	118633	1336849498	1	0.0999999999999996	0.00175438596491227	9989	1
4	Food 1	Intake 3	103	119023	1336849888	/users/cn/jespinosa/phecomp/data/CRG/20120502_FDF_CRG/20120502_FDF_CRG/20120511_FDF_CRG_c12.mtb	3352	367	WWFF	food_fat	3	118920	1336849785	1	0.16	0.00155339805825243	9990	1
4	Food 2	Intake 4	32	119422	1336850287	/users/cn/jespinosa/phecomp/data/CRG/20120502_FDF_CRG/20120502_FDF_CRG/20120511_FDF_CRG_c12.mtb	3776	89	WWFF	food_fat	4	119390	1336850255	1	0.0200000000000005	0.000625000000000016	9991	1
4	Food 1	Intake 3	43	119554	1336850419	/users/cn/jespinosa/phecomp/data/CRG/20120502_FDF_CRG/20120502_FDF_CRG/20120511_FDF_CRG_c12.mtb	3357	COLL	WWFF	food_fat	3	119511	1336850376	1	0.0800000000000001	0.00186046511627907	9992	1
4	Food 2	Intake 4	38	119553	1336850418	/users/cn/jespinosa/phecomp/data/CRG/20120502_FDF_CRG/20120502_FDF_CRG/20120511_FDF_CRG_c12.mtb	3778	129	WWFF	food_fat	4	119515	1336850380	1	0.04	0.00105263157894737	9993	1
4	Food 2	Intake 4	42	119724	1336850589	/users/cn/jespinosa/phecomp/data/CRG/20120502_FDF_CRG/20120502_FDF_CRG/20120511_FDF_CRG_c12.mtb	3780	61	WWFF	food_fat	4	119682	1336850547	1	0.04	0.000952380952380952	9994	1
4	Food 1	Intake 3	110	119895	1336850760	/users/cn/jespinosa/phecomp/data/CRG/20120502_FDF_CRG/20120502_FDF_CRG/20120511_FDF_CRG_c12.mtb	3359	COLL	WWFF	food_fat	3	119785	1336850650	1	0.0400000000000009	0.000363636363636372	9995	1
4	Food 2	Intake 4	74	119892	1336850757	/users/cn/jespinosa/phecomp/data/CRG/20120502_FDF_CRG/20120502_FDF_CRG/20120511_FDF_CRG_c12.mtb	3782	209	WWFF	food_fat	4	119818	1336850683	1	0.04	0.000540540540540541	9996	1
4	Food 2	Intake 4	107	120208	1336851073	/users/cn/jespinosa/phecomp/data/CRG/20120502_FDF_CRG/20120502_FDF_CRG/20120511_FDF_CRG_c12.mtb	3785	55	WWFF	food_fat	4	120101	1336850966	1	0.16	0.00149532710280374	9997	1
4	Food 2	Intake 4	75	120338	1336851203	/users/cn/jespinosa/phecomp/data/CRG/20120502_FDF_CRG/20120502_FDF_CRG/20120511_FDF_CRG_c12.mtb	3786	227	WWFF	food_fat	4	120263	1336851128	1	0.0600000000000005	0.000800000000000007	9998	1
4	Drink 2	Intake 2	23	120414	1336851279	/users/cn/jespinosa/phecomp/data/CRG/20120502_FDF_CRG/20120502_FDF_CRG/20120511_FDF_CRG_c12.mtb	1410	NA	WWFF	water	2	120391	1336851256	1	0.04	0.00173913043478261	9999	1
4	Food 1	Intake 3	91	120656	1336851521	/users/cn/jespinosa/phecomp/data/CRG/20120502_FDF_CRG/20120502_FDF_CRG/20120511_FDF_CRG_c12.mtb	3364	559	WWFF	food_fat	3	120565	1336851430	1	0.0600000000000005	0.000659340659340665	10000	1
4	Food 1	Intake 3	171	121386	1336852251	/users/cn/jespinosa/phecomp/data/CRG/20120502_FDF_CRG/20120502_FDF_CRG/20120511_FDF_CRG_c12.mtb	3369	104	WWFF	food_fat	3	121215	1336852080	1	0.0999999999999996	0.000584795321637425	10001	1
4	Drink 2	Intake 2	84	121432	1336852297	/users/cn/jespinosa/phecomp/data/CRG/20120502_FDF_CRG/20120502_FDF_CRG/20120511_FDF_CRG_c12.mtb	1411	NA	WWFF	water	2	121348	1336852213	1	0.04	0.000476190476190476	10002	1
4	Food 2	Intake 4	45	121535	1336852400	/users/cn/jespinosa/phecomp/data/CRG/20120502_FDF_CRG/20120502_FDF_CRG/20120511_FDF_CRG_c12.mtb	3792	10	WWFF	food_fat	4	121490	1336852355	1	0.04	0.000888888888888889	10003	1
4	Food 2	Intake 4	57	121602	1336852467	/users/cn/jespinosa/phecomp/data/CRG/20120502_FDF_CRG/20120502_FDF_CRG/20120511_FDF_CRG_c12.mtb	3793	63	WWFF	food_fat	4	121545	1336852410	1	0.0200000000000005	0.000350877192982465	10004	1
4	Drink 2	Intake 2	20	121677	1336852542	/users/cn/jespinosa/phecomp/data/CRG/20120502_FDF_CRG/20120502_FDF_CRG/20120511_FDF_CRG_c12.mtb	1413	NA	WWFF	water	2	121657	1336852522	1	0.0399999999999998	0.00199999999999999	10005	1
4	Food 1	Intake 3	15	121680	1336852545	/users/cn/jespinosa/phecomp/data/CRG/20120502_FDF_CRG/20120502_FDF_CRG/20120511_FDF_CRG_c12.mtb	3373	305	WWFF	food_fat	3	121665	1336852530	1	0.0999999999999996	0.00666666666666664	10006	1
4	Food 1	Intake 3	197	122182	1336853047	/users/cn/jespinosa/phecomp/data/CRG/20120502_FDF_CRG/20120502_FDF_CRG/20120511_FDF_CRG_c12.mtb	3375	614	WWFF	food_fat	3	121985	1336852850	1	0.0800000000000001	0.000406091370558376	10007	1
4	Food 1	Intake 3	115	122911	1336853776	/users/cn/jespinosa/phecomp/data/CRG/20120502_FDF_CRG/20120502_FDF_CRG/20120511_FDF_CRG_c12.mtb	3385	119	WWFF	food_fat	3	122796	1336853661	1	0.0999999999999996	0.000869565217391301	10008	1
4	Food 1	Intake 3	192	123222	1336854087	/users/cn/jespinosa/phecomp/data/CRG/20120502_FDF_CRG/20120502_FDF_CRG/20120511_FDF_CRG_c12.mtb	3387	COLL	WWFF	food_fat	3	123030	1336853895	1	0.0800000000000001	0.000416666666666667	10009	1
4	Food 2	Intake 4	37	123090	1336853955	/users/cn/jespinosa/phecomp/data/CRG/20120502_FDF_CRG/20120502_FDF_CRG/20120511_FDF_CRG_c12.mtb	3801	30	WWFF	food_fat	4	123053	1336853918	1	0.0599999999999996	0.00162162162162161	10010	1
4	Food 2	Intake 4	22	123142	1336854007	/users/cn/jespinosa/phecomp/data/CRG/20120502_FDF_CRG/20120502_FDF_CRG/20120511_FDF_CRG_c12.mtb	3802	41	WWFF	food_fat	4	123120	1336853985	1	0.04	0.00181818181818182	10011	1
4	Food 2	Intake 4	47	123230	1336854095	/users/cn/jespinosa/phecomp/data/CRG/20120502_FDF_CRG/20120502_FDF_CRG/20120511_FDF_CRG_c12.mtb	3803	25	WWFF	food_fat	4	123183	1336854048	1	0.04	0.000851063829787234	10012	1
4	Food 1	Intake 3	191	123446	1336854311	/users/cn/jespinosa/phecomp/data/CRG/20120502_FDF_CRG/20120502_FDF_CRG/20120511_FDF_CRG_c12.mtb	3388	COLL	WWFF	food_fat	3	123255	1336854120	1	0.139999999999999	0.000732984293193712	10013	1
4	Food 2	Intake 4	92	123444	1336854309	/users/cn/jespinosa/phecomp/data/CRG/20120502_FDF_CRG/20120502_FDF_CRG/20120511_FDF_CRG_c12.mtb	3805	20	WWFF	food_fat	4	123352	1336854217	1	0.12	0.00130434782608696	10014	1
4	Food 1	Intake 3	125	123589	1336854454	/users/cn/jespinosa/phecomp/data/CRG/20120502_FDF_CRG/20120502_FDF_CRG/20120511_FDF_CRG_c12.mtb	3389	COLL	WWFF	food_fat	3	123464	1336854329	1	0.0399999999999991	0.000319999999999993	10015	1
4	Drink 2	Intake 2	39	123505	1336854370	/users/cn/jespinosa/phecomp/data/CRG/20120502_FDF_CRG/20120502_FDF_CRG/20120511_FDF_CRG_c12.mtb	1416	NA	WWFF	water	2	123466	1336854331	1	0.0600000000000001	0.00153846153846154	10016	1
4	Food 2	Intake 4	89	123586	1336854451	/users/cn/jespinosa/phecomp/data/CRG/20120502_FDF_CRG/20120502_FDF_CRG/20120511_FDF_CRG_c12.mtb	3807	30	WWFF	food_fat	4	123497	1336854362	1	0.0800000000000001	0.000898876404494383	10017	1
4	Food 1	Intake 3	172	123788	1336854653	/users/cn/jespinosa/phecomp/data/CRG/20120502_FDF_CRG/20120502_FDF_CRG/20120511_FDF_CRG_c12.mtb	3390	COLL	WWFF	food_fat	3	123616	1336854481	1	0.0400000000000027	0.000232558139534899	10018	1
4	Food 2	Intake 4	112	123784	1336854649	/users/cn/jespinosa/phecomp/data/CRG/20120502_FDF_CRG/20120502_FDF_CRG/20120511_FDF_CRG_c12.mtb	3808	97	WWFF	food_fat	4	123672	1336854537	1	0.0800000000000001	0.000714285714285715	10019	1
4	Drink 2	Intake 2	27	123859	1336854724	/users/cn/jespinosa/phecomp/data/CRG/20120502_FDF_CRG/20120502_FDF_CRG/20120511_FDF_CRG_c12.mtb	1417	NA	WWFF	water	2	123832	1336854697	1	0.0799999999999998	0.00296296296296296	10020	1
4	Food 2	Intake 4	33	123914	1336854779	/users/cn/jespinosa/phecomp/data/CRG/20120502_FDF_CRG/20120502_FDF_CRG/20120511_FDF_CRG_c12.mtb	3810	106	WWFF	food_fat	4	123881	1336854746	1	0.0600000000000005	0.00181818181818183	10021	1
4	Drink 2	Intake 2	16	124024	1336854889	/users/cn/jespinosa/phecomp/data/CRG/20120502_FDF_CRG/20120502_FDF_CRG/20120511_FDF_CRG_c12.mtb	1418	NA	WWFF	water	2	124008	1336854873	1	0.02	0.00125	10022	1
4	Food 2	Intake 4	27	124047	1336854912	/users/cn/jespinosa/phecomp/data/CRG/20120502_FDF_CRG/20120502_FDF_CRG/20120511_FDF_CRG_c12.mtb	3814	42	WWFF	food_fat	4	124020	1336854885	1	0.0200000000000005	0.000740740740740759	10023	1
4	Food 1	Intake 3	160	124249	1336855114	/users/cn/jespinosa/phecomp/data/CRG/20120502_FDF_CRG/20120502_FDF_CRG/20120511_FDF_CRG_c12.mtb	3392	COLL	WWFF	food_fat	3	124089	1336854954	1	0.18	0.001125	10024	1
4	Food 2	Intake 4	93	124246	1336855111	/users/cn/jespinosa/phecomp/data/CRG/20120502_FDF_CRG/20120502_FDF_CRG/20120511_FDF_CRG_c12.mtb	3815	337	WWFF	food_fat	4	124153	1336855018	1	0.04	0.00043010752688172	10025	1
4	Food 1	Intake 3	10	124593	1336855458	/users/cn/jespinosa/phecomp/data/CRG/20120502_FDF_CRG/20120502_FDF_CRG/20120511_FDF_CRG_c12.mtb	3396	72	WWFF	food_fat	3	124583	1336855448	1	0.0400000000000009	0.00400000000000009	10026	1
4	Food 2	Intake 4	72	124737	1336855602	/users/cn/jespinosa/phecomp/data/CRG/20120502_FDF_CRG/20120502_FDF_CRG/20120511_FDF_CRG_c12.mtb	3820	21	WWFF	food_fat	4	124665	1336855530	1	0.0200000000000005	0.000277777777777785	10027	1
4	Food 1	Intake 3	86	124844	1336855709	/users/cn/jespinosa/phecomp/data/CRG/20120502_FDF_CRG/20120502_FDF_CRG/20120511_FDF_CRG_c12.mtb	3398	134	WWFF	food_fat	3	124758	1336855623	1	0.26	0.00302325581395349	10028	1
4	Drink 1	Intake 1	24	124857	1336855722	/users/cn/jespinosa/phecomp/data/CRG/20120502_FDF_CRG/20120502_FDF_CRG/20120511_FDF_CRG_c12.mtb	1524	NA	WWFF	water	1	124833	1336855698	1	0.02	0.000833333333333333	10029	1
4	Food 2	Intake 4	43	125021	1336855886	/users/cn/jespinosa/phecomp/data/CRG/20120502_FDF_CRG/20120502_FDF_CRG/20120511_FDF_CRG_c12.mtb	3824	426	WWFF	food_fat	4	124978	1336855843	1	0.04	0.000930232558139535	10030	1
4	Food 2	Intake 4	78	125525	1336856390	/users/cn/jespinosa/phecomp/data/CRG/20120502_FDF_CRG/20120502_FDF_CRG/20120511_FDF_CRG_c12.mtb	3828	219	WWFF	food_fat	4	125447	1336856312	1	0.0200000000000005	0.000256410256410263	10031	1
4	Drink 1	Intake 1	17	125483	1336856348	/users/cn/jespinosa/phecomp/data/CRG/20120502_FDF_CRG/20120502_FDF_CRG/20120511_FDF_CRG_c12.mtb	1525	NA	WWFF	water	1	125466	1336856331	1	0.02	0.00117647058823529	10032	1
4	Food 1	Intake 3	17	125761	1336856626	/users/cn/jespinosa/phecomp/data/CRG/20120502_FDF_CRG/20120502_FDF_CRG/20120511_FDF_CRG_c12.mtb	3406	COLL	WWFF	food_fat	3	125744	1336856609	1	0.26	0.0152941176470588	10033	1
4	Food 2	Intake 4	12	125758	1336856623	/users/cn/jespinosa/phecomp/data/CRG/20120502_FDF_CRG/20120502_FDF_CRG/20120511_FDF_CRG_c12.mtb	3831	3721	WWFF	food_fat	4	125746	1336856611	1	0.04	0.00333333333333333	10034	1
4	Drink 2	Intake 2	17	127536	1336858401	/users/cn/jespinosa/phecomp/data/CRG/20120502_FDF_CRG/20120502_FDF_CRG/20120511_FDF_CRG_c12.mtb	1421	NA	WWFF	water	2	127519	1336858384	1	0.04	0.00235294117647059	10035	1
4	Food 1	Intake 3	44	129523	1336860388	/users/cn/jespinosa/phecomp/data/CRG/20120502_FDF_CRG/20120502_FDF_CRG/20120511_FDF_CRG_c12.mtb	3430	159	WWFF	food_fat	3	129479	1336860344	1	0.0399999999999991	0.000909090909090889	10036	1
4	Food 2	Intake 4	54	129736	1336860601	/users/cn/jespinosa/phecomp/data/CRG/20120502_FDF_CRG/20120502_FDF_CRG/20120511_FDF_CRG_c12.mtb	3834	335	WWFF	food_fat	4	129682	1336860547	1	0.0200000000000005	0.00037037037037038	10037	1
4	Food 1	Intake 3	110	130181	1336861046	/users/cn/jespinosa/phecomp/data/CRG/20120502_FDF_CRG/20120502_FDF_CRG/20120511_FDF_CRG_c12.mtb	3432	COLL	WWFF	food_fat	3	130071	1336860936	1	0.0200000000000031	0.00018181818181821	10038	1
4	Food 2	Intake 4	13	130178	1336861043	/users/cn/jespinosa/phecomp/data/CRG/20120502_FDF_CRG/20120502_FDF_CRG/20120511_FDF_CRG_c12.mtb	3836	1096	WWFF	food_fat	4	130165	1336861030	1	0.0599999999999996	0.00461538461538458	10039	1
4	Food 2	Intake 4	14	131288	1336862153	/users/cn/jespinosa/phecomp/data/CRG/20120502_FDF_CRG/20120502_FDF_CRG/20120511_FDF_CRG_c12.mtb	3839	348	WWFF	food_fat	4	131274	1336862139	1	0.0599999999999996	0.00428571428571426	10040	1
4	Food 2	Intake 4	99	131735	1336862600	/users/cn/jespinosa/phecomp/data/CRG/20120502_FDF_CRG/20120502_FDF_CRG/20120511_FDF_CRG_c12.mtb	3840	174	WWFF	food_fat	4	131636	1336862501	1	0.0400000000000009	0.000404040404040413	10041	1
4	Food 1	Intake 3	163	132072	1336862937	/users/cn/jespinosa/phecomp/data/CRG/20120502_FDF_CRG/20120502_FDF_CRG/20120511_FDF_CRG_c12.mtb	3448	30	WWFF	food_fat	3	131909	1336862774	1	0.279999999999999	0.00171779141104294	10042	1
4	Food 1	Intake 3	315	132417	1336863282	/users/cn/jespinosa/phecomp/data/CRG/20120502_FDF_CRG/20120502_FDF_CRG/20120511_FDF_CRG_c12.mtb	3449	COLL	WWFF	food_fat	3	132102	1336862967	1	0.199999999999999	0.000634920634920632	10043	1
4	Food 2	Intake 4	152	132330	1336863195	/users/cn/jespinosa/phecomp/data/CRG/20120502_FDF_CRG/20120502_FDF_CRG/20120511_FDF_CRG_c12.mtb	3845	65	WWFF	food_fat	4	132178	1336863043	1	0.0999999999999996	0.000657894736842103	10044	1
4	Food 2	Intake 4	16	132411	1336863276	/users/cn/jespinosa/phecomp/data/CRG/20120502_FDF_CRG/20120502_FDF_CRG/20120511_FDF_CRG_c12.mtb	3846	134	WWFF	food_fat	4	132395	1336863260	1	0.0400000000000009	0.00250000000000006	10045	1
4	Food 2	Intake 4	83	132628	1336863493	/users/cn/jespinosa/phecomp/data/CRG/20120502_FDF_CRG/20120502_FDF_CRG/20120511_FDF_CRG_c12.mtb	3848	49	WWFF	food_fat	4	132545	1336863410	1	0.0400000000000009	0.000481927710843384	10046	1
4	Food 1	Intake 3	126	132803	1336863668	/users/cn/jespinosa/phecomp/data/CRG/20120502_FDF_CRG/20120502_FDF_CRG/20120511_FDF_CRG_c12.mtb	3451	362	WWFF	food_fat	3	132677	1336863542	1	0.18	0.00142857142857143	10047	1
4	Drink 2	Intake 2	17	132704	1336863569	/users/cn/jespinosa/phecomp/data/CRG/20120502_FDF_CRG/20120502_FDF_CRG/20120511_FDF_CRG_c12.mtb	1422	NA	WWFF	water	2	132687	1336863552	1	0.02	0.00117647058823529	10048	1
4	Drink 1	Intake 1	24	132816	1336863681	/users/cn/jespinosa/phecomp/data/CRG/20120502_FDF_CRG/20120502_FDF_CRG/20120511_FDF_CRG_c12.mtb	1528	NA	WWFF	water	1	132792	1336863657	1	0.0999999999999999	0.00416666666666666	10049	1
4	Drink 1	Intake 1	70	133030	1336863895	/users/cn/jespinosa/phecomp/data/CRG/20120502_FDF_CRG/20120502_FDF_CRG/20120511_FDF_CRG_c12.mtb	1529	NA	WWFF	water	1	132960	1336863825	1	0.02	0.000285714285714286	10050	1
4	Food 1	Intake 3	157	133322	1336864187	/users/cn/jespinosa/phecomp/data/CRG/20120502_FDF_CRG/20120502_FDF_CRG/20120511_FDF_CRG_c12.mtb	3453	215	WWFF	food_fat	3	133165	1336864030	1	0.120000000000001	0.000764331210191089	10051	1
4	Food 1	Intake 3	295	133832	1336864697	/users/cn/jespinosa/phecomp/data/CRG/20120502_FDF_CRG/20120502_FDF_CRG/20120511_FDF_CRG_c12.mtb	3457	1055	WWFF	food_fat	3	133537	1336864402	1	0.220000000000002	0.000745762711864414	10052	1
4	Food 1	Intake 3	232	135119	1336865984	/users/cn/jespinosa/phecomp/data/CRG/20120502_FDF_CRG/20120502_FDF_CRG/20120511_FDF_CRG_c12.mtb	3465	COLL	WWFF	food_fat	3	134887	1336865752	1	0.259999999999998	0.00112068965517241	10053	1
4	Food 2	Intake 4	67	134994	1336865859	/users/cn/jespinosa/phecomp/data/CRG/20120502_FDF_CRG/20120502_FDF_CRG/20120511_FDF_CRG_c12.mtb	3865	525	WWFF	food_fat	4	134927	1336865792	1	0.0200000000000014	0.000298507462686588	10054	1
4	Drink 2	Intake 2	23	135249	1336866114	/users/cn/jespinosa/phecomp/data/CRG/20120502_FDF_CRG/20120502_FDF_CRG/20120511_FDF_CRG_c12.mtb	1427	NA	WWFF	water	2	135226	1336866091	1	0.04	0.00173913043478261	10055	1
4	Food 1	Intake 3	282	135801	1336866666	/users/cn/jespinosa/phecomp/data/CRG/20120502_FDF_CRG/20120502_FDF_CRG/20120511_FDF_CRG_c12.mtb	3469	730	WWFF	food_fat	3	135519	1336866384	1	0.0400000000000027	0.000141843971631215	10056	1
4	Drink 1	Intake 1	17	136211	1336867076	/users/cn/jespinosa/phecomp/data/CRG/20120502_FDF_CRG/20120502_FDF_CRG/20120511_FDF_CRG_c12.mtb	1532	NA	WWFF	water	1	136194	1336867059	1	0.02	0.00117647058823529	10057	1
4	Drink 2	Intake 2	16	136225	1336867090	/users/cn/jespinosa/phecomp/data/CRG/20120502_FDF_CRG/20120502_FDF_CRG/20120511_FDF_CRG_c12.mtb	1430	NA	WWFF	water	2	136209	1336867074	1	0.02	0.00125	10058	1
4	Food 2	Intake 4	78	136609	1336867474	/users/cn/jespinosa/phecomp/data/CRG/20120502_FDF_CRG/20120502_FDF_CRG/20120511_FDF_CRG_c12.mtb	3879	2657	WWFF	food_fat	4	136531	1336867396	1	0.0400000000000009	0.000512820512820524	10059	1
4	Drink 2	Intake 2	30	138325	1336869190	/users/cn/jespinosa/phecomp/data/CRG/20120502_FDF_CRG/20120502_FDF_CRG/20120511_FDF_CRG_c12.mtb	1431	NA	WWFF	water	2	138295	1336869160	1	0.04	0.00133333333333333	10060	1
4	Food 2	Intake 4	14	139280	1336870145	/users/cn/jespinosa/phecomp/data/CRG/20120502_FDF_CRG/20120502_FDF_CRG/20120511_FDF_CRG_c12.mtb	3882	2047	WWFF	food_fat	4	139266	1336870131	1	0.0600000000000005	0.00428571428571432	10061	1
4	Food 2	Intake 4	10	141337	1336872202	/users/cn/jespinosa/phecomp/data/CRG/20120502_FDF_CRG/20120502_FDF_CRG/20120511_FDF_CRG_c12.mtb	3887	946	WWFF	food_fat	4	141327	1336872192	1	0.0200000000000014	0.00200000000000014	10062	1
4	Drink 2	Intake 2	23	141936	1336872801	/users/cn/jespinosa/phecomp/data/CRG/20120502_FDF_CRG/20120502_FDF_CRG/20120511_FDF_CRG_c12.mtb	1434	NA	WWFF	water	2	141913	1336872778	1	0.02	0.000869565217391304	10063	1
4	Food 1	Intake 3	212	142495	1336873360	/users/cn/jespinosa/phecomp/data/CRG/20120502_FDF_CRG/20120502_FDF_CRG/20120511_FDF_CRG_c12.mtb	3508	436	WWFF	food_fat	3	142283	1336873148	1	0.34	0.00160377358490566	10064	1
4	Drink 2	Intake 2	42	142346	1336873211	/users/cn/jespinosa/phecomp/data/CRG/20120502_FDF_CRG/20120502_FDF_CRG/20120511_FDF_CRG_c12.mtb	1435	NA	WWFF	water	2	142304	1336873169	1	0.02	0.000476190476190476	10065	1
4	Drink 1	Intake 1	28	142362	1336873227	/users/cn/jespinosa/phecomp/data/CRG/20120502_FDF_CRG/20120502_FDF_CRG/20120511_FDF_CRG_c12.mtb	1538	NA	WWFF	water	1	142334	1336873199	1	0.04	0.00142857142857143	10066	1
4	Food 1	Intake 3	207	143138	1336874003	/users/cn/jespinosa/phecomp/data/CRG/20120502_FDF_CRG/20120502_FDF_CRG/20120511_FDF_CRG_c12.mtb	3514	9	WWFF	food_fat	3	142931	1336873796	1	0.0800000000000018	0.0003864734299517	10067	1
4	Food 1	Intake 3	34	143181	1336874046	/users/cn/jespinosa/phecomp/data/CRG/20120502_FDF_CRG/20120502_FDF_CRG/20120511_FDF_CRG_c12.mtb	3515	8	WWFF	food_fat	3	143147	1336874012	1	0.0799999999999983	0.00235294117647054	10068	1
4	Drink 2	Intake 2	31	143181	1336874046	/users/cn/jespinosa/phecomp/data/CRG/20120502_FDF_CRG/20120502_FDF_CRG/20120511_FDF_CRG_c12.mtb	1436	NA	WWFF	water	2	143150	1336874015	1	0.0600000000000001	0.00193548387096775	10069	1
4	Food 1	Intake 3	216	143405	1336874270	/users/cn/jespinosa/phecomp/data/CRG/20120502_FDF_CRG/20120502_FDF_CRG/20120511_FDF_CRG_c12.mtb	3516	1221	WWFF	food_fat	3	143189	1336874054	1	0.0399999999999991	0.000185185185185181	10070	1
4	Food 1	Intake 3	20	144646	1336875511	/users/cn/jespinosa/phecomp/data/CRG/20120502_FDF_CRG/20120502_FDF_CRG/20120511_FDF_CRG_c12.mtb	3528	594	WWFF	food_fat	3	144626	1336875491	1	0.0200000000000031	0.00100000000000015	10071	1
4	Food 2	Intake 4	23	145263	1336876128	/users/cn/jespinosa/phecomp/data/CRG/20120502_FDF_CRG/20120502_FDF_CRG/20120511_FDF_CRG_c12.mtb	3908	2040	WWFF	food_fat	4	145240	1336876105	1	0.0399999999999991	0.00173913043478257	10072	1
4	Food 2	Intake 4	28	147331	1336878196	/users/cn/jespinosa/phecomp/data/CRG/20120502_FDF_CRG/20120502_FDF_CRG/20120511_FDF_CRG_c12.mtb	3911	1255	WWFF	food_fat	4	147303	1336878168	1	0.0200000000000014	0.000714285714285764	10073	1
4	Drink 2	Intake 2	14	147325	1336878190	/users/cn/jespinosa/phecomp/data/CRG/20120502_FDF_CRG/20120502_FDF_CRG/20120511_FDF_CRG_c12.mtb	1437	NA	WWFF	water	2	147311	1336878176	1	0.0600000000000001	0.00428571428571429	10074	1
4	Food 1	Intake 3	81	148667	1336879532	/users/cn/jespinosa/phecomp/data/CRG/20120502_FDF_CRG/20120502_FDF_CRG/20120511_FDF_CRG_c12.mtb	3555	COLL	WWFF	food_fat	3	148586	1336879451	1	0.0200000000000031	0.000246913580246952	10075	1
4	Food 2	Intake 4	13	148638	1336879503	/users/cn/jespinosa/phecomp/data/CRG/20120502_FDF_CRG/20120502_FDF_CRG/20120511_FDF_CRG_c12.mtb	3917	1231	WWFF	food_fat	4	148625	1336879490	1	0.119999999999999	0.00923076923076915	10076	1
4	Drink 2	Intake 2	15	149231	1336880096	/users/cn/jespinosa/phecomp/data/CRG/20120502_FDF_CRG/20120502_FDF_CRG/20120511_FDF_CRG_c12.mtb	1438	NA	WWFF	water	2	149216	1336880081	1	0.02	0.00133333333333333	10077	1
4	Food 2	Intake 4	13	149882	1336880747	/users/cn/jespinosa/phecomp/data/CRG/20120502_FDF_CRG/20120502_FDF_CRG/20120511_FDF_CRG_c12.mtb	3922	COLL	WWFF	food_fat	4	149869	1336880734	1	0.0800000000000001	0.00615384615384616	10078	1
4	Food 1	Intake 3	13	149883	1336880748	/users/cn/jespinosa/phecomp/data/CRG/20120502_FDF_CRG/20120502_FDF_CRG/20120511_FDF_CRG_c12.mtb	3562	663	WWFF	food_fat	3	149870	1336880735	1	0.52	0.04	10079	1
4	Food 2	Intake 4	21	150567	1336881432	/users/cn/jespinosa/phecomp/data/CRG/20120502_FDF_CRG/20120502_FDF_CRG/20120511_FDF_CRG_c12.mtb	3924	96	WWFF	food_fat	4	150546	1336881411	1	0.0200000000000014	0.000952380952381019	10080	1
4	Food 2	Intake 4	14	150677	1336881542	/users/cn/jespinosa/phecomp/data/CRG/20120502_FDF_CRG/20120502_FDF_CRG/20120511_FDF_CRG_c12.mtb	3926	179	WWFF	food_fat	4	150663	1336881528	1	0.0600000000000005	0.00428571428571432	10081	1
4	Food 2	Intake 4	14	150870	1336881735	/users/cn/jespinosa/phecomp/data/CRG/20120502_FDF_CRG/20120502_FDF_CRG/20120511_FDF_CRG_c12.mtb	3929	377	WWFF	food_fat	4	150856	1336881721	1	0.0800000000000001	0.00571428571428572	10082	1
4	Food 1	Intake 3	208	151455	1336882320	/users/cn/jespinosa/phecomp/data/CRG/20120502_FDF_CRG/20120502_FDF_CRG/20120511_FDF_CRG_c12.mtb	3572	94	WWFF	food_fat	3	151247	1336882112	1	0.260000000000002	0.00125000000000001	10083	1
4	Food 1	Intake 3	9	151558	1336882423	/users/cn/jespinosa/phecomp/data/CRG/20120502_FDF_CRG/20120502_FDF_CRG/20120511_FDF_CRG_c12.mtb	3574	31	WWFF	food_fat	3	151549	1336882414	1	0.0399999999999991	0.00444444444444434	10084	1
4	Food 1	Intake 3	553	152142	1336883007	/users/cn/jespinosa/phecomp/data/CRG/20120502_FDF_CRG/20120502_FDF_CRG/20120511_FDF_CRG_c12.mtb	3575	479	WWFF	food_fat	3	151589	1336882454	1	0.240000000000002	0.000433996383363476	10085	1
4	Drink 2	Intake 2	16	151788	1336882653	/users/cn/jespinosa/phecomp/data/CRG/20120502_FDF_CRG/20120502_FDF_CRG/20120511_FDF_CRG_c12.mtb	1440	NA	WWFF	water	2	151772	1336882637	1	0.04	0.0025	10086	1
4	Drink 2	Intake 2	33	151833	1336882698	/users/cn/jespinosa/phecomp/data/CRG/20120502_FDF_CRG/20120502_FDF_CRG/20120511_FDF_CRG_c12.mtb	1441	NA	WWFF	water	2	151800	1336882665	1	0.04	0.00121212121212121	10087	1
4	Drink 2	Intake 2	17	152317	1336883182	/users/cn/jespinosa/phecomp/data/CRG/20120502_FDF_CRG/20120502_FDF_CRG/20120511_FDF_CRG_c12.mtb	1442	NA	WWFF	water	2	152300	1336883165	1	0.0399999999999996	0.00235294117647056	10088	1
4	Food 2	Intake 4	10	152631	1336883496	/users/cn/jespinosa/phecomp/data/CRG/20120502_FDF_CRG/20120502_FDF_CRG/20120511_FDF_CRG_c12.mtb	3942	717	WWFF	food_fat	4	152621	1336883486	1	0.0200000000000014	0.00200000000000014	10089	1
4	Food 1	Intake 3	29	153377	1336884242	/users/cn/jespinosa/phecomp/data/CRG/20120502_FDF_CRG/20120502_FDF_CRG/20120511_FDF_CRG_c12.mtb	3581	2145	WWFF	food_fat	3	153348	1336884213	1	0.200000000000003	0.00689655172413804	10090	1
4	Food 1	Intake 3	92	155614	1336886479	/users/cn/jespinosa/phecomp/data/CRG/20120502_FDF_CRG/20120502_FDF_CRG/20120511_FDF_CRG_c12.mtb	3595	360	WWFF	food_fat	3	155522	1336886387	1	0.240000000000002	0.00260869565217393	10091	1
4	Drink 1	Intake 1	14	155763	1336886628	/users/cn/jespinosa/phecomp/data/CRG/20120502_FDF_CRG/20120502_FDF_CRG/20120511_FDF_CRG_c12.mtb	1543	NA	WWFF	water	1	155749	1336886614	1	0.02	0.00142857142857143	10092	1
4	Food 2	Intake 4	119	156093	1336886958	/users/cn/jespinosa/phecomp/data/CRG/20120502_FDF_CRG/20120502_FDF_CRG/20120511_FDF_CRG_c12.mtb	3960	COLL	WWFF	food_fat	4	155974	1336886839	1	0.0600000000000005	0.000504201680672273	10093	1
4	Food 1	Intake 3	31	156095	1336886960	/users/cn/jespinosa/phecomp/data/CRG/20120502_FDF_CRG/20120502_FDF_CRG/20120511_FDF_CRG_c12.mtb	3601	42	WWFF	food_fat	3	156064	1336886929	1	0.100000000000001	0.00322580645161294	10094	1
4	Drink 2	Intake 2	33	156142	1336887007	/users/cn/jespinosa/phecomp/data/CRG/20120502_FDF_CRG/20120502_FDF_CRG/20120511_FDF_CRG_c12.mtb	1445	NA	WWFF	water	2	156109	1336886974	1	0.0800000000000001	0.00242424242424243	10095	1
4	Food 2	Intake 4	75	156212	1336887077	/users/cn/jespinosa/phecomp/data/CRG/20120502_FDF_CRG/20120502_FDF_CRG/20120511_FDF_CRG_c12.mtb	3961	114	WWFF	food_fat	4	156137	1336887002	1	0.0399999999999991	0.000533333333333321	10096	1
4	Food 1	Intake 3	17	156343	1336887208	/users/cn/jespinosa/phecomp/data/CRG/20120502_FDF_CRG/20120502_FDF_CRG/20120511_FDF_CRG_c12.mtb	3604	143	WWFF	food_fat	3	156326	1336887191	1	0.0600000000000023	0.00352941176470602	10097	1
4	Food 1	Intake 3	13	156499	1336887364	/users/cn/jespinosa/phecomp/data/CRG/20120502_FDF_CRG/20120502_FDF_CRG/20120511_FDF_CRG_c12.mtb	3606	386	WWFF	food_fat	3	156486	1336887351	1	0.0999999999999979	0.00769230769230753	10098	1
4	Drink 2	Intake 2	45	156608	1336887473	/users/cn/jespinosa/phecomp/data/CRG/20120502_FDF_CRG/20120502_FDF_CRG/20120511_FDF_CRG_c12.mtb	1446	NA	WWFF	water	2	156563	1336887428	1	0.0600000000000001	0.00133333333333334	10099	1
4	Food 1	Intake 3	104	156989	1336887854	/users/cn/jespinosa/phecomp/data/CRG/20120502_FDF_CRG/20120502_FDF_CRG/20120511_FDF_CRG_c12.mtb	3610	271	WWFF	food_fat	3	156885	1336887750	1	0.0599999999999987	0.000576923076923064	10100	1
4	Drink 1	Intake 1	18	157033	1336887898	/users/cn/jespinosa/phecomp/data/CRG/20120502_FDF_CRG/20120502_FDF_CRG/20120511_FDF_CRG_c12.mtb	1544	NA	WWFF	water	1	157015	1336887880	1	0.02	0.00111111111111111	10101	1
4	Food 1	Intake 3	38	157298	1336888163	/users/cn/jespinosa/phecomp/data/CRG/20120502_FDF_CRG/20120502_FDF_CRG/20120511_FDF_CRG_c12.mtb	3613	14	WWFF	food_fat	3	157260	1336888125	1	0.0799999999999983	0.00210526315789469	10102	1
4	Food 1	Intake 3	93	157405	1336888270	/users/cn/jespinosa/phecomp/data/CRG/20120502_FDF_CRG/20120502_FDF_CRG/20120511_FDF_CRG_c12.mtb	3614	85	WWFF	food_fat	3	157312	1336888177	1	0.140000000000001	0.00150537634408603	10103	1
4	Food 2	Intake 4	48	157538	1336888403	/users/cn/jespinosa/phecomp/data/CRG/20120502_FDF_CRG/20120502_FDF_CRG/20120511_FDF_CRG_c12.mtb	3977	855	WWFF	food_fat	4	157490	1336888355	1	0.0399999999999991	0.000833333333333315	10104	1
4	Drink 1	Intake 1	17	158288	1336889153	/users/cn/jespinosa/phecomp/data/CRG/20120502_FDF_CRG/20120502_FDF_CRG/20120511_FDF_CRG_c12.mtb	1546	NA	WWFF	water	1	158271	1336889136	1	0.02	0.00117647058823529	10105	1
4	Drink 1	Intake 1	25	158346	1336889211	/users/cn/jespinosa/phecomp/data/CRG/20120502_FDF_CRG/20120502_FDF_CRG/20120511_FDF_CRG_c12.mtb	1547	NA	WWFF	water	1	158321	1336889186	1	0.02	0.0008	10106	1
4	Drink 2	Intake 2	47	158385	1336889250	/users/cn/jespinosa/phecomp/data/CRG/20120502_FDF_CRG/20120502_FDF_CRG/20120511_FDF_CRG_c12.mtb	1450	NA	WWFF	water	2	158338	1336889203	1	0.02	0.000425531914893617	10107	1
4	Food 2	Intake 4	14	158407	1336889272	/users/cn/jespinosa/phecomp/data/CRG/20120502_FDF_CRG/20120502_FDF_CRG/20120511_FDF_CRG_c12.mtb	3983	24	WWFF	food_fat	4	158393	1336889258	1	0.0399999999999991	0.00285714285714279	10108	1
4	Food 1	Intake 3	67	158498	1336889363	/users/cn/jespinosa/phecomp/data/CRG/20120502_FDF_CRG/20120502_FDF_CRG/20120511_FDF_CRG_c12.mtb	3623	91	WWFF	food_fat	3	158431	1336889296	1	0.0200000000000031	0.000298507462686613	10109	1
4	Food 2	Intake 4	14	158603	1336889468	/users/cn/jespinosa/phecomp/data/CRG/20120502_FDF_CRG/20120502_FDF_CRG/20120511_FDF_CRG_c12.mtb	3985	1725	WWFF	food_fat	4	158589	1336889454	1	0.0400000000000009	0.00285714285714292	10110	1
4	Food 1	Intake 3	20	160348	1336891213	/users/cn/jespinosa/phecomp/data/CRG/20120502_FDF_CRG/20120502_FDF_CRG/20120511_FDF_CRG_c12.mtb	3629	3863	WWFF	food_fat	3	160328	1336891193	1	0.0200000000000031	0.00100000000000015	10111	1
4	Drink 1	Intake 1	14	161925	1336892790	/users/cn/jespinosa/phecomp/data/CRG/20120502_FDF_CRG/20120502_FDF_CRG/20120511_FDF_CRG_c12.mtb	1549	NA	WWFF	water	1	161911	1336892776	1	0.04	0.00285714285714286	10112	1
4	Drink 1	Intake 1	12	163503	1336894368	/users/cn/jespinosa/phecomp/data/CRG/20120502_FDF_CRG/20120502_FDF_CRG/20120511_FDF_CRG_c12.mtb	1550	NA	WWFF	water	1	163491	1336894356	1	0.04	0.00333333333333333	10113	1
4	Food 2	Intake 4	14	164225	1336895090	/users/cn/jespinosa/phecomp/data/CRG/20120502_FDF_CRG/20120502_FDF_CRG/20120511_FDF_CRG_c12.mtb	3992	5337	WWFF	food_fat	4	164211	1336895076	1	0.0399999999999991	0.00285714285714279	10114	1
4	Drink 1	Intake 1	23	165257	1336896122	/users/cn/jespinosa/phecomp/data/CRG/20120502_FDF_CRG/20120502_FDF_CRG/20120511_FDF_CRG_c12.mtb	1552	NA	WWFF	water	1	165234	1336896099	1	0.12	0.00521739130434783	10115	1
4	Drink 2	Intake 2	23	169567	1336900432	/users/cn/jespinosa/phecomp/data/CRG/20120502_FDF_CRG/20120502_FDF_CRG/20120511_FDF_CRG_c12.mtb	1451	NA	WWFF	water	2	169544	1336900409	1	0.12	0.00521739130434783	10116	1
4	Food 1	Intake 3	26	169588	1336900453	/users/cn/jespinosa/phecomp/data/CRG/20120502_FDF_CRG/20120502_FDF_CRG/20120511_FDF_CRG_c12.mtb	3649	1889	WWFF	food_fat	3	169562	1336900427	1	0.120000000000001	0.00461538461538465	10117	1
4	Food 2	Intake 4	18	171495	1336902360	/users/cn/jespinosa/phecomp/data/CRG/20120502_FDF_CRG/20120502_FDF_CRG/20120511_FDF_CRG_c12.mtb	3995	2315	WWFF	food_fat	4	171477	1336902342	1	0.0200000000000014	0.00111111111111119	10118	1
4	Drink 1	Intake 1	28	173737	1336904602	/users/cn/jespinosa/phecomp/data/CRG/20120502_FDF_CRG/20120502_FDF_CRG/20120511_FDF_CRG_c12.mtb	1553	NA	WWFF	water	1	173709	1336904574	1	0.1	0.00357142857142857	10119	1
4	Food 2	Intake 4	13	173823	1336904688	/users/cn/jespinosa/phecomp/data/CRG/20120502_FDF_CRG/20120502_FDF_CRG/20120511_FDF_CRG_c12.mtb	3997	741	WWFF	food_fat	4	173810	1336904675	1	0.0599999999999987	0.00461538461538452	10120	1
4	Food 2	Intake 4	12	174576	1336905441	/users/cn/jespinosa/phecomp/data/CRG/20120502_FDF_CRG/20120502_FDF_CRG/20120511_FDF_CRG_c12.mtb	4002	121	WWFF	food_fat	4	174564	1336905429	1	0.0200000000000014	0.00166666666666678	10121	1
4	Food 1	Intake 3	306	175003	1336905868	/users/cn/jespinosa/phecomp/data/CRG/20120502_FDF_CRG/20120502_FDF_CRG/20120511_FDF_CRG_c12.mtb	3663	263	WWFF	food_fat	3	174697	1336905562	1	0.199999999999999	0.000653594771241827	10122	1
4	Food 1	Intake 3	49	175315	1336906180	/users/cn/jespinosa/phecomp/data/CRG/20120502_FDF_CRG/20120502_FDF_CRG/20120511_FDF_CRG_c12.mtb	3666	607	WWFF	food_fat	3	175266	1336906131	1	0.0200000000000031	0.000408163265306186	10123	1
4	Food 1	Intake 3	512	176434	1336907299	/users/cn/jespinosa/phecomp/data/CRG/20120502_FDF_CRG/20120502_FDF_CRG/20120511_FDF_CRG_c12.mtb	3670	COLL	WWFF	food_fat	3	175922	1336906787	1	0.120000000000001	0.000234375000000002	10124	1
4	Food 2	Intake 4	20	176010	1336906875	/users/cn/jespinosa/phecomp/data/CRG/20120502_FDF_CRG/20120502_FDF_CRG/20120511_FDF_CRG_c12.mtb	4008	3920	WWFF	food_fat	4	175990	1336906855	1	0.0200000000000014	0.00100000000000007	10125	1
4	Food 1	Intake 3	13	179943	1336910808	/users/cn/jespinosa/phecomp/data/CRG/20120502_FDF_CRG/20120502_FDF_CRG/20120511_FDF_CRG_c12.mtb	3676	8950	WWFF	food_fat	3	179930	1336910795	1	0.0400000000000027	0.00307692307692328	10126	1
4	Drink 1	Intake 1	21	180423	1336911288	/users/cn/jespinosa/phecomp/data/CRG/20120502_FDF_CRG/20120502_FDF_CRG/20120511_FDF_CRG_c12.mtb	1554	NA	WWFF	water	1	180402	1336911267	1	0.0999999999999996	0.00476190476190474	10127	1
4	Drink 1	Intake 1	24	181502	1336912367	/users/cn/jespinosa/phecomp/data/CRG/20120502_FDF_CRG/20120502_FDF_CRG/20120511_FDF_CRG_c12.mtb	1555	NA	WWFF	water	1	181478	1336912343	1	0.14	0.00583333333333333	10128	1
4	Drink 1	Intake 1	31	183844	1336914709	/users/cn/jespinosa/phecomp/data/CRG/20120502_FDF_CRG/20120502_FDF_CRG/20120511_FDF_CRG_c12.mtb	1556	NA	WWFF	water	1	183813	1336914678	1	0.0800000000000001	0.00258064516129033	10129	1
4	Drink 2	Intake 2	25	188715	1336919580	/users/cn/jespinosa/phecomp/data/CRG/20120502_FDF_CRG/20120502_FDF_CRG/20120511_FDF_CRG_c12.mtb	1452	NA	WWFF	water	2	188690	1336919555	1	0.0800000000000001	0.0032	10130	1
4	Food 2	Intake 4	14	188907	1336919772	/users/cn/jespinosa/phecomp/data/CRG/20120502_FDF_CRG/20120502_FDF_CRG/20120511_FDF_CRG_c12.mtb	4014	48	WWFF	food_fat	4	188893	1336919758	1	0.0600000000000005	0.00428571428571432	10131	1
4	Food 2	Intake 4	16	188971	1336919836	/users/cn/jespinosa/phecomp/data/CRG/20120502_FDF_CRG/20120502_FDF_CRG/20120511_FDF_CRG_c12.mtb	4015	131	WWFF	food_fat	4	188955	1336919820	1	0.0600000000000005	0.00375000000000003	10132	1
4	Food 1	Intake 3	72	189174	1336920039	/users/cn/jespinosa/phecomp/data/CRG/20120502_FDF_CRG/20120502_FDF_CRG/20120511_FDF_CRG_c12.mtb	3705	COLL	WWFF	food_fat	3	189102	1336919967	1	0.459999999999997	0.00638888888888885	10133	1
4	Food 2	Intake 4	13	189153	1336920018	/users/cn/jespinosa/phecomp/data/CRG/20120502_FDF_CRG/20120502_FDF_CRG/20120511_FDF_CRG_c12.mtb	4017	67	WWFF	food_fat	4	189140	1336920005	1	0.0399999999999991	0.00307692307692301	10134	1
4	Food 2	Intake 4	13	189233	1336920098	/users/cn/jespinosa/phecomp/data/CRG/20120502_FDF_CRG/20120502_FDF_CRG/20120511_FDF_CRG_c12.mtb	4018	54	WWFF	food_fat	4	189220	1336920085	1	0.0200000000000014	0.00153846153846165	10135	1
4	Food 1	Intake 3	67	189354	1336920219	/users/cn/jespinosa/phecomp/data/CRG/20120502_FDF_CRG/20120502_FDF_CRG/20120511_FDF_CRG_c12.mtb	3708	COLL	WWFF	food_fat	3	189287	1336920152	1	0.400000000000002	0.00597014925373137	10136	1
4	Food 2	Intake 4	11	189352	1336920217	/users/cn/jespinosa/phecomp/data/CRG/20120502_FDF_CRG/20120502_FDF_CRG/20120511_FDF_CRG_c12.mtb	4020	286	WWFF	food_fat	4	189341	1336920206	1	0.0200000000000014	0.00181818181818195	10137	1
4	Food 2	Intake 4	13	189651	1336920516	/users/cn/jespinosa/phecomp/data/CRG/20120502_FDF_CRG/20120502_FDF_CRG/20120511_FDF_CRG_c12.mtb	4023	421	WWFF	food_fat	4	189638	1336920503	1	0.0800000000000001	0.00615384615384616	10138	1
4	Food 1	Intake 3	13	190085	1336920950	/users/cn/jespinosa/phecomp/data/CRG/20120502_FDF_CRG/20120502_FDF_CRG/20120511_FDF_CRG_c12.mtb	3716	389	WWFF	food_fat	3	190072	1336920937	1	0.0400000000000027	0.00307692307692328	10139	1
4	Food 2	Intake 4	12	190486	1336921351	/users/cn/jespinosa/phecomp/data/CRG/20120502_FDF_CRG/20120502_FDF_CRG/20120511_FDF_CRG_c12.mtb	4025	9002	WWFF	food_fat	4	190474	1336921339	1	0.0400000000000009	0.00333333333333341	10140	1
4	Drink 1	Intake 1	26	194250	1336925115	/users/cn/jespinosa/phecomp/data/CRG/20120502_FDF_CRG/20120502_FDF_CRG/20120511_FDF_CRG_c12.mtb	1557	NA	WWFF	water	1	194224	1336925089	1	0.12	0.00461538461538461	10141	1
4	Drink 1	Intake 1	29	199491	1336930356	/users/cn/jespinosa/phecomp/data/CRG/20120502_FDF_CRG/20120502_FDF_CRG/20120511_FDF_CRG_c12.mtb	1558	NA	WWFF	water	1	199462	1336930327	1	0.14	0.00482758620689655	10142	1
4	Food 1	Intake 3	9	199497	1336930362	/users/cn/jespinosa/phecomp/data/CRG/20120502_FDF_CRG/20120502_FDF_CRG/20120511_FDF_CRG_c12.mtb	3725	2556	WWFF	food_fat	3	199488	1336930353	1	0.0399999999999991	0.00444444444444434	10143	1
4	Food 2	Intake 4	61	202114	1336932979	/users/cn/jespinosa/phecomp/data/CRG/20120502_FDF_CRG/20120502_FDF_CRG/20120511_FDF_CRG_c12.mtb	4030	1075	WWFF	food_fat	4	202053	1336932918	1	0.0399999999999991	0.000655737704918018	10144	1
4	Food 1	Intake 3	20	203209	1336934074	/users/cn/jespinosa/phecomp/data/CRG/20120502_FDF_CRG/20120502_FDF_CRG/20120511_FDF_CRG_c12.mtb	3737	160	WWFF	food_fat	3	203189	1336934054	1	0.0599999999999987	0.00299999999999994	10145	1
4	Food 1	Intake 3	194	203563	1336934428	/users/cn/jespinosa/phecomp/data/CRG/20120502_FDF_CRG/20120502_FDF_CRG/20120511_FDF_CRG_c12.mtb	3739	COLL	WWFF	food_fat	3	203369	1336934234	1	0.120000000000001	0.000618556701030933	10146	1
4	Food 2	Intake 4	34	203404	1336934269	/users/cn/jespinosa/phecomp/data/CRG/20120502_FDF_CRG/20120502_FDF_CRG/20120511_FDF_CRG_c12.mtb	4041	605	WWFF	food_fat	4	203370	1336934235	1	0.0400000000000009	0.00117647058823532	10147	1
4	Food 1	Intake 3	114	204123	1336934988	/users/cn/jespinosa/phecomp/data/CRG/20120502_FDF_CRG/20120502_FDF_CRG/20120511_FDF_CRG_c12.mtb	3743	242	WWFF	food_fat	3	204009	1336934874	1	0.0200000000000031	0.000175438596491255	10148	1
4	Drink 2	Intake 2	49	204373	1336935238	/users/cn/jespinosa/phecomp/data/CRG/20120502_FDF_CRG/20120502_FDF_CRG/20120511_FDF_CRG_c12.mtb	1459	NA	WWFF	water	2	204324	1336935189	1	0.0399999999999996	0.000816326530612237	10149	1
4	Food 2	Intake 4	162	204527	1336935392	/users/cn/jespinosa/phecomp/data/CRG/20120502_FDF_CRG/20120502_FDF_CRG/20120511_FDF_CRG_c12.mtb	4051	58	WWFF	food_fat	4	204365	1336935230	1	0.200000000000001	0.00123456790123457	10150	1
4	Food 1	Intake 3	143	204728	1336935593	/users/cn/jespinosa/phecomp/data/CRG/20120502_FDF_CRG/20120502_FDF_CRG/20120511_FDF_CRG_c12.mtb	3746	COLL	WWFF	food_fat	3	204585	1336935450	1	0.0599999999999987	0.00041958041958041	10151	1
4	Food 2	Intake 4	141	204728	1336935593	/users/cn/jespinosa/phecomp/data/CRG/20120502_FDF_CRG/20120502_FDF_CRG/20120511_FDF_CRG_c12.mtb	4052	334	WWFF	food_fat	4	204587	1336935452	1	0.18	0.00127659574468085	10152	1
4	Food 2	Intake 4	126	205188	1336936053	/users/cn/jespinosa/phecomp/data/CRG/20120502_FDF_CRG/20120502_FDF_CRG/20120511_FDF_CRG_c12.mtb	4054	COLL	WWFF	food_fat	4	205062	1336935927	1	0.24	0.0019047619047619	10153	1
4	Food 1	Intake 3	62	205194	1336936059	/users/cn/jespinosa/phecomp/data/CRG/20120502_FDF_CRG/20120502_FDF_CRG/20120511_FDF_CRG_c12.mtb	3750	75	WWFF	food_fat	3	205132	1336935997	1	0.0999999999999979	0.00161290322580642	10154	1
4	Food 2	Intake 4	115	205384	1336936249	/users/cn/jespinosa/phecomp/data/CRG/20120502_FDF_CRG/20120502_FDF_CRG/20120511_FDF_CRG_c12.mtb	4055	15	WWFF	food_fat	4	205269	1336936134	1	0.119999999999999	0.00104347826086956	10155	1
4	Food 1	Intake 3	12	205411	1336936276	/users/cn/jespinosa/phecomp/data/CRG/20120502_FDF_CRG/20120502_FDF_CRG/20120511_FDF_CRG_c12.mtb	3753	60	WWFF	food_fat	3	205399	1336936264	1	0.0999999999999979	0.00833333333333316	10156	1
4	Food 2	Intake 4	140	205611	1336936476	/users/cn/jespinosa/phecomp/data/CRG/20120502_FDF_CRG/20120502_FDF_CRG/20120511_FDF_CRG_c12.mtb	4057	COLL	WWFF	food_fat	4	205471	1336936336	1	0.119999999999999	0.00085714285714285	10157	1
4	Food 1	Intake 3	76	205612	1336936477	/users/cn/jespinosa/phecomp/data/CRG/20120502_FDF_CRG/20120502_FDF_CRG/20120511_FDF_CRG_c12.mtb	3756	20	WWFF	food_fat	3	205536	1336936401	1	0.0800000000000018	0.00105263157894739	10158	1
4	Food 2	Intake 4	164	205796	1336936661	/users/cn/jespinosa/phecomp/data/CRG/20120502_FDF_CRG/20120502_FDF_CRG/20120511_FDF_CRG_c12.mtb	4058	COLL	WWFF	food_fat	4	205632	1336936497	1	0.940000000000001	0.00573170731707318	10159	1
4	Food 1	Intake 3	101	205798	1336936663	/users/cn/jespinosa/phecomp/data/CRG/20120502_FDF_CRG/20120502_FDF_CRG/20120511_FDF_CRG_c12.mtb	3758	73	WWFF	food_fat	3	205697	1336936562	1	0.100000000000001	0.000990099009901	10160	1
4	Food 2	Intake 4	170	206041	1336936906	/users/cn/jespinosa/phecomp/data/CRG/20120502_FDF_CRG/20120502_FDF_CRG/20120511_FDF_CRG_c12.mtb	4059	64	WWFF	food_fat	4	205871	1336936736	1	0.84	0.00494117647058824	10161	1
4	Food 2	Intake 4	478	206583	1336937448	/users/cn/jespinosa/phecomp/data/CRG/20120502_FDF_CRG/20120502_FDF_CRG/20120511_FDF_CRG_c12.mtb	4060	COLL	WWFF	food_fat	4	206105	1336936970	1	3.56	0.00744769874476987	10162	1
4	Food 1	Intake 3	51	206539	1336937404	/users/cn/jespinosa/phecomp/data/CRG/20120502_FDF_CRG/20120502_FDF_CRG/20120511_FDF_CRG_c12.mtb	3762	5	WWFF	food_fat	3	206488	1336937353	1	0.0399999999999991	0.000784313725490178	10163	1
4	Food 1	Intake 3	41	206585	1336937450	/users/cn/jespinosa/phecomp/data/CRG/20120502_FDF_CRG/20120502_FDF_CRG/20120511_FDF_CRG_c12.mtb	3763	57	WWFF	food_fat	3	206544	1336937409	1	0.0600000000000023	0.0014634146341464	10164	1
4	Food 2	Intake 4	206	206848	1336937713	/users/cn/jespinosa/phecomp/data/CRG/20120502_FDF_CRG/20120502_FDF_CRG/20120511_FDF_CRG_c12.mtb	4061	148	WWFF	food_fat	4	206642	1336937507	1	2.38	0.0115533980582524	10165	1
4	Food 2	Intake 4	233	207229	1336938094	/users/cn/jespinosa/phecomp/data/CRG/20120502_FDF_CRG/20120502_FDF_CRG/20120511_FDF_CRG_c12.mtb	4062	273	WWFF	food_fat	4	206996	1336937861	1	0.280000000000001	0.00120171673819743	10166	1
4	Food 2	Intake 4	215	207717	1336938582	/users/cn/jespinosa/phecomp/data/CRG/20120502_FDF_CRG/20120502_FDF_CRG/20120511_FDF_CRG_c12.mtb	4064	31	WWFF	food_fat	4	207502	1336938367	1	0.380000000000003	0.00176744186046513	10167	1
4	Food 1	Intake 3	151	207899	1336938764	/users/cn/jespinosa/phecomp/data/CRG/20120502_FDF_CRG/20120502_FDF_CRG/20120511_FDF_CRG_c12.mtb	3771	COLL	WWFF	food_fat	3	207748	1336938613	1	0.16	0.00105960264900662	10168	1
4	Food 2	Intake 4	17	207885	1336938750	/users/cn/jespinosa/phecomp/data/CRG/20120502_FDF_CRG/20120502_FDF_CRG/20120511_FDF_CRG_c12.mtb	4067	51	WWFF	food_fat	4	207868	1336938733	1	0.0599999999999987	0.00352941176470581	10169	1
4	Food 2	Intake 4	284	208220	1336939085	/users/cn/jespinosa/phecomp/data/CRG/20120502_FDF_CRG/20120502_FDF_CRG/20120511_FDF_CRG_c12.mtb	4068	39	WWFF	food_fat	4	207936	1336938801	1	0.120000000000001	0.000422535211267609	10170	1
4	Food 2	Intake 4	284	208543	1336939408	/users/cn/jespinosa/phecomp/data/CRG/20120502_FDF_CRG/20120502_FDF_CRG/20120511_FDF_CRG_c12.mtb	4069	COLL	WWFF	food_fat	4	208259	1336939124	1	2.44	0.00859154929577465	10171	1
4	Food 1	Intake 3	166	208541	1336939406	/users/cn/jespinosa/phecomp/data/CRG/20120502_FDF_CRG/20120502_FDF_CRG/20120511_FDF_CRG_c12.mtb	3775	40	WWFF	food_fat	3	208375	1336939240	1	0.0399999999999991	0.000240963855421681	10172	1
4	Food 2	Intake 4	80	208661	1336939526	/users/cn/jespinosa/phecomp/data/CRG/20120502_FDF_CRG/20120502_FDF_CRG/20120511_FDF_CRG_c12.mtb	4070	80	WWFF	food_fat	4	208581	1336939446	1	0.0600000000000023	0.000750000000000029	10173	1
4	Food 2	Intake 4	305	209046	1336939911	/users/cn/jespinosa/phecomp/data/CRG/20120502_FDF_CRG/20120502_FDF_CRG/20120511_FDF_CRG_c12.mtb	4072	COLL	WWFF	food_fat	4	208741	1336939606	1	0.34	0.00111475409836066	10174	1
4	Food 1	Intake 3	109	208976	1336939841	/users/cn/jespinosa/phecomp/data/CRG/20120502_FDF_CRG/20120502_FDF_CRG/20120511_FDF_CRG_c12.mtb	3780	77	WWFF	food_fat	3	208867	1336939732	1	0.0399999999999991	0.000366972477064212	10175	1
4	Drink 1	Intake 1	23	208994	1336939859	/users/cn/jespinosa/phecomp/data/CRG/20120502_FDF_CRG/20120502_FDF_CRG/20120511_FDF_CRG_c12.mtb	1563	NA	WWFF	water	1	208971	1336939836	1	0.0800000000000001	0.00347826086956522	10176	1
4	Food 2	Intake 4	74	209127	1336939992	/users/cn/jespinosa/phecomp/data/CRG/20120502_FDF_CRG/20120502_FDF_CRG/20120511_FDF_CRG_c12.mtb	4073	COLL	WWFF	food_fat	4	209053	1336939918	1	0.0599999999999987	0.000810810810810793	10177	1
4	Food 1	Intake 3	17	209113	1336939978	/users/cn/jespinosa/phecomp/data/CRG/20120502_FDF_CRG/20120502_FDF_CRG/20120511_FDF_CRG_c12.mtb	3783	20	WWFF	food_fat	3	209096	1336939961	1	0.0600000000000023	0.00352941176470602	10178	1
4	Food 2	Intake 4	143	209276	1336940141	/users/cn/jespinosa/phecomp/data/CRG/20120502_FDF_CRG/20120502_FDF_CRG/20120511_FDF_CRG_c12.mtb	4074	COLL	WWFF	food_fat	4	209133	1336939998	1	0.199999999999999	0.00139860139860139	10179	1
4	Food 1	Intake 3	77	209273	1336940138	/users/cn/jespinosa/phecomp/data/CRG/20120502_FDF_CRG/20120502_FDF_CRG/20120511_FDF_CRG_c12.mtb	3785	75	WWFF	food_fat	3	209196	1336940061	1	0.0999999999999979	0.00129870129870127	10180	1
4	Food 2	Intake 4	404	209752	1336940617	/users/cn/jespinosa/phecomp/data/CRG/20120502_FDF_CRG/20120502_FDF_CRG/20120511_FDF_CRG_c12.mtb	4076	COLL	WWFF	food_fat	4	209348	1336940213	1	0.100000000000001	0.00024752475247525	10181	1
4	Food 1	Intake 3	172	209751	1336940616	/users/cn/jespinosa/phecomp/data/CRG/20120502_FDF_CRG/20120502_FDF_CRG/20120511_FDF_CRG_c12.mtb	3787	92	WWFF	food_fat	3	209579	1336940444	1	0.0399999999999991	0.000232558139534878	10182	1
4	Food 1	Intake 3	309	210152	1336941017	/users/cn/jespinosa/phecomp/data/CRG/20120502_FDF_CRG/20120502_FDF_CRG/20120511_FDF_CRG_c12.mtb	3788	COLL	WWFF	food_fat	3	209843	1336940708	1	0.0200000000000031	6.47249190938612e-05	10183	1
4	Food 2	Intake 4	187	210162	1336941027	/users/cn/jespinosa/phecomp/data/CRG/20120502_FDF_CRG/20120502_FDF_CRG/20120511_FDF_CRG_c12.mtb	4079	133	WWFF	food_fat	4	209975	1336940840	1	0.140000000000001	0.000748663101604283	10184	1
4	Drink 2	Intake 2	20	210120	1336940985	/users/cn/jespinosa/phecomp/data/CRG/20120502_FDF_CRG/20120502_FDF_CRG/20120511_FDF_CRG_c12.mtb	1469	NA	WWFF	water	2	210100	1336940965	1	0.0600000000000001	0.00300000000000001	10185	1
4	Food 2	Intake 4	187	210482	1336941347	/users/cn/jespinosa/phecomp/data/CRG/20120502_FDF_CRG/20120502_FDF_CRG/20120511_FDF_CRG_c12.mtb	4081	COLL	WWFF	food_fat	4	210295	1336941160	1	0.459999999999997	0.00245989304812833	10186	1
4	Food 1	Intake 3	159	210480	1336941345	/users/cn/jespinosa/phecomp/data/CRG/20120502_FDF_CRG/20120502_FDF_CRG/20120511_FDF_CRG_c12.mtb	3790	188	WWFF	food_fat	3	210321	1336941186	1	0.18	0.00113207547169811	10187	1
4	Food 1	Intake 3	191	210859	1336941724	/users/cn/jespinosa/phecomp/data/CRG/20120502_FDF_CRG/20120502_FDF_CRG/20120511_FDF_CRG_c12.mtb	3791	4	WWFF	food_fat	3	210668	1336941533	1	0.0599999999999987	0.000314136125654443	10188	1
4	Food 1	Intake 3	190	211053	1336941918	/users/cn/jespinosa/phecomp/data/CRG/20120502_FDF_CRG/20120502_FDF_CRG/20120511_FDF_CRG_c12.mtb	3792	COLL	WWFF	food_fat	3	210863	1336941728	1	0.0399999999999991	0.000210526315789469	10189	1
4	Food 2	Intake 4	191	211056	1336941921	/users/cn/jespinosa/phecomp/data/CRG/20120502_FDF_CRG/20120502_FDF_CRG/20120511_FDF_CRG_c12.mtb	4084	365	WWFF	food_fat	4	210865	1336941730	1	0.32	0.00167539267015707	10190	1
4	Food 1	Intake 3	96	211517	1336942382	/users/cn/jespinosa/phecomp/data/CRG/20120502_FDF_CRG/20120502_FDF_CRG/20120511_FDF_CRG_c12.mtb	3796	102	WWFF	food_fat	3	211421	1336942286	1	0.100000000000001	0.00104166666666668	10191	1
4	Food 1	Intake 3	92	211711	1336942576	/users/cn/jespinosa/phecomp/data/CRG/20120502_FDF_CRG/20120502_FDF_CRG/20120511_FDF_CRG_c12.mtb	3798	5	WWFF	food_fat	3	211619	1336942484	1	0.0200000000000031	0.00021739130434786	10192	1
4	Food 1	Intake 3	179	211895	1336942760	/users/cn/jespinosa/phecomp/data/CRG/20120502_FDF_CRG/20120502_FDF_CRG/20120511_FDF_CRG_c12.mtb	3799	598	WWFF	food_fat	3	211716	1336942581	1	0.0999999999999979	0.000558659217877083	10193	1
4	Drink 2	Intake 2	11	212101	1336942966	/users/cn/jespinosa/phecomp/data/CRG/20120502_FDF_CRG/20120502_FDF_CRG/20120511_FDF_CRG_c12.mtb	1470	NA	WWFF	water	2	212090	1336942955	1	0.02	0.00181818181818182	10194	1
4	Food 2	Intake 4	381	212874	1336943739	/users/cn/jespinosa/phecomp/data/CRG/20120502_FDF_CRG/20120502_FDF_CRG/20120511_FDF_CRG_c12.mtb	4093	3271	WWFF	food_fat	4	212493	1336943358	1	0.0200000000000031	5.24934383202181e-05	10195	1
4	Drink 1	Intake 1	27	215434	1336946299	/users/cn/jespinosa/phecomp/data/CRG/20120502_FDF_CRG/20120502_FDF_CRG/20120511_FDF_CRG_c12.mtb	1566	NA	WWFF	water	1	215407	1336946272	1	0.14	0.00518518518518519	10196	1
4	Food 2	Intake 4	14	216159	1336947024	/users/cn/jespinosa/phecomp/data/CRG/20120502_FDF_CRG/20120502_FDF_CRG/20120511_FDF_CRG_c12.mtb	4102	1027	WWFF	food_fat	4	216145	1336947010	1	0.0399999999999991	0.00285714285714279	10197	1
4	Drink 1	Intake 1	16	216614	1336947479	/users/cn/jespinosa/phecomp/data/CRG/20120502_FDF_CRG/20120502_FDF_CRG/20120511_FDF_CRG_c12.mtb	1567	NA	WWFF	water	1	216598	1336947463	1	0.02	0.00125	10198	1
4	Food 1	Intake 3	84	217270	1336948135	/users/cn/jespinosa/phecomp/data/CRG/20120502_FDF_CRG/20120502_FDF_CRG/20120511_FDF_CRG_c12.mtb	3812	621	WWFF	food_fat	3	217186	1336948051	1	0.0200000000000031	0.000238095238095275	10199	1
4	Drink 1	Intake 1	19	217297	1336948162	/users/cn/jespinosa/phecomp/data/CRG/20120502_FDF_CRG/20120502_FDF_CRG/20120511_FDF_CRG_c12.mtb	1569	NA	WWFF	water	1	217278	1336948143	1	0.0600000000000001	0.00315789473684211	10200	1
4	Food 1	Intake 3	73	217964	1336948829	/users/cn/jespinosa/phecomp/data/CRG/20120502_FDF_CRG/20120502_FDF_CRG/20120511_FDF_CRG_c12.mtb	3816	COLL	WWFF	food_fat	3	217891	1336948756	1	0.16	0.00219178082191781	10201	1
4	Food 2	Intake 4	58	217951	1336948816	/users/cn/jespinosa/phecomp/data/CRG/20120502_FDF_CRG/20120502_FDF_CRG/20120511_FDF_CRG_c12.mtb	4112	40	WWFF	food_fat	4	217893	1336948758	1	0.0399999999999991	0.000689655172413778	10202	1
4	Food 2	Intake 4	113	218104	1336948969	/users/cn/jespinosa/phecomp/data/CRG/20120502_FDF_CRG/20120502_FDF_CRG/20120511_FDF_CRG_c12.mtb	4113	COLL	WWFF	food_fat	4	217991	1336948856	1	0.140000000000001	0.00123893805309735	10203	1
4	Food 1	Intake 3	102	218097	1336948962	/users/cn/jespinosa/phecomp/data/CRG/20120502_FDF_CRG/20120502_FDF_CRG/20120511_FDF_CRG_c12.mtb	3817	400	WWFF	food_fat	3	217995	1336948860	1	0.0999999999999979	0.000980392156862724	10204	1
4	Food 1	Intake 3	279	218776	1336949641	/users/cn/jespinosa/phecomp/data/CRG/20120502_FDF_CRG/20120502_FDF_CRG/20120511_FDF_CRG_c12.mtb	3822	COLL	WWFF	food_fat	3	218497	1336949362	1	0.119999999999997	0.00043010752688171	10205	1
4	Food 2	Intake 4	240	218739	1336949604	/users/cn/jespinosa/phecomp/data/CRG/20120502_FDF_CRG/20120502_FDF_CRG/20120511_FDF_CRG_c12.mtb	4119	108	WWFF	food_fat	4	218499	1336949364	1	0.0399999999999991	0.000166666666666663	10206	1
4	Food 2	Intake 4	188	219035	1336949900	/users/cn/jespinosa/phecomp/data/CRG/20120502_FDF_CRG/20120502_FDF_CRG/20120511_FDF_CRG_c12.mtb	4121	COLL	WWFF	food_fat	4	218847	1336949712	1	0.100000000000001	0.000531914893617027	10207	1
4	Food 1	Intake 3	185	219033	1336949898	/users/cn/jespinosa/phecomp/data/CRG/20120502_FDF_CRG/20120502_FDF_CRG/20120511_FDF_CRG_c12.mtb	3823	87	WWFF	food_fat	3	218848	1336949713	1	0.0800000000000018	0.000432432432432442	10208	1
4	Drink 1	Intake 1	53	219079	1336949944	/users/cn/jespinosa/phecomp/data/CRG/20120502_FDF_CRG/20120502_FDF_CRG/20120511_FDF_CRG_c12.mtb	1571	NA	WWFF	water	1	219026	1336949891	1	0.1	0.00188679245283019	10209	1
4	Food 1	Intake 3	103	219223	1336950088	/users/cn/jespinosa/phecomp/data/CRG/20120502_FDF_CRG/20120502_FDF_CRG/20120511_FDF_CRG_c12.mtb	3825	8	WWFF	food_fat	3	219120	1336949985	1	0.0399999999999991	0.000388349514563098	10210	1
4	Food 1	Intake 3	28	219259	1336950124	/users/cn/jespinosa/phecomp/data/CRG/20120502_FDF_CRG/20120502_FDF_CRG/20120511_FDF_CRG_c12.mtb	3826	257	WWFF	food_fat	3	219231	1336950096	1	0.0600000000000023	0.00214285714285722	10211	1
4	Food 2	Intake 4	73	219589	1336950454	/users/cn/jespinosa/phecomp/data/CRG/20120502_FDF_CRG/20120502_FDF_CRG/20120511_FDF_CRG_c12.mtb	4124	134	WWFF	food_fat	4	219516	1336950381	1	0.0200000000000031	0.000273972602739768	10212	1
4	Food 2	Intake 4	104	219827	1336950692	/users/cn/jespinosa/phecomp/data/CRG/20120502_FDF_CRG/20120502_FDF_CRG/20120511_FDF_CRG_c12.mtb	4126	COLL	WWFF	food_fat	4	219723	1336950588	1	0.280000000000001	0.0026923076923077	10213	1
4	Food 1	Intake 3	103	219828	1336950693	/users/cn/jespinosa/phecomp/data/CRG/20120502_FDF_CRG/20120502_FDF_CRG/20120511_FDF_CRG_c12.mtb	3831	144	WWFF	food_fat	3	219725	1336950590	1	0.18	0.00174757281553398	10214	1
4	Drink 2	Intake 2	20	219844	1336950709	/users/cn/jespinosa/phecomp/data/CRG/20120502_FDF_CRG/20120502_FDF_CRG/20120511_FDF_CRG_c12.mtb	1475	NA	WWFF	water	2	219824	1336950689	1	0.02	0.001	10215	1
4	Food 1	Intake 3	208	220180	1336951045	/users/cn/jespinosa/phecomp/data/CRG/20120502_FDF_CRG/20120502_FDF_CRG/20120511_FDF_CRG_c12.mtb	3833	90	WWFF	food_fat	3	219972	1336950837	1	0.120000000000001	0.000576923076923082	10216	1
4	Food 2	Intake 4	36	220306	1336951171	/users/cn/jespinosa/phecomp/data/CRG/20120502_FDF_CRG/20120502_FDF_CRG/20120511_FDF_CRG_c12.mtb	4129	22	WWFF	food_fat	4	220270	1336951135	1	0.0599999999999987	0.00166666666666663	10217	1
4	Food 1	Intake 3	219	220547	1336951412	/users/cn/jespinosa/phecomp/data/CRG/20120502_FDF_CRG/20120502_FDF_CRG/20120511_FDF_CRG_c12.mtb	3836	6	WWFF	food_fat	3	220328	1336951193	1	0.0600000000000023	0.000273972602739737	10218	1
4	Food 1	Intake 3	173	220726	1336951591	/users/cn/jespinosa/phecomp/data/CRG/20120502_FDF_CRG/20120502_FDF_CRG/20120511_FDF_CRG_c12.mtb	3837	1151	WWFF	food_fat	3	220553	1336951418	1	0.0399999999999991	0.000231213872832365	10219	1
4	Food 1	Intake 3	15	221892	1336952757	/users/cn/jespinosa/phecomp/data/CRG/20120502_FDF_CRG/20120502_FDF_CRG/20120511_FDF_CRG_c12.mtb	3844	783	WWFF	food_fat	3	221877	1336952742	1	0.219999999999999	0.0146666666666666	10220	1
4	Food 1	Intake 3	14	222689	1336953554	/users/cn/jespinosa/phecomp/data/CRG/20120502_FDF_CRG/20120502_FDF_CRG/20120511_FDF_CRG_c12.mtb	3851	1587	WWFF	food_fat	3	222675	1336953540	1	0.0200000000000031	0.00142857142857165	10221	1
4	Food 2	Intake 4	12	224288	1336955153	/users/cn/jespinosa/phecomp/data/CRG/20120502_FDF_CRG/20120502_FDF_CRG/20120511_FDF_CRG_c12.mtb	4152	148	WWFF	food_fat	4	224276	1336955141	1	0.0399999999999991	0.00333333333333326	10222	1
4	Drink 1	Intake 1	18	224448	1336955313	/users/cn/jespinosa/phecomp/data/CRG/20120502_FDF_CRG/20120502_FDF_CRG/20120511_FDF_CRG_c12.mtb	1574	NA	WWFF	water	1	224430	1336955295	1	0.0399999999999996	0.0022222222222222	10223	1
4	Food 2	Intake 4	18	224454	1336955319	/users/cn/jespinosa/phecomp/data/CRG/20120502_FDF_CRG/20120502_FDF_CRG/20120511_FDF_CRG_c12.mtb	4153	COLL	WWFF	food_fat	4	224436	1336955301	1	0.0600000000000023	0.00333333333333346	10224	1
4	Food 1	Intake 3	18	224455	1336955320	/users/cn/jespinosa/phecomp/data/CRG/20120502_FDF_CRG/20120502_FDF_CRG/20120511_FDF_CRG_c12.mtb	3853	333	WWFF	food_fat	3	224437	1336955302	1	0.0399999999999991	0.00222222222222217	10225	1
4	Food 2	Intake 4	24	224812	1336955677	/users/cn/jespinosa/phecomp/data/CRG/20120502_FDF_CRG/20120502_FDF_CRG/20120511_FDF_CRG_c12.mtb	4155	2991	WWFF	food_fat	4	224788	1336955653	1	0.0399999999999991	0.00166666666666663	10226	1
4	Drink 1	Intake 1	13	225426	1336956291	/users/cn/jespinosa/phecomp/data/CRG/20120502_FDF_CRG/20120502_FDF_CRG/20120511_FDF_CRG_c12.mtb	1575	NA	WWFF	water	1	225413	1336956278	1	0.04	0.00307692307692308	10227	1
4	Drink 1	Intake 1	16	226755	1336957620	/users/cn/jespinosa/phecomp/data/CRG/20120502_FDF_CRG/20120502_FDF_CRG/20120511_FDF_CRG_c12.mtb	1576	NA	WWFF	water	1	226739	1336957604	1	0.0600000000000001	0.00375000000000001	10228	1
4	Food 2	Intake 4	13	227816	1336958681	/users/cn/jespinosa/phecomp/data/CRG/20120502_FDF_CRG/20120502_FDF_CRG/20120511_FDF_CRG_c12.mtb	4177	929	WWFF	food_fat	4	227803	1336958668	1	0.0400000000000027	0.00307692307692328	10229	1
4	Food 2	Intake 4	22	228767	1336959632	/users/cn/jespinosa/phecomp/data/CRG/20120502_FDF_CRG/20120502_FDF_CRG/20120511_FDF_CRG_c12.mtb	4183	294	WWFF	food_fat	4	228745	1336959610	1	0.0399999999999991	0.00181818181818178	10230	1
4	Food 2	Intake 4	11	229072	1336959937	/users/cn/jespinosa/phecomp/data/CRG/20120502_FDF_CRG/20120502_FDF_CRG/20120511_FDF_CRG_c12.mtb	4184	588	WWFF	food_fat	4	229061	1336959926	1	0.0399999999999991	0.00363636363636355	10231	1
4	Food 2	Intake 4	14	229674	1336960539	/users/cn/jespinosa/phecomp/data/CRG/20120502_FDF_CRG/20120502_FDF_CRG/20120511_FDF_CRG_c12.mtb	4186	975	WWFF	food_fat	4	229660	1336960525	1	0.0400000000000027	0.00285714285714305	10232	1
4	Food 2	Intake 4	25	230674	1336961539	/users/cn/jespinosa/phecomp/data/CRG/20120502_FDF_CRG/20120502_FDF_CRG/20120511_FDF_CRG_c12.mtb	4192	959	WWFF	food_fat	4	230649	1336961514	1	0.0399999999999991	0.00159999999999996	10233	1
4	Food 2	Intake 4	225	231858	1336962723	/users/cn/jespinosa/phecomp/data/CRG/20120502_FDF_CRG/20120502_FDF_CRG/20120511_FDF_CRG_c12.mtb	4200	78	WWFF	food_fat	4	231633	1336962498	1	0.0399999999999991	0.000177777777777774	10234	1
4	Food 2	Intake 4	127	232063	1336962928	/users/cn/jespinosa/phecomp/data/CRG/20120502_FDF_CRG/20120502_FDF_CRG/20120511_FDF_CRG_c12.mtb	4202	COLL	WWFF	food_fat	4	231936	1336962801	1	0.0800000000000018	0.000629921259842534	10235	1
4	Food 1	Intake 3	133	232073	1336962938	/users/cn/jespinosa/phecomp/data/CRG/20120502_FDF_CRG/20120502_FDF_CRG/20120511_FDF_CRG_c12.mtb	3889	9	WWFF	food_fat	3	231940	1336962805	1	0.180000000000003	0.00135338345864664	10236	1
4	Food 1	Intake 3	187	232269	1336963134	/users/cn/jespinosa/phecomp/data/CRG/20120502_FDF_CRG/20120502_FDF_CRG/20120511_FDF_CRG_c12.mtb	3890	COLL	WWFF	food_fat	3	232082	1336962947	1	0.18	0.000962566844919786	10237	1
4	Food 2	Intake 4	162	232273	1336963138	/users/cn/jespinosa/phecomp/data/CRG/20120502_FDF_CRG/20120502_FDF_CRG/20120511_FDF_CRG_c12.mtb	4204	49	WWFF	food_fat	4	232111	1336962976	1	0.120000000000001	0.000740740740740747	10238	1
4	Drink 1	Intake 1	15	232191	1336963056	/users/cn/jespinosa/phecomp/data/CRG/20120502_FDF_CRG/20120502_FDF_CRG/20120511_FDF_CRG_c12.mtb	1577	NA	WWFF	water	1	232176	1336963041	1	0.02	0.00133333333333333	10239	1
4	Food 2	Intake 4	96	232418	1336963283	/users/cn/jespinosa/phecomp/data/CRG/20120502_FDF_CRG/20120502_FDF_CRG/20120511_FDF_CRG_c12.mtb	4205	629	WWFF	food_fat	4	232322	1336963187	1	0.0999999999999979	0.00104166666666664	10240	1
4	Drink 1	Intake 1	35	232442	1336963307	/users/cn/jespinosa/phecomp/data/CRG/20120502_FDF_CRG/20120502_FDF_CRG/20120511_FDF_CRG_c12.mtb	1578	NA	WWFF	water	1	232407	1336963272	1	0.1	0.00285714285714286	10241	1
4	Drink 1	Intake 1	23	232725	1336963590	/users/cn/jespinosa/phecomp/data/CRG/20120502_FDF_CRG/20120502_FDF_CRG/20120511_FDF_CRG_c12.mtb	1579	NA	WWFF	water	1	232702	1336963567	1	0.02	0.000869565217391304	10242	1
4	Food 1	Intake 3	23	233070	1336963935	/users/cn/jespinosa/phecomp/data/CRG/20120502_FDF_CRG/20120502_FDF_CRG/20120511_FDF_CRG_c12.mtb	3899	COLL	WWFF	food_fat	3	233047	1336963912	1	0.139999999999997	0.006086956521739	10243	1
4	Food 2	Intake 4	151	233199	1336964064	/users/cn/jespinosa/phecomp/data/CRG/20120502_FDF_CRG/20120502_FDF_CRG/20120511_FDF_CRG_c12.mtb	4210	COLL	WWFF	food_fat	4	233048	1336963913	1	0.140000000000001	0.000927152317880801	10244	1
4	Food 1	Intake 3	13	233198	1336964063	/users/cn/jespinosa/phecomp/data/CRG/20120502_FDF_CRG/20120502_FDF_CRG/20120511_FDF_CRG_c12.mtb	3902	333	WWFF	food_fat	3	233185	1336964050	1	0.0399999999999991	0.00307692307692301	10245	1
4	Food 2	Intake 4	14	233545	1336964410	/users/cn/jespinosa/phecomp/data/CRG/20120502_FDF_CRG/20120502_FDF_CRG/20120511_FDF_CRG_c12.mtb	4213	341	WWFF	food_fat	4	233531	1336964396	1	0.16	0.0114285714285714	10246	1
4	Food 1	Intake 3	326	234212	1336965077	/users/cn/jespinosa/phecomp/data/CRG/20120502_FDF_CRG/20120502_FDF_CRG/20120511_FDF_CRG_c12.mtb	3910	COLL	WWFF	food_fat	3	233886	1336964751	1	0.199999999999999	0.000613496932515334	10247	1
4	Food 2	Intake 4	267	234157	1336965022	/users/cn/jespinosa/phecomp/data/CRG/20120502_FDF_CRG/20120502_FDF_CRG/20120511_FDF_CRG_c12.mtb	4219	1605	WWFF	food_fat	4	233890	1336964755	1	0.259999999999998	0.000973782771535573	10248	1
4	Drink 2	Intake 2	15	233943	1336964808	/users/cn/jespinosa/phecomp/data/CRG/20120502_FDF_CRG/20120502_FDF_CRG/20120511_FDF_CRG_c12.mtb	1481	NA	WWFF	water	2	233928	1336964793	1	0.04	0.00266666666666667	10249	1
4	Food 1	Intake 3	13	235775	1336966640	/users/cn/jespinosa/phecomp/data/CRG/20120502_FDF_CRG/20120502_FDF_CRG/20120511_FDF_CRG_c12.mtb	3913	1152	WWFF	food_fat	3	235762	1336966627	1	0.0399999999999991	0.00307692307692301	10250	1
4	Drink 2	Intake 2	27	236782	1336967647	/users/cn/jespinosa/phecomp/data/CRG/20120502_FDF_CRG/20120502_FDF_CRG/20120511_FDF_CRG_c12.mtb	1482	NA	WWFF	water	2	236755	1336967620	1	0.0600000000000001	0.00222222222222223	10251	1
4	Food 2	Intake 4	29	236956	1336967821	/users/cn/jespinosa/phecomp/data/CRG/20120502_FDF_CRG/20120502_FDF_CRG/20120511_FDF_CRG_c12.mtb	4228	219	WWFF	food_fat	4	236927	1336967792	1	0.0400000000000027	0.00137931034482768	10252	1
4	Food 1	Intake 3	17	237192	1336968057	/users/cn/jespinosa/phecomp/data/CRG/20120502_FDF_CRG/20120502_FDF_CRG/20120511_FDF_CRG_c12.mtb	3917	1199	WWFF	food_fat	3	237175	1336968040	1	0.0200000000000031	0.00117647058823548	10253	1
4	Drink 1	Intake 1	30	237560	1336968425	/users/cn/jespinosa/phecomp/data/CRG/20120502_FDF_CRG/20120502_FDF_CRG/20120511_FDF_CRG_c12.mtb	1581	NA	WWFF	water	1	237530	1336968395	1	0.0600000000000001	0.002	10254	1
4	Food 1	Intake 3	20	238411	1336969276	/users/cn/jespinosa/phecomp/data/CRG/20120502_FDF_CRG/20120502_FDF_CRG/20120511_FDF_CRG_c12.mtb	3925	COLL	WWFF	food_fat	3	238391	1336969256	1	0.48	0.024	10255	1
4	Food 2	Intake 4	45	238437	1336969302	/users/cn/jespinosa/phecomp/data/CRG/20120502_FDF_CRG/20120502_FDF_CRG/20120511_FDF_CRG_c12.mtb	4237	177	WWFF	food_fat	4	238392	1336969257	1	0.379999999999999	0.00844444444444442	10256	1
4	Food 2	Intake 4	218	238832	1336969697	/users/cn/jespinosa/phecomp/data/CRG/20120502_FDF_CRG/20120502_FDF_CRG/20120511_FDF_CRG_c12.mtb	4239	COLL	WWFF	food_fat	4	238614	1336969479	1	0.0600000000000023	0.000275229357798176	10257	1
4	Food 1	Intake 3	151	238878	1336969743	/users/cn/jespinosa/phecomp/data/CRG/20120502_FDF_CRG/20120502_FDF_CRG/20120511_FDF_CRG_c12.mtb	3929	60	WWFF	food_fat	3	238727	1336969592	1	0.16	0.00105960264900662	10258	1
4	Food 1	Intake 3	73	239011	1336969876	/users/cn/jespinosa/phecomp/data/CRG/20120502_FDF_CRG/20120502_FDF_CRG/20120511_FDF_CRG_c12.mtb	3930	6	WWFF	food_fat	3	238938	1336969803	1	0.0399999999999991	0.00054794520547944	10259	1
4	Food 1	Intake 3	92	239109	1336969974	/users/cn/jespinosa/phecomp/data/CRG/20120502_FDF_CRG/20120502_FDF_CRG/20120511_FDF_CRG_c12.mtb	3931	20	WWFF	food_fat	3	239017	1336969882	1	0.0599999999999987	0.000652173913043464	10260	1
4	Food 2	Intake 4	65	239194	1336970059	/users/cn/jespinosa/phecomp/data/CRG/20120502_FDF_CRG/20120502_FDF_CRG/20120511_FDF_CRG_c12.mtb	4244	COLL	WWFF	food_fat	4	239129	1336969994	1	0.16	0.00246153846153846	10261	1
4	Food 1	Intake 3	37	239167	1336970032	/users/cn/jespinosa/phecomp/data/CRG/20120502_FDF_CRG/20120502_FDF_CRG/20120511_FDF_CRG_c12.mtb	3932	2143	WWFF	food_fat	3	239130	1336969995	1	0.0600000000000023	0.00162162162162168	10262	1
4	Drink 1	Intake 1	25	239181	1336970046	/users/cn/jespinosa/phecomp/data/CRG/20120502_FDF_CRG/20120502_FDF_CRG/20120511_FDF_CRG_c12.mtb	1583	NA	WWFF	water	1	239156	1336970021	1	0.14	0.0056	10263	1
4	Food 1	Intake 3	389	241699	1336972564	/users/cn/jespinosa/phecomp/data/CRG/20120502_FDF_CRG/20120502_FDF_CRG/20120511_FDF_CRG_c12.mtb	3937	514	WWFF	food_fat	3	241310	1336972175	1	0.140000000000001	0.000359897172236506	10264	1
4	Food 2	Intake 4	54	242267	1336973132	/users/cn/jespinosa/phecomp/data/CRG/20120502_FDF_CRG/20120502_FDF_CRG/20120511_FDF_CRG_c12.mtb	4255	COLL	WWFF	food_fat	4	242213	1336973078	1	0.100000000000001	0.00185185185185187	10265	1
4	Food 1	Intake 3	12	242267	1336973132	/users/cn/jespinosa/phecomp/data/CRG/20120502_FDF_CRG/20120502_FDF_CRG/20120511_FDF_CRG_c12.mtb	3944	460	WWFF	food_fat	3	242255	1336973120	1	0.0399999999999991	0.00333333333333326	10266	1
4	Food 2	Intake 4	161	242888	1336973753	/users/cn/jespinosa/phecomp/data/CRG/20120502_FDF_CRG/20120502_FDF_CRG/20120511_FDF_CRG_c12.mtb	4258	COLL	WWFF	food_fat	4	242727	1336973592	1	0.0799999999999983	0.000496894409937878	10267	1
4	Food 1	Intake 3	134	242862	1336973727	/users/cn/jespinosa/phecomp/data/CRG/20120502_FDF_CRG/20120502_FDF_CRG/20120511_FDF_CRG_c12.mtb	3951	51	WWFF	food_fat	3	242728	1336973593	1	0.0599999999999987	0.000447761194029841	10268	1
4	Drink 2	Intake 2	16	242918	1336973783	/users/cn/jespinosa/phecomp/data/CRG/20120502_FDF_CRG/20120502_FDF_CRG/20120511_FDF_CRG_c12.mtb	1485	NA	WWFF	water	2	242902	1336973767	1	0.0600000000000001	0.00375000000000001	10269	1
4	Food 1	Intake 3	14	242927	1336973792	/users/cn/jespinosa/phecomp/data/CRG/20120502_FDF_CRG/20120502_FDF_CRG/20120511_FDF_CRG_c12.mtb	3952	24	WWFF	food_fat	3	242913	1336973778	1	0.0200000000000031	0.00142857142857165	10270	1
4	Food 2	Intake 4	71	243022	1336973887	/users/cn/jespinosa/phecomp/data/CRG/20120502_FDF_CRG/20120502_FDF_CRG/20120511_FDF_CRG_c12.mtb	4260	152	WWFF	food_fat	4	242951	1336973816	1	0.0399999999999991	0.000563380281690128	10271	1
4	Food 1	Intake 3	113	243287	1336974152	/users/cn/jespinosa/phecomp/data/CRG/20120502_FDF_CRG/20120502_FDF_CRG/20120511_FDF_CRG_c12.mtb	3956	93	WWFF	food_fat	3	243174	1336974039	1	0.0399999999999991	0.000353982300884948	10272	1
4	Food 2	Intake 4	14	243394	1336974259	/users/cn/jespinosa/phecomp/data/CRG/20120502_FDF_CRG/20120502_FDF_CRG/20120511_FDF_CRG_c12.mtb	4262	3318	WWFF	food_fat	4	243380	1336974245	1	0.0200000000000031	0.00142857142857165	10273	1
4	Food 2	Intake 4	20	246732	1336977597	/users/cn/jespinosa/phecomp/data/CRG/20120502_FDF_CRG/20120502_FDF_CRG/20120511_FDF_CRG_c12.mtb	4270	2462	WWFF	food_fat	4	246712	1336977577	1	0.0399999999999991	0.00199999999999995	10274	1
4	Drink 1	Intake 1	28	247748	1336978613	/users/cn/jespinosa/phecomp/data/CRG/20120502_FDF_CRG/20120502_FDF_CRG/20120511_FDF_CRG_c12.mtb	1585	NA	WWFF	water	1	247720	1336978585	1	0.12	0.00428571428571429	10275	1
4	Food 2	Intake 4	18	249212	1336980077	/users/cn/jespinosa/phecomp/data/CRG/20120502_FDF_CRG/20120502_FDF_CRG/20120511_FDF_CRG_c12.mtb	4277	13	WWFF	food_fat	4	249194	1336980059	1	0.0600000000000023	0.00333333333333346	10276	1
4	Food 2	Intake 4	82	249307	1336980172	/users/cn/jespinosa/phecomp/data/CRG/20120502_FDF_CRG/20120502_FDF_CRG/20120511_FDF_CRG_c12.mtb	4278	COLL	WWFF	food_fat	4	249225	1336980090	1	0.300000000000001	0.00365853658536587	10277	1
4	Food 1	Intake 3	49	249304	1336980169	/users/cn/jespinosa/phecomp/data/CRG/20120502_FDF_CRG/20120502_FDF_CRG/20120511_FDF_CRG_c12.mtb	3966	179	WWFF	food_fat	3	249255	1336980120	1	0.16	0.00326530612244898	10278	1
4	Drink 1	Intake 1	35	249353	1336980218	/users/cn/jespinosa/phecomp/data/CRG/20120502_FDF_CRG/20120502_FDF_CRG/20120511_FDF_CRG_c12.mtb	1587	NA	WWFF	water	1	249318	1336980183	1	0.1	0.00285714285714286	10279	1
4	Food 2	Intake 4	125	249608	1336980473	/users/cn/jespinosa/phecomp/data/CRG/20120502_FDF_CRG/20120502_FDF_CRG/20120511_FDF_CRG_c12.mtb	4280	COLL	WWFF	food_fat	4	249483	1336980348	1	0.200000000000003	0.00160000000000002	10280	1
4	Food 1	Intake 3	53	249538	1336980403	/users/cn/jespinosa/phecomp/data/CRG/20120502_FDF_CRG/20120502_FDF_CRG/20120511_FDF_CRG_c12.mtb	3969	219	WWFF	food_fat	3	249485	1336980350	1	0.100000000000001	0.00188679245283021	10281	1
4	Food 2	Intake 4	139	249896	1336980761	/users/cn/jespinosa/phecomp/data/CRG/20120502_FDF_CRG/20120502_FDF_CRG/20120511_FDF_CRG_c12.mtb	4283	155	WWFF	food_fat	4	249757	1336980622	1	0.0399999999999991	0.000287769784172655	10282	1
4	Food 1	Intake 3	26	250077	1336980942	/users/cn/jespinosa/phecomp/data/CRG/20120502_FDF_CRG/20120502_FDF_CRG/20120511_FDF_CRG_c12.mtb	3975	668	WWFF	food_fat	3	250051	1336980916	1	0.0400000000000027	0.00153846153846164	10283	1
4	Food 1	Intake 3	32	250777	1336981642	/users/cn/jespinosa/phecomp/data/CRG/20120502_FDF_CRG/20120502_FDF_CRG/20120511_FDF_CRG_c12.mtb	3983	237	WWFF	food_fat	3	250745	1336981610	1	0.0399999999999991	0.00124999999999997	10284	1
4	Food 2	Intake 4	70	251084	1336981949	/users/cn/jespinosa/phecomp/data/CRG/20120502_FDF_CRG/20120502_FDF_CRG/20120511_FDF_CRG_c12.mtb	4291	COLL	WWFF	food_fat	4	251014	1336981879	1	0.0599999999999987	0.000857142857142839	10285	1
4	Food 1	Intake 3	41	251063	1336981928	/users/cn/jespinosa/phecomp/data/CRG/20120502_FDF_CRG/20120502_FDF_CRG/20120511_FDF_CRG_c12.mtb	3985	10391	WWFF	food_fat	3	251022	1336981887	1	0.0399999999999991	0.000975609756097539	10286	1
4	Food 1	Intake 3	76	222	1336992395	/users/cn/jespinosa/phecomp/data/CRG/20120502_FDF_CRG/20120502_FDF_CRG/20120514_FDF_CRG_c12.mtb	4316	233	WWFF	food_fat	3	146	1336992319	1	0.04	0.000526315789473684	10287	1
4	Food 2	Intake 4	131	586	1336992759	/users/cn/jespinosa/phecomp/data/CRG/20120502_FDF_CRG/20120502_FDF_CRG/20120514_FDF_CRG_c12.mtb	4812	COLL	WWFF	food_fat	4	455	1336992628	1	0.16	0.00122137404580153	10288	1
4	Food 1	Intake 3	67	639	1336992812	/users/cn/jespinosa/phecomp/data/CRG/20120502_FDF_CRG/20120502_FDF_CRG/20120514_FDF_CRG_c12.mtb	4318	154	WWFF	food_fat	3	572	1336992745	1	0.02	0.000298507462686567	10289	1
4	Food 1	Intake 3	63	856	1336993029	/users/cn/jespinosa/phecomp/data/CRG/20120502_FDF_CRG/20120502_FDF_CRG/20120514_FDF_CRG_c12.mtb	4319	46	WWFF	food_fat	3	793	1336992966	1	0.52	0.00825396825396825	10290	1
4	Food 1	Intake 3	94	996	1336993169	/users/cn/jespinosa/phecomp/data/CRG/20120502_FDF_CRG/20120502_FDF_CRG/20120514_FDF_CRG_c12.mtb	4320	COLL	WWFF	food_fat	3	902	1336993075	1	0.0600000000000001	0.000638297872340427	10291	1
4	Food 2	Intake 4	14	1008	1336993181	/users/cn/jespinosa/phecomp/data/CRG/20120502_FDF_CRG/20120502_FDF_CRG/20120514_FDF_CRG_c12.mtb	4816	182	WWFF	food_fat	4	994	1336993167	1	0.06	0.00428571428571429	10292	1
4	Food 2	Intake 4	387	1577	1336993750	/users/cn/jespinosa/phecomp/data/CRG/20120502_FDF_CRG/20120502_FDF_CRG/20120514_FDF_CRG_c12.mtb	4818	COLL	WWFF	food_fat	4	1190	1336993363	1	0.64	0.00165374677002584	10293	1
4	Food 1	Intake 3	21	1361	1336993534	/users/cn/jespinosa/phecomp/data/CRG/20120502_FDF_CRG/20120502_FDF_CRG/20120514_FDF_CRG_c12.mtb	4322	61	WWFF	food_fat	3	1340	1336993513	1	0.02	0.000952380952380952	10294	1
4	Food 1	Intake 3	73	1495	1336993668	/users/cn/jespinosa/phecomp/data/CRG/20120502_FDF_CRG/20120502_FDF_CRG/20120514_FDF_CRG_c12.mtb	4323	17	WWFF	food_fat	3	1422	1336993595	1	0.0799999999999998	0.0010958904109589	10295	1
4	Food 1	Intake 3	58	1570	1336993743	/users/cn/jespinosa/phecomp/data/CRG/20120502_FDF_CRG/20120502_FDF_CRG/20120514_FDF_CRG_c12.mtb	4324	240	WWFF	food_fat	3	1512	1336993685	1	0.0800000000000001	0.00137931034482759	10296	1
4	Food 2	Intake 4	53	1863	1336994036	/users/cn/jespinosa/phecomp/data/CRG/20120502_FDF_CRG/20120502_FDF_CRG/20120514_FDF_CRG_c12.mtb	4821	302	WWFF	food_fat	4	1810	1336993983	1	0.0600000000000001	0.00113207547169812	10297	1
4	Drink 1	Intake 1	29	2089	1336994262	/users/cn/jespinosa/phecomp/data/CRG/20120502_FDF_CRG/20120502_FDF_CRG/20120514_FDF_CRG_c12.mtb	1673	NA	WWFF	water	1	2060	1336994233	1	0.1	0.00344827586206897	10298	1
4	Food 2	Intake 4	273	2438	1336994611	/users/cn/jespinosa/phecomp/data/CRG/20120502_FDF_CRG/20120502_FDF_CRG/20120514_FDF_CRG_c12.mtb	4825	87	WWFF	food_fat	4	2165	1336994338	1	0.26	0.000952380952380952	10299	1
4	Food 2	Intake 4	12	2537	1336994710	/users/cn/jespinosa/phecomp/data/CRG/20120502_FDF_CRG/20120502_FDF_CRG/20120514_FDF_CRG_c12.mtb	4827	40	WWFF	food_fat	4	2525	1336994698	1	0.02	0.00166666666666667	10300	1
4	Food 2	Intake 4	36	2613	1336994786	/users/cn/jespinosa/phecomp/data/CRG/20120502_FDF_CRG/20120502_FDF_CRG/20120514_FDF_CRG_c12.mtb	4828	4	WWFF	food_fat	4	2577	1336994750	1	0.26	0.00722222222222222	10301	1
4	Food 2	Intake 4	210	2827	1336995000	/users/cn/jespinosa/phecomp/data/CRG/20120502_FDF_CRG/20120502_FDF_CRG/20120514_FDF_CRG_c12.mtb	4829	COLL	WWFF	food_fat	4	2617	1336994790	1	0.26	0.00123809523809524	10302	1
4	Food 1	Intake 3	76	2791	1336994964	/users/cn/jespinosa/phecomp/data/CRG/20120502_FDF_CRG/20120502_FDF_CRG/20120514_FDF_CRG_c12.mtb	4325	146	WWFF	food_fat	3	2715	1336994888	1	0.28	0.00368421052631579	10303	1
4	Food 2	Intake 4	14	2951	1336995124	/users/cn/jespinosa/phecomp/data/CRG/20120502_FDF_CRG/20120502_FDF_CRG/20120514_FDF_CRG_c12.mtb	4831	904	WWFF	food_fat	4	2937	1336995110	1	0.02	0.00142857142857143	10304	1
4	Food 2	Intake 4	25	3880	1336996053	/users/cn/jespinosa/phecomp/data/CRG/20120502_FDF_CRG/20120502_FDF_CRG/20120514_FDF_CRG_c12.mtb	4837	317	WWFF	food_fat	4	3855	1336996028	1	0.04	0.0016	10305	1
4	Food 2	Intake 4	15	4212	1336996385	/users/cn/jespinosa/phecomp/data/CRG/20120502_FDF_CRG/20120502_FDF_CRG/20120514_FDF_CRG_c12.mtb	4839	1717	WWFF	food_fat	4	4197	1336996370	1	0.02	0.00133333333333333	10306	1
4	Food 2	Intake 4	19	5948	1336998121	/users/cn/jespinosa/phecomp/data/CRG/20120502_FDF_CRG/20120502_FDF_CRG/20120514_FDF_CRG_c12.mtb	4844	521	WWFF	food_fat	4	5929	1336998102	1	0.0800000000000001	0.00421052631578948	10307	1
4	Food 2	Intake 4	49	6518	1336998691	/users/cn/jespinosa/phecomp/data/CRG/20120502_FDF_CRG/20120502_FDF_CRG/20120514_FDF_CRG_c12.mtb	4846	990	WWFF	food_fat	4	6469	1336998642	1	0.02	0.000408163265306122	10308	1
4	Drink 1	Intake 1	23	6497	1336998670	/users/cn/jespinosa/phecomp/data/CRG/20120502_FDF_CRG/20120502_FDF_CRG/20120514_FDF_CRG_c12.mtb	1674	NA	WWFF	water	1	6474	1336998647	1	0.08	0.00347826086956522	10309	1
4	Drink 1	Intake 1	24	7496	1336999669	/users/cn/jespinosa/phecomp/data/CRG/20120502_FDF_CRG/20120502_FDF_CRG/20120514_FDF_CRG_c12.mtb	1675	NA	WWFF	water	1	7472	1336999645	1	0.1	0.00416666666666667	10310	1
4	Food 2	Intake 4	51	7559	1336999732	/users/cn/jespinosa/phecomp/data/CRG/20120502_FDF_CRG/20120502_FDF_CRG/20120514_FDF_CRG_c12.mtb	4851	1341	WWFF	food_fat	4	7508	1336999681	1	0.1	0.00196078431372549	10311	1
4	Food 2	Intake 4	166	9066	1337001239	/users/cn/jespinosa/phecomp/data/CRG/20120502_FDF_CRG/20120502_FDF_CRG/20120514_FDF_CRG_c12.mtb	4856	282	WWFF	food_fat	4	8900	1337001073	1	0.24	0.00144578313253012	10312	1
4	Food 2	Intake 4	14	9362	1337001535	/users/cn/jespinosa/phecomp/data/CRG/20120502_FDF_CRG/20120502_FDF_CRG/20120514_FDF_CRG_c12.mtb	4859	139	WWFF	food_fat	4	9348	1337001521	1	0.0600000000000001	0.00428571428571429	10313	1
4	Food 2	Intake 4	26	9527	1337001700	/users/cn/jespinosa/phecomp/data/CRG/20120502_FDF_CRG/20120502_FDF_CRG/20120514_FDF_CRG_c12.mtb	4860	485	WWFF	food_fat	4	9501	1337001674	1	0.02	0.000769230769230769	10314	1
4	Food 2	Intake 4	54	10066	1337002239	/users/cn/jespinosa/phecomp/data/CRG/20120502_FDF_CRG/20120502_FDF_CRG/20120514_FDF_CRG_c12.mtb	4864	345	WWFF	food_fat	4	10012	1337002185	1	0.54	0.01	10315	1
4	Food 2	Intake 4	31	10442	1337002615	/users/cn/jespinosa/phecomp/data/CRG/20120502_FDF_CRG/20120502_FDF_CRG/20120514_FDF_CRG_c12.mtb	4865	205	WWFF	food_fat	4	10411	1337002584	1	0.0600000000000001	0.00193548387096775	10316	1
4	Food 2	Intake 4	14	10661	1337002834	/users/cn/jespinosa/phecomp/data/CRG/20120502_FDF_CRG/20120502_FDF_CRG/20120514_FDF_CRG_c12.mtb	4866	627	WWFF	food_fat	4	10647	1337002820	1	0.0600000000000001	0.00428571428571429	10317	1
4	Drink 1	Intake 1	17	11074	1337003247	/users/cn/jespinosa/phecomp/data/CRG/20120502_FDF_CRG/20120502_FDF_CRG/20120514_FDF_CRG_c12.mtb	1676	NA	WWFF	water	1	11057	1337003230	1	0.1	0.00588235294117647	10318	1
4	Food 2	Intake 4	14	11302	1337003475	/users/cn/jespinosa/phecomp/data/CRG/20120502_FDF_CRG/20120502_FDF_CRG/20120514_FDF_CRG_c12.mtb	4868	115	WWFF	food_fat	4	11288	1337003461	1	0.04	0.00285714285714286	10319	1
4	Food 2	Intake 4	12	11429	1337003602	/users/cn/jespinosa/phecomp/data/CRG/20120502_FDF_CRG/20120502_FDF_CRG/20120514_FDF_CRG_c12.mtb	4869	843	WWFF	food_fat	4	11417	1337003590	1	0.04	0.00333333333333333	10320	1
4	Food 2	Intake 4	15	12287	1337004460	/users/cn/jespinosa/phecomp/data/CRG/20120502_FDF_CRG/20120502_FDF_CRG/20120514_FDF_CRG_c12.mtb	4872	744	WWFF	food_fat	4	12272	1337004445	1	0.0600000000000001	0.00400000000000001	10321	1
4	Food 2	Intake 4	33	13064	1337005237	/users/cn/jespinosa/phecomp/data/CRG/20120502_FDF_CRG/20120502_FDF_CRG/20120514_FDF_CRG_c12.mtb	4877	359	WWFF	food_fat	4	13031	1337005204	1	0.3	0.00909090909090909	10322	1
4	Food 2	Intake 4	11	13434	1337005607	/users/cn/jespinosa/phecomp/data/CRG/20120502_FDF_CRG/20120502_FDF_CRG/20120514_FDF_CRG_c12.mtb	4878	748	WWFF	food_fat	4	13423	1337005596	1	0.02	0.00181818181818182	10323	1
4	Food 2	Intake 4	26	14208	1337006381	/users/cn/jespinosa/phecomp/data/CRG/20120502_FDF_CRG/20120502_FDF_CRG/20120514_FDF_CRG_c12.mtb	4880	587	WWFF	food_fat	4	14182	1337006355	1	0.1	0.00384615384615385	10324	1
4	Food 2	Intake 4	24	14819	1337006992	/users/cn/jespinosa/phecomp/data/CRG/20120502_FDF_CRG/20120502_FDF_CRG/20120514_FDF_CRG_c12.mtb	4882	194	WWFF	food_fat	4	14795	1337006968	1	0.04	0.00166666666666667	10325	1
4	Food 2	Intake 4	33	15046	1337007219	/users/cn/jespinosa/phecomp/data/CRG/20120502_FDF_CRG/20120502_FDF_CRG/20120514_FDF_CRG_c12.mtb	4883	384	WWFF	food_fat	4	15013	1337007186	1	0.02	0.000606060606060606	10326	1
4	Drink 1	Intake 1	18	15329	1337007502	/users/cn/jespinosa/phecomp/data/CRG/20120502_FDF_CRG/20120502_FDF_CRG/20120514_FDF_CRG_c12.mtb	1677	NA	WWFF	water	1	15311	1337007484	1	0.08	0.00444444444444444	10327	1
4	Food 2	Intake 4	11	15441	1337007614	/users/cn/jespinosa/phecomp/data/CRG/20120502_FDF_CRG/20120502_FDF_CRG/20120514_FDF_CRG_c12.mtb	4885	1096	WWFF	food_fat	4	15430	1337007603	1	0.02	0.00181818181818182	10328	1
4	Food 2	Intake 4	23	16560	1337008733	/users/cn/jespinosa/phecomp/data/CRG/20120502_FDF_CRG/20120502_FDF_CRG/20120514_FDF_CRG_c12.mtb	4891	1021	WWFF	food_fat	4	16537	1337008710	1	0.72	0.031304347826087	10329	1
4	Drink 1	Intake 1	14	17579	1337009752	/users/cn/jespinosa/phecomp/data/CRG/20120502_FDF_CRG/20120502_FDF_CRG/20120514_FDF_CRG_c12.mtb	1678	NA	WWFF	water	1	17565	1337009738	1	0.08	0.00571428571428571	10330	1
4	Food 2	Intake 4	15	17596	1337009769	/users/cn/jespinosa/phecomp/data/CRG/20120502_FDF_CRG/20120502_FDF_CRG/20120514_FDF_CRG_c12.mtb	4895	380	WWFF	food_fat	4	17581	1337009754	1	0.02	0.00133333333333333	10331	1
4	Food 2	Intake 4	10	17986	1337010159	/users/cn/jespinosa/phecomp/data/CRG/20120502_FDF_CRG/20120502_FDF_CRG/20120514_FDF_CRG_c12.mtb	4896	258	WWFF	food_fat	4	17976	1337010149	1	0.04	0.004	10332	1
4	Food 2	Intake 4	9	18253	1337010426	/users/cn/jespinosa/phecomp/data/CRG/20120502_FDF_CRG/20120502_FDF_CRG/20120514_FDF_CRG_c12.mtb	4899	773	WWFF	food_fat	4	18244	1337010417	1	0.04	0.00444444444444444	10333	1
4	Food 2	Intake 4	27	19053	1337011226	/users/cn/jespinosa/phecomp/data/CRG/20120502_FDF_CRG/20120502_FDF_CRG/20120514_FDF_CRG_c12.mtb	4902	461	WWFF	food_fat	4	19026	1337011199	1	0.02	0.000740740740740741	10334	1
4	Food 2	Intake 4	273	19787	1337011960	/users/cn/jespinosa/phecomp/data/CRG/20120502_FDF_CRG/20120502_FDF_CRG/20120514_FDF_CRG_c12.mtb	4906	30	WWFF	food_fat	4	19514	1337011687	1	0.12	0.00043956043956044	10335	1
4	Food 2	Intake 4	102	19919	1337012092	/users/cn/jespinosa/phecomp/data/CRG/20120502_FDF_CRG/20120502_FDF_CRG/20120514_FDF_CRG_c12.mtb	4907	2254	WWFF	food_fat	4	19817	1337011990	1	0.02	0.000196078431372549	10336	1
4	Drink 1	Intake 1	30	20548	1337012721	/users/cn/jespinosa/phecomp/data/CRG/20120502_FDF_CRG/20120502_FDF_CRG/20120514_FDF_CRG_c12.mtb	1679	NA	WWFF	water	1	20518	1337012691	1	0.12	0.004	10337	1
4	Food 2	Intake 4	14	22187	1337014360	/users/cn/jespinosa/phecomp/data/CRG/20120502_FDF_CRG/20120502_FDF_CRG/20120514_FDF_CRG_c12.mtb	4915	649	WWFF	food_fat	4	22173	1337014346	1	0.0600000000000001	0.00428571428571429	10338	1
4	Food 2	Intake 4	17	22853	1337015026	/users/cn/jespinosa/phecomp/data/CRG/20120502_FDF_CRG/20120502_FDF_CRG/20120514_FDF_CRG_c12.mtb	4917	662	WWFF	food_fat	4	22836	1337015009	1	0.02	0.00117647058823529	10339	1
4	Food 2	Intake 4	53	23568	1337015741	/users/cn/jespinosa/phecomp/data/CRG/20120502_FDF_CRG/20120502_FDF_CRG/20120514_FDF_CRG_c12.mtb	4920	664	WWFF	food_fat	4	23515	1337015688	1	0.42	0.00792452830188679	10340	1
4	Food 2	Intake 4	50	24282	1337016455	/users/cn/jespinosa/phecomp/data/CRG/20120502_FDF_CRG/20120502_FDF_CRG/20120514_FDF_CRG_c12.mtb	4927	302	WWFF	food_fat	4	24232	1337016405	1	0.04	0.0008	10341	1
4	Food 2	Intake 4	111	24695	1337016868	/users/cn/jespinosa/phecomp/data/CRG/20120502_FDF_CRG/20120502_FDF_CRG/20120514_FDF_CRG_c12.mtb	4930	942	WWFF	food_fat	4	24584	1337016757	1	0.04	0.00036036036036036	10342	1
4	Drink 1	Intake 1	23	24652	1337016825	/users/cn/jespinosa/phecomp/data/CRG/20120502_FDF_CRG/20120502_FDF_CRG/20120514_FDF_CRG_c12.mtb	1680	NA	WWFF	water	1	24629	1337016802	1	0.02	0.000869565217391304	10343	1
4	Food 2	Intake 4	55	25692	1337017865	/users/cn/jespinosa/phecomp/data/CRG/20120502_FDF_CRG/20120502_FDF_CRG/20120514_FDF_CRG_c12.mtb	4935	277	WWFF	food_fat	4	25637	1337017810	1	0.02	0.000363636363636364	10344	1
4	Drink 1	Intake 1	31	25675	1337017848	/users/cn/jespinosa/phecomp/data/CRG/20120502_FDF_CRG/20120502_FDF_CRG/20120514_FDF_CRG_c12.mtb	1681	NA	WWFF	water	1	25644	1337017817	1	0.12	0.00387096774193548	10345	1
4	Food 2	Intake 4	125	26094	1337018267	/users/cn/jespinosa/phecomp/data/CRG/20120502_FDF_CRG/20120502_FDF_CRG/20120514_FDF_CRG_c12.mtb	4937	622	WWFF	food_fat	4	25969	1337018142	1	0.02	0.00016	10346	1
4	Food 2	Intake 4	426	27142	1337019315	/users/cn/jespinosa/phecomp/data/CRG/20120502_FDF_CRG/20120502_FDF_CRG/20120514_FDF_CRG_c12.mtb	4941	COLL	WWFF	food_fat	4	26716	1337018889	1	0.18	0.000422535211267606	10347	1
4	Food 1	Intake 3	85	26950	1337019123	/users/cn/jespinosa/phecomp/data/CRG/20120502_FDF_CRG/20120502_FDF_CRG/20120514_FDF_CRG_c12.mtb	4328	96	WWFF	food_fat	3	26865	1337019038	1	0.24	0.00282352941176471	10348	1
4	Food 1	Intake 3	93	27139	1337019312	/users/cn/jespinosa/phecomp/data/CRG/20120502_FDF_CRG/20120502_FDF_CRG/20120514_FDF_CRG_c12.mtb	4331	19	WWFF	food_fat	3	27046	1337019219	1	0.04	0.00043010752688172	10349	1
4	Food 2	Intake 4	599	27757	1337019930	/users/cn/jespinosa/phecomp/data/CRG/20120502_FDF_CRG/20120502_FDF_CRG/20120514_FDF_CRG_c12.mtb	4942	COLL	WWFF	food_fat	4	27158	1337019331	1	0.46	0.000767946577629382	10350	1
4	Food 1	Intake 3	71	27388	1337019561	/users/cn/jespinosa/phecomp/data/CRG/20120502_FDF_CRG/20120502_FDF_CRG/20120514_FDF_CRG_c12.mtb	4332	175	WWFF	food_fat	3	27317	1337019490	1	0.2	0.0028169014084507	10351	1
4	Food 1	Intake 3	113	27676	1337019849	/users/cn/jespinosa/phecomp/data/CRG/20120502_FDF_CRG/20120502_FDF_CRG/20120514_FDF_CRG_c12.mtb	4334	43	WWFF	food_fat	3	27563	1337019736	1	0.6	0.00530973451327434	10352	1
4	Food 1	Intake 3	29	27748	1337019921	/users/cn/jespinosa/phecomp/data/CRG/20120502_FDF_CRG/20120502_FDF_CRG/20120514_FDF_CRG_c12.mtb	4335	37	WWFF	food_fat	3	27719	1337019892	1	0.26	0.00896551724137931	10353	1
4	Food 2	Intake 4	244	28029	1337020202	/users/cn/jespinosa/phecomp/data/CRG/20120502_FDF_CRG/20120502_FDF_CRG/20120514_FDF_CRG_c12.mtb	4943	COLL	WWFF	food_fat	4	27785	1337019958	1	0.0800000000000001	0.000327868852459017	10354	1
4	Food 1	Intake 3	25	27842	1337020015	/users/cn/jespinosa/phecomp/data/CRG/20120502_FDF_CRG/20120502_FDF_CRG/20120514_FDF_CRG_c12.mtb	4336	36	WWFF	food_fat	3	27817	1337019990	1	0.04	0.0016	10355	1
4	Food 1	Intake 3	149	28027	1337020200	/users/cn/jespinosa/phecomp/data/CRG/20120502_FDF_CRG/20120502_FDF_CRG/20120514_FDF_CRG_c12.mtb	4337	101	WWFF	food_fat	3	27878	1337020051	1	0.12	0.000805369127516779	10356	1
4	Food 2	Intake 4	364	28492	1337020665	/users/cn/jespinosa/phecomp/data/CRG/20120502_FDF_CRG/20120502_FDF_CRG/20120514_FDF_CRG_c12.mtb	4944	COLL	WWFF	food_fat	4	28128	1337020301	1	0.4	0.0010989010989011	10357	1
4	Food 1	Intake 3	67	28313	1337020486	/users/cn/jespinosa/phecomp/data/CRG/20120502_FDF_CRG/20120502_FDF_CRG/20120514_FDF_CRG_c12.mtb	4338	77	WWFF	food_fat	3	28246	1337020419	1	0.04	0.000597014925373134	10358	1
4	Food 1	Intake 3	100	28490	1337020663	/users/cn/jespinosa/phecomp/data/CRG/20120502_FDF_CRG/20120502_FDF_CRG/20120514_FDF_CRG_c12.mtb	4339	35	WWFF	food_fat	3	28390	1337020563	1	0.42	0.0042	10359	1
4	Food 2	Intake 4	409	28934	1337021107	/users/cn/jespinosa/phecomp/data/CRG/20120502_FDF_CRG/20120502_FDF_CRG/20120514_FDF_CRG_c12.mtb	4945	COLL	WWFF	food_fat	4	28525	1337020698	1	0.62	0.0015158924205379	10360	1
4	Food 1	Intake 3	17	28712	1337020885	/users/cn/jespinosa/phecomp/data/CRG/20120502_FDF_CRG/20120502_FDF_CRG/20120514_FDF_CRG_c12.mtb	4341	171	WWFF	food_fat	3	28695	1337020868	1	0.04	0.00235294117647059	10361	1
4	Food 1	Intake 3	49	28932	1337021105	/users/cn/jespinosa/phecomp/data/CRG/20120502_FDF_CRG/20120502_FDF_CRG/20120514_FDF_CRG_c12.mtb	4342	51	WWFF	food_fat	3	28883	1337021056	1	0.02	0.000408163265306122	10362	1
4	Food 2	Intake 4	217	29200	1337021373	/users/cn/jespinosa/phecomp/data/CRG/20120502_FDF_CRG/20120502_FDF_CRG/20120514_FDF_CRG_c12.mtb	4946	34	WWFF	food_fat	4	28983	1337021156	1	0.36	0.00165898617511521	10363	1
4	Food 2	Intake 4	266	29500	1337021673	/users/cn/jespinosa/phecomp/data/CRG/20120502_FDF_CRG/20120502_FDF_CRG/20120514_FDF_CRG_c12.mtb	4947	COLL	WWFF	food_fat	4	29234	1337021407	1	0.0800000000000001	0.000300751879699248	10364	1
4	Food 1	Intake 3	115	29486	1337021659	/users/cn/jespinosa/phecomp/data/CRG/20120502_FDF_CRG/20120502_FDF_CRG/20120514_FDF_CRG_c12.mtb	4345	271	WWFF	food_fat	3	29371	1337021544	1	0.56	0.0048695652173913	10365	1
4	Food 2	Intake 4	242	29999	1337022172	/users/cn/jespinosa/phecomp/data/CRG/20120502_FDF_CRG/20120502_FDF_CRG/20120514_FDF_CRG_c12.mtb	4951	25	WWFF	food_fat	4	29757	1337021930	1	0.02	8.26446280991736e-05	10366	1
4	Food 2	Intake 4	115	30139	1337022312	/users/cn/jespinosa/phecomp/data/CRG/20120502_FDF_CRG/20120502_FDF_CRG/20120514_FDF_CRG_c12.mtb	4952	COLL	WWFF	food_fat	4	30024	1337022197	1	0.0399999999999996	0.000347826086956518	10367	1
4	Food 1	Intake 3	56	30116	1337022289	/users/cn/jespinosa/phecomp/data/CRG/20120502_FDF_CRG/20120502_FDF_CRG/20120514_FDF_CRG_c12.mtb	4347	32	WWFF	food_fat	3	30060	1337022233	1	0.04	0.000714285714285714	10368	1
4	Food 2	Intake 4	271	30419	1337022592	/users/cn/jespinosa/phecomp/data/CRG/20120502_FDF_CRG/20120502_FDF_CRG/20120514_FDF_CRG_c12.mtb	4953	COLL	WWFF	food_fat	4	30148	1337022321	1	0.600000000000001	0.00221402214022141	10369	1
4	Drink 1	Intake 1	15	30170	1337022343	/users/cn/jespinosa/phecomp/data/CRG/20120502_FDF_CRG/20120502_FDF_CRG/20120514_FDF_CRG_c12.mtb	1683	NA	WWFF	water	1	30155	1337022328	1	0.0399999999999999	0.00266666666666666	10370	1
4	Food 1	Intake 3	109	30406	1337022579	/users/cn/jespinosa/phecomp/data/CRG/20120502_FDF_CRG/20120502_FDF_CRG/20120514_FDF_CRG_c12.mtb	4349	22	WWFF	food_fat	3	30297	1337022470	1	0.42	0.00385321100917431	10371	1
4	Food 2	Intake 4	271	30699	1337022872	/users/cn/jespinosa/phecomp/data/CRG/20120502_FDF_CRG/20120502_FDF_CRG/20120514_FDF_CRG_c12.mtb	4954	391	WWFF	food_fat	4	30428	1337022601	1	0.12	0.00044280442804428	10372	1
4	Drink 1	Intake 1	20	30786	1337022959	/users/cn/jespinosa/phecomp/data/CRG/20120502_FDF_CRG/20120502_FDF_CRG/20120514_FDF_CRG_c12.mtb	1684	NA	WWFF	water	1	30766	1337022939	1	0.04	0.002	10373	1
4	Food 2	Intake 4	198	31288	1337023461	/users/cn/jespinosa/phecomp/data/CRG/20120502_FDF_CRG/20120502_FDF_CRG/20120514_FDF_CRG_c12.mtb	4956	256	WWFF	food_fat	4	31090	1337023263	1	0.4	0.00202020202020202	10374	1
4	Food 1	Intake 3	177	31721	1337023894	/users/cn/jespinosa/phecomp/data/CRG/20120502_FDF_CRG/20120502_FDF_CRG/20120514_FDF_CRG_c12.mtb	4354	11	WWFF	food_fat	3	31544	1337023717	1	0.48	0.00271186440677966	10375	1
4	Food 1	Intake 3	55	31787	1337023960	/users/cn/jespinosa/phecomp/data/CRG/20120502_FDF_CRG/20120502_FDF_CRG/20120514_FDF_CRG_c12.mtb	4355	32	WWFF	food_fat	3	31732	1337023905	1	0.0200000000000005	0.000363636363636373	10376	1
4	Food 2	Intake 4	387	32206	1337024379	/users/cn/jespinosa/phecomp/data/CRG/20120502_FDF_CRG/20120502_FDF_CRG/20120514_FDF_CRG_c12.mtb	4959	145	WWFF	food_fat	4	31819	1337023992	1	0.779999999999999	0.00201550387596899	10377	1
4	Food 2	Intake 4	138	32489	1337024662	/users/cn/jespinosa/phecomp/data/CRG/20120502_FDF_CRG/20120502_FDF_CRG/20120514_FDF_CRG_c12.mtb	4961	15	WWFF	food_fat	4	32351	1337024524	1	0.04	0.000289855072463768	10378	1
4	Food 2	Intake 4	128	32632	1337024805	/users/cn/jespinosa/phecomp/data/CRG/20120502_FDF_CRG/20120502_FDF_CRG/20120514_FDF_CRG_c12.mtb	4962	97	WWFF	food_fat	4	32504	1337024677	1	0.0200000000000005	0.000156250000000004	10379	1
4	Food 2	Intake 4	241	32970	1337025143	/users/cn/jespinosa/phecomp/data/CRG/20120502_FDF_CRG/20120502_FDF_CRG/20120514_FDF_CRG_c12.mtb	4964	141	WWFF	food_fat	4	32729	1337024902	1	0.180000000000001	0.000746887966804983	10380	1
4	Food 2	Intake 4	544	33655	1337025828	/users/cn/jespinosa/phecomp/data/CRG/20120502_FDF_CRG/20120502_FDF_CRG/20120514_FDF_CRG_c12.mtb	4965	4	WWFF	food_fat	4	33111	1337025284	1	0.84	0.00154411764705882	10381	1
4	Food 2	Intake 4	162	33821	1337025994	/users/cn/jespinosa/phecomp/data/CRG/20120502_FDF_CRG/20120502_FDF_CRG/20120514_FDF_CRG_c12.mtb	4966	311	WWFF	food_fat	4	33659	1337025832	1	0.28	0.0017283950617284	10382	1
4	Food 2	Intake 4	205	34337	1337026510	/users/cn/jespinosa/phecomp/data/CRG/20120502_FDF_CRG/20120502_FDF_CRG/20120514_FDF_CRG_c12.mtb	4967	COLL	WWFF	food_fat	4	34132	1337026305	1	0.239999999999999	0.00117073170731707	10383	1
4	Drink 2	Intake 2	16	34223	1337026396	/users/cn/jespinosa/phecomp/data/CRG/20120502_FDF_CRG/20120502_FDF_CRG/20120514_FDF_CRG_c12.mtb	1579	NA	WWFF	water	2	34207	1337026380	1	0.06	0.00375	10384	1
4	Food 1	Intake 3	50	34330	1337026503	/users/cn/jespinosa/phecomp/data/CRG/20120502_FDF_CRG/20120502_FDF_CRG/20120514_FDF_CRG_c12.mtb	4361	381	WWFF	food_fat	3	34280	1337026453	1	0.0200000000000005	0.00040000000000001	10385	1
4	Food 2	Intake 4	46	34757	1337026930	/users/cn/jespinosa/phecomp/data/CRG/20120502_FDF_CRG/20120502_FDF_CRG/20120514_FDF_CRG_c12.mtb	4969	121	WWFF	food_fat	4	34711	1337026884	1	0.0600000000000005	0.00130434782608697	10386	1
4	Drink 1	Intake 1	18	34749	1337026922	/users/cn/jespinosa/phecomp/data/CRG/20120502_FDF_CRG/20120502_FDF_CRG/20120514_FDF_CRG_c12.mtb	1686	NA	WWFF	water	1	34731	1337026904	1	0.04	0.00222222222222222	10387	1
4	Food 2	Intake 4	10	34888	1337027061	/users/cn/jespinosa/phecomp/data/CRG/20120502_FDF_CRG/20120502_FDF_CRG/20120514_FDF_CRG_c12.mtb	4971	98	WWFF	food_fat	4	34878	1337027051	1	0.04	0.004	10388	1
4	Food 2	Intake 4	533	35519	1337027692	/users/cn/jespinosa/phecomp/data/CRG/20120502_FDF_CRG/20120502_FDF_CRG/20120514_FDF_CRG_c12.mtb	4973	39	WWFF	food_fat	4	34986	1337027159	1	0.12	0.000225140712945591	10389	1
4	Food 2	Intake 4	20	35578	1337027751	/users/cn/jespinosa/phecomp/data/CRG/20120502_FDF_CRG/20120502_FDF_CRG/20120514_FDF_CRG_c12.mtb	4974	64	WWFF	food_fat	4	35558	1337027731	1	0.0200000000000005	0.00100000000000002	10390	1
4	Food 2	Intake 4	145	35787	1337027960	/users/cn/jespinosa/phecomp/data/CRG/20120502_FDF_CRG/20120502_FDF_CRG/20120514_FDF_CRG_c12.mtb	4975	143	WWFF	food_fat	4	35642	1337027815	1	0.26	0.00179310344827586	10391	1
4	Food 2	Intake 4	67	35997	1337028170	/users/cn/jespinosa/phecomp/data/CRG/20120502_FDF_CRG/20120502_FDF_CRG/20120514_FDF_CRG_c12.mtb	4977	671	WWFF	food_fat	4	35930	1337028103	1	0.0600000000000005	0.000895522388059709	10392	1
4	Food 2	Intake 4	60	36728	1337028901	/users/cn/jespinosa/phecomp/data/CRG/20120502_FDF_CRG/20120502_FDF_CRG/20120514_FDF_CRG_c12.mtb	4984	182	WWFF	food_fat	4	36668	1337028841	1	0.04	0.000666666666666667	10393	1
4	Drink 2	Intake 2	18	36689	1337028862	/users/cn/jespinosa/phecomp/data/CRG/20120502_FDF_CRG/20120502_FDF_CRG/20120514_FDF_CRG_c12.mtb	1580	NA	WWFF	water	2	36671	1337028844	1	0.04	0.00222222222222222	10394	1
4	Food 2	Intake 4	58	36968	1337029141	/users/cn/jespinosa/phecomp/data/CRG/20120502_FDF_CRG/20120502_FDF_CRG/20120514_FDF_CRG_c12.mtb	4986	340	WWFF	food_fat	4	36910	1337029083	1	0.0200000000000005	0.000344827586206905	10395	1
4	Food 2	Intake 4	22	37330	1337029503	/users/cn/jespinosa/phecomp/data/CRG/20120502_FDF_CRG/20120502_FDF_CRG/20120514_FDF_CRG_c12.mtb	4988	736	WWFF	food_fat	4	37308	1337029481	1	0.04	0.00181818181818182	10396	1
4	Food 2	Intake 4	13	38079	1337030252	/users/cn/jespinosa/phecomp/data/CRG/20120502_FDF_CRG/20120502_FDF_CRG/20120514_FDF_CRG_c12.mtb	4990	400	WWFF	food_fat	4	38066	1337030239	1	0.0399999999999991	0.00307692307692301	10397	1
4	Food 2	Intake 4	14	38493	1337030666	/users/cn/jespinosa/phecomp/data/CRG/20120502_FDF_CRG/20120502_FDF_CRG/20120514_FDF_CRG_c12.mtb	4991	412	WWFF	food_fat	4	38479	1337030652	1	0.0400000000000009	0.00285714285714292	10398	1
4	Drink 1	Intake 1	16	38651	1337030824	/users/cn/jespinosa/phecomp/data/CRG/20120502_FDF_CRG/20120502_FDF_CRG/20120514_FDF_CRG_c12.mtb	1688	NA	WWFF	water	1	38635	1337030808	1	0.08	0.005	10399	1
4	Food 2	Intake 4	17	38922	1337031095	/users/cn/jespinosa/phecomp/data/CRG/20120502_FDF_CRG/20120502_FDF_CRG/20120514_FDF_CRG_c12.mtb	4994	522	WWFF	food_fat	4	38905	1337031078	1	0.0400000000000009	0.00235294117647064	10400	1
4	Food 2	Intake 4	26	39470	1337031643	/users/cn/jespinosa/phecomp/data/CRG/20120502_FDF_CRG/20120502_FDF_CRG/20120514_FDF_CRG_c12.mtb	4997	2019	WWFF	food_fat	4	39444	1337031617	1	0.04	0.00153846153846154	10401	1
4	Food 2	Intake 4	21	41510	1337033683	/users/cn/jespinosa/phecomp/data/CRG/20120502_FDF_CRG/20120502_FDF_CRG/20120514_FDF_CRG_c12.mtb	5010	1847	WWFF	food_fat	4	41489	1337033662	1	0.0200000000000005	0.000952380952380976	10402	1
4	Drink 1	Intake 1	11	42025	1337034198	/users/cn/jespinosa/phecomp/data/CRG/20120502_FDF_CRG/20120502_FDF_CRG/20120514_FDF_CRG_c12.mtb	1690	NA	WWFF	water	1	42014	1337034187	1	0.0600000000000001	0.00545454545454546	10403	1
4	Drink 1	Intake 1	13	43101	1337035274	/users/cn/jespinosa/phecomp/data/CRG/20120502_FDF_CRG/20120502_FDF_CRG/20120514_FDF_CRG_c12.mtb	1691	NA	WWFF	water	1	43088	1337035261	1	0.02	0.00153846153846154	10404	1
4	Food 2	Intake 4	12	43369	1337035542	/users/cn/jespinosa/phecomp/data/CRG/20120502_FDF_CRG/20120502_FDF_CRG/20120514_FDF_CRG_c12.mtb	5018	291	WWFF	food_fat	4	43357	1337035530	1	0.04	0.00333333333333333	10405	1
4	Food 2	Intake 4	15	43675	1337035848	/users/cn/jespinosa/phecomp/data/CRG/20120502_FDF_CRG/20120502_FDF_CRG/20120514_FDF_CRG_c12.mtb	5020	547	WWFF	food_fat	4	43660	1337035833	1	0.0200000000000005	0.00133333333333337	10406	1
4	Food 2	Intake 4	12	44234	1337036407	/users/cn/jespinosa/phecomp/data/CRG/20120502_FDF_CRG/20120502_FDF_CRG/20120514_FDF_CRG_c12.mtb	5024	1066	WWFF	food_fat	4	44222	1337036395	1	0.04	0.00333333333333333	10407	1
4	Food 2	Intake 4	56	45356	1337037529	/users/cn/jespinosa/phecomp/data/CRG/20120502_FDF_CRG/20120502_FDF_CRG/20120514_FDF_CRG_c12.mtb	5030	445	WWFF	food_fat	4	45300	1337037473	1	0.04	0.000714285714285714	10408	1
4	Drink 1	Intake 1	16	45321	1337037494	/users/cn/jespinosa/phecomp/data/CRG/20120502_FDF_CRG/20120502_FDF_CRG/20120514_FDF_CRG_c12.mtb	1693	NA	WWFF	water	1	45305	1337037478	1	0.04	0.0025	10409	1
4	Food 2	Intake 4	279	46080	1337038253	/users/cn/jespinosa/phecomp/data/CRG/20120502_FDF_CRG/20120502_FDF_CRG/20120514_FDF_CRG_c12.mtb	5035	32	WWFF	food_fat	4	45801	1337037974	1	0.36	0.00129032258064516	10410	1
4	Food 2	Intake 4	181	46293	1337038466	/users/cn/jespinosa/phecomp/data/CRG/20120502_FDF_CRG/20120502_FDF_CRG/20120514_FDF_CRG_c12.mtb	5036	COLL	WWFF	food_fat	4	46112	1337038285	1	0.100000000000001	0.000552486187845309	10411	1
4	Food 1	Intake 3	142	46284	1337038457	/users/cn/jespinosa/phecomp/data/CRG/20120502_FDF_CRG/20120502_FDF_CRG/20120514_FDF_CRG_c12.mtb	4366	37	WWFF	food_fat	3	46142	1337038315	1	0.04	0.00028169014084507	10412	1
4	Food 2	Intake 4	330	46651	1337038824	/users/cn/jespinosa/phecomp/data/CRG/20120502_FDF_CRG/20120502_FDF_CRG/20120514_FDF_CRG_c12.mtb	5037	COLL	WWFF	food_fat	4	46321	1337038494	1	0.0399999999999991	0.000121212121212118	10413	1
4	Food 1	Intake 3	123	46557	1337038730	/users/cn/jespinosa/phecomp/data/CRG/20120502_FDF_CRG/20120502_FDF_CRG/20120514_FDF_CRG_c12.mtb	4367	7	WWFF	food_fat	3	46434	1337038607	1	0.18	0.00146341463414634	10414	1
4	Food 1	Intake 3	83	46647	1337038820	/users/cn/jespinosa/phecomp/data/CRG/20120502_FDF_CRG/20120502_FDF_CRG/20120514_FDF_CRG_c12.mtb	4368	66	WWFF	food_fat	3	46564	1337038737	1	0.0200000000000005	0.000240963855421693	10415	1
4	Drink 2	Intake 2	18	46703	1337038876	/users/cn/jespinosa/phecomp/data/CRG/20120502_FDF_CRG/20120502_FDF_CRG/20120514_FDF_CRG_c12.mtb	1581	NA	WWFF	water	2	46685	1337038858	1	0.04	0.00222222222222222	10416	1
4	Food 1	Intake 3	217	46930	1337039103	/users/cn/jespinosa/phecomp/data/CRG/20120502_FDF_CRG/20120502_FDF_CRG/20120514_FDF_CRG_c12.mtb	4369	249	WWFF	food_fat	3	46713	1337038886	1	0.119999999999999	0.000552995391705064	10417	1
4	Food 2	Intake 4	14	47193	1337039366	/users/cn/jespinosa/phecomp/data/CRG/20120502_FDF_CRG/20120502_FDF_CRG/20120514_FDF_CRG_c12.mtb	5041	160	WWFF	food_fat	4	47179	1337039352	1	0.159999999999999	0.0114285714285714	10418	1
4	Food 2	Intake 4	248	47601	1337039774	/users/cn/jespinosa/phecomp/data/CRG/20120502_FDF_CRG/20120502_FDF_CRG/20120514_FDF_CRG_c12.mtb	5043	COLL	WWFF	food_fat	4	47353	1337039526	1	0.16	0.000645161290322581	10419	1
4	Food 1	Intake 3	17	47397	1337039570	/users/cn/jespinosa/phecomp/data/CRG/20120502_FDF_CRG/20120502_FDF_CRG/20120514_FDF_CRG_c12.mtb	4370	239	WWFF	food_fat	3	47380	1337039553	1	0.0200000000000005	0.00117647058823532	10420	1
4	Food 2	Intake 4	307	47943	1337040116	/users/cn/jespinosa/phecomp/data/CRG/20120502_FDF_CRG/20120502_FDF_CRG/20120514_FDF_CRG_c12.mtb	5044	COLL	WWFF	food_fat	4	47636	1337039809	1	0.32	0.00104234527687296	10421	1
4	Food 1	Intake 3	51	47852	1337040025	/users/cn/jespinosa/phecomp/data/CRG/20120502_FDF_CRG/20120502_FDF_CRG/20120514_FDF_CRG_c12.mtb	4372	15	WWFF	food_fat	3	47801	1337039974	1	0.0599999999999996	0.00117647058823529	10422	1
4	Food 1	Intake 3	75	47942	1337040115	/users/cn/jespinosa/phecomp/data/CRG/20120502_FDF_CRG/20120502_FDF_CRG/20120514_FDF_CRG_c12.mtb	4373	67	WWFF	food_fat	3	47867	1337040040	1	0.0200000000000005	0.000266666666666673	10423	1
4	Food 2	Intake 4	281	48290	1337040463	/users/cn/jespinosa/phecomp/data/CRG/20120502_FDF_CRG/20120502_FDF_CRG/20120514_FDF_CRG_c12.mtb	5045	49	WWFF	food_fat	4	48009	1337040182	1	0.42	0.00149466192170819	10424	1
4	Drink 2	Intake 2	18	48054	1337040227	/users/cn/jespinosa/phecomp/data/CRG/20120502_FDF_CRG/20120502_FDF_CRG/20120514_FDF_CRG_c12.mtb	1583	NA	WWFF	water	2	48036	1337040209	1	0.04	0.00222222222222222	10425	1
4	Food 2	Intake 4	137	48476	1337040649	/users/cn/jespinosa/phecomp/data/CRG/20120502_FDF_CRG/20120502_FDF_CRG/20120514_FDF_CRG_c12.mtb	5046	45	WWFF	food_fat	4	48339	1337040512	1	0.0600000000000005	0.000437956204379566	10426	1
4	Drink 1	Intake 1	18	48496	1337040669	/users/cn/jespinosa/phecomp/data/CRG/20120502_FDF_CRG/20120502_FDF_CRG/20120514_FDF_CRG_c12.mtb	1695	NA	WWFF	water	1	48478	1337040651	1	0.0399999999999998	0.00222222222222221	10427	1
4	Food 2	Intake 4	256	48777	1337040950	/users/cn/jespinosa/phecomp/data/CRG/20120502_FDF_CRG/20120502_FDF_CRG/20120514_FDF_CRG_c12.mtb	5048	828	WWFF	food_fat	4	48521	1337040694	1	0.459999999999999	0.001796875	10428	1
4	Food 2	Intake 4	218	49823	1337041996	/users/cn/jespinosa/phecomp/data/CRG/20120502_FDF_CRG/20120502_FDF_CRG/20120514_FDF_CRG_c12.mtb	5058	221	WWFF	food_fat	4	49605	1337041778	1	0.18	0.000825688073394495	10429	1
4	Drink 1	Intake 1	17	49704	1337041877	/users/cn/jespinosa/phecomp/data/CRG/20120502_FDF_CRG/20120502_FDF_CRG/20120514_FDF_CRG_c12.mtb	1696	NA	WWFF	water	1	49687	1337041860	1	0.04	0.00235294117647059	10430	1
4	Food 2	Intake 4	120	50164	1337042337	/users/cn/jespinosa/phecomp/data/CRG/20120502_FDF_CRG/20120502_FDF_CRG/20120514_FDF_CRG_c12.mtb	5061	23	WWFF	food_fat	4	50044	1337042217	1	0.0200000000000014	0.000166666666666678	10431	1
4	Food 2	Intake 4	189	50376	1337042549	/users/cn/jespinosa/phecomp/data/CRG/20120502_FDF_CRG/20120502_FDF_CRG/20120514_FDF_CRG_c12.mtb	5062	120	WWFF	food_fat	4	50187	1337042360	1	0.0399999999999991	0.000211640211640207	10432	1
4	Food 2	Intake 4	43	50539	1337042712	/users/cn/jespinosa/phecomp/data/CRG/20120502_FDF_CRG/20120502_FDF_CRG/20120514_FDF_CRG_c12.mtb	5064	70	WWFF	food_fat	4	50496	1337042669	1	0.34	0.00790697674418605	10433	1
4	Food 2	Intake 4	26	50635	1337042808	/users/cn/jespinosa/phecomp/data/CRG/20120502_FDF_CRG/20120502_FDF_CRG/20120514_FDF_CRG_c12.mtb	5067	90	WWFF	food_fat	4	50609	1337042782	1	0.0999999999999996	0.00384615384615383	10434	1
4	Food 2	Intake 4	26	50751	1337042924	/users/cn/jespinosa/phecomp/data/CRG/20120502_FDF_CRG/20120502_FDF_CRG/20120514_FDF_CRG_c12.mtb	5069	143	WWFF	food_fat	4	50725	1337042898	1	0.299999999999999	0.0115384615384615	10435	1
4	Food 2	Intake 4	370	51264	1337043437	/users/cn/jespinosa/phecomp/data/CRG/20120502_FDF_CRG/20120502_FDF_CRG/20120514_FDF_CRG_c12.mtb	5072	654	WWFF	food_fat	4	50894	1337043067	1	0.0200000000000014	5.40540540540578e-05	10436	1
4	Food 2	Intake 4	83	52001	1337044174	/users/cn/jespinosa/phecomp/data/CRG/20120502_FDF_CRG/20120502_FDF_CRG/20120514_FDF_CRG_c12.mtb	5079	4850	WWFF	food_fat	4	51918	1337044091	1	0.34	0.00409638554216867	10437	1
4	Drink 1	Intake 1	14	53638	1337045811	/users/cn/jespinosa/phecomp/data/CRG/20120502_FDF_CRG/20120502_FDF_CRG/20120514_FDF_CRG_c12.mtb	1697	NA	WWFF	water	1	53624	1337045797	1	0.0800000000000001	0.00571428571428572	10438	1
4	Drink 2	Intake 2	18	55969	1337048142	/users/cn/jespinosa/phecomp/data/CRG/20120502_FDF_CRG/20120502_FDF_CRG/20120514_FDF_CRG_c12.mtb	1584	NA	WWFF	water	2	55951	1337048124	1	0.02	0.00111111111111111	10439	1
4	Drink 1	Intake 1	17	55977	1337048150	/users/cn/jespinosa/phecomp/data/CRG/20120502_FDF_CRG/20120502_FDF_CRG/20120514_FDF_CRG_c12.mtb	1698	NA	WWFF	water	1	55960	1337048133	1	0.02	0.00117647058823529	10440	1
4	Food 2	Intake 4	69	56920	1337049093	/users/cn/jespinosa/phecomp/data/CRG/20120502_FDF_CRG/20120502_FDF_CRG/20120514_FDF_CRG_c12.mtb	5099	551	WWFF	food_fat	4	56851	1337049024	1	0.319999999999999	0.00463768115942028	10441	1
4	Food 2	Intake 4	33	57504	1337049677	/users/cn/jespinosa/phecomp/data/CRG/20120502_FDF_CRG/20120502_FDF_CRG/20120514_FDF_CRG_c12.mtb	5101	1662	WWFF	food_fat	4	57471	1337049644	1	0.0400000000000009	0.00121212121212124	10442	1
4	Drink 1	Intake 1	16	57901	1337050074	/users/cn/jespinosa/phecomp/data/CRG/20120502_FDF_CRG/20120502_FDF_CRG/20120514_FDF_CRG_c12.mtb	1699	NA	WWFF	water	1	57885	1337050058	1	0.02	0.00125	10443	1
4	Food 2	Intake 4	37	59203	1337051376	/users/cn/jespinosa/phecomp/data/CRG/20120502_FDF_CRG/20120502_FDF_CRG/20120514_FDF_CRG_c12.mtb	5105	587	WWFF	food_fat	4	59166	1337051339	1	0.0399999999999991	0.00108108108108106	10444	1
4	Drink 1	Intake 1	19	59196	1337051369	/users/cn/jespinosa/phecomp/data/CRG/20120502_FDF_CRG/20120502_FDF_CRG/20120514_FDF_CRG_c12.mtb	1700	NA	WWFF	water	1	59177	1337051350	1	0.0599999999999998	0.00315789473684209	10445	1
4	Food 2	Intake 4	12	59802	1337051975	/users/cn/jespinosa/phecomp/data/CRG/20120502_FDF_CRG/20120502_FDF_CRG/20120514_FDF_CRG_c12.mtb	5107	1612	WWFF	food_fat	4	59790	1337051963	1	0.0200000000000014	0.00166666666666678	10446	1
4	Drink 1	Intake 1	22	60304	1337052477	/users/cn/jespinosa/phecomp/data/CRG/20120502_FDF_CRG/20120502_FDF_CRG/20120514_FDF_CRG_c12.mtb	1701	NA	WWFF	water	1	60282	1337052455	1	0.04	0.00181818181818182	10447	1
4	Food 2	Intake 4	272	61686	1337053859	/users/cn/jespinosa/phecomp/data/CRG/20120502_FDF_CRG/20120502_FDF_CRG/20120514_FDF_CRG_c12.mtb	5116	2556	WWFF	food_fat	4	61414	1337053587	1	0.619999999999999	0.00227941176470588	10448	1
4	Drink 1	Intake 1	22	61743	1337053916	/users/cn/jespinosa/phecomp/data/CRG/20120502_FDF_CRG/20120502_FDF_CRG/20120514_FDF_CRG_c12.mtb	1702	NA	WWFF	water	1	61721	1337053894	1	0.12	0.00545454545454545	10449	1
4	Food 2	Intake 4	371	64613	1337056786	/users/cn/jespinosa/phecomp/data/CRG/20120502_FDF_CRG/20120502_FDF_CRG/20120514_FDF_CRG_c12.mtb	5123	15	WWFF	food_fat	4	64242	1337056415	1	0.0800000000000001	0.000215633423180593	10450	1
4	Food 2	Intake 4	118	64746	1337056919	/users/cn/jespinosa/phecomp/data/CRG/20120502_FDF_CRG/20120502_FDF_CRG/20120514_FDF_CRG_c12.mtb	5124	22	WWFF	food_fat	4	64628	1337056801	1	0.119999999999999	0.00101694915254236	10451	1
4	Food 2	Intake 4	148	64916	1337057089	/users/cn/jespinosa/phecomp/data/CRG/20120502_FDF_CRG/20120502_FDF_CRG/20120514_FDF_CRG_c12.mtb	5125	COLL	WWFF	food_fat	4	64768	1337056941	1	0.0200000000000014	0.000135135135135145	10452	1
4	Food 1	Intake 3	23	64920	1337057093	/users/cn/jespinosa/phecomp/data/CRG/20120502_FDF_CRG/20120502_FDF_CRG/20120514_FDF_CRG_c12.mtb	4382	128	WWFF	food_fat	3	64897	1337057070	1	0.0200000000000005	0.000869565217391326	10453	1
4	Food 1	Intake 3	63	65111	1337057284	/users/cn/jespinosa/phecomp/data/CRG/20120502_FDF_CRG/20120502_FDF_CRG/20120514_FDF_CRG_c12.mtb	4384	COLL	WWFF	food_fat	3	65048	1337057221	1	0.04	0.000634920634920635	10454	1
4	Food 2	Intake 4	48	65128	1337057301	/users/cn/jespinosa/phecomp/data/CRG/20120502_FDF_CRG/20120502_FDF_CRG/20120514_FDF_CRG_c12.mtb	5127	42	WWFF	food_fat	4	65080	1337057253	1	0.119999999999999	0.00249999999999998	10455	1
4	Drink 2	Intake 2	24	65141	1337057314	/users/cn/jespinosa/phecomp/data/CRG/20120502_FDF_CRG/20120502_FDF_CRG/20120514_FDF_CRG_c12.mtb	1585	NA	WWFF	water	2	65117	1337057290	1	0.12	0.005	10456	1
4	Food 2	Intake 4	98	65268	1337057441	/users/cn/jespinosa/phecomp/data/CRG/20120502_FDF_CRG/20120502_FDF_CRG/20120514_FDF_CRG_c12.mtb	5129	60	WWFF	food_fat	4	65170	1337057343	1	0.0800000000000001	0.000816326530612246	10457	1
4	Food 2	Intake 4	105	65433	1337057606	/users/cn/jespinosa/phecomp/data/CRG/20120502_FDF_CRG/20120502_FDF_CRG/20120514_FDF_CRG_c12.mtb	5131	124	WWFF	food_fat	4	65328	1337057501	1	0.299999999999999	0.00285714285714285	10458	1
4	Food 2	Intake 4	174	65731	1337057904	/users/cn/jespinosa/phecomp/data/CRG/20120502_FDF_CRG/20120502_FDF_CRG/20120514_FDF_CRG_c12.mtb	5133	846	WWFF	food_fat	4	65557	1337057730	1	0.140000000000001	0.000804597701149431	10459	1
4	Drink 2	Intake 2	21	65820	1337057993	/users/cn/jespinosa/phecomp/data/CRG/20120502_FDF_CRG/20120502_FDF_CRG/20120514_FDF_CRG_c12.mtb	1586	NA	WWFF	water	2	65799	1337057972	1	0.04	0.0019047619047619	10460	1
4	Drink 1	Intake 1	18	66466	1337058639	/users/cn/jespinosa/phecomp/data/CRG/20120502_FDF_CRG/20120502_FDF_CRG/20120514_FDF_CRG_c12.mtb	1704	NA	WWFF	water	1	66448	1337058621	1	0.02	0.00111111111111111	10461	1
4	Food 2	Intake 4	126	66703	1337058876	/users/cn/jespinosa/phecomp/data/CRG/20120502_FDF_CRG/20120502_FDF_CRG/20120514_FDF_CRG_c12.mtb	5138	105	WWFF	food_fat	4	66577	1337058750	1	0.139999999999999	0.0011111111111111	10462	1
4	Food 2	Intake 4	61	66869	1337059042	/users/cn/jespinosa/phecomp/data/CRG/20120502_FDF_CRG/20120502_FDF_CRG/20120514_FDF_CRG_c12.mtb	5140	361	WWFF	food_fat	4	66808	1337058981	1	0.120000000000001	0.00196721311475411	10463	1
4	Food 2	Intake 4	190	67420	1337059593	/users/cn/jespinosa/phecomp/data/CRG/20120502_FDF_CRG/20120502_FDF_CRG/20120514_FDF_CRG_c12.mtb	5143	3135	WWFF	food_fat	4	67230	1337059403	1	0.260000000000002	0.00136842105263159	10464	1
4	Drink 1	Intake 1	22	69643	1337061816	/users/cn/jespinosa/phecomp/data/CRG/20120502_FDF_CRG/20120502_FDF_CRG/20120514_FDF_CRG_c12.mtb	1705	NA	WWFF	water	1	69621	1337061794	1	0.0800000000000001	0.00363636363636364	10465	1
4	Food 2	Intake 4	12	70567	1337062740	/users/cn/jespinosa/phecomp/data/CRG/20120502_FDF_CRG/20120502_FDF_CRG/20120514_FDF_CRG_c12.mtb	5148	731	WWFF	food_fat	4	70555	1337062728	1	0.0200000000000014	0.00166666666666678	10466	1
4	Drink 1	Intake 1	15	70730	1337062903	/users/cn/jespinosa/phecomp/data/CRG/20120502_FDF_CRG/20120502_FDF_CRG/20120514_FDF_CRG_c12.mtb	1706	NA	WWFF	water	1	70715	1337062888	1	0.02	0.00133333333333333	10467	1
4	Food 2	Intake 4	12	71310	1337063483	/users/cn/jespinosa/phecomp/data/CRG/20120502_FDF_CRG/20120502_FDF_CRG/20120514_FDF_CRG_c12.mtb	5150	847	WWFF	food_fat	4	71298	1337063471	1	0.0400000000000009	0.00333333333333341	10468	1
4	Food 2	Intake 4	20	72177	1337064350	/users/cn/jespinosa/phecomp/data/CRG/20120502_FDF_CRG/20120502_FDF_CRG/20120514_FDF_CRG_c12.mtb	5152	2637	WWFF	food_fat	4	72157	1337064330	1	0.0399999999999991	0.00199999999999995	10469	1
4	Drink 1	Intake 1	17	72674	1337064847	/users/cn/jespinosa/phecomp/data/CRG/20120502_FDF_CRG/20120502_FDF_CRG/20120514_FDF_CRG_c12.mtb	1707	NA	WWFF	water	1	72657	1337064830	1	0.0799999999999998	0.00470588235294116	10470	1
4	Drink 1	Intake 1	15	74541	1337066714	/users/cn/jespinosa/phecomp/data/CRG/20120502_FDF_CRG/20120502_FDF_CRG/20120514_FDF_CRG_c12.mtb	1708	NA	WWFF	water	1	74526	1337066699	1	0.0600000000000001	0.00400000000000001	10471	1
4	Food 2	Intake 4	20	74834	1337067007	/users/cn/jespinosa/phecomp/data/CRG/20120502_FDF_CRG/20120502_FDF_CRG/20120514_FDF_CRG_c12.mtb	5155	8088	WWFF	food_fat	4	74814	1337066987	1	0.0200000000000014	0.00100000000000007	10472	1
4	Drink 1	Intake 1	29	79643	1337071816	/users/cn/jespinosa/phecomp/data/CRG/20120502_FDF_CRG/20120502_FDF_CRG/20120514_FDF_CRG_c12.mtb	1710	NA	WWFF	water	1	79614	1337071787	1	0.1	0.00344827586206897	10473	1
4	Drink 1	Intake 1	22	80893	1337073066	/users/cn/jespinosa/phecomp/data/CRG/20120502_FDF_CRG/20120502_FDF_CRG/20120514_FDF_CRG_c12.mtb	1711	NA	WWFF	water	1	80871	1337073044	1	0.0800000000000001	0.00363636363636364	10474	1
4	Food 2	Intake 4	170	83092	1337075265	/users/cn/jespinosa/phecomp/data/CRG/20120502_FDF_CRG/20120502_FDF_CRG/20120514_FDF_CRG_c12.mtb	5164	12	WWFF	food_fat	4	82922	1337075095	1	0.219999999999999	0.00129411764705882	10475	1
4	Drink 2	Intake 2	28	82962	1337075135	/users/cn/jespinosa/phecomp/data/CRG/20120502_FDF_CRG/20120502_FDF_CRG/20120514_FDF_CRG_c12.mtb	1588	NA	WWFF	water	2	82934	1337075107	1	0.02	0.000714285714285714	10476	1
4	Food 2	Intake 4	340	83444	1337075617	/users/cn/jespinosa/phecomp/data/CRG/20120502_FDF_CRG/20120502_FDF_CRG/20120514_FDF_CRG_c12.mtb	5165	1829	WWFF	food_fat	4	83104	1337075277	1	0.0400000000000009	0.000117647058823532	10477	1
4	Drink 1	Intake 1	17	83338	1337075511	/users/cn/jespinosa/phecomp/data/CRG/20120502_FDF_CRG/20120502_FDF_CRG/20120514_FDF_CRG_c12.mtb	1712	NA	WWFF	water	1	83321	1337075494	1	0.02	0.00117647058823529	10478	1
4	Drink 2	Intake 2	111	83861	1337076034	/users/cn/jespinosa/phecomp/data/CRG/20120502_FDF_CRG/20120502_FDF_CRG/20120514_FDF_CRG_c12.mtb	1589	NA	WWFF	water	2	83750	1337075923	1	0.02	0.00018018018018018	10479	1
4	Food 2	Intake 4	52	85325	1337077498	/users/cn/jespinosa/phecomp/data/CRG/20120502_FDF_CRG/20120502_FDF_CRG/20120514_FDF_CRG_c12.mtb	5175	9532	WWFF	food_fat	4	85273	1337077446	1	0.0200000000000014	0.000384615384615412	10480	1
4	Drink 1	Intake 1	20	88724	1337080897	/users/cn/jespinosa/phecomp/data/CRG/20120502_FDF_CRG/20120502_FDF_CRG/20120514_FDF_CRG_c12.mtb	1714	NA	WWFF	water	1	88704	1337080877	1	0.12	0.006	10481	1
4	Drink 1	Intake 1	26	92815	1337084988	/users/cn/jespinosa/phecomp/data/CRG/20120502_FDF_CRG/20120502_FDF_CRG/20120514_FDF_CRG_c12.mtb	1715	NA	WWFF	water	1	92789	1337084962	1	0.1	0.00384615384615385	10482	1
4	Food 2	Intake 4	17	94874	1337087047	/users/cn/jespinosa/phecomp/data/CRG/20120502_FDF_CRG/20120502_FDF_CRG/20120514_FDF_CRG_c12.mtb	5181	626	WWFF	food_fat	4	94857	1337087030	1	0.0800000000000001	0.00470588235294118	10483	1
4	Food 2	Intake 4	11	95511	1337087684	/users/cn/jespinosa/phecomp/data/CRG/20120502_FDF_CRG/20120502_FDF_CRG/20120514_FDF_CRG_c12.mtb	5182	613	WWFF	food_fat	4	95500	1337087673	1	0.0399999999999991	0.00363636363636355	10484	1
4	Drink 1	Intake 1	30	95746	1337087919	/users/cn/jespinosa/phecomp/data/CRG/20120502_FDF_CRG/20120502_FDF_CRG/20120514_FDF_CRG_c12.mtb	1716	NA	WWFF	water	1	95716	1337087889	1	0.12	0.004	10485	1
4	Food 2	Intake 4	11	96135	1337088308	/users/cn/jespinosa/phecomp/data/CRG/20120502_FDF_CRG/20120502_FDF_CRG/20120514_FDF_CRG_c12.mtb	5183	12472	WWFF	food_fat	4	96124	1337088297	1	0.0200000000000014	0.00181818181818195	10486	1
4	Drink 1	Intake 1	11	99345	1337091518	/users/cn/jespinosa/phecomp/data/CRG/20120502_FDF_CRG/20120502_FDF_CRG/20120514_FDF_CRG_c12.mtb	1717	NA	WWFF	water	1	99334	1337091507	1	0.02	0.00181818181818182	10487	1
4	Drink 1	Intake 1	22	102286	1337094459	/users/cn/jespinosa/phecomp/data/CRG/20120502_FDF_CRG/20120502_FDF_CRG/20120514_FDF_CRG_c12.mtb	1718	NA	WWFF	water	1	102264	1337094437	1	0.12	0.00545454545454545	10488	1
4	Drink 1	Intake 1	26	105986	1337098159	/users/cn/jespinosa/phecomp/data/CRG/20120502_FDF_CRG/20120502_FDF_CRG/20120514_FDF_CRG_c12.mtb	1719	NA	WWFF	water	1	105960	1337098133	1	0.1	0.00384615384615385	10489	1
4	Food 2	Intake 4	24	108631	1337100804	/users/cn/jespinosa/phecomp/data/CRG/20120502_FDF_CRG/20120502_FDF_CRG/20120514_FDF_CRG_c12.mtb	5193	2730	WWFF	food_fat	4	108607	1337100780	1	0.0200000000000014	0.000833333333333392	10490	1
4	Drink 1	Intake 1	18	110835	1337103008	/users/cn/jespinosa/phecomp/data/CRG/20120502_FDF_CRG/20120502_FDF_CRG/20120514_FDF_CRG_c12.mtb	1720	NA	WWFF	water	1	110817	1337102990	1	0.0600000000000001	0.00333333333333334	10491	1
4	Food 2	Intake 4	43	111404	1337103577	/users/cn/jespinosa/phecomp/data/CRG/20120502_FDF_CRG/20120502_FDF_CRG/20120514_FDF_CRG_c12.mtb	5199	41	WWFF	food_fat	4	111361	1337103534	1	0.100000000000001	0.00232558139534886	10492	1
4	Food 2	Intake 4	129	111574	1337103747	/users/cn/jespinosa/phecomp/data/CRG/20120502_FDF_CRG/20120502_FDF_CRG/20120514_FDF_CRG_c12.mtb	5201	2487	WWFF	food_fat	4	111445	1337103618	1	0.0999999999999996	0.000775193798449609	10493	1
4	Drink 1	Intake 1	20	112723	1337104896	/users/cn/jespinosa/phecomp/data/CRG/20120502_FDF_CRG/20120502_FDF_CRG/20120514_FDF_CRG_c12.mtb	1722	NA	WWFF	water	1	112703	1337104876	1	0.0599999999999996	0.00299999999999998	10494	1
4	Food 2	Intake 4	279	114340	1337106513	/users/cn/jespinosa/phecomp/data/CRG/20120502_FDF_CRG/20120502_FDF_CRG/20120514_FDF_CRG_c12.mtb	5206	36	WWFF	food_fat	4	114061	1337106234	1	0.0600000000000005	0.000215053763440862	10495	1
4	Food 2	Intake 4	123	114499	1337106672	/users/cn/jespinosa/phecomp/data/CRG/20120502_FDF_CRG/20120502_FDF_CRG/20120514_FDF_CRG_c12.mtb	5207	127	WWFF	food_fat	4	114376	1337106549	1	0.18	0.00146341463414634	10496	1
4	Food 2	Intake 4	119	114745	1337106918	/users/cn/jespinosa/phecomp/data/CRG/20120502_FDF_CRG/20120502_FDF_CRG/20120514_FDF_CRG_c12.mtb	5208	COLL	WWFF	food_fat	4	114626	1337106799	1	0.26	0.00218487394957983	10497	1
4	Food 1	Intake 3	54	114697	1337106870	/users/cn/jespinosa/phecomp/data/CRG/20120502_FDF_CRG/20120502_FDF_CRG/20120514_FDF_CRG_c12.mtb	4397	62	WWFF	food_fat	3	114643	1337106816	1	0.0200000000000005	0.00037037037037038	10498	1
4	Food 2	Intake 4	379	115138	1337107311	/users/cn/jespinosa/phecomp/data/CRG/20120502_FDF_CRG/20120502_FDF_CRG/20120514_FDF_CRG_c12.mtb	5209	211	WWFF	food_fat	4	114759	1337106932	1	0.0800000000000001	0.000211081794195251	10499	1
4	Food 2	Intake 4	161	115510	1337107683	/users/cn/jespinosa/phecomp/data/CRG/20120502_FDF_CRG/20120502_FDF_CRG/20120514_FDF_CRG_c12.mtb	5211	81	WWFF	food_fat	4	115349	1337107522	1	0.0800000000000001	0.000496894409937889	10500	1
4	Food 2	Intake 4	260	115851	1337108024	/users/cn/jespinosa/phecomp/data/CRG/20120502_FDF_CRG/20120502_FDF_CRG/20120514_FDF_CRG_c12.mtb	5213	121	WWFF	food_fat	4	115591	1337107764	1	0.16	0.000615384615384615	10501	1
4	Food 2	Intake 4	81	116053	1337108226	/users/cn/jespinosa/phecomp/data/CRG/20120502_FDF_CRG/20120502_FDF_CRG/20120514_FDF_CRG_c12.mtb	5215	93	WWFF	food_fat	4	115972	1337108145	1	0.119999999999999	0.00148148148148147	10502	1
4	Food 2	Intake 4	123	116269	1337108442	/users/cn/jespinosa/phecomp/data/CRG/20120502_FDF_CRG/20120502_FDF_CRG/20120514_FDF_CRG_c12.mtb	5217	4	WWFF	food_fat	4	116146	1337108319	1	0.0800000000000001	0.000650406504065041	10503	1
4	Food 2	Intake 4	23	116296	1337108469	/users/cn/jespinosa/phecomp/data/CRG/20120502_FDF_CRG/20120502_FDF_CRG/20120514_FDF_CRG_c12.mtb	5218	207	WWFF	food_fat	4	116273	1337108446	1	0.0200000000000014	0.000869565217391365	10504	1
4	Food 2	Intake 4	163	116666	1337108839	/users/cn/jespinosa/phecomp/data/CRG/20120502_FDF_CRG/20120502_FDF_CRG/20120514_FDF_CRG_c12.mtb	5221	185	WWFF	food_fat	4	116503	1337108676	1	0.199999999999999	0.00122699386503067	10505	1
4	Food 2	Intake 4	132	116983	1337109156	/users/cn/jespinosa/phecomp/data/CRG/20120502_FDF_CRG/20120502_FDF_CRG/20120514_FDF_CRG_c12.mtb	5222	72	WWFF	food_fat	4	116851	1337109024	1	0.140000000000001	0.00106060606060607	10506	1
4	Food 2	Intake 4	52	117107	1337109280	/users/cn/jespinosa/phecomp/data/CRG/20120502_FDF_CRG/20120502_FDF_CRG/20120514_FDF_CRG_c12.mtb	5224	493	WWFF	food_fat	4	117055	1337109228	1	0.0399999999999991	0.000769230769230752	10507	1
4	Food 2	Intake 4	99	117699	1337109872	/users/cn/jespinosa/phecomp/data/CRG/20120502_FDF_CRG/20120502_FDF_CRG/20120514_FDF_CRG_c12.mtb	5228	14	WWFF	food_fat	4	117600	1337109773	1	0.0800000000000001	0.000808080808080809	10508	1
4	Food 2	Intake 4	242	117955	1337110128	/users/cn/jespinosa/phecomp/data/CRG/20120502_FDF_CRG/20120502_FDF_CRG/20120514_FDF_CRG_c12.mtb	5229	95	WWFF	food_fat	4	117713	1337109886	1	0.279999999999999	0.00115702479338843	10509	1
4	Food 2	Intake 4	122	118172	1337110345	/users/cn/jespinosa/phecomp/data/CRG/20120502_FDF_CRG/20120502_FDF_CRG/20120514_FDF_CRG_c12.mtb	5230	COLL	WWFF	food_fat	4	118050	1337110223	1	0.120000000000001	0.000983606557377057	10510	1
4	Food 1	Intake 3	54	118170	1337110343	/users/cn/jespinosa/phecomp/data/CRG/20120502_FDF_CRG/20120502_FDF_CRG/20120514_FDF_CRG_c12.mtb	4404	48	WWFF	food_fat	3	118116	1337110289	1	0.0200000000000005	0.00037037037037038	10511	1
4	Food 2	Intake 4	126	118344	1337110517	/users/cn/jespinosa/phecomp/data/CRG/20120502_FDF_CRG/20120502_FDF_CRG/20120514_FDF_CRG_c12.mtb	5231	49	WWFF	food_fat	4	118218	1337110391	1	0.0800000000000001	0.000634920634920636	10512	1
4	Drink 2	Intake 2	21	118407	1337110580	/users/cn/jespinosa/phecomp/data/CRG/20120502_FDF_CRG/20120502_FDF_CRG/20120514_FDF_CRG_c12.mtb	1601	NA	WWFF	water	2	118386	1337110559	1	0.02	0.000952380952380952	10513	1
4	Food 2	Intake 4	128	118521	1337110694	/users/cn/jespinosa/phecomp/data/CRG/20120502_FDF_CRG/20120502_FDF_CRG/20120514_FDF_CRG_c12.mtb	5233	43	WWFF	food_fat	4	118393	1337110566	1	0.0799999999999983	0.000624999999999987	10514	1
4	Food 2	Intake 4	177	118741	1337110914	/users/cn/jespinosa/phecomp/data/CRG/20120502_FDF_CRG/20120502_FDF_CRG/20120514_FDF_CRG_c12.mtb	5234	30	WWFF	food_fat	4	118564	1337110737	1	0.140000000000001	0.000790960451977407	10515	1
4	Food 2	Intake 4	182	118953	1337111126	/users/cn/jespinosa/phecomp/data/CRG/20120502_FDF_CRG/20120502_FDF_CRG/20120514_FDF_CRG_c12.mtb	5235	42	WWFF	food_fat	4	118771	1337110944	1	0.120000000000001	0.000659340659340665	10516	1
4	Food 2	Intake 4	89	119084	1337111257	/users/cn/jespinosa/phecomp/data/CRG/20120502_FDF_CRG/20120502_FDF_CRG/20120514_FDF_CRG_c12.mtb	5236	126	WWFF	food_fat	4	118995	1337111168	1	0.0999999999999996	0.00112359550561797	10517	1
4	Food 2	Intake 4	184	119394	1337111567	/users/cn/jespinosa/phecomp/data/CRG/20120502_FDF_CRG/20120502_FDF_CRG/20120514_FDF_CRG_c12.mtb	5238	5	WWFF	food_fat	4	119210	1337111383	1	0.359999999999999	0.00195652173913043	10518	1
4	Drink 2	Intake 2	18	119287	1337111460	/users/cn/jespinosa/phecomp/data/CRG/20120502_FDF_CRG/20120502_FDF_CRG/20120514_FDF_CRG_c12.mtb	1603	NA	WWFF	water	2	119269	1337111442	1	0.04	0.00222222222222222	10519	1
4	Food 2	Intake 4	192	119591	1337111764	/users/cn/jespinosa/phecomp/data/CRG/20120502_FDF_CRG/20120502_FDF_CRG/20120514_FDF_CRG_c12.mtb	5239	25	WWFF	food_fat	4	119399	1337111572	1	0.380000000000001	0.00197916666666667	10520	1
4	Food 2	Intake 4	206	119822	1337111995	/users/cn/jespinosa/phecomp/data/CRG/20120502_FDF_CRG/20120502_FDF_CRG/20120514_FDF_CRG_c12.mtb	5240	COLL	WWFF	food_fat	4	119616	1337111789	1	0.139999999999999	0.000679611650485432	10521	1
4	Food 1	Intake 3	57	119822	1337111995	/users/cn/jespinosa/phecomp/data/CRG/20120502_FDF_CRG/20120502_FDF_CRG/20120514_FDF_CRG_c12.mtb	4407	120	WWFF	food_fat	3	119765	1337111938	1	0.04	0.000701754385964912	10522	1
4	Food 2	Intake 4	118	120060	1337112233	/users/cn/jespinosa/phecomp/data/CRG/20120502_FDF_CRG/20120502_FDF_CRG/20120514_FDF_CRG_c12.mtb	5242	272	WWFF	food_fat	4	119942	1337112115	1	0.0200000000000014	0.000169491525423741	10523	1
4	Drink 2	Intake 2	21	120196	1337112369	/users/cn/jespinosa/phecomp/data/CRG/20120502_FDF_CRG/20120502_FDF_CRG/20120514_FDF_CRG_c12.mtb	1605	NA	WWFF	water	2	120175	1337112348	1	0.04	0.0019047619047619	10524	1
4	Food 2	Intake 4	184	120516	1337112689	/users/cn/jespinosa/phecomp/data/CRG/20120502_FDF_CRG/20120502_FDF_CRG/20120514_FDF_CRG_c12.mtb	5244	715	WWFF	food_fat	4	120332	1337112505	1	0.0999999999999996	0.000543478260869563	10525	1
4	Drink 1	Intake 1	36	120686	1337112859	/users/cn/jespinosa/phecomp/data/CRG/20120502_FDF_CRG/20120502_FDF_CRG/20120514_FDF_CRG_c12.mtb	1726	NA	WWFF	water	1	120650	1337112823	1	0.04	0.00111111111111111	10526	1
4	Drink 2	Intake 2	63	120740	1337112913	/users/cn/jespinosa/phecomp/data/CRG/20120502_FDF_CRG/20120502_FDF_CRG/20120514_FDF_CRG_c12.mtb	1606	NA	WWFF	water	2	120677	1337112850	1	0.0599999999999999	0.000952380952380951	10527	1
4	Food 2	Intake 4	37	121268	1337113441	/users/cn/jespinosa/phecomp/data/CRG/20120502_FDF_CRG/20120502_FDF_CRG/20120514_FDF_CRG_c12.mtb	5248	79	WWFF	food_fat	4	121231	1337113404	1	0.0599999999999987	0.00162162162162159	10528	1
4	Food 2	Intake 4	139	121486	1337113659	/users/cn/jespinosa/phecomp/data/CRG/20120502_FDF_CRG/20120502_FDF_CRG/20120514_FDF_CRG_c12.mtb	5250	75	WWFF	food_fat	4	121347	1337113520	1	0.379999999999999	0.00273381294964028	10529	1
4	Food 2	Intake 4	235	121796	1337113969	/users/cn/jespinosa/phecomp/data/CRG/20120502_FDF_CRG/20120502_FDF_CRG/20120514_FDF_CRG_c12.mtb	5251	327	WWFF	food_fat	4	121561	1337113734	1	0.0400000000000009	0.000170212765957451	10530	1
4	Drink 2	Intake 2	32	121736	1337113909	/users/cn/jespinosa/phecomp/data/CRG/20120502_FDF_CRG/20120502_FDF_CRG/20120514_FDF_CRG_c12.mtb	1608	NA	WWFF	water	2	121704	1337113877	1	0.02	0.000625	10531	1
4	Food 2	Intake 4	17	122140	1337114313	/users/cn/jespinosa/phecomp/data/CRG/20120502_FDF_CRG/20120502_FDF_CRG/20120514_FDF_CRG_c12.mtb	5254	91	WWFF	food_fat	4	122123	1337114296	1	0.139999999999999	0.008235294117647	10532	1
4	Food 1	Intake 3	76	122307	1337114480	/users/cn/jespinosa/phecomp/data/CRG/20120502_FDF_CRG/20120502_FDF_CRG/20120514_FDF_CRG_c12.mtb	4412	COLL	WWFF	food_fat	3	122231	1337114404	1	0.04	0.000526315789473684	10533	1
4	Food 2	Intake 4	134	122399	1337114572	/users/cn/jespinosa/phecomp/data/CRG/20120502_FDF_CRG/20120502_FDF_CRG/20120514_FDF_CRG_c12.mtb	5256	22	WWFF	food_fat	4	122265	1337114438	1	0.0999999999999996	0.000746268656716415	10534	1
4	Food 2	Intake 4	102	122523	1337114696	/users/cn/jespinosa/phecomp/data/CRG/20120502_FDF_CRG/20120502_FDF_CRG/20120514_FDF_CRG_c12.mtb	5257	90	WWFF	food_fat	4	122421	1337114594	1	0.0200000000000014	0.000196078431372563	10535	1
4	Food 2	Intake 4	23	122636	1337114809	/users/cn/jespinosa/phecomp/data/CRG/20120502_FDF_CRG/20120502_FDF_CRG/20120514_FDF_CRG_c12.mtb	5260	337	WWFF	food_fat	4	122613	1337114786	1	0.0599999999999987	0.00260869565217386	10536	1
4	Food 2	Intake 4	126	123099	1337115272	/users/cn/jespinosa/phecomp/data/CRG/20120502_FDF_CRG/20120502_FDF_CRG/20120514_FDF_CRG_c12.mtb	5262	159	WWFF	food_fat	4	122973	1337115146	1	0.140000000000001	0.00111111111111112	10537	1
4	Food 2	Intake 4	36	123294	1337115467	/users/cn/jespinosa/phecomp/data/CRG/20120502_FDF_CRG/20120502_FDF_CRG/20120514_FDF_CRG_c12.mtb	5264	546	WWFF	food_fat	4	123258	1337115431	1	0.0400000000000009	0.00111111111111114	10538	1
4	Food 2	Intake 4	161	124001	1337116174	/users/cn/jespinosa/phecomp/data/CRG/20120502_FDF_CRG/20120502_FDF_CRG/20120514_FDF_CRG_c12.mtb	5271	101	WWFF	food_fat	4	123840	1337116013	1	0.140000000000001	0.000869565217391311	10539	1
4	Food 2	Intake 4	55	124157	1337116330	/users/cn/jespinosa/phecomp/data/CRG/20120502_FDF_CRG/20120502_FDF_CRG/20120514_FDF_CRG_c12.mtb	5272	386	WWFF	food_fat	4	124102	1337116275	1	0.0400000000000009	0.000727272727272744	10540	1
4	Drink 1	Intake 1	18	124399	1337116572	/users/cn/jespinosa/phecomp/data/CRG/20120502_FDF_CRG/20120502_FDF_CRG/20120514_FDF_CRG_c12.mtb	1731	NA	WWFF	water	1	124381	1337116554	1	0.04	0.00222222222222222	10541	1
4	Food 2	Intake 4	94	124637	1337116810	/users/cn/jespinosa/phecomp/data/CRG/20120502_FDF_CRG/20120502_FDF_CRG/20120514_FDF_CRG_c12.mtb	5274	292	WWFF	food_fat	4	124543	1337116716	1	0.120000000000001	0.00127659574468086	10542	1
4	Drink 2	Intake 2	35	124683	1337116856	/users/cn/jespinosa/phecomp/data/CRG/20120502_FDF_CRG/20120502_FDF_CRG/20120514_FDF_CRG_c12.mtb	1611	NA	WWFF	water	2	124648	1337116821	1	0.02	0.000571428571428571	10543	1
4	Drink 2	Intake 2	31	124731	1337116904	/users/cn/jespinosa/phecomp/data/CRG/20120502_FDF_CRG/20120502_FDF_CRG/20120514_FDF_CRG_c12.mtb	1612	NA	WWFF	water	2	124700	1337116873	1	0.02	0.000645161290322581	10544	1
4	Food 2	Intake 4	224	125153	1337117326	/users/cn/jespinosa/phecomp/data/CRG/20120502_FDF_CRG/20120502_FDF_CRG/20120514_FDF_CRG_c12.mtb	5278	445	WWFF	food_fat	4	124929	1337117102	1	0.139999999999999	0.000624999999999995	10545	1
4	Drink 2	Intake 2	36	125537	1337117710	/users/cn/jespinosa/phecomp/data/CRG/20120502_FDF_CRG/20120502_FDF_CRG/20120514_FDF_CRG_c12.mtb	1614	NA	WWFF	water	2	125501	1337117674	1	0.02	0.000555555555555556	10546	1
4	Food 2	Intake 4	16	125614	1337117787	/users/cn/jespinosa/phecomp/data/CRG/20120502_FDF_CRG/20120502_FDF_CRG/20120514_FDF_CRG_c12.mtb	5282	45	WWFF	food_fat	4	125598	1337117771	1	0.139999999999999	0.00874999999999994	10547	1
4	Food 2	Intake 4	27	125686	1337117859	/users/cn/jespinosa/phecomp/data/CRG/20120502_FDF_CRG/20120502_FDF_CRG/20120514_FDF_CRG_c12.mtb	5284	118	WWFF	food_fat	4	125659	1337117832	1	0.0800000000000001	0.00296296296296297	10548	1
4	Food 2	Intake 4	388	126192	1337118365	/users/cn/jespinosa/phecomp/data/CRG/20120502_FDF_CRG/20120502_FDF_CRG/20120514_FDF_CRG_c12.mtb	5286	663	WWFF	food_fat	4	125804	1337117977	1	0.26	0.000670103092783505	10549	1
4	Drink 2	Intake 2	23	126610	1337118783	/users/cn/jespinosa/phecomp/data/CRG/20120502_FDF_CRG/20120502_FDF_CRG/20120514_FDF_CRG_c12.mtb	1615	NA	WWFF	water	2	126587	1337118760	1	0.02	0.000869565217391304	10550	1
4	Food 2	Intake 4	241	127096	1337119269	/users/cn/jespinosa/phecomp/data/CRG/20120502_FDF_CRG/20120502_FDF_CRG/20120514_FDF_CRG_c12.mtb	5292	906	WWFF	food_fat	4	126855	1337119028	1	0.0200000000000014	8.29875518672257e-05	10551	1
4	Drink 1	Intake 1	13	127108	1337119281	/users/cn/jespinosa/phecomp/data/CRG/20120502_FDF_CRG/20120502_FDF_CRG/20120514_FDF_CRG_c12.mtb	1735	NA	WWFF	water	1	127095	1337119268	1	0.0800000000000001	0.00615384615384616	10552	1
4	Food 2	Intake 4	181	128183	1337120356	/users/cn/jespinosa/phecomp/data/CRG/20120502_FDF_CRG/20120502_FDF_CRG/20120514_FDF_CRG_c12.mtb	5300	176	WWFF	food_fat	4	128002	1337120175	1	0.0200000000000014	0.000110497237569068	10553	1
4	Drink 1	Intake 1	21	128204	1337120377	/users/cn/jespinosa/phecomp/data/CRG/20120502_FDF_CRG/20120502_FDF_CRG/20120514_FDF_CRG_c12.mtb	1736	NA	WWFF	water	1	128183	1337120356	1	0.02	0.000952380952380952	10554	1
4	Food 2	Intake 4	16	128375	1337120548	/users/cn/jespinosa/phecomp/data/CRG/20120502_FDF_CRG/20120502_FDF_CRG/20120514_FDF_CRG_c12.mtb	5302	3756	WWFF	food_fat	4	128359	1337120532	1	0.0999999999999996	0.00624999999999998	10555	1
4	Drink 2	Intake 2	22	131265	1337123438	/users/cn/jespinosa/phecomp/data/CRG/20120502_FDF_CRG/20120502_FDF_CRG/20120514_FDF_CRG_c12.mtb	1616	NA	WWFF	water	2	131243	1337123416	1	0.0599999999999999	0.00272727272727272	10556	1
4	Food 2	Intake 4	36	132167	1337124340	/users/cn/jespinosa/phecomp/data/CRG/20120502_FDF_CRG/20120502_FDF_CRG/20120514_FDF_CRG_c12.mtb	5330	1812	WWFF	food_fat	4	132131	1337124304	1	0.0399999999999991	0.00111111111111109	10557	1
4	Drink 2	Intake 2	19	132829	1337125002	/users/cn/jespinosa/phecomp/data/CRG/20120502_FDF_CRG/20120502_FDF_CRG/20120514_FDF_CRG_c12.mtb	1617	NA	WWFF	water	2	132810	1337124983	1	0.04	0.00210526315789474	10558	1
4	Drink 2	Intake 2	20	133507	1337125680	/users/cn/jespinosa/phecomp/data/CRG/20120502_FDF_CRG/20120502_FDF_CRG/20120514_FDF_CRG_c12.mtb	1618	NA	WWFF	water	2	133487	1337125660	1	0.0399999999999999	0.00199999999999999	10559	1
4	Food 2	Intake 4	12	133991	1337126164	/users/cn/jespinosa/phecomp/data/CRG/20120502_FDF_CRG/20120502_FDF_CRG/20120514_FDF_CRG_c12.mtb	5336	126	WWFF	food_fat	4	133979	1337126152	1	0.0200000000000014	0.00166666666666678	10560	1
4	Food 2	Intake 4	21	134138	1337126311	/users/cn/jespinosa/phecomp/data/CRG/20120502_FDF_CRG/20120502_FDF_CRG/20120514_FDF_CRG_c12.mtb	5339	3010	WWFF	food_fat	4	134117	1337126290	1	0.0400000000000009	0.00190476190476195	10561	1
4	Food 2	Intake 4	420	137568	1337129741	/users/cn/jespinosa/phecomp/data/CRG/20120502_FDF_CRG/20120502_FDF_CRG/20120514_FDF_CRG_c12.mtb	5361	COLL	WWFF	food_fat	4	137148	1337129321	1	0.0600000000000005	0.000142857142857144	10562	1
4	Food 1	Intake 3	25	137246	1337129419	/users/cn/jespinosa/phecomp/data/CRG/20120502_FDF_CRG/20120502_FDF_CRG/20120514_FDF_CRG_c12.mtb	4421	841	WWFF	food_fat	3	137221	1337129394	1	0.0200000000000005	0.00080000000000002	10563	1
4	Drink 2	Intake 2	20	138023	1337130196	/users/cn/jespinosa/phecomp/data/CRG/20120502_FDF_CRG/20120502_FDF_CRG/20120514_FDF_CRG_c12.mtb	1620	NA	WWFF	water	2	138003	1337130176	1	0.02	0.001	10564	1
4	Drink 1	Intake 1	14	138025	1337130198	/users/cn/jespinosa/phecomp/data/CRG/20120502_FDF_CRG/20120502_FDF_CRG/20120514_FDF_CRG_c12.mtb	1737	NA	WWFF	water	1	138011	1337130184	1	0.0800000000000001	0.00571428571428572	10565	1
4	Food 2	Intake 4	14	138101	1337130274	/users/cn/jespinosa/phecomp/data/CRG/20120502_FDF_CRG/20120502_FDF_CRG/20120514_FDF_CRG_c12.mtb	5365	270	WWFF	food_fat	4	138087	1337130260	1	0.0800000000000001	0.00571428571428572	10566	1
4	Drink 1	Intake 1	36	138350	1337130523	/users/cn/jespinosa/phecomp/data/CRG/20120502_FDF_CRG/20120502_FDF_CRG/20120514_FDF_CRG_c12.mtb	1738	NA	WWFF	water	1	138314	1337130487	1	0.04	0.00111111111111111	10567	1
4	Food 1	Intake 3	94	138465	1337130638	/users/cn/jespinosa/phecomp/data/CRG/20120502_FDF_CRG/20120502_FDF_CRG/20120514_FDF_CRG_c12.mtb	4425	253	WWFF	food_fat	3	138371	1337130544	1	0.0599999999999996	0.000638297872340421	10568	1
4	Food 2	Intake 4	24	138742	1337130915	/users/cn/jespinosa/phecomp/data/CRG/20120502_FDF_CRG/20120502_FDF_CRG/20120514_FDF_CRG_c12.mtb	5368	414	WWFF	food_fat	4	138718	1337130891	1	0.199999999999999	0.00833333333333329	10569	1
4	Drink 2	Intake 2	41	138774	1337130947	/users/cn/jespinosa/phecomp/data/CRG/20120502_FDF_CRG/20120502_FDF_CRG/20120514_FDF_CRG_c12.mtb	1621	NA	WWFF	water	2	138733	1337130906	1	0.12	0.00292682926829268	10570	1
4	Food 1	Intake 3	43	139199	1337131372	/users/cn/jespinosa/phecomp/data/CRG/20120502_FDF_CRG/20120502_FDF_CRG/20120514_FDF_CRG_c12.mtb	4427	36	WWFF	food_fat	3	139156	1337131329	1	0.0200000000000005	0.000465116279069779	10571	1
4	Food 2	Intake 4	160	139395	1337131568	/users/cn/jespinosa/phecomp/data/CRG/20120502_FDF_CRG/20120502_FDF_CRG/20120514_FDF_CRG_c12.mtb	5371	1003	WWFF	food_fat	4	139235	1337131408	1	0.119999999999999	0.000749999999999994	10572	1
4	Drink 2	Intake 2	20	139380	1337131553	/users/cn/jespinosa/phecomp/data/CRG/20120502_FDF_CRG/20120502_FDF_CRG/20120514_FDF_CRG_c12.mtb	1622	NA	WWFF	water	2	139360	1337131533	1	0.04	0.002	10573	1
4	Food 2	Intake 4	12	140410	1337132583	/users/cn/jespinosa/phecomp/data/CRG/20120502_FDF_CRG/20120502_FDF_CRG/20120514_FDF_CRG_c12.mtb	5377	834	WWFF	food_fat	4	140398	1337132571	1	0.0400000000000009	0.00333333333333341	10574	1
4	Food 2	Intake 4	55	141299	1337133472	/users/cn/jespinosa/phecomp/data/CRG/20120502_FDF_CRG/20120502_FDF_CRG/20120514_FDF_CRG_c12.mtb	5386	583	WWFF	food_fat	4	141244	1337133417	1	0.0200000000000014	0.000363636363636389	10575	1
4	Food 2	Intake 4	32	141914	1337134087	/users/cn/jespinosa/phecomp/data/CRG/20120502_FDF_CRG/20120502_FDF_CRG/20120514_FDF_CRG_c12.mtb	5390	1248	WWFF	food_fat	4	141882	1337134055	1	0.0399999999999991	0.00124999999999997	10576	1
4	Food 2	Intake 4	52	143214	1337135387	/users/cn/jespinosa/phecomp/data/CRG/20120502_FDF_CRG/20120502_FDF_CRG/20120514_FDF_CRG_c12.mtb	5397	188	WWFF	food_fat	4	143162	1337135335	1	0.0399999999999991	0.000769230769230752	10577	1
4	Drink 1	Intake 1	22	143408	1337135581	/users/cn/jespinosa/phecomp/data/CRG/20120502_FDF_CRG/20120502_FDF_CRG/20120514_FDF_CRG_c12.mtb	1739	NA	WWFF	water	1	143386	1337135559	1	0.0800000000000001	0.00363636363636364	10578	1
4	Food 2	Intake 4	15	143417	1337135590	/users/cn/jespinosa/phecomp/data/CRG/20120502_FDF_CRG/20120502_FDF_CRG/20120514_FDF_CRG_c12.mtb	5399	1736	WWFF	food_fat	4	143402	1337135575	1	0.0600000000000005	0.00400000000000003	10579	1
4	Food 2	Intake 4	182	145335	1337137508	/users/cn/jespinosa/phecomp/data/CRG/20120502_FDF_CRG/20120502_FDF_CRG/20120514_FDF_CRG_c12.mtb	5415	38	WWFF	food_fat	4	145153	1337137326	1	0.0599999999999987	0.000329670329670323	10580	1
4	Food 2	Intake 4	136	145509	1337137682	/users/cn/jespinosa/phecomp/data/CRG/20120502_FDF_CRG/20120502_FDF_CRG/20120514_FDF_CRG_c12.mtb	5416	420	WWFF	food_fat	4	145373	1337137546	1	0.16	0.00117647058823529	10581	1
4	Food 2	Intake 4	345	146274	1337138447	/users/cn/jespinosa/phecomp/data/CRG/20120502_FDF_CRG/20120502_FDF_CRG/20120514_FDF_CRG_c12.mtb	5422	170	WWFF	food_fat	4	145929	1337138102	1	0.0399999999999991	0.000115942028985505	10582	1
4	Food 2	Intake 4	189	146633	1337138806	/users/cn/jespinosa/phecomp/data/CRG/20120502_FDF_CRG/20120502_FDF_CRG/20120514_FDF_CRG_c12.mtb	5425	120	WWFF	food_fat	4	146444	1337138617	1	0.119999999999999	0.00063492063492063	10583	1
4	Food 2	Intake 4	65	146818	1337138991	/users/cn/jespinosa/phecomp/data/CRG/20120502_FDF_CRG/20120502_FDF_CRG/20120514_FDF_CRG_c12.mtb	5427	144	WWFF	food_fat	4	146753	1337138926	1	0.0400000000000009	0.000615384615384629	10584	1
4	Food 2	Intake 4	13	146975	1337139148	/users/cn/jespinosa/phecomp/data/CRG/20120502_FDF_CRG/20120502_FDF_CRG/20120514_FDF_CRG_c12.mtb	5430	996	WWFF	food_fat	4	146962	1337139135	1	0.0400000000000009	0.00307692307692315	10585	1
4	Food 2	Intake 4	65	148036	1337140209	/users/cn/jespinosa/phecomp/data/CRG/20120502_FDF_CRG/20120502_FDF_CRG/20120514_FDF_CRG_c12.mtb	5436	466	WWFF	food_fat	4	147971	1337140144	1	0.0800000000000001	0.00123076923076923	10586	1
4	Food 2	Intake 4	12	148514	1337140687	/users/cn/jespinosa/phecomp/data/CRG/20120502_FDF_CRG/20120502_FDF_CRG/20120514_FDF_CRG_c12.mtb	5441	158	WWFF	food_fat	4	148502	1337140675	1	0.0600000000000005	0.00500000000000004	10587	1
4	Food 2	Intake 4	14	148686	1337140859	/users/cn/jespinosa/phecomp/data/CRG/20120502_FDF_CRG/20120502_FDF_CRG/20120514_FDF_CRG_c12.mtb	5443	896	WWFF	food_fat	4	148672	1337140845	1	0.0400000000000009	0.00285714285714292	10588	1
4	Food 2	Intake 4	84	149666	1337141839	/users/cn/jespinosa/phecomp/data/CRG/20120502_FDF_CRG/20120502_FDF_CRG/20120514_FDF_CRG_c12.mtb	5452	69	WWFF	food_fat	4	149582	1337141755	1	0.299999999999999	0.00357142857142856	10589	1
4	Food 2	Intake 4	18	149753	1337141926	/users/cn/jespinosa/phecomp/data/CRG/20120502_FDF_CRG/20120502_FDF_CRG/20120514_FDF_CRG_c12.mtb	5453	796	WWFF	food_fat	4	149735	1337141908	1	0.0600000000000005	0.00333333333333336	10590	1
4	Drink 2	Intake 2	18	150352	1337142525	/users/cn/jespinosa/phecomp/data/CRG/20120502_FDF_CRG/20120502_FDF_CRG/20120514_FDF_CRG_c12.mtb	1623	NA	WWFF	water	2	150334	1337142507	1	0.04	0.00222222222222222	10591	1
4	Food 2	Intake 4	36	150585	1337142758	/users/cn/jespinosa/phecomp/data/CRG/20120502_FDF_CRG/20120502_FDF_CRG/20120514_FDF_CRG_c12.mtb	5459	1395	WWFF	food_fat	4	150549	1337142722	1	0.0400000000000009	0.00111111111111114	10592	1
4	Food 2	Intake 4	251	152231	1337144404	/users/cn/jespinosa/phecomp/data/CRG/20120502_FDF_CRG/20120502_FDF_CRG/20120514_FDF_CRG_c12.mtb	5465	21	WWFF	food_fat	4	151980	1337144153	1	0.0600000000000005	0.000239043824701197	10593	1
4	Food 2	Intake 4	36	152288	1337144461	/users/cn/jespinosa/phecomp/data/CRG/20120502_FDF_CRG/20120502_FDF_CRG/20120514_FDF_CRG_c12.mtb	5466	33	WWFF	food_fat	4	152252	1337144425	1	0.0400000000000009	0.00111111111111114	10594	1
4	Food 2	Intake 4	55	152376	1337144549	/users/cn/jespinosa/phecomp/data/CRG/20120502_FDF_CRG/20120502_FDF_CRG/20120514_FDF_CRG_c12.mtb	5468	508	WWFF	food_fat	4	152321	1337144494	1	0.199999999999999	0.00363636363636362	10595	1
4	Drink 2	Intake 2	24	152400	1337144573	/users/cn/jespinosa/phecomp/data/CRG/20120502_FDF_CRG/20120502_FDF_CRG/20120514_FDF_CRG_c12.mtb	1624	NA	WWFF	water	2	152376	1337144549	1	0.0800000000000001	0.00333333333333334	10596	1
4	Drink 2	Intake 2	21	152713	1337144886	/users/cn/jespinosa/phecomp/data/CRG/20120502_FDF_CRG/20120502_FDF_CRG/20120514_FDF_CRG_c12.mtb	1625	NA	WWFF	water	2	152692	1337144865	1	0.0999999999999999	0.00476190476190476	10597	1
4	Food 2	Intake 4	271	153155	1337145328	/users/cn/jespinosa/phecomp/data/CRG/20120502_FDF_CRG/20120502_FDF_CRG/20120514_FDF_CRG_c12.mtb	5472	6	WWFF	food_fat	4	152884	1337145057	1	0.139999999999999	0.000516605166051657	10598	1
4	Food 2	Intake 4	36	153197	1337145370	/users/cn/jespinosa/phecomp/data/CRG/20120502_FDF_CRG/20120502_FDF_CRG/20120514_FDF_CRG_c12.mtb	5473	706	WWFF	food_fat	4	153161	1337145334	1	0.0800000000000001	0.00222222222222222	10599	1
4	Drink 2	Intake 2	32	153252	1337145425	/users/cn/jespinosa/phecomp/data/CRG/20120502_FDF_CRG/20120502_FDF_CRG/20120514_FDF_CRG_c12.mtb	1626	NA	WWFF	water	2	153220	1337145393	1	0.04	0.00125	10600	1
4	Drink 1	Intake 1	28	153373	1337145546	/users/cn/jespinosa/phecomp/data/CRG/20120502_FDF_CRG/20120502_FDF_CRG/20120514_FDF_CRG_c12.mtb	1741	NA	WWFF	water	1	153345	1337145518	1	0.0600000000000001	0.00214285714285715	10601	1
4	Food 2	Intake 4	52	153955	1337146128	/users/cn/jespinosa/phecomp/data/CRG/20120502_FDF_CRG/20120502_FDF_CRG/20120514_FDF_CRG_c12.mtb	5481	2877	WWFF	food_fat	4	153903	1337146076	1	0.0200000000000014	0.000384615384615412	10602	1
4	Drink 1	Intake 1	23	156714	1337148887	/users/cn/jespinosa/phecomp/data/CRG/20120502_FDF_CRG/20120502_FDF_CRG/20120514_FDF_CRG_c12.mtb	1742	NA	WWFF	water	1	156691	1337148864	1	0.0600000000000001	0.00260869565217392	10603	1
4	Food 2	Intake 4	147	156979	1337149152	/users/cn/jespinosa/phecomp/data/CRG/20120502_FDF_CRG/20120502_FDF_CRG/20120514_FDF_CRG_c12.mtb	5489	875	WWFF	food_fat	4	156832	1337149005	1	0.279999999999999	0.0019047619047619	10604	1
4	Food 2	Intake 4	21	157875	1337150048	/users/cn/jespinosa/phecomp/data/CRG/20120502_FDF_CRG/20120502_FDF_CRG/20120514_FDF_CRG_c12.mtb	5493	1609	WWFF	food_fat	4	157854	1337150027	1	0.0400000000000009	0.00190476190476195	10605	1
4	Food 2	Intake 4	21	159505	1337151678	/users/cn/jespinosa/phecomp/data/CRG/20120502_FDF_CRG/20120502_FDF_CRG/20120514_FDF_CRG_c12.mtb	5495	1395	WWFF	food_fat	4	159484	1337151657	1	0.0399999999999991	0.00190476190476186	10606	1
4	Food 2	Intake 4	18	160918	1337153091	/users/cn/jespinosa/phecomp/data/CRG/20120502_FDF_CRG/20120502_FDF_CRG/20120514_FDF_CRG_c12.mtb	5497	985	WWFF	food_fat	4	160900	1337153073	1	0.0200000000000014	0.00111111111111119	10607	1
4	Food 2	Intake 4	28	161931	1337154104	/users/cn/jespinosa/phecomp/data/CRG/20120502_FDF_CRG/20120502_FDF_CRG/20120514_FDF_CRG_c12.mtb	5502	211	WWFF	food_fat	4	161903	1337154076	1	0.0200000000000014	0.000714285714285764	10608	1
4	Food 2	Intake 4	127	162269	1337154442	/users/cn/jespinosa/phecomp/data/CRG/20120502_FDF_CRG/20120502_FDF_CRG/20120514_FDF_CRG_c12.mtb	5505	9235	WWFF	food_fat	4	162142	1337154315	1	0.18	0.00141732283464567	10609	1
4	Drink 1	Intake 1	36	163303	1337155476	/users/cn/jespinosa/phecomp/data/CRG/20120502_FDF_CRG/20120502_FDF_CRG/20120514_FDF_CRG_c12.mtb	1743	NA	WWFF	water	1	163267	1337155440	1	0.16	0.00444444444444444	10610	1
4	Food 1	Intake 3	33	431	1337163710	/users/cn/jespinosa/phecomp/data/CRG/20120502_FDF_CRG/20120502_FDF_CRG/20120516_FDF_CRG_c12.mtb	4695	353	WWFF	food_fat	3	398	1337163677	1	0.02	0.000606060606060606	10611	1
4	Food 1	Intake 3	22	806	1337164085	/users/cn/jespinosa/phecomp/data/CRG/20120502_FDF_CRG/20120502_FDF_CRG/20120516_FDF_CRG_c12.mtb	4696	7	WWFF	food_fat	3	784	1337164063	1	0.02	0.000909090909090909	10612	1
4	Food 1	Intake 3	15	828	1337164107	/users/cn/jespinosa/phecomp/data/CRG/20120502_FDF_CRG/20120502_FDF_CRG/20120516_FDF_CRG_c12.mtb	4697	10307	WWFF	food_fat	3	813	1337164092	1	0.04	0.00266666666666667	10613	1
4	Drink 1	Intake 1	17	2767	1337166046	/users/cn/jespinosa/phecomp/data/CRG/20120502_FDF_CRG/20120502_FDF_CRG/20120516_FDF_CRG_c12.mtb	1838	NA	WWFF	water	1	2750	1337166029	1	0.02	0.00117647058823529	10614	1
4	Drink 1	Intake 1	15	5408	1337168687	/users/cn/jespinosa/phecomp/data/CRG/20120502_FDF_CRG/20120502_FDF_CRG/20120516_FDF_CRG_c12.mtb	1839	NA	WWFF	water	1	5393	1337168672	1	0.04	0.00266666666666667	10615	1
4	Food 1	Intake 3	23	11158	1337174437	/users/cn/jespinosa/phecomp/data/CRG/20120502_FDF_CRG/20120502_FDF_CRG/20120516_FDF_CRG_c12.mtb	4700	9	WWFF	food_fat	3	11135	1337174414	1	0.04	0.00173913043478261	10616	1
4	Food 1	Intake 3	22	11189	1337174468	/users/cn/jespinosa/phecomp/data/CRG/20120502_FDF_CRG/20120502_FDF_CRG/20120516_FDF_CRG_c12.mtb	4701	10	WWFF	food_fat	3	11167	1337174446	1	0.08	0.00363636363636364	10617	1
4	Food 1	Intake 3	22	11221	1337174500	/users/cn/jespinosa/phecomp/data/CRG/20120502_FDF_CRG/20120502_FDF_CRG/20120516_FDF_CRG_c12.mtb	4702	5599	WWFF	food_fat	3	11199	1337174478	1	0.02	0.000909090909090909	10618	1
4	Drink 1	Intake 1	23	14461	1337177740	/users/cn/jespinosa/phecomp/data/CRG/20120502_FDF_CRG/20120502_FDF_CRG/20120516_FDF_CRG_c12.mtb	1840	NA	WWFF	water	1	14438	1337177717	1	0.1	0.00434782608695652	10619	1
4	Food 2	Intake 4	23	16843	1337180122	/users/cn/jespinosa/phecomp/data/CRG/20120502_FDF_CRG/20120502_FDF_CRG/20120516_FDF_CRG_c12.mtb	5999	12	WWFF	food_fat	4	16820	1337180099	1	0.06	0.00260869565217391	10620	1
4	Food 1	Intake 3	65	16920	1337180199	/users/cn/jespinosa/phecomp/data/CRG/20120502_FDF_CRG/20120502_FDF_CRG/20120516_FDF_CRG_c12.mtb	4704	53	WWFF	food_fat	3	16855	1337180134	1	0.1	0.00153846153846154	10621	1
4	Food 1	Intake 3	78	17051	1337180330	/users/cn/jespinosa/phecomp/data/CRG/20120502_FDF_CRG/20120502_FDF_CRG/20120516_FDF_CRG_c12.mtb	4705	3	WWFF	food_fat	3	16973	1337180252	1	0.2	0.00256410256410256	10622	1
4	Food 2	Intake 4	52	17106	1337180385	/users/cn/jespinosa/phecomp/data/CRG/20120502_FDF_CRG/20120502_FDF_CRG/20120516_FDF_CRG_c12.mtb	6000	12	WWFF	food_fat	4	17054	1337180333	1	0.24	0.00461538461538461	10623	1
4	Food 2	Intake 4	29	17147	1337180426	/users/cn/jespinosa/phecomp/data/CRG/20120502_FDF_CRG/20120502_FDF_CRG/20120516_FDF_CRG_c12.mtb	6001	30	WWFF	food_fat	4	17118	1337180397	1	0.12	0.00413793103448276	10624	1
4	Food 2	Intake 4	28	17205	1337180484	/users/cn/jespinosa/phecomp/data/CRG/20120502_FDF_CRG/20120502_FDF_CRG/20120516_FDF_CRG_c12.mtb	6002	COLL	WWFF	food_fat	4	17177	1337180456	1	0.08	0.00285714285714286	10625	1
4	Food 1	Intake 3	37	17232	1337180511	/users/cn/jespinosa/phecomp/data/CRG/20120502_FDF_CRG/20120502_FDF_CRG/20120516_FDF_CRG_c12.mtb	4707	128	WWFF	food_fat	3	17195	1337180474	1	0.12	0.00324324324324324	10626	1
4	Drink 2	Intake 2	20	17370	1337180649	/users/cn/jespinosa/phecomp/data/CRG/20120502_FDF_CRG/20120502_FDF_CRG/20120516_FDF_CRG_c12.mtb	1718	NA	WWFF	water	2	17350	1337180629	1	0.02	0.001	10627	1
4	Food 1	Intake 3	80	17440	1337180719	/users/cn/jespinosa/phecomp/data/CRG/20120502_FDF_CRG/20120502_FDF_CRG/20120516_FDF_CRG_c12.mtb	4708	11061	WWFF	food_fat	3	17360	1337180639	1	0.1	0.00125	10628	1
4	Drink 1	Intake 1	26	17537	1337180816	/users/cn/jespinosa/phecomp/data/CRG/20120502_FDF_CRG/20120502_FDF_CRG/20120516_FDF_CRG_c12.mtb	1841	NA	WWFF	water	1	17511	1337180790	1	0.1	0.00384615384615385	10629	1
4	Drink 1	Intake 1	26	23029	1337186308	/users/cn/jespinosa/phecomp/data/CRG/20120502_FDF_CRG/20120502_FDF_CRG/20120516_FDF_CRG_c12.mtb	1842	NA	WWFF	water	1	23003	1337186282	1	0.1	0.00384615384615385	10630	1
4	Drink 1	Intake 1	31	25595	1337188874	/users/cn/jespinosa/phecomp/data/CRG/20120502_FDF_CRG/20120502_FDF_CRG/20120516_FDF_CRG_c12.mtb	1843	NA	WWFF	water	1	25564	1337188843	1	0.12	0.00387096774193548	10631	1
4	Food 1	Intake 3	18	28519	1337191798	/users/cn/jespinosa/phecomp/data/CRG/20120502_FDF_CRG/20120502_FDF_CRG/20120516_FDF_CRG_c12.mtb	4710	79	WWFF	food_fat	3	28501	1337191780	1	0.02	0.00111111111111111	10632	1
4	Food 2	Intake 4	15	28613	1337191892	/users/cn/jespinosa/phecomp/data/CRG/20120502_FDF_CRG/20120502_FDF_CRG/20120516_FDF_CRG_c12.mtb	6005	55	WWFF	food_fat	4	28598	1337191877	1	0.04	0.00266666666666667	10633	1
4	Food 1	Intake 3	78	28746	1337192025	/users/cn/jespinosa/phecomp/data/CRG/20120502_FDF_CRG/20120502_FDF_CRG/20120516_FDF_CRG_c12.mtb	4712	7	WWFF	food_fat	3	28668	1337191947	1	0.1	0.00128205128205128	10634	1
4	Food 1	Intake 3	30	28783	1337192062	/users/cn/jespinosa/phecomp/data/CRG/20120502_FDF_CRG/20120502_FDF_CRG/20120516_FDF_CRG_c12.mtb	4713	COLL	WWFF	food_fat	3	28753	1337192032	1	0.04	0.00133333333333333	10635	1
4	Food 2	Intake 4	48	28821	1337192100	/users/cn/jespinosa/phecomp/data/CRG/20120502_FDF_CRG/20120502_FDF_CRG/20120516_FDF_CRG_c12.mtb	6006	651	WWFF	food_fat	4	28773	1337192052	1	0.28	0.00583333333333333	10636	1
4	Food 1	Intake 3	109	29581	1337192860	/users/cn/jespinosa/phecomp/data/CRG/20120502_FDF_CRG/20120502_FDF_CRG/20120516_FDF_CRG_c12.mtb	4714	9	WWFF	food_fat	3	29472	1337192751	1	0.08	0.00073394495412844	10637	1
4	Food 1	Intake 3	21	29611	1337192890	/users/cn/jespinosa/phecomp/data/CRG/20120502_FDF_CRG/20120502_FDF_CRG/20120516_FDF_CRG_c12.mtb	4715	152	WWFF	food_fat	3	29590	1337192869	1	0.02	0.000952380952380952	10638	1
4	Food 2	Intake 4	16	29779	1337193058	/users/cn/jespinosa/phecomp/data/CRG/20120502_FDF_CRG/20120502_FDF_CRG/20120516_FDF_CRG_c12.mtb	6007	COLL	WWFF	food_fat	4	29763	1337193042	1	0.02	0.00125	10639	1
4	Food 1	Intake 3	130	29898	1337193177	/users/cn/jespinosa/phecomp/data/CRG/20120502_FDF_CRG/20120502_FDF_CRG/20120516_FDF_CRG_c12.mtb	4717	84	WWFF	food_fat	3	29768	1337193047	1	0.6	0.00461538461538461	10640	1
4	Food 1	Intake 3	19	30001	1337193280	/users/cn/jespinosa/phecomp/data/CRG/20120502_FDF_CRG/20120502_FDF_CRG/20120516_FDF_CRG_c12.mtb	4718	COLL	WWFF	food_fat	3	29982	1337193261	1	0.02	0.00105263157894737	10641	1
4	Food 2	Intake 4	97	30089	1337193368	/users/cn/jespinosa/phecomp/data/CRG/20120502_FDF_CRG/20120502_FDF_CRG/20120516_FDF_CRG_c12.mtb	6008	COLL	WWFF	food_fat	4	29992	1337193271	1	1.12	0.0115463917525773	10642	1
4	Food 1	Intake 3	60	30139	1337193418	/users/cn/jespinosa/phecomp/data/CRG/20120502_FDF_CRG/20120502_FDF_CRG/20120516_FDF_CRG_c12.mtb	4719	56	WWFF	food_fat	3	30079	1337193358	1	0.42	0.007	10643	1
4	Drink 2	Intake 2	20	30193	1337193472	/users/cn/jespinosa/phecomp/data/CRG/20120502_FDF_CRG/20120502_FDF_CRG/20120516_FDF_CRG_c12.mtb	1719	NA	WWFF	water	2	30173	1337193452	1	0.04	0.002	10644	1
4	Food 2	Intake 4	60	30255	1337193534	/users/cn/jespinosa/phecomp/data/CRG/20120502_FDF_CRG/20120502_FDF_CRG/20120516_FDF_CRG_c12.mtb	6009	2	WWFF	food_fat	4	30195	1337193474	1	0.38	0.00633333333333333	10645	1
4	Food 1	Intake 3	101	30358	1337193637	/users/cn/jespinosa/phecomp/data/CRG/20120502_FDF_CRG/20120502_FDF_CRG/20120516_FDF_CRG_c12.mtb	4720	240	WWFF	food_fat	3	30257	1337193536	1	0.1	0.00099009900990099	10646	1
4	Food 1	Intake 3	69	30667	1337193946	/users/cn/jespinosa/phecomp/data/CRG/20120502_FDF_CRG/20120502_FDF_CRG/20120516_FDF_CRG_c12.mtb	4721	14	WWFF	food_fat	3	30598	1337193877	1	0.2	0.00289855072463768	10647	1
4	Food 2	Intake 4	66	30747	1337194026	/users/cn/jespinosa/phecomp/data/CRG/20120502_FDF_CRG/20120502_FDF_CRG/20120516_FDF_CRG_c12.mtb	6011	135	WWFF	food_fat	4	30681	1337193960	1	0.28	0.00424242424242424	10648	1
4	Food 1	Intake 3	90	30972	1337194251	/users/cn/jespinosa/phecomp/data/CRG/20120502_FDF_CRG/20120502_FDF_CRG/20120516_FDF_CRG_c12.mtb	4722	144	WWFF	food_fat	3	30882	1337194161	1	0.14	0.00155555555555556	10649	1
4	Food 1	Intake 3	205	31321	1337194600	/users/cn/jespinosa/phecomp/data/CRG/20120502_FDF_CRG/20120502_FDF_CRG/20120516_FDF_CRG_c12.mtb	4723	138	WWFF	food_fat	3	31116	1337194395	1	1.3	0.00634146341463415	10650	1
4	Food 2	Intake 4	51	31510	1337194789	/users/cn/jespinosa/phecomp/data/CRG/20120502_FDF_CRG/20120502_FDF_CRG/20120516_FDF_CRG_c12.mtb	6012	COLL	WWFF	food_fat	4	31459	1337194738	1	0.0600000000000001	0.0011764705882353	10651	1
4	Food 1	Intake 3	31	31529	1337194808	/users/cn/jespinosa/phecomp/data/CRG/20120502_FDF_CRG/20120502_FDF_CRG/20120516_FDF_CRG_c12.mtb	4724	32	WWFF	food_fat	3	31498	1337194777	1	0.18	0.00580645161290323	10652	1
4	Drink 2	Intake 2	31	31551	1337194830	/users/cn/jespinosa/phecomp/data/CRG/20120502_FDF_CRG/20120502_FDF_CRG/20120516_FDF_CRG_c12.mtb	1721	NA	WWFF	water	2	31520	1337194799	1	0.04	0.00129032258064516	10653	1
4	Food 1	Intake 3	121	31682	1337194961	/users/cn/jespinosa/phecomp/data/CRG/20120502_FDF_CRG/20120502_FDF_CRG/20120516_FDF_CRG_c12.mtb	4725	17	WWFF	food_fat	3	31561	1337194840	1	0.32	0.00264462809917355	10654	1
4	Food 2	Intake 4	61	31760	1337195039	/users/cn/jespinosa/phecomp/data/CRG/20120502_FDF_CRG/20120502_FDF_CRG/20120516_FDF_CRG_c12.mtb	6013	COLL	WWFF	food_fat	4	31699	1337194978	1	0.14	0.00229508196721312	10655	1
4	Food 1	Intake 3	36	31785	1337195064	/users/cn/jespinosa/phecomp/data/CRG/20120502_FDF_CRG/20120502_FDF_CRG/20120516_FDF_CRG_c12.mtb	4727	81	WWFF	food_fat	3	31749	1337195028	1	0.28	0.00777777777777778	10656	1
4	Food 2	Intake 4	57	31923	1337195202	/users/cn/jespinosa/phecomp/data/CRG/20120502_FDF_CRG/20120502_FDF_CRG/20120516_FDF_CRG_c12.mtb	6014	169	WWFF	food_fat	4	31866	1337195145	1	0.12	0.00210526315789474	10657	1
4	Drink 1	Intake 1	35	31948	1337195227	/users/cn/jespinosa/phecomp/data/CRG/20120502_FDF_CRG/20120502_FDF_CRG/20120516_FDF_CRG_c12.mtb	1846	NA	WWFF	water	1	31913	1337195192	1	0.0800000000000001	0.00228571428571429	10658	1
4	Food 2	Intake 4	63	32155	1337195434	/users/cn/jespinosa/phecomp/data/CRG/20120502_FDF_CRG/20120502_FDF_CRG/20120516_FDF_CRG_c12.mtb	6016	COLL	WWFF	food_fat	4	32092	1337195371	1	0.04	0.000634920634920635	10659	1
4	Food 1	Intake 3	60	32206	1337195485	/users/cn/jespinosa/phecomp/data/CRG/20120502_FDF_CRG/20120502_FDF_CRG/20120516_FDF_CRG_c12.mtb	4729	892	WWFF	food_fat	3	32146	1337195425	1	0.04	0.000666666666666667	10660	1
4	Food 1	Intake 3	218	33316	1337196595	/users/cn/jespinosa/phecomp/data/CRG/20120502_FDF_CRG/20120502_FDF_CRG/20120516_FDF_CRG_c12.mtb	4732	82	WWFF	food_fat	3	33098	1337196377	1	0.24	0.00110091743119266	10661	1
4	Food 1	Intake 3	102	33500	1337196779	/users/cn/jespinosa/phecomp/data/CRG/20120502_FDF_CRG/20120502_FDF_CRG/20120516_FDF_CRG_c12.mtb	4733	33	WWFF	food_fat	3	33398	1337196677	1	0.899999999999999	0.0088235294117647	10662	1
4	Food 1	Intake 3	152	33685	1337196964	/users/cn/jespinosa/phecomp/data/CRG/20120502_FDF_CRG/20120502_FDF_CRG/20120516_FDF_CRG_c12.mtb	4734	49	WWFF	food_fat	3	33533	1337196812	1	0.04	0.000263157894736842	10663	1
4	Food 1	Intake 3	147	33881	1337197160	/users/cn/jespinosa/phecomp/data/CRG/20120502_FDF_CRG/20120502_FDF_CRG/20120516_FDF_CRG_c12.mtb	4737	195	WWFF	food_fat	3	33734	1337197013	1	0.04	0.000272108843537415	10664	1
4	Food 1	Intake 3	135	34211	1337197490	/users/cn/jespinosa/phecomp/data/CRG/20120502_FDF_CRG/20120502_FDF_CRG/20120516_FDF_CRG_c12.mtb	4739	1	WWFF	food_fat	3	34076	1337197355	1	0.12	0.000888888888888889	10665	1
4	Food 2	Intake 4	17	34229	1337197508	/users/cn/jespinosa/phecomp/data/CRG/20120502_FDF_CRG/20120502_FDF_CRG/20120516_FDF_CRG_c12.mtb	6019	2	WWFF	food_fat	4	34212	1337197491	1	0.02	0.00117647058823529	10666	1
4	Food 1	Intake 3	33	34264	1337197543	/users/cn/jespinosa/phecomp/data/CRG/20120502_FDF_CRG/20120502_FDF_CRG/20120516_FDF_CRG_c12.mtb	4740	20	WWFF	food_fat	3	34231	1337197510	1	0.16	0.00484848484848485	10667	1
4	Food 1	Intake 3	107	34391	1337197670	/users/cn/jespinosa/phecomp/data/CRG/20120502_FDF_CRG/20120502_FDF_CRG/20120516_FDF_CRG_c12.mtb	4741	9	WWFF	food_fat	3	34284	1337197563	1	0.0800000000000001	0.00074766355140187	10668	1
4	Drink 1	Intake 1	18	34408	1337197687	/users/cn/jespinosa/phecomp/data/CRG/20120502_FDF_CRG/20120502_FDF_CRG/20120516_FDF_CRG_c12.mtb	1848	NA	WWFF	water	1	34390	1337197669	1	0.0399999999999999	0.00222222222222222	10669	1
4	Food 1	Intake 3	229	34629	1337197908	/users/cn/jespinosa/phecomp/data/CRG/20120502_FDF_CRG/20120502_FDF_CRG/20120516_FDF_CRG_c12.mtb	4742	589	WWFF	food_fat	3	34400	1337197679	1	0.76	0.00331877729257642	10670	1
4	Food 1	Intake 3	136	35354	1337198633	/users/cn/jespinosa/phecomp/data/CRG/20120502_FDF_CRG/20120502_FDF_CRG/20120516_FDF_CRG_c12.mtb	4745	COLL	WWFF	food_fat	3	35218	1337198497	1	1.02	0.0075	10671	1
4	Food 2	Intake 4	25	35375	1337198654	/users/cn/jespinosa/phecomp/data/CRG/20120502_FDF_CRG/20120502_FDF_CRG/20120516_FDF_CRG_c12.mtb	6021	COLL	WWFF	food_fat	4	35350	1337198629	1	0.02	0.0008	10672	1
4	Food 1	Intake 3	37	35402	1337198681	/users/cn/jespinosa/phecomp/data/CRG/20120502_FDF_CRG/20120502_FDF_CRG/20120516_FDF_CRG_c12.mtb	4746	236	WWFF	food_fat	3	35365	1337198644	1	0.359999999999999	0.0097297297297297	10673	1
4	Food 1	Intake 3	48	35686	1337198965	/users/cn/jespinosa/phecomp/data/CRG/20120502_FDF_CRG/20120502_FDF_CRG/20120516_FDF_CRG_c12.mtb	4748	799	WWFF	food_fat	3	35638	1337198917	1	0.120000000000001	0.00250000000000002	10674	1
4	Food 2	Intake 4	37	36522	1337199801	/users/cn/jespinosa/phecomp/data/CRG/20120502_FDF_CRG/20120502_FDF_CRG/20120516_FDF_CRG_c12.mtb	6024	367	WWFF	food_fat	4	36485	1337199764	1	0.02	0.000540540540540541	10675	1
4	Drink 2	Intake 2	20	36713	1337199992	/users/cn/jespinosa/phecomp/data/CRG/20120502_FDF_CRG/20120502_FDF_CRG/20120516_FDF_CRG_c12.mtb	1727	NA	WWFF	water	2	36693	1337199972	1	0.04	0.002	10676	1
4	Food 2	Intake 4	16	36905	1337200184	/users/cn/jespinosa/phecomp/data/CRG/20120502_FDF_CRG/20120502_FDF_CRG/20120516_FDF_CRG_c12.mtb	6025	7814	WWFF	food_fat	4	36889	1337200168	1	0.02	0.00125	10677	1
4	Drink 1	Intake 1	9	36975	1337200254	/users/cn/jespinosa/phecomp/data/CRG/20120502_FDF_CRG/20120502_FDF_CRG/20120516_FDF_CRG_c12.mtb	1850	NA	WWFF	water	1	36966	1337200245	1	0.02	0.00222222222222222	10678	1
4	Drink 1	Intake 1	17	37668	1337200947	/users/cn/jespinosa/phecomp/data/CRG/20120502_FDF_CRG/20120502_FDF_CRG/20120516_FDF_CRG_c12.mtb	1851	NA	WWFF	water	1	37651	1337200930	1	0.0600000000000001	0.00352941176470589	10679	1
4	Drink 2	Intake 2	28	39827	1337203106	/users/cn/jespinosa/phecomp/data/CRG/20120502_FDF_CRG/20120502_FDF_CRG/20120516_FDF_CRG_c12.mtb	1730	NA	WWFF	water	2	39799	1337203078	1	0.02	0.000714285714285714	10680	1
4	Drink 1	Intake 1	17	42417	1337205696	/users/cn/jespinosa/phecomp/data/CRG/20120502_FDF_CRG/20120502_FDF_CRG/20120516_FDF_CRG_c12.mtb	1852	NA	WWFF	water	1	42400	1337205679	1	0.0399999999999999	0.00235294117647058	10681	1
4	Drink 1	Intake 1	20	43345	1337206624	/users/cn/jespinosa/phecomp/data/CRG/20120502_FDF_CRG/20120502_FDF_CRG/20120516_FDF_CRG_c12.mtb	1853	NA	WWFF	water	1	43325	1337206604	1	0.04	0.002	10682	1
4	Food 2	Intake 4	11	44730	1337208009	/users/cn/jespinosa/phecomp/data/CRG/20120502_FDF_CRG/20120502_FDF_CRG/20120516_FDF_CRG_c12.mtb	6027	6644	WWFF	food_fat	4	44719	1337207998	1	0.02	0.00181818181818182	10683	1
4	Drink 1	Intake 1	23	45837	1337209116	/users/cn/jespinosa/phecomp/data/CRG/20120502_FDF_CRG/20120502_FDF_CRG/20120516_FDF_CRG_c12.mtb	1854	NA	WWFF	water	1	45814	1337209093	1	0.1	0.00434782608695652	10684	1
4	Drink 1	Intake 1	17	47586	1337210865	/users/cn/jespinosa/phecomp/data/CRG/20120502_FDF_CRG/20120502_FDF_CRG/20120516_FDF_CRG_c12.mtb	1855	NA	WWFF	water	1	47569	1337210848	1	0.0600000000000001	0.00352941176470589	10685	1
4	Drink 1	Intake 1	21	47959	1337211238	/users/cn/jespinosa/phecomp/data/CRG/20120502_FDF_CRG/20120502_FDF_CRG/20120516_FDF_CRG_c12.mtb	1856	NA	WWFF	water	1	47938	1337211217	1	0.0599999999999999	0.00285714285714285	10686	1
4	Drink 1	Intake 1	19	49330	1337212609	/users/cn/jespinosa/phecomp/data/CRG/20120502_FDF_CRG/20120502_FDF_CRG/20120516_FDF_CRG_c12.mtb	1857	NA	WWFF	water	1	49311	1337212590	1	0.0800000000000001	0.00421052631578948	10687	1
4	Drink 1	Intake 1	14	50089	1337213368	/users/cn/jespinosa/phecomp/data/CRG/20120502_FDF_CRG/20120502_FDF_CRG/20120516_FDF_CRG_c12.mtb	1858	NA	WWFF	water	1	50075	1337213354	1	0.02	0.00142857142857143	10688	1
4	Food 2	Intake 4	42	51416	1337214695	/users/cn/jespinosa/phecomp/data/CRG/20120502_FDF_CRG/20120502_FDF_CRG/20120516_FDF_CRG_c12.mtb	6028	155	WWFF	food_fat	4	51374	1337214653	1	0.04	0.000952380952380952	10689	1
4	Food 1	Intake 3	57	51628	1337214907	/users/cn/jespinosa/phecomp/data/CRG/20120502_FDF_CRG/20120502_FDF_CRG/20120516_FDF_CRG_c12.mtb	4755	171	WWFF	food_fat	3	51571	1337214850	1	0.0400000000000009	0.000701754385964928	10690	1
4	Food 1	Intake 3	46	51845	1337215124	/users/cn/jespinosa/phecomp/data/CRG/20120502_FDF_CRG/20120502_FDF_CRG/20120516_FDF_CRG_c12.mtb	4756	494	WWFF	food_fat	3	51799	1337215078	1	0.0399999999999991	0.000869565217391285	10691	1
4	Drink 1	Intake 1	18	52217	1337215496	/users/cn/jespinosa/phecomp/data/CRG/20120502_FDF_CRG/20120502_FDF_CRG/20120516_FDF_CRG_c12.mtb	1860	NA	WWFF	water	1	52199	1337215478	1	0.0799999999999998	0.00444444444444443	10692	1
4	Food 2	Intake 4	97	52436	1337215715	/users/cn/jespinosa/phecomp/data/CRG/20120502_FDF_CRG/20120502_FDF_CRG/20120516_FDF_CRG_c12.mtb	6032	168	WWFF	food_fat	4	52339	1337215618	1	0.04	0.000412371134020619	10693	1
4	Food 1	Intake 3	122	52726	1337216005	/users/cn/jespinosa/phecomp/data/CRG/20120502_FDF_CRG/20120502_FDF_CRG/20120516_FDF_CRG_c12.mtb	4757	63	WWFF	food_fat	3	52604	1337215883	1	0.0800000000000001	0.000655737704918034	10694	1
4	Food 2	Intake 4	237	53026	1337216305	/users/cn/jespinosa/phecomp/data/CRG/20120502_FDF_CRG/20120502_FDF_CRG/20120516_FDF_CRG_c12.mtb	6034	33	WWFF	food_fat	4	52789	1337216068	1	0.4	0.00168776371308017	10695	1
4	Drink 1	Intake 1	23	53059	1337216338	/users/cn/jespinosa/phecomp/data/CRG/20120502_FDF_CRG/20120502_FDF_CRG/20120516_FDF_CRG_c12.mtb	1861	NA	WWFF	water	1	53036	1337216315	1	0.04	0.00173913043478261	10696	1
4	Food 2	Intake 4	48	53107	1337216386	/users/cn/jespinosa/phecomp/data/CRG/20120502_FDF_CRG/20120502_FDF_CRG/20120516_FDF_CRG_c12.mtb	6035	41	WWFF	food_fat	4	53059	1337216338	1	0.0600000000000001	0.00125	10697	1
4	Food 2	Intake 4	177	53325	1337216604	/users/cn/jespinosa/phecomp/data/CRG/20120502_FDF_CRG/20120502_FDF_CRG/20120516_FDF_CRG_c12.mtb	6036	198	WWFF	food_fat	4	53148	1337216427	1	0.84	0.00474576271186441	10698	1
4	Food 2	Intake 4	109	53632	1337216911	/users/cn/jespinosa/phecomp/data/CRG/20120502_FDF_CRG/20120502_FDF_CRG/20120516_FDF_CRG_c12.mtb	6038	45	WWFF	food_fat	4	53523	1337216802	1	0.64	0.00587155963302752	10699	1
4	Food 2	Intake 4	62	53739	1337217018	/users/cn/jespinosa/phecomp/data/CRG/20120502_FDF_CRG/20120502_FDF_CRG/20120516_FDF_CRG_c12.mtb	6039	18	WWFF	food_fat	4	53677	1337216956	1	0.460000000000001	0.00741935483870969	10700	1
4	Food 2	Intake 4	59	53816	1337217095	/users/cn/jespinosa/phecomp/data/CRG/20120502_FDF_CRG/20120502_FDF_CRG/20120516_FDF_CRG_c12.mtb	6040	290	WWFF	food_fat	4	53757	1337217036	1	0.22	0.00372881355932203	10701	1
4	Drink 1	Intake 1	26	54035	1337217314	/users/cn/jespinosa/phecomp/data/CRG/20120502_FDF_CRG/20120502_FDF_CRG/20120516_FDF_CRG_c12.mtb	1863	NA	WWFF	water	1	54009	1337217288	1	0.1	0.00384615384615385	10702	1
4	Food 2	Intake 4	14	54120	1337217399	/users/cn/jespinosa/phecomp/data/CRG/20120502_FDF_CRG/20120502_FDF_CRG/20120516_FDF_CRG_c12.mtb	6042	1583	WWFF	food_fat	4	54106	1337217385	1	0.04	0.00285714285714286	10703	1
4	Food 2	Intake 4	14	55717	1337218996	/users/cn/jespinosa/phecomp/data/CRG/20120502_FDF_CRG/20120502_FDF_CRG/20120516_FDF_CRG_c12.mtb	6044	147	WWFF	food_fat	4	55703	1337218982	1	0.0600000000000005	0.00428571428571432	10704	1
4	Food 2	Intake 4	89	55953	1337219232	/users/cn/jespinosa/phecomp/data/CRG/20120502_FDF_CRG/20120502_FDF_CRG/20120516_FDF_CRG_c12.mtb	6047	16	WWFF	food_fat	4	55864	1337219143	1	0.0599999999999996	0.000674157303370782	10705	1
4	Food 2	Intake 4	52	56021	1337219300	/users/cn/jespinosa/phecomp/data/CRG/20120502_FDF_CRG/20120502_FDF_CRG/20120516_FDF_CRG_c12.mtb	6048	4750	WWFF	food_fat	4	55969	1337219248	1	0.0200000000000005	0.000384615384615394	10706	1
4	Drink 1	Intake 1	14	57501	1337220780	/users/cn/jespinosa/phecomp/data/CRG/20120502_FDF_CRG/20120502_FDF_CRG/20120516_FDF_CRG_c12.mtb	1864	NA	WWFF	water	1	57487	1337220766	1	0.0599999999999998	0.00428571428571427	10707	1
4	Drink 1	Intake 1	24	60473	1337223752	/users/cn/jespinosa/phecomp/data/CRG/20120502_FDF_CRG/20120502_FDF_CRG/20120516_FDF_CRG_c12.mtb	1865	NA	WWFF	water	1	60449	1337223728	1	0.04	0.00166666666666667	10708	1
4	Food 2	Intake 4	13	60784	1337224063	/users/cn/jespinosa/phecomp/data/CRG/20120502_FDF_CRG/20120502_FDF_CRG/20120516_FDF_CRG_c12.mtb	6050	3426	WWFF	food_fat	4	60771	1337224050	1	0.0600000000000005	0.00461538461538465	10709	1
4	Drink 1	Intake 1	42	63722	1337227001	/users/cn/jespinosa/phecomp/data/CRG/20120502_FDF_CRG/20120502_FDF_CRG/20120516_FDF_CRG_c12.mtb	1867	NA	WWFF	water	1	63680	1337226959	1	0.12	0.00285714285714286	10710	1
4	Food 2	Intake 4	17	64227	1337227506	/users/cn/jespinosa/phecomp/data/CRG/20120502_FDF_CRG/20120502_FDF_CRG/20120516_FDF_CRG_c12.mtb	6058	2999	WWFF	food_fat	4	64210	1337227489	1	0.0200000000000005	0.00117647058823532	10711	1
4	Drink 1	Intake 1	14	66674	1337229953	/users/cn/jespinosa/phecomp/data/CRG/20120502_FDF_CRG/20120502_FDF_CRG/20120516_FDF_CRG_c12.mtb	1868	NA	WWFF	water	1	66660	1337229939	1	0.02	0.00142857142857143	10712	1
4	Food 2	Intake 4	33	67259	1337230538	/users/cn/jespinosa/phecomp/data/CRG/20120502_FDF_CRG/20120502_FDF_CRG/20120516_FDF_CRG_c12.mtb	6061	224	WWFF	food_fat	4	67226	1337230505	1	0.0200000000000005	0.000606060606060621	10713	1
4	Food 2	Intake 4	19	67502	1337230781	/users/cn/jespinosa/phecomp/data/CRG/20120502_FDF_CRG/20120502_FDF_CRG/20120516_FDF_CRG_c12.mtb	6063	109	WWFF	food_fat	4	67483	1337230762	1	0.0599999999999996	0.00315789473684208	10714	1
4	Food 2	Intake 4	100	67711	1337230990	/users/cn/jespinosa/phecomp/data/CRG/20120502_FDF_CRG/20120502_FDF_CRG/20120516_FDF_CRG_c12.mtb	6065	93	WWFF	food_fat	4	67611	1337230890	1	0.0600000000000005	0.000600000000000005	10715	1
4	Food 2	Intake 4	133	67937	1337231216	/users/cn/jespinosa/phecomp/data/CRG/20120502_FDF_CRG/20120502_FDF_CRG/20120516_FDF_CRG_c12.mtb	6066	200	WWFF	food_fat	4	67804	1337231083	1	0.359999999999999	0.00270676691729323	10716	1
4	Drink 1	Intake 1	28	67993	1337231272	/users/cn/jespinosa/phecomp/data/CRG/20120502_FDF_CRG/20120502_FDF_CRG/20120516_FDF_CRG_c12.mtb	1869	NA	WWFF	water	1	67965	1337231244	1	0.14	0.005	10717	1
4	Food 2	Intake 4	80	68217	1337231496	/users/cn/jespinosa/phecomp/data/CRG/20120502_FDF_CRG/20120502_FDF_CRG/20120516_FDF_CRG_c12.mtb	6068	314	WWFF	food_fat	4	68137	1337231416	1	0.0200000000000005	0.000250000000000006	10718	1
4	Food 2	Intake 4	76	68607	1337231886	/users/cn/jespinosa/phecomp/data/CRG/20120502_FDF_CRG/20120502_FDF_CRG/20120516_FDF_CRG_c12.mtb	6071	408	WWFF	food_fat	4	68531	1337231810	1	0.0200000000000005	0.000263157894736849	10719	1
4	Drink 1	Intake 1	28	69010	1337232289	/users/cn/jespinosa/phecomp/data/CRG/20120502_FDF_CRG/20120502_FDF_CRG/20120516_FDF_CRG_c12.mtb	1871	NA	WWFF	water	1	68982	1337232261	1	0.0599999999999998	0.00214285714285714	10720	1
4	Food 1	Intake 3	49	69064	1337232343	/users/cn/jespinosa/phecomp/data/CRG/20120502_FDF_CRG/20120502_FDF_CRG/20120516_FDF_CRG_c12.mtb	4766	658	WWFF	food_fat	3	69015	1337232294	1	0.0200000000000014	0.000408163265306151	10721	1
4	Food 2	Intake 4	57	69779	1337233058	/users/cn/jespinosa/phecomp/data/CRG/20120502_FDF_CRG/20120502_FDF_CRG/20120516_FDF_CRG_c12.mtb	6086	236	WWFF	food_fat	4	69722	1337233001	1	0.04	0.000701754385964912	10722	1
4	Food 2	Intake 4	211	70226	1337233505	/users/cn/jespinosa/phecomp/data/CRG/20120502_FDF_CRG/20120502_FDF_CRG/20120516_FDF_CRG_c12.mtb	6090	6	WWFF	food_fat	4	70015	1337233294	1	0.0599999999999996	0.000284360189573458	10723	1
4	Food 2	Intake 4	171	70403	1337233682	/users/cn/jespinosa/phecomp/data/CRG/20120502_FDF_CRG/20120502_FDF_CRG/20120516_FDF_CRG_c12.mtb	6091	51	WWFF	food_fat	4	70232	1337233511	1	0.0200000000000005	0.000116959064327488	10724	1
4	Food 2	Intake 4	12	70466	1337233745	/users/cn/jespinosa/phecomp/data/CRG/20120502_FDF_CRG/20120502_FDF_CRG/20120516_FDF_CRG_c12.mtb	6093	360	WWFF	food_fat	4	70454	1337233733	1	0.04	0.00333333333333333	10725	1
4	Drink 2	Intake 2	23	70729	1337234008	/users/cn/jespinosa/phecomp/data/CRG/20120502_FDF_CRG/20120502_FDF_CRG/20120516_FDF_CRG_c12.mtb	1738	NA	WWFF	water	2	70706	1337233985	1	0.06	0.00260869565217391	10726	1
4	Food 2	Intake 4	222	71048	1337234327	/users/cn/jespinosa/phecomp/data/CRG/20120502_FDF_CRG/20120502_FDF_CRG/20120516_FDF_CRG_c12.mtb	6095	666	WWFF	food_fat	4	70826	1337234105	1	0.0600000000000005	0.000270270270270272	10727	1
4	Food 2	Intake 4	44	71758	1337235037	/users/cn/jespinosa/phecomp/data/CRG/20120502_FDF_CRG/20120502_FDF_CRG/20120516_FDF_CRG_c12.mtb	6097	179	WWFF	food_fat	4	71714	1337234993	1	0.0200000000000005	0.000454545454545466	10728	1
4	Food 2	Intake 4	35	71972	1337235251	/users/cn/jespinosa/phecomp/data/CRG/20120502_FDF_CRG/20120502_FDF_CRG/20120516_FDF_CRG_c12.mtb	6100	109	WWFF	food_fat	4	71937	1337235216	1	0.0200000000000005	0.000571428571428586	10729	1
4	Food 2	Intake 4	29	72110	1337235389	/users/cn/jespinosa/phecomp/data/CRG/20120502_FDF_CRG/20120502_FDF_CRG/20120516_FDF_CRG_c12.mtb	6102	4026	WWFF	food_fat	4	72081	1337235360	1	0.04	0.00137931034482759	10730	1
4	Drink 1	Intake 1	23	74077	1337237356	/users/cn/jespinosa/phecomp/data/CRG/20120502_FDF_CRG/20120502_FDF_CRG/20120516_FDF_CRG_c12.mtb	1873	NA	WWFF	water	1	74054	1337237333	1	0.0799999999999998	0.00347826086956521	10731	1
4	Food 2	Intake 4	23	76159	1337239438	/users/cn/jespinosa/phecomp/data/CRG/20120502_FDF_CRG/20120502_FDF_CRG/20120516_FDF_CRG_c12.mtb	6105	3745	WWFF	food_fat	4	76136	1337239415	1	0.14	0.00608695652173913	10732	1
4	Drink 1	Intake 1	18	76635	1337239914	/users/cn/jespinosa/phecomp/data/CRG/20120502_FDF_CRG/20120502_FDF_CRG/20120516_FDF_CRG_c12.mtb	1874	NA	WWFF	water	1	76617	1337239896	1	0.1	0.00555555555555556	10733	1
4	Drink 1	Intake 1	20	79877	1337243156	/users/cn/jespinosa/phecomp/data/CRG/20120502_FDF_CRG/20120502_FDF_CRG/20120516_FDF_CRG_c12.mtb	1875	NA	WWFF	water	1	79857	1337243136	1	0.0800000000000001	0.00400000000000001	10734	1
4	Food 2	Intake 4	22	79926	1337243205	/users/cn/jespinosa/phecomp/data/CRG/20120502_FDF_CRG/20120502_FDF_CRG/20120516_FDF_CRG_c12.mtb	6107	4586	WWFF	food_fat	4	79904	1337243183	1	0.16	0.00727272727272727	10735	1
4	Drink 1	Intake 1	15	80422	1337243701	/users/cn/jespinosa/phecomp/data/CRG/20120502_FDF_CRG/20120502_FDF_CRG/20120516_FDF_CRG_c12.mtb	1876	NA	WWFF	water	1	80407	1337243686	1	0.02	0.00133333333333333	10736	1
4	Drink 1	Intake 1	13	81576	1337244855	/users/cn/jespinosa/phecomp/data/CRG/20120502_FDF_CRG/20120502_FDF_CRG/20120516_FDF_CRG_c12.mtb	1877	NA	WWFF	water	1	81563	1337244842	1	0.04	0.00307692307692308	10737	1
4	Drink 1	Intake 1	15	83616	1337246895	/users/cn/jespinosa/phecomp/data/CRG/20120502_FDF_CRG/20120502_FDF_CRG/20120516_FDF_CRG_c12.mtb	1878	NA	WWFF	water	1	83601	1337246880	1	0.0800000000000001	0.00533333333333334	10738	1
4	Food 2	Intake 4	14	84526	1337247805	/users/cn/jespinosa/phecomp/data/CRG/20120502_FDF_CRG/20120502_FDF_CRG/20120516_FDF_CRG_c12.mtb	6109	2616	WWFF	food_fat	4	84512	1337247791	1	0.12	0.00857142857142857	10739	1
4	Drink 2	Intake 2	49	87025	1337250304	/users/cn/jespinosa/phecomp/data/CRG/20120502_FDF_CRG/20120502_FDF_CRG/20120516_FDF_CRG_c12.mtb	1739	NA	WWFF	water	2	86976	1337250255	1	0.02	0.000408163265306122	10740	1
4	Food 2	Intake 4	20	87162	1337250441	/users/cn/jespinosa/phecomp/data/CRG/20120502_FDF_CRG/20120502_FDF_CRG/20120516_FDF_CRG_c12.mtb	6115	549	WWFF	food_fat	4	87142	1337250421	1	0.04	0.002	10741	1
4	Drink 2	Intake 2	35	87339	1337250618	/users/cn/jespinosa/phecomp/data/CRG/20120502_FDF_CRG/20120502_FDF_CRG/20120516_FDF_CRG_c12.mtb	1743	NA	WWFF	water	2	87304	1337250583	1	0.02	0.000571428571428571	10742	1
4	Food 2	Intake 4	66	87777	1337251056	/users/cn/jespinosa/phecomp/data/CRG/20120502_FDF_CRG/20120502_FDF_CRG/20120516_FDF_CRG_c12.mtb	6123	100	WWFF	food_fat	4	87711	1337250990	1	0.04	0.000606060606060606	10743	1
4	Food 2	Intake 4	33	87910	1337251189	/users/cn/jespinosa/phecomp/data/CRG/20120502_FDF_CRG/20120502_FDF_CRG/20120516_FDF_CRG_c12.mtb	6124	164	WWFF	food_fat	4	87877	1337251156	1	0.04	0.00121212121212121	10744	1
4	Drink 2	Intake 2	19	87980	1337251259	/users/cn/jespinosa/phecomp/data/CRG/20120502_FDF_CRG/20120502_FDF_CRG/20120516_FDF_CRG_c12.mtb	1745	NA	WWFF	water	2	87961	1337251240	1	0.08	0.00421052631578947	10745	1
4	Drink 2	Intake 2	18	88012	1337251291	/users/cn/jespinosa/phecomp/data/CRG/20120502_FDF_CRG/20120502_FDF_CRG/20120516_FDF_CRG_c12.mtb	1746	NA	WWFF	water	2	87994	1337251273	1	0.02	0.00111111111111111	10746	1
4	Food 2	Intake 4	23	88097	1337251376	/users/cn/jespinosa/phecomp/data/CRG/20120502_FDF_CRG/20120502_FDF_CRG/20120516_FDF_CRG_c12.mtb	6128	438	WWFF	food_fat	4	88074	1337251353	1	0.0200000000000005	0.000869565217391326	10747	1
4	Food 2	Intake 4	21	88556	1337251835	/users/cn/jespinosa/phecomp/data/CRG/20120502_FDF_CRG/20120502_FDF_CRG/20120516_FDF_CRG_c12.mtb	6130	232	WWFF	food_fat	4	88535	1337251814	1	0.0599999999999996	0.00285714285714284	10748	1
4	Food 2	Intake 4	22	88810	1337252089	/users/cn/jespinosa/phecomp/data/CRG/20120502_FDF_CRG/20120502_FDF_CRG/20120516_FDF_CRG_c12.mtb	6132	184	WWFF	food_fat	4	88788	1337252067	1	0.0599999999999996	0.00272727272727271	10749	1
4	Food 2	Intake 4	12	89006	1337252285	/users/cn/jespinosa/phecomp/data/CRG/20120502_FDF_CRG/20120502_FDF_CRG/20120516_FDF_CRG_c12.mtb	6134	7838	WWFF	food_fat	4	88994	1337252273	1	0.04	0.00333333333333333	10750	1
4	Drink 1	Intake 1	26	95782	1337259061	/users/cn/jespinosa/phecomp/data/CRG/20120502_FDF_CRG/20120502_FDF_CRG/20120516_FDF_CRG_c12.mtb	1879	NA	WWFF	water	1	95756	1337259035	1	0.12	0.00461538461538461	10751	1
4	Food 2	Intake 4	29	96873	1337260152	/users/cn/jespinosa/phecomp/data/CRG/20120502_FDF_CRG/20120502_FDF_CRG/20120516_FDF_CRG_c12.mtb	6136	6311	WWFF	food_fat	4	96844	1337260123	1	0.04	0.00137931034482759	10752	1
4	Drink 1	Intake 1	26	99683	1337262962	/users/cn/jespinosa/phecomp/data/CRG/20120502_FDF_CRG/20120502_FDF_CRG/20120516_FDF_CRG_c12.mtb	1880	NA	WWFF	water	1	99657	1337262936	1	0.1	0.00384615384615385	10753	1
4	Food 2	Intake 4	13	103197	1337266476	/users/cn/jespinosa/phecomp/data/CRG/20120502_FDF_CRG/20120502_FDF_CRG/20120516_FDF_CRG_c12.mtb	6138	217	WWFF	food_fat	4	103184	1337266463	1	0.100000000000001	0.00769230769230777	10754	1
4	Food 2	Intake 4	28	103442	1337266721	/users/cn/jespinosa/phecomp/data/CRG/20120502_FDF_CRG/20120502_FDF_CRG/20120516_FDF_CRG_c12.mtb	6141	189	WWFF	food_fat	4	103414	1337266693	1	0.0999999999999996	0.00357142857142856	10755	1
4	Food 2	Intake 4	45	103676	1337266955	/users/cn/jespinosa/phecomp/data/CRG/20120502_FDF_CRG/20120502_FDF_CRG/20120516_FDF_CRG_c12.mtb	6142	27	WWFF	food_fat	4	103631	1337266910	1	0.0599999999999996	0.00133333333333332	10756	1
4	Food 2	Intake 4	14	103717	1337266996	/users/cn/jespinosa/phecomp/data/CRG/20120502_FDF_CRG/20120502_FDF_CRG/20120516_FDF_CRG_c12.mtb	6143	211	WWFF	food_fat	4	103703	1337266982	1	0.0200000000000005	0.00142857142857146	10757	1
4	Food 2	Intake 4	19	103947	1337267226	/users/cn/jespinosa/phecomp/data/CRG/20120502_FDF_CRG/20120502_FDF_CRG/20120516_FDF_CRG_c12.mtb	6145	250	WWFF	food_fat	4	103928	1337267207	1	0.0200000000000005	0.00105263157894739	10758	1
4	Food 2	Intake 4	13	104210	1337267489	/users/cn/jespinosa/phecomp/data/CRG/20120502_FDF_CRG/20120502_FDF_CRG/20120516_FDF_CRG_c12.mtb	6147	4839	WWFF	food_fat	4	104197	1337267476	1	0.0800000000000001	0.00615384615384616	10759	1
4	Food 2	Intake 4	36	109085	1337272364	/users/cn/jespinosa/phecomp/data/CRG/20120502_FDF_CRG/20120502_FDF_CRG/20120516_FDF_CRG_c12.mtb	6150	5757	WWFF	food_fat	4	109049	1337272328	1	0.0200000000000005	0.000555555555555569	10760	1
4	Drink 1	Intake 1	23	109524	1337272803	/users/cn/jespinosa/phecomp/data/CRG/20120502_FDF_CRG/20120502_FDF_CRG/20120516_FDF_CRG_c12.mtb	1881	NA	WWFF	water	1	109501	1337272780	1	0.14	0.00608695652173913	10761	1
4	Drink 1	Intake 1	25	110793	1337274072	/users/cn/jespinosa/phecomp/data/CRG/20120502_FDF_CRG/20120502_FDF_CRG/20120516_FDF_CRG_c12.mtb	1882	NA	WWFF	water	1	110768	1337274047	1	0.0800000000000001	0.0032	10762	1
4	Food 2	Intake 4	47	114889	1337278168	/users/cn/jespinosa/phecomp/data/CRG/20120502_FDF_CRG/20120502_FDF_CRG/20120516_FDF_CRG_c12.mtb	6155	69	WWFF	food_fat	4	114842	1337278121	1	0.04	0.000851063829787234	10763	1
4	Food 2	Intake 4	13	114971	1337278250	/users/cn/jespinosa/phecomp/data/CRG/20120502_FDF_CRG/20120502_FDF_CRG/20120516_FDF_CRG_c12.mtb	6157	90	WWFF	food_fat	4	114958	1337278237	1	0.0200000000000005	0.00153846153846158	10764	1
4	Food 2	Intake 4	55	115116	1337278395	/users/cn/jespinosa/phecomp/data/CRG/20120502_FDF_CRG/20120502_FDF_CRG/20120516_FDF_CRG_c12.mtb	6159	339	WWFF	food_fat	4	115061	1337278340	1	0.0999999999999996	0.00181818181818181	10765	1
4	Food 2	Intake 4	13	115468	1337278747	/users/cn/jespinosa/phecomp/data/CRG/20120502_FDF_CRG/20120502_FDF_CRG/20120516_FDF_CRG_c12.mtb	6163	126	WWFF	food_fat	4	115455	1337278734	1	0.0200000000000005	0.00153846153846158	10766	1
4	Food 1	Intake 3	116	115710	1337278989	/users/cn/jespinosa/phecomp/data/CRG/20120502_FDF_CRG/20120502_FDF_CRG/20120516_FDF_CRG_c12.mtb	4784	26	WWFF	food_fat	3	115594	1337278873	1	0.0800000000000001	0.000689655172413794	10767	1
4	Food 2	Intake 4	14	115750	1337279029	/users/cn/jespinosa/phecomp/data/CRG/20120502_FDF_CRG/20120502_FDF_CRG/20120516_FDF_CRG_c12.mtb	6166	142	WWFF	food_fat	4	115736	1337279015	1	0.04	0.00285714285714286	10768	1
4	Food 2	Intake 4	104	115996	1337279275	/users/cn/jespinosa/phecomp/data/CRG/20120502_FDF_CRG/20120502_FDF_CRG/20120516_FDF_CRG_c12.mtb	6169	205	WWFF	food_fat	4	115892	1337279171	1	0.0600000000000005	0.000576923076923082	10769	1
4	Food 1	Intake 3	20	116221	1337279500	/users/cn/jespinosa/phecomp/data/CRG/20120502_FDF_CRG/20120502_FDF_CRG/20120516_FDF_CRG_c12.mtb	4787	701	WWFF	food_fat	3	116201	1337279480	1	0.0200000000000014	0.00100000000000007	10770	1
4	Drink 1	Intake 1	33	116920	1337280199	/users/cn/jespinosa/phecomp/data/CRG/20120502_FDF_CRG/20120502_FDF_CRG/20120516_FDF_CRG_c12.mtb	1884	NA	WWFF	water	1	116887	1337280166	1	0.0600000000000001	0.00181818181818182	10771	1
4	Food 2	Intake 4	110	117032	1337280311	/users/cn/jespinosa/phecomp/data/CRG/20120502_FDF_CRG/20120502_FDF_CRG/20120516_FDF_CRG_c12.mtb	6175	85	WWFF	food_fat	4	116922	1337280201	1	0.0400000000000009	0.000363636363636372	10772	1
4	Food 2	Intake 4	147	117264	1337280543	/users/cn/jespinosa/phecomp/data/CRG/20120502_FDF_CRG/20120502_FDF_CRG/20120516_FDF_CRG_c12.mtb	6177	99	WWFF	food_fat	4	117117	1337280396	1	0.0999999999999996	0.000680272108843535	10773	1
4	Drink 2	Intake 2	17	117149	1337280428	/users/cn/jespinosa/phecomp/data/CRG/20120502_FDF_CRG/20120502_FDF_CRG/20120516_FDF_CRG_c12.mtb	1756	NA	WWFF	water	2	117132	1337280411	1	0.02	0.00117647058823529	10774	1
4	Food 1	Intake 3	89	117452	1337280731	/users/cn/jespinosa/phecomp/data/CRG/20120502_FDF_CRG/20120502_FDF_CRG/20120516_FDF_CRG_c12.mtb	4791	67	WWFF	food_fat	3	117363	1337280642	1	0.119999999999999	0.00134831460674156	10775	1
4	Food 1	Intake 3	65	117584	1337280863	/users/cn/jespinosa/phecomp/data/CRG/20120502_FDF_CRG/20120502_FDF_CRG/20120516_FDF_CRG_c12.mtb	4793	COLL	WWFF	food_fat	3	117519	1337280798	1	0.0600000000000005	0.000923076923076931	10776	1
4	Food 2	Intake 4	112	117668	1337280947	/users/cn/jespinosa/phecomp/data/CRG/20120502_FDF_CRG/20120502_FDF_CRG/20120516_FDF_CRG_c12.mtb	6181	355	WWFF	food_fat	4	117556	1337280835	1	0.28	0.0025	10777	1
4	Food 2	Intake 4	23	118046	1337281325	/users/cn/jespinosa/phecomp/data/CRG/20120502_FDF_CRG/20120502_FDF_CRG/20120516_FDF_CRG_c12.mtb	6182	662	WWFF	food_fat	4	118023	1337281302	1	0.0200000000000005	0.000869565217391326	10778	1
4	Drink 1	Intake 1	22	118058	1337281337	/users/cn/jespinosa/phecomp/data/CRG/20120502_FDF_CRG/20120502_FDF_CRG/20120516_FDF_CRG_c12.mtb	1885	NA	WWFF	water	1	118036	1337281315	1	0.0600000000000001	0.00272727272727273	10779	1
4	Food 2	Intake 4	43	118751	1337282030	/users/cn/jespinosa/phecomp/data/CRG/20120502_FDF_CRG/20120502_FDF_CRG/20120516_FDF_CRG_c12.mtb	6192	217	WWFF	food_fat	4	118708	1337281987	1	0.0400000000000009	0.000930232558139556	10780	1
4	Food 1	Intake 3	73	119041	1337282320	/users/cn/jespinosa/phecomp/data/CRG/20120502_FDF_CRG/20120502_FDF_CRG/20120516_FDF_CRG_c12.mtb	4795	68	WWFF	food_fat	3	118968	1337282247	1	0.0399999999999991	0.00054794520547944	10781	1
4	Drink 2	Intake 2	18	119115	1337282394	/users/cn/jespinosa/phecomp/data/CRG/20120502_FDF_CRG/20120502_FDF_CRG/20120516_FDF_CRG_c12.mtb	1758	NA	WWFF	water	2	119097	1337282376	1	0.02	0.00111111111111111	10782	1
4	Food 2	Intake 4	143	119252	1337282531	/users/cn/jespinosa/phecomp/data/CRG/20120502_FDF_CRG/20120502_FDF_CRG/20120516_FDF_CRG_c12.mtb	6197	90	WWFF	food_fat	4	119109	1337282388	1	0.120000000000001	0.000839160839160846	10783	1
4	Food 2	Intake 4	47	119389	1337282668	/users/cn/jespinosa/phecomp/data/CRG/20120502_FDF_CRG/20120502_FDF_CRG/20120516_FDF_CRG_c12.mtb	6198	52	WWFF	food_fat	4	119342	1337282621	1	0.0599999999999987	0.00127659574468082	10784	1
4	Drink 2	Intake 2	15	119412	1337282691	/users/cn/jespinosa/phecomp/data/CRG/20120502_FDF_CRG/20120502_FDF_CRG/20120516_FDF_CRG_c12.mtb	1759	NA	WWFF	water	2	119397	1337282676	1	0.02	0.00133333333333333	10785	1
4	Food 1	Intake 3	68	119509	1337282788	/users/cn/jespinosa/phecomp/data/CRG/20120502_FDF_CRG/20120502_FDF_CRG/20120516_FDF_CRG_c12.mtb	4796	COLL	WWFF	food_fat	3	119441	1337282720	1	0.0400000000000009	0.00058823529411766	10786	1
4	Food 2	Intake 4	19	119515	1337282794	/users/cn/jespinosa/phecomp/data/CRG/20120502_FDF_CRG/20120502_FDF_CRG/20120516_FDF_CRG_c12.mtb	6200	57	WWFF	food_fat	4	119496	1337282775	1	0.0200000000000014	0.00105263157894744	10787	1
4	Food 2	Intake 4	17	119589	1337282868	/users/cn/jespinosa/phecomp/data/CRG/20120502_FDF_CRG/20120502_FDF_CRG/20120516_FDF_CRG_c12.mtb	6201	1521	WWFF	food_fat	4	119572	1337282851	1	0.0399999999999991	0.00235294117647054	10788	1
4	Drink 1	Intake 1	156	120676	1337283955	/users/cn/jespinosa/phecomp/data/CRG/20120502_FDF_CRG/20120502_FDF_CRG/20120516_FDF_CRG_c12.mtb	1887	NA	WWFF	water	1	120520	1337283799	1	0.0999999999999996	0.000641025641025639	10789	1
4	Food 2	Intake 4	98	121208	1337284487	/users/cn/jespinosa/phecomp/data/CRG/20120502_FDF_CRG/20120502_FDF_CRG/20120516_FDF_CRG_c12.mtb	6209	COLL	WWFF	food_fat	4	121110	1337284389	1	0.24	0.00244897959183673	10790	1
4	Food 1	Intake 3	197	121390	1337284669	/users/cn/jespinosa/phecomp/data/CRG/20120502_FDF_CRG/20120502_FDF_CRG/20120516_FDF_CRG_c12.mtb	4800	899	WWFF	food_fat	3	121193	1337284472	1	0.140000000000001	0.000710659898477162	10791	1
4	Food 2	Intake 4	47	122336	1337285615	/users/cn/jespinosa/phecomp/data/CRG/20120502_FDF_CRG/20120502_FDF_CRG/20120516_FDF_CRG_c12.mtb	6219	1342	WWFF	food_fat	4	122289	1337285568	1	0.0200000000000014	0.000425531914893647	10792	1
4	Drink 2	Intake 2	27	122358	1337285637	/users/cn/jespinosa/phecomp/data/CRG/20120502_FDF_CRG/20120502_FDF_CRG/20120516_FDF_CRG_c12.mtb	1763	NA	WWFF	water	2	122331	1337285610	1	0.04	0.00148148148148148	10793	1
4	Drink 2	Intake 2	26	122388	1337285667	/users/cn/jespinosa/phecomp/data/CRG/20120502_FDF_CRG/20120502_FDF_CRG/20120516_FDF_CRG_c12.mtb	1764	NA	WWFF	water	2	122362	1337285641	1	0.04	0.00153846153846154	10794	1
4	Food 2	Intake 4	69	123747	1337287026	/users/cn/jespinosa/phecomp/data/CRG/20120502_FDF_CRG/20120502_FDF_CRG/20120516_FDF_CRG_c12.mtb	6225	55	WWFF	food_fat	4	123678	1337286957	1	0.0400000000000009	0.000579710144927549	10795	1
4	Food 1	Intake 3	113	123915	1337287194	/users/cn/jespinosa/phecomp/data/CRG/20120502_FDF_CRG/20120502_FDF_CRG/20120516_FDF_CRG_c12.mtb	4805	3	WWFF	food_fat	3	123802	1337287081	1	0.0399999999999991	0.000353982300884948	10796	1
4	Food 2	Intake 4	146	124064	1337287343	/users/cn/jespinosa/phecomp/data/CRG/20120502_FDF_CRG/20120502_FDF_CRG/20120516_FDF_CRG_c12.mtb	6228	COLL	WWFF	food_fat	4	123918	1337287197	1	0.140000000000001	0.000958904109589048	10797	1
4	Food 1	Intake 3	29	124007	1337287286	/users/cn/jespinosa/phecomp/data/CRG/20120502_FDF_CRG/20120502_FDF_CRG/20120516_FDF_CRG_c12.mtb	4806	1835	WWFF	food_fat	3	123978	1337287257	1	0.0200000000000014	0.000689655172413841	10798	1
4	Drink 2	Intake 2	25	124902	1337288181	/users/cn/jespinosa/phecomp/data/CRG/20120502_FDF_CRG/20120502_FDF_CRG/20120516_FDF_CRG_c12.mtb	1766	NA	WWFF	water	2	124877	1337288156	1	0.04	0.0016	10799	1
4	Food 2	Intake 4	16	125858	1337289137	/users/cn/jespinosa/phecomp/data/CRG/20120502_FDF_CRG/20120502_FDF_CRG/20120516_FDF_CRG_c12.mtb	6244	83	WWFF	food_fat	4	125842	1337289121	1	0.0200000000000014	0.00125000000000009	10800	1
4	Food 2	Intake 4	14	125955	1337289234	/users/cn/jespinosa/phecomp/data/CRG/20120502_FDF_CRG/20120502_FDF_CRG/20120516_FDF_CRG_c12.mtb	6246	17	WWFF	food_fat	4	125941	1337289220	1	0.0399999999999991	0.00285714285714279	10801	1
4	Drink 1	Intake 1	17	125967	1337289246	/users/cn/jespinosa/phecomp/data/CRG/20120502_FDF_CRG/20120502_FDF_CRG/20120516_FDF_CRG_c12.mtb	1892	NA	WWFF	water	1	125950	1337289229	1	0.02	0.00117647058823529	10802	1
4	Food 2	Intake 4	64	126036	1337289315	/users/cn/jespinosa/phecomp/data/CRG/20120502_FDF_CRG/20120502_FDF_CRG/20120516_FDF_CRG_c12.mtb	6247	105	WWFF	food_fat	4	125972	1337289251	1	0.0200000000000014	0.000312500000000022	10803	1
4	Food 2	Intake 4	12	126153	1337289432	/users/cn/jespinosa/phecomp/data/CRG/20120502_FDF_CRG/20120502_FDF_CRG/20120516_FDF_CRG_c12.mtb	6249	295	WWFF	food_fat	4	126141	1337289420	1	0.0399999999999991	0.00333333333333326	10804	1
4	Food 2	Intake 4	12	126460	1337289739	/users/cn/jespinosa/phecomp/data/CRG/20120502_FDF_CRG/20120502_FDF_CRG/20120516_FDF_CRG_c12.mtb	6252	154	WWFF	food_fat	4	126448	1337289727	1	0.0200000000000014	0.00166666666666678	10805	1
4	Food 2	Intake 4	37	126651	1337289930	/users/cn/jespinosa/phecomp/data/CRG/20120502_FDF_CRG/20120502_FDF_CRG/20120516_FDF_CRG_c12.mtb	6255	77	WWFF	food_fat	4	126614	1337289893	1	0.0399999999999991	0.00108108108108106	10806	1
4	Food 2	Intake 4	12	126740	1337290019	/users/cn/jespinosa/phecomp/data/CRG/20120502_FDF_CRG/20120502_FDF_CRG/20120516_FDF_CRG_c12.mtb	6256	4583	WWFF	food_fat	4	126728	1337290007	1	0.0400000000000009	0.00333333333333341	10807	1
4	Drink 1	Intake 1	26	129161	1337292440	/users/cn/jespinosa/phecomp/data/CRG/20120502_FDF_CRG/20120502_FDF_CRG/20120516_FDF_CRG_c12.mtb	1893	NA	WWFF	water	1	129135	1337292414	1	0.04	0.00153846153846154	10808	1
4	Drink 1	Intake 1	16	129452	1337292731	/users/cn/jespinosa/phecomp/data/CRG/20120502_FDF_CRG/20120502_FDF_CRG/20120516_FDF_CRG_c12.mtb	1894	NA	WWFF	water	1	129436	1337292715	1	0.02	0.00125	10809	1
4	Drink 1	Intake 1	16	130016	1337293295	/users/cn/jespinosa/phecomp/data/CRG/20120502_FDF_CRG/20120502_FDF_CRG/20120516_FDF_CRG_c12.mtb	1895	NA	WWFF	water	1	130000	1337293279	1	0.04	0.0025	10810	1
4	Food 2	Intake 4	50	131373	1337294652	/users/cn/jespinosa/phecomp/data/CRG/20120502_FDF_CRG/20120502_FDF_CRG/20120516_FDF_CRG_c12.mtb	6262	67	WWFF	food_fat	4	131323	1337294602	1	0.0800000000000001	0.0016	10811	1
4	Food 2	Intake 4	18	131458	1337294737	/users/cn/jespinosa/phecomp/data/CRG/20120502_FDF_CRG/20120502_FDF_CRG/20120516_FDF_CRG_c12.mtb	6263	40	WWFF	food_fat	4	131440	1337294719	1	0.0200000000000014	0.00111111111111119	10812	1
4	Food 2	Intake 4	73	131571	1337294850	/users/cn/jespinosa/phecomp/data/CRG/20120502_FDF_CRG/20120502_FDF_CRG/20120516_FDF_CRG_c12.mtb	6265	311	WWFF	food_fat	4	131498	1337294777	1	0.0399999999999991	0.00054794520547944	10813	1
4	Drink 2	Intake 2	110	131699	1337294978	/users/cn/jespinosa/phecomp/data/CRG/20120502_FDF_CRG/20120502_FDF_CRG/20120516_FDF_CRG_c12.mtb	1771	NA	WWFF	water	2	131589	1337294868	1	0.08	0.000727272727272727	10814	1
4	Food 2	Intake 4	69	131951	1337295230	/users/cn/jespinosa/phecomp/data/CRG/20120502_FDF_CRG/20120502_FDF_CRG/20120516_FDF_CRG_c12.mtb	6272	434	WWFF	food_fat	4	131882	1337295161	1	0.0200000000000014	0.000289855072463788	10815	1
4	Drink 2	Intake 2	21	132310	1337295589	/users/cn/jespinosa/phecomp/data/CRG/20120502_FDF_CRG/20120502_FDF_CRG/20120516_FDF_CRG_c12.mtb	1775	NA	WWFF	water	2	132289	1337295568	1	0.02	0.000952380952380952	10816	1
4	Food 2	Intake 4	13	132398	1337295677	/users/cn/jespinosa/phecomp/data/CRG/20120502_FDF_CRG/20120502_FDF_CRG/20120516_FDF_CRG_c12.mtb	6280	105	WWFF	food_fat	4	132385	1337295664	1	0.0200000000000014	0.00153846153846165	10817	1
4	Food 2	Intake 4	14	132517	1337295796	/users/cn/jespinosa/phecomp/data/CRG/20120502_FDF_CRG/20120502_FDF_CRG/20120516_FDF_CRG_c12.mtb	6281	4948	WWFF	food_fat	4	132503	1337295782	1	0.0399999999999991	0.00285714285714279	10818	1
4	Drink 1	Intake 1	32	132546	1337295825	/users/cn/jespinosa/phecomp/data/CRG/20120502_FDF_CRG/20120502_FDF_CRG/20120516_FDF_CRG_c12.mtb	1897	NA	WWFF	water	1	132514	1337295793	1	0.12	0.00375	10819	1
4	Drink 1	Intake 1	19	137422	1337300701	/users/cn/jespinosa/phecomp/data/CRG/20120502_FDF_CRG/20120502_FDF_CRG/20120516_FDF_CRG_c12.mtb	1899	NA	WWFF	water	1	137403	1337300682	1	0.0600000000000001	0.00315789473684211	10820	1
4	Food 2	Intake 4	33	137498	1337300777	/users/cn/jespinosa/phecomp/data/CRG/20120502_FDF_CRG/20120502_FDF_CRG/20120516_FDF_CRG_c12.mtb	6287	3776	WWFF	food_fat	4	137465	1337300744	1	0.0200000000000014	0.000606060606060648	10821	1
4	Food 2	Intake 4	13	141287	1337304566	/users/cn/jespinosa/phecomp/data/CRG/20120502_FDF_CRG/20120502_FDF_CRG/20120516_FDF_CRG_c12.mtb	6296	138	WWFF	food_fat	4	141274	1337304553	1	0.0600000000000005	0.00461538461538465	10822	1
4	Food 2	Intake 4	12	141437	1337304716	/users/cn/jespinosa/phecomp/data/CRG/20120502_FDF_CRG/20120502_FDF_CRG/20120516_FDF_CRG_c12.mtb	6298	409	WWFF	food_fat	4	141425	1337304704	1	0.0399999999999991	0.00333333333333326	10823	1
4	Drink 1	Intake 1	19	141842	1337305121	/users/cn/jespinosa/phecomp/data/CRG/20120502_FDF_CRG/20120502_FDF_CRG/20120516_FDF_CRG_c12.mtb	1900	NA	WWFF	water	1	141823	1337305102	1	0.1	0.00526315789473684	10824	1
4	Food 2	Intake 4	115	141961	1337305240	/users/cn/jespinosa/phecomp/data/CRG/20120502_FDF_CRG/20120502_FDF_CRG/20120516_FDF_CRG_c12.mtb	6303	176	WWFF	food_fat	4	141846	1337305125	1	0.0800000000000001	0.000695652173913044	10825	1
4	Food 2	Intake 4	30	142167	1337305446	/users/cn/jespinosa/phecomp/data/CRG/20120502_FDF_CRG/20120502_FDF_CRG/20120516_FDF_CRG_c12.mtb	6306	29	WWFF	food_fat	4	142137	1337305416	1	0.0800000000000001	0.00266666666666667	10826	1
4	Food 1	Intake 3	93	142289	1337305568	/users/cn/jespinosa/phecomp/data/CRG/20120502_FDF_CRG/20120502_FDF_CRG/20120516_FDF_CRG_c12.mtb	4816	4	WWFF	food_fat	3	142196	1337305475	1	0.0399999999999991	0.000430107526881711	10827	1
4	Food 1	Intake 3	92	142385	1337305664	/users/cn/jespinosa/phecomp/data/CRG/20120502_FDF_CRG/20120502_FDF_CRG/20120516_FDF_CRG_c12.mtb	4817	11	WWFF	food_fat	3	142293	1337305572	1	0.0400000000000009	0.000434782608695662	10828	1
4	Food 1	Intake 3	95	142491	1337305770	/users/cn/jespinosa/phecomp/data/CRG/20120502_FDF_CRG/20120502_FDF_CRG/20120516_FDF_CRG_c12.mtb	4818	63	WWFF	food_fat	3	142396	1337305675	1	0.0399999999999991	0.000421052631578938	10829	1
4	Food 1	Intake 3	177	142731	1337306010	/users/cn/jespinosa/phecomp/data/CRG/20120502_FDF_CRG/20120502_FDF_CRG/20120516_FDF_CRG_c12.mtb	4819	326	WWFF	food_fat	3	142554	1337305833	1	0.0800000000000001	0.000451977401129944	10830	1
4	Drink 1	Intake 1	29	142990	1337306269	/users/cn/jespinosa/phecomp/data/CRG/20120502_FDF_CRG/20120502_FDF_CRG/20120516_FDF_CRG_c12.mtb	1901	NA	WWFF	water	1	142961	1337306240	1	0.0999999999999996	0.00344827586206895	10831	1
4	Food 2	Intake 4	13	143070	1337306349	/users/cn/jespinosa/phecomp/data/CRG/20120502_FDF_CRG/20120502_FDF_CRG/20120516_FDF_CRG_c12.mtb	6316	272	WWFF	food_fat	4	143057	1337306336	1	0.0200000000000014	0.00153846153846165	10832	1
4	Food 2	Intake 4	49	143391	1337306670	/users/cn/jespinosa/phecomp/data/CRG/20120502_FDF_CRG/20120502_FDF_CRG/20120516_FDF_CRG_c12.mtb	6319	305	WWFF	food_fat	4	143342	1337306621	1	0.0399999999999991	0.000816326530612226	10833	1
4	Food 2	Intake 4	26	143722	1337307001	/users/cn/jespinosa/phecomp/data/CRG/20120502_FDF_CRG/20120502_FDF_CRG/20120516_FDF_CRG_c12.mtb	6324	191	WWFF	food_fat	4	143696	1337306975	1	0.0200000000000014	0.000769230769230823	10834	1
4	Food 2	Intake 4	25	143938	1337307217	/users/cn/jespinosa/phecomp/data/CRG/20120502_FDF_CRG/20120502_FDF_CRG/20120516_FDF_CRG_c12.mtb	6327	2236	WWFF	food_fat	4	143913	1337307192	1	0.0599999999999987	0.00239999999999995	10835	1
4	Food 2	Intake 4	15	146189	1337309468	/users/cn/jespinosa/phecomp/data/CRG/20120502_FDF_CRG/20120502_FDF_CRG/20120516_FDF_CRG_c12.mtb	6328	2114	WWFF	food_fat	4	146174	1337309453	1	0.0200000000000014	0.00133333333333343	10836	1
4	Drink 1	Intake 1	13	146610	1337309889	/users/cn/jespinosa/phecomp/data/CRG/20120502_FDF_CRG/20120502_FDF_CRG/20120516_FDF_CRG_c12.mtb	1902	NA	WWFF	water	1	146597	1337309876	1	0.0600000000000001	0.00461538461538462	10837	1
4	Food 2	Intake 4	18	148321	1337311600	/users/cn/jespinosa/phecomp/data/CRG/20120502_FDF_CRG/20120502_FDF_CRG/20120516_FDF_CRG_c12.mtb	6332	3460	WWFF	food_fat	4	148303	1337311582	1	0.0200000000000014	0.00111111111111119	10838	1
4	Drink 1	Intake 1	10	149469	1337312748	/users/cn/jespinosa/phecomp/data/CRG/20120502_FDF_CRG/20120502_FDF_CRG/20120516_FDF_CRG_c12.mtb	1903	NA	WWFF	water	1	149459	1337312738	1	0.04	0.004	10839	1
4	Food 2	Intake 4	66	151847	1337315126	/users/cn/jespinosa/phecomp/data/CRG/20120502_FDF_CRG/20120502_FDF_CRG/20120516_FDF_CRG_c12.mtb	6343	48	WWFF	food_fat	4	151781	1337315060	1	0.0200000000000014	0.000303030303030324	10840	1
4	Food 2	Intake 4	52	151947	1337315226	/users/cn/jespinosa/phecomp/data/CRG/20120502_FDF_CRG/20120502_FDF_CRG/20120516_FDF_CRG_c12.mtb	6345	16	WWFF	food_fat	4	151895	1337315174	1	0.0400000000000009	0.000769230769230787	10841	1
4	Food 2	Intake 4	179	152142	1337315421	/users/cn/jespinosa/phecomp/data/CRG/20120502_FDF_CRG/20120502_FDF_CRG/20120516_FDF_CRG_c12.mtb	6346	4	WWFF	food_fat	4	151963	1337315242	1	0.0599999999999987	0.00033519553072625	10842	1
4	Drink 1	Intake 1	24	152158	1337315437	/users/cn/jespinosa/phecomp/data/CRG/20120502_FDF_CRG/20120502_FDF_CRG/20120516_FDF_CRG_c12.mtb	1904	NA	WWFF	water	1	152134	1337315413	1	0.0600000000000001	0.0025	10843	1
4	Food 2	Intake 4	155	152301	1337315580	/users/cn/jespinosa/phecomp/data/CRG/20120502_FDF_CRG/20120502_FDF_CRG/20120516_FDF_CRG_c12.mtb	6347	276	WWFF	food_fat	4	152146	1337315425	1	0.140000000000001	0.000903225806451619	10844	1
4	Food 1	Intake 3	75	152652	1337315931	/users/cn/jespinosa/phecomp/data/CRG/20120502_FDF_CRG/20120502_FDF_CRG/20120516_FDF_CRG_c12.mtb	4822	155	WWFF	food_fat	3	152577	1337315856	1	0.0400000000000009	0.000533333333333345	10845	1
4	Drink 2	Intake 2	28	152736	1337316015	/users/cn/jespinosa/phecomp/data/CRG/20120502_FDF_CRG/20120502_FDF_CRG/20120516_FDF_CRG_c12.mtb	1778	NA	WWFF	water	2	152708	1337315987	1	0.1	0.00357142857142857	10846	1
4	Food 2	Intake 4	20	152827	1337316106	/users/cn/jespinosa/phecomp/data/CRG/20120502_FDF_CRG/20120502_FDF_CRG/20120516_FDF_CRG_c12.mtb	6353	643	WWFF	food_fat	4	152807	1337316086	1	0.0200000000000014	0.00100000000000007	10847	1
4	Drink 2	Intake 2	49	153391	1337316670	/users/cn/jespinosa/phecomp/data/CRG/20120502_FDF_CRG/20120502_FDF_CRG/20120516_FDF_CRG_c12.mtb	1779	NA	WWFF	water	2	153342	1337316621	1	0.06	0.00122448979591837	10848	1
4	Food 2	Intake 4	48	153518	1337316797	/users/cn/jespinosa/phecomp/data/CRG/20120502_FDF_CRG/20120502_FDF_CRG/20120516_FDF_CRG_c12.mtb	6363	496	WWFF	food_fat	4	153470	1337316749	1	0.0200000000000014	0.000416666666666696	10849	1
4	Food 2	Intake 4	23	154037	1337317316	/users/cn/jespinosa/phecomp/data/CRG/20120502_FDF_CRG/20120502_FDF_CRG/20120516_FDF_CRG_c12.mtb	6367	820	WWFF	food_fat	4	154014	1337317293	1	0.0400000000000009	0.00173913043478265	10850	1
4	Food 2	Intake 4	48	154905	1337318184	/users/cn/jespinosa/phecomp/data/CRG/20120502_FDF_CRG/20120502_FDF_CRG/20120516_FDF_CRG_c12.mtb	6369	1031	WWFF	food_fat	4	154857	1337318136	1	0.0399999999999991	0.000833333333333315	10851	1
4	Food 2	Intake 4	26	155962	1337319241	/users/cn/jespinosa/phecomp/data/CRG/20120502_FDF_CRG/20120502_FDF_CRG/20120516_FDF_CRG_c12.mtb	6372	10	WWFF	food_fat	4	155936	1337319215	1	0.0400000000000009	0.00153846153846157	10852	1
4	Food 2	Intake 4	20	155992	1337319271	/users/cn/jespinosa/phecomp/data/CRG/20120502_FDF_CRG/20120502_FDF_CRG/20120516_FDF_CRG_c12.mtb	6373	428	WWFF	food_fat	4	155972	1337319251	1	0.0399999999999991	0.00199999999999995	10853	1
4	Food 2	Intake 4	203	156623	1337319902	/users/cn/jespinosa/phecomp/data/CRG/20120502_FDF_CRG/20120502_FDF_CRG/20120516_FDF_CRG_c12.mtb	6379	455	WWFF	food_fat	4	156420	1337319699	1	0.0600000000000005	0.000295566502463057	10854	1
4	Drink 1	Intake 1	36	156944	1337320223	/users/cn/jespinosa/phecomp/data/CRG/20120502_FDF_CRG/20120502_FDF_CRG/20120516_FDF_CRG_c12.mtb	1905	NA	WWFF	water	1	156908	1337320187	1	0.1	0.00277777777777778	10855	1
4	Food 2	Intake 4	124	157202	1337320481	/users/cn/jespinosa/phecomp/data/CRG/20120502_FDF_CRG/20120502_FDF_CRG/20120516_FDF_CRG_c12.mtb	6384	729	WWFF	food_fat	4	157078	1337320357	1	0.0400000000000009	0.000322580645161298	10856	1
4	Food 2	Intake 4	12	157943	1337321222	/users/cn/jespinosa/phecomp/data/CRG/20120502_FDF_CRG/20120502_FDF_CRG/20120516_FDF_CRG_c12.mtb	6392	112	WWFF	food_fat	4	157931	1337321210	1	0.0400000000000009	0.00333333333333341	10857	1
4	Food 2	Intake 4	41	158096	1337321375	/users/cn/jespinosa/phecomp/data/CRG/20120502_FDF_CRG/20120502_FDF_CRG/20120516_FDF_CRG_c12.mtb	6395	11281	WWFF	food_fat	4	158055	1337321334	1	0.0599999999999987	0.00146341463414631	10858	1
4	Drink 2	Intake 2	28	158114	1337321393	/users/cn/jespinosa/phecomp/data/CRG/20120502_FDF_CRG/20120502_FDF_CRG/20120516_FDF_CRG_c12.mtb	1783	NA	WWFF	water	2	158086	1337321365	1	0.08	0.00285714285714286	10859	1
4	Drink 1	Intake 1	22	161664	1337324943	/users/cn/jespinosa/phecomp/data/CRG/20120502_FDF_CRG/20120502_FDF_CRG/20120516_FDF_CRG_c12.mtb	1907	NA	WWFF	water	1	161642	1337324921	1	0.12	0.00545454545454545	10860	1
4	Drink 1	Intake 1	12	162114	1337325393	/users/cn/jespinosa/phecomp/data/CRG/20120502_FDF_CRG/20120502_FDF_CRG/20120516_FDF_CRG_c12.mtb	1908	NA	WWFF	water	1	162102	1337325381	1	0.0600000000000001	0.00500000000000001	10861	1
4	Food 1	Intake 3	25	166	1337332681	/users/cn/jespinosa/phecomp/data/CRG/20120502_FDF_CRG/20120502_FDF_CRG/20120518_FDF_CRG_c12.mtb	4831	40	WWFF	food_fat	3	141	1337332656	1	0.24	0.0096	10862	1
4	Food 1	Intake 3	100	306	1337332821	/users/cn/jespinosa/phecomp/data/CRG/20120502_FDF_CRG/20120502_FDF_CRG/20120518_FDF_CRG_c12.mtb	4832	31	WWFF	food_fat	3	206	1337332721	1	1.72	0.0172	10863	1
4	Food 1	Intake 3	117	454	1337332969	/users/cn/jespinosa/phecomp/data/CRG/20120502_FDF_CRG/20120502_FDF_CRG/20120518_FDF_CRG_c12.mtb	4833	20	WWFF	food_fat	3	337	1337332852	1	3.02	0.0258119658119658	10864	1
4	Food 1	Intake 3	36	510	1337333025	/users/cn/jespinosa/phecomp/data/CRG/20120502_FDF_CRG/20120502_FDF_CRG/20120518_FDF_CRG_c12.mtb	4834	COLL	WWFF	food_fat	3	474	1337332989	1	0.0799999999999992	0.0022222222222222	10865	1
4	Food 2	Intake 4	13	515	1337333030	/users/cn/jespinosa/phecomp/data/CRG/20120502_FDF_CRG/20120502_FDF_CRG/20120518_FDF_CRG_c12.mtb	6403	4971	WWFF	food_fat	4	502	1337333017	1	0.04	0.00307692307692308	10866	1
4	Drink 1	Intake 1	21	3302	1337335817	/users/cn/jespinosa/phecomp/data/CRG/20120502_FDF_CRG/20120502_FDF_CRG/20120518_FDF_CRG_c12.mtb	1909	NA	WWFF	water	1	3281	1337335796	1	0.08	0.00380952380952381	10867	1
4	Food 1	Intake 3	18	5504	1337338019	/users/cn/jespinosa/phecomp/data/CRG/20120502_FDF_CRG/20120502_FDF_CRG/20120518_FDF_CRG_c12.mtb	4845	COLL	WWFF	food_fat	3	5486	1337338001	1	0.22	0.0122222222222222	10868	1
4	Food 2	Intake 4	15	5503	1337338018	/users/cn/jespinosa/phecomp/data/CRG/20120502_FDF_CRG/20120502_FDF_CRG/20120518_FDF_CRG_c12.mtb	6405	1323	WWFF	food_fat	4	5488	1337338003	1	0.1	0.00666666666666667	10869	1
4	Drink 1	Intake 1	26	6165	1337338680	/users/cn/jespinosa/phecomp/data/CRG/20120502_FDF_CRG/20120502_FDF_CRG/20120518_FDF_CRG_c12.mtb	1910	NA	WWFF	water	1	6139	1337338654	1	0.12	0.00461538461538461	10870	1
4	Food 1	Intake 3	14	6840	1337339355	/users/cn/jespinosa/phecomp/data/CRG/20120502_FDF_CRG/20120502_FDF_CRG/20120518_FDF_CRG_c12.mtb	4848	1916	WWFF	food_fat	3	6826	1337339341	1	0.04	0.00285714285714286	10871	1
4	Drink 1	Intake 1	21	8006	1337340521	/users/cn/jespinosa/phecomp/data/CRG/20120502_FDF_CRG/20120502_FDF_CRG/20120518_FDF_CRG_c12.mtb	1911	NA	WWFF	water	1	7985	1337340500	1	0.14	0.00666666666666667	10872	1
4	Food 2	Intake 4	13	8769	1337341284	/users/cn/jespinosa/phecomp/data/CRG/20120502_FDF_CRG/20120502_FDF_CRG/20120518_FDF_CRG_c12.mtb	6407	3869	WWFF	food_fat	4	8756	1337341271	1	0.1	0.00769230769230769	10873	1
4	Drink 1	Intake 1	13	9326	1337341841	/users/cn/jespinosa/phecomp/data/CRG/20120502_FDF_CRG/20120502_FDF_CRG/20120518_FDF_CRG_c12.mtb	1912	NA	WWFF	water	1	9313	1337341828	1	0.04	0.00307692307692308	10874	1
4	Food 1	Intake 3	26	12664	1337345179	/users/cn/jespinosa/phecomp/data/CRG/20120502_FDF_CRG/20120502_FDF_CRG/20120518_FDF_CRG_c12.mtb	4866	COLL	WWFF	food_fat	3	12638	1337345153	1	0.22	0.00846153846153846	10875	1
4	Food 2	Intake 4	13	12658	1337345173	/users/cn/jespinosa/phecomp/data/CRG/20120502_FDF_CRG/20120502_FDF_CRG/20120518_FDF_CRG_c12.mtb	6410	1245	WWFF	food_fat	4	12645	1337345160	1	0.04	0.00307692307692308	10876	1
4	Food 2	Intake 4	9	13912	1337346427	/users/cn/jespinosa/phecomp/data/CRG/20120502_FDF_CRG/20120502_FDF_CRG/20120518_FDF_CRG_c12.mtb	6411	1774	WWFF	food_fat	4	13903	1337346418	1	0.02	0.00222222222222222	10877	1
4	Food 2	Intake 4	15	15701	1337348216	/users/cn/jespinosa/phecomp/data/CRG/20120502_FDF_CRG/20120502_FDF_CRG/20120518_FDF_CRG_c12.mtb	6413	COLL	WWFF	food_fat	4	15686	1337348201	1	0.12	0.008	10878	1
4	Food 1	Intake 3	13	15701	1337348216	/users/cn/jespinosa/phecomp/data/CRG/20120502_FDF_CRG/20120502_FDF_CRG/20120518_FDF_CRG_c12.mtb	4873	2945	WWFF	food_fat	3	15688	1337348203	1	0.28	0.0215384615384615	10879	1
4	Drink 1	Intake 1	13	15970	1337348485	/users/cn/jespinosa/phecomp/data/CRG/20120502_FDF_CRG/20120502_FDF_CRG/20120518_FDF_CRG_c12.mtb	1913	NA	WWFF	water	1	15957	1337348472	1	0.04	0.00307692307692308	10880	1
4	Drink 1	Intake 1	23	16575	1337349090	/users/cn/jespinosa/phecomp/data/CRG/20120502_FDF_CRG/20120502_FDF_CRG/20120518_FDF_CRG_c12.mtb	1914	NA	WWFF	water	1	16552	1337349067	1	0.06	0.00260869565217391	10881	1
4	Food 1	Intake 3	17	18663	1337351178	/users/cn/jespinosa/phecomp/data/CRG/20120502_FDF_CRG/20120502_FDF_CRG/20120518_FDF_CRG_c12.mtb	4880	1663	WWFF	food_fat	3	18646	1337351161	1	0.0599999999999996	0.00352941176470586	10882	1
4	Drink 1	Intake 1	15	19279	1337351794	/users/cn/jespinosa/phecomp/data/CRG/20120502_FDF_CRG/20120502_FDF_CRG/20120518_FDF_CRG_c12.mtb	1915	NA	WWFF	water	1	19264	1337351779	1	0.04	0.00266666666666667	10883	1
4	Drink 1	Intake 1	17	19897	1337352412	/users/cn/jespinosa/phecomp/data/CRG/20120502_FDF_CRG/20120502_FDF_CRG/20120518_FDF_CRG_c12.mtb	1916	NA	WWFF	water	1	19880	1337352395	1	0.04	0.00235294117647059	10884	1
4	Food 1	Intake 3	15	20341	1337352856	/users/cn/jespinosa/phecomp/data/CRG/20120502_FDF_CRG/20120502_FDF_CRG/20120518_FDF_CRG_c12.mtb	4883	4411	WWFF	food_fat	3	20326	1337352841	1	0.04	0.00266666666666667	10885	1
4	Drink 1	Intake 1	28	21466	1337353981	/users/cn/jespinosa/phecomp/data/CRG/20120502_FDF_CRG/20120502_FDF_CRG/20120518_FDF_CRG_c12.mtb	1917	NA	WWFF	water	1	21438	1337353953	1	0.1	0.00357142857142857	10886	1
4	Food 1	Intake 3	44	24796	1337357311	/users/cn/jespinosa/phecomp/data/CRG/20120502_FDF_CRG/20120502_FDF_CRG/20120518_FDF_CRG_c12.mtb	4897	COLL	WWFF	food_fat	3	24752	1337357267	1	0.24	0.00545454545454545	10887	1
4	Food 2	Intake 4	28	24782	1337357297	/users/cn/jespinosa/phecomp/data/CRG/20120502_FDF_CRG/20120502_FDF_CRG/20120518_FDF_CRG_c12.mtb	6415	572	WWFF	food_fat	4	24754	1337357269	1	0.14	0.005	10888	1
4	Food 1	Intake 3	18	25372	1337357887	/users/cn/jespinosa/phecomp/data/CRG/20120502_FDF_CRG/20120502_FDF_CRG/20120518_FDF_CRG_c12.mtb	4904	3780	WWFF	food_fat	3	25354	1337357869	1	0.0200000000000005	0.00111111111111114	10889	1
4	Drink 1	Intake 1	16	28655	1337361170	/users/cn/jespinosa/phecomp/data/CRG/20120502_FDF_CRG/20120502_FDF_CRG/20120518_FDF_CRG_c12.mtb	1918	NA	WWFF	water	1	28639	1337361154	1	0.14	0.00875	10890	1
4	Food 2	Intake 4	19	29171	1337361686	/users/cn/jespinosa/phecomp/data/CRG/20120502_FDF_CRG/20120502_FDF_CRG/20120518_FDF_CRG_c12.mtb	6417	522	WWFF	food_fat	4	29152	1337361667	1	0.02	0.00105263157894737	10891	1
4	Food 1	Intake 3	40	29733	1337362248	/users/cn/jespinosa/phecomp/data/CRG/20120502_FDF_CRG/20120502_FDF_CRG/20120518_FDF_CRG_c12.mtb	4912	COLL	WWFF	food_fat	3	29693	1337362208	1	0.04	0.001	10892	1
4	Food 2	Intake 4	16	29731	1337362246	/users/cn/jespinosa/phecomp/data/CRG/20120502_FDF_CRG/20120502_FDF_CRG/20120518_FDF_CRG_c12.mtb	6418	752	WWFF	food_fat	4	29715	1337362230	1	0.02	0.00125	10893	1
4	Food 1	Intake 3	60	30543	1337363058	/users/cn/jespinosa/phecomp/data/CRG/20120502_FDF_CRG/20120502_FDF_CRG/20120518_FDF_CRG_c12.mtb	4918	COLL	WWFF	food_fat	3	30483	1337362998	1	0.28	0.00466666666666667	10894	1
4	Food 2	Intake 4	46	30537	1337363052	/users/cn/jespinosa/phecomp/data/CRG/20120502_FDF_CRG/20120502_FDF_CRG/20120518_FDF_CRG_c12.mtb	6420	648	WWFF	food_fat	4	30491	1337363006	1	0.12	0.00260869565217391	10895	1
4	Drink 1	Intake 1	25	31190	1337363705	/users/cn/jespinosa/phecomp/data/CRG/20120502_FDF_CRG/20120502_FDF_CRG/20120518_FDF_CRG_c12.mtb	1919	NA	WWFF	water	1	31165	1337363680	1	0.1	0.004	10896	1
4	Food 1	Intake 3	19	31204	1337363719	/users/cn/jespinosa/phecomp/data/CRG/20120502_FDF_CRG/20120502_FDF_CRG/20120518_FDF_CRG_c12.mtb	4920	1351	WWFF	food_fat	3	31185	1337363700	1	0.0600000000000005	0.00315789473684213	10897	1
4	Food 2	Intake 4	309	32864	1337365379	/users/cn/jespinosa/phecomp/data/CRG/20120502_FDF_CRG/20120502_FDF_CRG/20120518_FDF_CRG_c12.mtb	6422	COLL	WWFF	food_fat	4	32555	1337365070	1	1.08	0.00349514563106796	10898	1
4	Food 1	Intake 3	52	32745	1337365260	/users/cn/jespinosa/phecomp/data/CRG/20120502_FDF_CRG/20120502_FDF_CRG/20120518_FDF_CRG_c12.mtb	4932	63	WWFF	food_fat	3	32693	1337365208	1	0.42	0.00807692307692308	10899	1
4	Food 1	Intake 3	133	32941	1337365456	/users/cn/jespinosa/phecomp/data/CRG/20120502_FDF_CRG/20120502_FDF_CRG/20120518_FDF_CRG_c12.mtb	4933	77	WWFF	food_fat	3	32808	1337365323	1	0.180000000000001	0.00135338345864662	10900	1
4	Food 1	Intake 3	71	33089	1337365604	/users/cn/jespinosa/phecomp/data/CRG/20120502_FDF_CRG/20120502_FDF_CRG/20120518_FDF_CRG_c12.mtb	4934	COLL	WWFF	food_fat	3	33018	1337365533	1	0.54	0.0076056338028169	10901	1
4	Food 2	Intake 4	274	33319	1337365834	/users/cn/jespinosa/phecomp/data/CRG/20120502_FDF_CRG/20120502_FDF_CRG/20120518_FDF_CRG_c12.mtb	6425	COLL	WWFF	food_fat	4	33045	1337365560	1	0.14	0.000510948905109489	10902	1
4	Food 1	Intake 3	100	33195	1337365710	/users/cn/jespinosa/phecomp/data/CRG/20120502_FDF_CRG/20120502_FDF_CRG/20120518_FDF_CRG_c12.mtb	4935	161	WWFF	food_fat	3	33095	1337365610	1	1.02	0.0102	10903	1
4	Food 2	Intake 4	41	33397	1337365912	/users/cn/jespinosa/phecomp/data/CRG/20120502_FDF_CRG/20120502_FDF_CRG/20120518_FDF_CRG_c12.mtb	6426	23	WWFF	food_fat	4	33356	1337365871	1	0.38	0.00926829268292683	10904	1
4	Food 2	Intake 4	720	34140	1337366655	/users/cn/jespinosa/phecomp/data/CRG/20120502_FDF_CRG/20120502_FDF_CRG/20120518_FDF_CRG_c12.mtb	6427	30	WWFF	food_fat	4	33420	1337365935	1	0.04	5.55555555555556e-05	10905	1
4	Food 2	Intake 4	748	34918	1337367433	/users/cn/jespinosa/phecomp/data/CRG/20120502_FDF_CRG/20120502_FDF_CRG/20120518_FDF_CRG_c12.mtb	6428	507	WWFF	food_fat	4	34170	1337366685	1	2.66	0.00355614973262032	10906	1
4	Food 2	Intake 4	536	35961	1337368476	/users/cn/jespinosa/phecomp/data/CRG/20120502_FDF_CRG/20120502_FDF_CRG/20120518_FDF_CRG_c12.mtb	6430	COLL	WWFF	food_fat	4	35425	1337367940	1	1.44	0.0026865671641791	10907	1
4	Drink 1	Intake 1	25	35714	1337368229	/users/cn/jespinosa/phecomp/data/CRG/20120502_FDF_CRG/20120502_FDF_CRG/20120518_FDF_CRG_c12.mtb	1923	NA	WWFF	water	1	35689	1337368204	1	0.02	0.0008	10908	1
4	Food 1	Intake 3	66	35835	1337368350	/users/cn/jespinosa/phecomp/data/CRG/20120502_FDF_CRG/20120502_FDF_CRG/20120518_FDF_CRG_c12.mtb	4938	25	WWFF	food_fat	3	35769	1337368284	1	0.0599999999999996	0.000909090909090903	10909	1
4	Food 1	Intake 3	28	35888	1337368403	/users/cn/jespinosa/phecomp/data/CRG/20120502_FDF_CRG/20120502_FDF_CRG/20120518_FDF_CRG_c12.mtb	4939	35	WWFF	food_fat	3	35860	1337368375	1	0.0200000000000005	0.000714285714285732	10910	1
4	Food 1	Intake 3	31	35954	1337368469	/users/cn/jespinosa/phecomp/data/CRG/20120502_FDF_CRG/20120502_FDF_CRG/20120518_FDF_CRG_c12.mtb	4940	14	WWFF	food_fat	3	35923	1337368438	1	0.0599999999999996	0.00193548387096773	10911	1
4	Food 2	Intake 4	487	36455	1337368970	/users/cn/jespinosa/phecomp/data/CRG/20120502_FDF_CRG/20120502_FDF_CRG/20120518_FDF_CRG_c12.mtb	6431	26	WWFF	food_fat	4	35968	1337368483	1	0.0600000000000005	0.000123203285420946	10912	1
4	Food 2	Intake 4	99	36580	1337369095	/users/cn/jespinosa/phecomp/data/CRG/20120502_FDF_CRG/20120502_FDF_CRG/20120518_FDF_CRG_c12.mtb	6432	429	WWFF	food_fat	4	36481	1337368996	1	0.12	0.00121212121212121	10913	1
4	Drink 2	Intake 2	16	36809	1337369324	/users/cn/jespinosa/phecomp/data/CRG/20120502_FDF_CRG/20120502_FDF_CRG/20120518_FDF_CRG_c12.mtb	1795	NA	WWFF	water	2	36793	1337369308	1	0.02	0.00125	10914	1
4	Food 2	Intake 4	93	37102	1337369617	/users/cn/jespinosa/phecomp/data/CRG/20120502_FDF_CRG/20120502_FDF_CRG/20120518_FDF_CRG_c12.mtb	6435	233	WWFF	food_fat	4	37009	1337369524	1	0.38	0.00408602150537634	10915	1
4	Food 2	Intake 4	141	37476	1337369991	/users/cn/jespinosa/phecomp/data/CRG/20120502_FDF_CRG/20120502_FDF_CRG/20120518_FDF_CRG_c12.mtb	6440	COLL	WWFF	food_fat	4	37335	1337369850	1	0.04	0.000283687943262411	10916	1
4	Food 1	Intake 3	33	37429	1337369944	/users/cn/jespinosa/phecomp/data/CRG/20120502_FDF_CRG/20120502_FDF_CRG/20120518_FDF_CRG_c12.mtb	4942	24	WWFF	food_fat	3	37396	1337369911	1	0.0200000000000005	0.000606060606060621	10917	1
4	Food 1	Intake 3	79	37532	1337370047	/users/cn/jespinosa/phecomp/data/CRG/20120502_FDF_CRG/20120502_FDF_CRG/20120518_FDF_CRG_c12.mtb	4943	COLL	WWFF	food_fat	3	37453	1337369968	1	0.04	0.000506329113924051	10918	1
4	Food 2	Intake 4	41	37540	1337370055	/users/cn/jespinosa/phecomp/data/CRG/20120502_FDF_CRG/20120502_FDF_CRG/20120518_FDF_CRG_c12.mtb	6441	286	WWFF	food_fat	4	37499	1337370014	1	0.04	0.000975609756097561	10919	1
4	Food 2	Intake 4	144	37970	1337370485	/users/cn/jespinosa/phecomp/data/CRG/20120502_FDF_CRG/20120502_FDF_CRG/20120518_FDF_CRG_c12.mtb	6444	78	WWFF	food_fat	4	37826	1337370341	1	0.100000000000001	0.000694444444444451	10920	1
4	Drink 2	Intake 2	20	38046	1337370561	/users/cn/jespinosa/phecomp/data/CRG/20120502_FDF_CRG/20120502_FDF_CRG/20120518_FDF_CRG_c12.mtb	1796	NA	WWFF	water	2	38026	1337370541	1	0.04	0.002	10921	1
4	Food 2	Intake 4	137	38185	1337370700	/users/cn/jespinosa/phecomp/data/CRG/20120502_FDF_CRG/20120502_FDF_CRG/20120518_FDF_CRG_c12.mtb	6446	4	WWFF	food_fat	4	38048	1337370563	1	0.0800000000000001	0.000583941605839417	10922	1
4	Food 1	Intake 3	62	38251	1337370766	/users/cn/jespinosa/phecomp/data/CRG/20120502_FDF_CRG/20120502_FDF_CRG/20120518_FDF_CRG_c12.mtb	4946	COLL	WWFF	food_fat	3	38189	1337370704	1	0.0200000000000005	0.000322580645161298	10923	1
4	Food 2	Intake 4	84	38322	1337370837	/users/cn/jespinosa/phecomp/data/CRG/20120502_FDF_CRG/20120502_FDF_CRG/20120518_FDF_CRG_c12.mtb	6447	280	WWFF	food_fat	4	38238	1337370753	1	0.82	0.00976190476190476	10924	1
4	Food 2	Intake 4	139	38741	1337371256	/users/cn/jespinosa/phecomp/data/CRG/20120502_FDF_CRG/20120502_FDF_CRG/20120518_FDF_CRG_c12.mtb	6451	41	WWFF	food_fat	4	38602	1337371117	1	0.3	0.00215827338129496	10925	1
4	Food 2	Intake 4	308	39090	1337371605	/users/cn/jespinosa/phecomp/data/CRG/20120502_FDF_CRG/20120502_FDF_CRG/20120518_FDF_CRG_c12.mtb	6452	297	WWFF	food_fat	4	38782	1337371297	1	0.0600000000000005	0.000194805194805196	10926	1
4	Drink 2	Intake 2	23	39016	1337371531	/users/cn/jespinosa/phecomp/data/CRG/20120502_FDF_CRG/20120502_FDF_CRG/20120518_FDF_CRG_c12.mtb	1798	NA	WWFF	water	2	38993	1337371508	1	0.02	0.000869565217391304	10927	1
4	Food 2	Intake 4	56	39443	1337371958	/users/cn/jespinosa/phecomp/data/CRG/20120502_FDF_CRG/20120502_FDF_CRG/20120518_FDF_CRG_c12.mtb	6454	130	WWFF	food_fat	4	39387	1337371902	1	0.04	0.000714285714285714	10928	1
4	Food 2	Intake 4	224	39797	1337372312	/users/cn/jespinosa/phecomp/data/CRG/20120502_FDF_CRG/20120502_FDF_CRG/20120518_FDF_CRG_c12.mtb	6457	390	WWFF	food_fat	4	39573	1337372088	1	0.100000000000001	0.000446428571428576	10929	1
4	Food 1	Intake 3	70	40257	1337372772	/users/cn/jespinosa/phecomp/data/CRG/20120502_FDF_CRG/20120502_FDF_CRG/20120518_FDF_CRG_c12.mtb	4950	COLL	WWFF	food_fat	3	40187	1337372702	1	0.0800000000000001	0.00114285714285714	10930	1
4	Food 2	Intake 4	18	40270	1337372785	/users/cn/jespinosa/phecomp/data/CRG/20120502_FDF_CRG/20120502_FDF_CRG/20120518_FDF_CRG_c12.mtb	6460	198	WWFF	food_fat	4	40252	1337372767	1	0.04	0.00222222222222222	10931	1
4	Food 2	Intake 4	113	40581	1337373096	/users/cn/jespinosa/phecomp/data/CRG/20120502_FDF_CRG/20120502_FDF_CRG/20120518_FDF_CRG_c12.mtb	6462	27	WWFF	food_fat	4	40468	1337372983	1	0.0599999999999996	0.00053097345132743	10932	1
4	Food 2	Intake 4	262	40870	1337373385	/users/cn/jespinosa/phecomp/data/CRG/20120502_FDF_CRG/20120502_FDF_CRG/20120518_FDF_CRG_c12.mtb	6463	12	WWFF	food_fat	4	40608	1337373123	1	0.180000000000001	0.000687022900763363	10933	1
4	Drink 1	Intake 1	22	40845	1337373360	/users/cn/jespinosa/phecomp/data/CRG/20120502_FDF_CRG/20120502_FDF_CRG/20120518_FDF_CRG_c12.mtb	1928	NA	WWFF	water	1	40823	1337373338	1	0.04	0.00181818181818182	10934	1
4	Food 2	Intake 4	16	40898	1337373413	/users/cn/jespinosa/phecomp/data/CRG/20120502_FDF_CRG/20120502_FDF_CRG/20120518_FDF_CRG_c12.mtb	6464	555	WWFF	food_fat	4	40882	1337373397	1	0.04	0.0025	10935	1
4	Food 2	Intake 4	25	41478	1337373993	/users/cn/jespinosa/phecomp/data/CRG/20120502_FDF_CRG/20120502_FDF_CRG/20120518_FDF_CRG_c12.mtb	6468	8	WWFF	food_fat	4	41453	1337373968	1	0.04	0.0016	10936	1
4	Drink 1	Intake 1	19	41487	1337374002	/users/cn/jespinosa/phecomp/data/CRG/20120502_FDF_CRG/20120502_FDF_CRG/20120518_FDF_CRG_c12.mtb	1929	NA	WWFF	water	1	41468	1337373983	1	0.02	0.00105263157894737	10937	1
4	Food 2	Intake 4	18	41504	1337374019	/users/cn/jespinosa/phecomp/data/CRG/20120502_FDF_CRG/20120502_FDF_CRG/20120518_FDF_CRG_c12.mtb	6469	5491	WWFF	food_fat	4	41486	1337374001	1	0.0200000000000005	0.00111111111111114	10938	1
4	Drink 1	Intake 1	22	43076	1337375591	/users/cn/jespinosa/phecomp/data/CRG/20120502_FDF_CRG/20120502_FDF_CRG/20120518_FDF_CRG_c12.mtb	1930	NA	WWFF	water	1	43054	1337375569	1	0.0800000000000001	0.00363636363636364	10939	1
4	Drink 1	Intake 1	17	45602	1337378117	/users/cn/jespinosa/phecomp/data/CRG/20120502_FDF_CRG/20120502_FDF_CRG/20120518_FDF_CRG_c12.mtb	1931	NA	WWFF	water	1	45585	1337378100	1	0.02	0.00117647058823529	10940	1
4	Food 1	Intake 3	68	47063	1337379578	/users/cn/jespinosa/phecomp/data/CRG/20120502_FDF_CRG/20120502_FDF_CRG/20120518_FDF_CRG_c12.mtb	4953	133	WWFF	food_fat	3	46995	1337379510	1	0.0800000000000001	0.0011764705882353	10941	1
4	Food 2	Intake 4	265	47461	1337379976	/users/cn/jespinosa/phecomp/data/CRG/20120502_FDF_CRG/20120502_FDF_CRG/20120518_FDF_CRG_c12.mtb	6474	104	WWFF	food_fat	4	47196	1337379711	1	0.360000000000001	0.00135849056603774	10942	1
4	Drink 2	Intake 2	16	47566	1337380081	/users/cn/jespinosa/phecomp/data/CRG/20120502_FDF_CRG/20120502_FDF_CRG/20120518_FDF_CRG_c12.mtb	1800	NA	WWFF	water	2	47550	1337380065	1	0.02	0.00125	10943	1
4	Food 2	Intake 4	57	47622	1337380137	/users/cn/jespinosa/phecomp/data/CRG/20120502_FDF_CRG/20120502_FDF_CRG/20120518_FDF_CRG_c12.mtb	6475	68	WWFF	food_fat	4	47565	1337380080	1	0.0399999999999991	0.000701754385964897	10944	1
4	Food 2	Intake 4	310	48000	1337380515	/users/cn/jespinosa/phecomp/data/CRG/20120502_FDF_CRG/20120502_FDF_CRG/20120518_FDF_CRG_c12.mtb	6476	109	WWFF	food_fat	4	47690	1337380205	1	0.359999999999999	0.00116129032258064	10945	1
4	Food 2	Intake 4	184	48293	1337380808	/users/cn/jespinosa/phecomp/data/CRG/20120502_FDF_CRG/20120502_FDF_CRG/20120518_FDF_CRG_c12.mtb	6477	295	WWFF	food_fat	4	48109	1337380624	1	0.0400000000000009	0.000217391304347831	10946	1
4	Food 2	Intake 4	71	48659	1337381174	/users/cn/jespinosa/phecomp/data/CRG/20120502_FDF_CRG/20120502_FDF_CRG/20120518_FDF_CRG_c12.mtb	6479	192	WWFF	food_fat	4	48588	1337381103	1	0.0400000000000009	0.000563380281690154	10947	1
4	Drink 2	Intake 2	54	48789	1337381304	/users/cn/jespinosa/phecomp/data/CRG/20120502_FDF_CRG/20120502_FDF_CRG/20120518_FDF_CRG_c12.mtb	1802	NA	WWFF	water	2	48735	1337381250	1	0.06	0.00111111111111111	10948	1
4	Food 1	Intake 3	118	48969	1337381484	/users/cn/jespinosa/phecomp/data/CRG/20120502_FDF_CRG/20120502_FDF_CRG/20120518_FDF_CRG_c12.mtb	4958	156	WWFF	food_fat	3	48851	1337381366	1	0.0200000000000005	0.000169491525423733	10949	1
4	Food 2	Intake 4	326	49451	1337381966	/users/cn/jespinosa/phecomp/data/CRG/20120502_FDF_CRG/20120502_FDF_CRG/20120518_FDF_CRG_c12.mtb	6483	171	WWFF	food_fat	4	49125	1337381640	1	0.0600000000000005	0.000184049079754603	10950	1
4	Food 2	Intake 4	30	49652	1337382167	/users/cn/jespinosa/phecomp/data/CRG/20120502_FDF_CRG/20120502_FDF_CRG/20120518_FDF_CRG_c12.mtb	6485	33	WWFF	food_fat	4	49622	1337382137	1	0.24	0.008	10951	1
4	Food 2	Intake 4	131	49816	1337382331	/users/cn/jespinosa/phecomp/data/CRG/20120502_FDF_CRG/20120502_FDF_CRG/20120518_FDF_CRG_c12.mtb	6486	760	WWFF	food_fat	4	49685	1337382200	1	0.0800000000000001	0.000610687022900764	10952	1
4	Drink 1	Intake 1	45	50444	1337382959	/users/cn/jespinosa/phecomp/data/CRG/20120502_FDF_CRG/20120502_FDF_CRG/20120518_FDF_CRG_c12.mtb	1932	NA	WWFF	water	1	50399	1337382914	1	0.02	0.000444444444444444	10953	1
4	Food 2	Intake 4	224	50800	1337383315	/users/cn/jespinosa/phecomp/data/CRG/20120502_FDF_CRG/20120502_FDF_CRG/20120518_FDF_CRG_c12.mtb	6490	559	WWFF	food_fat	4	50576	1337383091	1	0.0200000000000014	8.92857142857205e-05	10954	1
4	Food 2	Intake 4	24	51383	1337383898	/users/cn/jespinosa/phecomp/data/CRG/20120502_FDF_CRG/20120502_FDF_CRG/20120518_FDF_CRG_c12.mtb	6493	2460	WWFF	food_fat	4	51359	1337383874	1	0.260000000000002	0.0108333333333334	10955	1
4	Drink 1	Intake 1	14	53844	1337386359	/users/cn/jespinosa/phecomp/data/CRG/20120502_FDF_CRG/20120502_FDF_CRG/20120518_FDF_CRG_c12.mtb	1934	NA	WWFF	water	1	53830	1337386345	1	0.0399999999999998	0.00285714285714284	10956	1
4	Food 2	Intake 4	9	53852	1337386367	/users/cn/jespinosa/phecomp/data/CRG/20120502_FDF_CRG/20120502_FDF_CRG/20120518_FDF_CRG_c12.mtb	6501	2087	WWFF	food_fat	4	53843	1337386358	1	0.0399999999999991	0.00444444444444434	10957	1
4	Drink 1	Intake 1	22	55612	1337388127	/users/cn/jespinosa/phecomp/data/CRG/20120502_FDF_CRG/20120502_FDF_CRG/20120518_FDF_CRG_c12.mtb	1935	NA	WWFF	water	1	55590	1337388105	1	0.0800000000000001	0.00363636363636364	10958	1
4	Food 2	Intake 4	33	55972	1337388487	/users/cn/jespinosa/phecomp/data/CRG/20120502_FDF_CRG/20120502_FDF_CRG/20120518_FDF_CRG_c12.mtb	6504	2773	WWFF	food_fat	4	55939	1337388454	1	0.0400000000000009	0.00121212121212124	10959	1
4	Drink 2	Intake 2	17	57771	1337390286	/users/cn/jespinosa/phecomp/data/CRG/20120502_FDF_CRG/20120502_FDF_CRG/20120518_FDF_CRG_c12.mtb	1807	NA	WWFF	water	2	57754	1337390269	1	0.02	0.00117647058823529	10960	1
4	Food 2	Intake 4	20	58765	1337391280	/users/cn/jespinosa/phecomp/data/CRG/20120502_FDF_CRG/20120502_FDF_CRG/20120518_FDF_CRG_c12.mtb	6511	2679	WWFF	food_fat	4	58745	1337391260	1	0.0200000000000014	0.00100000000000007	10961	1
4	Food 2	Intake 4	261	61705	1337394220	/users/cn/jespinosa/phecomp/data/CRG/20120502_FDF_CRG/20120502_FDF_CRG/20120518_FDF_CRG_c12.mtb	6522	20	WWFF	food_fat	4	61444	1337393959	1	0.620000000000001	0.00237547892720307	10962	1
4	Food 2	Intake 4	92	61817	1337394332	/users/cn/jespinosa/phecomp/data/CRG/20120502_FDF_CRG/20120502_FDF_CRG/20120518_FDF_CRG_c12.mtb	6523	27	WWFF	food_fat	4	61725	1337394240	1	0.18	0.00195652173913043	10963	1
4	Drink 1	Intake 1	16	61750	1337394265	/users/cn/jespinosa/phecomp/data/CRG/20120502_FDF_CRG/20120502_FDF_CRG/20120518_FDF_CRG_c12.mtb	1937	NA	WWFF	water	1	61734	1337394249	1	0.02	0.00125	10964	1
4	Food 2	Intake 4	109	61953	1337394468	/users/cn/jespinosa/phecomp/data/CRG/20120502_FDF_CRG/20120502_FDF_CRG/20120518_FDF_CRG_c12.mtb	6524	COLL	WWFF	food_fat	4	61844	1337394359	1	0.0999999999999996	0.000917431192660547	10965	1
4	Food 1	Intake 3	93	61953	1337394468	/users/cn/jespinosa/phecomp/data/CRG/20120502_FDF_CRG/20120502_FDF_CRG/20120518_FDF_CRG_c12.mtb	4964	31	WWFF	food_fat	3	61860	1337394375	1	0.0600000000000005	0.000645161290322586	10966	1
4	Drink 1	Intake 1	14	61990	1337394505	/users/cn/jespinosa/phecomp/data/CRG/20120502_FDF_CRG/20120502_FDF_CRG/20120518_FDF_CRG_c12.mtb	1938	NA	WWFF	water	1	61976	1337394491	1	0.02	0.00142857142857143	10967	1
4	Food 2	Intake 4	295	62279	1337394794	/users/cn/jespinosa/phecomp/data/CRG/20120502_FDF_CRG/20120502_FDF_CRG/20120518_FDF_CRG_c12.mtb	6525	2570	WWFF	food_fat	4	61984	1337394499	1	0.0999999999999996	0.000338983050847456	10968	1
4	Drink 2	Intake 2	11	62085	1337394600	/users/cn/jespinosa/phecomp/data/CRG/20120502_FDF_CRG/20120502_FDF_CRG/20120518_FDF_CRG_c12.mtb	1808	NA	WWFF	water	2	62074	1337394589	1	0.04	0.00363636363636364	10969	1
4	Drink 1	Intake 1	19	62183	1337394698	/users/cn/jespinosa/phecomp/data/CRG/20120502_FDF_CRG/20120502_FDF_CRG/20120518_FDF_CRG_c12.mtb	1939	NA	WWFF	water	1	62164	1337394679	1	0.04	0.00210526315789474	10970	1
4	Drink 2	Intake 2	19	62423	1337394938	/users/cn/jespinosa/phecomp/data/CRG/20120502_FDF_CRG/20120502_FDF_CRG/20120518_FDF_CRG_c12.mtb	1809	NA	WWFF	water	2	62404	1337394919	1	0.06	0.00315789473684211	10971	1
4	Drink 2	Intake 2	17	63013	1337395528	/users/cn/jespinosa/phecomp/data/CRG/20120502_FDF_CRG/20120502_FDF_CRG/20120518_FDF_CRG_c12.mtb	1810	NA	WWFF	water	2	62996	1337395511	1	0.04	0.00235294117647059	10972	1
4	Food 2	Intake 4	30	64879	1337397394	/users/cn/jespinosa/phecomp/data/CRG/20120502_FDF_CRG/20120502_FDF_CRG/20120518_FDF_CRG_c12.mtb	6531	906	WWFF	food_fat	4	64849	1337397364	1	0.0200000000000014	0.000666666666666713	10973	1
4	Food 2	Intake 4	18	65803	1337398318	/users/cn/jespinosa/phecomp/data/CRG/20120502_FDF_CRG/20120502_FDF_CRG/20120518_FDF_CRG_c12.mtb	6534	1204	WWFF	food_fat	4	65785	1337398300	1	0.0399999999999991	0.00222222222222217	10974	1
4	Food 2	Intake 4	32	67039	1337399554	/users/cn/jespinosa/phecomp/data/CRG/20120502_FDF_CRG/20120502_FDF_CRG/20120518_FDF_CRG_c12.mtb	6539	1973	WWFF	food_fat	4	67007	1337399522	1	0.0200000000000014	0.000625000000000044	10975	1
4	Drink 1	Intake 1	15	67327	1337399842	/users/cn/jespinosa/phecomp/data/CRG/20120502_FDF_CRG/20120502_FDF_CRG/20120518_FDF_CRG_c12.mtb	1940	NA	WWFF	water	1	67312	1337399827	1	0.02	0.00133333333333333	10976	1
4	Food 2	Intake 4	24	69036	1337401551	/users/cn/jespinosa/phecomp/data/CRG/20120502_FDF_CRG/20120502_FDF_CRG/20120518_FDF_CRG_c12.mtb	6546	1251	WWFF	food_fat	4	69012	1337401527	1	0.0200000000000014	0.000833333333333392	10977	1
4	Food 2	Intake 4	129	70416	1337402931	/users/cn/jespinosa/phecomp/data/CRG/20120502_FDF_CRG/20120502_FDF_CRG/20120518_FDF_CRG_c12.mtb	6552	159	WWFF	food_fat	4	70287	1337402802	1	0.0800000000000001	0.000620155038759691	10978	1
4	Drink 2	Intake 2	42	70420	1337402935	/users/cn/jespinosa/phecomp/data/CRG/20120502_FDF_CRG/20120502_FDF_CRG/20120518_FDF_CRG_c12.mtb	1811	NA	WWFF	water	2	70378	1337402893	1	0.02	0.000476190476190476	10979	1
4	Drink 2	Intake 2	30	70496	1337403011	/users/cn/jespinosa/phecomp/data/CRG/20120502_FDF_CRG/20120502_FDF_CRG/20120518_FDF_CRG_c12.mtb	1812	NA	WWFF	water	2	70466	1337402981	1	0.02	0.000666666666666667	10980	1
4	Food 2	Intake 4	25	70600	1337403115	/users/cn/jespinosa/phecomp/data/CRG/20120502_FDF_CRG/20120502_FDF_CRG/20120518_FDF_CRG_c12.mtb	6554	11	WWFF	food_fat	4	70575	1337403090	1	0.0599999999999987	0.00239999999999995	10981	1
4	Food 2	Intake 4	375	70986	1337403501	/users/cn/jespinosa/phecomp/data/CRG/20120502_FDF_CRG/20120502_FDF_CRG/20120518_FDF_CRG_c12.mtb	6555	42	WWFF	food_fat	4	70611	1337403126	1	0.200000000000001	0.000533333333333336	10982	1
4	Food 2	Intake 4	164	71192	1337403707	/users/cn/jespinosa/phecomp/data/CRG/20120502_FDF_CRG/20120502_FDF_CRG/20120518_FDF_CRG_c12.mtb	6556	29	WWFF	food_fat	4	71028	1337403543	1	0.0999999999999996	0.000609756097560973	10983	1
4	Food 2	Intake 4	65	71286	1337403801	/users/cn/jespinosa/phecomp/data/CRG/20120502_FDF_CRG/20120502_FDF_CRG/20120518_FDF_CRG_c12.mtb	6557	544	WWFF	food_fat	4	71221	1337403736	1	0.0600000000000005	0.000923076923076931	10984	1
4	Drink 1	Intake 1	23	71324	1337403839	/users/cn/jespinosa/phecomp/data/CRG/20120502_FDF_CRG/20120502_FDF_CRG/20120518_FDF_CRG_c12.mtb	1943	NA	WWFF	water	1	71301	1337403816	1	0.0800000000000001	0.00347826086956522	10985	1
4	Drink 1	Intake 1	16	71720	1337404235	/users/cn/jespinosa/phecomp/data/CRG/20120502_FDF_CRG/20120502_FDF_CRG/20120518_FDF_CRG_c12.mtb	1944	NA	WWFF	water	1	71704	1337404219	1	0.02	0.00125	10986	1
4	Food 2	Intake 4	134	71964	1337404479	/users/cn/jespinosa/phecomp/data/CRG/20120502_FDF_CRG/20120502_FDF_CRG/20120518_FDF_CRG_c12.mtb	6561	269	WWFF	food_fat	4	71830	1337404345	1	0.0599999999999987	0.000447761194029841	10987	1
4	Food 2	Intake 4	101	72334	1337404849	/users/cn/jespinosa/phecomp/data/CRG/20120502_FDF_CRG/20120502_FDF_CRG/20120518_FDF_CRG_c12.mtb	6564	916	WWFF	food_fat	4	72233	1337404748	1	0.140000000000001	0.0013861386138614	10988	1
4	Food 1	Intake 3	105	73355	1337405870	/users/cn/jespinosa/phecomp/data/CRG/20120502_FDF_CRG/20120502_FDF_CRG/20120518_FDF_CRG_c12.mtb	4974	COLL	WWFF	food_fat	3	73250	1337405765	1	0.0200000000000005	0.000190476190476195	10989	1
4	Food 2	Intake 4	28	73356	1337405871	/users/cn/jespinosa/phecomp/data/CRG/20120502_FDF_CRG/20120502_FDF_CRG/20120518_FDF_CRG_c12.mtb	6571	1236	WWFF	food_fat	4	73328	1337405843	1	0.0400000000000009	0.00142857142857146	10990	1
4	Food 2	Intake 4	9	74601	1337407116	/users/cn/jespinosa/phecomp/data/CRG/20120502_FDF_CRG/20120502_FDF_CRG/20120518_FDF_CRG_c12.mtb	6579	3479	WWFF	food_fat	4	74592	1337407107	1	0.0200000000000014	0.00222222222222238	10991	1
4	Drink 1	Intake 1	20	77055	1337409570	/users/cn/jespinosa/phecomp/data/CRG/20120502_FDF_CRG/20120502_FDF_CRG/20120518_FDF_CRG_c12.mtb	1945	NA	WWFF	water	1	77035	1337409550	1	0.04	0.002	10992	1
4	Food 2	Intake 4	12	78092	1337410607	/users/cn/jespinosa/phecomp/data/CRG/20120502_FDF_CRG/20120502_FDF_CRG/20120518_FDF_CRG_c12.mtb	6584	3462	WWFF	food_fat	4	78080	1337410595	1	0.0399999999999991	0.00333333333333326	10993	1
4	Drink 1	Intake 1	19	78299	1337410814	/users/cn/jespinosa/phecomp/data/CRG/20120502_FDF_CRG/20120502_FDF_CRG/20120518_FDF_CRG_c12.mtb	1946	NA	WWFF	water	1	78280	1337410795	1	0.0600000000000001	0.00315789473684211	10994	1
4	Drink 1	Intake 1	21	78989	1337411504	/users/cn/jespinosa/phecomp/data/CRG/20120502_FDF_CRG/20120502_FDF_CRG/20120518_FDF_CRG_c12.mtb	1947	NA	WWFF	water	1	78968	1337411483	1	0.04	0.0019047619047619	10995	1
4	Drink 1	Intake 1	22	80186	1337412701	/users/cn/jespinosa/phecomp/data/CRG/20120502_FDF_CRG/20120502_FDF_CRG/20120518_FDF_CRG_c12.mtb	1948	NA	WWFF	water	1	80164	1337412679	1	0.0999999999999999	0.00454545454545454	10996	1
4	Food 2	Intake 4	23	81577	1337414092	/users/cn/jespinosa/phecomp/data/CRG/20120502_FDF_CRG/20120502_FDF_CRG/20120518_FDF_CRG_c12.mtb	6587	10327	WWFF	food_fat	4	81554	1337414069	1	0.0200000000000014	0.000869565217391365	10997	1
4	Drink 1	Intake 1	23	86051	1337418566	/users/cn/jespinosa/phecomp/data/CRG/20120502_FDF_CRG/20120502_FDF_CRG/20120518_FDF_CRG_c12.mtb	1949	NA	WWFF	water	1	86028	1337418543	1	0.0800000000000001	0.00347826086956522	10998	1
4	Drink 1	Intake 1	23	86955	1337419470	/users/cn/jespinosa/phecomp/data/CRG/20120502_FDF_CRG/20120502_FDF_CRG/20120518_FDF_CRG_c12.mtb	1950	NA	WWFF	water	1	86932	1337419447	1	0.0599999999999998	0.0026086956521739	10999	1
4	Drink 1	Intake 1	25	87849	1337420364	/users/cn/jespinosa/phecomp/data/CRG/20120502_FDF_CRG/20120502_FDF_CRG/20120518_FDF_CRG_c12.mtb	1951	NA	WWFF	water	1	87824	1337420339	1	0.1	0.004	11000	1
4	Drink 1	Intake 1	41	91071	1337423586	/users/cn/jespinosa/phecomp/data/CRG/20120502_FDF_CRG/20120502_FDF_CRG/20120518_FDF_CRG_c12.mtb	1953	NA	WWFF	water	1	91030	1337423545	1	0.02	0.00048780487804878	11001	1
4	Drink 2	Intake 2	26	91302	1337423817	/users/cn/jespinosa/phecomp/data/CRG/20120502_FDF_CRG/20120502_FDF_CRG/20120518_FDF_CRG_c12.mtb	1815	NA	WWFF	water	2	91276	1337423791	1	0.04	0.00153846153846154	11002	1
4	Food 2	Intake 4	15	91919	1337424434	/users/cn/jespinosa/phecomp/data/CRG/20120502_FDF_CRG/20120502_FDF_CRG/20120518_FDF_CRG_c12.mtb	6606	201	WWFF	food_fat	4	91904	1337424419	1	0.0399999999999991	0.00266666666666661	11003	1
4	Food 2	Intake 4	18	92138	1337424653	/users/cn/jespinosa/phecomp/data/CRG/20120502_FDF_CRG/20120502_FDF_CRG/20120518_FDF_CRG_c12.mtb	6608	739	WWFF	food_fat	4	92120	1337424635	1	0.0200000000000014	0.00111111111111119	11004	1
4	Food 2	Intake 4	13	92890	1337425405	/users/cn/jespinosa/phecomp/data/CRG/20120502_FDF_CRG/20120502_FDF_CRG/20120518_FDF_CRG_c12.mtb	6617	397	WWFF	food_fat	4	92877	1337425392	1	0.0200000000000014	0.00153846153846165	11005	1
4	Drink 2	Intake 2	13	93243	1337425758	/users/cn/jespinosa/phecomp/data/CRG/20120502_FDF_CRG/20120502_FDF_CRG/20120518_FDF_CRG_c12.mtb	1817	NA	WWFF	water	2	93230	1337425745	1	0.02	0.00153846153846154	11006	1
4	Food 2	Intake 4	25	93312	1337425827	/users/cn/jespinosa/phecomp/data/CRG/20120502_FDF_CRG/20120502_FDF_CRG/20120518_FDF_CRG_c12.mtb	6622	266	WWFF	food_fat	4	93287	1337425802	1	0.0399999999999991	0.00159999999999996	11007	1
4	Food 2	Intake 4	15	93593	1337426108	/users/cn/jespinosa/phecomp/data/CRG/20120502_FDF_CRG/20120502_FDF_CRG/20120518_FDF_CRG_c12.mtb	6625	46	WWFF	food_fat	4	93578	1337426093	1	0.0200000000000014	0.00133333333333343	11008	1
4	Food 2	Intake 4	17	93656	1337426171	/users/cn/jespinosa/phecomp/data/CRG/20120502_FDF_CRG/20120502_FDF_CRG/20120518_FDF_CRG_c12.mtb	6626	3714	WWFF	food_fat	4	93639	1337426154	1	0.0599999999999987	0.00352941176470581	11009	1
4	Food 2	Intake 4	44	97414	1337429929	/users/cn/jespinosa/phecomp/data/CRG/20120502_FDF_CRG/20120502_FDF_CRG/20120518_FDF_CRG_c12.mtb	6628	10989	WWFF	food_fat	4	97370	1337429885	1	0.0200000000000014	0.000454545454545486	11010	1
4	Drink 1	Intake 1	31	99962	1337432477	/users/cn/jespinosa/phecomp/data/CRG/20120502_FDF_CRG/20120502_FDF_CRG/20120518_FDF_CRG_c12.mtb	1955	NA	WWFF	water	1	99931	1337432446	1	0.16	0.00516129032258065	11011	1
4	Drink 1	Intake 1	19	100995	1337433510	/users/cn/jespinosa/phecomp/data/CRG/20120502_FDF_CRG/20120502_FDF_CRG/20120518_FDF_CRG_c12.mtb	1956	NA	WWFF	water	1	100976	1337433491	1	0.0600000000000001	0.00315789473684211	11012	1
4	Drink 1	Intake 1	17	102018	1337434533	/users/cn/jespinosa/phecomp/data/CRG/20120502_FDF_CRG/20120502_FDF_CRG/20120518_FDF_CRG_c12.mtb	1957	NA	WWFF	water	1	102001	1337434516	1	0.04	0.00235294117647059	11013	1
4	Drink 1	Intake 1	30	104878	1337437393	/users/cn/jespinosa/phecomp/data/CRG/20120502_FDF_CRG/20120502_FDF_CRG/20120518_FDF_CRG_c12.mtb	1958	NA	WWFF	water	1	104848	1337437363	1	0.14	0.00466666666666667	11014	1
4	Drink 2	Intake 2	18	108177	1337440692	/users/cn/jespinosa/phecomp/data/CRG/20120502_FDF_CRG/20120502_FDF_CRG/20120518_FDF_CRG_c12.mtb	1820	NA	WWFF	water	2	108159	1337440674	1	0.04	0.00222222222222222	11015	1
4	Food 2	Intake 4	39	108442	1337440957	/users/cn/jespinosa/phecomp/data/CRG/20120502_FDF_CRG/20120502_FDF_CRG/20120518_FDF_CRG_c12.mtb	6640	2480	WWFF	food_fat	4	108403	1337440918	1	0.0399999999999991	0.001025641025641	11016	1
4	Food 2	Intake 4	18	110940	1337443455	/users/cn/jespinosa/phecomp/data/CRG/20120502_FDF_CRG/20120502_FDF_CRG/20120518_FDF_CRG_c12.mtb	6649	7853	WWFF	food_fat	4	110922	1337443437	1	0.0200000000000014	0.00111111111111119	11017	1
4	Drink 1	Intake 1	16	110942	1337443457	/users/cn/jespinosa/phecomp/data/CRG/20120502_FDF_CRG/20120502_FDF_CRG/20120518_FDF_CRG_c12.mtb	1959	NA	WWFF	water	1	110926	1337443441	1	0.04	0.0025	11018	1
4	Drink 1	Intake 1	25	112458	1337444973	/users/cn/jespinosa/phecomp/data/CRG/20120502_FDF_CRG/20120502_FDF_CRG/20120518_FDF_CRG_c12.mtb	1960	NA	WWFF	water	1	112433	1337444948	1	0.0800000000000001	0.0032	11019	1
4	Drink 1	Intake 1	23	115035	1337447550	/users/cn/jespinosa/phecomp/data/CRG/20120502_FDF_CRG/20120502_FDF_CRG/20120518_FDF_CRG_c12.mtb	1961	NA	WWFF	water	1	115012	1337447527	1	0.0800000000000001	0.00347826086956522	11020	1
4	Drink 1	Intake 1	17	116818	1337449333	/users/cn/jespinosa/phecomp/data/CRG/20120502_FDF_CRG/20120502_FDF_CRG/20120518_FDF_CRG_c12.mtb	1962	NA	WWFF	water	1	116801	1337449316	1	0.04	0.00235294117647059	11021	1
4	Drink 1	Intake 1	25	117415	1337449930	/users/cn/jespinosa/phecomp/data/CRG/20120502_FDF_CRG/20120502_FDF_CRG/20120518_FDF_CRG_c12.mtb	1963	NA	WWFF	water	1	117390	1337449905	1	0.0999999999999996	0.00399999999999998	11022	1
4	Food 1	Intake 3	17	118810	1337451325	/users/cn/jespinosa/phecomp/data/CRG/20120502_FDF_CRG/20120502_FDF_CRG/20120518_FDF_CRG_c12.mtb	4977	69	WWFF	food_fat	3	118793	1337451308	1	0.0200000000000005	0.00117647058823532	11023	1
4	Food 2	Intake 4	65	118944	1337451459	/users/cn/jespinosa/phecomp/data/CRG/20120502_FDF_CRG/20120502_FDF_CRG/20120518_FDF_CRG_c12.mtb	6658	7	WWFF	food_fat	4	118879	1337451394	1	0.0200000000000014	0.000307692307692329	11024	1
4	Food 2	Intake 4	224	119175	1337451690	/users/cn/jespinosa/phecomp/data/CRG/20120502_FDF_CRG/20120502_FDF_CRG/20120518_FDF_CRG_c12.mtb	6659	380	WWFF	food_fat	4	118951	1337451466	1	0.0800000000000001	0.000357142857142858	11025	1
4	Food 2	Intake 4	137	119692	1337452207	/users/cn/jespinosa/phecomp/data/CRG/20120502_FDF_CRG/20120502_FDF_CRG/20120518_FDF_CRG_c12.mtb	6663	171	WWFF	food_fat	4	119555	1337452070	1	0.0800000000000001	0.000583941605839417	11026	1
4	Food 2	Intake 4	39	119902	1337452417	/users/cn/jespinosa/phecomp/data/CRG/20120502_FDF_CRG/20120502_FDF_CRG/20120518_FDF_CRG_c12.mtb	6665	87	WWFF	food_fat	4	119863	1337452378	1	0.0200000000000014	0.000512820512820549	11027	1
4	Food 2	Intake 4	194	120183	1337452698	/users/cn/jespinosa/phecomp/data/CRG/20120502_FDF_CRG/20120502_FDF_CRG/20120518_FDF_CRG_c12.mtb	6667	COLL	WWFF	food_fat	4	119989	1337452504	1	0.0999999999999996	0.000515463917525771	11028	1
4	Food 1	Intake 3	118	120179	1337452694	/users/cn/jespinosa/phecomp/data/CRG/20120502_FDF_CRG/20120502_FDF_CRG/20120518_FDF_CRG_c12.mtb	4984	71	WWFF	food_fat	3	120061	1337452576	1	0.0399999999999991	0.00033898305084745	11029	1
4	Food 2	Intake 4	79	120329	1337452844	/users/cn/jespinosa/phecomp/data/CRG/20120502_FDF_CRG/20120502_FDF_CRG/20120518_FDF_CRG_c12.mtb	6668	382	WWFF	food_fat	4	120250	1337452765	1	0.0399999999999991	0.000506329113924039	11030	1
4	Drink 1	Intake 1	33	120460	1337452975	/users/cn/jespinosa/phecomp/data/CRG/20120502_FDF_CRG/20120502_FDF_CRG/20120518_FDF_CRG_c12.mtb	1967	NA	WWFF	water	1	120427	1337452942	1	0.0200000000000005	0.000606060606060621	11031	1
4	Food 2	Intake 4	210	120921	1337453436	/users/cn/jespinosa/phecomp/data/CRG/20120502_FDF_CRG/20120502_FDF_CRG/20120518_FDF_CRG_c12.mtb	6672	59	WWFF	food_fat	4	120711	1337453226	1	0.0200000000000014	9.52380952381019e-05	11032	1
4	Food 1	Intake 3	127	121107	1337453622	/users/cn/jespinosa/phecomp/data/CRG/20120502_FDF_CRG/20120502_FDF_CRG/20120518_FDF_CRG_c12.mtb	4985	859	WWFF	food_fat	3	120980	1337453495	1	0.0200000000000005	0.000157480314960634	11033	1
4	Food 2	Intake 4	348	122314	1337454829	/users/cn/jespinosa/phecomp/data/CRG/20120502_FDF_CRG/20120502_FDF_CRG/20120518_FDF_CRG_c12.mtb	6676	COLL	WWFF	food_fat	4	121966	1337454481	1	0.0600000000000005	0.00017241379310345	11034	1
4	Food 1	Intake 3	36	122301	1337454816	/users/cn/jespinosa/phecomp/data/CRG/20120502_FDF_CRG/20120502_FDF_CRG/20120518_FDF_CRG_c12.mtb	4987	138	WWFF	food_fat	3	122265	1337454780	1	0.0200000000000005	0.000555555555555569	11035	1
4	Food 2	Intake 4	147	122586	1337455101	/users/cn/jespinosa/phecomp/data/CRG/20120502_FDF_CRG/20120502_FDF_CRG/20120518_FDF_CRG_c12.mtb	6678	120	WWFF	food_fat	4	122439	1337454954	1	0.0599999999999987	0.000408163265306114	11036	1
4	Food 2	Intake 4	30	122736	1337455251	/users/cn/jespinosa/phecomp/data/CRG/20120502_FDF_CRG/20120502_FDF_CRG/20120518_FDF_CRG_c12.mtb	6680	18	WWFF	food_fat	4	122706	1337455221	1	0.0200000000000014	0.000666666666666713	11037	1
4	Food 2	Intake 4	91	122845	1337455360	/users/cn/jespinosa/phecomp/data/CRG/20120502_FDF_CRG/20120502_FDF_CRG/20120518_FDF_CRG_c12.mtb	6681	41	WWFF	food_fat	4	122754	1337455269	1	0.0399999999999991	0.00043956043956043	11038	1
4	Food 2	Intake 4	101	122987	1337455502	/users/cn/jespinosa/phecomp/data/CRG/20120502_FDF_CRG/20120502_FDF_CRG/20120518_FDF_CRG_c12.mtb	6682	1439	WWFF	food_fat	4	122886	1337455401	1	0.0400000000000009	0.000396039603960405	11039	1
4	Food 2	Intake 4	237	124663	1337457178	/users/cn/jespinosa/phecomp/data/CRG/20120502_FDF_CRG/20120502_FDF_CRG/20120518_FDF_CRG_c12.mtb	6693	648	WWFF	food_fat	4	124426	1337456941	1	0.26	0.00109704641350211	11040	1
4	Food 2	Intake 4	19	125330	1337457845	/users/cn/jespinosa/phecomp/data/CRG/20120502_FDF_CRG/20120502_FDF_CRG/20120518_FDF_CRG_c12.mtb	6697	2445	WWFF	food_fat	4	125311	1337457826	1	0.0200000000000014	0.00105263157894744	11041	1
4	Drink 1	Intake 1	19	127123	1337459638	/users/cn/jespinosa/phecomp/data/CRG/20120502_FDF_CRG/20120502_FDF_CRG/20120518_FDF_CRG_c12.mtb	1970	NA	WWFF	water	1	127104	1337459619	1	0.0599999999999996	0.00315789473684208	11042	1
4	Food 2	Intake 4	84	127859	1337460374	/users/cn/jespinosa/phecomp/data/CRG/20120502_FDF_CRG/20120502_FDF_CRG/20120518_FDF_CRG_c12.mtb	6707	61	WWFF	food_fat	4	127775	1337460290	1	0.0999999999999996	0.00119047619047619	11043	1
4	Food 2	Intake 4	191	128111	1337460626	/users/cn/jespinosa/phecomp/data/CRG/20120502_FDF_CRG/20120502_FDF_CRG/20120518_FDF_CRG_c12.mtb	6708	9	WWFF	food_fat	4	127920	1337460435	1	0.0800000000000001	0.000418848167539268	11044	1
4	Food 2	Intake 4	104	128224	1337460739	/users/cn/jespinosa/phecomp/data/CRG/20120502_FDF_CRG/20120502_FDF_CRG/20120518_FDF_CRG_c12.mtb	6709	270	WWFF	food_fat	4	128120	1337460635	1	0.140000000000001	0.00134615384615386	11045	1
4	Food 2	Intake 4	36	128530	1337461045	/users/cn/jespinosa/phecomp/data/CRG/20120502_FDF_CRG/20120502_FDF_CRG/20120518_FDF_CRG_c12.mtb	6712	21	WWFF	food_fat	4	128494	1337461009	1	0.120000000000001	0.00333333333333336	11046	1
4	Drink 1	Intake 1	53	128565	1337461080	/users/cn/jespinosa/phecomp/data/CRG/20120502_FDF_CRG/20120502_FDF_CRG/20120518_FDF_CRG_c12.mtb	1972	NA	WWFF	water	1	128512	1337461027	1	0.02	0.000377358490566038	11047	1
4	Food 2	Intake 4	323	128874	1337461389	/users/cn/jespinosa/phecomp/data/CRG/20120502_FDF_CRG/20120502_FDF_CRG/20120518_FDF_CRG_c12.mtb	6713	COLL	WWFF	food_fat	4	128551	1337461066	1	0.0800000000000001	0.000247678018575852	11048	1
4	Food 1	Intake 3	95	128651	1337461166	/users/cn/jespinosa/phecomp/data/CRG/20120502_FDF_CRG/20120502_FDF_CRG/20120518_FDF_CRG_c12.mtb	4998	259	WWFF	food_fat	3	128556	1337461071	1	0.04	0.000421052631578947	11049	1
4	Food 2	Intake 4	131	129041	1337461556	/users/cn/jespinosa/phecomp/data/CRG/20120502_FDF_CRG/20120502_FDF_CRG/20120518_FDF_CRG_c12.mtb	6714	6	WWFF	food_fat	4	128910	1337461425	1	0.0800000000000001	0.000610687022900764	11050	1
4	Food 2	Intake 4	208	129255	1337461770	/users/cn/jespinosa/phecomp/data/CRG/20120502_FDF_CRG/20120502_FDF_CRG/20120518_FDF_CRG_c12.mtb	6715	COLL	WWFF	food_fat	4	129047	1337461562	1	0.619999999999999	0.00298076923076923	11051	1
4	Food 1	Intake 3	28	129234	1337461749	/users/cn/jespinosa/phecomp/data/CRG/20120502_FDF_CRG/20120502_FDF_CRG/20120518_FDF_CRG_c12.mtb	5002	102	WWFF	food_fat	3	129206	1337461721	1	0.0200000000000005	0.000714285714285732	11052	1
4	Food 2	Intake 4	99	129435	1337461950	/users/cn/jespinosa/phecomp/data/CRG/20120502_FDF_CRG/20120502_FDF_CRG/20120518_FDF_CRG_c12.mtb	6716	COLL	WWFF	food_fat	4	129336	1337461851	1	0.0800000000000001	0.000808080808080809	11053	1
4	Food 1	Intake 3	109	129518	1337462033	/users/cn/jespinosa/phecomp/data/CRG/20120502_FDF_CRG/20120502_FDF_CRG/20120518_FDF_CRG_c12.mtb	5003	COLL	WWFF	food_fat	3	129409	1337461924	1	0.04	0.00036697247706422	11054	1
4	Food 2	Intake 4	21	129512	1337462027	/users/cn/jespinosa/phecomp/data/CRG/20120502_FDF_CRG/20120502_FDF_CRG/20120518_FDF_CRG_c12.mtb	6718	206	WWFF	food_fat	4	129491	1337462006	1	0.0400000000000009	0.00190476190476195	11055	1
4	Food 2	Intake 4	57	129775	1337462290	/users/cn/jespinosa/phecomp/data/CRG/20120502_FDF_CRG/20120502_FDF_CRG/20120518_FDF_CRG_c12.mtb	6722	46	WWFF	food_fat	4	129718	1337462233	1	0.0600000000000005	0.00105263157894738	11056	1
4	Food 2	Intake 4	13	129834	1337462349	/users/cn/jespinosa/phecomp/data/CRG/20120502_FDF_CRG/20120502_FDF_CRG/20120518_FDF_CRG_c12.mtb	6724	136	WWFF	food_fat	4	129821	1337462336	1	0.0400000000000009	0.00307692307692315	11057	1
4	Food 2	Intake 4	41	130011	1337462526	/users/cn/jespinosa/phecomp/data/CRG/20120502_FDF_CRG/20120502_FDF_CRG/20120518_FDF_CRG_c12.mtb	6727	18	WWFF	food_fat	4	129970	1337462485	1	0.16	0.00390243902439024	11058	1
4	Food 2	Intake 4	51	130080	1337462595	/users/cn/jespinosa/phecomp/data/CRG/20120502_FDF_CRG/20120502_FDF_CRG/20120518_FDF_CRG_c12.mtb	6728	791	WWFF	food_fat	4	130029	1337462544	1	0.0200000000000014	0.000392156862745125	11059	1
4	Drink 1	Intake 1	23	130166	1337462681	/users/cn/jespinosa/phecomp/data/CRG/20120502_FDF_CRG/20120502_FDF_CRG/20120518_FDF_CRG_c12.mtb	1973	NA	WWFF	water	1	130143	1337462658	1	0.0600000000000001	0.00260869565217392	11060	1
4	Drink 2	Intake 2	17	130176	1337462691	/users/cn/jespinosa/phecomp/data/CRG/20120502_FDF_CRG/20120502_FDF_CRG/20120518_FDF_CRG_c12.mtb	1835	NA	WWFF	water	2	130159	1337462674	1	0.02	0.00117647058823529	11061	1
4	Drink 2	Intake 2	57	130694	1337463209	/users/cn/jespinosa/phecomp/data/CRG/20120502_FDF_CRG/20120502_FDF_CRG/20120518_FDF_CRG_c12.mtb	1836	NA	WWFF	water	2	130637	1337463152	1	0.04	0.000701754385964912	11062	1
4	Drink 2	Intake 2	53	130752	1337463267	/users/cn/jespinosa/phecomp/data/CRG/20120502_FDF_CRG/20120502_FDF_CRG/20120518_FDF_CRG_c12.mtb	1837	NA	WWFF	water	2	130699	1337463214	1	0.02	0.000377358490566038	11063	1
4	Food 1	Intake 3	169	131040	1337463555	/users/cn/jespinosa/phecomp/data/CRG/20120502_FDF_CRG/20120502_FDF_CRG/20120518_FDF_CRG_c12.mtb	5008	37	WWFF	food_fat	3	130871	1337463386	1	0.2	0.00118343195266272	11064	1
4	Food 2	Intake 4	13	131090	1337463605	/users/cn/jespinosa/phecomp/data/CRG/20120502_FDF_CRG/20120502_FDF_CRG/20120518_FDF_CRG_c12.mtb	6735	1555	WWFF	food_fat	4	131077	1337463592	1	0.0400000000000009	0.00307692307692315	11065	1
4	Food 2	Intake 4	15	132660	1337465175	/users/cn/jespinosa/phecomp/data/CRG/20120502_FDF_CRG/20120502_FDF_CRG/20120518_FDF_CRG_c12.mtb	6739	3855	WWFF	food_fat	4	132645	1337465160	1	0.4	0.0266666666666667	11066	1
4	Drink 1	Intake 1	15	135419	1337467934	/users/cn/jespinosa/phecomp/data/CRG/20120502_FDF_CRG/20120502_FDF_CRG/20120518_FDF_CRG_c12.mtb	1975	NA	WWFF	water	1	135404	1337467919	1	0.02	0.00133333333333333	11067	1
4	Food 2	Intake 4	39	136554	1337469069	/users/cn/jespinosa/phecomp/data/CRG/20120502_FDF_CRG/20120502_FDF_CRG/20120518_FDF_CRG_c12.mtb	6749	516	WWFF	food_fat	4	136515	1337469030	1	0.26	0.00666666666666667	11068	1
4	Food 2	Intake 4	18	137088	1337469603	/users/cn/jespinosa/phecomp/data/CRG/20120502_FDF_CRG/20120502_FDF_CRG/20120518_FDF_CRG_c12.mtb	6751	2358	WWFF	food_fat	4	137070	1337469585	1	0.0800000000000001	0.00444444444444445	11069	1
4	Drink 1	Intake 1	14	137446	1337469961	/users/cn/jespinosa/phecomp/data/CRG/20120502_FDF_CRG/20120502_FDF_CRG/20120518_FDF_CRG_c12.mtb	1976	NA	WWFF	water	1	137432	1337469947	1	0.04	0.00285714285714286	11070	1
4	Food 2	Intake 4	173	139619	1337472134	/users/cn/jespinosa/phecomp/data/CRG/20120502_FDF_CRG/20120502_FDF_CRG/20120518_FDF_CRG_c12.mtb	6760	224	WWFF	food_fat	4	139446	1337471961	1	0.0600000000000005	0.000346820809248558	11071	1
4	Food 2	Intake 4	36	139879	1337472394	/users/cn/jespinosa/phecomp/data/CRG/20120502_FDF_CRG/20120502_FDF_CRG/20120518_FDF_CRG_c12.mtb	6763	117	WWFF	food_fat	4	139843	1337472358	1	0.0399999999999991	0.00111111111111109	11072	1
4	Drink 1	Intake 1	28	139984	1337472499	/users/cn/jespinosa/phecomp/data/CRG/20120502_FDF_CRG/20120502_FDF_CRG/20120518_FDF_CRG_c12.mtb	1977	NA	WWFF	water	1	139956	1337472471	1	0.0800000000000001	0.00285714285714286	11073	1
4	Food 2	Intake 4	64	140060	1337472575	/users/cn/jespinosa/phecomp/data/CRG/20120502_FDF_CRG/20120502_FDF_CRG/20120518_FDF_CRG_c12.mtb	6766	COLL	WWFF	food_fat	4	139996	1337472511	1	0.0399999999999991	0.000624999999999986	11074	1
4	Food 1	Intake 3	83	140106	1337472621	/users/cn/jespinosa/phecomp/data/CRG/20120502_FDF_CRG/20120502_FDF_CRG/20120518_FDF_CRG_c12.mtb	5014	COLL	WWFF	food_fat	3	140023	1337472538	1	0.56	0.00674698795180723	11075	1
4	Food 2	Intake 4	24	140105	1337472620	/users/cn/jespinosa/phecomp/data/CRG/20120502_FDF_CRG/20120502_FDF_CRG/20120518_FDF_CRG_c12.mtb	6767	7	WWFF	food_fat	4	140081	1337472596	1	0.0200000000000014	0.000833333333333392	11076	1
4	Food 2	Intake 4	221	140333	1337472848	/users/cn/jespinosa/phecomp/data/CRG/20120502_FDF_CRG/20120502_FDF_CRG/20120518_FDF_CRG_c12.mtb	6768	COLL	WWFF	food_fat	4	140112	1337472627	1	0.139999999999999	0.000633484162895923	11077	1
4	Food 1	Intake 3	39	140160	1337472675	/users/cn/jespinosa/phecomp/data/CRG/20120502_FDF_CRG/20120502_FDF_CRG/20120518_FDF_CRG_c12.mtb	5015	61	WWFF	food_fat	3	140121	1337472636	1	0.0800000000000001	0.00205128205128205	11078	1
4	Food 1	Intake 3	105	140326	1337472841	/users/cn/jespinosa/phecomp/data/CRG/20120502_FDF_CRG/20120502_FDF_CRG/20120518_FDF_CRG_c12.mtb	5016	50	WWFF	food_fat	3	140221	1337472736	1	0.0599999999999987	0.000571428571428559	11079	1
4	Food 2	Intake 4	137	140513	1337473028	/users/cn/jespinosa/phecomp/data/CRG/20120502_FDF_CRG/20120502_FDF_CRG/20120518_FDF_CRG_c12.mtb	6769	COLL	WWFF	food_fat	4	140376	1337472891	1	0.0200000000000014	0.000145985401459864	11080	1
4	Food 1	Intake 3	130	140513	1337473028	/users/cn/jespinosa/phecomp/data/CRG/20120502_FDF_CRG/20120502_FDF_CRG/20120518_FDF_CRG_c12.mtb	5017	22	WWFF	food_fat	3	140383	1337472898	1	0.56	0.00430769230769231	11081	1
4	Food 2	Intake 4	218	140753	1337473268	/users/cn/jespinosa/phecomp/data/CRG/20120502_FDF_CRG/20120502_FDF_CRG/20120518_FDF_CRG_c12.mtb	6770	COLL	WWFF	food_fat	4	140535	1337473050	1	0.0399999999999991	0.000183486238532106	11082	1
4	Food 1	Intake 3	118	140751	1337473266	/users/cn/jespinosa/phecomp/data/CRG/20120502_FDF_CRG/20120502_FDF_CRG/20120518_FDF_CRG_c12.mtb	5019	269	WWFF	food_fat	3	140633	1337473148	1	0.0600000000000005	0.000508474576271191	11083	1
4	Drink 1	Intake 1	20	140774	1337473289	/users/cn/jespinosa/phecomp/data/CRG/20120502_FDF_CRG/20120502_FDF_CRG/20120518_FDF_CRG_c12.mtb	1978	NA	WWFF	water	1	140754	1337473269	1	0.02	0.001	11084	1
4	Drink 1	Intake 1	13	141015	1337473530	/users/cn/jespinosa/phecomp/data/CRG/20120502_FDF_CRG/20120502_FDF_CRG/20120518_FDF_CRG_c12.mtb	1979	NA	WWFF	water	1	141002	1337473517	1	0.04	0.00307692307692308	11085	1
4	Food 1	Intake 3	46	141066	1337473581	/users/cn/jespinosa/phecomp/data/CRG/20120502_FDF_CRG/20120502_FDF_CRG/20120518_FDF_CRG_c12.mtb	5022	26	WWFF	food_fat	3	141020	1337473535	1	0.0200000000000014	0.000434782608695683	11086	1
4	Food 2	Intake 4	172	141264	1337473779	/users/cn/jespinosa/phecomp/data/CRG/20120502_FDF_CRG/20120502_FDF_CRG/20120518_FDF_CRG_c12.mtb	6774	COLL	WWFF	food_fat	4	141092	1337473607	1	0.32	0.00186046511627907	11087	1
4	Food 1	Intake 3	31	141230	1337473745	/users/cn/jespinosa/phecomp/data/CRG/20120502_FDF_CRG/20120502_FDF_CRG/20120518_FDF_CRG_c12.mtb	5023	331	WWFF	food_fat	3	141199	1337473714	1	0.0399999999999991	0.00129032258064513	11088	1
4	Drink 2	Intake 2	28	141426	1337473941	/users/cn/jespinosa/phecomp/data/CRG/20120502_FDF_CRG/20120502_FDF_CRG/20120518_FDF_CRG_c12.mtb	1841	NA	WWFF	water	2	141398	1337473913	1	0.02	0.000714285714285714	11089	1
4	Food 2	Intake 4	97	141658	1337474173	/users/cn/jespinosa/phecomp/data/CRG/20120502_FDF_CRG/20120502_FDF_CRG/20120518_FDF_CRG_c12.mtb	6776	59	WWFF	food_fat	4	141561	1337474076	1	0.140000000000001	0.00144329896907218	11090	1
4	Food 2	Intake 4	261	141978	1337474493	/users/cn/jespinosa/phecomp/data/CRG/20120502_FDF_CRG/20120502_FDF_CRG/20120518_FDF_CRG_c12.mtb	6779	1012	WWFF	food_fat	4	141717	1337474232	1	0.0800000000000001	0.000306513409961686	11091	1
4	Drink 2	Intake 2	48	142121	1337474636	/users/cn/jespinosa/phecomp/data/CRG/20120502_FDF_CRG/20120502_FDF_CRG/20120518_FDF_CRG_c12.mtb	1842	NA	WWFF	water	2	142073	1337474588	1	0.08	0.00166666666666667	11092	1
4	Food 2	Intake 4	36	143026	1337475541	/users/cn/jespinosa/phecomp/data/CRG/20120502_FDF_CRG/20120502_FDF_CRG/20120518_FDF_CRG_c12.mtb	6790	657	WWFF	food_fat	4	142990	1337475505	1	0.0400000000000009	0.00111111111111114	11093	1
4	Food 2	Intake 4	71	143754	1337476269	/users/cn/jespinosa/phecomp/data/CRG/20120502_FDF_CRG/20120502_FDF_CRG/20120518_FDF_CRG_c12.mtb	6796	1251	WWFF	food_fat	4	143683	1337476198	1	0.18	0.00253521126760563	11094	1
4	Drink 1	Intake 1	20	144960	1337477475	/users/cn/jespinosa/phecomp/data/CRG/20120502_FDF_CRG/20120502_FDF_CRG/20120518_FDF_CRG_c12.mtb	1980	NA	WWFF	water	1	144940	1337477455	1	0.04	0.002	11095	1
4	Food 2	Intake 4	121	145126	1337477641	/users/cn/jespinosa/phecomp/data/CRG/20120502_FDF_CRG/20120502_FDF_CRG/20120518_FDF_CRG_c12.mtb	6803	16	WWFF	food_fat	4	145005	1337477520	1	0.0400000000000009	0.000330578512396702	11096	1
4	Food 2	Intake 4	15	145157	1337477672	/users/cn/jespinosa/phecomp/data/CRG/20120502_FDF_CRG/20120502_FDF_CRG/20120518_FDF_CRG_c12.mtb	6804	72	WWFF	food_fat	4	145142	1337477657	1	0.479999999999999	0.0319999999999999	11097	1
4	Food 2	Intake 4	121	145350	1337477865	/users/cn/jespinosa/phecomp/data/CRG/20120502_FDF_CRG/20120502_FDF_CRG/20120518_FDF_CRG_c12.mtb	6805	421	WWFF	food_fat	4	145229	1337477744	1	0.0200000000000014	0.000165289256198359	11098	1
4	Food 2	Intake 4	227	145998	1337478513	/users/cn/jespinosa/phecomp/data/CRG/20120502_FDF_CRG/20120502_FDF_CRG/20120518_FDF_CRG_c12.mtb	6808	1780	WWFF	food_fat	4	145771	1337478286	1	0.140000000000001	0.000616740088105731	11099	1
4	Drink 1	Intake 1	15	146126	1337478641	/users/cn/jespinosa/phecomp/data/CRG/20120502_FDF_CRG/20120502_FDF_CRG/20120518_FDF_CRG_c12.mtb	1981	NA	WWFF	water	1	146111	1337478626	1	0.04	0.00266666666666667	11100	1
4	Food 2	Intake 4	49	147827	1337480342	/users/cn/jespinosa/phecomp/data/CRG/20120502_FDF_CRG/20120502_FDF_CRG/20120518_FDF_CRG_c12.mtb	6816	1175	WWFF	food_fat	4	147778	1337480293	1	0.0400000000000009	0.000816326530612263	11101	1
4	Food 2	Intake 4	21	149023	1337481538	/users/cn/jespinosa/phecomp/data/CRG/20120502_FDF_CRG/20120502_FDF_CRG/20120518_FDF_CRG_c12.mtb	6821	1505	WWFF	food_fat	4	149002	1337481517	1	0.0200000000000014	0.000952380952381019	11102	1
4	Food 2	Intake 4	24	150552	1337483067	/users/cn/jespinosa/phecomp/data/CRG/20120502_FDF_CRG/20120502_FDF_CRG/20120518_FDF_CRG_c12.mtb	6829	2164	WWFF	food_fat	4	150528	1337483043	1	0.18	0.0075	11103	1
4	Food 2	Intake 4	15	152731	1337485246	/users/cn/jespinosa/phecomp/data/CRG/20120502_FDF_CRG/20120502_FDF_CRG/20120518_FDF_CRG_c12.mtb	6837	316	WWFF	food_fat	4	152716	1337485231	1	0.399999999999999	0.0266666666666666	11104	1
4	Drink 1	Intake 1	14	153047	1337485562	/users/cn/jespinosa/phecomp/data/CRG/20120502_FDF_CRG/20120502_FDF_CRG/20120518_FDF_CRG_c12.mtb	1983	NA	WWFF	water	1	153033	1337485548	1	0.04	0.00285714285714286	11105	1
4	Food 2	Intake 4	23	153070	1337485585	/users/cn/jespinosa/phecomp/data/CRG/20120502_FDF_CRG/20120502_FDF_CRG/20120518_FDF_CRG_c12.mtb	6838	403	WWFF	food_fat	4	153047	1337485562	1	0.0200000000000014	0.000869565217391365	11106	1
4	Food 2	Intake 4	25	153498	1337486013	/users/cn/jespinosa/phecomp/data/CRG/20120502_FDF_CRG/20120502_FDF_CRG/20120518_FDF_CRG_c12.mtb	6840	265	WWFF	food_fat	4	153473	1337485988	1	0.0399999999999991	0.00159999999999996	11107	1
4	Food 2	Intake 4	30	153793	1337486308	/users/cn/jespinosa/phecomp/data/CRG/20120502_FDF_CRG/20120502_FDF_CRG/20120518_FDF_CRG_c12.mtb	6842	1179	WWFF	food_fat	4	153763	1337486278	1	0.0200000000000014	0.000666666666666713	11108	1
4	Food 2	Intake 4	27	154999	1337487514	/users/cn/jespinosa/phecomp/data/CRG/20120502_FDF_CRG/20120502_FDF_CRG/20120518_FDF_CRG_c12.mtb	6851	494	WWFF	food_fat	4	154972	1337487487	1	0.140000000000001	0.00518518518518522	11109	1
4	Drink 1	Intake 1	12	155485	1337488000	/users/cn/jespinosa/phecomp/data/CRG/20120502_FDF_CRG/20120502_FDF_CRG/20120518_FDF_CRG_c12.mtb	1984	NA	WWFF	water	1	155473	1337487988	1	0.0599999999999996	0.00499999999999997	11110	1
4	Food 2	Intake 4	228	155721	1337488236	/users/cn/jespinosa/phecomp/data/CRG/20120502_FDF_CRG/20120502_FDF_CRG/20120518_FDF_CRG_c12.mtb	6854	COLL	WWFF	food_fat	4	155493	1337488008	1	0.0999999999999996	0.000438596491228068	11111	1
4	Food 1	Intake 3	44	155680	1337488195	/users/cn/jespinosa/phecomp/data/CRG/20120502_FDF_CRG/20120502_FDF_CRG/20120518_FDF_CRG_c12.mtb	5035	444	WWFF	food_fat	3	155636	1337488151	1	0.0200000000000014	0.000454545454545486	11112	1
4	Drink 1	Intake 1	17	155784	1337488299	/users/cn/jespinosa/phecomp/data/CRG/20120502_FDF_CRG/20120502_FDF_CRG/20120518_FDF_CRG_c12.mtb	1985	NA	WWFF	water	1	155767	1337488282	1	0.02	0.00117647058823529	11113	1
4	Drink 2	Intake 2	91	155865	1337488380	/users/cn/jespinosa/phecomp/data/CRG/20120502_FDF_CRG/20120502_FDF_CRG/20120518_FDF_CRG_c12.mtb	1847	NA	WWFF	water	2	155774	1337488289	1	0.08	0.000879120879120879	11114	1
4	Drink 2	Intake 2	63	156006	1337488521	/users/cn/jespinosa/phecomp/data/CRG/20120502_FDF_CRG/20120502_FDF_CRG/20120518_FDF_CRG_c12.mtb	1849	NA	WWFF	water	2	155943	1337488458	1	0.02	0.000317460317460317	11115	1
4	Food 2	Intake 4	95	156219	1337488734	/users/cn/jespinosa/phecomp/data/CRG/20120502_FDF_CRG/20120502_FDF_CRG/20120518_FDF_CRG_c12.mtb	6857	394	WWFF	food_fat	4	156124	1337488639	1	0.0800000000000001	0.000842105263157896	11116	1
4	Food 2	Intake 4	245	156858	1337489373	/users/cn/jespinosa/phecomp/data/CRG/20120502_FDF_CRG/20120502_FDF_CRG/20120518_FDF_CRG_c12.mtb	6859	22	WWFF	food_fat	4	156613	1337489128	1	0.16	0.000653061224489796	11117	1
4	Food 2	Intake 4	23	156903	1337489418	/users/cn/jespinosa/phecomp/data/CRG/20120502_FDF_CRG/20120502_FDF_CRG/20120518_FDF_CRG_c12.mtb	6860	391	WWFF	food_fat	4	156880	1337489395	1	0.0600000000000005	0.00260869565217393	11118	1
4	Drink 1	Intake 1	20	156973	1337489488	/users/cn/jespinosa/phecomp/data/CRG/20120502_FDF_CRG/20120502_FDF_CRG/20120518_FDF_CRG_c12.mtb	1987	NA	WWFF	water	1	156953	1337489468	1	0.1	0.005	11119	1
4	Food 2	Intake 4	45	157339	1337489854	/users/cn/jespinosa/phecomp/data/CRG/20120502_FDF_CRG/20120502_FDF_CRG/20120518_FDF_CRG_c12.mtb	6866	1462	WWFF	food_fat	4	157294	1337489809	1	0.0200000000000014	0.000444444444444476	11120	1
4	Food 2	Intake 4	40	158841	1337491356	/users/cn/jespinosa/phecomp/data/CRG/20120502_FDF_CRG/20120502_FDF_CRG/20120518_FDF_CRG_c12.mtb	6870	884	WWFF	food_fat	4	158801	1337491316	1	0.540000000000001	0.0135	11121	1
4	Food 2	Intake 4	19	159744	1337492259	/users/cn/jespinosa/phecomp/data/CRG/20120502_FDF_CRG/20120502_FDF_CRG/20120518_FDF_CRG_c12.mtb	6875	1082	WWFF	food_fat	4	159725	1337492240	1	0.0200000000000014	0.00105263157894744	11122	1
4	Food 2	Intake 4	26	160852	1337493367	/users/cn/jespinosa/phecomp/data/CRG/20120502_FDF_CRG/20120502_FDF_CRG/20120518_FDF_CRG_c12.mtb	6881	907	WWFF	food_fat	4	160826	1337493341	1	0.0200000000000014	0.000769230769230823	11123	1
4	Food 2	Intake 4	232	161991	1337494506	/users/cn/jespinosa/phecomp/data/CRG/20120502_FDF_CRG/20120502_FDF_CRG/20120518_FDF_CRG_c12.mtb	6884	16	WWFF	food_fat	4	161759	1337494274	1	0.359999999999999	0.00155172413793103	11124	1
4	Drink 2	Intake 2	60	161979	1337494494	/users/cn/jespinosa/phecomp/data/CRG/20120502_FDF_CRG/20120502_FDF_CRG/20120518_FDF_CRG_c12.mtb	1853	NA	WWFF	water	2	161919	1337494434	1	0.0600000000000001	0.001	11125	1
4	Food 2	Intake 4	142	162149	1337494664	/users/cn/jespinosa/phecomp/data/CRG/20120502_FDF_CRG/20120502_FDF_CRG/20120518_FDF_CRG_c12.mtb	6885	318	WWFF	food_fat	4	162007	1337494522	1	0.0600000000000005	0.000422535211267609	11126	1
4	Food 2	Intake 4	161	162628	1337495143	/users/cn/jespinosa/phecomp/data/CRG/20120502_FDF_CRG/20120502_FDF_CRG/20120518_FDF_CRG_c12.mtb	6888	175	WWFF	food_fat	4	162467	1337494982	1	0.18	0.00111801242236025	11127	1
4	Food 1	Intake 3	198	163001	1337495516	/users/cn/jespinosa/phecomp/data/CRG/20120502_FDF_CRG/20120502_FDF_CRG/20120518_FDF_CRG_c12.mtb	5045	COLL	WWFF	food_fat	3	162803	1337495318	1	0.0399999999999991	0.000202020202020197	11128	1
4	Food 2	Intake 4	216	163113	1337495628	/users/cn/jespinosa/phecomp/data/CRG/20120502_FDF_CRG/20120502_FDF_CRG/20120518_FDF_CRG_c12.mtb	6891	173	WWFF	food_fat	4	162897	1337495412	1	0.0999999999999996	0.000462962962962961	11129	1
4	Drink 2	Intake 2	17	163133	1337495648	/users/cn/jespinosa/phecomp/data/CRG/20120502_FDF_CRG/20120502_FDF_CRG/20120518_FDF_CRG_c12.mtb	1858	NA	WWFF	water	2	163116	1337495631	1	0.02	0.00117647058823529	11130	1
4	Food 2	Intake 4	361	163647	1337496162	/users/cn/jespinosa/phecomp/data/CRG/20120502_FDF_CRG/20120502_FDF_CRG/20120518_FDF_CRG_c12.mtb	6893	308	WWFF	food_fat	4	163286	1337495801	1	0.0800000000000001	0.000221606648199446	11131	1
4	Food 2	Intake 4	15	163970	1337496485	/users/cn/jespinosa/phecomp/data/CRG/20120502_FDF_CRG/20120502_FDF_CRG/20120518_FDF_CRG_c12.mtb	6896	97	WWFF	food_fat	4	163955	1337496470	1	0.26	0.0173333333333333	11132	1
4	Food 2	Intake 4	35	164102	1337496617	/users/cn/jespinosa/phecomp/data/CRG/20120502_FDF_CRG/20120502_FDF_CRG/20120518_FDF_CRG_c12.mtb	6897	13635	WWFF	food_fat	4	164067	1337496582	1	0.0400000000000009	0.00114285714285717	11133	1
4	Drink 1	Intake 1	17	168040	1337500555	/users/cn/jespinosa/phecomp/data/CRG/20120502_FDF_CRG/20120502_FDF_CRG/20120518_FDF_CRG_c12.mtb	1990	NA	WWFF	water	1	168023	1337500538	1	0.0600000000000001	0.00352941176470589	11134	1
4	Drink 1	Intake 1	20	169439	1337501954	/users/cn/jespinosa/phecomp/data/CRG/20120502_FDF_CRG/20120502_FDF_CRG/20120518_FDF_CRG_c12.mtb	1991	NA	WWFF	water	1	169419	1337501934	1	0.1	0.005	11135	1
4	Drink 1	Intake 1	28	172196	1337504711	/users/cn/jespinosa/phecomp/data/CRG/20120502_FDF_CRG/20120502_FDF_CRG/20120518_FDF_CRG_c12.mtb	1992	NA	WWFF	water	1	172168	1337504683	1	0.1	0.00357142857142857	11136	1
4	Drink 1	Intake 1	21	173328	1337505843	/users/cn/jespinosa/phecomp/data/CRG/20120502_FDF_CRG/20120502_FDF_CRG/20120518_FDF_CRG_c12.mtb	1993	NA	WWFF	water	1	173307	1337505822	1	0.0799999999999996	0.00380952380952379	11137	1
4	Drink 1	Intake 1	25	175513	1337508028	/users/cn/jespinosa/phecomp/data/CRG/20120502_FDF_CRG/20120502_FDF_CRG/20120518_FDF_CRG_c12.mtb	1994	NA	WWFF	water	1	175488	1337508003	1	0.12	0.0048	11138	1
4	Drink 1	Intake 1	18	177722	1337510237	/users/cn/jespinosa/phecomp/data/CRG/20120502_FDF_CRG/20120502_FDF_CRG/20120518_FDF_CRG_c12.mtb	1995	NA	WWFF	water	1	177704	1337510219	1	0.12	0.00666666666666667	11139	1
4	Food 2	Intake 4	30	177767	1337510282	/users/cn/jespinosa/phecomp/data/CRG/20120502_FDF_CRG/20120502_FDF_CRG/20120518_FDF_CRG_c12.mtb	6910	1483	WWFF	food_fat	4	177737	1337510252	1	0.0200000000000014	0.000666666666666713	11140	1
4	Drink 1	Intake 1	19	179155	1337511670	/users/cn/jespinosa/phecomp/data/CRG/20120502_FDF_CRG/20120502_FDF_CRG/20120518_FDF_CRG_c12.mtb	1996	NA	WWFF	water	1	179136	1337511651	1	0.04	0.00210526315789474	11141	1
4	Food 1	Intake 3	16	179266	1337511781	/users/cn/jespinosa/phecomp/data/CRG/20120502_FDF_CRG/20120502_FDF_CRG/20120518_FDF_CRG_c12.mtb	5048	595	WWFF	food_fat	3	179250	1337511765	1	0.0200000000000014	0.00125000000000009	11142	1
4	Food 2	Intake 4	169	180030	1337512545	/users/cn/jespinosa/phecomp/data/CRG/20120502_FDF_CRG/20120502_FDF_CRG/20120518_FDF_CRG_c12.mtb	6917	8465	WWFF	food_fat	4	179861	1337512376	1	0.0600000000000005	0.00035502958579882	11143	1
4	Drink 2	Intake 2	27	179959	1337512474	/users/cn/jespinosa/phecomp/data/CRG/20120502_FDF_CRG/20120502_FDF_CRG/20120518_FDF_CRG_c12.mtb	1862	NA	WWFF	water	2	179932	1337512447	1	0.02	0.000740740740740741	11144	1
4	Drink 1	Intake 1	27	187940	1337520455	/users/cn/jespinosa/phecomp/data/CRG/20120502_FDF_CRG/20120502_FDF_CRG/20120518_FDF_CRG_c12.mtb	1997	NA	WWFF	water	1	187913	1337520428	1	0.0999999999999996	0.00370370370370369	11145	1
4	Food 2	Intake 4	16	188511	1337521026	/users/cn/jespinosa/phecomp/data/CRG/20120502_FDF_CRG/20120502_FDF_CRG/20120518_FDF_CRG_c12.mtb	6932	567	WWFF	food_fat	4	188495	1337521010	1	0.399999999999999	0.0249999999999999	11146	1
4	Food 2	Intake 4	14	189092	1337521607	/users/cn/jespinosa/phecomp/data/CRG/20120502_FDF_CRG/20120502_FDF_CRG/20120518_FDF_CRG_c12.mtb	6933	5669	WWFF	food_fat	4	189078	1337521593	1	0.0200000000000014	0.00142857142857153	11147	1
4	Drink 1	Intake 1	25	189872	1337522387	/users/cn/jespinosa/phecomp/data/CRG/20120502_FDF_CRG/20120502_FDF_CRG/20120518_FDF_CRG_c12.mtb	1998	NA	WWFF	water	1	189847	1337522362	1	0.12	0.0048	11148	1
4	Drink 1	Intake 1	22	192590	1337525105	/users/cn/jespinosa/phecomp/data/CRG/20120502_FDF_CRG/20120502_FDF_CRG/20120518_FDF_CRG_c12.mtb	1999	NA	WWFF	water	1	192568	1337525083	1	0.0600000000000005	0.00272727272727275	11149	1
4	Drink 1	Intake 1	27	194307	1337526822	/users/cn/jespinosa/phecomp/data/CRG/20120502_FDF_CRG/20120502_FDF_CRG/20120518_FDF_CRG_c12.mtb	2000	NA	WWFF	water	1	194280	1337526795	1	0.12	0.00444444444444444	11150	1
4	Food 2	Intake 4	58	194819	1337527334	/users/cn/jespinosa/phecomp/data/CRG/20120502_FDF_CRG/20120502_FDF_CRG/20120518_FDF_CRG_c12.mtb	6937	7731	WWFF	food_fat	4	194761	1337527276	1	0.42	0.00724137931034483	11151	1
4	Drink 1	Intake 1	22	195881	1337528396	/users/cn/jespinosa/phecomp/data/CRG/20120502_FDF_CRG/20120502_FDF_CRG/20120518_FDF_CRG_c12.mtb	2001	NA	WWFF	water	1	195859	1337528374	1	0.0599999999999996	0.00272727272727271	11152	1
4	Drink 1	Intake 1	15	199313	1337531828	/users/cn/jespinosa/phecomp/data/CRG/20120502_FDF_CRG/20120502_FDF_CRG/20120518_FDF_CRG_c12.mtb	2002	NA	WWFF	water	1	199298	1337531813	1	0.0600000000000005	0.00400000000000003	11153	1
4	Food 2	Intake 4	65	202615	1337535130	/users/cn/jespinosa/phecomp/data/CRG/20120502_FDF_CRG/20120502_FDF_CRG/20120518_FDF_CRG_c12.mtb	6940	3954	WWFF	food_fat	4	202550	1337535065	1	0.0399999999999991	0.000615384615384602	11154	1
4	Drink 1	Intake 1	23	204162	1337536677	/users/cn/jespinosa/phecomp/data/CRG/20120502_FDF_CRG/20120502_FDF_CRG/20120518_FDF_CRG_c12.mtb	2004	NA	WWFF	water	1	204139	1337536654	1	0.04	0.00173913043478261	11155	1
4	Drink 1	Intake 1	23	204768	1337537283	/users/cn/jespinosa/phecomp/data/CRG/20120502_FDF_CRG/20120502_FDF_CRG/20120518_FDF_CRG_c12.mtb	2005	NA	WWFF	water	1	204745	1337537260	1	0.0599999999999996	0.0026086956521739	11156	1
4	Drink 2	Intake 2	18	206033	1337538548	/users/cn/jespinosa/phecomp/data/CRG/20120502_FDF_CRG/20120502_FDF_CRG/20120518_FDF_CRG_c12.mtb	1866	NA	WWFF	water	2	206015	1337538530	1	0.02	0.00111111111111111	11157	1
4	Food 2	Intake 4	68	206637	1337539152	/users/cn/jespinosa/phecomp/data/CRG/20120502_FDF_CRG/20120502_FDF_CRG/20120518_FDF_CRG_c12.mtb	6951	114	WWFF	food_fat	4	206569	1337539084	1	0.0200000000000014	0.000294117647058844	11158	1
4	Food 2	Intake 4	67	206818	1337539333	/users/cn/jespinosa/phecomp/data/CRG/20120502_FDF_CRG/20120502_FDF_CRG/20120518_FDF_CRG_c12.mtb	6953	237	WWFF	food_fat	4	206751	1337539266	1	0.0399999999999991	0.000597014925373121	11159	1
4	Food 2	Intake 4	22	207077	1337539592	/users/cn/jespinosa/phecomp/data/CRG/20120502_FDF_CRG/20120502_FDF_CRG/20120518_FDF_CRG_c12.mtb	6955	227	WWFF	food_fat	4	207055	1337539570	1	0.0800000000000001	0.00363636363636364	11160	1
4	Food 2	Intake 4	17	207321	1337539836	/users/cn/jespinosa/phecomp/data/CRG/20120502_FDF_CRG/20120502_FDF_CRG/20120518_FDF_CRG_c12.mtb	6958	226	WWFF	food_fat	4	207304	1337539819	1	0.0800000000000001	0.00470588235294118	11161	1
4	Food 2	Intake 4	193	207740	1337540255	/users/cn/jespinosa/phecomp/data/CRG/20120502_FDF_CRG/20120502_FDF_CRG/20120518_FDF_CRG_c12.mtb	6960	102	WWFF	food_fat	4	207547	1337540062	1	0.100000000000001	0.000518134715025912	11162	1
4	Food 2	Intake 4	20	207862	1337540377	/users/cn/jespinosa/phecomp/data/CRG/20120502_FDF_CRG/20120502_FDF_CRG/20120518_FDF_CRG_c12.mtb	6962	194	WWFF	food_fat	4	207842	1337540357	1	0.0399999999999991	0.00199999999999995	11163	1
4	Drink 1	Intake 1	52	207959	1337540474	/users/cn/jespinosa/phecomp/data/CRG/20120502_FDF_CRG/20120502_FDF_CRG/20120518_FDF_CRG_c12.mtb	2009	NA	WWFF	water	1	207907	1337540422	1	0.0200000000000005	0.000384615384615394	11164	1
4	Food 2	Intake 4	50	208106	1337540621	/users/cn/jespinosa/phecomp/data/CRG/20120502_FDF_CRG/20120502_FDF_CRG/20120518_FDF_CRG_c12.mtb	6965	74	WWFF	food_fat	4	208056	1337540571	1	0.0399999999999991	0.000799999999999982	11165	1
4	Food 2	Intake 4	368	208548	1337541063	/users/cn/jespinosa/phecomp/data/CRG/20120502_FDF_CRG/20120502_FDF_CRG/20120518_FDF_CRG_c12.mtb	6966	133	WWFF	food_fat	4	208180	1337540695	1	0.520000000000001	0.00141304347826087	11166	1
4	Food 1	Intake 3	76	208757	1337541272	/users/cn/jespinosa/phecomp/data/CRG/20120502_FDF_CRG/20120502_FDF_CRG/20120518_FDF_CRG_c12.mtb	5066	64	WWFF	food_fat	3	208681	1337541196	1	0.0399999999999991	0.000526315789473672	11167	1
4	Drink 2	Intake 2	16	208771	1337541286	/users/cn/jespinosa/phecomp/data/CRG/20120502_FDF_CRG/20120502_FDF_CRG/20120518_FDF_CRG_c12.mtb	1870	NA	WWFF	water	2	208755	1337541270	1	0.04	0.0025	11168	1
4	Food 2	Intake 4	279	209100	1337541615	/users/cn/jespinosa/phecomp/data/CRG/20120502_FDF_CRG/20120502_FDF_CRG/20120518_FDF_CRG_c12.mtb	6968	5	WWFF	food_fat	4	208821	1337541336	1	0.34	0.00121863799283154	11169	1
4	Food 2	Intake 4	74	209179	1337541694	/users/cn/jespinosa/phecomp/data/CRG/20120502_FDF_CRG/20120502_FDF_CRG/20120518_FDF_CRG_c12.mtb	6969	369	WWFF	food_fat	4	209105	1337541620	1	0.0399999999999991	0.000540540540540528	11170	1
4	Food 1	Intake 3	202	209750	1337542265	/users/cn/jespinosa/phecomp/data/CRG/20120502_FDF_CRG/20120502_FDF_CRG/20120518_FDF_CRG_c12.mtb	5070	COLL	WWFF	food_fat	3	209548	1337542063	1	0.9	0.00445544554455446	11171	1
4	Food 2	Intake 4	60	209757	1337542272	/users/cn/jespinosa/phecomp/data/CRG/20120502_FDF_CRG/20120502_FDF_CRG/20120518_FDF_CRG_c12.mtb	6972	321	WWFF	food_fat	4	209697	1337542212	1	0.0999999999999979	0.00166666666666663	11172	1
4	Drink 1	Intake 1	22	209883	1337542398	/users/cn/jespinosa/phecomp/data/CRG/20120502_FDF_CRG/20120502_FDF_CRG/20120518_FDF_CRG_c12.mtb	2011	NA	WWFF	water	1	209861	1337542376	1	0.0599999999999996	0.00272727272727271	11173	1
4	Food 2	Intake 4	206	210284	1337542799	/users/cn/jespinosa/phecomp/data/CRG/20120502_FDF_CRG/20120502_FDF_CRG/20120518_FDF_CRG_c12.mtb	6974	474	WWFF	food_fat	4	210078	1337542593	1	0.140000000000001	0.000679611650485442	11174	1
4	Drink 2	Intake 2	46	210691	1337543206	/users/cn/jespinosa/phecomp/data/CRG/20120502_FDF_CRG/20120502_FDF_CRG/20120518_FDF_CRG_c12.mtb	1872	NA	WWFF	water	2	210645	1337543160	1	0.0399999999999999	0.000869565217391302	11175	1
4	Food 1	Intake 3	79	210837	1337543352	/users/cn/jespinosa/phecomp/data/CRG/20120502_FDF_CRG/20120502_FDF_CRG/20120518_FDF_CRG_c12.mtb	5076	349	WWFF	food_fat	3	210758	1337543273	1	0.0200000000000014	0.000253164556962043	11176	1
4	Food 2	Intake 4	35	211221	1337543736	/users/cn/jespinosa/phecomp/data/CRG/20120502_FDF_CRG/20120502_FDF_CRG/20120518_FDF_CRG_c12.mtb	6978	236	WWFF	food_fat	4	211186	1337543701	1	0.0799999999999983	0.00228571428571424	11177	1
4	Food 2	Intake 4	102	211559	1337544074	/users/cn/jespinosa/phecomp/data/CRG/20120502_FDF_CRG/20120502_FDF_CRG/20120518_FDF_CRG_c12.mtb	6981	118	WWFF	food_fat	4	211457	1337543972	1	0.399999999999999	0.00392156862745097	11178	1
4	Food 2	Intake 4	182	211859	1337544374	/users/cn/jespinosa/phecomp/data/CRG/20120502_FDF_CRG/20120502_FDF_CRG/20120518_FDF_CRG_c12.mtb	6983	COLL	WWFF	food_fat	4	211677	1337544192	1	0.0599999999999987	0.000329670329670323	11179	1
4	Food 1	Intake 3	118	211808	1337544323	/users/cn/jespinosa/phecomp/data/CRG/20120502_FDF_CRG/20120502_FDF_CRG/20120518_FDF_CRG_c12.mtb	5081	601	WWFF	food_fat	3	211690	1337544205	1	0.0399999999999991	0.00033898305084745	11180	1
4	Food 2	Intake 4	155	212564	1337545079	/users/cn/jespinosa/phecomp/data/CRG/20120502_FDF_CRG/20120502_FDF_CRG/20120518_FDF_CRG_c12.mtb	6987	9	WWFF	food_fat	4	212409	1337544924	1	0.0399999999999991	0.000258064516129026	11181	1
4	Food 2	Intake 4	342	212915	1337545430	/users/cn/jespinosa/phecomp/data/CRG/20120502_FDF_CRG/20120502_FDF_CRG/20120518_FDF_CRG_c12.mtb	6988	255	WWFF	food_fat	4	212573	1337545088	1	0.0200000000000031	5.84795321637518e-05	11182	1
4	Food 2	Intake 4	98	213268	1337545783	/users/cn/jespinosa/phecomp/data/CRG/20120502_FDF_CRG/20120502_FDF_CRG/20120518_FDF_CRG_c12.mtb	6991	393	WWFF	food_fat	4	213170	1337545685	1	0.0599999999999987	0.00061224489795917	11183	1
4	Food 2	Intake 4	39	213700	1337546215	/users/cn/jespinosa/phecomp/data/CRG/20120502_FDF_CRG/20120502_FDF_CRG/20120518_FDF_CRG_c12.mtb	6993	499	WWFF	food_fat	4	213661	1337546176	1	0.0200000000000031	0.000512820512820592	11184	1
4	Food 2	Intake 4	239	214438	1337546953	/users/cn/jespinosa/phecomp/data/CRG/20120502_FDF_CRG/20120502_FDF_CRG/20120518_FDF_CRG_c12.mtb	6998	254	WWFF	food_fat	4	214199	1337546714	1	0.0599999999999987	0.000251046025104597	11185	1
4	Food 2	Intake 4	217	214909	1337547424	/users/cn/jespinosa/phecomp/data/CRG/20120502_FDF_CRG/20120502_FDF_CRG/20120518_FDF_CRG_c12.mtb	7000	5	WWFF	food_fat	4	214692	1337547207	1	0.0399999999999991	0.000184331797235019	11186	1
4	Food 2	Intake 4	29	214943	1337547458	/users/cn/jespinosa/phecomp/data/CRG/20120502_FDF_CRG/20120502_FDF_CRG/20120518_FDF_CRG_c12.mtb	7001	233	WWFF	food_fat	4	214914	1337547429	1	0.100000000000001	0.003448275862069	11187	1
4	Drink 2	Intake 2	21	215021	1337547536	/users/cn/jespinosa/phecomp/data/CRG/20120502_FDF_CRG/20120502_FDF_CRG/20120518_FDF_CRG_c12.mtb	1877	NA	WWFF	water	2	215000	1337547515	1	0.1	0.00476190476190476	11188	1
4	Drink 2	Intake 2	49	215078	1337547593	/users/cn/jespinosa/phecomp/data/CRG/20120502_FDF_CRG/20120502_FDF_CRG/20120518_FDF_CRG_c12.mtb	1878	NA	WWFF	water	2	215029	1337547544	1	0.02	0.000408163265306122	11189	1
4	Food 2	Intake 4	137	215313	1337547828	/users/cn/jespinosa/phecomp/data/CRG/20120502_FDF_CRG/20120502_FDF_CRG/20120518_FDF_CRG_c12.mtb	7004	4442	WWFF	food_fat	4	215176	1337547691	1	0.0600000000000023	0.000437956204379579	11190	1
4	Drink 2	Intake 2	39	215217	1337547732	/users/cn/jespinosa/phecomp/data/CRG/20120502_FDF_CRG/20120502_FDF_CRG/20120518_FDF_CRG_c12.mtb	1879	NA	WWFF	water	2	215178	1337547693	1	0.02	0.000512820512820513	11191	1
4	Drink 1	Intake 1	29	216952	1337549467	/users/cn/jespinosa/phecomp/data/CRG/20120502_FDF_CRG/20120502_FDF_CRG/20120518_FDF_CRG_c12.mtb	2015	NA	WWFF	water	1	216923	1337549438	1	0.12	0.00413793103448276	11192	1
4	Drink 1	Intake 1	21	219538	1337552053	/users/cn/jespinosa/phecomp/data/CRG/20120502_FDF_CRG/20120502_FDF_CRG/20120518_FDF_CRG_c12.mtb	2016	NA	WWFF	water	1	219517	1337552032	1	0.0200000000000005	0.000952380952380976	11193	1
4	Drink 2	Intake 2	67	219591	1337552106	/users/cn/jespinosa/phecomp/data/CRG/20120502_FDF_CRG/20120502_FDF_CRG/20120518_FDF_CRG_c12.mtb	1881	NA	WWFF	water	2	219524	1337552039	1	0.04	0.000597014925373134	11194	1
4	Food 2	Intake 4	81	219836	1337552351	/users/cn/jespinosa/phecomp/data/CRG/20120502_FDF_CRG/20120502_FDF_CRG/20120518_FDF_CRG_c12.mtb	7013	14	WWFF	food_fat	4	219755	1337552270	1	0.0999999999999979	0.00123456790123454	11195	1
4	Food 2	Intake 4	327	220177	1337552692	/users/cn/jespinosa/phecomp/data/CRG/20120502_FDF_CRG/20120502_FDF_CRG/20120518_FDF_CRG_c12.mtb	7014	291	WWFF	food_fat	4	219850	1337552365	1	0.120000000000001	0.000366972477064223	11196	1
4	Food 2	Intake 4	28	220496	1337553011	/users/cn/jespinosa/phecomp/data/CRG/20120502_FDF_CRG/20120502_FDF_CRG/20120518_FDF_CRG_c12.mtb	7016	363	WWFF	food_fat	4	220468	1337552983	1	0.0800000000000018	0.00285714285714292	11197	1
4	Food 2	Intake 4	205	221064	1337553579	/users/cn/jespinosa/phecomp/data/CRG/20120502_FDF_CRG/20120502_FDF_CRG/20120518_FDF_CRG_c12.mtb	7019	165	WWFF	food_fat	4	220859	1337553374	1	0.18	0.000878048780487805	11198	1
4	Drink 1	Intake 1	15	221199	1337553714	/users/cn/jespinosa/phecomp/data/CRG/20120502_FDF_CRG/20120502_FDF_CRG/20120518_FDF_CRG_c12.mtb	2019	NA	WWFF	water	1	221184	1337553699	1	0.0600000000000005	0.00400000000000003	11199	1
4	Food 2	Intake 4	136	221365	1337553880	/users/cn/jespinosa/phecomp/data/CRG/20120502_FDF_CRG/20120502_FDF_CRG/20120518_FDF_CRG_c12.mtb	7021	655	WWFF	food_fat	4	221229	1337553744	1	0.0399999999999991	0.000294117647058817	11200	1
4	Food 2	Intake 4	14	222034	1337554549	/users/cn/jespinosa/phecomp/data/CRG/20120502_FDF_CRG/20120502_FDF_CRG/20120518_FDF_CRG_c12.mtb	7027	41	WWFF	food_fat	4	222020	1337554535	1	0.120000000000001	0.00857142857142864	11201	1
4	Food 2	Intake 4	21	222096	1337554611	/users/cn/jespinosa/phecomp/data/CRG/20120502_FDF_CRG/20120502_FDF_CRG/20120518_FDF_CRG_c12.mtb	7028	2871	WWFF	food_fat	4	222075	1337554590	1	0.0399999999999991	0.00190476190476186	11202	1
4	Food 2	Intake 4	37	225004	1337557519	/users/cn/jespinosa/phecomp/data/CRG/20120502_FDF_CRG/20120502_FDF_CRG/20120518_FDF_CRG_c12.mtb	7038	1409	WWFF	food_fat	4	224967	1337557482	1	0.0399999999999991	0.00108108108108106	11203	1
4	Food 2	Intake 4	70	226483	1337558998	/users/cn/jespinosa/phecomp/data/CRG/20120502_FDF_CRG/20120502_FDF_CRG/20120518_FDF_CRG_c12.mtb	7047	28	WWFF	food_fat	4	226413	1337558928	1	0.0399999999999991	0.000571428571428559	11204	1
4	Food 2	Intake 4	210	226721	1337559236	/users/cn/jespinosa/phecomp/data/CRG/20120502_FDF_CRG/20120502_FDF_CRG/20120518_FDF_CRG_c12.mtb	7048	49	WWFF	food_fat	4	226511	1337559026	1	0.0400000000000027	0.000190476190476203	11205	1
4	Food 2	Intake 4	165	226935	1337559450	/users/cn/jespinosa/phecomp/data/CRG/20120502_FDF_CRG/20120502_FDF_CRG/20120518_FDF_CRG_c12.mtb	7050	59	WWFF	food_fat	4	226770	1337559285	1	0.0799999999999983	0.000484848484848475	11206	1
4	Food 1	Intake 3	64	227058	1337559573	/users/cn/jespinosa/phecomp/data/CRG/20120502_FDF_CRG/20120502_FDF_CRG/20120518_FDF_CRG_c12.mtb	5099	COLL	WWFF	food_fat	3	226994	1337559509	1	0.0200000000000014	0.000312500000000022	11207	1
4	Food 2	Intake 4	64	227078	1337559593	/users/cn/jespinosa/phecomp/data/CRG/20120502_FDF_CRG/20120502_FDF_CRG/20120518_FDF_CRG_c12.mtb	7052	11	WWFF	food_fat	4	227014	1337559529	1	0.0600000000000023	0.000937500000000036	11208	1
4	Food 2	Intake 4	144	227233	1337559748	/users/cn/jespinosa/phecomp/data/CRG/20120502_FDF_CRG/20120502_FDF_CRG/20120518_FDF_CRG_c12.mtb	7053	501	WWFF	food_fat	4	227089	1337559604	1	0.0799999999999983	0.000555555555555544	11209	1
4	Drink 1	Intake 1	38	227275	1337559790	/users/cn/jespinosa/phecomp/data/CRG/20120502_FDF_CRG/20120502_FDF_CRG/20120518_FDF_CRG_c12.mtb	2021	NA	WWFF	water	1	227237	1337559752	1	0.0999999999999996	0.00263157894736841	11210	1
4	Food 2	Intake 4	13	227747	1337560262	/users/cn/jespinosa/phecomp/data/CRG/20120502_FDF_CRG/20120502_FDF_CRG/20120518_FDF_CRG_c12.mtb	7056	177	WWFF	food_fat	4	227734	1337560249	1	0.0399999999999991	0.00307692307692301	11211	1
4	Drink 1	Intake 1	30	227769	1337560284	/users/cn/jespinosa/phecomp/data/CRG/20120502_FDF_CRG/20120502_FDF_CRG/20120518_FDF_CRG_c12.mtb	2022	NA	WWFF	water	1	227739	1337560254	1	0.0800000000000001	0.00266666666666667	11212	1
4	Food 2	Intake 4	13	227937	1337560452	/users/cn/jespinosa/phecomp/data/CRG/20120502_FDF_CRG/20120502_FDF_CRG/20120518_FDF_CRG_c12.mtb	7060	93	WWFF	food_fat	4	227924	1337560439	1	0.0599999999999987	0.00461538461538452	11213	1
4	Food 2	Intake 4	14	228044	1337560559	/users/cn/jespinosa/phecomp/data/CRG/20120502_FDF_CRG/20120502_FDF_CRG/20120518_FDF_CRG_c12.mtb	7062	367	WWFF	food_fat	4	228030	1337560545	1	0.199999999999999	0.0142857142857142	11214	1
4	Food 2	Intake 4	56	228467	1337560982	/users/cn/jespinosa/phecomp/data/CRG/20120502_FDF_CRG/20120502_FDF_CRG/20120518_FDF_CRG_c12.mtb	7065	1008	WWFF	food_fat	4	228411	1337560926	1	0.0400000000000027	0.000714285714285763	11215	1
4	Food 2	Intake 4	142	229617	1337562132	/users/cn/jespinosa/phecomp/data/CRG/20120502_FDF_CRG/20120502_FDF_CRG/20120518_FDF_CRG_c12.mtb	7073	4	WWFF	food_fat	4	229475	1337561990	1	0.120000000000001	0.000845070422535218	11216	1
4	Food 2	Intake 4	99	229720	1337562235	/users/cn/jespinosa/phecomp/data/CRG/20120502_FDF_CRG/20120502_FDF_CRG/20120518_FDF_CRG_c12.mtb	7074	2021	WWFF	food_fat	4	229621	1337562136	1	0.0599999999999987	0.000606060606060593	11217	1
4	Food 2	Intake 4	21	231762	1337564277	/users/cn/jespinosa/phecomp/data/CRG/20120502_FDF_CRG/20120502_FDF_CRG/20120518_FDF_CRG_c12.mtb	7079	296	WWFF	food_fat	4	231741	1337564256	1	0.0399999999999991	0.00190476190476186	11218	1
4	Food 2	Intake 4	19	232077	1337564592	/users/cn/jespinosa/phecomp/data/CRG/20120502_FDF_CRG/20120502_FDF_CRG/20120518_FDF_CRG_c12.mtb	7080	3507	WWFF	food_fat	4	232058	1337564573	1	0.0200000000000031	0.00105263157894753	11219	1
4	Drink 1	Intake 1	21	232298	1337564813	/users/cn/jespinosa/phecomp/data/CRG/20120502_FDF_CRG/20120502_FDF_CRG/20120518_FDF_CRG_c12.mtb	2023	NA	WWFF	water	1	232277	1337564792	1	0.0600000000000005	0.00285714285714288	11220	1
4	Food 2	Intake 4	31	235615	1337568130	/users/cn/jespinosa/phecomp/data/CRG/20120502_FDF_CRG/20120502_FDF_CRG/20120518_FDF_CRG_c12.mtb	7099	14	WWFF	food_fat	4	235584	1337568099	1	0.0399999999999991	0.00129032258064513	11221	1
4	Food 2	Intake 4	17	235646	1337568161	/users/cn/jespinosa/phecomp/data/CRG/20120502_FDF_CRG/20120502_FDF_CRG/20120518_FDF_CRG_c12.mtb	7100	200	WWFF	food_fat	4	235629	1337568144	1	0.16	0.00941176470588235	11222	1
4	Food 2	Intake 4	22	235868	1337568383	/users/cn/jespinosa/phecomp/data/CRG/20120502_FDF_CRG/20120502_FDF_CRG/20120518_FDF_CRG_c12.mtb	7102	15	WWFF	food_fat	4	235846	1337568361	1	0.0400000000000027	0.00181818181818194	11223	1
4	Food 2	Intake 4	184	236067	1337568582	/users/cn/jespinosa/phecomp/data/CRG/20120502_FDF_CRG/20120502_FDF_CRG/20120518_FDF_CRG_c12.mtb	7103	368	WWFF	food_fat	4	235883	1337568398	1	0.0399999999999991	0.000217391304347821	11224	1
4	Drink 1	Intake 1	31	236272	1337568787	/users/cn/jespinosa/phecomp/data/CRG/20120502_FDF_CRG/20120502_FDF_CRG/20120518_FDF_CRG_c12.mtb	2024	NA	WWFF	water	1	236241	1337568756	1	0.0999999999999996	0.00322580645161289	11225	1
4	Food 2	Intake 4	13	236448	1337568963	/users/cn/jespinosa/phecomp/data/CRG/20120502_FDF_CRG/20120502_FDF_CRG/20120518_FDF_CRG_c12.mtb	7108	1828	WWFF	food_fat	4	236435	1337568950	1	0.0399999999999991	0.00307692307692301	11226	1
4	Drink 1	Intake 1	17	236545	1337569060	/users/cn/jespinosa/phecomp/data/CRG/20120502_FDF_CRG/20120502_FDF_CRG/20120518_FDF_CRG_c12.mtb	2025	NA	WWFF	water	1	236528	1337569043	1	0.04	0.00235294117647059	11227	1
4	Food 2	Intake 4	18	238294	1337570809	/users/cn/jespinosa/phecomp/data/CRG/20120502_FDF_CRG/20120502_FDF_CRG/20120518_FDF_CRG_c12.mtb	7112	109	WWFF	food_fat	4	238276	1337570791	1	0.0399999999999991	0.00222222222222217	11228	1
4	Drink 1	Intake 1	15	238410	1337570925	/users/cn/jespinosa/phecomp/data/CRG/20120502_FDF_CRG/20120502_FDF_CRG/20120518_FDF_CRG_c12.mtb	2026	NA	WWFF	water	1	238395	1337570910	1	0.04	0.00266666666666667	11229	1
4	Food 2	Intake 4	13	238416	1337570931	/users/cn/jespinosa/phecomp/data/CRG/20120502_FDF_CRG/20120502_FDF_CRG/20120518_FDF_CRG_c12.mtb	7113	2973	WWFF	food_fat	4	238403	1337570918	1	0.0400000000000027	0.00307692307692328	11230	1
4	Food 2	Intake 4	104	241493	1337574008	/users/cn/jespinosa/phecomp/data/CRG/20120502_FDF_CRG/20120502_FDF_CRG/20120518_FDF_CRG_c12.mtb	7129	56	WWFF	food_fat	4	241389	1337573904	1	0.0599999999999987	0.000576923076923064	11231	1
4	Food 2	Intake 4	235	241784	1337574299	/users/cn/jespinosa/phecomp/data/CRG/20120502_FDF_CRG/20120502_FDF_CRG/20120518_FDF_CRG_c12.mtb	7131	189	WWFF	food_fat	4	241549	1337574064	1	0.220000000000002	0.000936170212765966	11232	1
4	Drink 1	Intake 1	30	241949	1337574464	/users/cn/jespinosa/phecomp/data/CRG/20120502_FDF_CRG/20120502_FDF_CRG/20120518_FDF_CRG_c12.mtb	2027	NA	WWFF	water	1	241919	1337574434	1	0.0600000000000005	0.00200000000000002	11233	1
4	Food 2	Intake 4	56	242029	1337574544	/users/cn/jespinosa/phecomp/data/CRG/20120502_FDF_CRG/20120502_FDF_CRG/20120518_FDF_CRG_c12.mtb	7133	31	WWFF	food_fat	4	241973	1337574488	1	0.120000000000001	0.00214285714285716	11234	1
4	Food 1	Intake 3	111	242171	1337574686	/users/cn/jespinosa/phecomp/data/CRG/20120502_FDF_CRG/20120502_FDF_CRG/20120518_FDF_CRG_c12.mtb	5108	COLL	WWFF	food_fat	3	242060	1337574575	1	0.0399999999999991	0.000360360360360352	11235	1
4	Food 2	Intake 4	28	242175	1337574690	/users/cn/jespinosa/phecomp/data/CRG/20120502_FDF_CRG/20120502_FDF_CRG/20120518_FDF_CRG_c12.mtb	7135	316	WWFF	food_fat	4	242147	1337574662	1	0.0600000000000023	0.00214285714285722	11236	1
4	Drink 2	Intake 2	36	242308	1337574823	/users/cn/jespinosa/phecomp/data/CRG/20120502_FDF_CRG/20120502_FDF_CRG/20120518_FDF_CRG_c12.mtb	1887	NA	WWFF	water	2	242272	1337574787	1	0.0600000000000001	0.00166666666666667	11237	1
4	Food 2	Intake 4	57	242548	1337575063	/users/cn/jespinosa/phecomp/data/CRG/20120502_FDF_CRG/20120502_FDF_CRG/20120518_FDF_CRG_c12.mtb	7137	159	WWFF	food_fat	4	242491	1337575006	1	0.120000000000001	0.00210526315789475	11238	1
4	Drink 2	Intake 2	17	242554	1337575069	/users/cn/jespinosa/phecomp/data/CRG/20120502_FDF_CRG/20120502_FDF_CRG/20120518_FDF_CRG_c12.mtb	1888	NA	WWFF	water	2	242537	1337575052	1	0.1	0.00588235294117647	11239	1
4	Food 2	Intake 4	144	242851	1337575366	/users/cn/jespinosa/phecomp/data/CRG/20120502_FDF_CRG/20120502_FDF_CRG/20120518_FDF_CRG_c12.mtb	7140	430	WWFF	food_fat	4	242707	1337575222	1	0.120000000000001	0.00083333333333334	11240	1
4	Drink 1	Intake 1	17	242809	1337575324	/users/cn/jespinosa/phecomp/data/CRG/20120502_FDF_CRG/20120502_FDF_CRG/20120518_FDF_CRG_c12.mtb	2028	NA	WWFF	water	1	242792	1337575307	1	0.0399999999999991	0.00235294117647054	11241	1
4	Food 2	Intake 4	316	243597	1337576112	/users/cn/jespinosa/phecomp/data/CRG/20120502_FDF_CRG/20120502_FDF_CRG/20120518_FDF_CRG_c12.mtb	7143	1755	WWFF	food_fat	4	243281	1337575796	1	0.0800000000000018	0.000253164556962031	11242	1
4	Drink 1	Intake 1	15	243589	1337576104	/users/cn/jespinosa/phecomp/data/CRG/20120502_FDF_CRG/20120502_FDF_CRG/20120518_FDF_CRG_c12.mtb	2029	NA	WWFF	water	1	243574	1337576089	1	0.0200000000000005	0.00133333333333337	11243	1
4	Food 2	Intake 4	21	245373	1337577888	/users/cn/jespinosa/phecomp/data/CRG/20120502_FDF_CRG/20120502_FDF_CRG/20120518_FDF_CRG_c12.mtb	7150	56	WWFF	food_fat	4	245352	1337577867	1	0.0399999999999991	0.00190476190476186	11244	1
4	Food 2	Intake 4	327	245756	1337578271	/users/cn/jespinosa/phecomp/data/CRG/20120502_FDF_CRG/20120502_FDF_CRG/20120518_FDF_CRG_c12.mtb	7152	65	WWFF	food_fat	4	245429	1337577944	1	0.220000000000002	0.000672782874617743	11245	1
4	Food 2	Intake 4	86	245907	1337578422	/users/cn/jespinosa/phecomp/data/CRG/20120502_FDF_CRG/20120502_FDF_CRG/20120518_FDF_CRG_c12.mtb	7154	13	WWFF	food_fat	4	245821	1337578336	1	0.0399999999999991	0.000465116279069757	11246	1
4	Food 2	Intake 4	326	246246	1337578761	/users/cn/jespinosa/phecomp/data/CRG/20120502_FDF_CRG/20120502_FDF_CRG/20120518_FDF_CRG_c12.mtb	7155	11	WWFF	food_fat	4	245920	1337578435	1	1.84	0.0056441717791411	11247	1
4	Food 2	Intake 4	144	246401	1337578916	/users/cn/jespinosa/phecomp/data/CRG/20120502_FDF_CRG/20120502_FDF_CRG/20120518_FDF_CRG_c12.mtb	7156	8	WWFF	food_fat	4	246257	1337578772	1	0.100000000000001	0.000694444444444451	11248	1
4	Drink 1	Intake 1	23	246413	1337578928	/users/cn/jespinosa/phecomp/data/CRG/20120502_FDF_CRG/20120502_FDF_CRG/20120518_FDF_CRG_c12.mtb	2030	NA	WWFF	water	1	246390	1337578905	1	0.0800000000000001	0.00347826086956522	11249	1
4	Food 2	Intake 4	86	246495	1337579010	/users/cn/jespinosa/phecomp/data/CRG/20120502_FDF_CRG/20120502_FDF_CRG/20120518_FDF_CRG_c12.mtb	7157	14	WWFF	food_fat	4	246409	1337578924	1	0.120000000000001	0.00139534883720931	11250	1
4	Food 2	Intake 4	143	246652	1337579167	/users/cn/jespinosa/phecomp/data/CRG/20120502_FDF_CRG/20120502_FDF_CRG/20120518_FDF_CRG_c12.mtb	7158	COLL	WWFF	food_fat	4	246509	1337579024	1	0.120000000000001	0.000839160839160846	11251	1
4	Food 1	Intake 3	66	246696	1337579211	/users/cn/jespinosa/phecomp/data/CRG/20120502_FDF_CRG/20120502_FDF_CRG/20120518_FDF_CRG_c12.mtb	5113	COLL	WWFF	food_fat	3	246630	1337579145	1	0.0200000000000014	0.000303030303030324	11252	1
4	Food 2	Intake 4	192	246852	1337579367	/users/cn/jespinosa/phecomp/data/CRG/20120502_FDF_CRG/20120502_FDF_CRG/20120518_FDF_CRG_c12.mtb	7159	171	WWFF	food_fat	4	246660	1337579175	1	0.279999999999998	0.00145833333333332	11253	1
4	Drink 1	Intake 1	18	246931	1337579446	/users/cn/jespinosa/phecomp/data/CRG/20120502_FDF_CRG/20120502_FDF_CRG/20120518_FDF_CRG_c12.mtb	2031	NA	WWFF	water	1	246913	1337579428	1	0.04	0.00222222222222222	11254	1
4	Food 2	Intake 4	131	247154	1337579669	/users/cn/jespinosa/phecomp/data/CRG/20120502_FDF_CRG/20120502_FDF_CRG/20120518_FDF_CRG_c12.mtb	7161	306	WWFF	food_fat	4	247023	1337579538	1	0.260000000000002	0.0019847328244275	11255	1
4	Food 2	Intake 4	361	247821	1337580336	/users/cn/jespinosa/phecomp/data/CRG/20120502_FDF_CRG/20120502_FDF_CRG/20120518_FDF_CRG_c12.mtb	7164	124	WWFF	food_fat	4	247460	1337579975	1	0.120000000000001	0.000332409972299172	11256	1
4	Food 2	Intake 4	32	247977	1337580492	/users/cn/jespinosa/phecomp/data/CRG/20120502_FDF_CRG/20120502_FDF_CRG/20120518_FDF_CRG_c12.mtb	7166	9	WWFF	food_fat	4	247945	1337580460	1	0.16	0.005	11257	1
4	Food 2	Intake 4	206	248192	1337580707	/users/cn/jespinosa/phecomp/data/CRG/20120502_FDF_CRG/20120502_FDF_CRG/20120518_FDF_CRG_c12.mtb	7167	149	WWFF	food_fat	4	247986	1337580501	1	0.399999999999999	0.00194174757281553	11258	1
4	Food 2	Intake 4	14	248355	1337580870	/users/cn/jespinosa/phecomp/data/CRG/20120502_FDF_CRG/20120502_FDF_CRG/20120518_FDF_CRG_c12.mtb	7169	102	WWFF	food_fat	4	248341	1337580856	1	0.0599999999999987	0.00428571428571419	11259	1
4	Food 2	Intake 4	22	248479	1337580994	/users/cn/jespinosa/phecomp/data/CRG/20120502_FDF_CRG/20120502_FDF_CRG/20120518_FDF_CRG_c12.mtb	7170	1860	WWFF	food_fat	4	248457	1337580972	1	0.219999999999999	0.00999999999999996	11260	1
4	Drink 1	Intake 1	28	248502	1337581017	/users/cn/jespinosa/phecomp/data/CRG/20120502_FDF_CRG/20120502_FDF_CRG/20120518_FDF_CRG_c12.mtb	2032	NA	WWFF	water	1	248474	1337580989	1	0.0999999999999996	0.00357142857142856	11261	1
4	Food 2	Intake 4	22	250361	1337582876	/users/cn/jespinosa/phecomp/data/CRG/20120502_FDF_CRG/20120502_FDF_CRG/20120518_FDF_CRG_c12.mtb	7184	516	WWFF	food_fat	4	250339	1337582854	1	0.0200000000000031	0.00090909090909105	11262	1
4	Food 2	Intake 4	40	250917	1337583432	/users/cn/jespinosa/phecomp/data/CRG/20120502_FDF_CRG/20120502_FDF_CRG/20120518_FDF_CRG_c12.mtb	7187	405	WWFF	food_fat	4	250877	1337583392	1	0.620000000000001	0.0155	11263	1
4	Food 2	Intake 4	15	251337	1337583852	/users/cn/jespinosa/phecomp/data/CRG/20120502_FDF_CRG/20120502_FDF_CRG/20120518_FDF_CRG_c12.mtb	7190	339	WWFF	food_fat	4	251322	1337583837	1	0.0399999999999991	0.00266666666666661	11264	1
4	Food 2	Intake 4	28	251704	1337584219	/users/cn/jespinosa/phecomp/data/CRG/20120502_FDF_CRG/20120502_FDF_CRG/20120518_FDF_CRG_c12.mtb	7194	377	WWFF	food_fat	4	251676	1337584191	1	0.0599999999999987	0.0021428571428571	11265	1
4	Food 2	Intake 4	32	252113	1337584628	/users/cn/jespinosa/phecomp/data/CRG/20120502_FDF_CRG/20120502_FDF_CRG/20120518_FDF_CRG_c12.mtb	7195	604	WWFF	food_fat	4	252081	1337584596	1	0.0399999999999991	0.00124999999999997	11266	1
4	Drink 1	Intake 1	13	252386	1337584901	/users/cn/jespinosa/phecomp/data/CRG/20120502_FDF_CRG/20120502_FDF_CRG/20120518_FDF_CRG_c12.mtb	2033	NA	WWFF	water	1	252373	1337584888	1	0.04	0.00307692307692308	11267	1
4	Food 2	Intake 4	11	252728	1337585243	/users/cn/jespinosa/phecomp/data/CRG/20120502_FDF_CRG/20120502_FDF_CRG/20120518_FDF_CRG_c12.mtb	7199	2686	WWFF	food_fat	4	252717	1337585232	1	0.0200000000000031	0.0018181818181821	11268	1
4	Drink 1	Intake 1	20	254611	1337587126	/users/cn/jespinosa/phecomp/data/CRG/20120502_FDF_CRG/20120502_FDF_CRG/20120518_FDF_CRG_c12.mtb	2034	NA	WWFF	water	1	254591	1337587106	1	0.0800000000000001	0.00400000000000001	11269	1
4	Food 2	Intake 4	15	255429	1337587944	/users/cn/jespinosa/phecomp/data/CRG/20120502_FDF_CRG/20120502_FDF_CRG/20120518_FDF_CRG_c12.mtb	7213	2298	WWFF	food_fat	4	255414	1337587929	1	0.0399999999999991	0.00266666666666661	11270	1
4	Drink 1	Intake 1	19	256220	1337588735	/users/cn/jespinosa/phecomp/data/CRG/20120502_FDF_CRG/20120502_FDF_CRG/20120518_FDF_CRG_c12.mtb	2035	NA	WWFF	water	1	256201	1337588716	1	0.0800000000000001	0.00421052631578948	11271	1
4	Drink 1	Intake 1	25	257240	1337589755	/users/cn/jespinosa/phecomp/data/CRG/20120502_FDF_CRG/20120502_FDF_CRG/20120518_FDF_CRG_c12.mtb	2036	NA	WWFF	water	1	257215	1337589730	1	0.0999999999999996	0.00399999999999998	11272	1
4	Food 2	Intake 4	16	257743	1337590258	/users/cn/jespinosa/phecomp/data/CRG/20120502_FDF_CRG/20120502_FDF_CRG/20120518_FDF_CRG_c12.mtb	7219	1994	WWFF	food_fat	4	257727	1337590242	1	0.0600000000000023	0.00375000000000014	11273	1
4	Food 2	Intake 4	33	259770	1337592285	/users/cn/jespinosa/phecomp/data/CRG/20120502_FDF_CRG/20120502_FDF_CRG/20120518_FDF_CRG_c12.mtb	7225	1737	WWFF	food_fat	4	259737	1337592252	1	0.540000000000003	0.0163636363636365	11274	1
4	Drink 2	Intake 2	17	261343	1337593858	/users/cn/jespinosa/phecomp/data/CRG/20120502_FDF_CRG/20120502_FDF_CRG/20120518_FDF_CRG_c12.mtb	1891	NA	WWFF	water	2	261326	1337593841	1	0.02	0.00117647058823529	11275	1
4	Food 2	Intake 4	70	261577	1337594092	/users/cn/jespinosa/phecomp/data/CRG/20120502_FDF_CRG/20120502_FDF_CRG/20120518_FDF_CRG_c12.mtb	7234	8003	WWFF	food_fat	4	261507	1337594022	1	0.560000000000002	0.00800000000000003	11276	1
4	Food 1	Intake 3	71	222	1337602166	/users/cn/jespinosa/phecomp/data/CRG/20120502_FDF_CRG/20120502_FDF_CRG/20120521_FDF_CRG_c12.mtb	6917	9	WWFF	food_fat	3	151	1337602095	1	0.64	0.00901408450704225	11277	1
4	Food 1	Intake 3	77	308	1337602252	/users/cn/jespinosa/phecomp/data/CRG/20120502_FDF_CRG/20120502_FDF_CRG/20120521_FDF_CRG_c12.mtb	6918	COLL	WWFF	food_fat	3	231	1337602175	1	0.22	0.00285714285714286	11278	1
4	Food 2	Intake 4	20	276	1337602220	/users/cn/jespinosa/phecomp/data/CRG/20120502_FDF_CRG/20120502_FDF_CRG/20120521_FDF_CRG_c12.mtb	8894	20	WWFF	food_fat	4	256	1337602200	1	0.14	0.007	11279	1
4	Food 2	Intake 4	25	321	1337602265	/users/cn/jespinosa/phecomp/data/CRG/20120502_FDF_CRG/20120502_FDF_CRG/20120521_FDF_CRG_c12.mtb	8895	COLL	WWFF	food_fat	4	296	1337602240	1	0.08	0.0032	11280	1
4	Food 1	Intake 3	39	351	1337602295	/users/cn/jespinosa/phecomp/data/CRG/20120502_FDF_CRG/20120502_FDF_CRG/20120521_FDF_CRG_c12.mtb	6919	COLL	WWFF	food_fat	3	312	1337602256	1	0.02	0.000512820512820513	11281	1
4	Food 2	Intake 4	35	376	1337602320	/users/cn/jespinosa/phecomp/data/CRG/20120502_FDF_CRG/20120502_FDF_CRG/20120521_FDF_CRG_c12.mtb	8896	10	WWFF	food_fat	4	341	1337602285	1	0.46	0.0131428571428571	11282	1
4	Food 2	Intake 4	39	425	1337602369	/users/cn/jespinosa/phecomp/data/CRG/20120502_FDF_CRG/20120502_FDF_CRG/20120521_FDF_CRG_c12.mtb	8897	COLL	WWFF	food_fat	4	386	1337602330	1	0.82	0.021025641025641	11283	1
4	Food 1	Intake 3	35	454	1337602398	/users/cn/jespinosa/phecomp/data/CRG/20120502_FDF_CRG/20120502_FDF_CRG/20120521_FDF_CRG_c12.mtb	6921	7	WWFF	food_fat	3	419	1337602363	1	0.2	0.00571428571428571	11284	1
4	Food 1	Intake 3	134	595	1337602539	/users/cn/jespinosa/phecomp/data/CRG/20120502_FDF_CRG/20120502_FDF_CRG/20120521_FDF_CRG_c12.mtb	6922	34	WWFF	food_fat	3	461	1337602405	1	1.24	0.00925373134328358	11285	1
4	Food 1	Intake 3	126	755	1337602699	/users/cn/jespinosa/phecomp/data/CRG/20120502_FDF_CRG/20120502_FDF_CRG/20120521_FDF_CRG_c12.mtb	6923	COLL	WWFF	food_fat	3	629	1337602573	1	0.0800000000000001	0.000634920634920636	11286	1
4	Food 2	Intake 4	18	708	1337602652	/users/cn/jespinosa/phecomp/data/CRG/20120502_FDF_CRG/20120502_FDF_CRG/20120521_FDF_CRG_c12.mtb	8901	85	WWFF	food_fat	4	690	1337602634	1	0.0600000000000001	0.00333333333333334	11287	1
4	Food 1	Intake 3	76	869	1337602813	/users/cn/jespinosa/phecomp/data/CRG/20120502_FDF_CRG/20120502_FDF_CRG/20120521_FDF_CRG_c12.mtb	6924	6	WWFF	food_fat	3	793	1337602737	1	0.38	0.005	11288	1
4	Food 1	Intake 3	34	909	1337602853	/users/cn/jespinosa/phecomp/data/CRG/20120502_FDF_CRG/20120502_FDF_CRG/20120521_FDF_CRG_c12.mtb	6925	COLL	WWFF	food_fat	3	875	1337602819	1	0.26	0.00764705882352941	11289	1
4	Food 2	Intake 4	56	955	1337602899	/users/cn/jespinosa/phecomp/data/CRG/20120502_FDF_CRG/20120502_FDF_CRG/20120521_FDF_CRG_c12.mtb	8904	COLL	WWFF	food_fat	4	899	1337602843	1	0.72	0.0128571428571429	11290	1
4	Food 1	Intake 3	91	1022	1337602966	/users/cn/jespinosa/phecomp/data/CRG/20120502_FDF_CRG/20120502_FDF_CRG/20120521_FDF_CRG_c12.mtb	6926	31	WWFF	food_fat	3	931	1337602875	1	0.46	0.00505494505494506	11291	1
4	Food 1	Intake 3	165	1218	1337603162	/users/cn/jespinosa/phecomp/data/CRG/20120502_FDF_CRG/20120502_FDF_CRG/20120521_FDF_CRG_c12.mtb	6927	COLL	WWFF	food_fat	3	1053	1337602997	1	1.16	0.00703030303030303	11292	1
4	Food 2	Intake 4	29	1239	1337603183	/users/cn/jespinosa/phecomp/data/CRG/20120502_FDF_CRG/20120502_FDF_CRG/20120521_FDF_CRG_c12.mtb	8905	COLL	WWFF	food_fat	4	1210	1337603154	1	0.36	0.0124137931034483	11293	1
4	Food 1	Intake 3	210	1440	1337603384	/users/cn/jespinosa/phecomp/data/CRG/20120502_FDF_CRG/20120502_FDF_CRG/20120521_FDF_CRG_c12.mtb	6928	COLL	WWFF	food_fat	3	1230	1337603174	1	1.06	0.00504761904761905	11294	1
4	Food 2	Intake 4	38	1455	1337603399	/users/cn/jespinosa/phecomp/data/CRG/20120502_FDF_CRG/20120502_FDF_CRG/20120521_FDF_CRG_c12.mtb	8906	57	WWFF	food_fat	4	1417	1337603361	1	0.02	0.000526315789473684	11295	1
4	Food 1	Intake 3	95	1607	1337603551	/users/cn/jespinosa/phecomp/data/CRG/20120502_FDF_CRG/20120502_FDF_CRG/20120521_FDF_CRG_c12.mtb	6930	12	WWFF	food_fat	3	1512	1337603456	1	1.88	0.0197894736842105	11296	1
4	Food 1	Intake 3	94	1713	1337603657	/users/cn/jespinosa/phecomp/data/CRG/20120502_FDF_CRG/20120502_FDF_CRG/20120521_FDF_CRG_c12.mtb	6931	COLL	WWFF	food_fat	3	1619	1337603563	1	0.140000000000001	0.00148936170212767	11297	1
4	Food 2	Intake 4	50	1702	1337603646	/users/cn/jespinosa/phecomp/data/CRG/20120502_FDF_CRG/20120502_FDF_CRG/20120521_FDF_CRG_c12.mtb	8907	94	WWFF	food_fat	4	1652	1337603596	1	0.6	0.012	11298	1
4	Food 1	Intake 3	226	2022	1337603966	/users/cn/jespinosa/phecomp/data/CRG/20120502_FDF_CRG/20120502_FDF_CRG/20120521_FDF_CRG_c12.mtb	6933	516	WWFF	food_fat	3	1796	1337603740	1	0.7	0.00309734513274336	11299	1
4	Drink 2	Intake 2	16	2248	1337604192	/users/cn/jespinosa/phecomp/data/CRG/20120502_FDF_CRG/20120502_FDF_CRG/20120521_FDF_CRG_c12.mtb	2078	NA	WWFF	water	2	2232	1337604176	1	0.04	0.0025	11300	1
4	Food 2	Intake 4	94	2632	1337604576	/users/cn/jespinosa/phecomp/data/CRG/20120502_FDF_CRG/20120502_FDF_CRG/20120521_FDF_CRG_c12.mtb	8912	208	WWFF	food_fat	4	2538	1337604482	1	0.879999999999999	0.00936170212765956	11301	1
4	Food 1	Intake 3	59	2899	1337604843	/users/cn/jespinosa/phecomp/data/CRG/20120502_FDF_CRG/20120502_FDF_CRG/20120521_FDF_CRG_c12.mtb	6940	COLL	WWFF	food_fat	3	2840	1337604784	1	0.119999999999999	0.00203389830508473	11302	1
4	Food 2	Intake 4	67	2933	1337604877	/users/cn/jespinosa/phecomp/data/CRG/20120502_FDF_CRG/20120502_FDF_CRG/20120521_FDF_CRG_c12.mtb	8913	COLL	WWFF	food_fat	4	2866	1337604810	1	0.12	0.0017910447761194	11303	1
4	Food 1	Intake 3	33	2947	1337604891	/users/cn/jespinosa/phecomp/data/CRG/20120502_FDF_CRG/20120502_FDF_CRG/20120521_FDF_CRG_c12.mtb	6941	1864	WWFF	food_fat	3	2914	1337604858	1	0.0399999999999991	0.00121212121212118	11304	1
4	Food 1	Intake 3	44	4855	1337606799	/users/cn/jespinosa/phecomp/data/CRG/20120502_FDF_CRG/20120502_FDF_CRG/20120521_FDF_CRG_c12.mtb	6943	5481	WWFF	food_fat	3	4811	1337606755	1	0.0400000000000009	0.00090909090909093	11305	1
4	Drink 2	Intake 2	43	6911	1337608855	/users/cn/jespinosa/phecomp/data/CRG/20120502_FDF_CRG/20120502_FDF_CRG/20120521_FDF_CRG_c12.mtb	2080	NA	WWFF	water	2	6868	1337608812	1	0.12	0.0027906976744186	11306	1
4	Drink 2	Intake 2	28	7766	1337609710	/users/cn/jespinosa/phecomp/data/CRG/20120502_FDF_CRG/20120502_FDF_CRG/20120521_FDF_CRG_c12.mtb	2081	NA	WWFF	water	2	7738	1337609682	1	0.12	0.00428571428571429	11307	1
4	Drink 2	Intake 2	24	9215	1337611159	/users/cn/jespinosa/phecomp/data/CRG/20120502_FDF_CRG/20120502_FDF_CRG/20120521_FDF_CRG_c12.mtb	2082	NA	WWFF	water	2	9191	1337611135	1	0.06	0.0025	11308	1
4	Food 1	Intake 3	14	10350	1337612294	/users/cn/jespinosa/phecomp/data/CRG/20120502_FDF_CRG/20120502_FDF_CRG/20120521_FDF_CRG_c12.mtb	6949	1697	WWFF	food_fat	3	10336	1337612280	1	0.0399999999999991	0.00285714285714279	11309	1
4	Drink 2	Intake 2	21	10362	1337612306	/users/cn/jespinosa/phecomp/data/CRG/20120502_FDF_CRG/20120502_FDF_CRG/20120521_FDF_CRG_c12.mtb	2083	NA	WWFF	water	2	10341	1337612285	1	0.12	0.00571428571428571	11310	1
4	Food 1	Intake 3	29	12076	1337614020	/users/cn/jespinosa/phecomp/data/CRG/20120502_FDF_CRG/20120502_FDF_CRG/20120521_FDF_CRG_c12.mtb	6953	1592	WWFF	food_fat	3	12047	1337613991	1	0.0600000000000005	0.0020689655172414	11311	1
4	Food 1	Intake 3	45	13713	1337615657	/users/cn/jespinosa/phecomp/data/CRG/20120502_FDF_CRG/20120502_FDF_CRG/20120521_FDF_CRG_c12.mtb	6956	41	WWFF	food_fat	3	13668	1337615612	1	0.279999999999999	0.0062222222222222	11312	1
4	Food 2	Intake 4	8	13762	1337615706	/users/cn/jespinosa/phecomp/data/CRG/20120502_FDF_CRG/20120502_FDF_CRG/20120521_FDF_CRG_c12.mtb	8914	3591	WWFF	food_fat	4	13754	1337615698	1	0.0200000000000005	0.00250000000000006	11313	1
4	Drink 2	Intake 2	22	14623	1337616567	/users/cn/jespinosa/phecomp/data/CRG/20120502_FDF_CRG/20120502_FDF_CRG/20120521_FDF_CRG_c12.mtb	2085	NA	WWFF	water	2	14601	1337616545	1	0.1	0.00454545454545455	11314	1
4	Food 1	Intake 3	13	17366	1337619310	/users/cn/jespinosa/phecomp/data/CRG/20120502_FDF_CRG/20120502_FDF_CRG/20120521_FDF_CRG_c12.mtb	6960	5173	WWFF	food_fat	3	17353	1337619297	1	0.0400000000000009	0.00307692307692315	11315	1
4	Drink 2	Intake 2	15	19142	1337621086	/users/cn/jespinosa/phecomp/data/CRG/20120502_FDF_CRG/20120502_FDF_CRG/20120521_FDF_CRG_c12.mtb	2086	NA	WWFF	water	2	19127	1337621071	1	0.0599999999999999	0.00399999999999999	11316	1
4	Drink 2	Intake 2	19	19791	1337621735	/users/cn/jespinosa/phecomp/data/CRG/20120502_FDF_CRG/20120502_FDF_CRG/20120521_FDF_CRG_c12.mtb	2087	NA	WWFF	water	2	19772	1337621716	1	0.04	0.00210526315789474	11317	1
4	Drink 2	Intake 2	20	21295	1337623239	/users/cn/jespinosa/phecomp/data/CRG/20120502_FDF_CRG/20120502_FDF_CRG/20120521_FDF_CRG_c12.mtb	2088	NA	WWFF	water	2	21275	1337623219	1	0.0599999999999999	0.00299999999999999	11318	1
4	Food 2	Intake 4	14	22553	1337624497	/users/cn/jespinosa/phecomp/data/CRG/20120502_FDF_CRG/20120502_FDF_CRG/20120521_FDF_CRG_c12.mtb	8915	12	WWFF	food_fat	4	22539	1337624483	1	0.04	0.00285714285714286	11319	1
4	Food 2	Intake 4	45	22610	1337624554	/users/cn/jespinosa/phecomp/data/CRG/20120502_FDF_CRG/20120502_FDF_CRG/20120521_FDF_CRG_c12.mtb	8916	6	WWFF	food_fat	4	22565	1337624509	1	0.14	0.00311111111111111	11320	1
4	Food 1	Intake 3	35	22651	1337624595	/users/cn/jespinosa/phecomp/data/CRG/20120502_FDF_CRG/20120502_FDF_CRG/20120521_FDF_CRG_c12.mtb	6969	COLL	WWFF	food_fat	3	22616	1337624560	1	0.0600000000000005	0.00171428571428573	11321	1
4	Food 2	Intake 4	150	22788	1337624732	/users/cn/jespinosa/phecomp/data/CRG/20120502_FDF_CRG/20120502_FDF_CRG/20120521_FDF_CRG_c12.mtb	8917	COLL	WWFF	food_fat	4	22638	1337624582	1	0.58	0.00386666666666667	11322	1
4	Food 1	Intake 3	348	23040	1337624984	/users/cn/jespinosa/phecomp/data/CRG/20120502_FDF_CRG/20120502_FDF_CRG/20120521_FDF_CRG_c12.mtb	6970	COLL	WWFF	food_fat	3	22692	1337624636	1	1.86	0.0053448275862069	11323	1
4	Food 2	Intake 4	30	22823	1337624767	/users/cn/jespinosa/phecomp/data/CRG/20120502_FDF_CRG/20120502_FDF_CRG/20120521_FDF_CRG_c12.mtb	8918	69	WWFF	food_fat	4	22793	1337624737	1	0.04	0.00133333333333333	11324	1
4	Food 2	Intake 4	38	22930	1337624874	/users/cn/jespinosa/phecomp/data/CRG/20120502_FDF_CRG/20120502_FDF_CRG/20120521_FDF_CRG_c12.mtb	8919	142	WWFF	food_fat	4	22892	1337624836	1	0.22	0.00578947368421053	11325	1
4	Food 2	Intake 4	160	23232	1337625176	/users/cn/jespinosa/phecomp/data/CRG/20120502_FDF_CRG/20120502_FDF_CRG/20120521_FDF_CRG_c12.mtb	8920	75	WWFF	food_fat	4	23072	1337625016	1	2.02	0.012625	11326	1
4	Food 2	Intake 4	124	23431	1337625375	/users/cn/jespinosa/phecomp/data/CRG/20120502_FDF_CRG/20120502_FDF_CRG/20120521_FDF_CRG_c12.mtb	8922	67	WWFF	food_fat	4	23307	1337625251	1	0.28	0.00225806451612903	11327	1
4	Food 1	Intake 3	517	24015	1337625959	/users/cn/jespinosa/phecomp/data/CRG/20120502_FDF_CRG/20120502_FDF_CRG/20120521_FDF_CRG_c12.mtb	6972	COLL	WWFF	food_fat	3	23498	1337625442	1	0.18	0.00034816247582205	11328	1
4	Food 2	Intake 4	12	23650	1337625594	/users/cn/jespinosa/phecomp/data/CRG/20120502_FDF_CRG/20120502_FDF_CRG/20120521_FDF_CRG_c12.mtb	8925	136	WWFF	food_fat	4	23638	1337625582	1	0.04	0.00333333333333333	11329	1
4	Food 2	Intake 4	218	24004	1337625948	/users/cn/jespinosa/phecomp/data/CRG/20120502_FDF_CRG/20120502_FDF_CRG/20120521_FDF_CRG_c12.mtb	8928	107	WWFF	food_fat	4	23786	1337625730	1	0.14	0.000642201834862385	11330	1
4	Food 1	Intake 3	309	24420	1337626364	/users/cn/jespinosa/phecomp/data/CRG/20120502_FDF_CRG/20120502_FDF_CRG/20120521_FDF_CRG_c12.mtb	6974	COLL	WWFF	food_fat	3	24111	1337626055	1	0.199999999999999	0.000647249190938508	11331	1
4	Food 2	Intake 4	104	24218	1337626162	/users/cn/jespinosa/phecomp/data/CRG/20120502_FDF_CRG/20120502_FDF_CRG/20120521_FDF_CRG_c12.mtb	8930	25	WWFF	food_fat	4	24114	1337626058	1	0.38	0.00365384615384615	11332	1
4	Food 2	Intake 4	102	24345	1337626289	/users/cn/jespinosa/phecomp/data/CRG/20120502_FDF_CRG/20120502_FDF_CRG/20120521_FDF_CRG_c12.mtb	8931	365	WWFF	food_fat	4	24243	1337626187	1	0.0599999999999996	0.000588235294117643	11333	1
4	Food 1	Intake 3	236	24946	1337626890	/users/cn/jespinosa/phecomp/data/CRG/20120502_FDF_CRG/20120502_FDF_CRG/20120521_FDF_CRG_c12.mtb	6975	COLL	WWFF	food_fat	3	24710	1337626654	1	0.0800000000000001	0.000338983050847458	11334	1
4	Food 2	Intake 4	28	24942	1337626886	/users/cn/jespinosa/phecomp/data/CRG/20120502_FDF_CRG/20120502_FDF_CRG/20120521_FDF_CRG_c12.mtb	8936	150	WWFF	food_fat	4	24914	1337626858	1	0.0200000000000005	0.000714285714285732	11335	1
4	Food 1	Intake 3	617	25709	1337627653	/users/cn/jespinosa/phecomp/data/CRG/20120502_FDF_CRG/20120502_FDF_CRG/20120521_FDF_CRG_c12.mtb	6978	COLL	WWFF	food_fat	3	25092	1337627036	1	0.340000000000002	0.000551053484602921	11336	1
4	Food 2	Intake 4	147	25241	1337627185	/users/cn/jespinosa/phecomp/data/CRG/20120502_FDF_CRG/20120502_FDF_CRG/20120521_FDF_CRG_c12.mtb	8939	140	WWFF	food_fat	4	25094	1337627038	1	0.0600000000000005	0.000408163265306126	11337	1
4	Food 2	Intake 4	323	25704	1337627648	/users/cn/jespinosa/phecomp/data/CRG/20120502_FDF_CRG/20120502_FDF_CRG/20120521_FDF_CRG_c12.mtb	8941	58	WWFF	food_fat	4	25381	1337627325	1	1.34	0.00414860681114551	11338	1
4	Food 2	Intake 4	90	25852	1337627796	/users/cn/jespinosa/phecomp/data/CRG/20120502_FDF_CRG/20120502_FDF_CRG/20120521_FDF_CRG_c12.mtb	8942	258	WWFF	food_fat	4	25762	1337627706	1	1.38	0.0153333333333333	11339	1
4	Food 1	Intake 3	15	26125	1337628069	/users/cn/jespinosa/phecomp/data/CRG/20120502_FDF_CRG/20120502_FDF_CRG/20120521_FDF_CRG_c12.mtb	6980	36	WWFF	food_fat	3	26110	1337628054	1	0.0600000000000005	0.00400000000000003	11340	1
4	Food 2	Intake 4	73	26234	1337628178	/users/cn/jespinosa/phecomp/data/CRG/20120502_FDF_CRG/20120502_FDF_CRG/20120521_FDF_CRG_c12.mtb	8943	13	WWFF	food_fat	4	26161	1337628105	1	0.0999999999999996	0.00136986301369862	11341	1
4	Drink 2	Intake 2	38	26270	1337628214	/users/cn/jespinosa/phecomp/data/CRG/20120502_FDF_CRG/20120502_FDF_CRG/20120521_FDF_CRG_c12.mtb	2094	NA	WWFF	water	2	26232	1337628176	1	0.04	0.00105263157894737	11342	1
4	Food 1	Intake 3	445	26692	1337628636	/users/cn/jespinosa/phecomp/data/CRG/20120502_FDF_CRG/20120502_FDF_CRG/20120521_FDF_CRG_c12.mtb	6982	COLL	WWFF	food_fat	3	26247	1337628191	1	0.0800000000000001	0.000179775280898877	11343	1
4	Food 2	Intake 4	245	26515	1337628459	/users/cn/jespinosa/phecomp/data/CRG/20120502_FDF_CRG/20120502_FDF_CRG/20120521_FDF_CRG_c12.mtb	8944	70	WWFF	food_fat	4	26270	1337628214	1	2.38	0.00971428571428571	11344	1
4	Food 2	Intake 4	102	26687	1337628631	/users/cn/jespinosa/phecomp/data/CRG/20120502_FDF_CRG/20120502_FDF_CRG/20120521_FDF_CRG_c12.mtb	8946	227	WWFF	food_fat	4	26585	1337628529	1	2.1	0.0205882352941176	11345	1
4	Food 2	Intake 4	81	26995	1337628939	/users/cn/jespinosa/phecomp/data/CRG/20120502_FDF_CRG/20120502_FDF_CRG/20120521_FDF_CRG_c12.mtb	8949	161	WWFF	food_fat	4	26914	1337628858	1	0.620000000000001	0.00765432098765433	11346	1
4	Food 1	Intake 3	240	27396	1337629340	/users/cn/jespinosa/phecomp/data/CRG/20120502_FDF_CRG/20120502_FDF_CRG/20120521_FDF_CRG_c12.mtb	6985	COLL	WWFF	food_fat	3	27156	1337629100	1	0.0800000000000001	0.000333333333333334	11347	1
4	Drink 2	Intake 2	18	27246	1337629190	/users/cn/jespinosa/phecomp/data/CRG/20120502_FDF_CRG/20120502_FDF_CRG/20120521_FDF_CRG_c12.mtb	2096	NA	WWFF	water	2	27228	1337629172	1	0.04	0.00222222222222222	11348	1
4	Food 2	Intake 4	54	27397	1337629341	/users/cn/jespinosa/phecomp/data/CRG/20120502_FDF_CRG/20120502_FDF_CRG/20120521_FDF_CRG_c12.mtb	8954	688	WWFF	food_fat	4	27343	1337629287	1	0.0600000000000005	0.00111111111111112	11349	1
4	Food 1	Intake 3	13	28098	1337630042	/users/cn/jespinosa/phecomp/data/CRG/20120502_FDF_CRG/20120502_FDF_CRG/20120521_FDF_CRG_c12.mtb	6989	962	WWFF	food_fat	3	28085	1337630029	1	0.0600000000000005	0.00461538461538465	11350	1
4	Drink 2	Intake 2	39	28129	1337630073	/users/cn/jespinosa/phecomp/data/CRG/20120502_FDF_CRG/20120502_FDF_CRG/20120521_FDF_CRG_c12.mtb	2097	NA	WWFF	water	2	28090	1337630034	1	0.0399999999999999	0.00102564102564102	11351	1
4	Food 1	Intake 3	26	29086	1337631030	/users/cn/jespinosa/phecomp/data/CRG/20120502_FDF_CRG/20120502_FDF_CRG/20120521_FDF_CRG_c12.mtb	6993	COLL	WWFF	food_fat	3	29060	1337631004	1	0.140000000000001	0.00538461538461542	11352	1
4	Food 2	Intake 4	10	29082	1337631026	/users/cn/jespinosa/phecomp/data/CRG/20120502_FDF_CRG/20120502_FDF_CRG/20120521_FDF_CRG_c12.mtb	8969	309	WWFF	food_fat	4	29072	1337631016	1	0.0400000000000009	0.00400000000000009	11353	1
4	Food 1	Intake 3	210	29601	1337631545	/users/cn/jespinosa/phecomp/data/CRG/20120502_FDF_CRG/20120502_FDF_CRG/20120521_FDF_CRG_c12.mtb	6995	COLL	WWFF	food_fat	3	29391	1337631335	1	0.56	0.00266666666666667	11354	1
4	Food 2	Intake 4	130	29573	1337631517	/users/cn/jespinosa/phecomp/data/CRG/20120502_FDF_CRG/20120502_FDF_CRG/20120521_FDF_CRG_c12.mtb	8973	167	WWFF	food_fat	4	29443	1337631387	1	0.0800000000000001	0.000615384615384616	11355	1
4	Food 1	Intake 3	94	29834	1337631778	/users/cn/jespinosa/phecomp/data/CRG/20120502_FDF_CRG/20120502_FDF_CRG/20120521_FDF_CRG_c12.mtb	6997	6	WWFF	food_fat	3	29740	1337631684	1	0.0400000000000009	0.000425531914893627	11356	1
4	Drink 2	Intake 2	15	29813	1337631757	/users/cn/jespinosa/phecomp/data/CRG/20120502_FDF_CRG/20120502_FDF_CRG/20120521_FDF_CRG_c12.mtb	2100	NA	WWFF	water	2	29798	1337631742	1	0.0600000000000001	0.00400000000000001	11357	1
4	Food 1	Intake 3	261	30101	1337632045	/users/cn/jespinosa/phecomp/data/CRG/20120502_FDF_CRG/20120502_FDF_CRG/20120521_FDF_CRG_c12.mtb	6998	COLL	WWFF	food_fat	3	29840	1337631784	1	0.48	0.00183908045977011	11358	1
4	Food 2	Intake 4	66	30124	1337632068	/users/cn/jespinosa/phecomp/data/CRG/20120502_FDF_CRG/20120502_FDF_CRG/20120521_FDF_CRG_c12.mtb	8977	577	WWFF	food_fat	4	30058	1337632002	1	0.0999999999999996	0.00151515151515151	11359	1
4	Drink 1	Intake 1	32	30528	1337632472	/users/cn/jespinosa/phecomp/data/CRG/20120502_FDF_CRG/20120502_FDF_CRG/20120521_FDF_CRG_c12.mtb	2322	NA	WWFF	water	1	30496	1337632440	1	0.08	0.0025	11360	1
4	Food 1	Intake 3	139	30840	1337632784	/users/cn/jespinosa/phecomp/data/CRG/20120502_FDF_CRG/20120502_FDF_CRG/20120521_FDF_CRG_c12.mtb	7005	COLL	WWFF	food_fat	3	30701	1337632645	1	0.4	0.00287769784172662	11361	1
4	Food 2	Intake 4	14	30717	1337632661	/users/cn/jespinosa/phecomp/data/CRG/20120502_FDF_CRG/20120502_FDF_CRG/20120521_FDF_CRG_c12.mtb	8982	8	WWFF	food_fat	4	30703	1337632647	1	0.0200000000000014	0.00142857142857153	11362	1
4	Food 2	Intake 4	73	30798	1337632742	/users/cn/jespinosa/phecomp/data/CRG/20120502_FDF_CRG/20120502_FDF_CRG/20120521_FDF_CRG_c12.mtb	8983	91	WWFF	food_fat	4	30725	1337632669	1	0.0799999999999983	0.00109589041095888	11363	1
4	Drink 2	Intake 2	15	30823	1337632767	/users/cn/jespinosa/phecomp/data/CRG/20120502_FDF_CRG/20120502_FDF_CRG/20120521_FDF_CRG_c12.mtb	2101	NA	WWFF	water	2	30808	1337632752	1	0.02	0.00133333333333333	11364	1
4	Food 1	Intake 3	721	31610	1337633554	/users/cn/jespinosa/phecomp/data/CRG/20120502_FDF_CRG/20120502_FDF_CRG/20120521_FDF_CRG_c12.mtb	7006	COLL	WWFF	food_fat	3	30889	1337632833	1	0.0800000000000001	0.000110957004160888	11365	1
4	Food 2	Intake 4	149	31162	1337633106	/users/cn/jespinosa/phecomp/data/CRG/20120502_FDF_CRG/20120502_FDF_CRG/20120521_FDF_CRG_c12.mtb	8988	1097	WWFF	food_fat	4	31013	1337632957	1	0.0800000000000018	0.000536912751677864	11366	1
4	Food 1	Intake 3	12	32271	1337634215	/users/cn/jespinosa/phecomp/data/CRG/20120502_FDF_CRG/20120502_FDF_CRG/20120521_FDF_CRG_c12.mtb	7011	530	WWFF	food_fat	3	32259	1337634203	1	0.0399999999999991	0.00333333333333326	11367	1
4	Drink 1	Intake 1	13	32421	1337634365	/users/cn/jespinosa/phecomp/data/CRG/20120502_FDF_CRG/20120502_FDF_CRG/20120521_FDF_CRG_c12.mtb	2324	NA	WWFF	water	1	32408	1337634352	1	0.08	0.00615384615384615	11368	1
4	Food 1	Intake 3	18	32819	1337634763	/users/cn/jespinosa/phecomp/data/CRG/20120502_FDF_CRG/20120502_FDF_CRG/20120521_FDF_CRG_c12.mtb	7018	173	WWFF	food_fat	3	32801	1337634745	1	0.139999999999999	0.00777777777777772	11369	1
4	Food 1	Intake 3	14	33006	1337634950	/users/cn/jespinosa/phecomp/data/CRG/20120502_FDF_CRG/20120502_FDF_CRG/20120521_FDF_CRG_c12.mtb	7020	107	WWFF	food_fat	3	32992	1337634936	1	0.0399999999999991	0.00285714285714279	11370	1
4	Food 1	Intake 3	13	33126	1337635070	/users/cn/jespinosa/phecomp/data/CRG/20120502_FDF_CRG/20120502_FDF_CRG/20120521_FDF_CRG_c12.mtb	7021	278	WWFF	food_fat	3	33113	1337635057	1	0.0200000000000014	0.00153846153846165	11371	1
4	Food 1	Intake 3	82	33486	1337635430	/users/cn/jespinosa/phecomp/data/CRG/20120502_FDF_CRG/20120502_FDF_CRG/20120521_FDF_CRG_c12.mtb	7024	243	WWFF	food_fat	3	33404	1337635348	1	0.0600000000000005	0.000731707317073177	11372	1
4	Food 1	Intake 3	15	33744	1337635688	/users/cn/jespinosa/phecomp/data/CRG/20120502_FDF_CRG/20120502_FDF_CRG/20120521_FDF_CRG_c12.mtb	7029	390	WWFF	food_fat	3	33729	1337635673	1	0.0200000000000014	0.00133333333333343	11373	1
4	Drink 1	Intake 1	21	34096	1337636040	/users/cn/jespinosa/phecomp/data/CRG/20120502_FDF_CRG/20120502_FDF_CRG/20120521_FDF_CRG_c12.mtb	2325	NA	WWFF	water	1	34075	1337636019	1	0.04	0.0019047619047619	11374	1
4	Food 1	Intake 3	132	34266	1337636210	/users/cn/jespinosa/phecomp/data/CRG/20120502_FDF_CRG/20120502_FDF_CRG/20120521_FDF_CRG_c12.mtb	7032	COLL	WWFF	food_fat	3	34134	1337636078	1	0.74	0.00560606060606061	11375	1
4	Food 2	Intake 4	52	34214	1337636158	/users/cn/jespinosa/phecomp/data/CRG/20120502_FDF_CRG/20120502_FDF_CRG/20120521_FDF_CRG_c12.mtb	8997	351	WWFF	food_fat	4	34162	1337636106	1	0.0599999999999987	0.00115384615384613	11376	1
4	Food 1	Intake 3	34	34599	1337636543	/users/cn/jespinosa/phecomp/data/CRG/20120502_FDF_CRG/20120502_FDF_CRG/20120521_FDF_CRG_c12.mtb	7034	COLL	WWFF	food_fat	3	34565	1337636509	1	0.0400000000000009	0.00117647058823532	11377	1
4	Food 2	Intake 4	13	34598	1337636542	/users/cn/jespinosa/phecomp/data/CRG/20120502_FDF_CRG/20120502_FDF_CRG/20120521_FDF_CRG_c12.mtb	8998	469	WWFF	food_fat	4	34585	1337636529	1	0.0399999999999991	0.00307692307692301	11378	1
4	Food 1	Intake 3	31	35098	1337637042	/users/cn/jespinosa/phecomp/data/CRG/20120502_FDF_CRG/20120502_FDF_CRG/20120521_FDF_CRG_c12.mtb	7039	67	WWFF	food_fat	3	35067	1337637011	1	0.0400000000000009	0.00129032258064519	11379	1
4	Food 1	Intake 3	17	35182	1337637126	/users/cn/jespinosa/phecomp/data/CRG/20120502_FDF_CRG/20120502_FDF_CRG/20120521_FDF_CRG_c12.mtb	7042	689	WWFF	food_fat	3	35165	1337637109	1	0.18	0.0105882352941176	11380	1
4	Drink 1	Intake 1	26	35243	1337637187	/users/cn/jespinosa/phecomp/data/CRG/20120502_FDF_CRG/20120502_FDF_CRG/20120521_FDF_CRG_c12.mtb	2326	NA	WWFF	water	1	35217	1337637161	1	0.06	0.00230769230769231	11381	1
4	Food 1	Intake 3	14	35885	1337637829	/users/cn/jespinosa/phecomp/data/CRG/20120502_FDF_CRG/20120502_FDF_CRG/20120521_FDF_CRG_c12.mtb	7048	1107	WWFF	food_fat	3	35871	1337637815	1	0.0200000000000014	0.00142857142857153	11382	1
4	Drink 1	Intake 1	12	36488	1337638432	/users/cn/jespinosa/phecomp/data/CRG/20120502_FDF_CRG/20120502_FDF_CRG/20120521_FDF_CRG_c12.mtb	2327	NA	WWFF	water	1	36476	1337638420	1	0.04	0.00333333333333333	11383	1
4	Food 1	Intake 3	336	37328	1337639272	/users/cn/jespinosa/phecomp/data/CRG/20120502_FDF_CRG/20120502_FDF_CRG/20120521_FDF_CRG_c12.mtb	7054	COLL	WWFF	food_fat	3	36992	1337638936	1	0.84	0.0025	11384	1
4	Food 2	Intake 4	77	37079	1337639023	/users/cn/jespinosa/phecomp/data/CRG/20120502_FDF_CRG/20120502_FDF_CRG/20120521_FDF_CRG_c12.mtb	9004	132	WWFF	food_fat	4	37002	1337638946	1	0.120000000000001	0.00155844155844157	11385	1
4	Food 2	Intake 4	118	37329	1337639273	/users/cn/jespinosa/phecomp/data/CRG/20120502_FDF_CRG/20120502_FDF_CRG/20120521_FDF_CRG_c12.mtb	9007	647	WWFF	food_fat	4	37211	1337639155	1	0.0799999999999983	0.000677966101694901	11386	1
4	Food 1	Intake 3	17	37993	1337639937	/users/cn/jespinosa/phecomp/data/CRG/20120502_FDF_CRG/20120502_FDF_CRG/20120521_FDF_CRG_c12.mtb	7060	10	WWFF	food_fat	3	37976	1337639920	1	0.180000000000001	0.0105882352941177	11387	1
4	Food 1	Intake 3	43	38046	1337639990	/users/cn/jespinosa/phecomp/data/CRG/20120502_FDF_CRG/20120502_FDF_CRG/20120521_FDF_CRG_c12.mtb	7061	105	WWFF	food_fat	3	38003	1337639947	1	0.0599999999999987	0.00139534883720927	11388	1
4	Food 1	Intake 3	603	38754	1337640698	/users/cn/jespinosa/phecomp/data/CRG/20120502_FDF_CRG/20120502_FDF_CRG/20120521_FDF_CRG_c12.mtb	7063	COLL	WWFF	food_fat	3	38151	1337640095	1	0.26	0.000431177446102819	11389	1
4	Food 2	Intake 4	62	38513	1337640457	/users/cn/jespinosa/phecomp/data/CRG/20120502_FDF_CRG/20120502_FDF_CRG/20120521_FDF_CRG_c12.mtb	9018	115	WWFF	food_fat	4	38451	1337640395	1	0.0200000000000014	0.000322580645161313	11390	1
4	Food 2	Intake 4	113	38741	1337640685	/users/cn/jespinosa/phecomp/data/CRG/20120502_FDF_CRG/20120502_FDF_CRG/20120521_FDF_CRG_c12.mtb	9021	64	WWFF	food_fat	4	38628	1337640572	1	0.0599999999999987	0.000530973451327422	11391	1
4	Food 2	Intake 4	86	38891	1337640835	/users/cn/jespinosa/phecomp/data/CRG/20120502_FDF_CRG/20120502_FDF_CRG/20120521_FDF_CRG_c12.mtb	9022	COLL	WWFF	food_fat	4	38805	1337640749	1	0.100000000000001	0.00116279069767443	11392	1
4	Food 1	Intake 3	224	39030	1337640974	/users/cn/jespinosa/phecomp/data/CRG/20120502_FDF_CRG/20120502_FDF_CRG/20120521_FDF_CRG_c12.mtb	7064	249	WWFF	food_fat	3	38806	1337640750	1	0.16	0.000714285714285714	11393	1
4	Food 1	Intake 3	70	39349	1337641293	/users/cn/jespinosa/phecomp/data/CRG/20120502_FDF_CRG/20120502_FDF_CRG/20120521_FDF_CRG_c12.mtb	7066	11	WWFF	food_fat	3	39279	1337641223	1	0.0200000000000014	0.000285714285714306	11394	1
4	Food 1	Intake 3	216	39576	1337641520	/users/cn/jespinosa/phecomp/data/CRG/20120502_FDF_CRG/20120502_FDF_CRG/20120521_FDF_CRG_c12.mtb	7067	COLL	WWFF	food_fat	3	39360	1337641304	1	0.0399999999999991	0.000185185185185181	11395	1
4	Food 2	Intake 4	22	39501	1337641445	/users/cn/jespinosa/phecomp/data/CRG/20120502_FDF_CRG/20120502_FDF_CRG/20120521_FDF_CRG_c12.mtb	9031	964	WWFF	food_fat	4	39479	1337641423	1	0.0600000000000005	0.00272727272727275	11396	1
4	Drink 1	Intake 1	13	39509	1337641453	/users/cn/jespinosa/phecomp/data/CRG/20120502_FDF_CRG/20120502_FDF_CRG/20120521_FDF_CRG_c12.mtb	2330	NA	WWFF	water	1	39496	1337641440	1	0.06	0.00461538461538461	11397	1
4	Drink 2	Intake 2	20	39577	1337641521	/users/cn/jespinosa/phecomp/data/CRG/20120502_FDF_CRG/20120502_FDF_CRG/20120521_FDF_CRG_c12.mtb	2106	NA	WWFF	water	2	39557	1337641501	1	0.0399999999999999	0.00199999999999999	11398	1
4	Food 2	Intake 4	14	40479	1337642423	/users/cn/jespinosa/phecomp/data/CRG/20120502_FDF_CRG/20120502_FDF_CRG/20120521_FDF_CRG_c12.mtb	9037	303	WWFF	food_fat	4	40465	1337642409	1	0.0399999999999991	0.00285714285714279	11399	1
4	Drink 1	Intake 1	75	40616	1337642560	/users/cn/jespinosa/phecomp/data/CRG/20120502_FDF_CRG/20120502_FDF_CRG/20120521_FDF_CRG_c12.mtb	2331	NA	WWFF	water	1	40541	1337642485	1	0.06	0.0008	11400	1
4	Drink 1	Intake 1	27	40658	1337642602	/users/cn/jespinosa/phecomp/data/CRG/20120502_FDF_CRG/20120502_FDF_CRG/20120521_FDF_CRG_c12.mtb	2332	NA	WWFF	water	1	40631	1337642575	1	0.04	0.00148148148148148	11401	1
4	Food 2	Intake 4	14	40796	1337642740	/users/cn/jespinosa/phecomp/data/CRG/20120502_FDF_CRG/20120502_FDF_CRG/20120521_FDF_CRG_c12.mtb	9043	388	WWFF	food_fat	4	40782	1337642726	1	0.0599999999999987	0.00428571428571419	11402	1
4	Food 1	Intake 3	1184	42368	1337644312	/users/cn/jespinosa/phecomp/data/CRG/20120502_FDF_CRG/20120502_FDF_CRG/20120521_FDF_CRG_c12.mtb	7075	COLL	WWFF	food_fat	3	41184	1337643128	1	0.34	0.000287162162162162	11403	1
4	Food 2	Intake 4	18	42147	1337644091	/users/cn/jespinosa/phecomp/data/CRG/20120502_FDF_CRG/20120502_FDF_CRG/20120521_FDF_CRG_c12.mtb	9050	159	WWFF	food_fat	4	42129	1337644073	1	0.0399999999999991	0.00222222222222217	11404	1
4	Food 2	Intake 4	61	42367	1337644311	/users/cn/jespinosa/phecomp/data/CRG/20120502_FDF_CRG/20120502_FDF_CRG/20120521_FDF_CRG_c12.mtb	9052	551	WWFF	food_fat	4	42306	1337644250	1	0.0200000000000014	0.000327868852459039	11405	1
4	Food 2	Intake 4	200	43118	1337645062	/users/cn/jespinosa/phecomp/data/CRG/20120502_FDF_CRG/20120502_FDF_CRG/20120521_FDF_CRG_c12.mtb	9057	331	WWFF	food_fat	4	42918	1337644862	1	0.0399999999999991	0.000199999999999995	11406	1
4	Drink 2	Intake 2	47	43106	1337645050	/users/cn/jespinosa/phecomp/data/CRG/20120502_FDF_CRG/20120502_FDF_CRG/20120521_FDF_CRG_c12.mtb	2107	NA	WWFF	water	2	43059	1337645003	1	0.02	0.000425531914893617	11407	1
4	Food 1	Intake 3	142	43591	1337645535	/users/cn/jespinosa/phecomp/data/CRG/20120502_FDF_CRG/20120502_FDF_CRG/20120521_FDF_CRG_c12.mtb	7083	7	WWFF	food_fat	3	43449	1337645393	1	0.18	0.00126760563380282	11408	1
4	Food 1	Intake 3	128	43726	1337645670	/users/cn/jespinosa/phecomp/data/CRG/20120502_FDF_CRG/20120502_FDF_CRG/20120521_FDF_CRG_c12.mtb	7084	367	WWFF	food_fat	3	43598	1337645542	1	0.0400000000000009	0.000312500000000007	11409	1
4	Food 1	Intake 3	12	44105	1337646049	/users/cn/jespinosa/phecomp/data/CRG/20120502_FDF_CRG/20120502_FDF_CRG/20120521_FDF_CRG_c12.mtb	7090	690	WWFF	food_fat	3	44093	1337646037	1	0.0400000000000009	0.00333333333333341	11410	1
4	Food 1	Intake 3	10	44805	1337646749	/users/cn/jespinosa/phecomp/data/CRG/20120502_FDF_CRG/20120502_FDF_CRG/20120521_FDF_CRG_c12.mtb	7092	212	WWFF	food_fat	3	44795	1337646739	1	0.0200000000000014	0.00200000000000014	11411	1
4	Food 1	Intake 3	87	45104	1337647048	/users/cn/jespinosa/phecomp/data/CRG/20120502_FDF_CRG/20120502_FDF_CRG/20120521_FDF_CRG_c12.mtb	7094	123	WWFF	food_fat	3	45017	1337646961	1	0.0399999999999991	0.000459770114942518	11412	1
4	Drink 1	Intake 1	19	45052	1337646996	/users/cn/jespinosa/phecomp/data/CRG/20120502_FDF_CRG/20120502_FDF_CRG/20120521_FDF_CRG_c12.mtb	2333	NA	WWFF	water	1	45033	1337646977	1	0.04	0.00210526315789474	11413	1
4	Food 1	Intake 3	27	45254	1337647198	/users/cn/jespinosa/phecomp/data/CRG/20120502_FDF_CRG/20120502_FDF_CRG/20120521_FDF_CRG_c12.mtb	7096	568	WWFF	food_fat	3	45227	1337647171	1	0.0400000000000009	0.00148148148148152	11414	1
4	Food 1	Intake 3	83	45905	1337647849	/users/cn/jespinosa/phecomp/data/CRG/20120502_FDF_CRG/20120502_FDF_CRG/20120521_FDF_CRG_c12.mtb	7099	413	WWFF	food_fat	3	45822	1337647766	1	0.199999999999999	0.00240963855421686	11415	1
4	Food 1	Intake 3	13	46331	1337648275	/users/cn/jespinosa/phecomp/data/CRG/20120502_FDF_CRG/20120502_FDF_CRG/20120521_FDF_CRG_c12.mtb	7102	442	WWFF	food_fat	3	46318	1337648262	1	0.0600000000000005	0.00461538461538465	11416	1
4	Food 1	Intake 3	681	47454	1337649398	/users/cn/jespinosa/phecomp/data/CRG/20120502_FDF_CRG/20120502_FDF_CRG/20120521_FDF_CRG_c12.mtb	7105	COLL	WWFF	food_fat	3	46773	1337648717	1	0.0800000000000001	0.000117474302496329	11417	1
4	Food 2	Intake 4	16	47028	1337648972	/users/cn/jespinosa/phecomp/data/CRG/20120502_FDF_CRG/20120502_FDF_CRG/20120521_FDF_CRG_c12.mtb	9064	54	WWFF	food_fat	4	47012	1337648956	1	0.0599999999999987	0.00374999999999992	11418	1
4	Food 2	Intake 4	42	47124	1337649068	/users/cn/jespinosa/phecomp/data/CRG/20120502_FDF_CRG/20120502_FDF_CRG/20120521_FDF_CRG_c12.mtb	9066	479	WWFF	food_fat	4	47082	1337649026	1	0.0800000000000001	0.00190476190476191	11419	1
4	Drink 1	Intake 1	26	47144	1337649088	/users/cn/jespinosa/phecomp/data/CRG/20120502_FDF_CRG/20120502_FDF_CRG/20120521_FDF_CRG_c12.mtb	2334	NA	WWFF	water	1	47118	1337649062	1	0.0600000000000001	0.00230769230769231	11420	1
4	Drink 1	Intake 1	17	47432	1337649376	/users/cn/jespinosa/phecomp/data/CRG/20120502_FDF_CRG/20120502_FDF_CRG/20120521_FDF_CRG_c12.mtb	2335	NA	WWFF	water	1	47415	1337649359	1	0.0599999999999999	0.00352941176470588	11421	1
4	Food 1	Intake 3	16	47619	1337649563	/users/cn/jespinosa/phecomp/data/CRG/20120502_FDF_CRG/20120502_FDF_CRG/20120521_FDF_CRG_c12.mtb	7107	304	WWFF	food_fat	3	47603	1337649547	1	0.0200000000000014	0.00125000000000009	11422	1
4	Food 1	Intake 3	21	47944	1337649888	/users/cn/jespinosa/phecomp/data/CRG/20120502_FDF_CRG/20120502_FDF_CRG/20120521_FDF_CRG_c12.mtb	7110	173	WWFF	food_fat	3	47923	1337649867	1	0.0599999999999987	0.0028571428571428	11423	1
4	Food 1	Intake 3	44	48161	1337650105	/users/cn/jespinosa/phecomp/data/CRG/20120502_FDF_CRG/20120502_FDF_CRG/20120521_FDF_CRG_c12.mtb	7112	96	WWFF	food_fat	3	48117	1337650061	1	0.0599999999999987	0.00136363636363633	11424	1
4	Food 1	Intake 3	14	48271	1337650215	/users/cn/jespinosa/phecomp/data/CRG/20120502_FDF_CRG/20120502_FDF_CRG/20120521_FDF_CRG_c12.mtb	7113	401	WWFF	food_fat	3	48257	1337650201	1	0.0400000000000009	0.00285714285714292	11425	1
4	Food 1	Intake 3	17	48689	1337650633	/users/cn/jespinosa/phecomp/data/CRG/20120502_FDF_CRG/20120502_FDF_CRG/20120521_FDF_CRG_c12.mtb	7118	790	WWFF	food_fat	3	48672	1337650616	1	0.100000000000001	0.00588235294117653	11426	1
4	Drink 1	Intake 1	20	48762	1337650706	/users/cn/jespinosa/phecomp/data/CRG/20120502_FDF_CRG/20120502_FDF_CRG/20120521_FDF_CRG_c12.mtb	2336	NA	WWFF	water	1	48742	1337650686	1	0.08	0.004	11427	1
4	Food 1	Intake 3	49	49528	1337651472	/users/cn/jespinosa/phecomp/data/CRG/20120502_FDF_CRG/20120502_FDF_CRG/20120521_FDF_CRG_c12.mtb	7124	257	WWFF	food_fat	3	49479	1337651423	1	0.0999999999999996	0.0020408163265306	11428	1
4	Food 1	Intake 3	21	49806	1337651750	/users/cn/jespinosa/phecomp/data/CRG/20120502_FDF_CRG/20120502_FDF_CRG/20120521_FDF_CRG_c12.mtb	7128	161	WWFF	food_fat	3	49785	1337651729	1	0.0399999999999991	0.00190476190476186	11429	1
4	Food 2	Intake 4	20	49987	1337651931	/users/cn/jespinosa/phecomp/data/CRG/20120502_FDF_CRG/20120502_FDF_CRG/20120521_FDF_CRG_c12.mtb	9074	160	WWFF	food_fat	4	49967	1337651911	1	0.100000000000001	0.00500000000000005	11430	1
4	Food 1	Intake 3	13	50160	1337652104	/users/cn/jespinosa/phecomp/data/CRG/20120502_FDF_CRG/20120502_FDF_CRG/20120521_FDF_CRG_c12.mtb	7134	152	WWFF	food_fat	3	50147	1337652091	1	0.0599999999999987	0.00461538461538452	11431	1
4	Food 1	Intake 3	15	50327	1337652271	/users/cn/jespinosa/phecomp/data/CRG/20120502_FDF_CRG/20120502_FDF_CRG/20120521_FDF_CRG_c12.mtb	7136	252	WWFF	food_fat	3	50312	1337652256	1	0.0399999999999991	0.00266666666666661	11432	1
4	Drink 1	Intake 1	22	50390	1337652334	/users/cn/jespinosa/phecomp/data/CRG/20120502_FDF_CRG/20120502_FDF_CRG/20120521_FDF_CRG_c12.mtb	2337	NA	WWFF	water	1	50368	1337652312	1	0.04	0.00181818181818182	11433	1
4	Food 1	Intake 3	22	50601	1337652545	/users/cn/jespinosa/phecomp/data/CRG/20120502_FDF_CRG/20120502_FDF_CRG/20120521_FDF_CRG_c12.mtb	7141	92	WWFF	food_fat	3	50579	1337652523	1	0.0200000000000014	0.000909090909090973	11434	1
4	Food 1	Intake 3	14	50707	1337652651	/users/cn/jespinosa/phecomp/data/CRG/20120502_FDF_CRG/20120502_FDF_CRG/20120521_FDF_CRG_c12.mtb	7144	67	WWFF	food_fat	3	50693	1337652637	1	0.140000000000001	0.0100000000000001	11435	1
4	Food 1	Intake 3	24	50798	1337652742	/users/cn/jespinosa/phecomp/data/CRG/20120502_FDF_CRG/20120502_FDF_CRG/20120521_FDF_CRG_c12.mtb	7147	69	WWFF	food_fat	3	50774	1337652718	1	0.120000000000001	0.00500000000000004	11436	1
4	Food 1	Intake 3	39	50906	1337652850	/users/cn/jespinosa/phecomp/data/CRG/20120502_FDF_CRG/20120502_FDF_CRG/20120521_FDF_CRG_c12.mtb	7148	56	WWFF	food_fat	3	50867	1337652811	1	0.0399999999999991	0.001025641025641	11437	1
4	Food 1	Intake 3	21	50983	1337652927	/users/cn/jespinosa/phecomp/data/CRG/20120502_FDF_CRG/20120502_FDF_CRG/20120521_FDF_CRG_c12.mtb	7149	119	WWFF	food_fat	3	50962	1337652906	1	0.0600000000000005	0.00285714285714288	11438	1
4	Food 1	Intake 3	15	51117	1337653061	/users/cn/jespinosa/phecomp/data/CRG/20120502_FDF_CRG/20120502_FDF_CRG/20120521_FDF_CRG_c12.mtb	7150	305	WWFF	food_fat	3	51102	1337653046	1	0.0999999999999996	0.00666666666666664	11439	1
4	Food 1	Intake 3	232	51654	1337653598	/users/cn/jespinosa/phecomp/data/CRG/20120502_FDF_CRG/20120502_FDF_CRG/20120521_FDF_CRG_c12.mtb	7152	17	WWFF	food_fat	3	51422	1337653366	1	0.220000000000001	0.00094827586206897	11440	1
4	Food 1	Intake 3	467	52138	1337654082	/users/cn/jespinosa/phecomp/data/CRG/20120502_FDF_CRG/20120502_FDF_CRG/20120521_FDF_CRG_c12.mtb	7153	COLL	WWFF	food_fat	3	51671	1337653615	1	0.24	0.000513918629550321	11441	1
4	Food 2	Intake 4	34	51707	1337653651	/users/cn/jespinosa/phecomp/data/CRG/20120502_FDF_CRG/20120502_FDF_CRG/20120521_FDF_CRG_c12.mtb	9077	111	WWFF	food_fat	4	51673	1337653617	1	0.0999999999999996	0.00294117647058822	11442	1
4	Food 2	Intake 4	56	51874	1337653818	/users/cn/jespinosa/phecomp/data/CRG/20120502_FDF_CRG/20120502_FDF_CRG/20120521_FDF_CRG_c12.mtb	9079	61	WWFF	food_fat	4	51818	1337653762	1	0.0400000000000009	0.00071428571428573	11443	1
4	Drink 1	Intake 1	15	51878	1337653822	/users/cn/jespinosa/phecomp/data/CRG/20120502_FDF_CRG/20120502_FDF_CRG/20120521_FDF_CRG_c12.mtb	2338	NA	WWFF	water	1	51863	1337653807	1	0.0600000000000001	0.00400000000000001	11444	1
4	Food 2	Intake 4	41	51976	1337653920	/users/cn/jespinosa/phecomp/data/CRG/20120502_FDF_CRG/20120502_FDF_CRG/20120521_FDF_CRG_c12.mtb	9081	174	WWFF	food_fat	4	51935	1337653879	1	0.0200000000000014	0.000487804878048815	11445	1
4	Food 1	Intake 3	13	52163	1337654107	/users/cn/jespinosa/phecomp/data/CRG/20120502_FDF_CRG/20120502_FDF_CRG/20120521_FDF_CRG_c12.mtb	7154	417	WWFF	food_fat	3	52150	1337654094	1	0.0600000000000005	0.00461538461538465	11446	1
4	Food 2	Intake 4	39	52619	1337654563	/users/cn/jespinosa/phecomp/data/CRG/20120502_FDF_CRG/20120502_FDF_CRG/20120521_FDF_CRG_c12.mtb	9088	645	WWFF	food_fat	4	52580	1337654524	1	0.0399999999999991	0.001025641025641	11447	1
4	Drink 1	Intake 1	16	52754	1337654698	/users/cn/jespinosa/phecomp/data/CRG/20120502_FDF_CRG/20120502_FDF_CRG/20120521_FDF_CRG_c12.mtb	2339	NA	WWFF	water	1	52738	1337654682	1	0.0399999999999999	0.00249999999999999	11448	1
4	Drink 1	Intake 1	18	53203	1337655147	/users/cn/jespinosa/phecomp/data/CRG/20120502_FDF_CRG/20120502_FDF_CRG/20120521_FDF_CRG_c12.mtb	2340	NA	WWFF	water	1	53185	1337655129	1	0.0800000000000001	0.00444444444444445	11449	1
4	Food 1	Intake 3	17	53281	1337655225	/users/cn/jespinosa/phecomp/data/CRG/20120502_FDF_CRG/20120502_FDF_CRG/20120521_FDF_CRG_c12.mtb	7162	65	WWFF	food_fat	3	53264	1337655208	1	0.140000000000001	0.00823529411764712	11450	1
4	Food 1	Intake 3	19	53365	1337655309	/users/cn/jespinosa/phecomp/data/CRG/20120502_FDF_CRG/20120502_FDF_CRG/20120521_FDF_CRG_c12.mtb	7163	1039	WWFF	food_fat	3	53346	1337655290	1	0.0800000000000001	0.00421052631578948	11451	1
4	Drink 1	Intake 1	20	54105	1337656049	/users/cn/jespinosa/phecomp/data/CRG/20120502_FDF_CRG/20120502_FDF_CRG/20120521_FDF_CRG_c12.mtb	2341	NA	WWFF	water	1	54085	1337656029	1	0.0599999999999999	0.00299999999999999	11452	1
4	Food 1	Intake 3	19	54423	1337656367	/users/cn/jespinosa/phecomp/data/CRG/20120502_FDF_CRG/20120502_FDF_CRG/20120521_FDF_CRG_c12.mtb	7170	264	WWFF	food_fat	3	54404	1337656348	1	0.0399999999999991	0.00210526315789469	11453	1
4	Food 1	Intake 3	39	54726	1337656670	/users/cn/jespinosa/phecomp/data/CRG/20120502_FDF_CRG/20120502_FDF_CRG/20120521_FDF_CRG_c12.mtb	7171	220	WWFF	food_fat	3	54687	1337656631	1	0.0600000000000005	0.00153846153846155	11454	1
4	Food 1	Intake 3	54	55000	1337656944	/users/cn/jespinosa/phecomp/data/CRG/20120502_FDF_CRG/20120502_FDF_CRG/20120521_FDF_CRG_c12.mtb	7173	271	WWFF	food_fat	3	54946	1337656890	1	0.120000000000001	0.00222222222222224	11455	1
4	Food 1	Intake 3	13	55284	1337657228	/users/cn/jespinosa/phecomp/data/CRG/20120502_FDF_CRG/20120502_FDF_CRG/20120521_FDF_CRG_c12.mtb	7175	287	WWFF	food_fat	3	55271	1337657215	1	0.119999999999999	0.00923076923076915	11456	1
4	Food 1	Intake 3	19	55590	1337657534	/users/cn/jespinosa/phecomp/data/CRG/20120502_FDF_CRG/20120502_FDF_CRG/20120521_FDF_CRG_c12.mtb	7176	390	WWFF	food_fat	3	55571	1337657515	1	0.0600000000000005	0.00315789473684213	11457	1
4	Drink 1	Intake 1	18	55851	1337657795	/users/cn/jespinosa/phecomp/data/CRG/20120502_FDF_CRG/20120502_FDF_CRG/20120521_FDF_CRG_c12.mtb	2342	NA	WWFF	water	1	55833	1337657777	1	0.04	0.00222222222222222	11458	1
4	Food 1	Intake 3	13	55993	1337657937	/users/cn/jespinosa/phecomp/data/CRG/20120502_FDF_CRG/20120502_FDF_CRG/20120521_FDF_CRG_c12.mtb	7179	83	WWFF	food_fat	3	55980	1337657924	1	0.0400000000000009	0.00307692307692315	11459	1
4	Food 1	Intake 3	14	56090	1337658034	/users/cn/jespinosa/phecomp/data/CRG/20120502_FDF_CRG/20120502_FDF_CRG/20120521_FDF_CRG_c12.mtb	7180	433	WWFF	food_fat	3	56076	1337658020	1	0.0399999999999991	0.00285714285714279	11460	1
4	Food 1	Intake 3	19	56542	1337658486	/users/cn/jespinosa/phecomp/data/CRG/20120502_FDF_CRG/20120502_FDF_CRG/20120521_FDF_CRG_c12.mtb	7182	578	WWFF	food_fat	3	56523	1337658467	1	0.0600000000000005	0.00315789473684213	11461	1
4	Food 1	Intake 3	182	57302	1337659246	/users/cn/jespinosa/phecomp/data/CRG/20120502_FDF_CRG/20120502_FDF_CRG/20120521_FDF_CRG_c12.mtb	7187	419	WWFF	food_fat	3	57120	1337659064	1	0.0399999999999991	0.000219780219780215	11462	1
4	Food 1	Intake 3	212	57933	1337659877	/users/cn/jespinosa/phecomp/data/CRG/20120502_FDF_CRG/20120502_FDF_CRG/20120521_FDF_CRG_c12.mtb	7189	522	WWFF	food_fat	3	57721	1337659665	1	0.120000000000001	0.000566037735849061	11463	1
4	Food 1	Intake 3	76	58531	1337660475	/users/cn/jespinosa/phecomp/data/CRG/20120502_FDF_CRG/20120502_FDF_CRG/20120521_FDF_CRG_c12.mtb	7193	421	WWFF	food_fat	3	58455	1337660399	1	0.120000000000001	0.00157894736842107	11464	1
4	Drink 1	Intake 1	25	58488	1337660432	/users/cn/jespinosa/phecomp/data/CRG/20120502_FDF_CRG/20120502_FDF_CRG/20120521_FDF_CRG_c12.mtb	2343	NA	WWFF	water	1	58463	1337660407	1	0.04	0.0016	11465	1
4	Food 1	Intake 3	15	58967	1337660911	/users/cn/jespinosa/phecomp/data/CRG/20120502_FDF_CRG/20120502_FDF_CRG/20120521_FDF_CRG_c12.mtb	7195	128	WWFF	food_fat	3	58952	1337660896	1	0.0399999999999991	0.00266666666666661	11466	1
4	Food 1	Intake 3	12	59107	1337661051	/users/cn/jespinosa/phecomp/data/CRG/20120502_FDF_CRG/20120502_FDF_CRG/20120521_FDF_CRG_c12.mtb	7196	255	WWFF	food_fat	3	59095	1337661039	1	0.0400000000000009	0.00333333333333341	11467	1
4	Food 1	Intake 3	18	59380	1337661324	/users/cn/jespinosa/phecomp/data/CRG/20120502_FDF_CRG/20120502_FDF_CRG/20120521_FDF_CRG_c12.mtb	7198	90	WWFF	food_fat	3	59362	1337661306	1	0.0600000000000005	0.00333333333333336	11468	1
4	Drink 1	Intake 1	15	59431	1337661375	/users/cn/jespinosa/phecomp/data/CRG/20120502_FDF_CRG/20120502_FDF_CRG/20120521_FDF_CRG_c12.mtb	2344	NA	WWFF	water	1	59416	1337661360	1	0.04	0.00266666666666667	11469	1
4	Food 1	Intake 3	251	59721	1337661665	/users/cn/jespinosa/phecomp/data/CRG/20120502_FDF_CRG/20120502_FDF_CRG/20120521_FDF_CRG_c12.mtb	7200	360	WWFF	food_fat	3	59470	1337661414	1	0.180000000000001	0.00071713147410359	11470	1
4	Food 1	Intake 3	118	60199	1337662143	/users/cn/jespinosa/phecomp/data/CRG/20120502_FDF_CRG/20120502_FDF_CRG/20120521_FDF_CRG_c12.mtb	7203	COLL	WWFF	food_fat	3	60081	1337662025	1	0.16	0.00135593220338983	11471	1
4	Food 2	Intake 4	11	60094	1337662038	/users/cn/jespinosa/phecomp/data/CRG/20120502_FDF_CRG/20120502_FDF_CRG/20120521_FDF_CRG_c12.mtb	9106	295	WWFF	food_fat	4	60083	1337662027	1	0.0200000000000014	0.00181818181818195	11472	1
4	Food 1	Intake 3	15	60404	1337662348	/users/cn/jespinosa/phecomp/data/CRG/20120502_FDF_CRG/20120502_FDF_CRG/20120521_FDF_CRG_c12.mtb	7204	331	WWFF	food_fat	3	60389	1337662333	1	0.0600000000000005	0.00400000000000003	11473	1
4	Food 2	Intake 4	99	60834	1337662778	/users/cn/jespinosa/phecomp/data/CRG/20120502_FDF_CRG/20120502_FDF_CRG/20120521_FDF_CRG_c12.mtb	9109	71	WWFF	food_fat	4	60735	1337662679	1	0.0399999999999991	0.000404040404040395	11474	1
4	Food 1	Intake 3	715	61620	1337663564	/users/cn/jespinosa/phecomp/data/CRG/20120502_FDF_CRG/20120502_FDF_CRG/20120521_FDF_CRG_c12.mtb	7206	COLL	WWFF	food_fat	3	60905	1337662849	1	0.74	0.00103496503496503	11475	1
4	Food 2	Intake 4	304	61226	1337663170	/users/cn/jespinosa/phecomp/data/CRG/20120502_FDF_CRG/20120502_FDF_CRG/20120521_FDF_CRG_c12.mtb	9111	21	WWFF	food_fat	4	60922	1337662866	1	0.18	0.000592105263157895	11476	1
4	Drink 2	Intake 2	55	61243	1337663187	/users/cn/jespinosa/phecomp/data/CRG/20120502_FDF_CRG/20120502_FDF_CRG/20120521_FDF_CRG_c12.mtb	2111	NA	WWFF	water	2	61188	1337663132	1	0.02	0.000363636363636364	11477	1
4	Food 2	Intake 4	243	61490	1337663434	/users/cn/jespinosa/phecomp/data/CRG/20120502_FDF_CRG/20120502_FDF_CRG/20120521_FDF_CRG_c12.mtb	9112	43	WWFF	food_fat	4	61247	1337663191	1	0.139999999999999	0.000576131687242794	11478	1
4	Food 2	Intake 4	59	61592	1337663536	/users/cn/jespinosa/phecomp/data/CRG/20120502_FDF_CRG/20120502_FDF_CRG/20120521_FDF_CRG_c12.mtb	9113	420	WWFF	food_fat	4	61533	1337663477	1	0.0200000000000031	0.00033898305084751	11479	1
4	Food 1	Intake 3	105	62117	1337664061	/users/cn/jespinosa/phecomp/data/CRG/20120502_FDF_CRG/20120502_FDF_CRG/20120521_FDF_CRG_c12.mtb	7209	COLL	WWFF	food_fat	3	62012	1337663956	1	0.140000000000001	0.00133333333333334	11480	1
4	Food 2	Intake 4	12	62116	1337664060	/users/cn/jespinosa/phecomp/data/CRG/20120502_FDF_CRG/20120502_FDF_CRG/20120521_FDF_CRG_c12.mtb	9121	305	WWFF	food_fat	4	62104	1337664048	1	0.0399999999999991	0.00333333333333326	11481	1
4	Drink 2	Intake 2	30	62138	1337664082	/users/cn/jespinosa/phecomp/data/CRG/20120502_FDF_CRG/20120502_FDF_CRG/20120521_FDF_CRG_c12.mtb	2114	NA	WWFF	water	2	62108	1337664052	1	0.1	0.00333333333333333	11482	1
4	Food 2	Intake 4	14	62435	1337664379	/users/cn/jespinosa/phecomp/data/CRG/20120502_FDF_CRG/20120502_FDF_CRG/20120521_FDF_CRG_c12.mtb	9127	91	WWFF	food_fat	4	62421	1337664365	1	0.0400000000000009	0.00285714285714292	11483	1
4	Food 2	Intake 4	21	62547	1337664491	/users/cn/jespinosa/phecomp/data/CRG/20120502_FDF_CRG/20120502_FDF_CRG/20120521_FDF_CRG_c12.mtb	9129	164	WWFF	food_fat	4	62526	1337664470	1	0.0399999999999991	0.00190476190476186	11484	1
4	Food 2	Intake 4	15	62726	1337664670	/users/cn/jespinosa/phecomp/data/CRG/20120502_FDF_CRG/20120502_FDF_CRG/20120521_FDF_CRG_c12.mtb	9132	730	WWFF	food_fat	4	62711	1337664655	1	0.0399999999999991	0.00266666666666661	11485	1
4	Food 2	Intake 4	194	63650	1337665594	/users/cn/jespinosa/phecomp/data/CRG/20120502_FDF_CRG/20120502_FDF_CRG/20120521_FDF_CRG_c12.mtb	9140	253	WWFF	food_fat	4	63456	1337665400	1	0.0399999999999991	0.000206185567010305	11486	1
4	Food 2	Intake 4	28	63931	1337665875	/users/cn/jespinosa/phecomp/data/CRG/20120502_FDF_CRG/20120502_FDF_CRG/20120521_FDF_CRG_c12.mtb	9143	9	WWFF	food_fat	4	63903	1337665847	1	0.0400000000000009	0.00142857142857146	11487	1
4	Food 2	Intake 4	22	63962	1337665906	/users/cn/jespinosa/phecomp/data/CRG/20120502_FDF_CRG/20120502_FDF_CRG/20120521_FDF_CRG_c12.mtb	9144	91	WWFF	food_fat	4	63940	1337665884	1	0.0999999999999996	0.00454545454545453	11488	1
4	Food 2	Intake 4	20	64073	1337666017	/users/cn/jespinosa/phecomp/data/CRG/20120502_FDF_CRG/20120502_FDF_CRG/20120521_FDF_CRG_c12.mtb	9146	1555	WWFF	food_fat	4	64053	1337665997	1	0.0799999999999983	0.00399999999999992	11489	1
4	Food 1	Intake 3	39	65667	1337667611	/users/cn/jespinosa/phecomp/data/CRG/20120502_FDF_CRG/20120502_FDF_CRG/20120521_FDF_CRG_c12.mtb	7221	99	WWFF	food_fat	3	65628	1337667572	1	0.0399999999999991	0.001025641025641	11490	1
4	Food 1	Intake 3	29	65795	1337667739	/users/cn/jespinosa/phecomp/data/CRG/20120502_FDF_CRG/20120502_FDF_CRG/20120521_FDF_CRG_c12.mtb	7222	241	WWFF	food_fat	3	65766	1337667710	1	0.0400000000000009	0.00137931034482762	11491	1
4	Food 1	Intake 3	18	66054	1337667998	/users/cn/jespinosa/phecomp/data/CRG/20120502_FDF_CRG/20120502_FDF_CRG/20120521_FDF_CRG_c12.mtb	7224	135	WWFF	food_fat	3	66036	1337667980	1	0.0200000000000014	0.00111111111111119	11492	1
4	Food 1	Intake 3	13	66202	1337668146	/users/cn/jespinosa/phecomp/data/CRG/20120502_FDF_CRG/20120502_FDF_CRG/20120521_FDF_CRG_c12.mtb	7226	117	WWFF	food_fat	3	66189	1337668133	1	0.0600000000000005	0.00461538461538465	11493	1
4	Food 1	Intake 3	15	66334	1337668278	/users/cn/jespinosa/phecomp/data/CRG/20120502_FDF_CRG/20120502_FDF_CRG/20120521_FDF_CRG_c12.mtb	7227	164	WWFF	food_fat	3	66319	1337668263	1	0.0800000000000001	0.00533333333333334	11494	1
4	Food 1	Intake 3	18	66516	1337668460	/users/cn/jespinosa/phecomp/data/CRG/20120502_FDF_CRG/20120502_FDF_CRG/20120521_FDF_CRG_c12.mtb	7230	425	WWFF	food_fat	3	66498	1337668442	1	0.0800000000000001	0.00444444444444445	11495	1
4	Food 1	Intake 3	19	66960	1337668904	/users/cn/jespinosa/phecomp/data/CRG/20120502_FDF_CRG/20120502_FDF_CRG/20120521_FDF_CRG_c12.mtb	7232	245	WWFF	food_fat	3	66941	1337668885	1	0.0999999999999996	0.00526315789473682	11496	1
4	Drink 1	Intake 1	24	67212	1337669156	/users/cn/jespinosa/phecomp/data/CRG/20120502_FDF_CRG/20120502_FDF_CRG/20120521_FDF_CRG_c12.mtb	2346	NA	WWFF	water	1	67188	1337669132	1	0.14	0.00583333333333333	11497	1
4	Food 1	Intake 3	215	67420	1337669364	/users/cn/jespinosa/phecomp/data/CRG/20120502_FDF_CRG/20120502_FDF_CRG/20120521_FDF_CRG_c12.mtb	7236	1107	WWFF	food_fat	3	67205	1337669149	1	0.140000000000001	0.000651162790697679	11498	1
4	Food 1	Intake 3	21	68548	1337670492	/users/cn/jespinosa/phecomp/data/CRG/20120502_FDF_CRG/20120502_FDF_CRG/20120521_FDF_CRG_c12.mtb	7244	151	WWFF	food_fat	3	68527	1337670471	1	0.120000000000001	0.00571428571428576	11499	1
4	Food 1	Intake 3	14	68713	1337670657	/users/cn/jespinosa/phecomp/data/CRG/20120502_FDF_CRG/20120502_FDF_CRG/20120521_FDF_CRG_c12.mtb	7247	422	WWFF	food_fat	3	68699	1337670643	1	0.0399999999999991	0.00285714285714279	11500	1
4	Food 1	Intake 3	28	69163	1337671107	/users/cn/jespinosa/phecomp/data/CRG/20120502_FDF_CRG/20120502_FDF_CRG/20120521_FDF_CRG_c12.mtb	7249	COLL	WWFF	food_fat	3	69135	1337671079	1	0.0200000000000014	0.000714285714285764	11501	1
4	Food 2	Intake 4	15	69160	1337671104	/users/cn/jespinosa/phecomp/data/CRG/20120502_FDF_CRG/20120502_FDF_CRG/20120521_FDF_CRG_c12.mtb	9155	864	WWFF	food_fat	4	69145	1337671089	1	0.0200000000000031	0.00133333333333354	11502	1
4	Food 1	Intake 3	62	70086	1337672030	/users/cn/jespinosa/phecomp/data/CRG/20120502_FDF_CRG/20120502_FDF_CRG/20120521_FDF_CRG_c12.mtb	7254	390	WWFF	food_fat	3	70024	1337671968	1	0.0200000000000014	0.000322580645161313	11503	1
4	Food 1	Intake 3	13	70489	1337672433	/users/cn/jespinosa/phecomp/data/CRG/20120502_FDF_CRG/20120502_FDF_CRG/20120521_FDF_CRG_c12.mtb	7258	368	WWFF	food_fat	3	70476	1337672420	1	0.0600000000000005	0.00461538461538465	11504	1
4	Food 1	Intake 3	18	70875	1337672819	/users/cn/jespinosa/phecomp/data/CRG/20120502_FDF_CRG/20120502_FDF_CRG/20120521_FDF_CRG_c12.mtb	7262	193	WWFF	food_fat	3	70857	1337672801	1	0.0399999999999991	0.00222222222222217	11505	1
4	Food 1	Intake 3	18	71086	1337673030	/users/cn/jespinosa/phecomp/data/CRG/20120502_FDF_CRG/20120502_FDF_CRG/20120521_FDF_CRG_c12.mtb	7263	162	WWFF	food_fat	3	71068	1337673012	1	0.0400000000000009	0.00222222222222227	11506	1
4	Food 1	Intake 3	13	71261	1337673205	/users/cn/jespinosa/phecomp/data/CRG/20120502_FDF_CRG/20120502_FDF_CRG/20120521_FDF_CRG_c12.mtb	7266	281	WWFF	food_fat	3	71248	1337673192	1	0.0400000000000009	0.00307692307692315	11507	1
4	Food 1	Intake 3	15	71557	1337673501	/users/cn/jespinosa/phecomp/data/CRG/20120502_FDF_CRG/20120502_FDF_CRG/20120521_FDF_CRG_c12.mtb	7268	101	WWFF	food_fat	3	71542	1337673486	1	0.0399999999999991	0.00266666666666661	11508	1
4	Food 1	Intake 3	14	71672	1337673616	/users/cn/jespinosa/phecomp/data/CRG/20120502_FDF_CRG/20120502_FDF_CRG/20120521_FDF_CRG_c12.mtb	7269	108	WWFF	food_fat	3	71658	1337673602	1	0.0600000000000005	0.00428571428571432	11509	1
4	Food 1	Intake 3	616	72396	1337674340	/users/cn/jespinosa/phecomp/data/CRG/20120502_FDF_CRG/20120502_FDF_CRG/20120521_FDF_CRG_c12.mtb	7271	COLL	WWFF	food_fat	3	71780	1337673724	1	0.699999999999999	0.00113636363636363	11510	1
4	Food 2	Intake 4	17	71802	1337673746	/users/cn/jespinosa/phecomp/data/CRG/20120502_FDF_CRG/20120502_FDF_CRG/20120521_FDF_CRG_c12.mtb	9157	608	WWFF	food_fat	4	71785	1337673729	1	0.239999999999998	0.0141176470588234	11511	1
4	Drink 1	Intake 1	30	72108	1337674052	/users/cn/jespinosa/phecomp/data/CRG/20120502_FDF_CRG/20120502_FDF_CRG/20120521_FDF_CRG_c12.mtb	2347	NA	WWFF	water	1	72078	1337674022	1	0.1	0.00333333333333333	11512	1
4	Food 1	Intake 3	480	72890	1337674834	/users/cn/jespinosa/phecomp/data/CRG/20120502_FDF_CRG/20120502_FDF_CRG/20120521_FDF_CRG_c12.mtb	7272	COLL	WWFF	food_fat	3	72410	1337674354	1	0.220000000000001	0.000458333333333335	11513	1
4	Food 2	Intake 4	52	72710	1337674654	/users/cn/jespinosa/phecomp/data/CRG/20120502_FDF_CRG/20120502_FDF_CRG/20120521_FDF_CRG_c12.mtb	9161	193	WWFF	food_fat	4	72658	1337674602	1	0.0200000000000031	0.000384615384615444	11514	1
4	Food 2	Intake 4	79	72982	1337674926	/users/cn/jespinosa/phecomp/data/CRG/20120502_FDF_CRG/20120502_FDF_CRG/20120521_FDF_CRG_c12.mtb	9163	880	WWFF	food_fat	4	72903	1337674847	1	0.100000000000001	0.00126582278481014	11515	1
4	Drink 1	Intake 1	16	73186	1337675130	/users/cn/jespinosa/phecomp/data/CRG/20120502_FDF_CRG/20120502_FDF_CRG/20120521_FDF_CRG_c12.mtb	2348	NA	WWFF	water	1	73170	1337675114	1	0.0399999999999998	0.00249999999999999	11516	1
4	Food 1	Intake 3	341	74203	1337676147	/users/cn/jespinosa/phecomp/data/CRG/20120502_FDF_CRG/20120502_FDF_CRG/20120521_FDF_CRG_c12.mtb	7275	COLL	WWFF	food_fat	3	73862	1337675806	1	0.44	0.00129032258064516	11517	1
4	Food 2	Intake 4	244	74107	1337676051	/users/cn/jespinosa/phecomp/data/CRG/20120502_FDF_CRG/20120502_FDF_CRG/20120521_FDF_CRG_c12.mtb	9171	110	WWFF	food_fat	4	73863	1337675807	1	0.16	0.000655737704918033	11518	1
4	Food 1	Intake 3	33	74250	1337676194	/users/cn/jespinosa/phecomp/data/CRG/20120502_FDF_CRG/20120502_FDF_CRG/20120521_FDF_CRG_c12.mtb	7276	633	WWFF	food_fat	3	74217	1337676161	1	0.0400000000000009	0.00121212121212124	11519	1
4	Food 1	Intake 3	13	74896	1337676840	/users/cn/jespinosa/phecomp/data/CRG/20120502_FDF_CRG/20120502_FDF_CRG/20120521_FDF_CRG_c12.mtb	7278	446	WWFF	food_fat	3	74883	1337676827	1	0.0400000000000009	0.00307692307692315	11520	1
4	Food 1	Intake 3	34	75376	1337677320	/users/cn/jespinosa/phecomp/data/CRG/20120502_FDF_CRG/20120502_FDF_CRG/20120521_FDF_CRG_c12.mtb	7281	303	WWFF	food_fat	3	75342	1337677286	1	0.0600000000000005	0.00176470588235296	11521	1
4	Food 1	Intake 3	13	75692	1337677636	/users/cn/jespinosa/phecomp/data/CRG/20120502_FDF_CRG/20120502_FDF_CRG/20120521_FDF_CRG_c12.mtb	7285	510	WWFF	food_fat	3	75679	1337677623	1	0.0800000000000001	0.00615384615384616	11522	1
4	Food 1	Intake 3	13	76215	1337678159	/users/cn/jespinosa/phecomp/data/CRG/20120502_FDF_CRG/20120502_FDF_CRG/20120521_FDF_CRG_c12.mtb	7291	144	WWFF	food_fat	3	76202	1337678146	1	0.0399999999999991	0.00307692307692301	11523	1
4	Food 1	Intake 3	28	76387	1337678331	/users/cn/jespinosa/phecomp/data/CRG/20120502_FDF_CRG/20120502_FDF_CRG/20120521_FDF_CRG_c12.mtb	7292	229	WWFF	food_fat	3	76359	1337678303	1	0.0800000000000001	0.00285714285714286	11524	1
4	Food 1	Intake 3	12	76628	1337678572	/users/cn/jespinosa/phecomp/data/CRG/20120502_FDF_CRG/20120502_FDF_CRG/20120521_FDF_CRG_c12.mtb	7295	259	WWFF	food_fat	3	76616	1337678560	1	0.0399999999999991	0.00333333333333326	11525	1
4	Food 1	Intake 3	20	76907	1337678851	/users/cn/jespinosa/phecomp/data/CRG/20120502_FDF_CRG/20120502_FDF_CRG/20120521_FDF_CRG_c12.mtb	7297	306	WWFF	food_fat	3	76887	1337678831	1	0.0600000000000005	0.00300000000000002	11526	1
4	Food 1	Intake 3	12	77225	1337679169	/users/cn/jespinosa/phecomp/data/CRG/20120502_FDF_CRG/20120502_FDF_CRG/20120521_FDF_CRG_c12.mtb	7298	102	WWFF	food_fat	3	77213	1337679157	1	0.0399999999999991	0.00333333333333326	11527	1
4	Food 1	Intake 3	10	77337	1337679281	/users/cn/jespinosa/phecomp/data/CRG/20120502_FDF_CRG/20120502_FDF_CRG/20120521_FDF_CRG_c12.mtb	7300	56	WWFF	food_fat	3	77327	1337679271	1	0.0200000000000014	0.00200000000000014	11528	1
4	Food 1	Intake 3	12	77405	1337679349	/users/cn/jespinosa/phecomp/data/CRG/20120502_FDF_CRG/20120502_FDF_CRG/20120521_FDF_CRG_c12.mtb	7301	1328	WWFF	food_fat	3	77393	1337679337	1	0.0599999999999987	0.00499999999999989	11529	1
4	Drink 1	Intake 1	20	78707	1337680651	/users/cn/jespinosa/phecomp/data/CRG/20120502_FDF_CRG/20120502_FDF_CRG/20120521_FDF_CRG_c12.mtb	2349	NA	WWFF	water	1	78687	1337680631	1	0.0800000000000001	0.00400000000000001	11530	1
4	Food 2	Intake 4	28	78761	1337680705	/users/cn/jespinosa/phecomp/data/CRG/20120502_FDF_CRG/20120502_FDF_CRG/20120521_FDF_CRG_c12.mtb	9178	459	WWFF	food_fat	4	78733	1337680677	1	0.220000000000001	0.00785714285714289	11531	1
4	Food 1	Intake 3	37	79257	1337681201	/users/cn/jespinosa/phecomp/data/CRG/20120502_FDF_CRG/20120502_FDF_CRG/20120521_FDF_CRG_c12.mtb	7309	1123	WWFF	food_fat	3	79220	1337681164	1	0.0400000000000009	0.00108108108108111	11532	1
4	Food 1	Intake 3	64	80444	1337682388	/users/cn/jespinosa/phecomp/data/CRG/20120502_FDF_CRG/20120502_FDF_CRG/20120521_FDF_CRG_c12.mtb	7318	350	WWFF	food_fat	3	80380	1337682324	1	0.0400000000000009	0.000625000000000014	11533	1
4	Drink 1	Intake 1	14	80410	1337682354	/users/cn/jespinosa/phecomp/data/CRG/20120502_FDF_CRG/20120502_FDF_CRG/20120521_FDF_CRG_c12.mtb	2350	NA	WWFF	water	1	80396	1337682340	1	0.0800000000000001	0.00571428571428572	11534	1
4	Food 1	Intake 3	14	80808	1337682752	/users/cn/jespinosa/phecomp/data/CRG/20120502_FDF_CRG/20120502_FDF_CRG/20120521_FDF_CRG_c12.mtb	7320	99	WWFF	food_fat	3	80794	1337682738	1	0.0999999999999996	0.00714285714285711	11535	1
4	Food 1	Intake 3	26	80933	1337682877	/users/cn/jespinosa/phecomp/data/CRG/20120502_FDF_CRG/20120502_FDF_CRG/20120521_FDF_CRG_c12.mtb	7321	498	WWFF	food_fat	3	80907	1337682851	1	0.18	0.00692307692307692	11536	1
4	Food 1	Intake 3	34	81465	1337683409	/users/cn/jespinosa/phecomp/data/CRG/20120502_FDF_CRG/20120502_FDF_CRG/20120521_FDF_CRG_c12.mtb	7323	1069	WWFF	food_fat	3	81431	1337683375	1	0.0400000000000009	0.00117647058823532	11537	1
4	Drink 1	Intake 1	16	82250	1337684194	/users/cn/jespinosa/phecomp/data/CRG/20120502_FDF_CRG/20120502_FDF_CRG/20120521_FDF_CRG_c12.mtb	2351	NA	WWFF	water	1	82234	1337684178	1	0.0800000000000001	0.00500000000000001	11538	1
4	Food 1	Intake 3	71	82605	1337684549	/users/cn/jespinosa/phecomp/data/CRG/20120502_FDF_CRG/20120502_FDF_CRG/20120521_FDF_CRG_c12.mtb	7327	562	WWFF	food_fat	3	82534	1337684478	1	0.0200000000000014	0.00028169014084509	11539	1
4	Food 1	Intake 3	89	83256	1337685200	/users/cn/jespinosa/phecomp/data/CRG/20120502_FDF_CRG/20120502_FDF_CRG/20120521_FDF_CRG_c12.mtb	7331	373	WWFF	food_fat	3	83167	1337685111	1	0.0399999999999991	0.000449438202247181	11540	1
4	Food 1	Intake 3	56	83685	1337685629	/users/cn/jespinosa/phecomp/data/CRG/20120502_FDF_CRG/20120502_FDF_CRG/20120521_FDF_CRG_c12.mtb	7336	358	WWFF	food_fat	3	83629	1337685573	1	0.0600000000000005	0.00107142857142858	11541	1
4	Drink 1	Intake 1	25	83664	1337685608	/users/cn/jespinosa/phecomp/data/CRG/20120502_FDF_CRG/20120502_FDF_CRG/20120521_FDF_CRG_c12.mtb	2352	NA	WWFF	water	1	83639	1337685583	1	0.0999999999999999	0.004	11542	1
4	Food 1	Intake 3	25	84068	1337686012	/users/cn/jespinosa/phecomp/data/CRG/20120502_FDF_CRG/20120502_FDF_CRG/20120521_FDF_CRG_c12.mtb	7341	181	WWFF	food_fat	3	84043	1337685987	1	0.0399999999999991	0.00159999999999996	11543	1
4	Food 1	Intake 3	17	84266	1337686210	/users/cn/jespinosa/phecomp/data/CRG/20120502_FDF_CRG/20120502_FDF_CRG/20120521_FDF_CRG_c12.mtb	7342	99	WWFF	food_fat	3	84249	1337686193	1	0.0200000000000014	0.00117647058823538	11544	1
4	Food 1	Intake 3	16	84381	1337686325	/users/cn/jespinosa/phecomp/data/CRG/20120502_FDF_CRG/20120502_FDF_CRG/20120521_FDF_CRG_c12.mtb	7343	606	WWFF	food_fat	3	84365	1337686309	1	0.0399999999999991	0.00249999999999994	11545	1
4	Food 1	Intake 3	20	85007	1337686951	/users/cn/jespinosa/phecomp/data/CRG/20120502_FDF_CRG/20120502_FDF_CRG/20120521_FDF_CRG_c12.mtb	7348	57	WWFF	food_fat	3	84987	1337686931	1	0.0400000000000009	0.00200000000000005	11546	1
4	Food 1	Intake 3	13	85077	1337687021	/users/cn/jespinosa/phecomp/data/CRG/20120502_FDF_CRG/20120502_FDF_CRG/20120521_FDF_CRG_c12.mtb	7349	762	WWFF	food_fat	3	85064	1337687008	1	0.0599999999999987	0.00461538461538452	11547	1
4	Food 1	Intake 3	15	85854	1337687798	/users/cn/jespinosa/phecomp/data/CRG/20120502_FDF_CRG/20120502_FDF_CRG/20120521_FDF_CRG_c12.mtb	7355	292	WWFF	food_fat	3	85839	1337687783	1	0.0399999999999991	0.00266666666666661	11548	1
4	Food 1	Intake 3	13	86159	1337688103	/users/cn/jespinosa/phecomp/data/CRG/20120502_FDF_CRG/20120502_FDF_CRG/20120521_FDF_CRG_c12.mtb	7357	702	WWFF	food_fat	3	86146	1337688090	1	0.0399999999999991	0.00307692307692301	11549	1
4	Food 1	Intake 3	14	86875	1337688819	/users/cn/jespinosa/phecomp/data/CRG/20120502_FDF_CRG/20120502_FDF_CRG/20120521_FDF_CRG_c12.mtb	7361	1279	WWFF	food_fat	3	86861	1337688805	1	0.0399999999999991	0.00285714285714279	11550	1
4	Drink 1	Intake 1	20	87043	1337688987	/users/cn/jespinosa/phecomp/data/CRG/20120502_FDF_CRG/20120502_FDF_CRG/20120521_FDF_CRG_c12.mtb	2353	NA	WWFF	water	1	87023	1337688967	1	0.04	0.002	11551	1
4	Food 1	Intake 3	18	88172	1337690116	/users/cn/jespinosa/phecomp/data/CRG/20120502_FDF_CRG/20120502_FDF_CRG/20120521_FDF_CRG_c12.mtb	7367	180	WWFF	food_fat	3	88154	1337690098	1	0.0600000000000005	0.00333333333333336	11552	1
4	Food 1	Intake 3	62	88414	1337690358	/users/cn/jespinosa/phecomp/data/CRG/20120502_FDF_CRG/20120502_FDF_CRG/20120521_FDF_CRG_c12.mtb	7368	1708	WWFF	food_fat	3	88352	1337690296	1	0.0600000000000005	0.000967741935483879	11553	1
4	Food 1	Intake 3	140	90262	1337692206	/users/cn/jespinosa/phecomp/data/CRG/20120502_FDF_CRG/20120502_FDF_CRG/20120521_FDF_CRG_c12.mtb	7378	632	WWFF	food_fat	3	90122	1337692066	1	0.0400000000000009	0.000285714285714292	11554	1
4	Food 2	Intake 4	89	90983	1337692927	/users/cn/jespinosa/phecomp/data/CRG/20120502_FDF_CRG/20120502_FDF_CRG/20120521_FDF_CRG_c12.mtb	9190	65	WWFF	food_fat	4	90894	1337692838	1	0.140000000000001	0.00157303370786518	11555	1
4	Food 2	Intake 4	101	91149	1337693093	/users/cn/jespinosa/phecomp/data/CRG/20120502_FDF_CRG/20120502_FDF_CRG/20120521_FDF_CRG_c12.mtb	9192	103	WWFF	food_fat	4	91048	1337692992	1	0.0399999999999991	0.000396039603960387	11556	1
4	Drink 1	Intake 1	13	91155	1337693099	/users/cn/jespinosa/phecomp/data/CRG/20120502_FDF_CRG/20120502_FDF_CRG/20120521_FDF_CRG_c12.mtb	2354	NA	WWFF	water	1	91142	1337693086	1	0.0799999999999998	0.00615384615384614	11557	1
4	Food 2	Intake 4	49	91301	1337693245	/users/cn/jespinosa/phecomp/data/CRG/20120502_FDF_CRG/20120502_FDF_CRG/20120521_FDF_CRG_c12.mtb	9195	411	WWFF	food_fat	4	91252	1337693196	1	0.0399999999999991	0.000816326530612226	11558	1
4	Drink 2	Intake 2	14	91270	1337693214	/users/cn/jespinosa/phecomp/data/CRG/20120502_FDF_CRG/20120502_FDF_CRG/20120521_FDF_CRG_c12.mtb	2119	NA	WWFF	water	2	91256	1337693200	1	0.02	0.00142857142857143	11559	1
4	Food 1	Intake 3	1750	93462	1337695406	/users/cn/jespinosa/phecomp/data/CRG/20120502_FDF_CRG/20120502_FDF_CRG/20120521_FDF_CRG_c12.mtb	7382	COLL	WWFF	food_fat	3	91712	1337693656	1	0.68	0.000388571428571429	11560	1
4	Food 2	Intake 4	43	91760	1337693704	/users/cn/jespinosa/phecomp/data/CRG/20120502_FDF_CRG/20120502_FDF_CRG/20120521_FDF_CRG_c12.mtb	9201	156	WWFF	food_fat	4	91717	1337693661	1	0.140000000000001	0.0032558139534884	11561	1
4	Drink 1	Intake 1	26	91785	1337693729	/users/cn/jespinosa/phecomp/data/CRG/20120502_FDF_CRG/20120502_FDF_CRG/20120521_FDF_CRG_c12.mtb	2355	NA	WWFF	water	1	91759	1337693703	1	0.0600000000000001	0.00230769230769231	11562	1
4	Food 2	Intake 4	25	91941	1337693885	/users/cn/jespinosa/phecomp/data/CRG/20120502_FDF_CRG/20120502_FDF_CRG/20120521_FDF_CRG_c12.mtb	9203	202	WWFF	food_fat	4	91916	1337693860	1	0.0400000000000027	0.00160000000000011	11563	1
4	Food 2	Intake 4	14	92157	1337694101	/users/cn/jespinosa/phecomp/data/CRG/20120502_FDF_CRG/20120502_FDF_CRG/20120521_FDF_CRG_c12.mtb	9206	1836	WWFF	food_fat	4	92143	1337694087	1	0.0400000000000027	0.00285714285714305	11564	1
4	Food 1	Intake 3	15	94008	1337695952	/users/cn/jespinosa/phecomp/data/CRG/20120502_FDF_CRG/20120502_FDF_CRG/20120521_FDF_CRG_c12.mtb	7386	235	WWFF	food_fat	3	93993	1337695937	1	0.0600000000000005	0.00400000000000003	11565	1
4	Food 1	Intake 3	18	94261	1337696205	/users/cn/jespinosa/phecomp/data/CRG/20120502_FDF_CRG/20120502_FDF_CRG/20120521_FDF_CRG_c12.mtb	7389	1038	WWFF	food_fat	3	94243	1337696187	1	0.0400000000000009	0.00222222222222227	11566	1
4	Food 1	Intake 3	51	95350	1337697294	/users/cn/jespinosa/phecomp/data/CRG/20120502_FDF_CRG/20120502_FDF_CRG/20120521_FDF_CRG_c12.mtb	7396	214	WWFF	food_fat	3	95299	1337697243	1	0.140000000000001	0.00274509803921571	11567	1
4	Food 1	Intake 3	17	95581	1337697525	/users/cn/jespinosa/phecomp/data/CRG/20120502_FDF_CRG/20120502_FDF_CRG/20120521_FDF_CRG_c12.mtb	7399	91	WWFF	food_fat	3	95564	1337697508	1	0.0399999999999991	0.00235294117647054	11568	1
4	Food 1	Intake 3	12	95684	1337697628	/users/cn/jespinosa/phecomp/data/CRG/20120502_FDF_CRG/20120502_FDF_CRG/20120521_FDF_CRG_c12.mtb	7400	54	WWFF	food_fat	3	95672	1337697616	1	0.0200000000000014	0.00166666666666678	11569	1
4	Food 1	Intake 3	26	95764	1337697708	/users/cn/jespinosa/phecomp/data/CRG/20120502_FDF_CRG/20120502_FDF_CRG/20120521_FDF_CRG_c12.mtb	7401	1381	WWFF	food_fat	3	95738	1337697682	1	0.0800000000000001	0.00307692307692308	11570	1
4	Food 1	Intake 3	18	97163	1337699107	/users/cn/jespinosa/phecomp/data/CRG/20120502_FDF_CRG/20120502_FDF_CRG/20120521_FDF_CRG_c12.mtb	7409	42	WWFF	food_fat	3	97145	1337699089	1	0.100000000000001	0.00555555555555561	11571	1
4	Food 1	Intake 3	13	97218	1337699162	/users/cn/jespinosa/phecomp/data/CRG/20120502_FDF_CRG/20120502_FDF_CRG/20120521_FDF_CRG_c12.mtb	7411	289	WWFF	food_fat	3	97205	1337699149	1	0.0400000000000009	0.00307692307692315	11572	1
4	Food 1	Intake 3	60	97567	1337699511	/users/cn/jespinosa/phecomp/data/CRG/20120502_FDF_CRG/20120502_FDF_CRG/20120521_FDF_CRG_c12.mtb	7414	127	WWFF	food_fat	3	97507	1337699451	1	0.0999999999999996	0.00166666666666666	11573	1
4	Food 1	Intake 3	56	97750	1337699694	/users/cn/jespinosa/phecomp/data/CRG/20120502_FDF_CRG/20120502_FDF_CRG/20120521_FDF_CRG_c12.mtb	7417	1354	WWFF	food_fat	3	97694	1337699638	1	0.0599999999999987	0.00107142857142855	11574	1
4	Drink 1	Intake 1	23	97851	1337699795	/users/cn/jespinosa/phecomp/data/CRG/20120502_FDF_CRG/20120502_FDF_CRG/20120521_FDF_CRG_c12.mtb	2356	NA	WWFF	water	1	97828	1337699772	1	0.0800000000000001	0.00347826086956522	11575	1
4	Food 1	Intake 3	18	99122	1337701066	/users/cn/jespinosa/phecomp/data/CRG/20120502_FDF_CRG/20120502_FDF_CRG/20120521_FDF_CRG_c12.mtb	7428	409	WWFF	food_fat	3	99104	1337701048	1	0.0400000000000009	0.00222222222222227	11576	1
4	Food 1	Intake 3	36	99567	1337701511	/users/cn/jespinosa/phecomp/data/CRG/20120502_FDF_CRG/20120502_FDF_CRG/20120521_FDF_CRG_c12.mtb	7432	143	WWFF	food_fat	3	99531	1337701475	1	0.0600000000000005	0.00166666666666668	11577	1
4	Food 1	Intake 3	172	99882	1337701826	/users/cn/jespinosa/phecomp/data/CRG/20120502_FDF_CRG/20120502_FDF_CRG/20120521_FDF_CRG_c12.mtb	7434	1450	WWFF	food_fat	3	99710	1337701654	1	0.18	0.00104651162790698	11578	1
4	Drink 1	Intake 1	15	100838	1337702782	/users/cn/jespinosa/phecomp/data/CRG/20120502_FDF_CRG/20120502_FDF_CRG/20120521_FDF_CRG_c12.mtb	2357	NA	WWFF	water	1	100823	1337702767	1	0.1	0.00666666666666667	11579	1
4	Food 2	Intake 4	171	101503	1337703447	/users/cn/jespinosa/phecomp/data/CRG/20120502_FDF_CRG/20120502_FDF_CRG/20120521_FDF_CRG_c12.mtb	9221	353	WWFF	food_fat	4	101332	1337703276	1	0.0599999999999987	0.000350877192982449	11580	1
4	Food 1	Intake 3	401	102257	1337704201	/users/cn/jespinosa/phecomp/data/CRG/20120502_FDF_CRG/20120502_FDF_CRG/20120521_FDF_CRG_c12.mtb	7436	602	WWFF	food_fat	3	101856	1337703800	1	0.18	0.000448877805486284	11581	1
4	Food 1	Intake 3	38	102897	1337704841	/users/cn/jespinosa/phecomp/data/CRG/20120502_FDF_CRG/20120502_FDF_CRG/20120521_FDF_CRG_c12.mtb	7440	197	WWFF	food_fat	3	102859	1337704803	1	0.279999999999999	0.00736842105263155	11582	1
4	Food 1	Intake 3	28	103122	1337705066	/users/cn/jespinosa/phecomp/data/CRG/20120502_FDF_CRG/20120502_FDF_CRG/20120521_FDF_CRG_c12.mtb	7441	97	WWFF	food_fat	3	103094	1337705038	1	0.0600000000000005	0.00214285714285716	11583	1
4	Food 1	Intake 3	17	103236	1337705180	/users/cn/jespinosa/phecomp/data/CRG/20120502_FDF_CRG/20120502_FDF_CRG/20120521_FDF_CRG_c12.mtb	7442	969	WWFF	food_fat	3	103219	1337705163	1	0.0400000000000009	0.00235294117647064	11584	1
4	Food 1	Intake 3	42	104247	1337706191	/users/cn/jespinosa/phecomp/data/CRG/20120502_FDF_CRG/20120502_FDF_CRG/20120521_FDF_CRG_c12.mtb	7446	1968	WWFF	food_fat	3	104205	1337706149	1	0.0399999999999991	0.000952380952380931	11585	1
4	Food 1	Intake 3	74	106289	1337708233	/users/cn/jespinosa/phecomp/data/CRG/20120502_FDF_CRG/20120502_FDF_CRG/20120521_FDF_CRG_c12.mtb	7461	461	WWFF	food_fat	3	106215	1337708159	1	0.4	0.00540540540540541	11586	1
4	Drink 1	Intake 1	34	106253	1337708197	/users/cn/jespinosa/phecomp/data/CRG/20120502_FDF_CRG/20120502_FDF_CRG/20120521_FDF_CRG_c12.mtb	2358	NA	WWFF	water	1	106219	1337708163	1	0.12	0.00352941176470588	11587	1
4	Food 1	Intake 3	101	106851	1337708795	/users/cn/jespinosa/phecomp/data/CRG/20120502_FDF_CRG/20120502_FDF_CRG/20120521_FDF_CRG_c12.mtb	7465	250	WWFF	food_fat	3	106750	1337708694	1	0.0400000000000009	0.000396039603960405	11588	1
4	Drink 1	Intake 1	23	106996	1337708940	/users/cn/jespinosa/phecomp/data/CRG/20120502_FDF_CRG/20120502_FDF_CRG/20120521_FDF_CRG_c12.mtb	2359	NA	WWFF	water	1	106973	1337708917	1	0.04	0.00173913043478261	11589	1
4	Food 1	Intake 3	15	107116	1337709060	/users/cn/jespinosa/phecomp/data/CRG/20120502_FDF_CRG/20120502_FDF_CRG/20120521_FDF_CRG_c12.mtb	7468	25	WWFF	food_fat	3	107101	1337709045	1	0.0399999999999991	0.00266666666666661	11590	1
4	Food 1	Intake 3	15	107156	1337709100	/users/cn/jespinosa/phecomp/data/CRG/20120502_FDF_CRG/20120502_FDF_CRG/20120521_FDF_CRG_c12.mtb	7469	56	WWFF	food_fat	3	107141	1337709085	1	0.0600000000000005	0.00400000000000003	11591	1
4	Food 1	Intake 3	32	107244	1337709188	/users/cn/jespinosa/phecomp/data/CRG/20120502_FDF_CRG/20120502_FDF_CRG/20120521_FDF_CRG_c12.mtb	7470	103	WWFF	food_fat	3	107212	1337709156	1	0.0600000000000005	0.00187500000000002	11592	1
4	Food 1	Intake 3	85	107432	1337709376	/users/cn/jespinosa/phecomp/data/CRG/20120502_FDF_CRG/20120502_FDF_CRG/20120521_FDF_CRG_c12.mtb	7473	381	WWFF	food_fat	3	107347	1337709291	1	0.199999999999999	0.00235294117647058	11593	1
4	Food 1	Intake 3	16	107829	1337709773	/users/cn/jespinosa/phecomp/data/CRG/20120502_FDF_CRG/20120502_FDF_CRG/20120521_FDF_CRG_c12.mtb	7477	172	WWFF	food_fat	3	107813	1337709757	1	0.16	0.01	11594	1
4	Food 1	Intake 3	12	108013	1337709957	/users/cn/jespinosa/phecomp/data/CRG/20120502_FDF_CRG/20120502_FDF_CRG/20120521_FDF_CRG_c12.mtb	7479	207	WWFF	food_fat	3	108001	1337709945	1	0.0399999999999991	0.00333333333333326	11595	1
4	Food 1	Intake 3	346	108566	1337710510	/users/cn/jespinosa/phecomp/data/CRG/20120502_FDF_CRG/20120502_FDF_CRG/20120521_FDF_CRG_c12.mtb	7484	4	WWFF	food_fat	3	108220	1337710164	1	0.0399999999999991	0.000115606936416182	11596	1
4	Food 1	Intake 3	1621	110191	1337712135	/users/cn/jespinosa/phecomp/data/CRG/20120502_FDF_CRG/20120502_FDF_CRG/20120521_FDF_CRG_c12.mtb	7485	COLL	WWFF	food_fat	3	108570	1337710514	1	0.16	9.87045033929673e-05	11597	1
4	Food 2	Intake 4	47	109604	1337711548	/users/cn/jespinosa/phecomp/data/CRG/20120502_FDF_CRG/20120502_FDF_CRG/20120521_FDF_CRG_c12.mtb	9239	62	WWFF	food_fat	4	109557	1337711501	1	0.0600000000000023	0.0012765957446809	11598	1
4	Food 2	Intake 4	203	109869	1337711813	/users/cn/jespinosa/phecomp/data/CRG/20120502_FDF_CRG/20120502_FDF_CRG/20120521_FDF_CRG_c12.mtb	9241	290	WWFF	food_fat	4	109666	1337711610	1	0.0399999999999991	0.000197044334975365	11599	1
4	Food 2	Intake 4	9	110168	1337712112	/users/cn/jespinosa/phecomp/data/CRG/20120502_FDF_CRG/20120502_FDF_CRG/20120521_FDF_CRG_c12.mtb	9245	150	WWFF	food_fat	4	110159	1337712103	1	0.0399999999999991	0.00444444444444434	11600	1
4	Food 2	Intake 4	53	110371	1337712315	/users/cn/jespinosa/phecomp/data/CRG/20120502_FDF_CRG/20120502_FDF_CRG/20120521_FDF_CRG_c12.mtb	9247	333	WWFF	food_fat	4	110318	1337712262	1	0.0599999999999987	0.00113207547169809	11601	1
4	Drink 2	Intake 2	37	110444	1337712388	/users/cn/jespinosa/phecomp/data/CRG/20120502_FDF_CRG/20120502_FDF_CRG/20120521_FDF_CRG_c12.mtb	2126	NA	WWFF	water	2	110407	1337712351	1	0.0999999999999999	0.0027027027027027	11602	1
4	Food 2	Intake 4	47	110751	1337712695	/users/cn/jespinosa/phecomp/data/CRG/20120502_FDF_CRG/20120502_FDF_CRG/20120521_FDF_CRG_c12.mtb	9251	27	WWFF	food_fat	4	110704	1337712648	1	0.119999999999997	0.00255319148936164	11603	1
4	Food 2	Intake 4	21	110799	1337712743	/users/cn/jespinosa/phecomp/data/CRG/20120502_FDF_CRG/20120502_FDF_CRG/20120521_FDF_CRG_c12.mtb	9253	41	WWFF	food_fat	4	110778	1337712722	1	0.0599999999999987	0.0028571428571428	11604	1
4	Food 2	Intake 4	35	110875	1337712819	/users/cn/jespinosa/phecomp/data/CRG/20120502_FDF_CRG/20120502_FDF_CRG/20120521_FDF_CRG_c12.mtb	9254	499	WWFF	food_fat	4	110840	1337712784	1	0.0400000000000027	0.00114285714285722	11605	1
4	Food 2	Intake 4	231	111605	1337713549	/users/cn/jespinosa/phecomp/data/CRG/20120502_FDF_CRG/20120502_FDF_CRG/20120521_FDF_CRG_c12.mtb	9261	911	WWFF	food_fat	4	111374	1337713318	1	0.120000000000001	0.000519480519480524	11606	1
4	Food 1	Intake 3	33	112549	1337714493	/users/cn/jespinosa/phecomp/data/CRG/20120502_FDF_CRG/20120502_FDF_CRG/20120521_FDF_CRG_c12.mtb	7487	COLL	WWFF	food_fat	3	112516	1337714460	1	0.0600000000000005	0.00181818181818183	11607	1
4	Food 2	Intake 4	33	112550	1337714494	/users/cn/jespinosa/phecomp/data/CRG/20120502_FDF_CRG/20120502_FDF_CRG/20120521_FDF_CRG_c12.mtb	9267	39	WWFF	food_fat	4	112517	1337714461	1	0.0400000000000027	0.00121212121212129	11608	1
4	Food 1	Intake 3	455	113044	1337714988	/users/cn/jespinosa/phecomp/data/CRG/20120502_FDF_CRG/20120502_FDF_CRG/20120521_FDF_CRG_c12.mtb	7489	COLL	WWFF	food_fat	3	112589	1337714533	1	0.460000000000001	0.00101098901098901	11609	1
4	Food 2	Intake 4	60	112654	1337714598	/users/cn/jespinosa/phecomp/data/CRG/20120502_FDF_CRG/20120502_FDF_CRG/20120521_FDF_CRG_c12.mtb	9268	20	WWFF	food_fat	4	112594	1337714538	1	0.0799999999999983	0.0013333333333333	11610	1
4	Food 2	Intake 4	65	112739	1337714683	/users/cn/jespinosa/phecomp/data/CRG/20120502_FDF_CRG/20120502_FDF_CRG/20120521_FDF_CRG_c12.mtb	9269	726	WWFF	food_fat	4	112674	1337714618	1	0.100000000000001	0.00153846153846155	11611	1
4	Food 1	Intake 3	44	113509	1337715453	/users/cn/jespinosa/phecomp/data/CRG/20120502_FDF_CRG/20120502_FDF_CRG/20120521_FDF_CRG_c12.mtb	7494	918	WWFF	food_fat	3	113465	1337715409	1	0.0800000000000001	0.00181818181818182	11612	1
4	Food 1	Intake 3	134	114561	1337716505	/users/cn/jespinosa/phecomp/data/CRG/20120502_FDF_CRG/20120502_FDF_CRG/20120521_FDF_CRG_c12.mtb	7500	329	WWFF	food_fat	3	114427	1337716371	1	0.0800000000000001	0.000597014925373135	11613	1
4	Food 1	Intake 3	14	114904	1337716848	/users/cn/jespinosa/phecomp/data/CRG/20120502_FDF_CRG/20120502_FDF_CRG/20120521_FDF_CRG_c12.mtb	7504	224	WWFF	food_fat	3	114890	1337716834	1	0.0400000000000009	0.00285714285714292	11614	1
4	Food 1	Intake 3	41	115169	1337717113	/users/cn/jespinosa/phecomp/data/CRG/20120502_FDF_CRG/20120502_FDF_CRG/20120521_FDF_CRG_c12.mtb	7507	284	WWFF	food_fat	3	115128	1337717072	1	0.220000000000001	0.00536585365853661	11615	1
4	Food 1	Intake 3	265	115718	1337717662	/users/cn/jespinosa/phecomp/data/CRG/20120502_FDF_CRG/20120502_FDF_CRG/20120521_FDF_CRG_c12.mtb	7512	662	WWFF	food_fat	3	115453	1337717397	1	0.0400000000000009	0.000150943396226418	11616	1
4	Food 2	Intake 4	92	116472	1337718416	/users/cn/jespinosa/phecomp/data/CRG/20120502_FDF_CRG/20120502_FDF_CRG/20120521_FDF_CRG_c12.mtb	9280	16	WWFF	food_fat	4	116380	1337718324	1	0.0400000000000027	0.000434782608695682	11617	1
4	Food 2	Intake 4	190	116678	1337718622	/users/cn/jespinosa/phecomp/data/CRG/20120502_FDF_CRG/20120502_FDF_CRG/20120521_FDF_CRG_c12.mtb	9281	106	WWFF	food_fat	4	116488	1337718432	1	0.0799999999999983	0.000421052631578938	11618	1
4	Drink 1	Intake 1	28	116760	1337718704	/users/cn/jespinosa/phecomp/data/CRG/20120502_FDF_CRG/20120502_FDF_CRG/20120521_FDF_CRG_c12.mtb	2367	NA	WWFF	water	1	116732	1337718676	1	0.0599999999999996	0.00214285714285713	11619	1
4	Food 2	Intake 4	18	116802	1337718746	/users/cn/jespinosa/phecomp/data/CRG/20120502_FDF_CRG/20120502_FDF_CRG/20120521_FDF_CRG_c12.mtb	9284	COLL	WWFF	food_fat	4	116784	1337718728	1	0.0799999999999983	0.00444444444444435	11620	1
4	Food 1	Intake 3	66	116851	1337718795	/users/cn/jespinosa/phecomp/data/CRG/20120502_FDF_CRG/20120502_FDF_CRG/20120521_FDF_CRG_c12.mtb	7514	22	WWFF	food_fat	3	116785	1337718729	1	0.0200000000000014	0.000303030303030324	11621	1
4	Food 1	Intake 3	78	116951	1337718895	/users/cn/jespinosa/phecomp/data/CRG/20120502_FDF_CRG/20120502_FDF_CRG/20120521_FDF_CRG_c12.mtb	7515	4	WWFF	food_fat	3	116873	1337718817	1	0.0399999999999991	0.000512820512820501	11622	1
4	Food 1	Intake 3	271	117226	1337719170	/users/cn/jespinosa/phecomp/data/CRG/20120502_FDF_CRG/20120502_FDF_CRG/20120521_FDF_CRG_c12.mtb	7516	COLL	WWFF	food_fat	3	116955	1337718899	1	0.220000000000001	0.000811808118081184	11623	1
4	Food 2	Intake 4	79	117046	1337718990	/users/cn/jespinosa/phecomp/data/CRG/20120502_FDF_CRG/20120502_FDF_CRG/20120521_FDF_CRG_c12.mtb	9286	516	WWFF	food_fat	4	116967	1337718911	1	0.18	0.00227848101265823	11624	1
4	Food 1	Intake 3	28	117590	1337719534	/users/cn/jespinosa/phecomp/data/CRG/20120502_FDF_CRG/20120502_FDF_CRG/20120521_FDF_CRG_c12.mtb	7518	123	WWFF	food_fat	3	117562	1337719506	1	0.120000000000001	0.00428571428571432	11625	1
4	Food 2	Intake 4	9	117722	1337719666	/users/cn/jespinosa/phecomp/data/CRG/20120502_FDF_CRG/20120502_FDF_CRG/20120521_FDF_CRG_c12.mtb	9294	102	WWFF	food_fat	4	117713	1337719657	1	0.0400000000000027	0.00444444444444474	11626	1
4	Food 2	Intake 4	111	117935	1337719879	/users/cn/jespinosa/phecomp/data/CRG/20120502_FDF_CRG/20120502_FDF_CRG/20120521_FDF_CRG_c12.mtb	9296	COLL	WWFF	food_fat	4	117824	1337719768	1	0.0600000000000023	0.000540540540540561	11627	1
4	Food 1	Intake 3	111	117937	1337719881	/users/cn/jespinosa/phecomp/data/CRG/20120502_FDF_CRG/20120502_FDF_CRG/20120521_FDF_CRG_c12.mtb	7522	93	WWFF	food_fat	3	117826	1337719770	1	0.34	0.00306306306306306	11628	1
4	Food 2	Intake 4	139	118169	1337720113	/users/cn/jespinosa/phecomp/data/CRG/20120502_FDF_CRG/20120502_FDF_CRG/20120521_FDF_CRG_c12.mtb	9298	358	WWFF	food_fat	4	118030	1337719974	1	0.279999999999998	0.00201438848920862	11629	1
4	Drink 1	Intake 1	25	118197	1337720141	/users/cn/jespinosa/phecomp/data/CRG/20120502_FDF_CRG/20120502_FDF_CRG/20120521_FDF_CRG_c12.mtb	2368	NA	WWFF	water	1	118172	1337720116	1	0.0800000000000001	0.0032	11630	1
4	Food 2	Intake 4	106	118633	1337720577	/users/cn/jespinosa/phecomp/data/CRG/20120502_FDF_CRG/20120502_FDF_CRG/20120521_FDF_CRG_c12.mtb	9300	858	WWFF	food_fat	4	118527	1337720471	1	0.100000000000001	0.000943396226415104	11631	1
4	Food 2	Intake 4	168	119659	1337721603	/users/cn/jespinosa/phecomp/data/CRG/20120502_FDF_CRG/20120502_FDF_CRG/20120521_FDF_CRG_c12.mtb	9306	396	WWFF	food_fat	4	119491	1337721435	1	0.120000000000001	0.00071428571428572	11632	1
4	Food 2	Intake 4	14	120069	1337722013	/users/cn/jespinosa/phecomp/data/CRG/20120502_FDF_CRG/20120502_FDF_CRG/20120521_FDF_CRG_c12.mtb	9312	126	WWFF	food_fat	4	120055	1337721999	1	0.0799999999999983	0.00571428571428559	11633	1
4	Drink 1	Intake 1	24	120081	1337722025	/users/cn/jespinosa/phecomp/data/CRG/20120502_FDF_CRG/20120502_FDF_CRG/20120521_FDF_CRG_c12.mtb	2369	NA	WWFF	water	1	120057	1337722001	1	0.04	0.00166666666666667	11634	1
4	Food 2	Intake 4	168	120363	1337722307	/users/cn/jespinosa/phecomp/data/CRG/20120502_FDF_CRG/20120502_FDF_CRG/20120521_FDF_CRG_c12.mtb	9314	613	WWFF	food_fat	4	120195	1337722139	1	0.100000000000001	0.000595238095238101	11635	1
4	Food 1	Intake 3	16	120992	1337722936	/users/cn/jespinosa/phecomp/data/CRG/20120502_FDF_CRG/20120502_FDF_CRG/20120521_FDF_CRG_c12.mtb	7528	33	WWFF	food_fat	3	120976	1337722920	1	0.0200000000000014	0.00125000000000009	11636	1
4	Food 1	Intake 3	584	121609	1337723553	/users/cn/jespinosa/phecomp/data/CRG/20120502_FDF_CRG/20120502_FDF_CRG/20120521_FDF_CRG_c12.mtb	7529	73	WWFF	food_fat	3	121025	1337722969	1	0.0799999999999983	0.00013698630136986	11637	1
4	Drink 2	Intake 2	16	121131	1337723075	/users/cn/jespinosa/phecomp/data/CRG/20120502_FDF_CRG/20120502_FDF_CRG/20120521_FDF_CRG_c12.mtb	2135	NA	WWFF	water	2	121115	1337723059	1	0.0600000000000001	0.00375000000000001	11638	1
4	Food 1	Intake 3	36	121718	1337723662	/users/cn/jespinosa/phecomp/data/CRG/20120502_FDF_CRG/20120502_FDF_CRG/20120521_FDF_CRG_c12.mtb	7531	402	WWFF	food_fat	3	121682	1337723626	1	0.0399999999999991	0.00111111111111109	11639	1
4	Food 1	Intake 3	18	122138	1337724082	/users/cn/jespinosa/phecomp/data/CRG/20120502_FDF_CRG/20120502_FDF_CRG/20120521_FDF_CRG_c12.mtb	7534	1357	WWFF	food_fat	3	122120	1337724064	1	0.0400000000000009	0.00222222222222227	11640	1
4	Food 1	Intake 3	16	123511	1337725455	/users/cn/jespinosa/phecomp/data/CRG/20120502_FDF_CRG/20120502_FDF_CRG/20120521_FDF_CRG_c12.mtb	7539	88	WWFF	food_fat	3	123495	1337725439	1	0.0200000000000014	0.00125000000000009	11641	1
4	Food 1	Intake 3	33	123632	1337725576	/users/cn/jespinosa/phecomp/data/CRG/20120502_FDF_CRG/20120502_FDF_CRG/20120521_FDF_CRG_c12.mtb	7541	COLL	WWFF	food_fat	3	123599	1337725543	1	0.199999999999999	0.00606060606060603	11642	1
4	Food 2	Intake 4	24	123624	1337725568	/users/cn/jespinosa/phecomp/data/CRG/20120502_FDF_CRG/20120502_FDF_CRG/20120521_FDF_CRG_c12.mtb	9337	157	WWFF	food_fat	4	123600	1337725544	1	0.0399999999999991	0.00166666666666663	11643	1
4	Food 1	Intake 3	32	123813	1337725757	/users/cn/jespinosa/phecomp/data/CRG/20120502_FDF_CRG/20120502_FDF_CRG/20120521_FDF_CRG_c12.mtb	7542	975	WWFF	food_fat	3	123781	1337725725	1	0.0600000000000005	0.00187500000000002	11644	1
4	Drink 1	Intake 1	19	124669	1337726613	/users/cn/jespinosa/phecomp/data/CRG/20120502_FDF_CRG/20120502_FDF_CRG/20120521_FDF_CRG_c12.mtb	2370	NA	WWFF	water	1	124650	1337726594	1	0.02	0.00105263157894737	11645	1
4	Food 2	Intake 4	28	124816	1337726760	/users/cn/jespinosa/phecomp/data/CRG/20120502_FDF_CRG/20120502_FDF_CRG/20120521_FDF_CRG_c12.mtb	9348	COLL	WWFF	food_fat	4	124788	1337726732	1	0.360000000000003	0.012857142857143	11646	1
4	Food 1	Intake 3	110	124901	1337726845	/users/cn/jespinosa/phecomp/data/CRG/20120502_FDF_CRG/20120502_FDF_CRG/20120521_FDF_CRG_c12.mtb	7548	250	WWFF	food_fat	3	124791	1337726735	1	0.719999999999999	0.00654545454545454	11647	1
4	Food 1	Intake 3	40	125191	1337727135	/users/cn/jespinosa/phecomp/data/CRG/20120502_FDF_CRG/20120502_FDF_CRG/20120521_FDF_CRG_c12.mtb	7550	233	WWFF	food_fat	3	125151	1337727095	1	0.0400000000000009	0.00100000000000002	11648	1
4	Drink 1	Intake 1	15	125175	1337727119	/users/cn/jespinosa/phecomp/data/CRG/20120502_FDF_CRG/20120502_FDF_CRG/20120521_FDF_CRG_c12.mtb	2371	NA	WWFF	water	1	125160	1337727104	1	0.0600000000000001	0.00400000000000001	11649	1
4	Food 1	Intake 3	26	125450	1337727394	/users/cn/jespinosa/phecomp/data/CRG/20120502_FDF_CRG/20120502_FDF_CRG/20120521_FDF_CRG_c12.mtb	7553	96	WWFF	food_fat	3	125424	1337727368	1	0.0399999999999991	0.0015384615384615	11650	1
4	Food 1	Intake 3	21	125567	1337727511	/users/cn/jespinosa/phecomp/data/CRG/20120502_FDF_CRG/20120502_FDF_CRG/20120521_FDF_CRG_c12.mtb	7555	1314	WWFF	food_fat	3	125546	1337727490	1	0.0400000000000009	0.00190476190476195	11651	1
4	Drink 1	Intake 1	17	125978	1337727922	/users/cn/jespinosa/phecomp/data/CRG/20120502_FDF_CRG/20120502_FDF_CRG/20120521_FDF_CRG_c12.mtb	2372	NA	WWFF	water	1	125961	1337727905	1	0.02	0.00117647058823529	11652	1
4	Food 2	Intake 4	274	127155	1337729099	/users/cn/jespinosa/phecomp/data/CRG/20120502_FDF_CRG/20120502_FDF_CRG/20120521_FDF_CRG_c12.mtb	9356	COLL	WWFF	food_fat	4	126881	1337728825	1	0.52	0.0018978102189781	11653	1
4	Food 1	Intake 3	576	127459	1337729403	/users/cn/jespinosa/phecomp/data/CRG/20120502_FDF_CRG/20120502_FDF_CRG/20120521_FDF_CRG_c12.mtb	7559	COLL	WWFF	food_fat	3	126883	1337728827	1	0.700000000000001	0.00121527777777778	11654	1
4	Drink 1	Intake 1	19	127242	1337729186	/users/cn/jespinosa/phecomp/data/CRG/20120502_FDF_CRG/20120502_FDF_CRG/20120521_FDF_CRG_c12.mtb	2373	NA	WWFF	water	1	127223	1337729167	1	0.04	0.00210526315789474	11655	1
4	Food 2	Intake 4	99	127331	1337729275	/users/cn/jespinosa/phecomp/data/CRG/20120502_FDF_CRG/20120502_FDF_CRG/20120521_FDF_CRG_c12.mtb	9358	212	WWFF	food_fat	4	127232	1337729176	1	0.0799999999999983	0.000808080808080791	11656	1
4	Food 1	Intake 3	405	127948	1337729892	/users/cn/jespinosa/phecomp/data/CRG/20120502_FDF_CRG/20120502_FDF_CRG/20120521_FDF_CRG_c12.mtb	7560	COLL	WWFF	food_fat	3	127543	1337729487	1	0.0399999999999991	9.87654320987632e-05	11657	1
4	Drink 2	Intake 2	83	127716	1337729660	/users/cn/jespinosa/phecomp/data/CRG/20120502_FDF_CRG/20120502_FDF_CRG/20120521_FDF_CRG_c12.mtb	2138	NA	WWFF	water	2	127633	1337729577	1	0.0600000000000001	0.000722891566265061	11658	1
4	Food 2	Intake 4	40	127747	1337729691	/users/cn/jespinosa/phecomp/data/CRG/20120502_FDF_CRG/20120502_FDF_CRG/20120521_FDF_CRG_c12.mtb	9363	8	WWFF	food_fat	4	127707	1337729651	1	0.0399999999999991	0.000999999999999977	11659	1
4	Food 2	Intake 4	148	127903	1337729847	/users/cn/jespinosa/phecomp/data/CRG/20120502_FDF_CRG/20120502_FDF_CRG/20120521_FDF_CRG_c12.mtb	9364	56	WWFF	food_fat	4	127755	1337729699	1	0.0399999999999991	0.000270270270270264	11660	1
4	Drink 1	Intake 1	26	127857	1337729801	/users/cn/jespinosa/phecomp/data/CRG/20120502_FDF_CRG/20120502_FDF_CRG/20120521_FDF_CRG_c12.mtb	2375	NA	WWFF	water	1	127831	1337729775	1	0.02	0.000769230769230769	11661	1
4	Food 1	Intake 3	314	128273	1337730217	/users/cn/jespinosa/phecomp/data/CRG/20120502_FDF_CRG/20120502_FDF_CRG/20120521_FDF_CRG_c12.mtb	7561	COLL	WWFF	food_fat	3	127959	1337729903	1	0.16	0.000509554140127389	11662	1
4	Drink 2	Intake 2	22	128067	1337730011	/users/cn/jespinosa/phecomp/data/CRG/20120502_FDF_CRG/20120502_FDF_CRG/20120521_FDF_CRG_c12.mtb	2139	NA	WWFF	water	2	128045	1337729989	1	0.0599999999999998	0.00272727272727272	11663	1
4	Food 2	Intake 4	33	128106	1337730050	/users/cn/jespinosa/phecomp/data/CRG/20120502_FDF_CRG/20120502_FDF_CRG/20120521_FDF_CRG_c12.mtb	9368	53	WWFF	food_fat	4	128073	1337730017	1	0.0399999999999991	0.00121212121212118	11664	1
4	Food 2	Intake 4	37	128196	1337730140	/users/cn/jespinosa/phecomp/data/CRG/20120502_FDF_CRG/20120502_FDF_CRG/20120521_FDF_CRG_c12.mtb	9370	247	WWFF	food_fat	4	128159	1337730103	1	0.0400000000000027	0.00108108108108115	11665	1
4	Drink 1	Intake 1	22	128409	1337730353	/users/cn/jespinosa/phecomp/data/CRG/20120502_FDF_CRG/20120502_FDF_CRG/20120521_FDF_CRG_c12.mtb	2376	NA	WWFF	water	1	128387	1337730331	1	0.0600000000000001	0.00272727272727273	11666	1
4	Food 2	Intake 4	81	128524	1337730468	/users/cn/jespinosa/phecomp/data/CRG/20120502_FDF_CRG/20120502_FDF_CRG/20120521_FDF_CRG_c12.mtb	9373	191	WWFF	food_fat	4	128443	1337730387	1	0.0399999999999991	0.000493827160493816	11667	1
4	Food 1	Intake 3	25	128740	1337730684	/users/cn/jespinosa/phecomp/data/CRG/20120502_FDF_CRG/20120502_FDF_CRG/20120521_FDF_CRG_c12.mtb	7564	9	WWFF	food_fat	3	128715	1337730659	1	0.0399999999999991	0.00159999999999996	11668	1
4	Food 1	Intake 3	15	128764	1337730708	/users/cn/jespinosa/phecomp/data/CRG/20120502_FDF_CRG/20120502_FDF_CRG/20120521_FDF_CRG_c12.mtb	7565	COLL	WWFF	food_fat	3	128749	1337730693	1	0.120000000000001	0.00800000000000007	11669	1
4	Food 2	Intake 4	11	128762	1337730706	/users/cn/jespinosa/phecomp/data/CRG/20120502_FDF_CRG/20120502_FDF_CRG/20120521_FDF_CRG_c12.mtb	9376	398	WWFF	food_fat	4	128751	1337730695	1	0.0400000000000027	0.00363636363636388	11670	1
4	Drink 2	Intake 2	25	128778	1337730722	/users/cn/jespinosa/phecomp/data/CRG/20120502_FDF_CRG/20120502_FDF_CRG/20120521_FDF_CRG_c12.mtb	2140	NA	WWFF	water	2	128753	1337730697	1	0.1	0.004	11671	1
4	Food 1	Intake 3	603	129763	1337731707	/users/cn/jespinosa/phecomp/data/CRG/20120502_FDF_CRG/20120502_FDF_CRG/20120521_FDF_CRG_c12.mtb	7568	COLL	WWFF	food_fat	3	129160	1337731104	1	0.200000000000001	0.000331674958540632	11672	1
4	Food 2	Intake 4	83	129596	1337731540	/users/cn/jespinosa/phecomp/data/CRG/20120502_FDF_CRG/20120502_FDF_CRG/20120521_FDF_CRG_c12.mtb	9386	179	WWFF	food_fat	4	129513	1337731457	1	0.0399999999999991	0.000481927710843363	11673	1
4	Food 1	Intake 3	123	129898	1337731842	/users/cn/jespinosa/phecomp/data/CRG/20120502_FDF_CRG/20120502_FDF_CRG/20120521_FDF_CRG_c12.mtb	7569	COLL	WWFF	food_fat	3	129775	1337731719	1	0.0800000000000001	0.000650406504065041	11674	1
4	Food 2	Intake 4	64	129871	1337731815	/users/cn/jespinosa/phecomp/data/CRG/20120502_FDF_CRG/20120502_FDF_CRG/20120521_FDF_CRG_c12.mtb	9390	154	WWFF	food_fat	4	129807	1337731751	1	0.0399999999999991	0.000624999999999986	11675	1
4	Food 2	Intake 4	18	130043	1337731987	/users/cn/jespinosa/phecomp/data/CRG/20120502_FDF_CRG/20120502_FDF_CRG/20120521_FDF_CRG_c12.mtb	9392	1871	WWFF	food_fat	4	130025	1337731969	1	0.0200000000000031	0.00111111111111128	11676	1
4	Drink 1	Intake 1	25	130238	1337732182	/users/cn/jespinosa/phecomp/data/CRG/20120502_FDF_CRG/20120502_FDF_CRG/20120521_FDF_CRG_c12.mtb	2378	NA	WWFF	water	1	130213	1337732157	1	0.1	0.004	11677	1
4	Food 1	Intake 3	38	131952	1337733896	/users/cn/jespinosa/phecomp/data/CRG/20120502_FDF_CRG/20120502_FDF_CRG/20120521_FDF_CRG_c12.mtb	7577	1161	WWFF	food_fat	3	131914	1337733858	1	0.0599999999999987	0.00157894736842102	11678	1
4	Food 1	Intake 3	17	133130	1337735074	/users/cn/jespinosa/phecomp/data/CRG/20120502_FDF_CRG/20120502_FDF_CRG/20120521_FDF_CRG_c12.mtb	7593	567	WWFF	food_fat	3	133113	1337735057	1	0.0400000000000009	0.00235294117647064	11679	1
4	Food 1	Intake 3	21	133718	1337735662	/users/cn/jespinosa/phecomp/data/CRG/20120502_FDF_CRG/20120502_FDF_CRG/20120521_FDF_CRG_c12.mtb	7597	154	WWFF	food_fat	3	133697	1337735641	1	0.0200000000000014	0.000952380952381019	11680	1
4	Food 1	Intake 3	1202	135074	1337737018	/users/cn/jespinosa/phecomp/data/CRG/20120502_FDF_CRG/20120502_FDF_CRG/20120521_FDF_CRG_c12.mtb	7599	403	WWFF	food_fat	3	133872	1337735816	1	0.16	0.000133111480865225	11681	1
4	Drink 1	Intake 1	16	134849	1337736793	/users/cn/jespinosa/phecomp/data/CRG/20120502_FDF_CRG/20120502_FDF_CRG/20120521_FDF_CRG_c12.mtb	2380	NA	WWFF	water	1	134833	1337736777	1	0.0599999999999996	0.00374999999999998	11682	1
4	Food 1	Intake 3	15	135492	1337737436	/users/cn/jespinosa/phecomp/data/CRG/20120502_FDF_CRG/20120502_FDF_CRG/20120521_FDF_CRG_c12.mtb	7604	340	WWFF	food_fat	3	135477	1337737421	1	0.0200000000000014	0.00133333333333343	11683	1
4	Food 1	Intake 3	22	135854	1337737798	/users/cn/jespinosa/phecomp/data/CRG/20120502_FDF_CRG/20120502_FDF_CRG/20120521_FDF_CRG_c12.mtb	7610	54	WWFF	food_fat	3	135832	1337737776	1	0.0399999999999991	0.00181818181818178	11684	1
4	Food 1	Intake 3	16	135924	1337737868	/users/cn/jespinosa/phecomp/data/CRG/20120502_FDF_CRG/20120502_FDF_CRG/20120521_FDF_CRG_c12.mtb	7611	693	WWFF	food_fat	3	135908	1337737852	1	0.0400000000000009	0.00250000000000006	11685	1
4	Food 1	Intake 3	13	136630	1337738574	/users/cn/jespinosa/phecomp/data/CRG/20120502_FDF_CRG/20120502_FDF_CRG/20120521_FDF_CRG_c12.mtb	7615	77	WWFF	food_fat	3	136617	1337738561	1	0.0600000000000005	0.00461538461538465	11686	1
4	Food 1	Intake 3	15	136722	1337738666	/users/cn/jespinosa/phecomp/data/CRG/20120502_FDF_CRG/20120502_FDF_CRG/20120521_FDF_CRG_c12.mtb	7616	142	WWFF	food_fat	3	136707	1337738651	1	0.0399999999999991	0.00266666666666661	11687	1
4	Food 1	Intake 3	15	136879	1337738823	/users/cn/jespinosa/phecomp/data/CRG/20120502_FDF_CRG/20120502_FDF_CRG/20120521_FDF_CRG_c12.mtb	7617	128	WWFF	food_fat	3	136864	1337738808	1	0.0600000000000005	0.00400000000000003	11688	1
4	Food 1	Intake 3	28	137035	1337738979	/users/cn/jespinosa/phecomp/data/CRG/20120502_FDF_CRG/20120502_FDF_CRG/20120521_FDF_CRG_c12.mtb	7620	214	WWFF	food_fat	3	137007	1337738951	1	0.199999999999999	0.00714285714285711	11689	1
4	Food 1	Intake 3	32	137281	1337739225	/users/cn/jespinosa/phecomp/data/CRG/20120502_FDF_CRG/20120502_FDF_CRG/20120521_FDF_CRG_c12.mtb	7623	654	WWFF	food_fat	3	137249	1337739193	1	0.100000000000001	0.00312500000000003	11690	1
4	Food 1	Intake 3	28	137963	1337739907	/users/cn/jespinosa/phecomp/data/CRG/20120502_FDF_CRG/20120502_FDF_CRG/20120521_FDF_CRG_c12.mtb	7626	3	WWFF	food_fat	3	137935	1337739879	1	0.640000000000001	0.0228571428571429	11691	1
4	Food 2	Intake 4	20	137986	1337739930	/users/cn/jespinosa/phecomp/data/CRG/20120502_FDF_CRG/20120502_FDF_CRG/20120521_FDF_CRG_c12.mtb	9420	38	WWFF	food_fat	4	137966	1337739910	1	0.219999999999999	0.011	11692	1
4	Food 1	Intake 3	483	138507	1337740451	/users/cn/jespinosa/phecomp/data/CRG/20120502_FDF_CRG/20120502_FDF_CRG/20120521_FDF_CRG_c12.mtb	7628	COLL	WWFF	food_fat	3	138024	1337739968	1	0.140000000000001	0.00028985507246377	11693	1
4	Food 2	Intake 4	107	138224	1337740168	/users/cn/jespinosa/phecomp/data/CRG/20120502_FDF_CRG/20120502_FDF_CRG/20120521_FDF_CRG_c12.mtb	9422	20	WWFF	food_fat	4	138117	1337740061	1	0.0400000000000027	0.00037383177570096	11694	1
4	Food 2	Intake 4	154	138398	1337740342	/users/cn/jespinosa/phecomp/data/CRG/20120502_FDF_CRG/20120502_FDF_CRG/20120521_FDF_CRG_c12.mtb	9423	617	WWFF	food_fat	4	138244	1337740188	1	0.0599999999999987	0.000389610389610381	11695	1
4	Drink 2	Intake 2	10	138553	1337740497	/users/cn/jespinosa/phecomp/data/CRG/20120502_FDF_CRG/20120502_FDF_CRG/20120521_FDF_CRG_c12.mtb	2142	NA	WWFF	water	2	138543	1337740487	1	0.04	0.004	11696	1
4	Drink 1	Intake 1	21	138658	1337740602	/users/cn/jespinosa/phecomp/data/CRG/20120502_FDF_CRG/20120502_FDF_CRG/20120521_FDF_CRG_c12.mtb	2382	NA	WWFF	water	1	138637	1337740581	1	0.0600000000000001	0.00285714285714286	11697	1
4	Food 2	Intake 4	24	139039	1337740983	/users/cn/jespinosa/phecomp/data/CRG/20120502_FDF_CRG/20120502_FDF_CRG/20120521_FDF_CRG_c12.mtb	9429	673	WWFF	food_fat	4	139015	1337740959	1	0.0599999999999987	0.00249999999999995	11698	1
4	Drink 1	Intake 1	15	139090	1337741034	/users/cn/jespinosa/phecomp/data/CRG/20120502_FDF_CRG/20120502_FDF_CRG/20120521_FDF_CRG_c12.mtb	2383	NA	WWFF	water	1	139075	1337741019	1	0.0600000000000001	0.00400000000000001	11699	1
4	Food 2	Intake 4	45	139757	1337741701	/users/cn/jespinosa/phecomp/data/CRG/20120502_FDF_CRG/20120502_FDF_CRG/20120521_FDF_CRG_c12.mtb	9434	179	WWFF	food_fat	4	139712	1337741656	1	0.100000000000001	0.00222222222222224	11700	1
4	Food 1	Intake 3	74	140010	1337741954	/users/cn/jespinosa/phecomp/data/CRG/20120502_FDF_CRG/20120502_FDF_CRG/20120521_FDF_CRG_c12.mtb	7632	68	WWFF	food_fat	3	139936	1337741880	1	0.0400000000000009	0.000540540540540553	11701	1
4	Food 2	Intake 4	18	140096	1337742040	/users/cn/jespinosa/phecomp/data/CRG/20120502_FDF_CRG/20120502_FDF_CRG/20120521_FDF_CRG_c12.mtb	9437	285	WWFF	food_fat	4	140078	1337742022	1	0.0599999999999987	0.00333333333333326	11702	1
4	Food 1	Intake 3	60	140441	1337742385	/users/cn/jespinosa/phecomp/data/CRG/20120502_FDF_CRG/20120502_FDF_CRG/20120521_FDF_CRG_c12.mtb	7636	33	WWFF	food_fat	3	140381	1337742325	1	0.119999999999999	0.00199999999999998	11703	1
4	Food 1	Intake 3	67	140541	1337742485	/users/cn/jespinosa/phecomp/data/CRG/20120502_FDF_CRG/20120502_FDF_CRG/20120521_FDF_CRG_c12.mtb	7637	721	WWFF	food_fat	3	140474	1337742418	1	0.0400000000000009	0.000597014925373148	11704	1
4	Food 1	Intake 3	405	141667	1337743611	/users/cn/jespinosa/phecomp/data/CRG/20120502_FDF_CRG/20120502_FDF_CRG/20120521_FDF_CRG_c12.mtb	7639	475	WWFF	food_fat	3	141262	1337743206	1	0.24	0.000592592592592593	11705	1
4	Drink 1	Intake 1	18	141437	1337743381	/users/cn/jespinosa/phecomp/data/CRG/20120502_FDF_CRG/20120502_FDF_CRG/20120521_FDF_CRG_c12.mtb	2384	NA	WWFF	water	1	141419	1337743363	1	0.0800000000000001	0.00444444444444445	11706	1
4	Food 1	Intake 3	35	142177	1337744121	/users/cn/jespinosa/phecomp/data/CRG/20120502_FDF_CRG/20120502_FDF_CRG/20120521_FDF_CRG_c12.mtb	7644	60	WWFF	food_fat	3	142142	1337744086	1	0.0800000000000001	0.00228571428571429	11707	1
4	Food 1	Intake 3	129	142366	1337744310	/users/cn/jespinosa/phecomp/data/CRG/20120502_FDF_CRG/20120502_FDF_CRG/20120521_FDF_CRG_c12.mtb	7646	349	WWFF	food_fat	3	142237	1337744181	1	0.139999999999999	0.00108527131782945	11708	1
4	Food 1	Intake 3	44	142759	1337744703	/users/cn/jespinosa/phecomp/data/CRG/20120502_FDF_CRG/20120502_FDF_CRG/20120521_FDF_CRG_c12.mtb	7648	493	WWFF	food_fat	3	142715	1337744659	1	0.239999999999998	0.00545454545454541	11709	1
4	Food 1	Intake 3	89	143341	1337745285	/users/cn/jespinosa/phecomp/data/CRG/20120502_FDF_CRG/20120502_FDF_CRG/20120521_FDF_CRG_c12.mtb	7652	COLL	WWFF	food_fat	3	143252	1337745196	1	0.0800000000000001	0.000898876404494383	11710	1
4	Food 2	Intake 4	31	143296	1337745240	/users/cn/jespinosa/phecomp/data/CRG/20120502_FDF_CRG/20120502_FDF_CRG/20120521_FDF_CRG_c12.mtb	9456	321	WWFF	food_fat	4	143265	1337745209	1	0.18	0.00580645161290323	11711	1
4	Drink 1	Intake 1	22	143311	1337745255	/users/cn/jespinosa/phecomp/data/CRG/20120502_FDF_CRG/20120502_FDF_CRG/20120521_FDF_CRG_c12.mtb	2385	NA	WWFF	water	1	143289	1337745233	1	0.0600000000000001	0.00272727272727273	11712	1
4	Food 1	Intake 3	20	143637	1337745581	/users/cn/jespinosa/phecomp/data/CRG/20120502_FDF_CRG/20120502_FDF_CRG/20120521_FDF_CRG_c12.mtb	7653	625	WWFF	food_fat	3	143617	1337745561	1	0.0399999999999991	0.00199999999999995	11713	1
4	Food 1	Intake 3	32	144294	1337746238	/users/cn/jespinosa/phecomp/data/CRG/20120502_FDF_CRG/20120502_FDF_CRG/20120521_FDF_CRG_c12.mtb	7656	189	WWFF	food_fat	3	144262	1337746206	1	0.0800000000000001	0.0025	11714	1
4	Food 1	Intake 3	33	144516	1337746460	/users/cn/jespinosa/phecomp/data/CRG/20120502_FDF_CRG/20120502_FDF_CRG/20120521_FDF_CRG_c12.mtb	7659	17	WWFF	food_fat	3	144483	1337746427	1	0.0999999999999996	0.00303030303030302	11715	1
4	Food 1	Intake 3	43	144576	1337746520	/users/cn/jespinosa/phecomp/data/CRG/20120502_FDF_CRG/20120502_FDF_CRG/20120521_FDF_CRG_c12.mtb	7660	1010	WWFF	food_fat	3	144533	1337746477	1	0.0800000000000001	0.00186046511627907	11716	1
4	Food 1	Intake 3	89	145675	1337747619	/users/cn/jespinosa/phecomp/data/CRG/20120502_FDF_CRG/20120502_FDF_CRG/20120521_FDF_CRG_c12.mtb	7665	110	WWFF	food_fat	3	145586	1337747530	1	0.139999999999999	0.00157303370786516	11717	1
4	Food 1	Intake 3	73	145858	1337747802	/users/cn/jespinosa/phecomp/data/CRG/20120502_FDF_CRG/20120502_FDF_CRG/20120521_FDF_CRG_c12.mtb	7667	443	WWFF	food_fat	3	145785	1337747729	1	0.100000000000001	0.00136986301369864	11718	1
4	Food 1	Intake 3	14	146315	1337748259	/users/cn/jespinosa/phecomp/data/CRG/20120502_FDF_CRG/20120502_FDF_CRG/20120521_FDF_CRG_c12.mtb	7672	49	WWFF	food_fat	3	146301	1337748245	1	0.0600000000000005	0.00428571428571432	11719	1
4	Food 1	Intake 3	101	146465	1337748409	/users/cn/jespinosa/phecomp/data/CRG/20120502_FDF_CRG/20120502_FDF_CRG/20120521_FDF_CRG_c12.mtb	7673	98	WWFF	food_fat	3	146364	1337748308	1	0.139999999999999	0.00138613861386138	11720	1
4	Drink 1	Intake 1	19	146395	1337748339	/users/cn/jespinosa/phecomp/data/CRG/20120502_FDF_CRG/20120502_FDF_CRG/20120521_FDF_CRG_c12.mtb	2386	NA	WWFF	water	1	146376	1337748320	1	0.02	0.00105263157894737	11721	1
4	Food 1	Intake 3	18	146581	1337748525	/users/cn/jespinosa/phecomp/data/CRG/20120502_FDF_CRG/20120502_FDF_CRG/20120521_FDF_CRG_c12.mtb	7675	57	WWFF	food_fat	3	146563	1337748507	1	0.0800000000000001	0.00444444444444445	11722	1
4	Food 2	Intake 4	18	146656	1337748600	/users/cn/jespinosa/phecomp/data/CRG/20120502_FDF_CRG/20120502_FDF_CRG/20120521_FDF_CRG_c12.mtb	9463	481	WWFF	food_fat	4	146638	1337748582	1	0.0400000000000027	0.00222222222222237	11723	1
4	Food 1	Intake 3	630	147767	1337749711	/users/cn/jespinosa/phecomp/data/CRG/20120502_FDF_CRG/20120502_FDF_CRG/20120521_FDF_CRG_c12.mtb	7681	COLL	WWFF	food_fat	3	147137	1337749081	1	0.479999999999999	0.00076190476190476	11724	1
4	Food 2	Intake 4	97	147413	1337749357	/users/cn/jespinosa/phecomp/data/CRG/20120502_FDF_CRG/20120502_FDF_CRG/20120521_FDF_CRG_c12.mtb	9465	169	WWFF	food_fat	4	147316	1337749260	1	0.120000000000001	0.00123711340206187	11725	1
4	Food 2	Intake 4	63	147645	1337749589	/users/cn/jespinosa/phecomp/data/CRG/20120502_FDF_CRG/20120502_FDF_CRG/20120521_FDF_CRG_c12.mtb	9467	168	WWFF	food_fat	4	147582	1337749526	1	0.0599999999999987	0.000952380952380932	11726	1
4	Food 1	Intake 3	79	147892	1337749836	/users/cn/jespinosa/phecomp/data/CRG/20120502_FDF_CRG/20120502_FDF_CRG/20120521_FDF_CRG_c12.mtb	7682	468	WWFF	food_fat	3	147813	1337749757	1	0.0800000000000001	0.0010126582278481	11727	1
4	Drink 2	Intake 2	23	147913	1337749857	/users/cn/jespinosa/phecomp/data/CRG/20120502_FDF_CRG/20120502_FDF_CRG/20120521_FDF_CRG_c12.mtb	2144	NA	WWFF	water	2	147890	1337749834	1	0.0600000000000001	0.00260869565217392	11728	1
4	Drink 2	Intake 2	35	147955	1337749899	/users/cn/jespinosa/phecomp/data/CRG/20120502_FDF_CRG/20120502_FDF_CRG/20120521_FDF_CRG_c12.mtb	2145	NA	WWFF	water	2	147920	1337749864	1	0.02	0.000571428571428571	11729	1
4	Drink 1	Intake 1	19	147969	1337749913	/users/cn/jespinosa/phecomp/data/CRG/20120502_FDF_CRG/20120502_FDF_CRG/20120521_FDF_CRG_c12.mtb	2387	NA	WWFF	water	1	147950	1337749894	1	0.04	0.00210526315789474	11730	1
4	Food 1	Intake 3	242	148602	1337750546	/users/cn/jespinosa/phecomp/data/CRG/20120502_FDF_CRG/20120502_FDF_CRG/20120521_FDF_CRG_c12.mtb	7685	4	WWFF	food_fat	3	148360	1337750304	1	0.0800000000000001	0.000330578512396695	11731	1
4	Drink 2	Intake 2	19	148494	1337750438	/users/cn/jespinosa/phecomp/data/CRG/20120502_FDF_CRG/20120502_FDF_CRG/20120521_FDF_CRG_c12.mtb	2146	NA	WWFF	water	2	148475	1337750419	1	0.0600000000000001	0.00315789473684211	11732	1
4	Food 1	Intake 3	138	148744	1337750688	/users/cn/jespinosa/phecomp/data/CRG/20120502_FDF_CRG/20120502_FDF_CRG/20120521_FDF_CRG_c12.mtb	7686	7	WWFF	food_fat	3	148606	1337750550	1	0.120000000000001	0.000869565217391312	11733	1
4	Food 1	Intake 3	36	148787	1337750731	/users/cn/jespinosa/phecomp/data/CRG/20120502_FDF_CRG/20120502_FDF_CRG/20120521_FDF_CRG_c12.mtb	7687	118	WWFF	food_fat	3	148751	1337750695	1	0.0599999999999987	0.00166666666666663	11734	1
4	Food 1	Intake 3	413	149318	1337751262	/users/cn/jespinosa/phecomp/data/CRG/20120502_FDF_CRG/20120502_FDF_CRG/20120521_FDF_CRG_c12.mtb	7690	COLL	WWFF	food_fat	3	148905	1337750849	1	0.459999999999999	0.0011138014527845	11735	1
4	Drink 1	Intake 1	22	149129	1337751073	/users/cn/jespinosa/phecomp/data/CRG/20120502_FDF_CRG/20120502_FDF_CRG/20120521_FDF_CRG_c12.mtb	2388	NA	WWFF	water	1	149107	1337751051	1	0.0800000000000001	0.00363636363636364	11736	1
4	Food 2	Intake 4	12	149162	1337751106	/users/cn/jespinosa/phecomp/data/CRG/20120502_FDF_CRG/20120502_FDF_CRG/20120521_FDF_CRG_c12.mtb	9492	29	WWFF	food_fat	4	149150	1337751094	1	0.0599999999999987	0.00499999999999989	11737	1
4	Food 2	Intake 4	65	149256	1337751200	/users/cn/jespinosa/phecomp/data/CRG/20120502_FDF_CRG/20120502_FDF_CRG/20120521_FDF_CRG_c12.mtb	9494	116	WWFF	food_fat	4	149191	1337751135	1	0.0400000000000027	0.000615384615384657	11738	1
4	Food 2	Intake 4	28	149400	1337751344	/users/cn/jespinosa/phecomp/data/CRG/20120502_FDF_CRG/20120502_FDF_CRG/20120521_FDF_CRG_c12.mtb	9495	78	WWFF	food_fat	4	149372	1337751316	1	0.0399999999999991	0.0014285714285714	11739	1
4	Food 1	Intake 3	60	149538	1337751482	/users/cn/jespinosa/phecomp/data/CRG/20120502_FDF_CRG/20120502_FDF_CRG/20120521_FDF_CRG_c12.mtb	7693	280	WWFF	food_fat	3	149478	1337751422	1	0.0600000000000005	0.00100000000000001	11740	1
4	Food 1	Intake 3	16	149834	1337751778	/users/cn/jespinosa/phecomp/data/CRG/20120502_FDF_CRG/20120502_FDF_CRG/20120521_FDF_CRG_c12.mtb	7697	285	WWFF	food_fat	3	149818	1337751762	1	0.0200000000000014	0.00125000000000009	11741	1
4	Food 2	Intake 4	12	150131	1337752075	/users/cn/jespinosa/phecomp/data/CRG/20120502_FDF_CRG/20120502_FDF_CRG/20120521_FDF_CRG_c12.mtb	9503	99	WWFF	food_fat	4	150119	1337752063	1	0.0599999999999987	0.00499999999999989	11742	1
4	Food 2	Intake 4	34	150264	1337752208	/users/cn/jespinosa/phecomp/data/CRG/20120502_FDF_CRG/20120502_FDF_CRG/20120521_FDF_CRG_c12.mtb	9505	1454	WWFF	food_fat	4	150230	1337752174	1	0.0800000000000018	0.00235294117647064	11743	1
4	Food 1	Intake 3	8	151726	1337753670	/users/cn/jespinosa/phecomp/data/CRG/20120502_FDF_CRG/20120502_FDF_CRG/20120521_FDF_CRG_c12.mtb	7711	1465	WWFF	food_fat	3	151718	1337753662	1	0.0200000000000014	0.00250000000000017	11744	1
4	Food 1	Intake 3	12	153203	1337755147	/users/cn/jespinosa/phecomp/data/CRG/20120502_FDF_CRG/20120502_FDF_CRG/20120521_FDF_CRG_c12.mtb	7719	335	WWFF	food_fat	3	153191	1337755135	1	0.0200000000000014	0.00166666666666678	11745	1
4	Food 1	Intake 3	168	153706	1337755650	/users/cn/jespinosa/phecomp/data/CRG/20120502_FDF_CRG/20120502_FDF_CRG/20120521_FDF_CRG_c12.mtb	7723	COLL	WWFF	food_fat	3	153538	1337755482	1	0.119999999999999	0.000714285714285708	11746	1
4	Food 2	Intake 4	57	153607	1337755551	/users/cn/jespinosa/phecomp/data/CRG/20120502_FDF_CRG/20120502_FDF_CRG/20120521_FDF_CRG_c12.mtb	9525	131	WWFF	food_fat	4	153550	1337755494	1	0.200000000000003	0.00350877192982461	11747	1
4	Drink 2	Intake 2	15	153741	1337755685	/users/cn/jespinosa/phecomp/data/CRG/20120502_FDF_CRG/20120502_FDF_CRG/20120521_FDF_CRG_c12.mtb	2149	NA	WWFF	water	2	153726	1337755670	1	0.04	0.00266666666666667	11748	1
4	Food 1	Intake 3	123	153861	1337755805	/users/cn/jespinosa/phecomp/data/CRG/20120502_FDF_CRG/20120502_FDF_CRG/20120521_FDF_CRG_c12.mtb	7725	101	WWFF	food_fat	3	153738	1337755682	1	0.0600000000000005	0.000487804878048785	11749	1
4	Food 2	Intake 4	31	153993	1337755937	/users/cn/jespinosa/phecomp/data/CRG/20120502_FDF_CRG/20120502_FDF_CRG/20120521_FDF_CRG_c12.mtb	9528	388	WWFF	food_fat	4	153962	1337755906	1	0.0600000000000023	0.00193548387096782	11750	1
4	Drink 1	Intake 1	45	154332	1337756276	/users/cn/jespinosa/phecomp/data/CRG/20120502_FDF_CRG/20120502_FDF_CRG/20120521_FDF_CRG_c12.mtb	2389	NA	WWFF	water	1	154287	1337756231	1	0.0800000000000001	0.00177777777777778	11751	1
4	Food 1	Intake 3	51	154432	1337756376	/users/cn/jespinosa/phecomp/data/CRG/20120502_FDF_CRG/20120502_FDF_CRG/20120521_FDF_CRG_c12.mtb	7731	4767	WWFF	food_fat	3	154381	1337756325	1	0.0200000000000014	0.000392156862745125	11752	1
4	Drink 1	Intake 1	23	155659	1337757603	/users/cn/jespinosa/phecomp/data/CRG/20120502_FDF_CRG/20120502_FDF_CRG/20120521_FDF_CRG_c12.mtb	2390	NA	WWFF	water	1	155636	1337757580	1	0.0799999999999996	0.0034782608695652	11753	1
4	Drink 1	Intake 1	26	158771	1337760715	/users/cn/jespinosa/phecomp/data/CRG/20120502_FDF_CRG/20120502_FDF_CRG/20120521_FDF_CRG_c12.mtb	2391	NA	WWFF	water	1	158745	1337760689	1	0.1	0.00384615384615385	11754	1
4	Food 1	Intake 3	19	159218	1337761162	/users/cn/jespinosa/phecomp/data/CRG/20120502_FDF_CRG/20120502_FDF_CRG/20120521_FDF_CRG_c12.mtb	7753	789	WWFF	food_fat	3	159199	1337761143	1	0.0200000000000014	0.00105263157894744	11755	1
4	Drink 1	Intake 1	16	159977	1337761921	/users/cn/jespinosa/phecomp/data/CRG/20120502_FDF_CRG/20120502_FDF_CRG/20120521_FDF_CRG_c12.mtb	2392	NA	WWFF	water	1	159961	1337761905	1	0.04	0.0025	11756	1
4	Food 1	Intake 3	37	160044	1337761988	/users/cn/jespinosa/phecomp/data/CRG/20120502_FDF_CRG/20120502_FDF_CRG/20120521_FDF_CRG_c12.mtb	7760	1659	WWFF	food_fat	3	160007	1337761951	1	0.0400000000000009	0.00108108108108111	11757	1
4	Food 2	Intake 4	14	161717	1337763661	/users/cn/jespinosa/phecomp/data/CRG/20120502_FDF_CRG/20120502_FDF_CRG/20120521_FDF_CRG_c12.mtb	9549	41	WWFF	food_fat	4	161703	1337763647	1	0.0799999999999983	0.00571428571428559	11758	1
4	Food 2	Intake 4	13	161771	1337763715	/users/cn/jespinosa/phecomp/data/CRG/20120502_FDF_CRG/20120502_FDF_CRG/20120521_FDF_CRG_c12.mtb	9550	59	WWFF	food_fat	4	161758	1337763702	1	0.0200000000000031	0.00153846153846178	11759	1
4	Food 1	Intake 3	49	161879	1337763823	/users/cn/jespinosa/phecomp/data/CRG/20120502_FDF_CRG/20120502_FDF_CRG/20120521_FDF_CRG_c12.mtb	7772	239	WWFF	food_fat	3	161830	1337763774	1	0.0400000000000009	0.000816326530612263	11760	1
4	Food 1	Intake 3	624	162742	1337764686	/users/cn/jespinosa/phecomp/data/CRG/20120502_FDF_CRG/20120502_FDF_CRG/20120521_FDF_CRG_c12.mtb	7774	1070	WWFF	food_fat	3	162118	1337764062	1	0.0600000000000005	9.6153846153847e-05	11761	1
4	Drink 1	Intake 1	27	162729	1337764673	/users/cn/jespinosa/phecomp/data/CRG/20120502_FDF_CRG/20120502_FDF_CRG/20120521_FDF_CRG_c12.mtb	2393	LAST	WWFF	water	1	162702	1337764646	1	0.1	0.0037037037037037	11762	1
4	Food 1	Intake 3	22	163834	1337765778	/users/cn/jespinosa/phecomp/data/CRG/20120502_FDF_CRG/20120502_FDF_CRG/20120521_FDF_CRG_c12.mtb	7784	139	WWFF	food_fat	3	163812	1337765756	1	0.0399999999999991	0.00181818181818178	11763	1
4	Food 1	Intake 3	60	164033	1337765977	/users/cn/jespinosa/phecomp/data/CRG/20120502_FDF_CRG/20120502_FDF_CRG/20120521_FDF_CRG_c12.mtb	7785	LAST	WWFF	food_fat	3	163973	1337765917	1	0.0200000000000014	0.000333333333333357	11764	1
