CAGE	Caption	Channel	Duration	EndL	EndT	File	Index	InterTime	Name	Nature	SlotI	StartL	StartT	Type	Value	Velocity	linen	period
2	Drink 2	Intake 2	40	1654	1335959662	/users/cn/jespinosa/phecomp/data/CRG/20120502_FDF_CRG/20120502_FDF_CRG/20120502_FDF_CRG_c12.mtb	106	NA	WWSS	water	2	1614	1335959622	1	0.02	0.0005	4790	1
2	Food 1	Intake 3	68	1850	1335959858	/users/cn/jespinosa/phecomp/data/CRG/20120502_FDF_CRG/20120502_FDF_CRG/20120502_FDF_CRG_c12.mtb	212	1160	WWSS	food_sc	3	1782	1335959790	1	0.02	0.000294117647058824	4791	1
2	Food 1	Intake 3	33	3043	1335961051	/users/cn/jespinosa/phecomp/data/CRG/20120502_FDF_CRG/20120502_FDF_CRG/20120502_FDF_CRG_c12.mtb	214	4	WWSS	food_sc	3	3010	1335961018	1	0.02	0.000606060606060606	4792	1
2	Food 1	Intake 3	52	3099	1335961107	/users/cn/jespinosa/phecomp/data/CRG/20120502_FDF_CRG/20120502_FDF_CRG/20120502_FDF_CRG_c12.mtb	215	8797	WWSS	food_sc	3	3047	1335961055	1	0.02	0.000384615384615385	4793	1
2	Drink 1	Intake 1	18	3641	1335961649	/users/cn/jespinosa/phecomp/data/CRG/20120502_FDF_CRG/20120502_FDF_CRG/20120502_FDF_CRG_c12.mtb	118	NA	WWSS	water	1	3623	1335961631	1	0.02	0.00111111111111111	4794	1
2	Drink 2	Intake 2	21	4513	1335962521	/users/cn/jespinosa/phecomp/data/CRG/20120502_FDF_CRG/20120502_FDF_CRG/20120502_FDF_CRG_c12.mtb	120	NA	WWSS	water	2	4492	1335962500	1	0.02	0.000952380952380952	4795	1
2	Drink 2	Intake 2	50	4780	1335962788	/users/cn/jespinosa/phecomp/data/CRG/20120502_FDF_CRG/20120502_FDF_CRG/20120502_FDF_CRG_c12.mtb	123	NA	WWSS	water	2	4730	1335962738	1	0.02	0.0004	4796	1
2	Drink 2	Intake 2	20	4822	1335962830	/users/cn/jespinosa/phecomp/data/CRG/20120502_FDF_CRG/20120502_FDF_CRG/20120502_FDF_CRG_c12.mtb	124	NA	WWSS	water	2	4802	1335962810	1	0.02	0.001	4797	1
2	Drink 2	Intake 2	20	5725	1335963733	/users/cn/jespinosa/phecomp/data/CRG/20120502_FDF_CRG/20120502_FDF_CRG/20120502_FDF_CRG_c12.mtb	129	NA	WWSS	water	2	5705	1335963713	1	0.02	0.001	4798	1
2	Food 1	Intake 3	153	12049	1335970057	/users/cn/jespinosa/phecomp/data/CRG/20120502_FDF_CRG/20120502_FDF_CRG/20120502_FDF_CRG_c12.mtb	227	3272	WWSS	food_sc	3	11896	1335969904	1	0.06	0.000392156862745098	4799	1
2	Food 2	Intake 4	202	15523	1335973531	/users/cn/jespinosa/phecomp/data/CRG/20120502_FDF_CRG/20120502_FDF_CRG/20120502_FDF_CRG_c12.mtb	485	150	WWSS	food_sc	4	15321	1335973329	1	0.06	0.000297029702970297	4800	1
2	Food 2	Intake 4	67	15740	1335973748	/users/cn/jespinosa/phecomp/data/CRG/20120502_FDF_CRG/20120502_FDF_CRG/20120502_FDF_CRG_c12.mtb	486	15	WWSS	food_sc	4	15673	1335973681	1	0.02	0.000298507462686567	4801	1
2	Food 2	Intake 4	19	15774	1335973782	/users/cn/jespinosa/phecomp/data/CRG/20120502_FDF_CRG/20120502_FDF_CRG/20120502_FDF_CRG_c12.mtb	487	4878	WWSS	food_sc	4	15755	1335973763	1	0.02	0.00105263157894737	4802	1
2	Food 1	Intake 3	553	21205	1335979213	/users/cn/jespinosa/phecomp/data/CRG/20120502_FDF_CRG/20120502_FDF_CRG/20120502_FDF_CRG_c12.mtb	234	3465	WWSS	food_sc	3	20652	1335978660	1	0.14	0.000253164556962025	4803	1
2	Drink 2	Intake 2	22	21225	1335979233	/users/cn/jespinosa/phecomp/data/CRG/20120502_FDF_CRG/20120502_FDF_CRG/20120502_FDF_CRG_c12.mtb	136	NA	WWSS	water	2	21203	1335979211	1	0.02	0.000909090909090909	4804	1
2	Drink 1	Intake 1	17	21435	1335979443	/users/cn/jespinosa/phecomp/data/CRG/20120502_FDF_CRG/20120502_FDF_CRG/20120502_FDF_CRG_c12.mtb	120	NA	WWSS	water	1	21418	1335979426	1	0.02	0.00117647058823529	4805	1
2	Drink 2	Intake 2	39	21721	1335979729	/users/cn/jespinosa/phecomp/data/CRG/20120502_FDF_CRG/20120502_FDF_CRG/20120502_FDF_CRG_c12.mtb	138	NA	WWSS	water	2	21682	1335979690	1	0.02	0.000512820512820513	4806	1
2	Drink 2	Intake 2	36	21845	1335979853	/users/cn/jespinosa/phecomp/data/CRG/20120502_FDF_CRG/20120502_FDF_CRG/20120502_FDF_CRG_c12.mtb	139	NA	WWSS	water	2	21809	1335979817	1	0.04	0.00111111111111111	4807	1
2	Drink 1	Intake 1	19	21879	1335979887	/users/cn/jespinosa/phecomp/data/CRG/20120502_FDF_CRG/20120502_FDF_CRG/20120502_FDF_CRG_c12.mtb	121	NA	WWSS	water	1	21860	1335979868	1	0.02	0.00105263157894737	4808	1
2	Food 2	Intake 4	346	25016	1335983024	/users/cn/jespinosa/phecomp/data/CRG/20120502_FDF_CRG/20120502_FDF_CRG/20120502_FDF_CRG_c12.mtb	492	1595	WWSS	food_sc	4	24670	1335982678	1	0.08	0.00023121387283237	4809	1
2	Food 1	Intake 3	120	26731	1335984739	/users/cn/jespinosa/phecomp/data/CRG/20120502_FDF_CRG/20120502_FDF_CRG/20120502_FDF_CRG_c12.mtb	239	788	WWSS	food_sc	3	26611	1335984619	1	0.06	0.0005	4810	1
2	Drink 2	Intake 2	18	26904	1335984912	/users/cn/jespinosa/phecomp/data/CRG/20120502_FDF_CRG/20120502_FDF_CRG/20120502_FDF_CRG_c12.mtb	142	NA	WWSS	water	2	26886	1335984894	1	0.02	0.00111111111111111	4811	1
2	Food 2	Intake 4	176	27695	1335985703	/users/cn/jespinosa/phecomp/data/CRG/20120502_FDF_CRG/20120502_FDF_CRG/20120502_FDF_CRG_c12.mtb	494	191	WWSS	food_sc	4	27519	1335985527	1	0.02	0.000113636363636364	4812	1
2	Food 2	Intake 4	97	27983	1335985991	/users/cn/jespinosa/phecomp/data/CRG/20120502_FDF_CRG/20120502_FDF_CRG/20120502_FDF_CRG_c12.mtb	496	294	WWSS	food_sc	4	27886	1335985894	1	0.02	0.000206185567010309	4813	1
2	Food 1	Intake 3	168	28445	1335986453	/users/cn/jespinosa/phecomp/data/CRG/20120502_FDF_CRG/20120502_FDF_CRG/20120502_FDF_CRG_c12.mtb	244	1316	WWSS	food_sc	3	28277	1335986285	1	0.04	0.000238095238095238	4814	1
2	Drink 2	Intake 2	39	28807	1335986815	/users/cn/jespinosa/phecomp/data/CRG/20120502_FDF_CRG/20120502_FDF_CRG/20120502_FDF_CRG_c12.mtb	148	NA	WWSS	water	2	28768	1335986776	1	0.04	0.00102564102564103	4815	1
2	Food 1	Intake 3	214	29975	1335987983	/users/cn/jespinosa/phecomp/data/CRG/20120502_FDF_CRG/20120502_FDF_CRG/20120502_FDF_CRG_c12.mtb	246	660	WWSS	food_sc	3	29761	1335987769	1	0.06	0.000280373831775701	4816	1
2	Drink 2	Intake 2	23	30128	1335988136	/users/cn/jespinosa/phecomp/data/CRG/20120502_FDF_CRG/20120502_FDF_CRG/20120502_FDF_CRG_c12.mtb	149	NA	WWSS	water	2	30105	1335988113	1	0.06	0.00260869565217391	4817	1
2	Drink 1	Intake 1	17	30630	1335988638	/users/cn/jespinosa/phecomp/data/CRG/20120502_FDF_CRG/20120502_FDF_CRG/20120502_FDF_CRG_c12.mtb	124	NA	WWSS	water	1	30613	1335988621	1	0.04	0.00235294117647059	4818	1
2	Food 1	Intake 3	742	31377	1335989385	/users/cn/jespinosa/phecomp/data/CRG/20120502_FDF_CRG/20120502_FDF_CRG/20120502_FDF_CRG_c12.mtb	252	8	WWSS	food_sc	3	30635	1335988643	1	0.2	0.000269541778975741	4819	1
2	Food 1	Intake 3	44	31429	1335989437	/users/cn/jespinosa/phecomp/data/CRG/20120502_FDF_CRG/20120502_FDF_CRG/20120502_FDF_CRG_c12.mtb	253	155	WWSS	food_sc	3	31385	1335989393	1	0.02	0.000454545454545455	4820	1
2	Drink 2	Intake 2	29	31512	1335989520	/users/cn/jespinosa/phecomp/data/CRG/20120502_FDF_CRG/20120502_FDF_CRG/20120502_FDF_CRG_c12.mtb	150	NA	WWSS	water	2	31483	1335989491	1	0.04	0.00137931034482759	4821	1
2	Drink 2	Intake 2	25	31577	1335989585	/users/cn/jespinosa/phecomp/data/CRG/20120502_FDF_CRG/20120502_FDF_CRG/20120502_FDF_CRG_c12.mtb	152	NA	WWSS	water	2	31552	1335989560	1	0.02	0.0008	4822	1
2	Food 1	Intake 3	81	31665	1335989673	/users/cn/jespinosa/phecomp/data/CRG/20120502_FDF_CRG/20120502_FDF_CRG/20120502_FDF_CRG_c12.mtb	254	851	WWSS	food_sc	3	31584	1335989592	1	0.02	0.000246913580246914	4823	1
2	Drink 2	Intake 2	19	31708	1335989716	/users/cn/jespinosa/phecomp/data/CRG/20120502_FDF_CRG/20120502_FDF_CRG/20120502_FDF_CRG_c12.mtb	153	NA	WWSS	water	2	31689	1335989697	1	0.06	0.00315789473684211	4824	1
2	Drink 1	Intake 1	17	31782	1335989790	/users/cn/jespinosa/phecomp/data/CRG/20120502_FDF_CRG/20120502_FDF_CRG/20120502_FDF_CRG_c12.mtb	125	NA	WWSS	water	1	31765	1335989773	1	0.06	0.00352941176470588	4825	1
2	Drink 2	Intake 2	43	32502	1335990510	/users/cn/jespinosa/phecomp/data/CRG/20120502_FDF_CRG/20120502_FDF_CRG/20120502_FDF_CRG_c12.mtb	160	NA	WWSS	water	2	32459	1335990467	1	0.02	0.000465116279069767	4826	1
2	Food 2	Intake 4	17	32533	1335990541	/users/cn/jespinosa/phecomp/data/CRG/20120502_FDF_CRG/20120502_FDF_CRG/20120502_FDF_CRG_c12.mtb	502	2849	WWSS	food_sc	4	32516	1335990524	1	0.02	0.00117647058823529	4827	1
2	Food 1	Intake 3	17	35399	1335993407	/users/cn/jespinosa/phecomp/data/CRG/20120502_FDF_CRG/20120502_FDF_CRG/20120502_FDF_CRG_c12.mtb	261	1121	WWSS	food_sc	3	35382	1335993390	1	0.02	0.00117647058823529	4828	1
2	Food 1	Intake 3	158	36678	1335994686	/users/cn/jespinosa/phecomp/data/CRG/20120502_FDF_CRG/20120502_FDF_CRG/20120502_FDF_CRG_c12.mtb	263	1476	WWSS	food_sc	3	36520	1335994528	1	0.0399999999999999	0.000253164556962025	4829	1
2	Drink 2	Intake 2	24	36784	1335994792	/users/cn/jespinosa/phecomp/data/CRG/20120502_FDF_CRG/20120502_FDF_CRG/20120502_FDF_CRG_c12.mtb	169	NA	WWSS	water	2	36760	1335994768	1	0.02	0.000833333333333333	4830	1
2	Food 1	Intake 3	48	38202	1335996210	/users/cn/jespinosa/phecomp/data/CRG/20120502_FDF_CRG/20120502_FDF_CRG/20120502_FDF_CRG_c12.mtb	266	7	WWSS	food_sc	3	38154	1335996162	1	0.02	0.000416666666666667	4831	1
2	Food 1	Intake 3	112	38321	1335996329	/users/cn/jespinosa/phecomp/data/CRG/20120502_FDF_CRG/20120502_FDF_CRG/20120502_FDF_CRG_c12.mtb	267	1447	WWSS	food_sc	3	38209	1335996217	1	0.02	0.000178571428571429	4832	1
2	Food 1	Intake 3	188	39956	1335997964	/users/cn/jespinosa/phecomp/data/CRG/20120502_FDF_CRG/20120502_FDF_CRG/20120502_FDF_CRG_c12.mtb	274	2098	WWSS	food_sc	3	39768	1335997776	1	0.02	0.000106382978723404	4833	1
2	Drink 2	Intake 2	16	39976	1335997984	/users/cn/jespinosa/phecomp/data/CRG/20120502_FDF_CRG/20120502_FDF_CRG/20120502_FDF_CRG_c12.mtb	175	NA	WWSS	water	2	39960	1335997968	1	0.02	0.00125	4834	1
2	Food 1	Intake 3	149	42203	1336000211	/users/cn/jespinosa/phecomp/data/CRG/20120502_FDF_CRG/20120502_FDF_CRG/20120502_FDF_CRG_c12.mtb	280	1852	WWSS	food_sc	3	42054	1336000062	1	0.02	0.000134228187919463	4835	1
2	Drink 2	Intake 2	23	42476	1336000484	/users/cn/jespinosa/phecomp/data/CRG/20120502_FDF_CRG/20120502_FDF_CRG/20120502_FDF_CRG_c12.mtb	191	NA	WWSS	water	2	42453	1336000461	1	0.02	0.000869565217391304	4836	1
2	Drink 1	Intake 1	20	42732	1336000740	/users/cn/jespinosa/phecomp/data/CRG/20120502_FDF_CRG/20120502_FDF_CRG/20120502_FDF_CRG_c12.mtb	134	NA	WWSS	water	1	42712	1336000720	1	0.04	0.002	4837	1
2	Drink 1	Intake 1	34	42954	1336000962	/users/cn/jespinosa/phecomp/data/CRG/20120502_FDF_CRG/20120502_FDF_CRG/20120502_FDF_CRG_c12.mtb	135	NA	WWSS	water	1	42920	1336000928	1	0.04	0.00117647058823529	4838	1
2	Food 2	Intake 4	859	44914	1336002922	/users/cn/jespinosa/phecomp/data/CRG/20120502_FDF_CRG/20120502_FDF_CRG/20120502_FDF_CRG_c12.mtb	520	7365	WWSS	food_sc	4	44055	1336002063	1	0.24	0.000279394644935972	4839	1
2	Drink 1	Intake 1	25	44973	1336002981	/users/cn/jespinosa/phecomp/data/CRG/20120502_FDF_CRG/20120502_FDF_CRG/20120502_FDF_CRG_c12.mtb	137	NA	WWSS	water	1	44948	1336002956	1	0.08	0.0032	4840	1
2	Drink 1	Intake 1	17	45079	1336003087	/users/cn/jespinosa/phecomp/data/CRG/20120502_FDF_CRG/20120502_FDF_CRG/20120502_FDF_CRG_c12.mtb	138	NA	WWSS	water	1	45062	1336003070	1	0.04	0.00235294117647059	4841	1
2	Drink 1	Intake 1	24	45175	1336003183	/users/cn/jespinosa/phecomp/data/CRG/20120502_FDF_CRG/20120502_FDF_CRG/20120502_FDF_CRG_c12.mtb	139	NA	WWSS	water	1	45151	1336003159	1	0.04	0.00166666666666667	4842	1
2	Drink 2	Intake 2	31	45301	1336003309	/users/cn/jespinosa/phecomp/data/CRG/20120502_FDF_CRG/20120502_FDF_CRG/20120502_FDF_CRG_c12.mtb	204	NA	WWSS	water	2	45270	1336003278	1	0.02	0.000645161290322581	4843	1
2	Drink 1	Intake 1	20	45452	1336003460	/users/cn/jespinosa/phecomp/data/CRG/20120502_FDF_CRG/20120502_FDF_CRG/20120502_FDF_CRG_c12.mtb	140	NA	WWSS	water	1	45432	1336003440	1	0.06	0.003	4844	1
2	Food 2	Intake 4	54	52333	1336010341	/users/cn/jespinosa/phecomp/data/CRG/20120502_FDF_CRG/20120502_FDF_CRG/20120502_FDF_CRG_c12.mtb	523	15	WWSS	food_sc	4	52279	1336010287	1	0.02	0.00037037037037037	4845	1
2	Food 2	Intake 4	470	52818	1336010826	/users/cn/jespinosa/phecomp/data/CRG/20120502_FDF_CRG/20120502_FDF_CRG/20120502_FDF_CRG_c12.mtb	524	21	WWSS	food_sc	4	52348	1336010356	1	0.1	0.000212765957446809	4846	1
2	Food 2	Intake 4	148	52987	1336010995	/users/cn/jespinosa/phecomp/data/CRG/20120502_FDF_CRG/20120502_FDF_CRG/20120502_FDF_CRG_c12.mtb	525	542	WWSS	food_sc	4	52839	1336010847	1	0.02	0.000135135135135135	4847	1
2	Drink 1	Intake 1	26	53007	1336011015	/users/cn/jespinosa/phecomp/data/CRG/20120502_FDF_CRG/20120502_FDF_CRG/20120502_FDF_CRG_c12.mtb	141	NA	WWSS	water	1	52981	1336010989	1	0.1	0.00384615384615385	4848	1
2	Drink 2	Intake 2	45	53403	1336011411	/users/cn/jespinosa/phecomp/data/CRG/20120502_FDF_CRG/20120502_FDF_CRG/20120502_FDF_CRG_c12.mtb	209	NA	WWSS	water	2	53358	1336011366	1	0.04	0.000888888888888889	4849	1
2	Food 2	Intake 4	705	54234	1336012242	/users/cn/jespinosa/phecomp/data/CRG/20120502_FDF_CRG/20120502_FDF_CRG/20120502_FDF_CRG_c12.mtb	529	141	WWSS	food_sc	4	53529	1336011537	1	0.16	0.000226950354609929	4850	1
2	Drink 1	Intake 1	28	54281	1336012289	/users/cn/jespinosa/phecomp/data/CRG/20120502_FDF_CRG/20120502_FDF_CRG/20120502_FDF_CRG_c12.mtb	142	NA	WWSS	water	1	54253	1336012261	1	0.1	0.00357142857142857	4851	1
2	Food 2	Intake 4	24	54399	1336012407	/users/cn/jespinosa/phecomp/data/CRG/20120502_FDF_CRG/20120502_FDF_CRG/20120502_FDF_CRG_c12.mtb	530	341	WWSS	food_sc	4	54375	1336012383	1	0.02	0.000833333333333333	4852	1
2	Drink 1	Intake 1	30	54630	1336012638	/users/cn/jespinosa/phecomp/data/CRG/20120502_FDF_CRG/20120502_FDF_CRG/20120502_FDF_CRG_c12.mtb	144	NA	WWSS	water	1	54600	1336012608	1	0.1	0.00333333333333333	4853	1
2	Food 2	Intake 4	108	54848	1336012856	/users/cn/jespinosa/phecomp/data/CRG/20120502_FDF_CRG/20120502_FDF_CRG/20120502_FDF_CRG_c12.mtb	531	22	WWSS	food_sc	4	54740	1336012748	1	0.0599999999999999	0.000555555555555555	4854	1
2	Food 2	Intake 4	197	55067	1336013075	/users/cn/jespinosa/phecomp/data/CRG/20120502_FDF_CRG/20120502_FDF_CRG/20120502_FDF_CRG_c12.mtb	532	7364	WWSS	food_sc	4	54870	1336012878	1	0.0600000000000001	0.000304568527918782	4855	1
2	Drink 2	Intake 2	28	55101	1336013109	/users/cn/jespinosa/phecomp/data/CRG/20120502_FDF_CRG/20120502_FDF_CRG/20120502_FDF_CRG_c12.mtb	213	NA	WWSS	water	2	55073	1336013081	1	0.02	0.000714285714285714	4856	1
2	Drink 1	Intake 1	25	55167	1336013175	/users/cn/jespinosa/phecomp/data/CRG/20120502_FDF_CRG/20120502_FDF_CRG/20120502_FDF_CRG_c12.mtb	145	NA	WWSS	water	1	55142	1336013150	1	0.04	0.0016	4857	1
2	Drink 2	Intake 2	11	55380	1336013388	/users/cn/jespinosa/phecomp/data/CRG/20120502_FDF_CRG/20120502_FDF_CRG/20120502_FDF_CRG_c12.mtb	215	NA	WWSS	water	2	55369	1336013377	1	0.02	0.00181818181818182	4858	1
2	Drink 1	Intake 1	22	56616	1336014624	/users/cn/jespinosa/phecomp/data/CRG/20120502_FDF_CRG/20120502_FDF_CRG/20120502_FDF_CRG_c12.mtb	148	NA	WWSS	water	1	56594	1336014602	1	0.0599999999999999	0.00272727272727272	4859	1
2	Food 2	Intake 4	202	62633	1336020641	/users/cn/jespinosa/phecomp/data/CRG/20120502_FDF_CRG/20120502_FDF_CRG/20120502_FDF_CRG_c12.mtb	539	73	WWSS	food_sc	4	62431	1336020439	1	0.02	9.9009900990099e-05	4860	1
2	Drink 1	Intake 1	54	62688	1336020696	/users/cn/jespinosa/phecomp/data/CRG/20120502_FDF_CRG/20120502_FDF_CRG/20120502_FDF_CRG_c12.mtb	151	NA	WWSS	water	1	62634	1336020642	1	0.1	0.00185185185185185	4861	1
2	Drink 2	Intake 2	15	62701	1336020709	/users/cn/jespinosa/phecomp/data/CRG/20120502_FDF_CRG/20120502_FDF_CRG/20120502_FDF_CRG_c12.mtb	226	NA	WWSS	water	2	62686	1336020694	1	0.02	0.00133333333333333	4862	1
2	Food 2	Intake 4	218	62924	1336020932	/users/cn/jespinosa/phecomp/data/CRG/20120502_FDF_CRG/20120502_FDF_CRG/20120502_FDF_CRG_c12.mtb	540	2381	WWSS	food_sc	4	62706	1336020714	1	0.0600000000000001	0.000275229357798166	4863	1
2	Drink 1	Intake 1	21	63064	1336021072	/users/cn/jespinosa/phecomp/data/CRG/20120502_FDF_CRG/20120502_FDF_CRG/20120502_FDF_CRG_c12.mtb	153	NA	WWSS	water	1	63043	1336021051	1	0.0600000000000001	0.00285714285714286	4864	1
2	Drink 1	Intake 1	35	64022	1336022030	/users/cn/jespinosa/phecomp/data/CRG/20120502_FDF_CRG/20120502_FDF_CRG/20120502_FDF_CRG_c12.mtb	155	NA	WWSS	water	1	63987	1336021995	1	0.1	0.00285714285714286	4865	1
2	Drink 1	Intake 1	30	64105	1336022113	/users/cn/jespinosa/phecomp/data/CRG/20120502_FDF_CRG/20120502_FDF_CRG/20120502_FDF_CRG_c12.mtb	157	NA	WWSS	water	1	64075	1336022083	1	0.0599999999999998	0.00199999999999999	4866	1
2	Food 2	Intake 4	21	65326	1336023334	/users/cn/jespinosa/phecomp/data/CRG/20120502_FDF_CRG/20120502_FDF_CRG/20120502_FDF_CRG_c12.mtb	552	5979	WWSS	food_sc	4	65305	1336023313	1	0.02	0.000952380952380952	4867	1
2	Drink 2	Intake 2	15	71274	1336029282	/users/cn/jespinosa/phecomp/data/CRG/20120502_FDF_CRG/20120502_FDF_CRG/20120502_FDF_CRG_c12.mtb	244	NA	WWSS	water	2	71259	1336029267	1	0.02	0.00133333333333333	4868	1
2	Food 2	Intake 4	541	71846	1336029854	/users/cn/jespinosa/phecomp/data/CRG/20120502_FDF_CRG/20120502_FDF_CRG/20120502_FDF_CRG_c12.mtb	554	56	WWSS	food_sc	4	71305	1336029313	1	0.02	3.69685767097967e-05	4869	1
2	Food 2	Intake 4	193	72095	1336030103	/users/cn/jespinosa/phecomp/data/CRG/20120502_FDF_CRG/20120502_FDF_CRG/20120502_FDF_CRG_c12.mtb	555	34	WWSS	food_sc	4	71902	1336029910	1	0.02	0.000103626943005181	4870	1
2	Food 2	Intake 4	114	72243	1336030251	/users/cn/jespinosa/phecomp/data/CRG/20120502_FDF_CRG/20120502_FDF_CRG/20120502_FDF_CRG_c12.mtb	556	19513	WWSS	food_sc	4	72129	1336030137	1	0.02	0.000175438596491228	4871	1
2	Drink 2	Intake 2	41	72465	1336030473	/users/cn/jespinosa/phecomp/data/CRG/20120502_FDF_CRG/20120502_FDF_CRG/20120502_FDF_CRG_c12.mtb	249	NA	WWSS	water	2	72424	1336030432	1	0.0399999999999999	0.000975609756097558	4872	1
2	Drink 2	Intake 2	36	72685	1336030693	/users/cn/jespinosa/phecomp/data/CRG/20120502_FDF_CRG/20120502_FDF_CRG/20120502_FDF_CRG_c12.mtb	250	NA	WWSS	water	2	72649	1336030657	1	0.04	0.00111111111111111	4873	1
2	Drink 2	Intake 2	26	83865	1336041873	/users/cn/jespinosa/phecomp/data/CRG/20120502_FDF_CRG/20120502_FDF_CRG/20120502_FDF_CRG_c12.mtb	256	NA	WWSS	water	2	83839	1336041847	1	0.02	0.000769230769230769	4874	1
2	Food 2	Intake 4	157	91913	1336049921	/users/cn/jespinosa/phecomp/data/CRG/20120502_FDF_CRG/20120502_FDF_CRG/20120502_FDF_CRG_c12.mtb	562	16994	WWSS	food_sc	4	91756	1336049764	1	0.02	0.000127388535031847	4875	1
2	Drink 1	Intake 1	23	93479	1336051487	/users/cn/jespinosa/phecomp/data/CRG/20120502_FDF_CRG/20120502_FDF_CRG/20120502_FDF_CRG_c12.mtb	161	NA	WWSS	water	1	93456	1336051464	1	0.02	0.000869565217391304	4876	1
2	Food 1	Intake 3	139	109046	1336067054	/users/cn/jespinosa/phecomp/data/CRG/20120502_FDF_CRG/20120502_FDF_CRG/20120502_FDF_CRG_c12.mtb	307	30	WWSS	food_sc	3	108907	1336066915	1	0.02	0.000143884892086331	4877	1
2	Food 1	Intake 3	673	109749	1336067757	/users/cn/jespinosa/phecomp/data/CRG/20120502_FDF_CRG/20120502_FDF_CRG/20120502_FDF_CRG_c12.mtb	308	16	WWSS	food_sc	3	109076	1336067084	1	0.14	0.000208023774145617	4878	1
2	Food 1	Intake 3	48	109813	1336067821	/users/cn/jespinosa/phecomp/data/CRG/20120502_FDF_CRG/20120502_FDF_CRG/20120502_FDF_CRG_c12.mtb	309	3078	WWSS	food_sc	3	109765	1336067773	1	0.02	0.000416666666666667	4879	1
2	Drink 1	Intake 1	31	109879	1336067887	/users/cn/jespinosa/phecomp/data/CRG/20120502_FDF_CRG/20120502_FDF_CRG/20120502_FDF_CRG_c12.mtb	162	NA	WWSS	water	1	109848	1336067856	1	0.0600000000000001	0.00193548387096775	4880	1
2	Drink 1	Intake 1	20	110015	1336068023	/users/cn/jespinosa/phecomp/data/CRG/20120502_FDF_CRG/20120502_FDF_CRG/20120502_FDF_CRG_c12.mtb	163	NA	WWSS	water	1	109995	1336068003	1	0.04	0.002	4881	1
2	Food 1	Intake 3	267	113158	1336071166	/users/cn/jespinosa/phecomp/data/CRG/20120502_FDF_CRG/20120502_FDF_CRG/20120502_FDF_CRG_c12.mtb	315	547	WWSS	food_sc	3	112891	1336070899	1	0.02	7.49063670411985e-05	4882	1
2	Food 1	Intake 3	186	113891	1336071899	/users/cn/jespinosa/phecomp/data/CRG/20120502_FDF_CRG/20120502_FDF_CRG/20120502_FDF_CRG_c12.mtb	316	76	WWSS	food_sc	3	113705	1336071713	1	0.04	0.00021505376344086	4883	1
2	Food 1	Intake 3	254	114221	1336072229	/users/cn/jespinosa/phecomp/data/CRG/20120502_FDF_CRG/20120502_FDF_CRG/20120502_FDF_CRG_c12.mtb	317	604	WWSS	food_sc	3	113967	1336071975	1	0.0800000000000001	0.00031496062992126	4884	1
2	Drink 2	Intake 2	39	114482	1336072490	/users/cn/jespinosa/phecomp/data/CRG/20120502_FDF_CRG/20120502_FDF_CRG/20120502_FDF_CRG_c12.mtb	272	NA	WWSS	water	2	114443	1336072451	1	0.04	0.00102564102564103	4885	1
2	Food 1	Intake 3	350	115175	1336073183	/users/cn/jespinosa/phecomp/data/CRG/20120502_FDF_CRG/20120502_FDF_CRG/20120502_FDF_CRG_c12.mtb	319	783	WWSS	food_sc	3	114825	1336072833	1	0.12	0.000342857142857143	4886	1
2	Drink 2	Intake 2	38	115215	1336073223	/users/cn/jespinosa/phecomp/data/CRG/20120502_FDF_CRG/20120502_FDF_CRG/20120502_FDF_CRG_c12.mtb	275	NA	WWSS	water	2	115177	1336073185	1	0.1	0.00263157894736842	4887	1
2	Drink 2	Intake 2	97	115694	1336073702	/users/cn/jespinosa/phecomp/data/CRG/20120502_FDF_CRG/20120502_FDF_CRG/20120502_FDF_CRG_c12.mtb	277	NA	WWSS	water	2	115597	1336073605	1	0.0399999999999999	0.000412371134020617	4888	1
2	Food 1	Intake 3	192	116150	1336074158	/users/cn/jespinosa/phecomp/data/CRG/20120502_FDF_CRG/20120502_FDF_CRG/20120502_FDF_CRG_c12.mtb	323	313	WWSS	food_sc	3	115958	1336073966	1	0.02	0.000104166666666667	4889	1
2	Drink 1	Intake 1	24	116456	1336074464	/users/cn/jespinosa/phecomp/data/CRG/20120502_FDF_CRG/20120502_FDF_CRG/20120502_FDF_CRG_c12.mtb	171	NA	WWSS	water	1	116432	1336074440	1	0.02	0.000833333333333333	4890	1
2	Food 1	Intake 3	141	116604	1336074612	/users/cn/jespinosa/phecomp/data/CRG/20120502_FDF_CRG/20120502_FDF_CRG/20120502_FDF_CRG_c12.mtb	325	321	WWSS	food_sc	3	116463	1336074471	1	0.02	0.000141843971631206	4891	1
2	Food 1	Intake 3	319	117244	1336075252	/users/cn/jespinosa/phecomp/data/CRG/20120502_FDF_CRG/20120502_FDF_CRG/20120502_FDF_CRG_c12.mtb	326	11	WWSS	food_sc	3	116925	1336074933	1	0.0599999999999998	0.00018808777429467	4892	1
2	Food 1	Intake 3	37	117292	1336075300	/users/cn/jespinosa/phecomp/data/CRG/20120502_FDF_CRG/20120502_FDF_CRG/20120502_FDF_CRG_c12.mtb	327	2576	WWSS	food_sc	3	117255	1336075263	1	0.02	0.000540540540540541	4893	1
2	Drink 2	Intake 2	31	117433	1336075441	/users/cn/jespinosa/phecomp/data/CRG/20120502_FDF_CRG/20120502_FDF_CRG/20120502_FDF_CRG_c12.mtb	285	NA	WWSS	water	2	117402	1336075410	1	0.0600000000000001	0.00193548387096775	4894	1
2	Drink 2	Intake 2	28	117786	1336075794	/users/cn/jespinosa/phecomp/data/CRG/20120502_FDF_CRG/20120502_FDF_CRG/20120502_FDF_CRG_c12.mtb	286	NA	WWSS	water	2	117758	1336075766	1	0.02	0.000714285714285714	4895	1
2	Food 1	Intake 3	124	119992	1336078000	/users/cn/jespinosa/phecomp/data/CRG/20120502_FDF_CRG/20120502_FDF_CRG/20120502_FDF_CRG_c12.mtb	333	24	WWSS	food_sc	3	119868	1336077876	1	0.02	0.000161290322580645	4896	1
2	Food 1	Intake 3	541	120557	1336078565	/users/cn/jespinosa/phecomp/data/CRG/20120502_FDF_CRG/20120502_FDF_CRG/20120502_FDF_CRG_c12.mtb	334	3251	WWSS	food_sc	3	120016	1336078024	1	0.0600000000000001	0.00011090573012939	4897	1
2	Drink 2	Intake 2	49	123649	1336081657	/users/cn/jespinosa/phecomp/data/CRG/20120502_FDF_CRG/20120502_FDF_CRG/20120502_FDF_CRG_c12.mtb	291	NA	WWSS	water	2	123600	1336081608	1	0.02	0.000408163265306122	4898	1
2	Food 1	Intake 3	245	124053	1336082061	/users/cn/jespinosa/phecomp/data/CRG/20120502_FDF_CRG/20120502_FDF_CRG/20120502_FDF_CRG_c12.mtb	338	77	WWSS	food_sc	3	123808	1336081816	1	0.04	0.000163265306122449	4899	1
2	Food 1	Intake 3	185	124315	1336082323	/users/cn/jespinosa/phecomp/data/CRG/20120502_FDF_CRG/20120502_FDF_CRG/20120502_FDF_CRG_c12.mtb	339	630	WWSS	food_sc	3	124130	1336082138	1	0.02	0.000108108108108108	4900	1
2	Drink 1	Intake 1	58	124932	1336082940	/users/cn/jespinosa/phecomp/data/CRG/20120502_FDF_CRG/20120502_FDF_CRG/20120502_FDF_CRG_c12.mtb	176	NA	WWSS	water	1	124874	1336082882	1	0.02	0.000344827586206897	4901	1
2	Food 1	Intake 3	594	125539	1336083547	/users/cn/jespinosa/phecomp/data/CRG/20120502_FDF_CRG/20120502_FDF_CRG/20120502_FDF_CRG_c12.mtb	340	708	WWSS	food_sc	3	124945	1336082953	1	0.12	0.000202020202020202	4902	1
2	Drink 2	Intake 2	40	125581	1336083589	/users/cn/jespinosa/phecomp/data/CRG/20120502_FDF_CRG/20120502_FDF_CRG/20120502_FDF_CRG_c12.mtb	298	NA	WWSS	water	2	125541	1336083549	1	0.12	0.003	4903	1
2	Drink 2	Intake 2	47	126255	1336084263	/users/cn/jespinosa/phecomp/data/CRG/20120502_FDF_CRG/20120502_FDF_CRG/20120502_FDF_CRG_c12.mtb	303	NA	WWSS	water	2	126208	1336084216	1	0.02	0.000425531914893617	4904	1
2	Food 1	Intake 3	571	126818	1336084826	/users/cn/jespinosa/phecomp/data/CRG/20120502_FDF_CRG/20120502_FDF_CRG/20120502_FDF_CRG_c12.mtb	343	83	WWSS	food_sc	3	126247	1336084255	1	0.12	0.00021015761821366	4905	1
2	Drink 2	Intake 2	39	126856	1336084864	/users/cn/jespinosa/phecomp/data/CRG/20120502_FDF_CRG/20120502_FDF_CRG/20120502_FDF_CRG_c12.mtb	304	NA	WWSS	water	2	126817	1336084825	1	0.1	0.00256410256410256	4906	1
2	Food 1	Intake 3	144	127045	1336085053	/users/cn/jespinosa/phecomp/data/CRG/20120502_FDF_CRG/20120502_FDF_CRG/20120502_FDF_CRG_c12.mtb	344	847	WWSS	food_sc	3	126901	1336084909	1	0.04	0.000277777777777778	4907	1
2	Drink 2	Intake 2	21	127063	1336085071	/users/cn/jespinosa/phecomp/data/CRG/20120502_FDF_CRG/20120502_FDF_CRG/20120502_FDF_CRG_c12.mtb	305	NA	WWSS	water	2	127042	1336085050	1	0.0600000000000001	0.00285714285714286	4908	1
2	Drink 2	Intake 2	26	127808	1336085816	/users/cn/jespinosa/phecomp/data/CRG/20120502_FDF_CRG/20120502_FDF_CRG/20120502_FDF_CRG_c12.mtb	311	NA	WWSS	water	2	127782	1336085790	1	0.0399999999999998	0.00153846153846153	4909	1
2	Food 1	Intake 3	380	128272	1336086280	/users/cn/jespinosa/phecomp/data/CRG/20120502_FDF_CRG/20120502_FDF_CRG/20120502_FDF_CRG_c12.mtb	346	38	WWSS	food_sc	3	127892	1336085900	1	0.0599999999999998	0.000157894736842105	4910	1
2	Food 1	Intake 3	204	128514	1336086522	/users/cn/jespinosa/phecomp/data/CRG/20120502_FDF_CRG/20120502_FDF_CRG/20120502_FDF_CRG_c12.mtb	347	498	WWSS	food_sc	3	128310	1336086318	1	0.04	0.000196078431372549	4911	1
2	Drink 2	Intake 2	16	128526	1336086534	/users/cn/jespinosa/phecomp/data/CRG/20120502_FDF_CRG/20120502_FDF_CRG/20120502_FDF_CRG_c12.mtb	314	NA	WWSS	water	2	128510	1336086518	1	0.04	0.0025	4912	1
2	Drink 2	Intake 2	22	128739	1336086747	/users/cn/jespinosa/phecomp/data/CRG/20120502_FDF_CRG/20120502_FDF_CRG/20120502_FDF_CRG_c12.mtb	315	NA	WWSS	water	2	128717	1336086725	1	0.0600000000000001	0.00272727272727273	4913	1
2	Food 1	Intake 3	487	129499	1336087507	/users/cn/jespinosa/phecomp/data/CRG/20120502_FDF_CRG/20120502_FDF_CRG/20120502_FDF_CRG_c12.mtb	353	2264	WWSS	food_sc	3	129012	1336087020	1	0.2	0.000410677618069815	4914	1
2	Drink 2	Intake 2	36	129534	1336087542	/users/cn/jespinosa/phecomp/data/CRG/20120502_FDF_CRG/20120502_FDF_CRG/20120502_FDF_CRG_c12.mtb	317	NA	WWSS	water	2	129498	1336087506	1	0.0800000000000001	0.00222222222222222	4915	1
2	Drink 2	Intake 2	55	130179	1336088187	/users/cn/jespinosa/phecomp/data/CRG/20120502_FDF_CRG/20120502_FDF_CRG/20120502_FDF_CRG_c12.mtb	320	NA	WWSS	water	2	130124	1336088132	1	0.0600000000000001	0.00109090909090909	4916	1
2	Drink 2	Intake 2	57	130471	1336088479	/users/cn/jespinosa/phecomp/data/CRG/20120502_FDF_CRG/20120502_FDF_CRG/20120502_FDF_CRG_c12.mtb	322	NA	WWSS	water	2	130414	1336088422	1	0.04	0.000701754385964912	4917	1
2	Drink 2	Intake 2	17	131454	1336089462	/users/cn/jespinosa/phecomp/data/CRG/20120502_FDF_CRG/20120502_FDF_CRG/20120502_FDF_CRG_c12.mtb	329	NA	WWSS	water	2	131437	1336089445	1	0.02	0.00117647058823529	4918	1
2	Food 1	Intake 3	137	131900	1336089908	/users/cn/jespinosa/phecomp/data/CRG/20120502_FDF_CRG/20120502_FDF_CRG/20120502_FDF_CRG_c12.mtb	360	5825	WWSS	food_sc	3	131763	1336089771	1	0.02	0.000145985401459854	4919	1
2	Drink 2	Intake 2	26	132102	1336090110	/users/cn/jespinosa/phecomp/data/CRG/20120502_FDF_CRG/20120502_FDF_CRG/20120502_FDF_CRG_c12.mtb	330	NA	WWSS	water	2	132076	1336090084	1	0.0399999999999998	0.00153846153846153	4920	1
2	Drink 2	Intake 2	10	132157	1336090165	/users/cn/jespinosa/phecomp/data/CRG/20120502_FDF_CRG/20120502_FDF_CRG/20120502_FDF_CRG_c12.mtb	331	NA	WWSS	water	2	132147	1336090155	1	0.02	0.002	4921	1
2	Food 1	Intake 3	391	138116	1336096124	/users/cn/jespinosa/phecomp/data/CRG/20120502_FDF_CRG/20120502_FDF_CRG/20120502_FDF_CRG_c12.mtb	372	492	WWSS	food_sc	3	137725	1336095733	1	0.0800000000000001	0.00020460358056266	4922	1
2	Drink 1	Intake 1	84	138342	1336096350	/users/cn/jespinosa/phecomp/data/CRG/20120502_FDF_CRG/20120502_FDF_CRG/20120502_FDF_CRG_c12.mtb	189	NA	WWSS	water	1	138258	1336096266	1	0.0399999999999998	0.000476190476190474	4923	1
2	Drink 1	Intake 1	29	138532	1336096540	/users/cn/jespinosa/phecomp/data/CRG/20120502_FDF_CRG/20120502_FDF_CRG/20120502_FDF_CRG_c12.mtb	190	NA	WWSS	water	1	138503	1336096511	1	0.04	0.00137931034482759	4924	1
2	Drink 1	Intake 1	42	138580	1336096588	/users/cn/jespinosa/phecomp/data/CRG/20120502_FDF_CRG/20120502_FDF_CRG/20120502_FDF_CRG_c12.mtb	191	NA	WWSS	water	1	138538	1336096546	1	0.0600000000000001	0.00142857142857143	4925	1
2	Food 2	Intake 4	476	139084	1336097092	/users/cn/jespinosa/phecomp/data/CRG/20120502_FDF_CRG/20120502_FDF_CRG/20120502_FDF_CRG_c12.mtb	589	421	WWSS	food_sc	4	138608	1336096616	1	0.0999999999999999	0.000210084033613445	4926	1
2	Drink 2	Intake 2	24	139113	1336097121	/users/cn/jespinosa/phecomp/data/CRG/20120502_FDF_CRG/20120502_FDF_CRG/20120502_FDF_CRG_c12.mtb	342	NA	WWSS	water	2	139089	1336097097	1	0.04	0.00166666666666667	4927	1
2	Drink 2	Intake 2	20	139229	1336097237	/users/cn/jespinosa/phecomp/data/CRG/20120502_FDF_CRG/20120502_FDF_CRG/20120502_FDF_CRG_c12.mtb	343	NA	WWSS	water	2	139209	1336097217	1	0.0399999999999998	0.00199999999999999	4928	1
2	Drink 2	Intake 2	23	139485	1336097493	/users/cn/jespinosa/phecomp/data/CRG/20120502_FDF_CRG/20120502_FDF_CRG/20120502_FDF_CRG_c12.mtb	345	NA	WWSS	water	2	139462	1336097470	1	0.04	0.00173913043478261	4929	1
2	Food 2	Intake 4	158	139663	1336097671	/users/cn/jespinosa/phecomp/data/CRG/20120502_FDF_CRG/20120502_FDF_CRG/20120502_FDF_CRG_c12.mtb	590	4259	WWSS	food_sc	4	139505	1336097513	1	0.02	0.000126582278481013	4930	1
2	Drink 2	Intake 2	23	139704	1336097712	/users/cn/jespinosa/phecomp/data/CRG/20120502_FDF_CRG/20120502_FDF_CRG/20120502_FDF_CRG_c12.mtb	346	NA	WWSS	water	2	139681	1336097689	1	0.02	0.000869565217391304	4931	1
2	Food 2	Intake 4	20	143942	1336101950	/users/cn/jespinosa/phecomp/data/CRG/20120502_FDF_CRG/20120502_FDF_CRG/20120502_FDF_CRG_c12.mtb	591	990	WWSS	food_sc	4	143922	1336101930	1	0.02	0.001	4932	1
2	Food 1	Intake 3	536	145468	1336103476	/users/cn/jespinosa/phecomp/data/CRG/20120502_FDF_CRG/20120502_FDF_CRG/20120502_FDF_CRG_c12.mtb	379	839	WWSS	food_sc	3	144932	1336102940	1	0.0800000000000001	0.000149253731343284	4933	1
2	Drink 1	Intake 1	21	145584	1336103592	/users/cn/jespinosa/phecomp/data/CRG/20120502_FDF_CRG/20120502_FDF_CRG/20120502_FDF_CRG_c12.mtb	194	NA	WWSS	water	1	145563	1336103571	1	0.0600000000000001	0.00285714285714286	4934	1
2	Drink 2	Intake 2	24	146262	1336104270	/users/cn/jespinosa/phecomp/data/CRG/20120502_FDF_CRG/20120502_FDF_CRG/20120502_FDF_CRG_c12.mtb	353	NA	WWSS	water	2	146238	1336104246	1	0.02	0.000833333333333333	4935	1
2	Drink 2	Intake 2	16	146296	1336104304	/users/cn/jespinosa/phecomp/data/CRG/20120502_FDF_CRG/20120502_FDF_CRG/20120502_FDF_CRG_c12.mtb	354	NA	WWSS	water	2	146280	1336104288	1	0.02	0.00125	4936	1
2	Food 1	Intake 3	501	146808	1336104816	/users/cn/jespinosa/phecomp/data/CRG/20120502_FDF_CRG/20120502_FDF_CRG/20120502_FDF_CRG_c12.mtb	382	3640	WWSS	food_sc	3	146307	1336104315	1	0.0599999999999996	0.000119760479041915	4937	1
2	Drink 2	Intake 2	17	146822	1336104830	/users/cn/jespinosa/phecomp/data/CRG/20120502_FDF_CRG/20120502_FDF_CRG/20120502_FDF_CRG_c12.mtb	355	NA	WWSS	water	2	146805	1336104813	1	0.04	0.00235294117647059	4938	1
2	Drink 1	Intake 1	15	147102	1336105110	/users/cn/jespinosa/phecomp/data/CRG/20120502_FDF_CRG/20120502_FDF_CRG/20120502_FDF_CRG_c12.mtb	197	NA	WWSS	water	1	147087	1336105095	1	0.02	0.00133333333333333	4939	1
2	Food 2	Intake 4	132	150580	1336108588	/users/cn/jespinosa/phecomp/data/CRG/20120502_FDF_CRG/20120502_FDF_CRG/20120502_FDF_CRG_c12.mtb	603	194	WWSS	food_sc	4	150448	1336108456	1	0.02	0.000151515151515152	4940	1
2	Food 2	Intake 4	558	151332	1336109340	/users/cn/jespinosa/phecomp/data/CRG/20120502_FDF_CRG/20120502_FDF_CRG/20120502_FDF_CRG_c12.mtb	606	349	WWSS	food_sc	4	150774	1336108782	1	0.18	0.00032258064516129	4941	1
2	Drink 1	Intake 1	23	151464	1336109472	/users/cn/jespinosa/phecomp/data/CRG/20120502_FDF_CRG/20120502_FDF_CRG/20120502_FDF_CRG_c12.mtb	199	NA	WWSS	water	1	151441	1336109449	1	0.1	0.00434782608695652	4942	1
2	Drink 1	Intake 1	17	151489	1336109497	/users/cn/jespinosa/phecomp/data/CRG/20120502_FDF_CRG/20120502_FDF_CRG/20120502_FDF_CRG_c12.mtb	200	NA	WWSS	water	1	151472	1336109480	1	0.02	0.00117647058823529	4943	1
2	Drink 1	Intake 1	21	151633	1336109641	/users/cn/jespinosa/phecomp/data/CRG/20120502_FDF_CRG/20120502_FDF_CRG/20120502_FDF_CRG_c12.mtb	201	NA	WWSS	water	1	151612	1336109620	1	0.0399999999999998	0.0019047619047619	4944	1
2	Food 2	Intake 4	256	151937	1336109945	/users/cn/jespinosa/phecomp/data/CRG/20120502_FDF_CRG/20120502_FDF_CRG/20120502_FDF_CRG_c12.mtb	608	939	WWSS	food_sc	4	151681	1336109689	1	0.1	0.000390625	4945	1
2	Drink 2	Intake 2	24	152084	1336110092	/users/cn/jespinosa/phecomp/data/CRG/20120502_FDF_CRG/20120502_FDF_CRG/20120502_FDF_CRG_c12.mtb	359	NA	WWSS	water	2	152060	1336110068	1	0.0600000000000001	0.0025	4946	1
2	Drink 1	Intake 1	34	152338	1336110346	/users/cn/jespinosa/phecomp/data/CRG/20120502_FDF_CRG/20120502_FDF_CRG/20120502_FDF_CRG_c12.mtb	202	NA	WWSS	water	1	152304	1336110312	1	0.12	0.00352941176470588	4947	1
2	Drink 2	Intake 2	22	152872	1336110880	/users/cn/jespinosa/phecomp/data/CRG/20120502_FDF_CRG/20120502_FDF_CRG/20120502_FDF_CRG_c12.mtb	362	NA	WWSS	water	2	152850	1336110858	1	0.02	0.000909090909090909	4948	1
2	Food 2	Intake 4	256	153132	1336111140	/users/cn/jespinosa/phecomp/data/CRG/20120502_FDF_CRG/20120502_FDF_CRG/20120502_FDF_CRG_c12.mtb	610	14544	WWSS	food_sc	4	152876	1336110884	1	0.04	0.00015625	4949	1
2	Drink 2	Intake 2	44	154286	1336112294	/users/cn/jespinosa/phecomp/data/CRG/20120502_FDF_CRG/20120502_FDF_CRG/20120502_FDF_CRG_c12.mtb	370	NA	WWSS	water	2	154242	1336112250	1	0.02	0.000454545454545455	4950	1
2	Food 2	Intake 4	157	3655	1336125841	/users/cn/jespinosa/phecomp/data/CRG/20120502_FDF_CRG/20120502_FDF_CRG/20120504_FDF_CRG_c12.mtb	978	17	WWSS	food_sc	4	3498	1336125684	1	0.02	0.000127388535031847	4951	1
2	Food 2	Intake 4	57	3729	1336125915	/users/cn/jespinosa/phecomp/data/CRG/20120502_FDF_CRG/20120502_FDF_CRG/20120504_FDF_CRG_c12.mtb	979	21936	WWSS	food_sc	4	3672	1336125858	1	0.02	0.000350877192982456	4952	1
2	Food 2	Intake 4	95	25760	1336147946	/users/cn/jespinosa/phecomp/data/CRG/20120502_FDF_CRG/20120502_FDF_CRG/20120504_FDF_CRG_c12.mtb	984	28	WWSS	food_sc	4	25665	1336147851	1	0.04	0.000421052631578947	4953	1
2	Food 2	Intake 4	419	26207	1336148393	/users/cn/jespinosa/phecomp/data/CRG/20120502_FDF_CRG/20120502_FDF_CRG/20120504_FDF_CRG_c12.mtb	985	307	WWSS	food_sc	4	25788	1336147974	1	0.16	0.000381861575178998	4954	1
2	Drink 1	Intake 1	17	26246	1336148432	/users/cn/jespinosa/phecomp/data/CRG/20120502_FDF_CRG/20120502_FDF_CRG/20120504_FDF_CRG_c12.mtb	352	NA	WWSS	water	1	26229	1336148415	1	0.02	0.00117647058823529	4955	1
2	Drink 1	Intake 1	16	26322	1336148508	/users/cn/jespinosa/phecomp/data/CRG/20120502_FDF_CRG/20120502_FDF_CRG/20120504_FDF_CRG_c12.mtb	353	NA	WWSS	water	1	26306	1336148492	1	0.04	0.0025	4956	1
2	Drink 1	Intake 1	19	26396	1336148582	/users/cn/jespinosa/phecomp/data/CRG/20120502_FDF_CRG/20120502_FDF_CRG/20120504_FDF_CRG_c12.mtb	354	NA	WWSS	water	1	26377	1336148563	1	0.02	0.00105263157894737	4957	1
2	Drink 2	Intake 2	26	26472	1336148658	/users/cn/jespinosa/phecomp/data/CRG/20120502_FDF_CRG/20120502_FDF_CRG/20120504_FDF_CRG_c12.mtb	551	NA	WWSS	water	2	26446	1336148632	1	0.02	0.000769230769230769	4958	1
2	Food 2	Intake 4	66	26580	1336148766	/users/cn/jespinosa/phecomp/data/CRG/20120502_FDF_CRG/20120502_FDF_CRG/20120504_FDF_CRG_c12.mtb	986	6531	WWSS	food_sc	4	26514	1336148700	1	0.04	0.000606060606060606	4959	1
2	Drink 2	Intake 2	12	26705	1336148891	/users/cn/jespinosa/phecomp/data/CRG/20120502_FDF_CRG/20120502_FDF_CRG/20120504_FDF_CRG_c12.mtb	552	NA	WWSS	water	2	26693	1336148879	1	0.04	0.00333333333333333	4960	1
2	Drink 2	Intake 2	12	28205	1336150391	/users/cn/jespinosa/phecomp/data/CRG/20120502_FDF_CRG/20120502_FDF_CRG/20120504_FDF_CRG_c12.mtb	553	NA	WWSS	water	2	28193	1336150379	1	0.06	0.005	4961	1
2	Food 2	Intake 4	330	33441	1336155627	/users/cn/jespinosa/phecomp/data/CRG/20120502_FDF_CRG/20120502_FDF_CRG/20120504_FDF_CRG_c12.mtb	990	90	WWSS	food_sc	4	33111	1336155297	1	0.06	0.000181818181818182	4962	1
2	Food 2	Intake 4	541	34072	1336156258	/users/cn/jespinosa/phecomp/data/CRG/20120502_FDF_CRG/20120502_FDF_CRG/20120504_FDF_CRG_c12.mtb	991	345	WWSS	food_sc	4	33531	1336155717	1	0.06	0.00011090573012939	4963	1
2	Food 2	Intake 4	441	34858	1336157044	/users/cn/jespinosa/phecomp/data/CRG/20120502_FDF_CRG/20120502_FDF_CRG/20120504_FDF_CRG_c12.mtb	993	508	WWSS	food_sc	4	34417	1336156603	1	0.06	0.000136054421768707	4964	1
2	Drink 1	Intake 1	15	35094	1336157280	/users/cn/jespinosa/phecomp/data/CRG/20120502_FDF_CRG/20120502_FDF_CRG/20120504_FDF_CRG_c12.mtb	356	NA	WWSS	water	1	35079	1336157265	1	0.04	0.00266666666666667	4965	1
2	Drink 2	Intake 2	13	35279	1336157465	/users/cn/jespinosa/phecomp/data/CRG/20120502_FDF_CRG/20120502_FDF_CRG/20120504_FDF_CRG_c12.mtb	555	NA	WWSS	water	2	35266	1336157452	1	0.02	0.00153846153846154	4966	1
2	Food 2	Intake 4	246	35612	1336157798	/users/cn/jespinosa/phecomp/data/CRG/20120502_FDF_CRG/20120502_FDF_CRG/20120504_FDF_CRG_c12.mtb	996	660	WWSS	food_sc	4	35366	1336157552	1	0.04	0.00016260162601626	4967	1
2	Drink 2	Intake 2	11	35862	1336158048	/users/cn/jespinosa/phecomp/data/CRG/20120502_FDF_CRG/20120502_FDF_CRG/20120504_FDF_CRG_c12.mtb	556	NA	WWSS	water	2	35851	1336158037	1	0.02	0.00181818181818182	4968	1
2	Drink 1	Intake 1	40	35897	1336158083	/users/cn/jespinosa/phecomp/data/CRG/20120502_FDF_CRG/20120502_FDF_CRG/20120504_FDF_CRG_c12.mtb	358	NA	WWSS	water	1	35857	1336158043	1	0.04	0.001	4969	1
2	Food 2	Intake 4	277	36549	1336158735	/users/cn/jespinosa/phecomp/data/CRG/20120502_FDF_CRG/20120502_FDF_CRG/20120504_FDF_CRG_c12.mtb	1001	296	WWSS	food_sc	4	36272	1336158458	1	0.02	7.2202166064982e-05	4970	1
2	Food 2	Intake 4	627	37472	1336159658	/users/cn/jespinosa/phecomp/data/CRG/20120502_FDF_CRG/20120502_FDF_CRG/20120504_FDF_CRG_c12.mtb	1005	1219	WWSS	food_sc	4	36845	1336159031	1	0.08	0.000127591706539075	4971	1
2	Drink 2	Intake 2	15	37706	1336159892	/users/cn/jespinosa/phecomp/data/CRG/20120502_FDF_CRG/20120502_FDF_CRG/20120504_FDF_CRG_c12.mtb	560	NA	WWSS	water	2	37691	1336159877	1	0.02	0.00133333333333333	4972	1
2	Drink 2	Intake 2	18	38087	1336160273	/users/cn/jespinosa/phecomp/data/CRG/20120502_FDF_CRG/20120502_FDF_CRG/20120504_FDF_CRG_c12.mtb	562	NA	WWSS	water	2	38069	1336160255	1	0.02	0.00111111111111111	4973	1
2	Food 2	Intake 4	151	38842	1336161028	/users/cn/jespinosa/phecomp/data/CRG/20120502_FDF_CRG/20120502_FDF_CRG/20120504_FDF_CRG_c12.mtb	1010	201	WWSS	food_sc	4	38691	1336160877	1	0.02	0.000132450331125828	4974	1
2	Food 1	Intake 3	160	39203	1336161389	/users/cn/jespinosa/phecomp/data/CRG/20120502_FDF_CRG/20120502_FDF_CRG/20120504_FDF_CRG_c12.mtb	523	11	WWSS	food_sc	3	39043	1336161229	1	0.06	0.000375	4975	1
2	Food 1	Intake 3	528	39742	1336161928	/users/cn/jespinosa/phecomp/data/CRG/20120502_FDF_CRG/20120502_FDF_CRG/20120504_FDF_CRG_c12.mtb	524	130	WWSS	food_sc	3	39214	1336161400	1	0.16	0.000303030303030303	4976	1
2	Drink 2	Intake 2	24	39762	1336161948	/users/cn/jespinosa/phecomp/data/CRG/20120502_FDF_CRG/20120502_FDF_CRG/20120504_FDF_CRG_c12.mtb	564	NA	WWSS	water	2	39738	1336161924	1	0.08	0.00333333333333333	4977	1
2	Drink 2	Intake 2	16	39849	1336162035	/users/cn/jespinosa/phecomp/data/CRG/20120502_FDF_CRG/20120502_FDF_CRG/20120504_FDF_CRG_c12.mtb	565	NA	WWSS	water	2	39833	1336162019	1	0.02	0.00125	4978	1
2	Food 1	Intake 3	240	40112	1336162298	/users/cn/jespinosa/phecomp/data/CRG/20120502_FDF_CRG/20120502_FDF_CRG/20120504_FDF_CRG_c12.mtb	526	390	WWSS	food_sc	3	39872	1336162058	1	0.02	8.33333333333333e-05	4979	1
2	Drink 1	Intake 1	11	40122	1336162308	/users/cn/jespinosa/phecomp/data/CRG/20120502_FDF_CRG/20120502_FDF_CRG/20120504_FDF_CRG_c12.mtb	360	NA	WWSS	water	1	40111	1336162297	1	0.04	0.00363636363636364	4980	1
2	Food 1	Intake 3	88	40590	1336162776	/users/cn/jespinosa/phecomp/data/CRG/20120502_FDF_CRG/20120502_FDF_CRG/20120504_FDF_CRG_c12.mtb	527	162	WWSS	food_sc	3	40502	1336162688	1	0.02	0.000227272727272727	4981	1
2	Food 1	Intake 3	205	40957	1336163143	/users/cn/jespinosa/phecomp/data/CRG/20120502_FDF_CRG/20120502_FDF_CRG/20120504_FDF_CRG_c12.mtb	529	1301	WWSS	food_sc	3	40752	1336162938	1	0.02	9.75609756097561e-05	4982	1
2	Drink 2	Intake 2	21	40982	1336163168	/users/cn/jespinosa/phecomp/data/CRG/20120502_FDF_CRG/20120502_FDF_CRG/20120504_FDF_CRG_c12.mtb	566	NA	WWSS	water	2	40961	1336163147	1	0.04	0.0019047619047619	4983	1
2	Drink 1	Intake 1	10	41059	1336163245	/users/cn/jespinosa/phecomp/data/CRG/20120502_FDF_CRG/20120502_FDF_CRG/20120504_FDF_CRG_c12.mtb	361	NA	WWSS	water	1	41049	1336163235	1	0.04	0.004	4984	1
2	Food 1	Intake 3	584	42842	1336165028	/users/cn/jespinosa/phecomp/data/CRG/20120502_FDF_CRG/20120502_FDF_CRG/20120504_FDF_CRG_c12.mtb	531	238	WWSS	food_sc	3	42258	1336164444	1	0.14	0.00023972602739726	4985	1
2	Drink 1	Intake 1	31	43057	1336165243	/users/cn/jespinosa/phecomp/data/CRG/20120502_FDF_CRG/20120502_FDF_CRG/20120504_FDF_CRG_c12.mtb	362	NA	WWSS	water	1	43026	1336165212	1	0.06	0.00193548387096774	4986	1
2	Food 1	Intake 3	819	43899	1336166085	/users/cn/jespinosa/phecomp/data/CRG/20120502_FDF_CRG/20120502_FDF_CRG/20120504_FDF_CRG_c12.mtb	534	532	WWSS	food_sc	3	43080	1336165266	1	0.18	0.00021978021978022	4987	1
2	Drink 2	Intake 2	22	43917	1336166103	/users/cn/jespinosa/phecomp/data/CRG/20120502_FDF_CRG/20120502_FDF_CRG/20120504_FDF_CRG_c12.mtb	568	NA	WWSS	water	2	43895	1336166081	1	0.08	0.00363636363636364	4988	1
2	Drink 2	Intake 2	15	43991	1336166177	/users/cn/jespinosa/phecomp/data/CRG/20120502_FDF_CRG/20120502_FDF_CRG/20120504_FDF_CRG_c12.mtb	569	NA	WWSS	water	2	43976	1336166162	1	0.02	0.00133333333333333	4989	1
2	Food 1	Intake 3	709	45140	1336167326	/users/cn/jespinosa/phecomp/data/CRG/20120502_FDF_CRG/20120502_FDF_CRG/20120504_FDF_CRG_c12.mtb	539	562	WWSS	food_sc	3	44431	1336166617	1	0.18	0.000253878702397743	4990	1
2	Drink 1	Intake 1	22	45157	1336167343	/users/cn/jespinosa/phecomp/data/CRG/20120502_FDF_CRG/20120502_FDF_CRG/20120504_FDF_CRG_c12.mtb	363	NA	WWSS	water	1	45135	1336167321	1	0.06	0.00272727272727273	4991	1
2	Drink 2	Intake 2	17	45381	1336167567	/users/cn/jespinosa/phecomp/data/CRG/20120502_FDF_CRG/20120502_FDF_CRG/20120504_FDF_CRG_c12.mtb	571	NA	WWSS	water	2	45364	1336167550	1	0.04	0.00235294117647059	4992	1
2	Drink 2	Intake 2	21	45670	1336167856	/users/cn/jespinosa/phecomp/data/CRG/20120502_FDF_CRG/20120502_FDF_CRG/20120504_FDF_CRG_c12.mtb	572	NA	WWSS	water	2	45649	1336167835	1	0.02	0.000952380952380952	4993	1
2	Food 1	Intake 3	262	45964	1336168150	/users/cn/jespinosa/phecomp/data/CRG/20120502_FDF_CRG/20120502_FDF_CRG/20120504_FDF_CRG_c12.mtb	542	665	WWSS	food_sc	3	45702	1336167888	1	0.0599999999999999	0.000229007633587786	4994	1
2	Drink 2	Intake 2	27	45983	1336168169	/users/cn/jespinosa/phecomp/data/CRG/20120502_FDF_CRG/20120502_FDF_CRG/20120504_FDF_CRG_c12.mtb	573	NA	WWSS	water	2	45956	1336168142	1	0.04	0.00148148148148148	4995	1
2	Food 1	Intake 3	46	46675	1336168861	/users/cn/jespinosa/phecomp/data/CRG/20120502_FDF_CRG/20120502_FDF_CRG/20120504_FDF_CRG_c12.mtb	544	77	WWSS	food_sc	3	46629	1336168815	1	0.02	0.000434782608695652	4996	1
2	Drink 2	Intake 2	23	46721	1336168907	/users/cn/jespinosa/phecomp/data/CRG/20120502_FDF_CRG/20120502_FDF_CRG/20120504_FDF_CRG_c12.mtb	574	NA	WWSS	water	2	46698	1336168884	1	0.02	0.000869565217391304	4997	1
2	Drink 1	Intake 1	17	46718	1336168904	/users/cn/jespinosa/phecomp/data/CRG/20120502_FDF_CRG/20120502_FDF_CRG/20120504_FDF_CRG_c12.mtb	365	NA	WWSS	water	1	46701	1336168887	1	0.02	0.00117647058823529	4998	1
2	Food 1	Intake 3	243	46995	1336169181	/users/cn/jespinosa/phecomp/data/CRG/20120502_FDF_CRG/20120502_FDF_CRG/20120504_FDF_CRG_c12.mtb	545	86	WWSS	food_sc	3	46752	1336168938	1	0.04	0.000164609053497942	4999	1
2	Drink 2	Intake 2	13	47038	1336169224	/users/cn/jespinosa/phecomp/data/CRG/20120502_FDF_CRG/20120502_FDF_CRG/20120504_FDF_CRG_c12.mtb	575	NA	WWSS	water	2	47025	1336169211	1	0.0399999999999999	0.00307692307692307	5000	1
2	Food 1	Intake 3	73	47154	1336169340	/users/cn/jespinosa/phecomp/data/CRG/20120502_FDF_CRG/20120502_FDF_CRG/20120504_FDF_CRG_c12.mtb	546	1060	WWSS	food_sc	3	47081	1336169267	1	0.02	0.000273972602739726	5001	1
2	Drink 2	Intake 2	15	47183	1336169369	/users/cn/jespinosa/phecomp/data/CRG/20120502_FDF_CRG/20120502_FDF_CRG/20120504_FDF_CRG_c12.mtb	576	NA	WWSS	water	2	47168	1336169354	1	0.02	0.00133333333333333	5002	1
2	Drink 1	Intake 1	16	47562	1336169748	/users/cn/jespinosa/phecomp/data/CRG/20120502_FDF_CRG/20120502_FDF_CRG/20120504_FDF_CRG_c12.mtb	366	NA	WWSS	water	1	47546	1336169732	1	0.06	0.00375	5003	1
2	Food 1	Intake 3	269	48483	1336170669	/users/cn/jespinosa/phecomp/data/CRG/20120502_FDF_CRG/20120502_FDF_CRG/20120504_FDF_CRG_c12.mtb	550	3495	WWSS	food_sc	3	48214	1336170400	1	0.0399999999999999	0.000148698884758364	5004	1
2	Drink 2	Intake 2	19	48699	1336170885	/users/cn/jespinosa/phecomp/data/CRG/20120502_FDF_CRG/20120502_FDF_CRG/20120504_FDF_CRG_c12.mtb	579	NA	WWSS	water	2	48680	1336170866	1	0.02	0.00105263157894737	5005	1
2	Food 1	Intake 3	593	52571	1336174757	/users/cn/jespinosa/phecomp/data/CRG/20120502_FDF_CRG/20120502_FDF_CRG/20120504_FDF_CRG_c12.mtb	553	279	WWSS	food_sc	3	51978	1336174164	1	0.1	0.000168634064080944	5006	1
2	Drink 1	Intake 1	16	52845	1336175031	/users/cn/jespinosa/phecomp/data/CRG/20120502_FDF_CRG/20120502_FDF_CRG/20120504_FDF_CRG_c12.mtb	369	NA	WWSS	water	1	52829	1336175015	1	0.02	0.00125	5007	1
2	Food 1	Intake 3	306	53156	1336175342	/users/cn/jespinosa/phecomp/data/CRG/20120502_FDF_CRG/20120502_FDF_CRG/20120504_FDF_CRG_c12.mtb	555	38	WWSS	food_sc	3	52850	1336175036	1	0.04	0.000130718954248366	5008	1
2	Drink 2	Intake 2	26	53175	1336175361	/users/cn/jespinosa/phecomp/data/CRG/20120502_FDF_CRG/20120502_FDF_CRG/20120504_FDF_CRG_c12.mtb	580	NA	WWSS	water	2	53149	1336175335	1	0.0599999999999999	0.0023076923076923	5009	1
2	Food 1	Intake 3	760	53954	1336176140	/users/cn/jespinosa/phecomp/data/CRG/20120502_FDF_CRG/20120502_FDF_CRG/20120504_FDF_CRG_c12.mtb	556	688	WWSS	food_sc	3	53194	1336175380	1	0.28	0.000368421052631579	5010	1
2	Drink 2	Intake 2	39	54011	1336176197	/users/cn/jespinosa/phecomp/data/CRG/20120502_FDF_CRG/20120502_FDF_CRG/20120504_FDF_CRG_c12.mtb	581	NA	WWSS	water	2	53972	1336176158	1	0.0800000000000001	0.00205128205128205	5011	1
2	Drink 1	Intake 1	23	54072	1336176258	/users/cn/jespinosa/phecomp/data/CRG/20120502_FDF_CRG/20120502_FDF_CRG/20120504_FDF_CRG_c12.mtb	370	NA	WWSS	water	1	54049	1336176235	1	0.08	0.00347826086956522	5012	1
2	Drink 1	Intake 1	23	54259	1336176445	/users/cn/jespinosa/phecomp/data/CRG/20120502_FDF_CRG/20120502_FDF_CRG/20120504_FDF_CRG_c12.mtb	371	NA	WWSS	water	1	54236	1336176422	1	0.0399999999999999	0.0017391304347826	5013	1
2	Drink 2	Intake 2	16	54270	1336176456	/users/cn/jespinosa/phecomp/data/CRG/20120502_FDF_CRG/20120502_FDF_CRG/20120504_FDF_CRG_c12.mtb	582	NA	WWSS	water	2	54254	1336176440	1	0.02	0.00125	5014	1
2	Food 1	Intake 3	176	54818	1336177004	/users/cn/jespinosa/phecomp/data/CRG/20120502_FDF_CRG/20120502_FDF_CRG/20120504_FDF_CRG_c12.mtb	558	1310	WWSS	food_sc	3	54642	1336176828	1	0.04	0.000227272727272727	5015	1
2	Drink 1	Intake 1	16	54905	1336177091	/users/cn/jespinosa/phecomp/data/CRG/20120502_FDF_CRG/20120502_FDF_CRG/20120504_FDF_CRG_c12.mtb	372	NA	WWSS	water	1	54889	1336177075	1	0.02	0.00125	5016	1
2	Drink 2	Intake 2	9	55356	1336177542	/users/cn/jespinosa/phecomp/data/CRG/20120502_FDF_CRG/20120502_FDF_CRG/20120504_FDF_CRG_c12.mtb	586	NA	WWSS	water	2	55347	1336177533	1	0.02	0.00222222222222222	5017	1
2	Drink 2	Intake 2	16	55676	1336177862	/users/cn/jespinosa/phecomp/data/CRG/20120502_FDF_CRG/20120502_FDF_CRG/20120504_FDF_CRG_c12.mtb	587	NA	WWSS	water	2	55660	1336177846	1	0.02	0.00125	5018	1
2	Food 1	Intake 3	131	56259	1336178445	/users/cn/jespinosa/phecomp/data/CRG/20120502_FDF_CRG/20120502_FDF_CRG/20120504_FDF_CRG_c12.mtb	561	83	WWSS	food_sc	3	56128	1336178314	1	0.1	0.000763358778625954	5019	1
2	Food 1	Intake 3	219	56561	1336178747	/users/cn/jespinosa/phecomp/data/CRG/20120502_FDF_CRG/20120502_FDF_CRG/20120504_FDF_CRG_c12.mtb	562	6406	WWSS	food_sc	3	56342	1336178528	1	0.0800000000000001	0.000365296803652968	5020	1
2	Drink 2	Intake 2	15	56601	1336178787	/users/cn/jespinosa/phecomp/data/CRG/20120502_FDF_CRG/20120502_FDF_CRG/20120504_FDF_CRG_c12.mtb	588	NA	WWSS	water	2	56586	1336178772	1	0.04	0.00266666666666667	5021	1
2	Drink 2	Intake 2	18	57058	1336179244	/users/cn/jespinosa/phecomp/data/CRG/20120502_FDF_CRG/20120502_FDF_CRG/20120504_FDF_CRG_c12.mtb	589	NA	WWSS	water	2	57040	1336179226	1	0.0399999999999999	0.00222222222222222	5022	1
2	Drink 2	Intake 2	19	57290	1336179476	/users/cn/jespinosa/phecomp/data/CRG/20120502_FDF_CRG/20120502_FDF_CRG/20120504_FDF_CRG_c12.mtb	590	NA	WWSS	water	2	57271	1336179457	1	0.04	0.00210526315789474	5023	1
2	Food 1	Intake 3	390	63357	1336185543	/users/cn/jespinosa/phecomp/data/CRG/20120502_FDF_CRG/20120502_FDF_CRG/20120504_FDF_CRG_c12.mtb	563	12806	WWSS	food_sc	3	62967	1336185153	1	0.48	0.00123076923076923	5024	1
2	Drink 1	Intake 1	17	63813	1336185999	/users/cn/jespinosa/phecomp/data/CRG/20120502_FDF_CRG/20120502_FDF_CRG/20120504_FDF_CRG_c12.mtb	373	NA	WWSS	water	1	63796	1336185982	1	0.04	0.00235294117647059	5025	1
2	Drink 1	Intake 1	17	63839	1336186025	/users/cn/jespinosa/phecomp/data/CRG/20120502_FDF_CRG/20120502_FDF_CRG/20120504_FDF_CRG_c12.mtb	374	NA	WWSS	water	1	63822	1336186008	1	0.02	0.00117647058823529	5026	1
2	Drink 2	Intake 2	33	63923	1336186109	/users/cn/jespinosa/phecomp/data/CRG/20120502_FDF_CRG/20120502_FDF_CRG/20120504_FDF_CRG_c12.mtb	593	NA	WWSS	water	2	63890	1336186076	1	0.02	0.000606060606060606	5027	1
2	Drink 1	Intake 1	43	63963	1336186149	/users/cn/jespinosa/phecomp/data/CRG/20120502_FDF_CRG/20120502_FDF_CRG/20120504_FDF_CRG_c12.mtb	375	NA	WWSS	water	1	63920	1336186106	1	0.0399999999999999	0.000930232558139532	5028	1
2	Drink 1	Intake 1	28	64053	1336186239	/users/cn/jespinosa/phecomp/data/CRG/20120502_FDF_CRG/20120502_FDF_CRG/20120504_FDF_CRG_c12.mtb	376	NA	WWSS	water	1	64025	1336186211	1	0.04	0.00142857142857143	5029	1
2	Drink 2	Intake 2	27	64802	1336186988	/users/cn/jespinosa/phecomp/data/CRG/20120502_FDF_CRG/20120502_FDF_CRG/20120504_FDF_CRG_c12.mtb	595	NA	WWSS	water	2	64775	1336186961	1	0.0600000000000001	0.00222222222222223	5030	1
2	Drink 1	Intake 1	16	65239	1336187425	/users/cn/jespinosa/phecomp/data/CRG/20120502_FDF_CRG/20120502_FDF_CRG/20120504_FDF_CRG_c12.mtb	377	NA	WWSS	water	1	65223	1336187409	1	0.08	0.005	5031	1
2	Drink 2	Intake 2	21	65428	1336187614	/users/cn/jespinosa/phecomp/data/CRG/20120502_FDF_CRG/20120502_FDF_CRG/20120504_FDF_CRG_c12.mtb	597	NA	WWSS	water	2	65407	1336187593	1	0.04	0.0019047619047619	5032	1
2	Drink 1	Intake 1	27	66253	1336188439	/users/cn/jespinosa/phecomp/data/CRG/20120502_FDF_CRG/20120502_FDF_CRG/20120504_FDF_CRG_c12.mtb	378	NA	WWSS	water	1	66226	1336188412	1	0.04	0.00148148148148148	5033	1
2	Drink 1	Intake 1	16	72146	1336194332	/users/cn/jespinosa/phecomp/data/CRG/20120502_FDF_CRG/20120502_FDF_CRG/20120504_FDF_CRG_c12.mtb	379	NA	WWSS	water	1	72130	1336194316	1	0.04	0.0025	5034	1
2	Drink 1	Intake 1	17	72472	1336194658	/users/cn/jespinosa/phecomp/data/CRG/20120502_FDF_CRG/20120502_FDF_CRG/20120504_FDF_CRG_c12.mtb	381	NA	WWSS	water	1	72455	1336194641	1	0.02	0.00117647058823529	5035	1
2	Drink 2	Intake 2	17	72577	1336194763	/users/cn/jespinosa/phecomp/data/CRG/20120502_FDF_CRG/20120502_FDF_CRG/20120504_FDF_CRG_c12.mtb	606	NA	WWSS	water	2	72560	1336194746	1	0.02	0.00117647058823529	5036	1
2	Food 1	Intake 3	89	76252	1336198438	/users/cn/jespinosa/phecomp/data/CRG/20120502_FDF_CRG/20120502_FDF_CRG/20120504_FDF_CRG_c12.mtb	575	8	WWSS	food_sc	3	76163	1336198349	1	0.02	0.000224719101123596	5037	1
2	Food 1	Intake 3	224	76484	1336198670	/users/cn/jespinosa/phecomp/data/CRG/20120502_FDF_CRG/20120502_FDF_CRG/20120504_FDF_CRG_c12.mtb	576	5242	WWSS	food_sc	3	76260	1336198446	1	0.04	0.000178571428571429	5038	1
2	Drink 2	Intake 2	15	80959	1336203145	/users/cn/jespinosa/phecomp/data/CRG/20120502_FDF_CRG/20120502_FDF_CRG/20120504_FDF_CRG_c12.mtb	611	NA	WWSS	water	2	80944	1336203130	1	0.02	0.00133333333333333	5039	1
2	Food 1	Intake 3	636	82362	1336204548	/users/cn/jespinosa/phecomp/data/CRG/20120502_FDF_CRG/20120502_FDF_CRG/20120504_FDF_CRG_c12.mtb	579	6350	WWSS	food_sc	3	81726	1336203912	1	0.0600000000000001	9.43396226415096e-05	5040	1
2	Drink 1	Intake 1	21	82416	1336204602	/users/cn/jespinosa/phecomp/data/CRG/20120502_FDF_CRG/20120502_FDF_CRG/20120504_FDF_CRG_c12.mtb	384	NA	WWSS	water	1	82395	1336204581	1	0.0399999999999999	0.0019047619047619	5041	1
2	Drink 1	Intake 1	14	82582	1336204768	/users/cn/jespinosa/phecomp/data/CRG/20120502_FDF_CRG/20120502_FDF_CRG/20120504_FDF_CRG_c12.mtb	385	NA	WWSS	water	1	82568	1336204754	1	0.04	0.00285714285714286	5042	1
2	Food 2	Intake 4	47	88759	1336210945	/users/cn/jespinosa/phecomp/data/CRG/20120502_FDF_CRG/20120502_FDF_CRG/20120504_FDF_CRG_c12.mtb	1034	433	WWSS	food_sc	4	88712	1336210898	1	0.02	0.000425531914893617	5043	1
2	Food 1	Intake 3	330	89522	1336211708	/users/cn/jespinosa/phecomp/data/CRG/20120502_FDF_CRG/20120502_FDF_CRG/20120504_FDF_CRG_c12.mtb	582	11052	WWSS	food_sc	3	89192	1336211378	1	0.02	6.06060606060606e-05	5044	1
2	Drink 1	Intake 1	16	89726	1336211912	/users/cn/jespinosa/phecomp/data/CRG/20120502_FDF_CRG/20120502_FDF_CRG/20120504_FDF_CRG_c12.mtb	386	NA	WWSS	water	1	89710	1336211896	1	0.04	0.0025	5045	1
2	Food 2	Intake 4	72	100646	1336222832	/users/cn/jespinosa/phecomp/data/CRG/20120502_FDF_CRG/20120502_FDF_CRG/20120504_FDF_CRG_c12.mtb	1040	12612	WWSS	food_sc	4	100574	1336222760	1	0.02	0.000277777777777778	5046	1
2	Food 2	Intake 4	247	113505	1336235691	/users/cn/jespinosa/phecomp/data/CRG/20120502_FDF_CRG/20120502_FDF_CRG/20120504_FDF_CRG_c12.mtb	1044	149	WWSS	food_sc	4	113258	1336235444	1	0.02	8.09716599190283e-05	5047	1
2	Food 2	Intake 4	501	114155	1336236341	/users/cn/jespinosa/phecomp/data/CRG/20120502_FDF_CRG/20120502_FDF_CRG/20120504_FDF_CRG_c12.mtb	1046	5206	WWSS	food_sc	4	113654	1336235840	1	0.0399999999999999	7.98403193612772e-05	5048	1
2	Food 1	Intake 3	800	120161	1336242347	/users/cn/jespinosa/phecomp/data/CRG/20120502_FDF_CRG/20120502_FDF_CRG/20120504_FDF_CRG_c12.mtb	592	817	WWSS	food_sc	3	119361	1336241547	1	0.0600000000000001	7.50000000000001e-05	5049	1
2	Food 1	Intake 3	123	121101	1336243287	/users/cn/jespinosa/phecomp/data/CRG/20120502_FDF_CRG/20120502_FDF_CRG/20120504_FDF_CRG_c12.mtb	594	COLL	WWSS	food_sc	3	120978	1336243164	1	0.02	0.00016260162601626	5050	1
2	Food 2	Intake 4	462	121556	1336243742	/users/cn/jespinosa/phecomp/data/CRG/20120502_FDF_CRG/20120502_FDF_CRG/20120504_FDF_CRG_c12.mtb	1053	341	WWSS	food_sc	4	121094	1336243280	1	0.0800000000000001	0.000173160173160173	5051	1
2	Drink 2	Intake 2	35	121625	1336243811	/users/cn/jespinosa/phecomp/data/CRG/20120502_FDF_CRG/20120502_FDF_CRG/20120504_FDF_CRG_c12.mtb	620	NA	WWSS	water	2	121590	1336243776	1	0.04	0.00114285714285714	5052	1
2	Drink 2	Intake 2	22	121847	1336244033	/users/cn/jespinosa/phecomp/data/CRG/20120502_FDF_CRG/20120502_FDF_CRG/20120504_FDF_CRG_c12.mtb	621	NA	WWSS	water	2	121825	1336244011	1	0.02	0.000909090909090909	5053	1
2	Drink 1	Intake 1	16	121859	1336244045	/users/cn/jespinosa/phecomp/data/CRG/20120502_FDF_CRG/20120502_FDF_CRG/20120504_FDF_CRG_c12.mtb	390	NA	WWSS	water	1	121843	1336244029	1	0.02	0.00125	5054	1
2	Food 2	Intake 4	445	122342	1336244528	/users/cn/jespinosa/phecomp/data/CRG/20120502_FDF_CRG/20120502_FDF_CRG/20120504_FDF_CRG_c12.mtb	1056	330	WWSS	food_sc	4	121897	1336244083	1	0.0399999999999999	8.9887640449438e-05	5055	1
2	Drink 2	Intake 2	37	122371	1336244557	/users/cn/jespinosa/phecomp/data/CRG/20120502_FDF_CRG/20120502_FDF_CRG/20120504_FDF_CRG_c12.mtb	622	NA	WWSS	water	2	122334	1336244520	1	0.1	0.0027027027027027	5056	1
2	Drink 2	Intake 2	20	122644	1336244830	/users/cn/jespinosa/phecomp/data/CRG/20120502_FDF_CRG/20120502_FDF_CRG/20120504_FDF_CRG_c12.mtb	623	NA	WWSS	water	2	122624	1336244810	1	0.02	0.001	5057	1
2	Food 2	Intake 4	317	122989	1336245175	/users/cn/jespinosa/phecomp/data/CRG/20120502_FDF_CRG/20120502_FDF_CRG/20120504_FDF_CRG_c12.mtb	1057	936	WWSS	food_sc	4	122672	1336244858	1	0.02	6.30914826498423e-05	5058	1
2	Drink 2	Intake 2	22	123144	1336245330	/users/cn/jespinosa/phecomp/data/CRG/20120502_FDF_CRG/20120502_FDF_CRG/20120504_FDF_CRG_c12.mtb	624	NA	WWSS	water	2	123122	1336245308	1	0.0399999999999998	0.00181818181818181	5059	1
2	Food 2	Intake 4	465	124390	1336246576	/users/cn/jespinosa/phecomp/data/CRG/20120502_FDF_CRG/20120502_FDF_CRG/20120504_FDF_CRG_c12.mtb	1060	123	WWSS	food_sc	4	123925	1336246111	1	0.0600000000000001	0.000129032258064516	5060	1
2	Drink 2	Intake 2	20	124446	1336246632	/users/cn/jespinosa/phecomp/data/CRG/20120502_FDF_CRG/20120502_FDF_CRG/20120504_FDF_CRG_c12.mtb	625	NA	WWSS	water	2	124426	1336246612	1	0.02	0.001	5061	1
2	Food 2	Intake 4	326	124839	1336247025	/users/cn/jespinosa/phecomp/data/CRG/20120502_FDF_CRG/20120502_FDF_CRG/20120504_FDF_CRG_c12.mtb	1061	28	WWSS	food_sc	4	124513	1336246699	1	0.0399999999999999	0.000122699386503067	5062	1
2	Drink 2	Intake 2	16	124854	1336247040	/users/cn/jespinosa/phecomp/data/CRG/20120502_FDF_CRG/20120502_FDF_CRG/20120504_FDF_CRG_c12.mtb	626	NA	WWSS	water	2	124838	1336247024	1	0.02	0.00125	5063	1
2	Food 2	Intake 4	854	125721	1336247907	/users/cn/jespinosa/phecomp/data/CRG/20120502_FDF_CRG/20120502_FDF_CRG/20120504_FDF_CRG_c12.mtb	1062	83	WWSS	food_sc	4	124867	1336247053	1	0.18	0.000210772833723653	5064	1
2	Drink 2	Intake 2	36	125755	1336247941	/users/cn/jespinosa/phecomp/data/CRG/20120502_FDF_CRG/20120502_FDF_CRG/20120504_FDF_CRG_c12.mtb	627	NA	WWSS	water	2	125719	1336247905	1	0.12	0.00333333333333333	5065	1
2	Drink 1	Intake 1	21	125787	1336247973	/users/cn/jespinosa/phecomp/data/CRG/20120502_FDF_CRG/20120502_FDF_CRG/20120504_FDF_CRG_c12.mtb	392	NA	WWSS	water	1	125766	1336247952	1	0.04	0.0019047619047619	5066	1
2	Food 2	Intake 4	442	126246	1336248432	/users/cn/jespinosa/phecomp/data/CRG/20120502_FDF_CRG/20120502_FDF_CRG/20120504_FDF_CRG_c12.mtb	1063	147	WWSS	food_sc	4	125804	1336247990	1	0.0999999999999999	0.000226244343891402	5067	1
2	Drink 2	Intake 2	41	126277	1336248463	/users/cn/jespinosa/phecomp/data/CRG/20120502_FDF_CRG/20120502_FDF_CRG/20120504_FDF_CRG_c12.mtb	628	NA	WWSS	water	2	126236	1336248422	1	0.1	0.0024390243902439	5068	1
2	Food 2	Intake 4	284	126677	1336248863	/users/cn/jespinosa/phecomp/data/CRG/20120502_FDF_CRG/20120502_FDF_CRG/20120504_FDF_CRG_c12.mtb	1065	1771	WWSS	food_sc	4	126393	1336248579	1	0.04	0.000140845070422535	5069	1
2	Drink 2	Intake 2	26	126702	1336248888	/users/cn/jespinosa/phecomp/data/CRG/20120502_FDF_CRG/20120502_FDF_CRG/20120504_FDF_CRG_c12.mtb	629	NA	WWSS	water	2	126676	1336248862	1	0.0799999999999998	0.00307692307692307	5070	1
2	Food 2	Intake 4	661	129109	1336251295	/users/cn/jespinosa/phecomp/data/CRG/20120502_FDF_CRG/20120502_FDF_CRG/20120504_FDF_CRG_c12.mtb	1068	1919	WWSS	food_sc	4	128448	1336250634	1	0.2	0.000302571860816944	5071	1
2	Drink 2	Intake 2	38	129145	1336251331	/users/cn/jespinosa/phecomp/data/CRG/20120502_FDF_CRG/20120502_FDF_CRG/20120504_FDF_CRG_c12.mtb	631	NA	WWSS	water	2	129107	1336251293	1	0.0999999999999999	0.00263157894736842	5072	1
2	Drink 1	Intake 1	19	129486	1336251672	/users/cn/jespinosa/phecomp/data/CRG/20120502_FDF_CRG/20120502_FDF_CRG/20120504_FDF_CRG_c12.mtb	393	NA	WWSS	water	1	129467	1336251653	1	0.04	0.00210526315789474	5073	1
2	Drink 2	Intake 2	12	130175	1336252361	/users/cn/jespinosa/phecomp/data/CRG/20120502_FDF_CRG/20120502_FDF_CRG/20120504_FDF_CRG_c12.mtb	636	NA	WWSS	water	2	130163	1336252349	1	0.04	0.00333333333333333	5074	1
2	Food 2	Intake 4	482	131510	1336253696	/users/cn/jespinosa/phecomp/data/CRG/20120502_FDF_CRG/20120502_FDF_CRG/20120504_FDF_CRG_c12.mtb	1074	606	WWSS	food_sc	4	131028	1336253214	1	0.02	4.149377593361e-05	5075	1
2	Food 2	Intake 4	167	132283	1336254469	/users/cn/jespinosa/phecomp/data/CRG/20120502_FDF_CRG/20120502_FDF_CRG/20120504_FDF_CRG_c12.mtb	1080	526	WWSS	food_sc	4	132116	1336254302	1	0.02	0.000119760479041916	5076	1
2	Drink 2	Intake 2	20	132306	1336254492	/users/cn/jespinosa/phecomp/data/CRG/20120502_FDF_CRG/20120502_FDF_CRG/20120504_FDF_CRG_c12.mtb	637	NA	WWSS	water	2	132286	1336254472	1	0.02	0.001	5077	1
2	Food 2	Intake 4	677	133486	1336255672	/users/cn/jespinosa/phecomp/data/CRG/20120502_FDF_CRG/20120502_FDF_CRG/20120504_FDF_CRG_c12.mtb	1082	135	WWSS	food_sc	4	132809	1336254995	1	0.0800000000000001	0.000118168389955687	5078	1
2	Drink 2	Intake 2	21	133503	1336255689	/users/cn/jespinosa/phecomp/data/CRG/20120502_FDF_CRG/20120502_FDF_CRG/20120504_FDF_CRG_c12.mtb	638	NA	WWSS	water	2	133482	1336255668	1	0.0800000000000001	0.00380952380952381	5079	1
2	Drink 2	Intake 2	15	133563	1336255749	/users/cn/jespinosa/phecomp/data/CRG/20120502_FDF_CRG/20120502_FDF_CRG/20120504_FDF_CRG_c12.mtb	639	NA	WWSS	water	2	133548	1336255734	1	0.04	0.00266666666666667	5080	1
2	Food 2	Intake 4	733	134354	1336256540	/users/cn/jespinosa/phecomp/data/CRG/20120502_FDF_CRG/20120502_FDF_CRG/20120504_FDF_CRG_c12.mtb	1084	31	WWSS	food_sc	4	133621	1336255807	1	0.0999999999999999	0.000136425648021828	5081	1
2	Drink 2	Intake 2	36	134380	1336256566	/users/cn/jespinosa/phecomp/data/CRG/20120502_FDF_CRG/20120502_FDF_CRG/20120504_FDF_CRG_c12.mtb	640	NA	WWSS	water	2	134344	1336256530	1	0.1	0.00277777777777778	5082	1
2	Food 2	Intake 4	39	134424	1336256610	/users/cn/jespinosa/phecomp/data/CRG/20120502_FDF_CRG/20120502_FDF_CRG/20120504_FDF_CRG_c12.mtb	1085	751	WWSS	food_sc	4	134385	1336256571	1	0.02	0.000512820512820513	5083	1
2	Drink 2	Intake 2	24	134458	1336256644	/users/cn/jespinosa/phecomp/data/CRG/20120502_FDF_CRG/20120502_FDF_CRG/20120504_FDF_CRG_c12.mtb	641	NA	WWSS	water	2	134434	1336256620	1	0.0600000000000001	0.0025	5084	1
2	Drink 2	Intake 2	17	135043	1336257229	/users/cn/jespinosa/phecomp/data/CRG/20120502_FDF_CRG/20120502_FDF_CRG/20120504_FDF_CRG_c12.mtb	642	NA	WWSS	water	2	135026	1336257212	1	0.04	0.00235294117647059	5085	1
2	Food 2	Intake 4	369	135544	1336257730	/users/cn/jespinosa/phecomp/data/CRG/20120502_FDF_CRG/20120502_FDF_CRG/20120504_FDF_CRG_c12.mtb	1087	101	WWSS	food_sc	4	135175	1336257361	1	0.04	0.00010840108401084	5086	1
2	Drink 2	Intake 2	22	135571	1336257757	/users/cn/jespinosa/phecomp/data/CRG/20120502_FDF_CRG/20120502_FDF_CRG/20120504_FDF_CRG_c12.mtb	643	NA	WWSS	water	2	135549	1336257735	1	0.02	0.000909090909090909	5087	1
2	Food 2	Intake 4	197	135842	1336258028	/users/cn/jespinosa/phecomp/data/CRG/20120502_FDF_CRG/20120502_FDF_CRG/20120504_FDF_CRG_c12.mtb	1089	3050	WWSS	food_sc	4	135645	1336257831	1	0.02	0.000101522842639594	5088	1
2	Food 2	Intake 4	1672	140564	1336262750	/users/cn/jespinosa/phecomp/data/CRG/20120502_FDF_CRG/20120502_FDF_CRG/20120504_FDF_CRG_c12.mtb	1094	442	WWSS	food_sc	4	138892	1336261078	1	0.44	0.000263157894736842	5089	1
2	Drink 2	Intake 2	41	140653	1336262839	/users/cn/jespinosa/phecomp/data/CRG/20120502_FDF_CRG/20120502_FDF_CRG/20120504_FDF_CRG_c12.mtb	644	NA	WWSS	water	2	140612	1336262798	1	0.14	0.00341463414634146	5090	1
2	Drink 2	Intake 2	29	140909	1336263095	/users/cn/jespinosa/phecomp/data/CRG/20120502_FDF_CRG/20120502_FDF_CRG/20120504_FDF_CRG_c12.mtb	645	NA	WWSS	water	2	140880	1336263066	1	0.0600000000000001	0.00206896551724138	5091	1
2	Food 2	Intake 4	313	141319	1336263505	/users/cn/jespinosa/phecomp/data/CRG/20120502_FDF_CRG/20120502_FDF_CRG/20120504_FDF_CRG_c12.mtb	1097	5	WWSS	food_sc	4	141006	1336263192	1	0.2	0.000638977635782748	5092	1
2	Food 2	Intake 4	32	141356	1336263542	/users/cn/jespinosa/phecomp/data/CRG/20120502_FDF_CRG/20120502_FDF_CRG/20120504_FDF_CRG_c12.mtb	1098	11531	WWSS	food_sc	4	141324	1336263510	1	0.3	0.009375	5093	1
2	Drink 1	Intake 1	20	141535	1336263721	/users/cn/jespinosa/phecomp/data/CRG/20120502_FDF_CRG/20120502_FDF_CRG/20120504_FDF_CRG_c12.mtb	395	NA	WWSS	water	1	141515	1336263701	1	0.12	0.006	5094	1
2	Drink 2	Intake 2	36	141586	1336263772	/users/cn/jespinosa/phecomp/data/CRG/20120502_FDF_CRG/20120502_FDF_CRG/20120504_FDF_CRG_c12.mtb	646	NA	WWSS	water	2	141550	1336263736	1	0.0600000000000001	0.00166666666666667	5095	1
2	Drink 2	Intake 2	20	141612	1336263798	/users/cn/jespinosa/phecomp/data/CRG/20120502_FDF_CRG/20120502_FDF_CRG/20120504_FDF_CRG_c12.mtb	647	NA	WWSS	water	2	141592	1336263778	1	0.02	0.001	5096	1
2	Drink 2	Intake 2	23	141837	1336264023	/users/cn/jespinosa/phecomp/data/CRG/20120502_FDF_CRG/20120502_FDF_CRG/20120504_FDF_CRG_c12.mtb	648	NA	WWSS	water	2	141814	1336264000	1	0.02	0.000869565217391304	5097	1
2	Drink 2	Intake 2	18	141929	1336264115	/users/cn/jespinosa/phecomp/data/CRG/20120502_FDF_CRG/20120502_FDF_CRG/20120504_FDF_CRG_c12.mtb	650	NA	WWSS	water	2	141911	1336264097	1	0.04	0.00222222222222222	5098	1
2	Drink 2	Intake 2	17	142150	1336264336	/users/cn/jespinosa/phecomp/data/CRG/20120502_FDF_CRG/20120502_FDF_CRG/20120504_FDF_CRG_c12.mtb	652	NA	WWSS	water	2	142133	1336264319	1	0.04	0.00235294117647059	5099	1
2	Drink 2	Intake 2	60	142542	1336264728	/users/cn/jespinosa/phecomp/data/CRG/20120502_FDF_CRG/20120502_FDF_CRG/20120504_FDF_CRG_c12.mtb	653	NA	WWSS	water	2	142482	1336264668	1	0.0600000000000001	0.001	5100	1
2	Drink 2	Intake 2	30	142898	1336265084	/users/cn/jespinosa/phecomp/data/CRG/20120502_FDF_CRG/20120502_FDF_CRG/20120504_FDF_CRG_c12.mtb	656	NA	WWSS	water	2	142868	1336265054	1	0.0599999999999996	0.00199999999999999	5101	1
2	Drink 2	Intake 2	20	143279	1336265465	/users/cn/jespinosa/phecomp/data/CRG/20120502_FDF_CRG/20120502_FDF_CRG/20120504_FDF_CRG_c12.mtb	657	NA	WWSS	water	2	143259	1336265445	1	0.04	0.002	5102	1
2	Drink 1	Intake 1	9	143768	1336265954	/users/cn/jespinosa/phecomp/data/CRG/20120502_FDF_CRG/20120502_FDF_CRG/20120504_FDF_CRG_c12.mtb	397	NA	WWSS	water	1	143759	1336265945	1	0.04	0.00444444444444444	5103	1
2	Drink 2	Intake 2	65	144079	1336266265	/users/cn/jespinosa/phecomp/data/CRG/20120502_FDF_CRG/20120502_FDF_CRG/20120504_FDF_CRG_c12.mtb	660	NA	WWSS	water	2	144014	1336266200	1	0.0200000000000005	0.000307692307692315	5104	1
2	Food 2	Intake 4	69	152956	1336275142	/users/cn/jespinosa/phecomp/data/CRG/20120502_FDF_CRG/20120502_FDF_CRG/20120504_FDF_CRG_c12.mtb	1106	4164	WWSS	food_sc	4	152887	1336275073	1	0.0200000000000005	0.000289855072463775	5105	1
2	Drink 1	Intake 1	12	154447	1336276633	/users/cn/jespinosa/phecomp/data/CRG/20120502_FDF_CRG/20120502_FDF_CRG/20120504_FDF_CRG_c12.mtb	400	NA	WWSS	water	1	154435	1336276621	1	0.04	0.00333333333333333	5106	1
2	Drink 2	Intake 2	30	157115	1336279301	/users/cn/jespinosa/phecomp/data/CRG/20120502_FDF_CRG/20120502_FDF_CRG/20120504_FDF_CRG_c12.mtb	672	NA	WWSS	water	2	157085	1336279271	1	0.0399999999999996	0.00133333333333332	5107	1
2	Food 2	Intake 4	440	157560	1336279746	/users/cn/jespinosa/phecomp/data/CRG/20120502_FDF_CRG/20120502_FDF_CRG/20120504_FDF_CRG_c12.mtb	1126	33	WWSS	food_sc	4	157120	1336279306	1	0.04	9.09090909090909e-05	5108	1
2	Food 2	Intake 4	963	158556	1336280742	/users/cn/jespinosa/phecomp/data/CRG/20120502_FDF_CRG/20120502_FDF_CRG/20120504_FDF_CRG_c12.mtb	1127	72	WWSS	food_sc	4	157593	1336279779	1	0.16	0.000166147455867082	5109	1
2	Drink 2	Intake 2	34	158594	1336280780	/users/cn/jespinosa/phecomp/data/CRG/20120502_FDF_CRG/20120502_FDF_CRG/20120504_FDF_CRG_c12.mtb	674	NA	WWSS	water	2	158560	1336280746	1	0.12	0.00352941176470588	5110	1
2	Food 2	Intake 4	282	158910	1336281096	/users/cn/jespinosa/phecomp/data/CRG/20120502_FDF_CRG/20120502_FDF_CRG/20120504_FDF_CRG_c12.mtb	1128	297	WWSS	food_sc	4	158628	1336280814	1	0.04	0.000141843971631206	5111	1
2	Drink 2	Intake 2	38	158942	1336281128	/users/cn/jespinosa/phecomp/data/CRG/20120502_FDF_CRG/20120502_FDF_CRG/20120504_FDF_CRG_c12.mtb	675	NA	WWSS	water	2	158904	1336281090	1	0.1	0.00263157894736842	5112	1
2	Food 2	Intake 4	461	159668	1336281854	/users/cn/jespinosa/phecomp/data/CRG/20120502_FDF_CRG/20120502_FDF_CRG/20120504_FDF_CRG_c12.mtb	1130	66	WWSS	food_sc	4	159207	1336281393	1	0.1	0.000216919739696312	5113	1
2	Drink 2	Intake 2	27	159700	1336281886	/users/cn/jespinosa/phecomp/data/CRG/20120502_FDF_CRG/20120502_FDF_CRG/20120504_FDF_CRG_c12.mtb	676	NA	WWSS	water	2	159673	1336281859	1	0.0600000000000001	0.00222222222222223	5114	1
2	Food 2	Intake 4	282	160016	1336282202	/users/cn/jespinosa/phecomp/data/CRG/20120502_FDF_CRG/20120502_FDF_CRG/20120504_FDF_CRG_c12.mtb	1131	78	WWSS	food_sc	4	159734	1336281920	1	0.04	0.000141843971631206	5115	1
2	Drink 2	Intake 2	17	160033	1336282219	/users/cn/jespinosa/phecomp/data/CRG/20120502_FDF_CRG/20120502_FDF_CRG/20120504_FDF_CRG_c12.mtb	677	NA	WWSS	water	2	160016	1336282202	1	0.0800000000000001	0.00470588235294118	5116	1
2	Food 2	Intake 4	326	160420	1336282606	/users/cn/jespinosa/phecomp/data/CRG/20120502_FDF_CRG/20120502_FDF_CRG/20120504_FDF_CRG_c12.mtb	1132	36	WWSS	food_sc	4	160094	1336282280	1	0.0800000000000001	0.000245398773006135	5117	1
2	Drink 2	Intake 2	12	160458	1336282644	/users/cn/jespinosa/phecomp/data/CRG/20120502_FDF_CRG/20120502_FDF_CRG/20120504_FDF_CRG_c12.mtb	678	NA	WWSS	water	2	160446	1336282632	1	0.04	0.00333333333333333	5118	1
2	Food 2	Intake 4	292	160748	1336282934	/users/cn/jespinosa/phecomp/data/CRG/20120502_FDF_CRG/20120502_FDF_CRG/20120504_FDF_CRG_c12.mtb	1133	202	WWSS	food_sc	4	160456	1336282642	1	0.0799999999999996	0.000273972602739725	5119	1
2	Drink 2	Intake 2	22	160855	1336283041	/users/cn/jespinosa/phecomp/data/CRG/20120502_FDF_CRG/20120502_FDF_CRG/20120504_FDF_CRG_c12.mtb	679	NA	WWSS	water	2	160833	1336283019	1	0.0399999999999996	0.0018181818181818	5120	1
2	Food 2	Intake 4	101	161051	1336283237	/users/cn/jespinosa/phecomp/data/CRG/20120502_FDF_CRG/20120502_FDF_CRG/20120504_FDF_CRG_c12.mtb	1135	7205	WWSS	food_sc	4	160950	1336283136	1	0.02	0.000198019801980198	5121	1
2	Food 2	Intake 4	271	168527	1336290713	/users/cn/jespinosa/phecomp/data/CRG/20120502_FDF_CRG/20120502_FDF_CRG/20120504_FDF_CRG_c12.mtb	1141	55	WWSS	food_sc	4	168256	1336290442	1	0.0600000000000001	0.000221402214022141	5122	1
2	Food 2	Intake 4	202	168784	1336290970	/users/cn/jespinosa/phecomp/data/CRG/20120502_FDF_CRG/20120502_FDF_CRG/20120504_FDF_CRG_c12.mtb	1142	11345	WWSS	food_sc	4	168582	1336290768	1	0.04	0.000198019801980198	5123	1
2	Drink 2	Intake 2	25	168833	1336291019	/users/cn/jespinosa/phecomp/data/CRG/20120502_FDF_CRG/20120502_FDF_CRG/20120504_FDF_CRG_c12.mtb	682	NA	WWSS	water	2	168808	1336290994	1	0.04	0.0016	5124	1
2	Drink 2	Intake 2	13	169655	1336291841	/users/cn/jespinosa/phecomp/data/CRG/20120502_FDF_CRG/20120502_FDF_CRG/20120504_FDF_CRG_c12.mtb	683	NA	WWSS	water	2	169642	1336291828	1	0.02	0.00153846153846154	5125	1
2	Food 2	Intake 4	942	181071	1336303257	/users/cn/jespinosa/phecomp/data/CRG/20120502_FDF_CRG/20120502_FDF_CRG/20120504_FDF_CRG_c12.mtb	1145	9068	WWSS	food_sc	4	180129	1336302315	1	0.28	0.00029723991507431	5126	1
2	Drink 1	Intake 1	20	181145	1336303331	/users/cn/jespinosa/phecomp/data/CRG/20120502_FDF_CRG/20120502_FDF_CRG/20120504_FDF_CRG_c12.mtb	403	NA	WWSS	water	1	181125	1336303311	1	0.1	0.005	5127	1
2	Drink 1	Intake 1	12	181464	1336303650	/users/cn/jespinosa/phecomp/data/CRG/20120502_FDF_CRG/20120502_FDF_CRG/20120504_FDF_CRG_c12.mtb	404	NA	WWSS	water	1	181452	1336303638	1	0.04	0.00333333333333333	5128	1
2	Drink 1	Intake 1	15	181558	1336303744	/users/cn/jespinosa/phecomp/data/CRG/20120502_FDF_CRG/20120502_FDF_CRG/20120504_FDF_CRG_c12.mtb	405	NA	WWSS	water	1	181543	1336303729	1	0.02	0.00133333333333333	5129	1
2	Food 2	Intake 4	891	191030	1336313216	/users/cn/jespinosa/phecomp/data/CRG/20120502_FDF_CRG/20120502_FDF_CRG/20120504_FDF_CRG_c12.mtb	1150	7541	WWSS	food_sc	4	190139	1336312325	1	0.3	0.000336700336700337	5130	1
2	Drink 1	Intake 1	18	191073	1336313259	/users/cn/jespinosa/phecomp/data/CRG/20120502_FDF_CRG/20120502_FDF_CRG/20120504_FDF_CRG_c12.mtb	406	NA	WWSS	water	1	191055	1336313241	1	0.04	0.00222222222222222	5131	1
2	Food 2	Intake 4	494	199065	1336321251	/users/cn/jespinosa/phecomp/data/CRG/20120502_FDF_CRG/20120502_FDF_CRG/20120504_FDF_CRG_c12.mtb	1151	7927	WWSS	food_sc	4	198571	1336320757	1	0.540000000000001	0.00109311740890688	5132	1
2	Drink 2	Intake 2	34	199542	1336321728	/users/cn/jespinosa/phecomp/data/CRG/20120502_FDF_CRG/20120502_FDF_CRG/20120504_FDF_CRG_c12.mtb	685	NA	WWSS	water	2	199508	1336321694	1	0.04	0.00117647058823529	5133	1
2	Drink 1	Intake 1	18	199593	1336321779	/users/cn/jespinosa/phecomp/data/CRG/20120502_FDF_CRG/20120502_FDF_CRG/20120504_FDF_CRG_c12.mtb	407	NA	WWSS	water	1	199575	1336321761	1	0.04	0.00222222222222222	5134	1
2	Drink 2	Intake 2	24	199965	1336322151	/users/cn/jespinosa/phecomp/data/CRG/20120502_FDF_CRG/20120502_FDF_CRG/20120504_FDF_CRG_c12.mtb	688	NA	WWSS	water	2	199941	1336322127	1	0.02	0.000833333333333333	5135	1
2	Drink 1	Intake 1	20	200132	1336322318	/users/cn/jespinosa/phecomp/data/CRG/20120502_FDF_CRG/20120502_FDF_CRG/20120504_FDF_CRG_c12.mtb	408	NA	WWSS	water	1	200112	1336322298	1	0.0600000000000001	0.00300000000000001	5136	1
2	Food 2	Intake 4	218	207210	1336329396	/users/cn/jespinosa/phecomp/data/CRG/20120502_FDF_CRG/20120502_FDF_CRG/20120504_FDF_CRG_c12.mtb	1158	44	WWSS	food_sc	4	206992	1336329178	1	0.0200000000000005	9.17431192660573e-05	5137	1
2	Food 2	Intake 4	182	207436	1336329622	/users/cn/jespinosa/phecomp/data/CRG/20120502_FDF_CRG/20120502_FDF_CRG/20120504_FDF_CRG_c12.mtb	1159	888	WWSS	food_sc	4	207254	1336329440	1	0.04	0.00021978021978022	5138	1
2	Food 2	Intake 4	21	208345	1336330531	/users/cn/jespinosa/phecomp/data/CRG/20120502_FDF_CRG/20120502_FDF_CRG/20120504_FDF_CRG_c12.mtb	1165	132	WWSS	food_sc	4	208324	1336330510	1	0.0200000000000005	0.000952380952380976	5139	1
2	Food 2	Intake 4	298	208775	1336330961	/users/cn/jespinosa/phecomp/data/CRG/20120502_FDF_CRG/20120502_FDF_CRG/20120504_FDF_CRG_c12.mtb	1166	389	WWSS	food_sc	4	208477	1336330663	1	0.04	0.000134228187919463	5140	1
2	Food 2	Intake 4	791	209955	1336332141	/users/cn/jespinosa/phecomp/data/CRG/20120502_FDF_CRG/20120502_FDF_CRG/20120504_FDF_CRG_c12.mtb	1169	911	WWSS	food_sc	4	209164	1336331350	1	0.16	0.000202275600505689	5141	1
2	Drink 2	Intake 2	22	209969	1336332155	/users/cn/jespinosa/phecomp/data/CRG/20120502_FDF_CRG/20120502_FDF_CRG/20120504_FDF_CRG_c12.mtb	693	NA	WWSS	water	2	209947	1336332133	1	0.04	0.00181818181818182	5142	1
2	Food 2	Intake 4	149	211015	1336333201	/users/cn/jespinosa/phecomp/data/CRG/20120502_FDF_CRG/20120502_FDF_CRG/20120504_FDF_CRG_c12.mtb	1179	33	WWSS	food_sc	4	210866	1336333052	1	0.0200000000000005	0.000134228187919466	5143	1
2	Drink 1	Intake 1	16	211033	1336333219	/users/cn/jespinosa/phecomp/data/CRG/20120502_FDF_CRG/20120502_FDF_CRG/20120504_FDF_CRG_c12.mtb	412	NA	WWSS	water	1	211017	1336333203	1	0.0599999999999998	0.00374999999999999	5144	1
2	Food 2	Intake 4	1200	212248	1336334434	/users/cn/jespinosa/phecomp/data/CRG/20120502_FDF_CRG/20120502_FDF_CRG/20120504_FDF_CRG_c12.mtb	1180	1905	WWSS	food_sc	4	211048	1336333234	1	0.3	0.00025	5145	1
2	Drink 2	Intake 2	42	212284	1336334470	/users/cn/jespinosa/phecomp/data/CRG/20120502_FDF_CRG/20120502_FDF_CRG/20120504_FDF_CRG_c12.mtb	696	NA	WWSS	water	2	212242	1336334428	1	0.1	0.00238095238095238	5146	1
2	Drink 1	Intake 1	24	212359	1336334545	/users/cn/jespinosa/phecomp/data/CRG/20120502_FDF_CRG/20120502_FDF_CRG/20120504_FDF_CRG_c12.mtb	413	NA	WWSS	water	1	212335	1336334521	1	0.0800000000000001	0.00333333333333334	5147	1
2	Food 2	Intake 4	123	214276	1336336462	/users/cn/jespinosa/phecomp/data/CRG/20120502_FDF_CRG/20120502_FDF_CRG/20120504_FDF_CRG_c12.mtb	1183	368	WWSS	food_sc	4	214153	1336336339	1	0.0200000000000005	0.000162601626016264	5148	1
2	Drink 2	Intake 2	12	214518	1336336704	/users/cn/jespinosa/phecomp/data/CRG/20120502_FDF_CRG/20120502_FDF_CRG/20120504_FDF_CRG_c12.mtb	704	NA	WWSS	water	2	214506	1336336692	1	0.02	0.00166666666666667	5149	1
2	Food 2	Intake 4	640	215284	1336337470	/users/cn/jespinosa/phecomp/data/CRG/20120502_FDF_CRG/20120502_FDF_CRG/20120504_FDF_CRG_c12.mtb	1186	2846	WWSS	food_sc	4	214644	1336336830	1	0.0600000000000005	9.37500000000008e-05	5150	1
2	Drink 2	Intake 2	26	215302	1336337488	/users/cn/jespinosa/phecomp/data/CRG/20120502_FDF_CRG/20120502_FDF_CRG/20120504_FDF_CRG_c12.mtb	705	NA	WWSS	water	2	215276	1336337462	1	0.0600000000000001	0.00230769230769231	5151	1
2	Drink 1	Intake 1	16	215975	1336338161	/users/cn/jespinosa/phecomp/data/CRG/20120502_FDF_CRG/20120502_FDF_CRG/20120504_FDF_CRG_c12.mtb	415	NA	WWSS	water	1	215959	1336338145	1	0.0399999999999998	0.00249999999999999	5152	1
2	Drink 1	Intake 1	22	216155	1336338341	/users/cn/jespinosa/phecomp/data/CRG/20120502_FDF_CRG/20120502_FDF_CRG/20120504_FDF_CRG_c12.mtb	416	NA	WWSS	water	1	216133	1336338319	1	0.02	0.000909090909090909	5153	1
2	Food 2	Intake 4	1111	219241	1336341427	/users/cn/jespinosa/phecomp/data/CRG/20120502_FDF_CRG/20120502_FDF_CRG/20120504_FDF_CRG_c12.mtb	1201	23	WWSS	food_sc	4	218130	1336340316	1	0.14	0.000126012601260126	5154	1
2	Food 2	Intake 4	203	219467	1336341653	/users/cn/jespinosa/phecomp/data/CRG/20120502_FDF_CRG/20120502_FDF_CRG/20120504_FDF_CRG_c12.mtb	1202	1561	WWSS	food_sc	4	219264	1336341450	1	0.0200000000000005	9.85221674876872e-05	5155	1
2	Drink 2	Intake 2	12	219470	1336341656	/users/cn/jespinosa/phecomp/data/CRG/20120502_FDF_CRG/20120502_FDF_CRG/20120504_FDF_CRG_c12.mtb	710	NA	WWSS	water	2	219458	1336341644	1	0.04	0.00333333333333333	5156	1
2	Food 2	Intake 4	586	221614	1336343800	/users/cn/jespinosa/phecomp/data/CRG/20120502_FDF_CRG/20120502_FDF_CRG/20120504_FDF_CRG_c12.mtb	1203	14	WWSS	food_sc	4	221028	1336343214	1	0.0599999999999996	0.000102389078498293	5157	1
2	Food 2	Intake 4	522	222150	1336344336	/users/cn/jespinosa/phecomp/data/CRG/20120502_FDF_CRG/20120502_FDF_CRG/20120504_FDF_CRG_c12.mtb	1204	3617	WWSS	food_sc	4	221628	1336343814	1	0.12	0.000229885057471264	5158	1
2	Drink 2	Intake 2	18	222159	1336344345	/users/cn/jespinosa/phecomp/data/CRG/20120502_FDF_CRG/20120502_FDF_CRG/20120504_FDF_CRG_c12.mtb	711	NA	WWSS	water	2	222141	1336344327	1	0.04	0.00222222222222222	5159	1
2	Drink 2	Intake 2	19	222251	1336344437	/users/cn/jespinosa/phecomp/data/CRG/20120502_FDF_CRG/20120502_FDF_CRG/20120504_FDF_CRG_c12.mtb	712	NA	WWSS	water	2	222232	1336344418	1	0.0600000000000001	0.00315789473684211	5160	1
2	Drink 1	Intake 1	25	222519	1336344705	/users/cn/jespinosa/phecomp/data/CRG/20120502_FDF_CRG/20120502_FDF_CRG/20120504_FDF_CRG_c12.mtb	419	NA	WWSS	water	1	222494	1336344680	1	0.04	0.0016	5161	1
2	Food 2	Intake 4	434	226201	1336348387	/users/cn/jespinosa/phecomp/data/CRG/20120502_FDF_CRG/20120502_FDF_CRG/20120504_FDF_CRG_c12.mtb	1217	1785	WWSS	food_sc	4	225767	1336347953	1	0.0200000000000005	4.60829493087569e-05	5162	1
2	Drink 1	Intake 1	16	226742	1336348928	/users/cn/jespinosa/phecomp/data/CRG/20120502_FDF_CRG/20120502_FDF_CRG/20120504_FDF_CRG_c12.mtb	422	NA	WWSS	water	1	226726	1336348912	1	0.02	0.00125	5163	1
2	Drink 1	Intake 1	20	227522	1336349708	/users/cn/jespinosa/phecomp/data/CRG/20120502_FDF_CRG/20120502_FDF_CRG/20120504_FDF_CRG_c12.mtb	423	NA	WWSS	water	1	227502	1336349688	1	0.02	0.001	5164	1
2	Food 2	Intake 4	539	228525	1336350711	/users/cn/jespinosa/phecomp/data/CRG/20120502_FDF_CRG/20120502_FDF_CRG/20120504_FDF_CRG_c12.mtb	1226	21	WWSS	food_sc	4	227986	1336350172	1	0.0200000000000005	3.71057513914666e-05	5165	1
2	Food 2	Intake 4	1083	229629	1336351815	/users/cn/jespinosa/phecomp/data/CRG/20120502_FDF_CRG/20120502_FDF_CRG/20120504_FDF_CRG_c12.mtb	1227	5945	WWSS	food_sc	4	228546	1336350732	1	0.22	0.000203139427516159	5166	1
2	Drink 2	Intake 2	36	229659	1336351845	/users/cn/jespinosa/phecomp/data/CRG/20120502_FDF_CRG/20120502_FDF_CRG/20120504_FDF_CRG_c12.mtb	723	NA	WWSS	water	2	229623	1336351809	1	0.1	0.00277777777777778	5167	1
2	Drink 2	Intake 2	22	229691	1336351877	/users/cn/jespinosa/phecomp/data/CRG/20120502_FDF_CRG/20120502_FDF_CRG/20120504_FDF_CRG_c12.mtb	724	NA	WWSS	water	2	229669	1336351855	1	0.0600000000000001	0.00272727272727273	5168	1
2	Drink 1	Intake 1	17	229750	1336351936	/users/cn/jespinosa/phecomp/data/CRG/20120502_FDF_CRG/20120502_FDF_CRG/20120504_FDF_CRG_c12.mtb	424	NA	WWSS	water	1	229733	1336351919	1	0.02	0.00117647058823529	5169	1
2	Drink 1	Intake 1	20	230183	1336352369	/users/cn/jespinosa/phecomp/data/CRG/20120502_FDF_CRG/20120502_FDF_CRG/20120504_FDF_CRG_c12.mtb	425	NA	WWSS	water	1	230163	1336352349	1	0.0600000000000001	0.00300000000000001	5170	1
2	Food 2	Intake 4	1061	236635	1336358821	/users/cn/jespinosa/phecomp/data/CRG/20120502_FDF_CRG/20120502_FDF_CRG/20120504_FDF_CRG_c12.mtb	1235	383	WWSS	food_sc	4	235574	1336357760	1	0.26	0.000245051837888784	5171	1
2	Drink 2	Intake 2	33	236661	1336358847	/users/cn/jespinosa/phecomp/data/CRG/20120502_FDF_CRG/20120502_FDF_CRG/20120504_FDF_CRG_c12.mtb	726	NA	WWSS	water	2	236628	1336358814	1	0.12	0.00363636363636364	5172	1
2	Drink 2	Intake 2	25	236695	1336358881	/users/cn/jespinosa/phecomp/data/CRG/20120502_FDF_CRG/20120502_FDF_CRG/20120504_FDF_CRG_c12.mtb	727	NA	WWSS	water	2	236670	1336358856	1	0.0599999999999996	0.00239999999999998	5173	1
2	Drink 1	Intake 1	19	236846	1336359032	/users/cn/jespinosa/phecomp/data/CRG/20120502_FDF_CRG/20120502_FDF_CRG/20120504_FDF_CRG_c12.mtb	426	NA	WWSS	water	1	236827	1336359013	1	0.02	0.00105263157894737	5174	1
2	Drink 2	Intake 2	18	236899	1336359085	/users/cn/jespinosa/phecomp/data/CRG/20120502_FDF_CRG/20120502_FDF_CRG/20120504_FDF_CRG_c12.mtb	728	NA	WWSS	water	2	236881	1336359067	1	0.04	0.00222222222222222	5175	1
2	Drink 2	Intake 2	60	236968	1336359154	/users/cn/jespinosa/phecomp/data/CRG/20120502_FDF_CRG/20120502_FDF_CRG/20120504_FDF_CRG_c12.mtb	729	NA	WWSS	water	2	236908	1336359094	1	0.0200000000000005	0.000333333333333342	5176	1
2	Drink 2	Intake 2	44	237018	1336359204	/users/cn/jespinosa/phecomp/data/CRG/20120502_FDF_CRG/20120502_FDF_CRG/20120504_FDF_CRG_c12.mtb	730	NA	WWSS	water	2	236974	1336359160	1	0.04	0.000909090909090909	5177	1
2	Food 2	Intake 4	590	237608	1336359794	/users/cn/jespinosa/phecomp/data/CRG/20120502_FDF_CRG/20120502_FDF_CRG/20120504_FDF_CRG_c12.mtb	1237	5241	WWSS	food_sc	4	237018	1336359204	1	0.220000000000001	0.000372881355932205	5178	1
2	Drink 2	Intake 2	32	237638	1336359824	/users/cn/jespinosa/phecomp/data/CRG/20120502_FDF_CRG/20120502_FDF_CRG/20120504_FDF_CRG_c12.mtb	731	NA	WWSS	water	2	237606	1336359792	1	0.0800000000000001	0.0025	5179	1
2	Drink 1	Intake 1	16	238040	1336360226	/users/cn/jespinosa/phecomp/data/CRG/20120502_FDF_CRG/20120502_FDF_CRG/20120504_FDF_CRG_c12.mtb	428	NA	WWSS	water	1	238024	1336360210	1	0.0600000000000001	0.00375000000000001	5180	1
2	Food 2	Intake 4	749	243598	1336365784	/users/cn/jespinosa/phecomp/data/CRG/20120502_FDF_CRG/20120502_FDF_CRG/20120504_FDF_CRG_c12.mtb	1241	455	WWSS	food_sc	4	242849	1336365035	1	0.22	0.000293724966622163	5181	1
2	Drink 1	Intake 1	18	243624	1336365810	/users/cn/jespinosa/phecomp/data/CRG/20120502_FDF_CRG/20120502_FDF_CRG/20120504_FDF_CRG_c12.mtb	429	NA	WWSS	water	1	243606	1336365792	1	0.04	0.00222222222222222	5182	1
2	Drink 2	Intake 2	25	243689	1336365875	/users/cn/jespinosa/phecomp/data/CRG/20120502_FDF_CRG/20120502_FDF_CRG/20120504_FDF_CRG_c12.mtb	737	NA	WWSS	water	2	243664	1336365850	1	0.04	0.0016	5183	1
2	Drink 2	Intake 2	45	243988	1336366174	/users/cn/jespinosa/phecomp/data/CRG/20120502_FDF_CRG/20120502_FDF_CRG/20120504_FDF_CRG_c12.mtb	738	NA	WWSS	water	2	243943	1336366129	1	0.0800000000000001	0.00177777777777778	5184	1
2	Food 2	Intake 4	662	244715	1336366901	/users/cn/jespinosa/phecomp/data/CRG/20120502_FDF_CRG/20120502_FDF_CRG/20120504_FDF_CRG_c12.mtb	1242	448	WWSS	food_sc	4	244053	1336366239	1	0.22	0.000332326283987915	5185	1
2	Drink 2	Intake 2	33	244751	1336366937	/users/cn/jespinosa/phecomp/data/CRG/20120502_FDF_CRG/20120502_FDF_CRG/20120504_FDF_CRG_c12.mtb	740	NA	WWSS	water	2	244718	1336366904	1	0.12	0.00363636363636364	5186	1
2	Drink 1	Intake 1	26	244842	1336367028	/users/cn/jespinosa/phecomp/data/CRG/20120502_FDF_CRG/20120502_FDF_CRG/20120504_FDF_CRG_c12.mtb	430	NA	WWSS	water	1	244816	1336367002	1	0.1	0.00384615384615385	5187	1
2	Food 2	Intake 4	158	245321	1336367507	/users/cn/jespinosa/phecomp/data/CRG/20120502_FDF_CRG/20120502_FDF_CRG/20120504_FDF_CRG_c12.mtb	1243	737	WWSS	food_sc	4	245163	1336367349	1	0.0200000000000005	0.000126582278481016	5188	1
2	Food 2	Intake 4	74	246132	1336368318	/users/cn/jespinosa/phecomp/data/CRG/20120502_FDF_CRG/20120502_FDF_CRG/20120504_FDF_CRG_c12.mtb	1247	6	WWSS	food_sc	4	246058	1336368244	1	0.0200000000000005	0.000270270270270277	5189	1
2	Food 2	Intake 4	390	246528	1336368714	/users/cn/jespinosa/phecomp/data/CRG/20120502_FDF_CRG/20120502_FDF_CRG/20120504_FDF_CRG_c12.mtb	1248	7443	WWSS	food_sc	4	246138	1336368324	1	0.119999999999999	0.000307692307692305	5190	1
2	Drink 2	Intake 2	26	246550	1336368736	/users/cn/jespinosa/phecomp/data/CRG/20120502_FDF_CRG/20120502_FDF_CRG/20120504_FDF_CRG_c12.mtb	747	NA	WWSS	water	2	246524	1336368710	1	0.0999999999999996	0.00384615384615383	5191	1
2	Food 2	Intake 4	504	254475	1336376661	/users/cn/jespinosa/phecomp/data/CRG/20120502_FDF_CRG/20120502_FDF_CRG/20120504_FDF_CRG_c12.mtb	1258	6334	WWSS	food_sc	4	253971	1336376157	1	0.180000000000001	0.000357142857142859	5192	1
2	Drink 2	Intake 2	25	254565	1336376751	/users/cn/jespinosa/phecomp/data/CRG/20120502_FDF_CRG/20120502_FDF_CRG/20120504_FDF_CRG_c12.mtb	750	NA	WWSS	water	2	254540	1336376726	1	0.100000000000001	0.00400000000000004	5193	1
2	Food 2	Intake 4	184	668	1336383179	/users/cn/jespinosa/phecomp/data/CRG/20120502_FDF_CRG/20120502_FDF_CRG/20120507_FDF_CRG_c12.mtb	1425	3847	WWSS	food_sc	4	484	1336382995	1	0.08	0.000434782608695652	5194	1
2	Food 2	Intake 4	316	4831	1336387342	/users/cn/jespinosa/phecomp/data/CRG/20120502_FDF_CRG/20120502_FDF_CRG/20120507_FDF_CRG_c12.mtb	1428	4350	WWSS	food_sc	4	4515	1336387026	1	0.08	0.000253164556962025	5195	1
2	Food 2	Intake 4	132	9313	1336391824	/users/cn/jespinosa/phecomp/data/CRG/20120502_FDF_CRG/20120502_FDF_CRG/20120507_FDF_CRG_c12.mtb	1433	6916	WWSS	food_sc	4	9181	1336391692	1	0.04	0.000303030303030303	5196	1
2	Food 2	Intake 4	211	16440	1336398951	/users/cn/jespinosa/phecomp/data/CRG/20120502_FDF_CRG/20120502_FDF_CRG/20120507_FDF_CRG_c12.mtb	1440	179	WWSS	food_sc	4	16229	1336398740	1	0.02	9.47867298578199e-05	5197	1
2	Food 2	Intake 4	194	16813	1336399324	/users/cn/jespinosa/phecomp/data/CRG/20120502_FDF_CRG/20120502_FDF_CRG/20120507_FDF_CRG_c12.mtb	1441	15828	WWSS	food_sc	4	16619	1336399130	1	0.04	0.000206185567010309	5198	1
2	Drink 2	Intake 2	15	17126	1336399637	/users/cn/jespinosa/phecomp/data/CRG/20120502_FDF_CRG/20120502_FDF_CRG/20120507_FDF_CRG_c12.mtb	850	NA	WWSS	water	2	17111	1336399622	1	0.02	0.00133333333333333	5199	1
2	Food 2	Intake 4	168	32809	1336415320	/users/cn/jespinosa/phecomp/data/CRG/20120502_FDF_CRG/20120502_FDF_CRG/20120507_FDF_CRG_c12.mtb	1453	1536	WWSS	food_sc	4	32641	1336415152	1	0.02	0.000119047619047619	5200	1
2	Food 1	Intake 3	686	35031	1336417542	/users/cn/jespinosa/phecomp/data/CRG/20120502_FDF_CRG/20120502_FDF_CRG/20120507_FDF_CRG_c12.mtb	768	44	WWSS	food_sc	3	34345	1336416856	1	0.08	0.000116618075801749	5201	1
2	Food 1	Intake 3	46	35121	1336417632	/users/cn/jespinosa/phecomp/data/CRG/20120502_FDF_CRG/20120502_FDF_CRG/20120507_FDF_CRG_c12.mtb	769	2493	WWSS	food_sc	3	35075	1336417586	1	0.02	0.000434782608695652	5202	1
2	Drink 2	Intake 2	28	35344	1336417855	/users/cn/jespinosa/phecomp/data/CRG/20120502_FDF_CRG/20120502_FDF_CRG/20120507_FDF_CRG_c12.mtb	853	NA	WWSS	water	2	35316	1336417827	1	0.02	0.000714285714285714	5203	1
2	Drink 2	Intake 2	13	36409	1336418920	/users/cn/jespinosa/phecomp/data/CRG/20120502_FDF_CRG/20120502_FDF_CRG/20120507_FDF_CRG_c12.mtb	855	NA	WWSS	water	2	36396	1336418907	1	0.02	0.00153846153846154	5204	1
2	Food 2	Intake 4	302	37916	1336420427	/users/cn/jespinosa/phecomp/data/CRG/20120502_FDF_CRG/20120502_FDF_CRG/20120507_FDF_CRG_c12.mtb	1462	9	WWSS	food_sc	4	37614	1336420125	1	0.04	0.000132450331125828	5205	1
2	Food 2	Intake 4	104	38029	1336420540	/users/cn/jespinosa/phecomp/data/CRG/20120502_FDF_CRG/20120502_FDF_CRG/20120507_FDF_CRG_c12.mtb	1463	10	WWSS	food_sc	4	37925	1336420436	1	0.08	0.000769230769230769	5206	1
2	Food 2	Intake 4	741	38780	1336421291	/users/cn/jespinosa/phecomp/data/CRG/20120502_FDF_CRG/20120502_FDF_CRG/20120507_FDF_CRG_c12.mtb	1464	37	WWSS	food_sc	4	38039	1336420550	1	0.1	0.000134952766531714	5207	1
2	Drink 2	Intake 2	25	38799	1336421310	/users/cn/jespinosa/phecomp/data/CRG/20120502_FDF_CRG/20120502_FDF_CRG/20120507_FDF_CRG_c12.mtb	857	NA	WWSS	water	2	38774	1336421285	1	0.06	0.0024	5208	1
2	Food 2	Intake 4	245	39062	1336421573	/users/cn/jespinosa/phecomp/data/CRG/20120502_FDF_CRG/20120502_FDF_CRG/20120507_FDF_CRG_c12.mtb	1465	268	WWSS	food_sc	4	38817	1336421328	1	0.04	0.000163265306122449	5209	1
2	Drink 2	Intake 2	30	39084	1336421595	/users/cn/jespinosa/phecomp/data/CRG/20120502_FDF_CRG/20120502_FDF_CRG/20120507_FDF_CRG_c12.mtb	858	NA	WWSS	water	2	39054	1336421565	1	0.1	0.00333333333333333	5210	1
2	Food 2	Intake 4	575	39905	1336422416	/users/cn/jespinosa/phecomp/data/CRG/20120502_FDF_CRG/20120502_FDF_CRG/20120507_FDF_CRG_c12.mtb	1468	1528	WWSS	food_sc	4	39330	1336421841	1	0.2	0.000347826086956522	5211	1
2	Drink 2	Intake 2	25	39924	1336422435	/users/cn/jespinosa/phecomp/data/CRG/20120502_FDF_CRG/20120502_FDF_CRG/20120507_FDF_CRG_c12.mtb	859	NA	WWSS	water	2	39899	1336422410	1	0.06	0.0024	5212	1
2	Drink 2	Intake 2	20	40001	1336422512	/users/cn/jespinosa/phecomp/data/CRG/20120502_FDF_CRG/20120502_FDF_CRG/20120507_FDF_CRG_c12.mtb	860	NA	WWSS	water	2	39981	1336422492	1	0.06	0.003	5213	1
2	Drink 1	Intake 1	20	40023	1336422534	/users/cn/jespinosa/phecomp/data/CRG/20120502_FDF_CRG/20120502_FDF_CRG/20120507_FDF_CRG_c12.mtb	513	NA	WWSS	water	1	40003	1336422514	1	0.02	0.001	5214	1
2	Drink 1	Intake 1	15	41435	1336423946	/users/cn/jespinosa/phecomp/data/CRG/20120502_FDF_CRG/20120502_FDF_CRG/20120507_FDF_CRG_c12.mtb	514	NA	WWSS	water	1	41420	1336423931	1	0.02	0.00133333333333333	5215	1
2	Food 2	Intake 4	887	42320	1336424831	/users/cn/jespinosa/phecomp/data/CRG/20120502_FDF_CRG/20120502_FDF_CRG/20120507_FDF_CRG_c12.mtb	1470	1113	WWSS	food_sc	4	41433	1336423944	1	0.16	0.000180383314543405	5216	1
2	Drink 2	Intake 2	24	42339	1336424850	/users/cn/jespinosa/phecomp/data/CRG/20120502_FDF_CRG/20120502_FDF_CRG/20120507_FDF_CRG_c12.mtb	861	NA	WWSS	water	2	42315	1336424826	1	0.04	0.00166666666666667	5217	1
2	Drink 2	Intake 2	20	42434	1336424945	/users/cn/jespinosa/phecomp/data/CRG/20120502_FDF_CRG/20120502_FDF_CRG/20120507_FDF_CRG_c12.mtb	862	NA	WWSS	water	2	42414	1336424925	1	0.02	0.001	5218	1
2	Drink 2	Intake 2	20	43433	1336425944	/users/cn/jespinosa/phecomp/data/CRG/20120502_FDF_CRG/20120502_FDF_CRG/20120507_FDF_CRG_c12.mtb	863	NA	WWSS	water	2	43413	1336425924	1	0.04	0.002	5219	1
2	Food 2	Intake 4	868	44301	1336426812	/users/cn/jespinosa/phecomp/data/CRG/20120502_FDF_CRG/20120502_FDF_CRG/20120507_FDF_CRG_c12.mtb	1473	41	WWSS	food_sc	4	43433	1336425944	1	0.26	0.000299539170506912	5220	1
2	Drink 2	Intake 2	36	44329	1336426840	/users/cn/jespinosa/phecomp/data/CRG/20120502_FDF_CRG/20120502_FDF_CRG/20120507_FDF_CRG_c12.mtb	864	NA	WWSS	water	2	44293	1336426804	1	0.12	0.00333333333333333	5221	1
2	Food 2	Intake 4	174	44516	1336427027	/users/cn/jespinosa/phecomp/data/CRG/20120502_FDF_CRG/20120502_FDF_CRG/20120507_FDF_CRG_c12.mtb	1474	157	WWSS	food_sc	4	44342	1336426853	1	0.04	0.000229885057471264	5222	1
2	Drink 2	Intake 2	20	44607	1336427118	/users/cn/jespinosa/phecomp/data/CRG/20120502_FDF_CRG/20120502_FDF_CRG/20120507_FDF_CRG_c12.mtb	866	NA	WWSS	water	2	44587	1336427098	1	0.04	0.002	5223	1
2	Food 2	Intake 4	50	44723	1336427234	/users/cn/jespinosa/phecomp/data/CRG/20120502_FDF_CRG/20120502_FDF_CRG/20120507_FDF_CRG_c12.mtb	1475	288	WWSS	food_sc	4	44673	1336427184	1	0.02	0.0004	5224	1
2	Drink 2	Intake 2	16	44883	1336427394	/users/cn/jespinosa/phecomp/data/CRG/20120502_FDF_CRG/20120502_FDF_CRG/20120507_FDF_CRG_c12.mtb	868	NA	WWSS	water	2	44867	1336427378	1	0.02	0.00125	5225	1
2	Drink 2	Intake 2	12	44990	1336427501	/users/cn/jespinosa/phecomp/data/CRG/20120502_FDF_CRG/20120502_FDF_CRG/20120507_FDF_CRG_c12.mtb	869	NA	WWSS	water	2	44978	1336427489	1	0.02	0.00166666666666667	5226	1
2	Food 2	Intake 4	662	45673	1336428184	/users/cn/jespinosa/phecomp/data/CRG/20120502_FDF_CRG/20120502_FDF_CRG/20120507_FDF_CRG_c12.mtb	1478	49	WWSS	food_sc	4	45011	1336427522	1	0.18	0.00027190332326284	5227	1
2	Drink 1	Intake 1	37	45709	1336428220	/users/cn/jespinosa/phecomp/data/CRG/20120502_FDF_CRG/20120502_FDF_CRG/20120507_FDF_CRG_c12.mtb	518	NA	WWSS	water	1	45672	1336428183	1	0.12	0.00324324324324324	5228	1
2	Food 2	Intake 4	91	45813	1336428324	/users/cn/jespinosa/phecomp/data/CRG/20120502_FDF_CRG/20120502_FDF_CRG/20120507_FDF_CRG_c12.mtb	1479	94	WWSS	food_sc	4	45722	1336428233	1	0.02	0.00021978021978022	5229	1
2	Drink 2	Intake 2	15	45825	1336428336	/users/cn/jespinosa/phecomp/data/CRG/20120502_FDF_CRG/20120502_FDF_CRG/20120507_FDF_CRG_c12.mtb	870	NA	WWSS	water	2	45810	1336428321	1	0.0399999999999999	0.00266666666666666	5230	1
2	Food 2	Intake 4	440	46347	1336428858	/users/cn/jespinosa/phecomp/data/CRG/20120502_FDF_CRG/20120502_FDF_CRG/20120507_FDF_CRG_c12.mtb	1480	1233	WWSS	food_sc	4	45907	1336428418	1	0.2	0.000454545454545455	5231	1
2	Drink 2	Intake 2	32	46374	1336428885	/users/cn/jespinosa/phecomp/data/CRG/20120502_FDF_CRG/20120502_FDF_CRG/20120507_FDF_CRG_c12.mtb	871	NA	WWSS	water	2	46342	1336428853	1	0.0800000000000001	0.0025	5232	1
2	Drink 2	Intake 2	19	46931	1336429442	/users/cn/jespinosa/phecomp/data/CRG/20120502_FDF_CRG/20120502_FDF_CRG/20120507_FDF_CRG_c12.mtb	872	NA	WWSS	water	2	46912	1336429423	1	0.0599999999999999	0.0031578947368421	5233	1
2	Drink 1	Intake 1	12	47491	1336430002	/users/cn/jespinosa/phecomp/data/CRG/20120502_FDF_CRG/20120502_FDF_CRG/20120507_FDF_CRG_c12.mtb	519	NA	WWSS	water	1	47479	1336429990	1	0.04	0.00333333333333333	5234	1
2	Food 2	Intake 4	155	47735	1336430246	/users/cn/jespinosa/phecomp/data/CRG/20120502_FDF_CRG/20120502_FDF_CRG/20120507_FDF_CRG_c12.mtb	1483	35	WWSS	food_sc	4	47580	1336430091	1	0.04	0.000258064516129032	5235	1
2	Food 2	Intake 4	193	47963	1336430474	/users/cn/jespinosa/phecomp/data/CRG/20120502_FDF_CRG/20120502_FDF_CRG/20120507_FDF_CRG_c12.mtb	1484	6073	WWSS	food_sc	4	47770	1336430281	1	0.0399999999999998	0.000207253886010362	5236	1
2	Drink 2	Intake 2	18	47982	1336430493	/users/cn/jespinosa/phecomp/data/CRG/20120502_FDF_CRG/20120502_FDF_CRG/20120507_FDF_CRG_c12.mtb	874	NA	WWSS	water	2	47964	1336430475	1	0.02	0.00111111111111111	5237	1
2	Drink 2	Intake 2	20	48919	1336431430	/users/cn/jespinosa/phecomp/data/CRG/20120502_FDF_CRG/20120502_FDF_CRG/20120507_FDF_CRG_c12.mtb	875	NA	WWSS	water	2	48899	1336431410	1	0.04	0.002	5238	1
2	Drink 2	Intake 2	17	54049	1336436560	/users/cn/jespinosa/phecomp/data/CRG/20120502_FDF_CRG/20120502_FDF_CRG/20120507_FDF_CRG_c12.mtb	877	NA	WWSS	water	2	54032	1336436543	1	0.02	0.00117647058823529	5239	1
2	Food 2	Intake 4	1117	55153	1336437664	/users/cn/jespinosa/phecomp/data/CRG/20120502_FDF_CRG/20120502_FDF_CRG/20120507_FDF_CRG_c12.mtb	1488	766	WWSS	food_sc	4	54036	1336436547	1	0.3	0.00026857654431513	5240	1
2	Drink 1	Intake 1	22	55176	1336437687	/users/cn/jespinosa/phecomp/data/CRG/20120502_FDF_CRG/20120502_FDF_CRG/20120507_FDF_CRG_c12.mtb	520	NA	WWSS	water	1	55154	1336437665	1	0.06	0.00272727272727273	5241	1
2	Drink 2	Intake 2	15	55302	1336437813	/users/cn/jespinosa/phecomp/data/CRG/20120502_FDF_CRG/20120502_FDF_CRG/20120507_FDF_CRG_c12.mtb	879	NA	WWSS	water	2	55287	1336437798	1	0.0399999999999999	0.00266666666666666	5242	1
2	Drink 2	Intake 2	38	55431	1336437942	/users/cn/jespinosa/phecomp/data/CRG/20120502_FDF_CRG/20120502_FDF_CRG/20120507_FDF_CRG_c12.mtb	880	NA	WWSS	water	2	55393	1336437904	1	0.04	0.00105263157894737	5243	1
2	Drink 2	Intake 2	30	55643	1336438154	/users/cn/jespinosa/phecomp/data/CRG/20120502_FDF_CRG/20120502_FDF_CRG/20120507_FDF_CRG_c12.mtb	882	NA	WWSS	water	2	55613	1336438124	1	0.04	0.00133333333333333	5244	1
2	Food 2	Intake 4	206	56125	1336438636	/users/cn/jespinosa/phecomp/data/CRG/20120502_FDF_CRG/20120502_FDF_CRG/20120507_FDF_CRG_c12.mtb	1494	4	WWSS	food_sc	4	55919	1336438430	1	0.0800000000000001	0.000388349514563107	5245	1
2	Food 2	Intake 4	128	56257	1336438768	/users/cn/jespinosa/phecomp/data/CRG/20120502_FDF_CRG/20120502_FDF_CRG/20120507_FDF_CRG_c12.mtb	1495	319	WWSS	food_sc	4	56129	1336438640	1	0.0600000000000001	0.000468750000000001	5246	1
2	Drink 2	Intake 2	23	56275	1336438786	/users/cn/jespinosa/phecomp/data/CRG/20120502_FDF_CRG/20120502_FDF_CRG/20120507_FDF_CRG_c12.mtb	886	NA	WWSS	water	2	56252	1336438763	1	0.04	0.00173913043478261	5247	1
2	Drink 1	Intake 1	21	56503	1336439014	/users/cn/jespinosa/phecomp/data/CRG/20120502_FDF_CRG/20120502_FDF_CRG/20120507_FDF_CRG_c12.mtb	521	NA	WWSS	water	1	56482	1336438993	1	0.02	0.000952380952380952	5248	1
2	Food 2	Intake 4	61	56637	1336439148	/users/cn/jespinosa/phecomp/data/CRG/20120502_FDF_CRG/20120502_FDF_CRG/20120507_FDF_CRG_c12.mtb	1497	4396	WWSS	food_sc	4	56576	1336439087	1	0.48	0.00786885245901639	5249	1
2	Drink 2	Intake 2	57	56945	1336439456	/users/cn/jespinosa/phecomp/data/CRG/20120502_FDF_CRG/20120502_FDF_CRG/20120507_FDF_CRG_c12.mtb	890	NA	WWSS	water	2	56888	1336439399	1	0.12	0.00210526315789474	5250	1
2	Drink 2	Intake 2	31	57702	1336440213	/users/cn/jespinosa/phecomp/data/CRG/20120502_FDF_CRG/20120502_FDF_CRG/20120507_FDF_CRG_c12.mtb	891	NA	WWSS	water	2	57671	1336440182	1	0.04	0.00129032258064516	5251	1
2	Drink 1	Intake 1	12	60818	1336443329	/users/cn/jespinosa/phecomp/data/CRG/20120502_FDF_CRG/20120502_FDF_CRG/20120507_FDF_CRG_c12.mtb	522	NA	WWSS	water	1	60806	1336443317	1	0.06	0.005	5252	1
2	Food 2	Intake 4	18	61051	1336443562	/users/cn/jespinosa/phecomp/data/CRG/20120502_FDF_CRG/20120502_FDF_CRG/20120507_FDF_CRG_c12.mtb	1500	5692	WWSS	food_sc	4	61033	1336443544	1	0.02	0.00111111111111111	5253	1
2	Drink 2	Intake 2	58	61473	1336443984	/users/cn/jespinosa/phecomp/data/CRG/20120502_FDF_CRG/20120502_FDF_CRG/20120507_FDF_CRG_c12.mtb	895	NA	WWSS	water	2	61415	1336443926	1	0.02	0.000344827586206897	5254	1
2	Drink 2	Intake 2	16	62014	1336444525	/users/cn/jespinosa/phecomp/data/CRG/20120502_FDF_CRG/20120502_FDF_CRG/20120507_FDF_CRG_c12.mtb	900	NA	WWSS	water	2	61998	1336444509	1	0.02	0.00125	5255	1
2	Drink 1	Intake 1	18	62105	1336444616	/users/cn/jespinosa/phecomp/data/CRG/20120502_FDF_CRG/20120502_FDF_CRG/20120507_FDF_CRG_c12.mtb	523	NA	WWSS	water	1	62087	1336444598	1	0.04	0.00222222222222222	5256	1
2	Food 2	Intake 4	86	66829	1336449340	/users/cn/jespinosa/phecomp/data/CRG/20120502_FDF_CRG/20120502_FDF_CRG/20120507_FDF_CRG_c12.mtb	1505	1410	WWSS	food_sc	4	66743	1336449254	1	0.02	0.000232558139534884	5257	1
2	Food 1	Intake 3	346	68585	1336451096	/users/cn/jespinosa/phecomp/data/CRG/20120502_FDF_CRG/20120502_FDF_CRG/20120507_FDF_CRG_c12.mtb	785	95	WWSS	food_sc	3	68239	1336450750	1	0.08	0.00023121387283237	5258	1
2	Drink 1	Intake 1	15	68604	1336451115	/users/cn/jespinosa/phecomp/data/CRG/20120502_FDF_CRG/20120502_FDF_CRG/20120507_FDF_CRG_c12.mtb	524	NA	WWSS	water	1	68589	1336451100	1	0.02	0.00133333333333333	5259	1
2	Drink 1	Intake 1	11	68657	1336451168	/users/cn/jespinosa/phecomp/data/CRG/20120502_FDF_CRG/20120502_FDF_CRG/20120507_FDF_CRG_c12.mtb	525	NA	WWSS	water	1	68646	1336451157	1	0.04	0.00363636363636364	5260	1
2	Food 1	Intake 3	427	69107	1336451618	/users/cn/jespinosa/phecomp/data/CRG/20120502_FDF_CRG/20120502_FDF_CRG/20120507_FDF_CRG_c12.mtb	787	909	WWSS	food_sc	3	68680	1336451191	1	0.18	0.000421545667447307	5261	1
2	Drink 2	Intake 2	24	69127	1336451638	/users/cn/jespinosa/phecomp/data/CRG/20120502_FDF_CRG/20120502_FDF_CRG/20120507_FDF_CRG_c12.mtb	901	NA	WWSS	water	2	69103	1336451614	1	0.0600000000000001	0.0025	5262	1
2	Drink 2	Intake 2	26	69172	1336451683	/users/cn/jespinosa/phecomp/data/CRG/20120502_FDF_CRG/20120502_FDF_CRG/20120507_FDF_CRG_c12.mtb	902	NA	WWSS	water	2	69146	1336451657	1	0.0599999999999998	0.0023076923076923	5263	1
2	Drink 2	Intake 2	14	69406	1336451917	/users/cn/jespinosa/phecomp/data/CRG/20120502_FDF_CRG/20120502_FDF_CRG/20120507_FDF_CRG_c12.mtb	903	NA	WWSS	water	2	69392	1336451903	1	0.02	0.00142857142857143	5264	1
2	Drink 1	Intake 1	12	69465	1336451976	/users/cn/jespinosa/phecomp/data/CRG/20120502_FDF_CRG/20120502_FDF_CRG/20120507_FDF_CRG_c12.mtb	526	NA	WWSS	water	1	69453	1336451964	1	0.02	0.00166666666666667	5265	1
2	Drink 1	Intake 1	16	69586	1336452097	/users/cn/jespinosa/phecomp/data/CRG/20120502_FDF_CRG/20120502_FDF_CRG/20120507_FDF_CRG_c12.mtb	527	NA	WWSS	water	1	69570	1336452081	1	0.04	0.0025	5266	1
2	Food 1	Intake 3	457	70473	1336452984	/users/cn/jespinosa/phecomp/data/CRG/20120502_FDF_CRG/20120502_FDF_CRG/20120507_FDF_CRG_c12.mtb	793	4393	WWSS	food_sc	3	70016	1336452527	1	0.18	0.000393873085339168	5267	1
2	Drink 2	Intake 2	20	71056	1336453567	/users/cn/jespinosa/phecomp/data/CRG/20120502_FDF_CRG/20120502_FDF_CRG/20120507_FDF_CRG_c12.mtb	906	NA	WWSS	water	2	71036	1336453547	1	0.0600000000000001	0.00300000000000001	5268	1
2	Drink 2	Intake 2	13	71201	1336453712	/users/cn/jespinosa/phecomp/data/CRG/20120502_FDF_CRG/20120502_FDF_CRG/20120507_FDF_CRG_c12.mtb	907	NA	WWSS	water	2	71188	1336453699	1	0.0600000000000001	0.00461538461538462	5269	1
2	Drink 2	Intake 2	20	71500	1336454011	/users/cn/jespinosa/phecomp/data/CRG/20120502_FDF_CRG/20120502_FDF_CRG/20120507_FDF_CRG_c12.mtb	908	NA	WWSS	water	2	71480	1336453991	1	0.02	0.001	5270	1
2	Food 1	Intake 3	294	75160	1336457671	/users/cn/jespinosa/phecomp/data/CRG/20120502_FDF_CRG/20120502_FDF_CRG/20120507_FDF_CRG_c12.mtb	796	3118	WWSS	food_sc	3	74866	1336457377	1	0.1	0.000340136054421769	5271	1
2	Food 1	Intake 3	317	78595	1336461106	/users/cn/jespinosa/phecomp/data/CRG/20120502_FDF_CRG/20120502_FDF_CRG/20120507_FDF_CRG_c12.mtb	797	7	WWSS	food_sc	3	78278	1336460789	1	0.14	0.000441640378548896	5272	1
2	Food 1	Intake 3	41	78643	1336461154	/users/cn/jespinosa/phecomp/data/CRG/20120502_FDF_CRG/20120502_FDF_CRG/20120507_FDF_CRG_c12.mtb	798	1299	WWSS	food_sc	3	78602	1336461113	1	0.02	0.00048780487804878	5273	1
2	Drink 2	Intake 2	22	79206	1336461717	/users/cn/jespinosa/phecomp/data/CRG/20120502_FDF_CRG/20120502_FDF_CRG/20120507_FDF_CRG_c12.mtb	912	NA	WWSS	water	2	79184	1336461695	1	0.02	0.000909090909090909	5274	1
2	Drink 2	Intake 2	195	79696	1336462207	/users/cn/jespinosa/phecomp/data/CRG/20120502_FDF_CRG/20120502_FDF_CRG/20120507_FDF_CRG_c12.mtb	913	NA	WWSS	water	2	79501	1336462012	1	0.02	0.000102564102564103	5275	1
2	Drink 1	Intake 1	35	79876	1336462387	/users/cn/jespinosa/phecomp/data/CRG/20120502_FDF_CRG/20120502_FDF_CRG/20120507_FDF_CRG_c12.mtb	530	NA	WWSS	water	1	79841	1336462352	1	0.04	0.00114285714285714	5276	1
2	Drink 1	Intake 1	15	79911	1336462422	/users/cn/jespinosa/phecomp/data/CRG/20120502_FDF_CRG/20120502_FDF_CRG/20120507_FDF_CRG_c12.mtb	531	NA	WWSS	water	1	79896	1336462407	1	0.02	0.00133333333333333	5277	1
2	Food 1	Intake 3	55	79997	1336462508	/users/cn/jespinosa/phecomp/data/CRG/20120502_FDF_CRG/20120502_FDF_CRG/20120507_FDF_CRG_c12.mtb	802	6	WWSS	food_sc	3	79942	1336462453	1	0.0399999999999999	0.000727272727272725	5278	1
2	Food 1	Intake 3	62	80065	1336462576	/users/cn/jespinosa/phecomp/data/CRG/20120502_FDF_CRG/20120502_FDF_CRG/20120507_FDF_CRG_c12.mtb	803	5193	WWSS	food_sc	3	80003	1336462514	1	0.04	0.000645161290322581	5279	1
2	Food 1	Intake 3	25	85283	1336467794	/users/cn/jespinosa/phecomp/data/CRG/20120502_FDF_CRG/20120502_FDF_CRG/20120507_FDF_CRG_c12.mtb	804	20	WWSS	food_sc	3	85258	1336467769	1	0.02	0.0008	5280	1
2	Food 1	Intake 3	67	85370	1336467881	/users/cn/jespinosa/phecomp/data/CRG/20120502_FDF_CRG/20120502_FDF_CRG/20120507_FDF_CRG_c12.mtb	805	6228	WWSS	food_sc	3	85303	1336467814	1	0.2	0.00298507462686567	5281	1
2	Drink 2	Intake 2	20	85898	1336468409	/users/cn/jespinosa/phecomp/data/CRG/20120502_FDF_CRG/20120502_FDF_CRG/20120507_FDF_CRG_c12.mtb	918	NA	WWSS	water	2	85878	1336468389	1	0.02	0.001	5282	1
2	Drink 1	Intake 1	19	86289	1336468800	/users/cn/jespinosa/phecomp/data/CRG/20120502_FDF_CRG/20120502_FDF_CRG/20120507_FDF_CRG_c12.mtb	532	NA	WWSS	water	1	86270	1336468781	1	0.08	0.00421052631578947	5283	1
2	Food 1	Intake 3	20	91618	1336474129	/users/cn/jespinosa/phecomp/data/CRG/20120502_FDF_CRG/20120502_FDF_CRG/20120507_FDF_CRG_c12.mtb	809	6873	WWSS	food_sc	3	91598	1336474109	1	0.02	0.001	5284	1
2	Food 1	Intake 3	59	98550	1336481061	/users/cn/jespinosa/phecomp/data/CRG/20120502_FDF_CRG/20120502_FDF_CRG/20120507_FDF_CRG_c12.mtb	812	19609	WWSS	food_sc	3	98491	1336481002	1	0.02	0.000338983050847458	5285	1
2	Food 2	Intake 4	121	118280	1336500791	/users/cn/jespinosa/phecomp/data/CRG/20120502_FDF_CRG/20120502_FDF_CRG/20120507_FDF_CRG_c12.mtb	1521	197	WWSS	food_sc	4	118159	1336500670	1	0.02	0.000165289256198347	5286	1
2	Drink 2	Intake 2	20	118474	1336500985	/users/cn/jespinosa/phecomp/data/CRG/20120502_FDF_CRG/20120502_FDF_CRG/20120507_FDF_CRG_c12.mtb	922	NA	WWSS	water	2	118454	1336500965	1	0.02	0.001	5287	1
2	Food 1	Intake 3	592	119069	1336501580	/users/cn/jespinosa/phecomp/data/CRG/20120502_FDF_CRG/20120502_FDF_CRG/20120507_FDF_CRG_c12.mtb	821	518	WWSS	food_sc	3	118477	1336500988	1	0.04	6.75675675675676e-05	5288	1
2	Food 1	Intake 3	364	119951	1336502462	/users/cn/jespinosa/phecomp/data/CRG/20120502_FDF_CRG/20120502_FDF_CRG/20120507_FDF_CRG_c12.mtb	825	511	WWSS	food_sc	3	119587	1336502098	1	0.0600000000000001	0.000164835164835165	5289	1
2	Drink 2	Intake 2	24	120280	1336502791	/users/cn/jespinosa/phecomp/data/CRG/20120502_FDF_CRG/20120502_FDF_CRG/20120507_FDF_CRG_c12.mtb	924	NA	WWSS	water	2	120256	1336502767	1	0.02	0.000833333333333333	5290	1
2	Food 1	Intake 3	514	120976	1336503487	/users/cn/jespinosa/phecomp/data/CRG/20120502_FDF_CRG/20120502_FDF_CRG/20120507_FDF_CRG_c12.mtb	827	857	WWSS	food_sc	3	120462	1336502973	1	0.12	0.000233463035019455	5291	1
2	Drink 2	Intake 2	30	121002	1336503513	/users/cn/jespinosa/phecomp/data/CRG/20120502_FDF_CRG/20120502_FDF_CRG/20120507_FDF_CRG_c12.mtb	926	NA	WWSS	water	2	120972	1336503483	1	0.0399999999999998	0.00133333333333333	5292	1
2	Drink 2	Intake 2	15	121066	1336503577	/users/cn/jespinosa/phecomp/data/CRG/20120502_FDF_CRG/20120502_FDF_CRG/20120507_FDF_CRG_c12.mtb	927	NA	WWSS	water	2	121051	1336503562	1	0.02	0.00133333333333333	5293	1
2	Drink 2	Intake 2	18	121161	1336503672	/users/cn/jespinosa/phecomp/data/CRG/20120502_FDF_CRG/20120502_FDF_CRG/20120507_FDF_CRG_c12.mtb	928	NA	WWSS	water	2	121143	1336503654	1	0.02	0.00111111111111111	5294	1
2	Food 1	Intake 3	242	122075	1336504586	/users/cn/jespinosa/phecomp/data/CRG/20120502_FDF_CRG/20120502_FDF_CRG/20120507_FDF_CRG_c12.mtb	829	14	WWSS	food_sc	3	121833	1336504344	1	0.02	8.26446280991736e-05	5295	1
2	Drink 2	Intake 2	35	122112	1336504623	/users/cn/jespinosa/phecomp/data/CRG/20120502_FDF_CRG/20120502_FDF_CRG/20120507_FDF_CRG_c12.mtb	929	NA	WWSS	water	2	122077	1336504588	1	0.02	0.000571428571428571	5296	1
2	Food 1	Intake 3	18	122107	1336504618	/users/cn/jespinosa/phecomp/data/CRG/20120502_FDF_CRG/20120502_FDF_CRG/20120507_FDF_CRG_c12.mtb	830	99	WWSS	food_sc	3	122089	1336504600	1	0.02	0.00111111111111111	5297	1
2	Food 1	Intake 3	116	122322	1336504833	/users/cn/jespinosa/phecomp/data/CRG/20120502_FDF_CRG/20120502_FDF_CRG/20120507_FDF_CRG_c12.mtb	832	147	WWSS	food_sc	3	122206	1336504717	1	0.02	0.000172413793103448	5298	1
2	Food 1	Intake 3	118	122587	1336505098	/users/cn/jespinosa/phecomp/data/CRG/20120502_FDF_CRG/20120502_FDF_CRG/20120507_FDF_CRG_c12.mtb	834	247	WWSS	food_sc	3	122469	1336504980	1	0.02	0.000169491525423729	5299	1
2	Drink 2	Intake 2	24	122639	1336505150	/users/cn/jespinosa/phecomp/data/CRG/20120502_FDF_CRG/20120502_FDF_CRG/20120507_FDF_CRG_c12.mtb	932	NA	WWSS	water	2	122615	1336505126	1	0.02	0.000833333333333333	5300	1
2	Food 1	Intake 3	152	122986	1336505497	/users/cn/jespinosa/phecomp/data/CRG/20120502_FDF_CRG/20120502_FDF_CRG/20120507_FDF_CRG_c12.mtb	835	844	WWSS	food_sc	3	122834	1336505345	1	0.04	0.000263157894736842	5301	1
2	Drink 2	Intake 2	15	123000	1336505511	/users/cn/jespinosa/phecomp/data/CRG/20120502_FDF_CRG/20120502_FDF_CRG/20120507_FDF_CRG_c12.mtb	933	NA	WWSS	water	2	122985	1336505496	1	0.0399999999999998	0.00266666666666665	5302	1
2	Food 1	Intake 3	482	124312	1336506823	/users/cn/jespinosa/phecomp/data/CRG/20120502_FDF_CRG/20120502_FDF_CRG/20120507_FDF_CRG_c12.mtb	836	723	WWSS	food_sc	3	123830	1336506341	1	0.1	0.00020746887966805	5303	1
2	Drink 1	Intake 1	14	124486	1336506997	/users/cn/jespinosa/phecomp/data/CRG/20120502_FDF_CRG/20120502_FDF_CRG/20120507_FDF_CRG_c12.mtb	534	NA	WWSS	water	1	124472	1336506983	1	0.0599999999999999	0.00428571428571428	5304	1
2	Food 1	Intake 3	249	125284	1336507795	/users/cn/jespinosa/phecomp/data/CRG/20120502_FDF_CRG/20120502_FDF_CRG/20120507_FDF_CRG_c12.mtb	840	490	WWSS	food_sc	3	125035	1336507546	1	0.02	8.03212851405622e-05	5305	1
2	Drink 2	Intake 2	39	125518	1336508029	/users/cn/jespinosa/phecomp/data/CRG/20120502_FDF_CRG/20120502_FDF_CRG/20120507_FDF_CRG_c12.mtb	939	NA	WWSS	water	2	125479	1336507990	1	0.02	0.000512820512820513	5306	1
2	Food 1	Intake 3	837	126611	1336509122	/users/cn/jespinosa/phecomp/data/CRG/20120502_FDF_CRG/20120502_FDF_CRG/20120507_FDF_CRG_c12.mtb	846	1745	WWSS	food_sc	3	125774	1336508285	1	0.28	0.00033452807646356	5307	1
2	Drink 2	Intake 2	38	126646	1336509157	/users/cn/jespinosa/phecomp/data/CRG/20120502_FDF_CRG/20120502_FDF_CRG/20120507_FDF_CRG_c12.mtb	943	NA	WWSS	water	2	126608	1336509119	1	0.1	0.00263157894736842	5308	1
2	Drink 2	Intake 2	21	126689	1336509200	/users/cn/jespinosa/phecomp/data/CRG/20120502_FDF_CRG/20120502_FDF_CRG/20120507_FDF_CRG_c12.mtb	944	NA	WWSS	water	2	126668	1336509179	1	0.04	0.0019047619047619	5309	1
2	Food 1	Intake 3	494	128850	1336511361	/users/cn/jespinosa/phecomp/data/CRG/20120502_FDF_CRG/20120502_FDF_CRG/20120507_FDF_CRG_c12.mtb	849	483	WWSS	food_sc	3	128356	1336510867	1	0.18	0.000364372469635627	5310	1
2	Drink 2	Intake 2	26	128866	1336511377	/users/cn/jespinosa/phecomp/data/CRG/20120502_FDF_CRG/20120502_FDF_CRG/20120507_FDF_CRG_c12.mtb	946	NA	WWSS	water	2	128840	1336511351	1	0.0800000000000001	0.00307692307692308	5311	1
2	Drink 1	Intake 1	26	128914	1336511425	/users/cn/jespinosa/phecomp/data/CRG/20120502_FDF_CRG/20120502_FDF_CRG/20120507_FDF_CRG_c12.mtb	537	NA	WWSS	water	1	128888	1336511399	1	0.0600000000000001	0.00230769230769231	5312	1
2	Drink 2	Intake 2	49	129282	1336511793	/users/cn/jespinosa/phecomp/data/CRG/20120502_FDF_CRG/20120502_FDF_CRG/20120507_FDF_CRG_c12.mtb	950	NA	WWSS	water	2	129233	1336511744	1	0.02	0.000408163265306122	5313	1
2	Food 1	Intake 3	516	129849	1336512360	/users/cn/jespinosa/phecomp/data/CRG/20120502_FDF_CRG/20120502_FDF_CRG/20120507_FDF_CRG_c12.mtb	851	160	WWSS	food_sc	3	129333	1336511844	1	0.24	0.000465116279069767	5314	1
2	Drink 2	Intake 2	34	129888	1336512399	/users/cn/jespinosa/phecomp/data/CRG/20120502_FDF_CRG/20120502_FDF_CRG/20120507_FDF_CRG_c12.mtb	952	NA	WWSS	water	2	129854	1336512365	1	0.1	0.00294117647058824	5315	1
2	Drink 2	Intake 2	20	129987	1336512498	/users/cn/jespinosa/phecomp/data/CRG/20120502_FDF_CRG/20120502_FDF_CRG/20120507_FDF_CRG_c12.mtb	953	NA	WWSS	water	2	129967	1336512478	1	0.04	0.002	5316	1
2	Food 1	Intake 3	65	130074	1336512585	/users/cn/jespinosa/phecomp/data/CRG/20120502_FDF_CRG/20120502_FDF_CRG/20120507_FDF_CRG_c12.mtb	852	1150	WWSS	food_sc	3	130009	1336512520	1	0.02	0.000307692307692308	5317	1
2	Drink 2	Intake 2	17	130106	1336512617	/users/cn/jespinosa/phecomp/data/CRG/20120502_FDF_CRG/20120502_FDF_CRG/20120507_FDF_CRG_c12.mtb	954	NA	WWSS	water	2	130089	1336512600	1	0.02	0.00117647058823529	5318	1
2	Drink 1	Intake 1	17	130411	1336512922	/users/cn/jespinosa/phecomp/data/CRG/20120502_FDF_CRG/20120502_FDF_CRG/20120507_FDF_CRG_c12.mtb	542	NA	WWSS	water	1	130394	1336512905	1	0.04	0.00235294117647059	5319	1
2	Drink 2	Intake 2	20	130912	1336513423	/users/cn/jespinosa/phecomp/data/CRG/20120502_FDF_CRG/20120502_FDF_CRG/20120507_FDF_CRG_c12.mtb	956	NA	WWSS	water	2	130892	1336513403	1	0.0200000000000005	0.00100000000000002	5320	1
2	Food 1	Intake 3	184	131408	1336513919	/users/cn/jespinosa/phecomp/data/CRG/20120502_FDF_CRG/20120502_FDF_CRG/20120507_FDF_CRG_c12.mtb	855	107	WWSS	food_sc	3	131224	1336513735	1	0.1	0.000543478260869565	5321	1
2	Food 1	Intake 3	17	131532	1336514043	/users/cn/jespinosa/phecomp/data/CRG/20120502_FDF_CRG/20120502_FDF_CRG/20120507_FDF_CRG_c12.mtb	856	8644	WWSS	food_sc	3	131515	1336514026	1	0.24	0.0141176470588235	5322	1
2	Drink 2	Intake 2	23	131780	1336514291	/users/cn/jespinosa/phecomp/data/CRG/20120502_FDF_CRG/20120502_FDF_CRG/20120507_FDF_CRG_c12.mtb	957	NA	WWSS	water	2	131757	1336514268	1	0.0399999999999996	0.00173913043478259	5323	1
2	Drink 1	Intake 1	15	132066	1336514577	/users/cn/jespinosa/phecomp/data/CRG/20120502_FDF_CRG/20120502_FDF_CRG/20120507_FDF_CRG_c12.mtb	544	NA	WWSS	water	1	132051	1336514562	1	0.04	0.00266666666666667	5324	1
2	Drink 1	Intake 1	35	132412	1336514923	/users/cn/jespinosa/phecomp/data/CRG/20120502_FDF_CRG/20120502_FDF_CRG/20120507_FDF_CRG_c12.mtb	546	NA	WWSS	water	1	132377	1336514888	1	0.02	0.000571428571428571	5325	1
2	Drink 1	Intake 1	30	132874	1336515385	/users/cn/jespinosa/phecomp/data/CRG/20120502_FDF_CRG/20120502_FDF_CRG/20120507_FDF_CRG_c12.mtb	547	NA	WWSS	water	1	132844	1336515355	1	0.0599999999999999	0.002	5326	1
2	Drink 1	Intake 1	39	133843	1336516354	/users/cn/jespinosa/phecomp/data/CRG/20120502_FDF_CRG/20120502_FDF_CRG/20120507_FDF_CRG_c12.mtb	549	NA	WWSS	water	1	133804	1336516315	1	0.02	0.000512820512820513	5327	1
2	Drink 1	Intake 1	31	133891	1336516402	/users/cn/jespinosa/phecomp/data/CRG/20120502_FDF_CRG/20120502_FDF_CRG/20120507_FDF_CRG_c12.mtb	550	NA	WWSS	water	1	133860	1336516371	1	0.12	0.00387096774193548	5328	1
2	Drink 1	Intake 1	24	134087	1336516598	/users/cn/jespinosa/phecomp/data/CRG/20120502_FDF_CRG/20120502_FDF_CRG/20120507_FDF_CRG_c12.mtb	551	NA	WWSS	water	1	134063	1336516574	1	0.02	0.000833333333333333	5329	1
2	Drink 2	Intake 2	62	134949	1336517460	/users/cn/jespinosa/phecomp/data/CRG/20120502_FDF_CRG/20120502_FDF_CRG/20120507_FDF_CRG_c12.mtb	965	NA	WWSS	water	2	134887	1336517398	1	0.12	0.00193548387096774	5330	1
2	Drink 2	Intake 2	17	140036	1336522547	/users/cn/jespinosa/phecomp/data/CRG/20120502_FDF_CRG/20120502_FDF_CRG/20120507_FDF_CRG_c12.mtb	971	NA	WWSS	water	2	140019	1336522530	1	0.02	0.00117647058823529	5331	1
2	Food 1	Intake 3	149	140325	1336522836	/users/cn/jespinosa/phecomp/data/CRG/20120502_FDF_CRG/20120502_FDF_CRG/20120507_FDF_CRG_c12.mtb	863	620	WWSS	food_sc	3	140176	1336522687	1	0.02	0.000134228187919463	5332	1
2	Drink 1	Intake 1	33	140935	1336523446	/users/cn/jespinosa/phecomp/data/CRG/20120502_FDF_CRG/20120502_FDF_CRG/20120507_FDF_CRG_c12.mtb	554	NA	WWSS	water	1	140902	1336523413	1	0.04	0.00121212121212121	5333	1
2	Food 2	Intake 4	251	141196	1336523707	/users/cn/jespinosa/phecomp/data/CRG/20120502_FDF_CRG/20120502_FDF_CRG/20120507_FDF_CRG_c12.mtb	1552	1179	WWSS	food_sc	4	140945	1336523456	1	0.02	7.96812749003984e-05	5334	1
2	Drink 2	Intake 2	43	142022	1336524533	/users/cn/jespinosa/phecomp/data/CRG/20120502_FDF_CRG/20120502_FDF_CRG/20120507_FDF_CRG_c12.mtb	974	NA	WWSS	water	2	141979	1336524490	1	0.0600000000000001	0.0013953488372093	5335	1
2	Drink 1	Intake 1	21	142049	1336524560	/users/cn/jespinosa/phecomp/data/CRG/20120502_FDF_CRG/20120502_FDF_CRG/20120507_FDF_CRG_c12.mtb	555	NA	WWSS	water	1	142028	1336524539	1	0.0399999999999998	0.0019047619047619	5336	1
2	Food 2	Intake 4	90	142465	1336524976	/users/cn/jespinosa/phecomp/data/CRG/20120502_FDF_CRG/20120502_FDF_CRG/20120507_FDF_CRG_c12.mtb	1560	4139	WWSS	food_sc	4	142375	1336524886	1	0.0200000000000005	0.000222222222222228	5337	1
2	Food 1	Intake 3	1358	147962	1336530473	/users/cn/jespinosa/phecomp/data/CRG/20120502_FDF_CRG/20120502_FDF_CRG/20120507_FDF_CRG_c12.mtb	880	584	WWSS	food_sc	3	146604	1336529115	1	0.32	0.000235640648011782	5338	1
2	Drink 2	Intake 2	18	147997	1336530508	/users/cn/jespinosa/phecomp/data/CRG/20120502_FDF_CRG/20120502_FDF_CRG/20120507_FDF_CRG_c12.mtb	977	NA	WWSS	water	2	147979	1336530490	1	0.02	0.00111111111111111	5339	1
2	Drink 1	Intake 1	14	148005	1336530516	/users/cn/jespinosa/phecomp/data/CRG/20120502_FDF_CRG/20120502_FDF_CRG/20120507_FDF_CRG_c12.mtb	556	NA	WWSS	water	1	147991	1336530502	1	0.02	0.00142857142857143	5340	1
2	Drink 1	Intake 1	14	148073	1336530584	/users/cn/jespinosa/phecomp/data/CRG/20120502_FDF_CRG/20120502_FDF_CRG/20120507_FDF_CRG_c12.mtb	557	NA	WWSS	water	1	148059	1336530570	1	0.04	0.00285714285714286	5341	1
2	Drink 1	Intake 1	20	148106	1336530617	/users/cn/jespinosa/phecomp/data/CRG/20120502_FDF_CRG/20120502_FDF_CRG/20120507_FDF_CRG_c12.mtb	558	NA	WWSS	water	1	148086	1336530597	1	0.04	0.002	5342	1
2	Drink 2	Intake 2	26	148153	1336530664	/users/cn/jespinosa/phecomp/data/CRG/20120502_FDF_CRG/20120502_FDF_CRG/20120507_FDF_CRG_c12.mtb	978	NA	WWSS	water	2	148127	1336530638	1	0.02	0.000769230769230769	5343	1
2	Drink 2	Intake 2	33	148229	1336530740	/users/cn/jespinosa/phecomp/data/CRG/20120502_FDF_CRG/20120502_FDF_CRG/20120507_FDF_CRG_c12.mtb	979	NA	WWSS	water	2	148196	1336530707	1	0.0600000000000001	0.00181818181818182	5344	1
2	Drink 2	Intake 2	16	148288	1336530799	/users/cn/jespinosa/phecomp/data/CRG/20120502_FDF_CRG/20120502_FDF_CRG/20120507_FDF_CRG_c12.mtb	980	NA	WWSS	water	2	148272	1336530783	1	0.02	0.00125	5345	1
2	Drink 1	Intake 1	17	148372	1336530883	/users/cn/jespinosa/phecomp/data/CRG/20120502_FDF_CRG/20120502_FDF_CRG/20120507_FDF_CRG_c12.mtb	559	NA	WWSS	water	1	148355	1336530866	1	0.02	0.00117647058823529	5346	1
2	Food 1	Intake 3	578	149124	1336531635	/users/cn/jespinosa/phecomp/data/CRG/20120502_FDF_CRG/20120502_FDF_CRG/20120507_FDF_CRG_c12.mtb	884	9	WWSS	food_sc	3	148546	1336531057	1	0.18	0.000311418685121107	5347	1
2	Food 1	Intake 3	50	149183	1336531694	/users/cn/jespinosa/phecomp/data/CRG/20120502_FDF_CRG/20120502_FDF_CRG/20120507_FDF_CRG_c12.mtb	885	5420	WWSS	food_sc	3	149133	1336531644	1	0.02	0.0004	5348	1
2	Drink 2	Intake 2	35	149209	1336531720	/users/cn/jespinosa/phecomp/data/CRG/20120502_FDF_CRG/20120502_FDF_CRG/20120507_FDF_CRG_c12.mtb	981	NA	WWSS	water	2	149174	1336531685	1	0.1	0.00285714285714286	5349	1
2	Drink 1	Intake 1	36	149270	1336531781	/users/cn/jespinosa/phecomp/data/CRG/20120502_FDF_CRG/20120502_FDF_CRG/20120507_FDF_CRG_c12.mtb	560	NA	WWSS	water	1	149234	1336531745	1	0.12	0.00333333333333333	5350	1
2	Drink 1	Intake 1	27	149693	1336532204	/users/cn/jespinosa/phecomp/data/CRG/20120502_FDF_CRG/20120502_FDF_CRG/20120507_FDF_CRG_c12.mtb	561	NA	WWSS	water	1	149666	1336532177	1	0.02	0.000740740740740741	5351	1
2	Food 1	Intake 3	166	154769	1336537280	/users/cn/jespinosa/phecomp/data/CRG/20120502_FDF_CRG/20120502_FDF_CRG/20120507_FDF_CRG_c12.mtb	888	9	WWSS	food_sc	3	154603	1336537114	1	0.0200000000000005	0.000120481927710846	5352	1
2	Food 1	Intake 3	57	154835	1336537346	/users/cn/jespinosa/phecomp/data/CRG/20120502_FDF_CRG/20120502_FDF_CRG/20120507_FDF_CRG_c12.mtb	889	4691	WWSS	food_sc	3	154778	1336537289	1	0.38	0.00666666666666667	5353	1
2	Drink 2	Intake 2	22	155409	1336537920	/users/cn/jespinosa/phecomp/data/CRG/20120502_FDF_CRG/20120502_FDF_CRG/20120507_FDF_CRG_c12.mtb	984	NA	WWSS	water	2	155387	1336537898	1	0.04	0.00181818181818182	5354	1
2	Drink 1	Intake 1	23	155856	1336538367	/users/cn/jespinosa/phecomp/data/CRG/20120502_FDF_CRG/20120502_FDF_CRG/20120507_FDF_CRG_c12.mtb	562	NA	WWSS	water	1	155833	1336538344	1	0.12	0.00521739130434783	5355	1
2	Drink 1	Intake 1	17	155983	1336538494	/users/cn/jespinosa/phecomp/data/CRG/20120502_FDF_CRG/20120502_FDF_CRG/20120507_FDF_CRG_c12.mtb	563	NA	WWSS	water	1	155966	1336538477	1	0.04	0.00235294117647059	5356	1
2	Food 1	Intake 3	39	159565	1336542076	/users/cn/jespinosa/phecomp/data/CRG/20120502_FDF_CRG/20120502_FDF_CRG/20120507_FDF_CRG_c12.mtb	890	537	WWSS	food_sc	3	159526	1336542037	1	0.02	0.000512820512820513	5357	1
2	Drink 1	Intake 1	17	159637	1336542148	/users/cn/jespinosa/phecomp/data/CRG/20120502_FDF_CRG/20120502_FDF_CRG/20120507_FDF_CRG_c12.mtb	564	NA	WWSS	water	1	159620	1336542131	1	0.02	0.00117647058823529	5358	1
2	Food 1	Intake 3	120	160222	1336542733	/users/cn/jespinosa/phecomp/data/CRG/20120502_FDF_CRG/20120502_FDF_CRG/20120507_FDF_CRG_c12.mtb	896	LAST	WWSS	food_sc	3	160102	1336542613	1	0.02	0.000166666666666667	5359	1
2	Food 1	Intake 3	31	1527	1336555215	/users/cn/jespinosa/phecomp/data/CRG/20120502_FDF_CRG/20120502_FDF_CRG/20120509_FDF_CRG_c12.mtb	1304	515	WWFF	food_fat	3	1496	1336555184	1	0.12	0.00387096774193548	5360	1
2	Food 2	Intake 4	121	2163	1336555851	/users/cn/jespinosa/phecomp/data/CRG/20120502_FDF_CRG/20120502_FDF_CRG/20120509_FDF_CRG_c12.mtb	2226	162	WWFF	food_fat	4	2042	1336555730	1	0.46	0.00380165289256198	5361	1
2	Food 2	Intake 4	87	2412	1336556100	/users/cn/jespinosa/phecomp/data/CRG/20120502_FDF_CRG/20120502_FDF_CRG/20120509_FDF_CRG_c12.mtb	2228	88	WWFF	food_fat	4	2325	1336556013	1	0.16	0.00183908045977011	5362	1
2	Drink 1	Intake 1	18	2493	1336556181	/users/cn/jespinosa/phecomp/data/CRG/20120502_FDF_CRG/20120502_FDF_CRG/20120509_FDF_CRG_c12.mtb	647	NA	WWFF	water	1	2475	1336556163	1	0.02	0.00111111111111111	5363	1
2	Food 2	Intake 4	27	2527	1336556215	/users/cn/jespinosa/phecomp/data/CRG/20120502_FDF_CRG/20120502_FDF_CRG/20120509_FDF_CRG_c12.mtb	2229	168	WWFF	food_fat	4	2500	1336556188	1	0.02	0.000740740740740741	5364	1
2	Drink 2	Intake 2	23	2688	1336556376	/users/cn/jespinosa/phecomp/data/CRG/20120502_FDF_CRG/20120502_FDF_CRG/20120509_FDF_CRG_c12.mtb	1055	NA	WWFF	water	2	2665	1336556353	1	0.04	0.00173913043478261	5365	1
2	Food 1	Intake 3	97	2792	1336556480	/users/cn/jespinosa/phecomp/data/CRG/20120502_FDF_CRG/20120502_FDF_CRG/20120509_FDF_CRG_c12.mtb	1307	COLL	WWFF	food_fat	3	2695	1336556383	1	0.16	0.00164948453608247	5366	1
2	Food 2	Intake 4	41	2823	1336556511	/users/cn/jespinosa/phecomp/data/CRG/20120502_FDF_CRG/20120502_FDF_CRG/20120509_FDF_CRG_c12.mtb	2230	73	WWFF	food_fat	4	2782	1336556470	1	0.02	0.00048780487804878	5367	1
2	Food 1	Intake 3	34	2930	1336556618	/users/cn/jespinosa/phecomp/data/CRG/20120502_FDF_CRG/20120502_FDF_CRG/20120509_FDF_CRG_c12.mtb	1308	4262	WWFF	food_fat	3	2896	1336556584	1	0.02	0.000588235294117647	5368	1
2	Drink 2	Intake 2	30	3321	1336557009	/users/cn/jespinosa/phecomp/data/CRG/20120502_FDF_CRG/20120502_FDF_CRG/20120509_FDF_CRG_c12.mtb	1058	NA	WWFF	water	2	3291	1336556979	1	0.02	0.000666666666666667	5369	1
2	Drink 2	Intake 2	24	4026	1336557714	/users/cn/jespinosa/phecomp/data/CRG/20120502_FDF_CRG/20120502_FDF_CRG/20120509_FDF_CRG_c12.mtb	1059	NA	WWFF	water	2	4002	1336557690	1	0.04	0.00166666666666667	5370	1
2	Drink 1	Intake 1	18	7149	1336560837	/users/cn/jespinosa/phecomp/data/CRG/20120502_FDF_CRG/20120502_FDF_CRG/20120509_FDF_CRG_c12.mtb	649	NA	WWFF	water	1	7131	1336560819	1	0.02	0.00111111111111111	5371	1
2	Food 1	Intake 3	17	7209	1336560897	/users/cn/jespinosa/phecomp/data/CRG/20120502_FDF_CRG/20120502_FDF_CRG/20120509_FDF_CRG_c12.mtb	1312	286	WWFF	food_fat	3	7192	1336560880	1	0.02	0.00117647058823529	5372	1
2	Drink 2	Intake 2	31	7268	1336560956	/users/cn/jespinosa/phecomp/data/CRG/20120502_FDF_CRG/20120502_FDF_CRG/20120509_FDF_CRG_c12.mtb	1060	NA	WWFF	water	2	7237	1336560925	1	0.02	0.000645161290322581	5373	1
2	Food 2	Intake 4	23	7518	1336561206	/users/cn/jespinosa/phecomp/data/CRG/20120502_FDF_CRG/20120502_FDF_CRG/20120509_FDF_CRG_c12.mtb	2233	6152	WWFF	food_fat	4	7495	1336561183	1	0.0399999999999999	0.0017391304347826	5374	1
2	Drink 2	Intake 2	18	7683	1336561371	/users/cn/jespinosa/phecomp/data/CRG/20120502_FDF_CRG/20120502_FDF_CRG/20120509_FDF_CRG_c12.mtb	1063	NA	WWFF	water	2	7665	1336561353	1	0.02	0.00111111111111111	5375	1
2	Drink 2	Intake 2	20	10235	1336563923	/users/cn/jespinosa/phecomp/data/CRG/20120502_FDF_CRG/20120502_FDF_CRG/20120509_FDF_CRG_c12.mtb	1064	NA	WWFF	water	2	10215	1336563903	1	0.02	0.001	5376	1
2	Drink 2	Intake 2	18	10450	1336564138	/users/cn/jespinosa/phecomp/data/CRG/20120502_FDF_CRG/20120502_FDF_CRG/20120509_FDF_CRG_c12.mtb	1065	NA	WWFF	water	2	10432	1336564120	1	0.06	0.00333333333333333	5377	1
2	Food 1	Intake 3	40	13710	1336567398	/users/cn/jespinosa/phecomp/data/CRG/20120502_FDF_CRG/20120502_FDF_CRG/20120509_FDF_CRG_c12.mtb	1318	9	WWFF	food_fat	3	13670	1336567358	1	0.04	0.001	5378	1
2	Food 1	Intake 3	15	13734	1336567422	/users/cn/jespinosa/phecomp/data/CRG/20120502_FDF_CRG/20120502_FDF_CRG/20120509_FDF_CRG_c12.mtb	1319	2193	WWFF	food_fat	3	13719	1336567407	1	0.04	0.00266666666666667	5379	1
2	Drink 2	Intake 2	33	13834	1336567522	/users/cn/jespinosa/phecomp/data/CRG/20120502_FDF_CRG/20120502_FDF_CRG/20120509_FDF_CRG_c12.mtb	1066	NA	WWFF	water	2	13801	1336567489	1	0.04	0.00121212121212121	5380	1
2	Food 1	Intake 3	22	15949	1336569637	/users/cn/jespinosa/phecomp/data/CRG/20120502_FDF_CRG/20120502_FDF_CRG/20120509_FDF_CRG_c12.mtb	1320	1913	WWFF	food_fat	3	15927	1336569615	1	0.02	0.000909090909090909	5381	1
2	Food 1	Intake 3	29	17891	1336571579	/users/cn/jespinosa/phecomp/data/CRG/20120502_FDF_CRG/20120502_FDF_CRG/20120509_FDF_CRG_c12.mtb	1322	1464	WWFF	food_fat	3	17862	1336571550	1	0.06	0.00206896551724138	5382	1
2	Drink 2	Intake 2	26	18375	1336572063	/users/cn/jespinosa/phecomp/data/CRG/20120502_FDF_CRG/20120502_FDF_CRG/20120509_FDF_CRG_c12.mtb	1067	NA	WWFF	water	2	18349	1336572037	1	0.1	0.00384615384615385	5383	1
2	Food 1	Intake 3	15	19370	1336573058	/users/cn/jespinosa/phecomp/data/CRG/20120502_FDF_CRG/20120502_FDF_CRG/20120509_FDF_CRG_c12.mtb	1325	3250	WWFF	food_fat	3	19355	1336573043	1	0.02	0.00133333333333333	5384	1
2	Food 1	Intake 3	16	22636	1336576324	/users/cn/jespinosa/phecomp/data/CRG/20120502_FDF_CRG/20120502_FDF_CRG/20120509_FDF_CRG_c12.mtb	1327	5	WWFF	food_fat	3	22620	1336576308	1	0.04	0.0025	5385	1
2	Food 1	Intake 3	44	22685	1336576373	/users/cn/jespinosa/phecomp/data/CRG/20120502_FDF_CRG/20120502_FDF_CRG/20120509_FDF_CRG_c12.mtb	1328	2545	WWFF	food_fat	3	22641	1336576329	1	0.02	0.000454545454545455	5386	1
2	Drink 2	Intake 2	57	22890	1336576578	/users/cn/jespinosa/phecomp/data/CRG/20120502_FDF_CRG/20120502_FDF_CRG/20120509_FDF_CRG_c12.mtb	1068	NA	WWFF	water	2	22833	1336576521	1	0.04	0.000701754385964912	5387	1
2	Drink 2	Intake 2	27	23529	1336577217	/users/cn/jespinosa/phecomp/data/CRG/20120502_FDF_CRG/20120502_FDF_CRG/20120509_FDF_CRG_c12.mtb	1069	NA	WWFF	water	2	23502	1336577190	1	0.08	0.00296296296296296	5388	1
2	Food 1	Intake 3	87	25317	1336579005	/users/cn/jespinosa/phecomp/data/CRG/20120502_FDF_CRG/20120502_FDF_CRG/20120509_FDF_CRG_c12.mtb	1331	8158	WWFF	food_fat	3	25230	1336578918	1	0.1	0.00114942528735632	5389	1
2	Drink 2	Intake 2	20	26666	1336580354	/users/cn/jespinosa/phecomp/data/CRG/20120502_FDF_CRG/20120502_FDF_CRG/20120509_FDF_CRG_c12.mtb	1070	NA	WWFF	water	2	26646	1336580334	1	0.02	0.001	5390	1
2	Drink 2	Intake 2	21	31771	1336585459	/users/cn/jespinosa/phecomp/data/CRG/20120502_FDF_CRG/20120502_FDF_CRG/20120509_FDF_CRG_c12.mtb	1071	NA	WWFF	water	2	31750	1336585438	1	0.0600000000000001	0.00285714285714286	5391	1
2	Food 1	Intake 3	45	33520	1336587208	/users/cn/jespinosa/phecomp/data/CRG/20120502_FDF_CRG/20120502_FDF_CRG/20120509_FDF_CRG_c12.mtb	1335	2657	WWFF	food_fat	3	33475	1336587163	1	0.02	0.000444444444444444	5392	1
2	Food 1	Intake 3	86	36263	1336589951	/users/cn/jespinosa/phecomp/data/CRG/20120502_FDF_CRG/20120502_FDF_CRG/20120509_FDF_CRG_c12.mtb	1340	979	WWFF	food_fat	3	36177	1336589865	1	0.1	0.00116279069767442	5393	1
2	Food 1	Intake 3	89	37331	1336591019	/users/cn/jespinosa/phecomp/data/CRG/20120502_FDF_CRG/20120502_FDF_CRG/20120509_FDF_CRG_c12.mtb	1341	651	WWFF	food_fat	3	37242	1336590930	1	0.1	0.00112359550561798	5394	1
2	Food 1	Intake 3	59	38041	1336591729	/users/cn/jespinosa/phecomp/data/CRG/20120502_FDF_CRG/20120502_FDF_CRG/20120509_FDF_CRG_c12.mtb	1342	194	WWFF	food_fat	3	37982	1336591670	1	0.0599999999999999	0.00101694915254237	5395	1
2	Food 1	Intake 3	17	38252	1336591940	/users/cn/jespinosa/phecomp/data/CRG/20120502_FDF_CRG/20120502_FDF_CRG/20120509_FDF_CRG_c12.mtb	1343	926	WWFF	food_fat	3	38235	1336591923	1	0.02	0.00117647058823529	5396	1
2	Drink 2	Intake 2	43	38747	1336592435	/users/cn/jespinosa/phecomp/data/CRG/20120502_FDF_CRG/20120502_FDF_CRG/20120509_FDF_CRG_c12.mtb	1075	NA	WWFF	water	2	38704	1336592392	1	0.12	0.0027906976744186	5397	1
2	Food 1	Intake 3	102	39280	1336592968	/users/cn/jespinosa/phecomp/data/CRG/20120502_FDF_CRG/20120502_FDF_CRG/20120509_FDF_CRG_c12.mtb	1344	1160	WWFF	food_fat	3	39178	1336592866	1	0.12	0.00117647058823529	5398	1
2	Drink 1	Intake 1	13	39606	1336593294	/users/cn/jespinosa/phecomp/data/CRG/20120502_FDF_CRG/20120502_FDF_CRG/20120509_FDF_CRG_c12.mtb	653	NA	WWFF	water	1	39593	1336593281	1	0.02	0.00153846153846154	5399	1
2	Food 1	Intake 3	16	40456	1336594144	/users/cn/jespinosa/phecomp/data/CRG/20120502_FDF_CRG/20120502_FDF_CRG/20120509_FDF_CRG_c12.mtb	1345	947	WWFF	food_fat	3	40440	1336594128	1	0.02	0.00125	5400	1
2	Drink 1	Intake 1	10	40626	1336594314	/users/cn/jespinosa/phecomp/data/CRG/20120502_FDF_CRG/20120502_FDF_CRG/20120509_FDF_CRG_c12.mtb	654	NA	WWFF	water	1	40616	1336594304	1	0.04	0.004	5401	1
2	Drink 2	Intake 2	29	40808	1336594496	/users/cn/jespinosa/phecomp/data/CRG/20120502_FDF_CRG/20120502_FDF_CRG/20120509_FDF_CRG_c12.mtb	1078	NA	WWFF	water	2	40779	1336594467	1	0.0599999999999999	0.00206896551724138	5402	1
2	Food 2	Intake 4	130	41533	1336595221	/users/cn/jespinosa/phecomp/data/CRG/20120502_FDF_CRG/20120502_FDF_CRG/20120509_FDF_CRG_c12.mtb	2239	476	WWFF	food_fat	4	41403	1336595091	1	0.02	0.000153846153846154	5403	1
2	Drink 2	Intake 2	30	41692	1336595380	/users/cn/jespinosa/phecomp/data/CRG/20120502_FDF_CRG/20120502_FDF_CRG/20120509_FDF_CRG_c12.mtb	1079	NA	WWFF	water	2	41662	1336595350	1	0.0600000000000001	0.002	5404	1
2	Food 1	Intake 3	150	42159	1336595847	/users/cn/jespinosa/phecomp/data/CRG/20120502_FDF_CRG/20120502_FDF_CRG/20120509_FDF_CRG_c12.mtb	1348	185	WWFF	food_fat	3	42009	1336595697	1	0.16	0.00106666666666667	5405	1
2	Drink 2	Intake 2	19	42286	1336595974	/users/cn/jespinosa/phecomp/data/CRG/20120502_FDF_CRG/20120502_FDF_CRG/20120509_FDF_CRG_c12.mtb	1082	NA	WWFF	water	2	42267	1336595955	1	0.0800000000000001	0.00421052631578948	5406	1
2	Food 1	Intake 3	208	42552	1336596240	/users/cn/jespinosa/phecomp/data/CRG/20120502_FDF_CRG/20120502_FDF_CRG/20120509_FDF_CRG_c12.mtb	1350	281	WWFF	food_fat	3	42344	1336596032	1	0.48	0.00230769230769231	5407	1
2	Food 1	Intake 3	229	43062	1336596750	/users/cn/jespinosa/phecomp/data/CRG/20120502_FDF_CRG/20120502_FDF_CRG/20120509_FDF_CRG_c12.mtb	1351	317	WWFF	food_fat	3	42833	1336596521	1	0.7	0.00305676855895197	5408	1
2	Food 1	Intake 3	121	43500	1336597188	/users/cn/jespinosa/phecomp/data/CRG/20120502_FDF_CRG/20120502_FDF_CRG/20120509_FDF_CRG_c12.mtb	1352	458	WWFF	food_fat	3	43379	1336597067	1	0.32	0.00264462809917355	5409	1
2	Food 1	Intake 3	120	44078	1336597766	/users/cn/jespinosa/phecomp/data/CRG/20120502_FDF_CRG/20120502_FDF_CRG/20120509_FDF_CRG_c12.mtb	1353	540	WWFF	food_fat	3	43958	1336597646	1	0.3	0.0025	5410	1
2	Food 1	Intake 3	33	44651	1336598339	/users/cn/jespinosa/phecomp/data/CRG/20120502_FDF_CRG/20120502_FDF_CRG/20120509_FDF_CRG_c12.mtb	1355	54	WWFF	food_fat	3	44618	1336598306	1	0.0800000000000001	0.00242424242424243	5411	1
2	Food 1	Intake 3	68	44773	1336598461	/users/cn/jespinosa/phecomp/data/CRG/20120502_FDF_CRG/20120502_FDF_CRG/20120509_FDF_CRG_c12.mtb	1356	1623	WWFF	food_fat	3	44705	1336598393	1	0.0800000000000001	0.0011764705882353	5412	1
2	Drink 2	Intake 2	12	44975	1336598663	/users/cn/jespinosa/phecomp/data/CRG/20120502_FDF_CRG/20120502_FDF_CRG/20120509_FDF_CRG_c12.mtb	1084	NA	WWFF	water	2	44963	1336598651	1	0.02	0.00166666666666667	5413	1
2	Drink 2	Intake 2	21	45976	1336599664	/users/cn/jespinosa/phecomp/data/CRG/20120502_FDF_CRG/20120502_FDF_CRG/20120509_FDF_CRG_c12.mtb	1085	NA	WWFF	water	2	45955	1336599643	1	0.0599999999999999	0.00285714285714285	5414	1
2	Food 1	Intake 3	102	46498	1336600186	/users/cn/jespinosa/phecomp/data/CRG/20120502_FDF_CRG/20120502_FDF_CRG/20120509_FDF_CRG_c12.mtb	1359	2043	WWFF	food_fat	3	46396	1336600084	1	0.0200000000000005	0.000196078431372554	5415	1
2	Food 2	Intake 4	87	48628	1336602316	/users/cn/jespinosa/phecomp/data/CRG/20120502_FDF_CRG/20120502_FDF_CRG/20120509_FDF_CRG_c12.mtb	2248	COLL	WWFF	food_fat	4	48541	1336602229	1	0.02	0.000229885057471264	5416	1
2	Food 1	Intake 3	113	48740	1336602428	/users/cn/jespinosa/phecomp/data/CRG/20120502_FDF_CRG/20120502_FDF_CRG/20120509_FDF_CRG_c12.mtb	1361	13617	WWFF	food_fat	3	48627	1336602315	1	0.44	0.00389380530973451	5417	1
2	Drink 1	Intake 1	19	49260	1336602948	/users/cn/jespinosa/phecomp/data/CRG/20120502_FDF_CRG/20120502_FDF_CRG/20120509_FDF_CRG_c12.mtb	658	NA	WWFF	water	1	49241	1336602929	1	0.04	0.00210526315789474	5418	1
2	Drink 2	Intake 2	15	50027	1336603715	/users/cn/jespinosa/phecomp/data/CRG/20120502_FDF_CRG/20120502_FDF_CRG/20120509_FDF_CRG_c12.mtb	1089	NA	WWFF	water	2	50012	1336603700	1	0.04	0.00266666666666667	5419	1
2	Drink 1	Intake 1	20	50045	1336603733	/users/cn/jespinosa/phecomp/data/CRG/20120502_FDF_CRG/20120502_FDF_CRG/20120509_FDF_CRG_c12.mtb	659	NA	WWFF	water	1	50025	1336603713	1	0.02	0.001	5420	1
2	Drink 2	Intake 2	20	52207	1336605895	/users/cn/jespinosa/phecomp/data/CRG/20120502_FDF_CRG/20120502_FDF_CRG/20120509_FDF_CRG_c12.mtb	1092	NA	WWFF	water	2	52187	1336605875	1	0.04	0.002	5421	1
2	Drink 1	Intake 1	15	52327	1336606015	/users/cn/jespinosa/phecomp/data/CRG/20120502_FDF_CRG/20120502_FDF_CRG/20120509_FDF_CRG_c12.mtb	660	NA	WWFF	water	1	52312	1336606000	1	0.02	0.00133333333333333	5422	1
2	Drink 1	Intake 1	22	53037	1336606725	/users/cn/jespinosa/phecomp/data/CRG/20120502_FDF_CRG/20120502_FDF_CRG/20120509_FDF_CRG_c12.mtb	661	NA	WWFF	water	1	53015	1336606703	1	0.04	0.00181818181818182	5423	1
2	Drink 1	Intake 1	32	53713	1336607401	/users/cn/jespinosa/phecomp/data/CRG/20120502_FDF_CRG/20120502_FDF_CRG/20120509_FDF_CRG_c12.mtb	662	NA	WWFF	water	1	53681	1336607369	1	0.02	0.000625	5424	1
2	Drink 2	Intake 2	15	58958	1336612646	/users/cn/jespinosa/phecomp/data/CRG/20120502_FDF_CRG/20120502_FDF_CRG/20120509_FDF_CRG_c12.mtb	1097	NA	WWFF	water	2	58943	1336612631	1	0.02	0.00133333333333333	5425	1
2	Drink 1	Intake 1	15	59009	1336612697	/users/cn/jespinosa/phecomp/data/CRG/20120502_FDF_CRG/20120502_FDF_CRG/20120509_FDF_CRG_c12.mtb	663	NA	WWFF	water	1	58994	1336612682	1	0.04	0.00266666666666667	5426	1
2	Drink 1	Intake 1	14	59512	1336613200	/users/cn/jespinosa/phecomp/data/CRG/20120502_FDF_CRG/20120502_FDF_CRG/20120509_FDF_CRG_c12.mtb	664	NA	WWFF	water	1	59498	1336613186	1	0.02	0.00142857142857143	5427	1
2	Drink 2	Intake 2	24	60422	1336614110	/users/cn/jespinosa/phecomp/data/CRG/20120502_FDF_CRG/20120502_FDF_CRG/20120509_FDF_CRG_c12.mtb	1098	NA	WWFF	water	2	60398	1336614086	1	0.0600000000000001	0.0025	5428	1
2	Drink 2	Intake 2	20	61913	1336615601	/users/cn/jespinosa/phecomp/data/CRG/20120502_FDF_CRG/20120502_FDF_CRG/20120509_FDF_CRG_c12.mtb	1099	NA	WWFF	water	2	61893	1336615581	1	0.0399999999999998	0.00199999999999999	5429	1
2	Drink 2	Intake 2	22	62272	1336615960	/users/cn/jespinosa/phecomp/data/CRG/20120502_FDF_CRG/20120502_FDF_CRG/20120509_FDF_CRG_c12.mtb	1100	NA	WWFF	water	2	62250	1336615938	1	0.0600000000000001	0.00272727272727273	5430	1
2	Food 1	Intake 3	37	62394	1336616082	/users/cn/jespinosa/phecomp/data/CRG/20120502_FDF_CRG/20120502_FDF_CRG/20120509_FDF_CRG_c12.mtb	1366	656	WWFF	food_fat	3	62357	1336616045	1	0.04	0.00108108108108108	5431	1
2	Drink 1	Intake 1	21	62993	1336616681	/users/cn/jespinosa/phecomp/data/CRG/20120502_FDF_CRG/20120502_FDF_CRG/20120509_FDF_CRG_c12.mtb	665	NA	WWFF	water	1	62972	1336616660	1	0.06	0.00285714285714286	5432	1
2	Food 2	Intake 4	84	63134	1336616822	/users/cn/jespinosa/phecomp/data/CRG/20120502_FDF_CRG/20120502_FDF_CRG/20120509_FDF_CRG_c12.mtb	2257	4370	WWFF	food_fat	4	63050	1336616738	1	0.02	0.000238095238095238	5433	1
2	Drink 2	Intake 2	21	67230	1336620918	/users/cn/jespinosa/phecomp/data/CRG/20120502_FDF_CRG/20120502_FDF_CRG/20120509_FDF_CRG_c12.mtb	1102	NA	WWFF	water	2	67209	1336620897	1	0.04	0.0019047619047619	5434	1
2	Drink 1	Intake 1	16	67496	1336621184	/users/cn/jespinosa/phecomp/data/CRG/20120502_FDF_CRG/20120502_FDF_CRG/20120509_FDF_CRG_c12.mtb	666	NA	WWFF	water	1	67480	1336621168	1	0.04	0.0025	5435	1
2	Food 1	Intake 3	37	67541	1336621229	/users/cn/jespinosa/phecomp/data/CRG/20120502_FDF_CRG/20120502_FDF_CRG/20120509_FDF_CRG_c12.mtb	1367	3771	WWFF	food_fat	3	67504	1336621192	1	0.0200000000000005	0.000540540540540554	5436	1
2	Drink 2	Intake 2	18	67679	1336621367	/users/cn/jespinosa/phecomp/data/CRG/20120502_FDF_CRG/20120502_FDF_CRG/20120509_FDF_CRG_c12.mtb	1103	NA	WWFF	water	2	67661	1336621349	1	0.0600000000000001	0.00333333333333334	5437	1
2	Drink 2	Intake 2	23	68467	1336622155	/users/cn/jespinosa/phecomp/data/CRG/20120502_FDF_CRG/20120502_FDF_CRG/20120509_FDF_CRG_c12.mtb	1104	NA	WWFF	water	2	68444	1336622132	1	0.0599999999999998	0.0026086956521739	5438	1
2	Food 2	Intake 4	65	71377	1336625065	/users/cn/jespinosa/phecomp/data/CRG/20120502_FDF_CRG/20120502_FDF_CRG/20120509_FDF_CRG_c12.mtb	2260	5157	WWFF	food_fat	4	71312	1336625000	1	0.02	0.000307692307692308	5439	1
2	Drink 2	Intake 2	16	71670	1336625358	/users/cn/jespinosa/phecomp/data/CRG/20120502_FDF_CRG/20120502_FDF_CRG/20120509_FDF_CRG_c12.mtb	1105	NA	WWFF	water	2	71654	1336625342	1	0.04	0.0025	5440	1
2	Drink 2	Intake 2	20	72295	1336625983	/users/cn/jespinosa/phecomp/data/CRG/20120502_FDF_CRG/20120502_FDF_CRG/20120509_FDF_CRG_c12.mtb	1108	NA	WWFF	water	2	72275	1336625963	1	0.0600000000000001	0.00300000000000001	5441	1
2	Drink 2	Intake 2	17	72894	1336626582	/users/cn/jespinosa/phecomp/data/CRG/20120502_FDF_CRG/20120502_FDF_CRG/20120509_FDF_CRG_c12.mtb	1109	NA	WWFF	water	2	72877	1336626565	1	0.02	0.00117647058823529	5442	1
2	Drink 2	Intake 2	23	73156	1336626844	/users/cn/jespinosa/phecomp/data/CRG/20120502_FDF_CRG/20120502_FDF_CRG/20120509_FDF_CRG_c12.mtb	1110	NA	WWFF	water	2	73133	1336626821	1	0.02	0.000869565217391304	5443	1
2	Drink 2	Intake 2	20	73552	1336627240	/users/cn/jespinosa/phecomp/data/CRG/20120502_FDF_CRG/20120502_FDF_CRG/20120509_FDF_CRG_c12.mtb	1111	NA	WWFF	water	2	73532	1336627220	1	0.0800000000000001	0.00400000000000001	5444	1
2	Food 2	Intake 4	32	76566	1336630254	/users/cn/jespinosa/phecomp/data/CRG/20120502_FDF_CRG/20120502_FDF_CRG/20120509_FDF_CRG_c12.mtb	2265	11395	WWFF	food_fat	4	76534	1336630222	1	0.02	0.000625	5445	1
2	Drink 2	Intake 2	22	76636	1336630324	/users/cn/jespinosa/phecomp/data/CRG/20120502_FDF_CRG/20120502_FDF_CRG/20120509_FDF_CRG_c12.mtb	1114	NA	WWFF	water	2	76614	1336630302	1	0.04	0.00181818181818182	5446	1
2	Drink 2	Intake 2	31	81258	1336634946	/users/cn/jespinosa/phecomp/data/CRG/20120502_FDF_CRG/20120502_FDF_CRG/20120509_FDF_CRG_c12.mtb	1116	NA	WWFF	water	2	81227	1336634915	1	0.0999999999999999	0.0032258064516129	5447	1
2	Drink 1	Intake 1	9	86830	1336640518	/users/cn/jespinosa/phecomp/data/CRG/20120502_FDF_CRG/20120502_FDF_CRG/20120509_FDF_CRG_c12.mtb	669	NA	WWFF	water	1	86821	1336640509	1	0.02	0.00222222222222222	5448	1
2	Drink 2	Intake 2	37	87562	1336641250	/users/cn/jespinosa/phecomp/data/CRG/20120502_FDF_CRG/20120502_FDF_CRG/20120509_FDF_CRG_c12.mtb	1122	NA	WWFF	water	2	87525	1336641213	1	0.0599999999999998	0.00162162162162162	5449	1
2	Food 1	Intake 3	121	88082	1336641770	/users/cn/jespinosa/phecomp/data/CRG/20120502_FDF_CRG/20120502_FDF_CRG/20120509_FDF_CRG_c12.mtb	1378	331	WWFF	food_fat	3	87961	1336641649	1	0.26	0.00214876033057851	5450	1
2	Drink 2	Intake 2	20	88412	1336642100	/users/cn/jespinosa/phecomp/data/CRG/20120502_FDF_CRG/20120502_FDF_CRG/20120509_FDF_CRG_c12.mtb	1124	NA	WWFF	water	2	88392	1336642080	1	0.02	0.001	5451	1
2	Food 1	Intake 3	49	88462	1336642150	/users/cn/jespinosa/phecomp/data/CRG/20120502_FDF_CRG/20120502_FDF_CRG/20120509_FDF_CRG_c12.mtb	1379	4893	WWFF	food_fat	3	88413	1336642101	1	0.04	0.000816326530612245	5452	1
2	Food 1	Intake 3	12	93367	1336647055	/users/cn/jespinosa/phecomp/data/CRG/20120502_FDF_CRG/20120502_FDF_CRG/20120509_FDF_CRG_c12.mtb	1380	13	WWFF	food_fat	3	93355	1336647043	1	0.04	0.00333333333333333	5453	1
2	Food 1	Intake 3	35	93415	1336647103	/users/cn/jespinosa/phecomp/data/CRG/20120502_FDF_CRG/20120502_FDF_CRG/20120509_FDF_CRG_c12.mtb	1381	1626	WWFF	food_fat	3	93380	1336647068	1	0.04	0.00114285714285714	5454	1
2	Drink 2	Intake 2	26	93460	1336647148	/users/cn/jespinosa/phecomp/data/CRG/20120502_FDF_CRG/20120502_FDF_CRG/20120509_FDF_CRG_c12.mtb	1127	NA	WWFF	water	2	93434	1336647122	1	0.04	0.00153846153846154	5455	1
2	Drink 2	Intake 2	16	94946	1336648634	/users/cn/jespinosa/phecomp/data/CRG/20120502_FDF_CRG/20120502_FDF_CRG/20120509_FDF_CRG_c12.mtb	1128	NA	WWFF	water	2	94930	1336648618	1	0.04	0.0025	5456	1
2	Food 1	Intake 3	59	95100	1336648788	/users/cn/jespinosa/phecomp/data/CRG/20120502_FDF_CRG/20120502_FDF_CRG/20120509_FDF_CRG_c12.mtb	1382	6328	WWFF	food_fat	3	95041	1336648729	1	0.0599999999999996	0.00101694915254237	5457	1
2	Drink 1	Intake 1	20	95226	1336648914	/users/cn/jespinosa/phecomp/data/CRG/20120502_FDF_CRG/20120502_FDF_CRG/20120509_FDF_CRG_c12.mtb	672	NA	WWFF	water	1	95206	1336648894	1	0.04	0.002	5458	1
2	Drink 2	Intake 2	24	95468	1336649156	/users/cn/jespinosa/phecomp/data/CRG/20120502_FDF_CRG/20120502_FDF_CRG/20120509_FDF_CRG_c12.mtb	1129	NA	WWFF	water	2	95444	1336649132	1	0.04	0.00166666666666667	5459	1
2	Drink 2	Intake 2	34	96238	1336649926	/users/cn/jespinosa/phecomp/data/CRG/20120502_FDF_CRG/20120502_FDF_CRG/20120509_FDF_CRG_c12.mtb	1130	NA	WWFF	water	2	96204	1336649892	1	0.02	0.000588235294117647	5460	1
2	Drink 2	Intake 2	13	97016	1336650704	/users/cn/jespinosa/phecomp/data/CRG/20120502_FDF_CRG/20120502_FDF_CRG/20120509_FDF_CRG_c12.mtb	1131	NA	WWFF	water	2	97003	1336650691	1	0.04	0.00307692307692308	5461	1
2	Food 1	Intake 3	16	101444	1336655132	/users/cn/jespinosa/phecomp/data/CRG/20120502_FDF_CRG/20120502_FDF_CRG/20120509_FDF_CRG_c12.mtb	1383	8	WWFF	food_fat	3	101428	1336655116	1	0.04	0.0025	5462	1
2	Food 1	Intake 3	28	101480	1336655168	/users/cn/jespinosa/phecomp/data/CRG/20120502_FDF_CRG/20120502_FDF_CRG/20120509_FDF_CRG_c12.mtb	1384	4	WWFF	food_fat	3	101452	1336655140	1	0.0600000000000005	0.00214285714285716	5463	1
2	Food 1	Intake 3	43	101527	1336655215	/users/cn/jespinosa/phecomp/data/CRG/20120502_FDF_CRG/20120502_FDF_CRG/20120509_FDF_CRG_c12.mtb	1385	2507	WWFF	food_fat	3	101484	1336655172	1	0.0599999999999996	0.00139534883720929	5464	1
2	Food 1	Intake 3	38	104072	1336657760	/users/cn/jespinosa/phecomp/data/CRG/20120502_FDF_CRG/20120502_FDF_CRG/20120509_FDF_CRG_c12.mtb	1386	2260	WWFF	food_fat	3	104034	1336657722	1	0.0800000000000001	0.00210526315789474	5465	1
2	Food 1	Intake 3	23	106355	1336660043	/users/cn/jespinosa/phecomp/data/CRG/20120502_FDF_CRG/20120502_FDF_CRG/20120509_FDF_CRG_c12.mtb	1387	14	WWFF	food_fat	3	106332	1336660020	1	0.04	0.00173913043478261	5466	1
2	Food 2	Intake 4	16	106385	1336660073	/users/cn/jespinosa/phecomp/data/CRG/20120502_FDF_CRG/20120502_FDF_CRG/20120509_FDF_CRG_c12.mtb	2271	2543	WWFF	food_fat	4	106369	1336660057	1	0.28	0.0175	5467	1
2	Drink 2	Intake 2	25	107416	1336661104	/users/cn/jespinosa/phecomp/data/CRG/20120502_FDF_CRG/20120502_FDF_CRG/20120509_FDF_CRG_c12.mtb	1132	NA	WWFF	water	2	107391	1336661079	1	0.0600000000000001	0.0024	5468	1
2	Food 1	Intake 3	36	108964	1336662652	/users/cn/jespinosa/phecomp/data/CRG/20120502_FDF_CRG/20120502_FDF_CRG/20120509_FDF_CRG_c12.mtb	1388	2173	WWFF	food_fat	3	108928	1336662616	1	0.0600000000000005	0.00166666666666668	5469	1
2	Food 1	Intake 3	30	111167	1336664855	/users/cn/jespinosa/phecomp/data/CRG/20120502_FDF_CRG/20120502_FDF_CRG/20120509_FDF_CRG_c12.mtb	1389	11101	WWFF	food_fat	3	111137	1336664825	1	0.0399999999999991	0.0013333333333333	5470	1
2	Drink 1	Intake 1	40	115149	1336668837	/users/cn/jespinosa/phecomp/data/CRG/20120502_FDF_CRG/20120502_FDF_CRG/20120509_FDF_CRG_c12.mtb	673	NA	WWFF	water	1	115109	1336668797	1	0.06	0.0015	5471	1
2	Drink 1	Intake 1	21	121785	1336675473	/users/cn/jespinosa/phecomp/data/CRG/20120502_FDF_CRG/20120502_FDF_CRG/20120509_FDF_CRG_c12.mtb	674	NA	WWFF	water	1	121764	1336675452	1	0.12	0.00571428571428571	5472	1
2	Food 1	Intake 3	60	122328	1336676016	/users/cn/jespinosa/phecomp/data/CRG/20120502_FDF_CRG/20120502_FDF_CRG/20120509_FDF_CRG_c12.mtb	1391	3347	WWFF	food_fat	3	122268	1336675956	1	0.140000000000001	0.00233333333333335	5473	1
2	Drink 2	Intake 2	16	123796	1336677484	/users/cn/jespinosa/phecomp/data/CRG/20120502_FDF_CRG/20120502_FDF_CRG/20120509_FDF_CRG_c12.mtb	1135	NA	WWFF	water	2	123780	1336677468	1	0.02	0.00125	5474	1
2	Drink 2	Intake 2	15	124329	1336678017	/users/cn/jespinosa/phecomp/data/CRG/20120502_FDF_CRG/20120502_FDF_CRG/20120509_FDF_CRG_c12.mtb	1136	NA	WWFF	water	2	124314	1336678002	1	0.04	0.00266666666666667	5475	1
2	Food 2	Intake 4	88	125763	1336679451	/users/cn/jespinosa/phecomp/data/CRG/20120502_FDF_CRG/20120502_FDF_CRG/20120509_FDF_CRG_c12.mtb	2276	326	WWFF	food_fat	4	125675	1336679363	1	0.02	0.000227272727272727	5476	1
2	Food 2	Intake 4	63	126152	1336679840	/users/cn/jespinosa/phecomp/data/CRG/20120502_FDF_CRG/20120502_FDF_CRG/20120509_FDF_CRG_c12.mtb	2278	104	WWFF	food_fat	4	126089	1336679777	1	0.02	0.000317460317460317	5477	1
2	Food 2	Intake 4	96	126352	1336680040	/users/cn/jespinosa/phecomp/data/CRG/20120502_FDF_CRG/20120502_FDF_CRG/20120509_FDF_CRG_c12.mtb	2279	99	WWFF	food_fat	4	126256	1336679944	1	0.0999999999999999	0.00104166666666667	5478	1
2	Food 2	Intake 4	147	126598	1336680286	/users/cn/jespinosa/phecomp/data/CRG/20120502_FDF_CRG/20120502_FDF_CRG/20120509_FDF_CRG_c12.mtb	2280	205	WWFF	food_fat	4	126451	1336680139	1	0.0800000000000001	0.000544217687074831	5479	1
2	Food 2	Intake 4	72	126875	1336680563	/users/cn/jespinosa/phecomp/data/CRG/20120502_FDF_CRG/20120502_FDF_CRG/20120509_FDF_CRG_c12.mtb	2281	871	WWFF	food_fat	4	126803	1336680491	1	0.12	0.00166666666666667	5480	1
2	Food 2	Intake 4	44	127790	1336681478	/users/cn/jespinosa/phecomp/data/CRG/20120502_FDF_CRG/20120502_FDF_CRG/20120509_FDF_CRG_c12.mtb	2284	16	WWFF	food_fat	4	127746	1336681434	1	0.04	0.000909090909090909	5481	1
2	Food 2	Intake 4	129	127935	1336681623	/users/cn/jespinosa/phecomp/data/CRG/20120502_FDF_CRG/20120502_FDF_CRG/20120509_FDF_CRG_c12.mtb	2285	116	WWFF	food_fat	4	127806	1336681494	1	0.14	0.00108527131782946	5482	1
2	Food 2	Intake 4	13	128064	1336681752	/users/cn/jespinosa/phecomp/data/CRG/20120502_FDF_CRG/20120502_FDF_CRG/20120509_FDF_CRG_c12.mtb	2286	295	WWFF	food_fat	4	128051	1336681739	1	0.0600000000000001	0.00461538461538462	5483	1
2	Food 2	Intake 4	16	128375	1336682063	/users/cn/jespinosa/phecomp/data/CRG/20120502_FDF_CRG/20120502_FDF_CRG/20120509_FDF_CRG_c12.mtb	2288	187	WWFF	food_fat	4	128359	1336682047	1	0.02	0.00125	5484	1
2	Drink 2	Intake 2	20	128391	1336682079	/users/cn/jespinosa/phecomp/data/CRG/20120502_FDF_CRG/20120502_FDF_CRG/20120509_FDF_CRG_c12.mtb	1142	NA	WWFF	water	2	128371	1336682059	1	0.02	0.001	5485	1
2	Food 2	Intake 4	14	128576	1336682264	/users/cn/jespinosa/phecomp/data/CRG/20120502_FDF_CRG/20120502_FDF_CRG/20120509_FDF_CRG_c12.mtb	2290	9	WWFF	food_fat	4	128562	1336682250	1	0.04	0.00285714285714286	5486	1
2	Food 2	Intake 4	65	128650	1336682338	/users/cn/jespinosa/phecomp/data/CRG/20120502_FDF_CRG/20120502_FDF_CRG/20120509_FDF_CRG_c12.mtb	2291	121	WWFF	food_fat	4	128585	1336682273	1	0.02	0.000307692307692308	5487	1
2	Food 2	Intake 4	16	128787	1336682475	/users/cn/jespinosa/phecomp/data/CRG/20120502_FDF_CRG/20120502_FDF_CRG/20120509_FDF_CRG_c12.mtb	2293	1827	WWFF	food_fat	4	128771	1336682459	1	0.0600000000000001	0.00375000000000001	5488	1
2	Food 2	Intake 4	20	130634	1336684322	/users/cn/jespinosa/phecomp/data/CRG/20120502_FDF_CRG/20120502_FDF_CRG/20120509_FDF_CRG_c12.mtb	2296	65	WWFF	food_fat	4	130614	1336684302	1	0.02	0.001	5489	1
2	Food 2	Intake 4	35	130734	1336684422	/users/cn/jespinosa/phecomp/data/CRG/20120502_FDF_CRG/20120502_FDF_CRG/20120509_FDF_CRG_c12.mtb	2298	781	WWFF	food_fat	4	130699	1336684387	1	0.1	0.00285714285714286	5490	1
2	Drink 1	Intake 1	12	130979	1336684667	/users/cn/jespinosa/phecomp/data/CRG/20120502_FDF_CRG/20120502_FDF_CRG/20120509_FDF_CRG_c12.mtb	677	NA	WWFF	water	1	130967	1336684655	1	0.04	0.00333333333333333	5491	1
2	Drink 1	Intake 1	21	131323	1336685011	/users/cn/jespinosa/phecomp/data/CRG/20120502_FDF_CRG/20120502_FDF_CRG/20120509_FDF_CRG_c12.mtb	678	NA	WWFF	water	1	131302	1336684990	1	0.0599999999999999	0.00285714285714285	5492	1
2	Food 2	Intake 4	234	131749	1336685437	/users/cn/jespinosa/phecomp/data/CRG/20120502_FDF_CRG/20120502_FDF_CRG/20120509_FDF_CRG_c12.mtb	2302	499	WWFF	food_fat	4	131515	1336685203	1	0.28	0.0011965811965812	5493	1
2	Food 2	Intake 4	61	132309	1336685997	/users/cn/jespinosa/phecomp/data/CRG/20120502_FDF_CRG/20120502_FDF_CRG/20120509_FDF_CRG_c12.mtb	2303	198	WWFF	food_fat	4	132248	1336685936	1	0.02	0.000327868852459016	5494	1
2	Food 2	Intake 4	97	132604	1336686292	/users/cn/jespinosa/phecomp/data/CRG/20120502_FDF_CRG/20120502_FDF_CRG/20120509_FDF_CRG_c12.mtb	2305	11	WWFF	food_fat	4	132507	1336686195	1	0.02	0.000206185567010309	5495	1
2	Food 2	Intake 4	229	132844	1336686532	/users/cn/jespinosa/phecomp/data/CRG/20120502_FDF_CRG/20120502_FDF_CRG/20120509_FDF_CRG_c12.mtb	2306	2593	WWFF	food_fat	4	132615	1336686303	1	0.24	0.00104803493449782	5496	1
2	Drink 2	Intake 2	26	133036	1336686724	/users/cn/jespinosa/phecomp/data/CRG/20120502_FDF_CRG/20120502_FDF_CRG/20120509_FDF_CRG_c12.mtb	1144	NA	WWFF	water	2	133010	1336686698	1	0.0800000000000001	0.00307692307692308	5497	1
2	Food 2	Intake 4	34	135471	1336689159	/users/cn/jespinosa/phecomp/data/CRG/20120502_FDF_CRG/20120502_FDF_CRG/20120509_FDF_CRG_c12.mtb	2308	1226	WWFF	food_fat	4	135437	1336689125	1	0.12	0.00352941176470588	5498	1
2	Food 2	Intake 4	26	136723	1336690411	/users/cn/jespinosa/phecomp/data/CRG/20120502_FDF_CRG/20120502_FDF_CRG/20120509_FDF_CRG_c12.mtb	2310	646	WWFF	food_fat	4	136697	1336690385	1	0.12	0.00461538461538461	5499	1
2	Drink 2	Intake 2	23	136738	1336690426	/users/cn/jespinosa/phecomp/data/CRG/20120502_FDF_CRG/20120502_FDF_CRG/20120509_FDF_CRG_c12.mtb	1145	NA	WWFF	water	2	136715	1336690403	1	0.0599999999999996	0.0026086956521739	5500	1
2	Drink 2	Intake 2	16	136862	1336690550	/users/cn/jespinosa/phecomp/data/CRG/20120502_FDF_CRG/20120502_FDF_CRG/20120509_FDF_CRG_c12.mtb	1146	NA	WWFF	water	2	136846	1336690534	1	0.04	0.0025	5501	1
2	Food 2	Intake 4	91	137460	1336691148	/users/cn/jespinosa/phecomp/data/CRG/20120502_FDF_CRG/20120502_FDF_CRG/20120509_FDF_CRG_c12.mtb	2312	557	WWFF	food_fat	4	137369	1336691057	1	0.0600000000000001	0.00065934065934066	5502	1
2	Drink 1	Intake 1	31	137462	1336691150	/users/cn/jespinosa/phecomp/data/CRG/20120502_FDF_CRG/20120502_FDF_CRG/20120509_FDF_CRG_c12.mtb	680	NA	WWFF	water	1	137431	1336691119	1	0.02	0.000645161290322581	5503	1
2	Drink 1	Intake 1	15	137528	1336691216	/users/cn/jespinosa/phecomp/data/CRG/20120502_FDF_CRG/20120502_FDF_CRG/20120509_FDF_CRG_c12.mtb	681	NA	WWFF	water	1	137513	1336691201	1	0.02	0.00133333333333333	5504	1
2	Food 2	Intake 4	436	138453	1336692141	/users/cn/jespinosa/phecomp/data/CRG/20120502_FDF_CRG/20120502_FDF_CRG/20120509_FDF_CRG_c12.mtb	2318	25	WWFF	food_fat	4	138017	1336691705	1	0.0799999999999998	0.00018348623853211	5505	1
2	Food 2	Intake 4	36	138514	1336692202	/users/cn/jespinosa/phecomp/data/CRG/20120502_FDF_CRG/20120502_FDF_CRG/20120509_FDF_CRG_c12.mtb	2319	370	WWFF	food_fat	4	138478	1336692166	1	0.1	0.00277777777777778	5506	1
2	Drink 1	Intake 1	17	138536	1336692224	/users/cn/jespinosa/phecomp/data/CRG/20120502_FDF_CRG/20120502_FDF_CRG/20120509_FDF_CRG_c12.mtb	682	NA	WWFF	water	1	138519	1336692207	1	0.0399999999999999	0.00235294117647058	5507	1
2	Food 2	Intake 4	92	138976	1336692664	/users/cn/jespinosa/phecomp/data/CRG/20120502_FDF_CRG/20120502_FDF_CRG/20120509_FDF_CRG_c12.mtb	2323	19	WWFF	food_fat	4	138884	1336692572	1	0.04	0.000434782608695652	5508	1
2	Food 2	Intake 4	142	139137	1336692825	/users/cn/jespinosa/phecomp/data/CRG/20120502_FDF_CRG/20120502_FDF_CRG/20120509_FDF_CRG_c12.mtb	2324	155	WWFF	food_fat	4	138995	1336692683	1	0.04	0.00028169014084507	5509	1
2	Food 2	Intake 4	36	139328	1336693016	/users/cn/jespinosa/phecomp/data/CRG/20120502_FDF_CRG/20120502_FDF_CRG/20120509_FDF_CRG_c12.mtb	2327	113	WWFF	food_fat	4	139292	1336692980	1	0.02	0.000555555555555556	5510	1
2	Food 2	Intake 4	122	139563	1336693251	/users/cn/jespinosa/phecomp/data/CRG/20120502_FDF_CRG/20120502_FDF_CRG/20120509_FDF_CRG_c12.mtb	2330	270	WWFF	food_fat	4	139441	1336693129	1	0.0800000000000001	0.000655737704918034	5511	1
2	Food 2	Intake 4	38	139871	1336693559	/users/cn/jespinosa/phecomp/data/CRG/20120502_FDF_CRG/20120502_FDF_CRG/20120509_FDF_CRG_c12.mtb	2332	75	WWFF	food_fat	4	139833	1336693521	1	0.02	0.000526315789473684	5512	1
2	Drink 2	Intake 2	34	139897	1336693585	/users/cn/jespinosa/phecomp/data/CRG/20120502_FDF_CRG/20120502_FDF_CRG/20120509_FDF_CRG_c12.mtb	1148	NA	WWFF	water	2	139863	1336693551	1	0.0600000000000001	0.00176470588235294	5513	1
2	Food 2	Intake 4	58	140004	1336693692	/users/cn/jespinosa/phecomp/data/CRG/20120502_FDF_CRG/20120502_FDF_CRG/20120509_FDF_CRG_c12.mtb	2334	67	WWFF	food_fat	4	139946	1336693634	1	0.04	0.000689655172413793	5514	1
2	Food 2	Intake 4	17	140088	1336693776	/users/cn/jespinosa/phecomp/data/CRG/20120502_FDF_CRG/20120502_FDF_CRG/20120509_FDF_CRG_c12.mtb	2335	416	WWFF	food_fat	4	140071	1336693759	1	0.02	0.00117647058823529	5515	1
2	Food 2	Intake 4	28	140532	1336694220	/users/cn/jespinosa/phecomp/data/CRG/20120502_FDF_CRG/20120502_FDF_CRG/20120509_FDF_CRG_c12.mtb	2338	347	WWFF	food_fat	4	140504	1336694192	1	0.0600000000000001	0.00214285714285715	5516	1
2	Food 2	Intake 4	26	140905	1336694593	/users/cn/jespinosa/phecomp/data/CRG/20120502_FDF_CRG/20120502_FDF_CRG/20120509_FDF_CRG_c12.mtb	2343	236	WWFF	food_fat	4	140879	1336694567	1	0.04	0.00153846153846154	5517	1
2	Food 2	Intake 4	31	141172	1336694860	/users/cn/jespinosa/phecomp/data/CRG/20120502_FDF_CRG/20120502_FDF_CRG/20120509_FDF_CRG_c12.mtb	2345	336	WWFF	food_fat	4	141141	1336694829	1	0.02	0.000645161290322581	5518	1
2	Drink 2	Intake 2	19	141185	1336694873	/users/cn/jespinosa/phecomp/data/CRG/20120502_FDF_CRG/20120502_FDF_CRG/20120509_FDF_CRG_c12.mtb	1149	NA	WWFF	water	2	141166	1336694854	1	0.04	0.00210526315789474	5519	1
2	Food 2	Intake 4	112	141620	1336695308	/users/cn/jespinosa/phecomp/data/CRG/20120502_FDF_CRG/20120502_FDF_CRG/20120509_FDF_CRG_c12.mtb	2348	81	WWFF	food_fat	4	141508	1336695196	1	0.02	0.000178571428571429	5520	1
2	Food 2	Intake 4	38	141739	1336695427	/users/cn/jespinosa/phecomp/data/CRG/20120502_FDF_CRG/20120502_FDF_CRG/20120509_FDF_CRG_c12.mtb	2349	1467	WWFF	food_fat	4	141701	1336695389	1	0.02	0.000526315789473684	5521	1
2	Food 2	Intake 4	118	143324	1336697012	/users/cn/jespinosa/phecomp/data/CRG/20120502_FDF_CRG/20120502_FDF_CRG/20120509_FDF_CRG_c12.mtb	2359	604	WWFF	food_fat	4	143206	1336696894	1	0.0600000000000001	0.000508474576271187	5522	1
2	Drink 2	Intake 2	36	143610	1336697298	/users/cn/jespinosa/phecomp/data/CRG/20120502_FDF_CRG/20120502_FDF_CRG/20120509_FDF_CRG_c12.mtb	1152	NA	WWFF	water	2	143574	1336697262	1	0.02	0.000555555555555556	5523	1
2	Food 2	Intake 4	12	143940	1336697628	/users/cn/jespinosa/phecomp/data/CRG/20120502_FDF_CRG/20120502_FDF_CRG/20120509_FDF_CRG_c12.mtb	2369	111	WWFF	food_fat	4	143928	1336697616	1	0.02	0.00166666666666667	5524	1
2	Food 2	Intake 4	32	144083	1336697771	/users/cn/jespinosa/phecomp/data/CRG/20120502_FDF_CRG/20120502_FDF_CRG/20120509_FDF_CRG_c12.mtb	2371	5513	WWFF	food_fat	4	144051	1336697739	1	0.04	0.00125	5525	1
2	Drink 1	Intake 1	16	146266	1336699954	/users/cn/jespinosa/phecomp/data/CRG/20120502_FDF_CRG/20120502_FDF_CRG/20120509_FDF_CRG_c12.mtb	683	NA	WWFF	water	1	146250	1336699938	1	0.02	0.00125	5526	1
2	Food 2	Intake 4	16	149612	1336703300	/users/cn/jespinosa/phecomp/data/CRG/20120502_FDF_CRG/20120502_FDF_CRG/20120509_FDF_CRG_c12.mtb	2376	299	WWFF	food_fat	4	149596	1336703284	1	0.02	0.00125	5527	1
2	Food 1	Intake 3	31	149942	1336703630	/users/cn/jespinosa/phecomp/data/CRG/20120502_FDF_CRG/20120502_FDF_CRG/20120509_FDF_CRG_c12.mtb	1407	14	WWFF	food_fat	3	149911	1336703599	1	0.0599999999999996	0.00193548387096773	5528	1
2	Food 1	Intake 3	74	150030	1336703718	/users/cn/jespinosa/phecomp/data/CRG/20120502_FDF_CRG/20120502_FDF_CRG/20120509_FDF_CRG_c12.mtb	1408	226	WWFF	food_fat	3	149956	1336703644	1	0.0800000000000001	0.00108108108108108	5529	1
2	Food 1	Intake 3	62	150318	1336704006	/users/cn/jespinosa/phecomp/data/CRG/20120502_FDF_CRG/20120502_FDF_CRG/20120509_FDF_CRG_c12.mtb	1409	COLL	WWFF	food_fat	3	150256	1336703944	1	0.28	0.00451612903225806	5530	1
2	Food 2	Intake 4	44	150340	1336704028	/users/cn/jespinosa/phecomp/data/CRG/20120502_FDF_CRG/20120502_FDF_CRG/20120509_FDF_CRG_c12.mtb	2383	434	WWFF	food_fat	4	150296	1336703984	1	0.0800000000000001	0.00181818181818182	5531	1
2	Food 2	Intake 4	86	150860	1336704548	/users/cn/jespinosa/phecomp/data/CRG/20120502_FDF_CRG/20120502_FDF_CRG/20120509_FDF_CRG_c12.mtb	2388	30	WWFF	food_fat	4	150774	1336704462	1	0.02	0.000232558139534884	5532	1
2	Food 2	Intake 4	282	151172	1336704860	/users/cn/jespinosa/phecomp/data/CRG/20120502_FDF_CRG/20120502_FDF_CRG/20120509_FDF_CRG_c12.mtb	2389	COLL	WWFF	food_fat	4	150890	1336704578	1	0.1	0.000354609929078014	5533	1
2	Food 1	Intake 3	173	151114	1336704802	/users/cn/jespinosa/phecomp/data/CRG/20120502_FDF_CRG/20120502_FDF_CRG/20120509_FDF_CRG_c12.mtb	1410	8	WWFF	food_fat	3	150941	1336704629	1	0.359999999999999	0.00208092485549132	5534	1
2	Food 1	Intake 3	49	151171	1336704859	/users/cn/jespinosa/phecomp/data/CRG/20120502_FDF_CRG/20120502_FDF_CRG/20120509_FDF_CRG_c12.mtb	1411	82	WWFF	food_fat	3	151122	1336704810	1	0.0600000000000005	0.00122448979591838	5535	1
2	Food 2	Intake 4	14	151267	1336704955	/users/cn/jespinosa/phecomp/data/CRG/20120502_FDF_CRG/20120502_FDF_CRG/20120509_FDF_CRG_c12.mtb	2390	68	WWFF	food_fat	4	151253	1336704941	1	0.0599999999999996	0.00428571428571426	5536	1
2	Drink 2	Intake 2	28	151335	1336705023	/users/cn/jespinosa/phecomp/data/CRG/20120502_FDF_CRG/20120502_FDF_CRG/20120509_FDF_CRG_c12.mtb	1154	NA	WWFF	water	2	151307	1336704995	1	0.0800000000000001	0.00285714285714286	5537	1
2	Food 2	Intake 4	173	151508	1336705196	/users/cn/jespinosa/phecomp/data/CRG/20120502_FDF_CRG/20120502_FDF_CRG/20120509_FDF_CRG_c12.mtb	2391	COLL	WWFF	food_fat	4	151335	1336705023	1	0.0600000000000001	0.000346820809248555	5538	1
2	Food 1	Intake 3	136	151503	1336705191	/users/cn/jespinosa/phecomp/data/CRG/20120502_FDF_CRG/20120502_FDF_CRG/20120509_FDF_CRG_c12.mtb	1412	277	WWFF	food_fat	3	151367	1336705055	1	0.4	0.00294117647058824	5539	1
2	Drink 1	Intake 1	23	151754	1336705442	/users/cn/jespinosa/phecomp/data/CRG/20120502_FDF_CRG/20120502_FDF_CRG/20120509_FDF_CRG_c12.mtb	685	NA	WWFF	water	1	151731	1336705419	1	0.0800000000000001	0.00347826086956522	5540	1
2	Food 1	Intake 3	183	151963	1336705651	/users/cn/jespinosa/phecomp/data/CRG/20120502_FDF_CRG/20120502_FDF_CRG/20120509_FDF_CRG_c12.mtb	1413	COLL	WWFF	food_fat	3	151780	1336705468	1	0.38	0.00207650273224044	5541	1
2	Food 2	Intake 4	81	151965	1336705653	/users/cn/jespinosa/phecomp/data/CRG/20120502_FDF_CRG/20120502_FDF_CRG/20120509_FDF_CRG_c12.mtb	2393	218	WWFF	food_fat	4	151884	1336705572	1	0.0800000000000001	0.000987654320987656	5542	1
2	Food 1	Intake 3	66	152249	1336705937	/users/cn/jespinosa/phecomp/data/CRG/20120502_FDF_CRG/20120502_FDF_CRG/20120509_FDF_CRG_c12.mtb	1414	39	WWFF	food_fat	3	152183	1336705871	1	0.14	0.00212121212121212	5543	1
2	Food 2	Intake 4	13	152301	1336705989	/users/cn/jespinosa/phecomp/data/CRG/20120502_FDF_CRG/20120502_FDF_CRG/20120509_FDF_CRG_c12.mtb	2395	101	WWFF	food_fat	4	152288	1336705976	1	0.04	0.00307692307692308	5544	1
2	Food 2	Intake 4	128	152530	1336706218	/users/cn/jespinosa/phecomp/data/CRG/20120502_FDF_CRG/20120502_FDF_CRG/20120509_FDF_CRG_c12.mtb	2398	COLL	WWFF	food_fat	4	152402	1336706090	1	0.04	0.0003125	5545	1
2	Food 1	Intake 3	103	152529	1336706217	/users/cn/jespinosa/phecomp/data/CRG/20120502_FDF_CRG/20120502_FDF_CRG/20120509_FDF_CRG_c12.mtb	1415	116	WWFF	food_fat	3	152426	1336706114	1	0.26	0.00252427184466019	5546	1
2	Food 2	Intake 4	15	152660	1336706348	/users/cn/jespinosa/phecomp/data/CRG/20120502_FDF_CRG/20120502_FDF_CRG/20120509_FDF_CRG_c12.mtb	2399	2207	WWFF	food_fat	4	152645	1336706333	1	0.02	0.00133333333333333	5547	1
2	Drink 2	Intake 2	16	154840	1336708528	/users/cn/jespinosa/phecomp/data/CRG/20120502_FDF_CRG/20120502_FDF_CRG/20120509_FDF_CRG_c12.mtb	1155	NA	WWFF	water	2	154824	1336708512	1	0.02	0.00125	5548	1
2	Food 1	Intake 3	82	154949	1336708637	/users/cn/jespinosa/phecomp/data/CRG/20120502_FDF_CRG/20120502_FDF_CRG/20120509_FDF_CRG_c12.mtb	1416	72	WWFF	food_fat	3	154867	1336708555	1	0.32	0.00390243902439024	5549	1
2	Food 1	Intake 3	62	155083	1336708771	/users/cn/jespinosa/phecomp/data/CRG/20120502_FDF_CRG/20120502_FDF_CRG/20120509_FDF_CRG_c12.mtb	1417	9	WWFF	food_fat	3	155021	1336708709	1	0.12	0.00193548387096774	5550	1
2	Food 1	Intake 3	105	155197	1336708885	/users/cn/jespinosa/phecomp/data/CRG/20120502_FDF_CRG/20120502_FDF_CRG/20120509_FDF_CRG_c12.mtb	1418	COLL	WWFF	food_fat	3	155092	1336708780	1	0.6	0.00571428571428571	5551	1
2	Food 2	Intake 4	149	155315	1336709003	/users/cn/jespinosa/phecomp/data/CRG/20120502_FDF_CRG/20120502_FDF_CRG/20120509_FDF_CRG_c12.mtb	2407	COLL	WWFF	food_fat	4	155166	1336708854	1	0.0799999999999996	0.00053691275167785	5552	1
2	Food 1	Intake 3	109	155315	1336709003	/users/cn/jespinosa/phecomp/data/CRG/20120502_FDF_CRG/20120502_FDF_CRG/20120509_FDF_CRG_c12.mtb	1419	72	WWFF	food_fat	3	155206	1336708894	1	0.78	0.00715596330275229	5553	1
2	Food 2	Intake 4	16	155403	1336709091	/users/cn/jespinosa/phecomp/data/CRG/20120502_FDF_CRG/20120502_FDF_CRG/20120509_FDF_CRG_c12.mtb	2408	32	WWFF	food_fat	4	155387	1336709075	1	0.02	0.00125	5554	1
2	Drink 2	Intake 2	25	155417	1336709105	/users/cn/jespinosa/phecomp/data/CRG/20120502_FDF_CRG/20120502_FDF_CRG/20120509_FDF_CRG_c12.mtb	1156	NA	WWFF	water	2	155392	1336709080	1	0.0800000000000001	0.0032	5555	1
2	Food 1	Intake 3	38	155473	1336709161	/users/cn/jespinosa/phecomp/data/CRG/20120502_FDF_CRG/20120502_FDF_CRG/20120509_FDF_CRG_c12.mtb	1420	67	WWFF	food_fat	3	155435	1336709123	1	0.380000000000001	0.01	5556	1
2	Food 2	Intake 4	365	155905	1336709593	/users/cn/jespinosa/phecomp/data/CRG/20120502_FDF_CRG/20120502_FDF_CRG/20120509_FDF_CRG_c12.mtb	2410	COLL	WWFF	food_fat	4	155540	1336709228	1	0.36	0.000986301369863014	5557	1
2	Food 1	Intake 3	27	155582	1336709270	/users/cn/jespinosa/phecomp/data/CRG/20120502_FDF_CRG/20120502_FDF_CRG/20120509_FDF_CRG_c12.mtb	1421	12	WWFF	food_fat	3	155555	1336709243	1	0.18	0.00666666666666667	5558	1
2	Food 1	Intake 3	123	155717	1336709405	/users/cn/jespinosa/phecomp/data/CRG/20120502_FDF_CRG/20120502_FDF_CRG/20120509_FDF_CRG_c12.mtb	1422	27	WWFF	food_fat	3	155594	1336709282	1	1.22	0.00991869918699187	5559	1
2	Food 1	Intake 3	50	155794	1336709482	/users/cn/jespinosa/phecomp/data/CRG/20120502_FDF_CRG/20120502_FDF_CRG/20120509_FDF_CRG_c12.mtb	1423	222	WWFF	food_fat	3	155744	1336709432	1	0.860000000000001	0.0172	5560	1
2	Food 2	Intake 4	27	156043	1336709731	/users/cn/jespinosa/phecomp/data/CRG/20120502_FDF_CRG/20120502_FDF_CRG/20120509_FDF_CRG_c12.mtb	2411	23	WWFF	food_fat	4	156016	1336709704	1	0.04	0.00148148148148148	5561	1
2	Drink 1	Intake 1	20	156051	1336709739	/users/cn/jespinosa/phecomp/data/CRG/20120502_FDF_CRG/20120502_FDF_CRG/20120509_FDF_CRG_c12.mtb	687	NA	WWFF	water	1	156031	1336709719	1	0.08	0.004	5562	1
2	Food 2	Intake 4	362	156428	1336710116	/users/cn/jespinosa/phecomp/data/CRG/20120502_FDF_CRG/20120502_FDF_CRG/20120509_FDF_CRG_c12.mtb	2412	COLL	WWFF	food_fat	4	156066	1336709754	1	0.7	0.00193370165745856	5563	1
2	Drink 1	Intake 1	16	156110	1336709798	/users/cn/jespinosa/phecomp/data/CRG/20120502_FDF_CRG/20120502_FDF_CRG/20120509_FDF_CRG_c12.mtb	688	NA	WWFF	water	1	156094	1336709782	1	0.02	0.00125	5564	1
2	Food 1	Intake 3	110	156248	1336709936	/users/cn/jespinosa/phecomp/data/CRG/20120502_FDF_CRG/20120502_FDF_CRG/20120509_FDF_CRG_c12.mtb	1425	469	WWFF	food_fat	3	156138	1336709826	1	0.0600000000000005	0.00054545454545455	5565	1
2	Food 2	Intake 4	719	157436	1336711124	/users/cn/jespinosa/phecomp/data/CRG/20120502_FDF_CRG/20120502_FDF_CRG/20120509_FDF_CRG_c12.mtb	2413	622	WWFF	food_fat	4	156717	1336710405	1	0.24	0.000333796940194715	5566	1
2	Drink 2	Intake 2	34	158064	1336711752	/users/cn/jespinosa/phecomp/data/CRG/20120502_FDF_CRG/20120502_FDF_CRG/20120509_FDF_CRG_c12.mtb	1159	NA	WWFF	water	2	158030	1336711718	1	0.02	0.000588235294117647	5567	1
2	Food 2	Intake 4	20	158078	1336711766	/users/cn/jespinosa/phecomp/data/CRG/20120502_FDF_CRG/20120502_FDF_CRG/20120509_FDF_CRG_c12.mtb	2414	608	WWFF	food_fat	4	158058	1336711746	1	0.02	0.001	5568	1
2	Drink 2	Intake 2	15	158634	1336712322	/users/cn/jespinosa/phecomp/data/CRG/20120502_FDF_CRG/20120502_FDF_CRG/20120509_FDF_CRG_c12.mtb	1160	NA	WWFF	water	2	158619	1336712307	1	0.02	0.00133333333333333	5569	1
2	Food 2	Intake 4	646	159332	1336713020	/users/cn/jespinosa/phecomp/data/CRG/20120502_FDF_CRG/20120502_FDF_CRG/20120509_FDF_CRG_c12.mtb	2416	22	WWFF	food_fat	4	158686	1336712374	1	0.18	0.000278637770897833	5570	1
2	Food 2	Intake 4	182	159536	1336713224	/users/cn/jespinosa/phecomp/data/CRG/20120502_FDF_CRG/20120502_FDF_CRG/20120509_FDF_CRG_c12.mtb	2417	244	WWFF	food_fat	4	159354	1336713042	1	0.0800000000000001	0.00043956043956044	5571	1
2	Food 2	Intake 4	168	159948	1336713636	/users/cn/jespinosa/phecomp/data/CRG/20120502_FDF_CRG/20120502_FDF_CRG/20120509_FDF_CRG_c12.mtb	2420	132	WWFF	food_fat	4	159780	1336713468	1	0.0600000000000001	0.000357142857142858	5572	1
2	Drink 2	Intake 2	20	159956	1336713644	/users/cn/jespinosa/phecomp/data/CRG/20120502_FDF_CRG/20120502_FDF_CRG/20120509_FDF_CRG_c12.mtb	1164	NA	WWFF	water	2	159936	1336713624	1	0.0799999999999996	0.00399999999999998	5573	1
2	Food 2	Intake 4	145	160225	1336713913	/users/cn/jespinosa/phecomp/data/CRG/20120502_FDF_CRG/20120502_FDF_CRG/20120509_FDF_CRG_c12.mtb	2422	50	WWFF	food_fat	4	160080	1336713768	1	0.04	0.000275862068965517	5574	1
2	Food 2	Intake 4	200	160475	1336714163	/users/cn/jespinosa/phecomp/data/CRG/20120502_FDF_CRG/20120502_FDF_CRG/20120509_FDF_CRG_c12.mtb	2424	302	WWFF	food_fat	4	160275	1336713963	1	0.0599999999999996	0.000299999999999998	5575	1
2	Food 2	Intake 4	332	161109	1336714797	/users/cn/jespinosa/phecomp/data/CRG/20120502_FDF_CRG/20120502_FDF_CRG/20120509_FDF_CRG_c12.mtb	2427	19	WWFF	food_fat	4	160777	1336714465	1	0.02	6.02409638554217e-05	5576	1
2	Food 2	Intake 4	89	161217	1336714905	/users/cn/jespinosa/phecomp/data/CRG/20120502_FDF_CRG/20120502_FDF_CRG/20120509_FDF_CRG_c12.mtb	2428	1061	WWFF	food_fat	4	161128	1336714816	1	0.04	0.000449438202247191	5577	1
2	Food 2	Intake 4	12	162290	1336715978	/users/cn/jespinosa/phecomp/data/CRG/20120502_FDF_CRG/20120502_FDF_CRG/20120509_FDF_CRG_c12.mtb	2433	172	WWFF	food_fat	4	162278	1336715966	1	0.0399999999999996	0.0033333333333333	5578	1
2	Food 2	Intake 4	26	162488	1336716176	/users/cn/jespinosa/phecomp/data/CRG/20120502_FDF_CRG/20120502_FDF_CRG/20120509_FDF_CRG_c12.mtb	2435	367	WWFF	food_fat	4	162462	1336716150	1	0.02	0.000769230769230769	5579	1
2	Food 2	Intake 4	11	162866	1336716554	/users/cn/jespinosa/phecomp/data/CRG/20120502_FDF_CRG/20120502_FDF_CRG/20120509_FDF_CRG_c12.mtb	2436	603	WWFF	food_fat	4	162855	1336716543	1	0.02	0.00181818181818182	5580	1
2	Food 2	Intake 4	18	163487	1336717175	/users/cn/jespinosa/phecomp/data/CRG/20120502_FDF_CRG/20120502_FDF_CRG/20120509_FDF_CRG_c12.mtb	2438	590	WWFF	food_fat	4	163469	1336717157	1	0.0600000000000001	0.00333333333333334	5581	1
2	Food 2	Intake 4	102	164179	1336717867	/users/cn/jespinosa/phecomp/data/CRG/20120502_FDF_CRG/20120502_FDF_CRG/20120509_FDF_CRG_c12.mtb	2442	511	WWFF	food_fat	4	164077	1336717765	1	0.02	0.000196078431372549	5582	1
2	Drink 2	Intake 2	28	164141	1336717829	/users/cn/jespinosa/phecomp/data/CRG/20120502_FDF_CRG/20120502_FDF_CRG/20120509_FDF_CRG_c12.mtb	1166	NA	WWFF	water	2	164113	1336717801	1	0.0600000000000001	0.00214285714285715	5583	1
2	Food 2	Intake 4	51	164741	1336718429	/users/cn/jespinosa/phecomp/data/CRG/20120502_FDF_CRG/20120502_FDF_CRG/20120509_FDF_CRG_c12.mtb	2444	101	WWFF	food_fat	4	164690	1336718378	1	0.0999999999999996	0.00196078431372548	5584	1
2	Drink 1	Intake 1	33	164762	1336718450	/users/cn/jespinosa/phecomp/data/CRG/20120502_FDF_CRG/20120502_FDF_CRG/20120509_FDF_CRG_c12.mtb	691	NA	WWFF	water	1	164729	1336718417	1	0.1	0.00303030303030303	5585	1
2	Food 2	Intake 4	634	165476	1336719164	/users/cn/jespinosa/phecomp/data/CRG/20120502_FDF_CRG/20120502_FDF_CRG/20120509_FDF_CRG_c12.mtb	2447	284	WWFF	food_fat	4	164842	1336718530	1	0.18	0.00028391167192429	5586	1
2	Food 2	Intake 4	314	166074	1336719762	/users/cn/jespinosa/phecomp/data/CRG/20120502_FDF_CRG/20120502_FDF_CRG/20120509_FDF_CRG_c12.mtb	2451	14	WWFF	food_fat	4	165760	1336719448	1	0.04	0.000127388535031847	5587	1
2	Food 2	Intake 4	57	166145	1336719833	/users/cn/jespinosa/phecomp/data/CRG/20120502_FDF_CRG/20120502_FDF_CRG/20120509_FDF_CRG_c12.mtb	2452	11176	WWFF	food_fat	4	166088	1336719776	1	0.02	0.000350877192982456	5588	1
2	Food 1	Intake 3	73	217	1336731082	/users/cn/jespinosa/phecomp/data/CRG/20120502_FDF_CRG/20120502_FDF_CRG/20120511_FDF_CRG_c12.mtb	2506	93	WWFF	food_fat	3	144	1336731009	1	0.56	0.00767123287671233	5589	1
2	Food 2	Intake 4	36	346	1336731211	/users/cn/jespinosa/phecomp/data/CRG/20120502_FDF_CRG/20120502_FDF_CRG/20120511_FDF_CRG_c12.mtb	3492	COLL	WWFF	food_fat	4	310	1336731175	1	0.42	0.0116666666666667	5590	1
2	Food 1	Intake 3	80	417	1336731282	/users/cn/jespinosa/phecomp/data/CRG/20120502_FDF_CRG/20120502_FDF_CRG/20120511_FDF_CRG_c12.mtb	2507	88	WWFF	food_fat	3	337	1336731202	1	0.32	0.004	5591	1
2	Food 1	Intake 3	97	602	1336731467	/users/cn/jespinosa/phecomp/data/CRG/20120502_FDF_CRG/20120502_FDF_CRG/20120511_FDF_CRG_c12.mtb	2508	84	WWFF	food_fat	3	505	1336731370	1	0.72	0.00742268041237113	5592	1
2	Drink 2	Intake 2	19	683	1336731548	/users/cn/jespinosa/phecomp/data/CRG/20120502_FDF_CRG/20120502_FDF_CRG/20120511_FDF_CRG_c12.mtb	1274	NA	WWFF	water	2	664	1336731529	1	0.06	0.00315789473684211	5593	1
2	Food 1	Intake 3	185	871	1336731736	/users/cn/jespinosa/phecomp/data/CRG/20120502_FDF_CRG/20120502_FDF_CRG/20120511_FDF_CRG_c12.mtb	2509	228	WWFF	food_fat	3	686	1336731551	1	1	0.00540540540540541	5594	1
2	Drink 1	Intake 1	29	969	1336731834	/users/cn/jespinosa/phecomp/data/CRG/20120502_FDF_CRG/20120502_FDF_CRG/20120511_FDF_CRG_c12.mtb	832	NA	WWFF	water	1	940	1336731805	1	0.08	0.00275862068965517	5595	1
2	Food 2	Intake 4	73	1172	1336732037	/users/cn/jespinosa/phecomp/data/CRG/20120502_FDF_CRG/20120502_FDF_CRG/20120511_FDF_CRG_c12.mtb	3493	COLL	WWFF	food_fat	4	1099	1336731964	1	0.04	0.000547945205479452	5596	1
2	Food 1	Intake 3	107	1231	1336732096	/users/cn/jespinosa/phecomp/data/CRG/20120502_FDF_CRG/20120502_FDF_CRG/20120511_FDF_CRG_c12.mtb	2510	31920	WWFF	food_fat	3	1124	1336731989	1	0.42	0.00392523364485981	5597	1
2	Drink 1	Intake 1	13	1336	1336732201	/users/cn/jespinosa/phecomp/data/CRG/20120502_FDF_CRG/20120502_FDF_CRG/20120511_FDF_CRG_c12.mtb	833	NA	WWFF	water	1	1323	1336732188	1	0.06	0.00461538461538461	5598	1
2	Drink 2	Intake 2	21	10141	1336741006	/users/cn/jespinosa/phecomp/data/CRG/20120502_FDF_CRG/20120502_FDF_CRG/20120511_FDF_CRG_c12.mtb	1278	NA	WWFF	water	2	10120	1336740985	1	0.02	0.000952380952380952	5599	1
2	Drink 2	Intake 2	39	10262	1336741127	/users/cn/jespinosa/phecomp/data/CRG/20120502_FDF_CRG/20120502_FDF_CRG/20120511_FDF_CRG_c12.mtb	1279	NA	WWFF	water	2	10223	1336741088	1	0.08	0.00205128205128205	5600	1
2	Drink 2	Intake 2	25	17379	1336748244	/users/cn/jespinosa/phecomp/data/CRG/20120502_FDF_CRG/20120502_FDF_CRG/20120511_FDF_CRG_c12.mtb	1280	NA	WWFF	water	2	17354	1336748219	1	0.06	0.0024	5601	1
2	Drink 1	Intake 1	20	31776	1336762641	/users/cn/jespinosa/phecomp/data/CRG/20120502_FDF_CRG/20120502_FDF_CRG/20120511_FDF_CRG_c12.mtb	834	NA	WWFF	water	1	31756	1336762621	1	0.08	0.004	5602	1
2	Drink 1	Intake 1	18	33137	1336764002	/users/cn/jespinosa/phecomp/data/CRG/20120502_FDF_CRG/20120502_FDF_CRG/20120511_FDF_CRG_c12.mtb	836	NA	WWFF	water	1	33119	1336763984	1	0.02	0.00111111111111111	5603	1
2	Food 2	Intake 4	106	33257	1336764122	/users/cn/jespinosa/phecomp/data/CRG/20120502_FDF_CRG/20120502_FDF_CRG/20120511_FDF_CRG_c12.mtb	3494	241	WWFF	food_fat	4	33151	1336764016	1	0.24	0.00226415094339623	5604	1
2	Food 2	Intake 4	15	33513	1336764378	/users/cn/jespinosa/phecomp/data/CRG/20120502_FDF_CRG/20120502_FDF_CRG/20120511_FDF_CRG_c12.mtb	3495	COLL	WWFF	food_fat	4	33498	1336764363	1	0.02	0.00133333333333333	5605	1
2	Food 1	Intake 3	14	33518	1336764383	/users/cn/jespinosa/phecomp/data/CRG/20120502_FDF_CRG/20120502_FDF_CRG/20120511_FDF_CRG_c12.mtb	2514	220	WWFF	food_fat	3	33504	1336764369	1	0.02	0.00142857142857143	5606	1
2	Food 2	Intake 4	23	33761	1336764626	/users/cn/jespinosa/phecomp/data/CRG/20120502_FDF_CRG/20120502_FDF_CRG/20120511_FDF_CRG_c12.mtb	3497	1	WWFF	food_fat	4	33738	1336764603	1	0.0800000000000001	0.00347826086956522	5607	1
2	Food 1	Intake 3	55	33817	1336764682	/users/cn/jespinosa/phecomp/data/CRG/20120502_FDF_CRG/20120502_FDF_CRG/20120511_FDF_CRG_c12.mtb	2515	17	WWFF	food_fat	3	33762	1336764627	1	0.94	0.0170909090909091	5608	1
2	Drink 2	Intake 2	33	33844	1336764709	/users/cn/jespinosa/phecomp/data/CRG/20120502_FDF_CRG/20120502_FDF_CRG/20120511_FDF_CRG_c12.mtb	1284	NA	WWFF	water	2	33811	1336764676	1	0.02	0.000606060606060606	5609	1
2	Food 1	Intake 3	76	33910	1336764775	/users/cn/jespinosa/phecomp/data/CRG/20120502_FDF_CRG/20120502_FDF_CRG/20120511_FDF_CRG_c12.mtb	2516	6	WWFF	food_fat	3	33834	1336764699	1	0.1	0.00131578947368421	5610	1
2	Food 1	Intake 3	41	33957	1336764822	/users/cn/jespinosa/phecomp/data/CRG/20120502_FDF_CRG/20120502_FDF_CRG/20120511_FDF_CRG_c12.mtb	2517	255	WWFF	food_fat	3	33916	1336764781	1	0.04	0.000975609756097561	5611	1
2	Drink 2	Intake 2	41	34209	1336765074	/users/cn/jespinosa/phecomp/data/CRG/20120502_FDF_CRG/20120502_FDF_CRG/20120511_FDF_CRG_c12.mtb	1285	NA	WWFF	water	2	34168	1336765033	1	0.04	0.000975609756097561	5612	1
2	Food 1	Intake 3	81	34293	1336765158	/users/cn/jespinosa/phecomp/data/CRG/20120502_FDF_CRG/20120502_FDF_CRG/20120511_FDF_CRG_c12.mtb	2518	3966	WWFF	food_fat	3	34212	1336765077	1	0.04	0.000493827160493827	5613	1
2	Drink 2	Intake 2	20	36660	1336767525	/users/cn/jespinosa/phecomp/data/CRG/20120502_FDF_CRG/20120502_FDF_CRG/20120511_FDF_CRG_c12.mtb	1286	NA	WWFF	water	2	36640	1336767505	1	0.04	0.002	5614	1
2	Drink 1	Intake 1	12	36727	1336767592	/users/cn/jespinosa/phecomp/data/CRG/20120502_FDF_CRG/20120502_FDF_CRG/20120511_FDF_CRG_c12.mtb	837	NA	WWFF	water	1	36715	1336767580	1	0.04	0.00333333333333333	5615	1
2	Drink 2	Intake 2	25	37408	1336768273	/users/cn/jespinosa/phecomp/data/CRG/20120502_FDF_CRG/20120502_FDF_CRG/20120511_FDF_CRG_c12.mtb	1287	NA	WWFF	water	2	37383	1336768248	1	0.06	0.0024	5616	1
2	Food 1	Intake 3	25	38284	1336769149	/users/cn/jespinosa/phecomp/data/CRG/20120502_FDF_CRG/20120502_FDF_CRG/20120511_FDF_CRG_c12.mtb	2521	113	WWFF	food_fat	3	38259	1336769124	1	0.0200000000000005	0.00080000000000002	5617	1
2	Drink 2	Intake 2	15	38389	1336769254	/users/cn/jespinosa/phecomp/data/CRG/20120502_FDF_CRG/20120502_FDF_CRG/20120511_FDF_CRG_c12.mtb	1288	NA	WWFF	water	2	38374	1336769239	1	0.02	0.00133333333333333	5618	1
2	Food 2	Intake 4	45	38442	1336769307	/users/cn/jespinosa/phecomp/data/CRG/20120502_FDF_CRG/20120502_FDF_CRG/20120511_FDF_CRG_c12.mtb	3505	559	WWFF	food_fat	4	38397	1336769262	1	0.0399999999999999	0.000888888888888887	5619	1
2	Food 2	Intake 4	13	39014	1336769879	/users/cn/jespinosa/phecomp/data/CRG/20120502_FDF_CRG/20120502_FDF_CRG/20120511_FDF_CRG_c12.mtb	3511	36	WWFF	food_fat	4	39001	1336769866	1	0.02	0.00153846153846154	5620	1
2	Food 1	Intake 3	64	39114	1336769979	/users/cn/jespinosa/phecomp/data/CRG/20120502_FDF_CRG/20120502_FDF_CRG/20120511_FDF_CRG_c12.mtb	2524	171	WWFF	food_fat	3	39050	1336769915	1	1.14	0.0178125	5621	1
2	Drink 2	Intake 2	36	39290	1336770155	/users/cn/jespinosa/phecomp/data/CRG/20120502_FDF_CRG/20120502_FDF_CRG/20120511_FDF_CRG_c12.mtb	1289	NA	WWFF	water	2	39254	1336770119	1	0.08	0.00222222222222222	5622	1
2	Food 1	Intake 3	25	39310	1336770175	/users/cn/jespinosa/phecomp/data/CRG/20120502_FDF_CRG/20120502_FDF_CRG/20120511_FDF_CRG_c12.mtb	2525	143	WWFF	food_fat	3	39285	1336770150	1	0.62	0.0248	5623	1
2	Food 1	Intake 3	69	39522	1336770387	/users/cn/jespinosa/phecomp/data/CRG/20120502_FDF_CRG/20120502_FDF_CRG/20120511_FDF_CRG_c12.mtb	2526	55	WWFF	food_fat	3	39453	1336770318	1	1.36	0.0197101449275362	5624	1
2	Food 2	Intake 4	79	39656	1336770521	/users/cn/jespinosa/phecomp/data/CRG/20120502_FDF_CRG/20120502_FDF_CRG/20120511_FDF_CRG_c12.mtb	3515	COLL	WWFF	food_fat	4	39577	1336770442	1	0.02	0.000253164556962025	5625	1
2	Food 1	Intake 3	33	39611	1336770476	/users/cn/jespinosa/phecomp/data/CRG/20120502_FDF_CRG/20120502_FDF_CRG/20120511_FDF_CRG_c12.mtb	2527	296	WWFF	food_fat	3	39578	1336770443	1	0.04	0.00121212121212121	5626	1
2	Food 2	Intake 4	86	39993	1336770858	/users/cn/jespinosa/phecomp/data/CRG/20120502_FDF_CRG/20120502_FDF_CRG/20120511_FDF_CRG_c12.mtb	3516	34	WWFF	food_fat	4	39907	1336770772	1	0.22	0.00255813953488372	5627	1
2	Food 2	Intake 4	14	40041	1336770906	/users/cn/jespinosa/phecomp/data/CRG/20120502_FDF_CRG/20120502_FDF_CRG/20120511_FDF_CRG_c12.mtb	3517	234	WWFF	food_fat	4	40027	1336770892	1	0.0599999999999998	0.00428571428571427	5628	1
2	Food 2	Intake 4	20	40295	1336771160	/users/cn/jespinosa/phecomp/data/CRG/20120502_FDF_CRG/20120502_FDF_CRG/20120511_FDF_CRG_c12.mtb	3520	199	WWFF	food_fat	4	40275	1336771140	1	0.0399999999999998	0.00199999999999999	5629	1
2	Drink 1	Intake 1	21	40311	1336771176	/users/cn/jespinosa/phecomp/data/CRG/20120502_FDF_CRG/20120502_FDF_CRG/20120511_FDF_CRG_c12.mtb	840	NA	WWFF	water	1	40290	1336771155	1	0.08	0.00380952380952381	5630	1
2	Food 2	Intake 4	22	40516	1336771381	/users/cn/jespinosa/phecomp/data/CRG/20120502_FDF_CRG/20120502_FDF_CRG/20120511_FDF_CRG_c12.mtb	3523	5907	WWFF	food_fat	4	40494	1336771359	1	0.02	0.000909090909090909	5631	1
2	Drink 1	Intake 1	14	45393	1336776258	/users/cn/jespinosa/phecomp/data/CRG/20120502_FDF_CRG/20120502_FDF_CRG/20120511_FDF_CRG_c12.mtb	842	NA	WWFF	water	1	45379	1336776244	1	0.04	0.00285714285714286	5632	1
2	Food 2	Intake 4	12	46435	1336777300	/users/cn/jespinosa/phecomp/data/CRG/20120502_FDF_CRG/20120502_FDF_CRG/20120511_FDF_CRG_c12.mtb	3529	57	WWFF	food_fat	4	46423	1336777288	1	0.0399999999999998	0.00333333333333332	5633	1
2	Food 1	Intake 3	44	46536	1336777401	/users/cn/jespinosa/phecomp/data/CRG/20120502_FDF_CRG/20120502_FDF_CRG/20120511_FDF_CRG_c12.mtb	2530	COLL	WWFF	food_fat	3	46492	1336777357	1	0.42	0.00954545454545454	5634	1
2	Food 2	Intake 4	11	46535	1336777400	/users/cn/jespinosa/phecomp/data/CRG/20120502_FDF_CRG/20120502_FDF_CRG/20120511_FDF_CRG_c12.mtb	3530	56	WWFF	food_fat	4	46524	1336777389	1	0.04	0.00363636363636364	5635	1
2	Food 2	Intake 4	37	46628	1336777493	/users/cn/jespinosa/phecomp/data/CRG/20120502_FDF_CRG/20120502_FDF_CRG/20120511_FDF_CRG_c12.mtb	3531	14	WWFF	food_fat	4	46591	1336777456	1	0.18	0.00486486486486486	5636	1
2	Food 2	Intake 4	29	46671	1336777536	/users/cn/jespinosa/phecomp/data/CRG/20120502_FDF_CRG/20120502_FDF_CRG/20120511_FDF_CRG_c12.mtb	3532	COLL	WWFF	food_fat	4	46642	1336777507	1	0.1	0.00344827586206897	5637	1
2	Food 1	Intake 3	64	46718	1336777583	/users/cn/jespinosa/phecomp/data/CRG/20120502_FDF_CRG/20120502_FDF_CRG/20120511_FDF_CRG_c12.mtb	2531	372	WWFF	food_fat	3	46654	1336777519	1	0.2	0.003125	5638	1
2	Drink 2	Intake 2	42	46952	1336777817	/users/cn/jespinosa/phecomp/data/CRG/20120502_FDF_CRG/20120502_FDF_CRG/20120511_FDF_CRG_c12.mtb	1293	NA	WWFF	water	2	46910	1336777775	1	0.0600000000000001	0.00142857142857143	5639	1
2	Drink 1	Intake 1	34	46997	1336777862	/users/cn/jespinosa/phecomp/data/CRG/20120502_FDF_CRG/20120502_FDF_CRG/20120511_FDF_CRG_c12.mtb	846	NA	WWFF	water	1	46963	1336777828	1	0.1	0.00294117647058824	5640	1
2	Food 2	Intake 4	187	47277	1336778142	/users/cn/jespinosa/phecomp/data/CRG/20120502_FDF_CRG/20120502_FDF_CRG/20120511_FDF_CRG_c12.mtb	3536	9671	WWFF	food_fat	4	47090	1336777955	1	0.5	0.00267379679144385	5641	1
2	Drink 1	Intake 1	33	47511	1336778376	/users/cn/jespinosa/phecomp/data/CRG/20120502_FDF_CRG/20120502_FDF_CRG/20120511_FDF_CRG_c12.mtb	847	NA	WWFF	water	1	47478	1336778343	1	0.04	0.00121212121212121	5642	1
2	Drink 1	Intake 1	18	51944	1336782809	/users/cn/jespinosa/phecomp/data/CRG/20120502_FDF_CRG/20120502_FDF_CRG/20120511_FDF_CRG_c12.mtb	848	NA	WWFF	water	1	51926	1336782791	1	0.02	0.00111111111111111	5643	1
2	Drink 1	Intake 1	31	55194	1336786059	/users/cn/jespinosa/phecomp/data/CRG/20120502_FDF_CRG/20120502_FDF_CRG/20120511_FDF_CRG_c12.mtb	849	NA	WWFF	water	1	55163	1336786028	1	0.08	0.00258064516129032	5644	1
2	Food 1	Intake 3	14	56962	1336787827	/users/cn/jespinosa/phecomp/data/CRG/20120502_FDF_CRG/20120502_FDF_CRG/20120511_FDF_CRG_c12.mtb	2537	213	WWFF	food_fat	3	56948	1336787813	1	0.0200000000000014	0.00142857142857153	5645	1
2	Food 2	Intake 4	217	57392	1336788257	/users/cn/jespinosa/phecomp/data/CRG/20120502_FDF_CRG/20120502_FDF_CRG/20120511_FDF_CRG_c12.mtb	3538	26	WWFF	food_fat	4	57175	1336788040	1	1.18	0.00543778801843318	5646	1
2	Food 2	Intake 4	27	57445	1336788310	/users/cn/jespinosa/phecomp/data/CRG/20120502_FDF_CRG/20120502_FDF_CRG/20120511_FDF_CRG_c12.mtb	3539	20	WWFF	food_fat	4	57418	1336788283	1	0.24	0.00888888888888889	5647	1
2	Food 2	Intake 4	46	57511	1336788376	/users/cn/jespinosa/phecomp/data/CRG/20120502_FDF_CRG/20120502_FDF_CRG/20120511_FDF_CRG_c12.mtb	3540	22	WWFF	food_fat	4	57465	1336788330	1	1.26	0.0273913043478261	5648	1
2	Drink 1	Intake 1	19	57537	1336788402	/users/cn/jespinosa/phecomp/data/CRG/20120502_FDF_CRG/20120502_FDF_CRG/20120511_FDF_CRG_c12.mtb	851	NA	WWFF	water	1	57518	1336788383	1	0.04	0.00210526315789474	5649	1
2	Food 2	Intake 4	150	57683	1336788548	/users/cn/jespinosa/phecomp/data/CRG/20120502_FDF_CRG/20120502_FDF_CRG/20120511_FDF_CRG_c12.mtb	3541	952	WWFF	food_fat	4	57533	1336788398	1	0.720000000000001	0.00480000000000001	5650	1
2	Food 2	Intake 4	105	58740	1336789605	/users/cn/jespinosa/phecomp/data/CRG/20120502_FDF_CRG/20120502_FDF_CRG/20120511_FDF_CRG_c12.mtb	3547	4672	WWFF	food_fat	4	58635	1336789500	1	0.04	0.000380952380952381	5651	1
2	Drink 1	Intake 1	28	59130	1336789995	/users/cn/jespinosa/phecomp/data/CRG/20120502_FDF_CRG/20120502_FDF_CRG/20120511_FDF_CRG_c12.mtb	853	NA	WWFF	water	1	59102	1336789967	1	0.0800000000000001	0.00285714285714286	5652	1
2	Drink 1	Intake 1	17	63349	1336794214	/users/cn/jespinosa/phecomp/data/CRG/20120502_FDF_CRG/20120502_FDF_CRG/20120511_FDF_CRG_c12.mtb	855	NA	WWFF	water	1	63332	1336794197	1	0.02	0.00117647058823529	5653	1
2	Food 2	Intake 4	38	63450	1336794315	/users/cn/jespinosa/phecomp/data/CRG/20120502_FDF_CRG/20120502_FDF_CRG/20120511_FDF_CRG_c12.mtb	3550	33	WWFF	food_fat	4	63412	1336794277	1	0.04	0.00105263157894737	5654	1
2	Food 2	Intake 4	194	63677	1336794542	/users/cn/jespinosa/phecomp/data/CRG/20120502_FDF_CRG/20120502_FDF_CRG/20120511_FDF_CRG_c12.mtb	3551	43	WWFF	food_fat	4	63483	1336794348	1	0.119999999999999	0.000618556701030923	5655	1
2	Food 2	Intake 4	118	63838	1336794703	/users/cn/jespinosa/phecomp/data/CRG/20120502_FDF_CRG/20120502_FDF_CRG/20120511_FDF_CRG_c12.mtb	3552	218	WWFF	food_fat	4	63720	1336794585	1	0.0200000000000005	0.000169491525423733	5656	1
2	Drink 1	Intake 1	40	64041	1336794906	/users/cn/jespinosa/phecomp/data/CRG/20120502_FDF_CRG/20120502_FDF_CRG/20120511_FDF_CRG_c12.mtb	856	NA	WWFF	water	1	64001	1336794866	1	0.0599999999999999	0.0015	5657	1
2	Food 2	Intake 4	82	64138	1336795003	/users/cn/jespinosa/phecomp/data/CRG/20120502_FDF_CRG/20120502_FDF_CRG/20120511_FDF_CRG_c12.mtb	3553	725	WWFF	food_fat	4	64056	1336794921	1	0.0999999999999996	0.00121951219512195	5658	1
2	Drink 2	Intake 2	26	64855	1336795720	/users/cn/jespinosa/phecomp/data/CRG/20120502_FDF_CRG/20120502_FDF_CRG/20120511_FDF_CRG_c12.mtb	1297	NA	WWFF	water	2	64829	1336795694	1	0.0399999999999999	0.00153846153846153	5659	1
2	Food 2	Intake 4	99	64962	1336795827	/users/cn/jespinosa/phecomp/data/CRG/20120502_FDF_CRG/20120502_FDF_CRG/20120511_FDF_CRG_c12.mtb	3555	1989	WWFF	food_fat	4	64863	1336795728	1	0.0600000000000005	0.000606060606060611	5660	1
2	Food 2	Intake 4	12	66963	1336797828	/users/cn/jespinosa/phecomp/data/CRG/20120502_FDF_CRG/20120502_FDF_CRG/20120511_FDF_CRG_c12.mtb	3556	1576	WWFF	food_fat	4	66951	1336797816	1	0.04	0.00333333333333333	5661	1
2	Drink 2	Intake 2	15	68122	1336798987	/users/cn/jespinosa/phecomp/data/CRG/20120502_FDF_CRG/20120502_FDF_CRG/20120511_FDF_CRG_c12.mtb	1298	NA	WWFF	water	2	68107	1336798972	1	0.02	0.00133333333333333	5662	1
2	Food 2	Intake 4	12	68551	1336799416	/users/cn/jespinosa/phecomp/data/CRG/20120502_FDF_CRG/20120502_FDF_CRG/20120511_FDF_CRG_c12.mtb	3559	138	WWFF	food_fat	4	68539	1336799404	1	0.04	0.00333333333333333	5663	1
2	Food 2	Intake 4	60	68749	1336799614	/users/cn/jespinosa/phecomp/data/CRG/20120502_FDF_CRG/20120502_FDF_CRG/20120511_FDF_CRG_c12.mtb	3562	199	WWFF	food_fat	4	68689	1336799554	1	0.0599999999999996	0.000999999999999993	5664	1
2	Food 2	Intake 4	16	68964	1336799829	/users/cn/jespinosa/phecomp/data/CRG/20120502_FDF_CRG/20120502_FDF_CRG/20120511_FDF_CRG_c12.mtb	3564	94	WWFF	food_fat	4	68948	1336799813	1	0.04	0.0025	5665	1
2	Food 2	Intake 4	70	69128	1336799993	/users/cn/jespinosa/phecomp/data/CRG/20120502_FDF_CRG/20120502_FDF_CRG/20120511_FDF_CRG_c12.mtb	3566	31	WWFF	food_fat	4	69058	1336799923	1	0.14	0.002	5666	1
2	Drink 1	Intake 1	29	69164	1336800029	/users/cn/jespinosa/phecomp/data/CRG/20120502_FDF_CRG/20120502_FDF_CRG/20120511_FDF_CRG_c12.mtb	857	NA	WWFF	water	1	69135	1336800000	1	0.0600000000000001	0.00206896551724138	5667	1
2	Food 2	Intake 4	51	69210	1336800075	/users/cn/jespinosa/phecomp/data/CRG/20120502_FDF_CRG/20120502_FDF_CRG/20120511_FDF_CRG_c12.mtb	3567	215	WWFF	food_fat	4	69159	1336800024	1	0.0200000000000005	0.000392156862745108	5668	1
2	Food 2	Intake 4	17	69442	1336800307	/users/cn/jespinosa/phecomp/data/CRG/20120502_FDF_CRG/20120502_FDF_CRG/20120511_FDF_CRG_c12.mtb	3570	57	WWFF	food_fat	4	69425	1336800290	1	0.04	0.00235294117647059	5669	1
2	Food 2	Intake 4	95	69594	1336800459	/users/cn/jespinosa/phecomp/data/CRG/20120502_FDF_CRG/20120502_FDF_CRG/20120511_FDF_CRG_c12.mtb	3572	544	WWFF	food_fat	4	69499	1336800364	1	0.0599999999999996	0.000631578947368417	5670	1
2	Drink 1	Intake 1	26	69825	1336800690	/users/cn/jespinosa/phecomp/data/CRG/20120502_FDF_CRG/20120502_FDF_CRG/20120511_FDF_CRG_c12.mtb	859	NA	WWFF	water	1	69799	1336800664	1	0.0600000000000001	0.00230769230769231	5671	1
2	Food 2	Intake 4	14	70152	1336801017	/users/cn/jespinosa/phecomp/data/CRG/20120502_FDF_CRG/20120502_FDF_CRG/20120511_FDF_CRG_c12.mtb	3578	408	WWFF	food_fat	4	70138	1336801003	1	0.0200000000000005	0.00142857142857146	5672	1
2	Food 2	Intake 4	28	70588	1336801453	/users/cn/jespinosa/phecomp/data/CRG/20120502_FDF_CRG/20120502_FDF_CRG/20120511_FDF_CRG_c12.mtb	3585	7	WWFF	food_fat	4	70560	1336801425	1	0.0200000000000005	0.000714285714285732	5673	1
2	Food 2	Intake 4	35	70630	1336801495	/users/cn/jespinosa/phecomp/data/CRG/20120502_FDF_CRG/20120502_FDF_CRG/20120511_FDF_CRG_c12.mtb	3586	51	WWFF	food_fat	4	70595	1336801460	1	0.0599999999999996	0.0017142857142857	5674	1
2	Drink 1	Intake 1	22	70648	1336801513	/users/cn/jespinosa/phecomp/data/CRG/20120502_FDF_CRG/20120502_FDF_CRG/20120511_FDF_CRG_c12.mtb	860	NA	WWFF	water	1	70626	1336801491	1	0.04	0.00181818181818182	5675	1
2	Food 2	Intake 4	13	70694	1336801559	/users/cn/jespinosa/phecomp/data/CRG/20120502_FDF_CRG/20120502_FDF_CRG/20120511_FDF_CRG_c12.mtb	3587	310	WWFF	food_fat	4	70681	1336801546	1	0.04	0.00307692307692308	5676	1
2	Drink 2	Intake 2	20	70708	1336801573	/users/cn/jespinosa/phecomp/data/CRG/20120502_FDF_CRG/20120502_FDF_CRG/20120511_FDF_CRG_c12.mtb	1305	NA	WWFF	water	2	70688	1336801553	1	0.02	0.001	5677	1
2	Food 2	Intake 4	12	71016	1336801881	/users/cn/jespinosa/phecomp/data/CRG/20120502_FDF_CRG/20120502_FDF_CRG/20120511_FDF_CRG_c12.mtb	3591	135	WWFF	food_fat	4	71004	1336801869	1	0.04	0.00333333333333333	5678	1
2	Food 2	Intake 4	28	71179	1336802044	/users/cn/jespinosa/phecomp/data/CRG/20120502_FDF_CRG/20120502_FDF_CRG/20120511_FDF_CRG_c12.mtb	3593	266	WWFF	food_fat	4	71151	1336802016	1	0.04	0.00142857142857143	5679	1
2	Food 2	Intake 4	136	71581	1336802446	/users/cn/jespinosa/phecomp/data/CRG/20120502_FDF_CRG/20120502_FDF_CRG/20120511_FDF_CRG_c12.mtb	3595	53	WWFF	food_fat	4	71445	1336802310	1	0.0200000000000005	0.000147058823529415	5680	1
2	Food 2	Intake 4	137	71771	1336802636	/users/cn/jespinosa/phecomp/data/CRG/20120502_FDF_CRG/20120502_FDF_CRG/20120511_FDF_CRG_c12.mtb	3596	43	WWFF	food_fat	4	71634	1336802499	1	0.12	0.000875912408759124	5681	1
2	Food 2	Intake 4	121	71935	1336802800	/users/cn/jespinosa/phecomp/data/CRG/20120502_FDF_CRG/20120502_FDF_CRG/20120511_FDF_CRG_c12.mtb	3597	37	WWFF	food_fat	4	71814	1336802679	1	0.0599999999999996	0.000495867768595038	5682	1
2	Food 2	Intake 4	41	72013	1336802878	/users/cn/jespinosa/phecomp/data/CRG/20120502_FDF_CRG/20120502_FDF_CRG/20120511_FDF_CRG_c12.mtb	3598	688	WWFF	food_fat	4	71972	1336802837	1	0.04	0.000975609756097561	5683	1
2	Food 2	Intake 4	13	72714	1336803579	/users/cn/jespinosa/phecomp/data/CRG/20120502_FDF_CRG/20120502_FDF_CRG/20120511_FDF_CRG_c12.mtb	3605	375	WWFF	food_fat	4	72701	1336803566	1	0.04	0.00307692307692308	5684	1
2	Food 2	Intake 4	15	73104	1336803969	/users/cn/jespinosa/phecomp/data/CRG/20120502_FDF_CRG/20120502_FDF_CRG/20120511_FDF_CRG_c12.mtb	3606	388	WWFF	food_fat	4	73089	1336803954	1	0.0200000000000005	0.00133333333333337	5685	1
2	Food 2	Intake 4	32	73524	1336804389	/users/cn/jespinosa/phecomp/data/CRG/20120502_FDF_CRG/20120502_FDF_CRG/20120511_FDF_CRG_c12.mtb	3610	23	WWFF	food_fat	4	73492	1336804357	1	0.0800000000000001	0.0025	5686	1
2	Food 2	Intake 4	72	73619	1336804484	/users/cn/jespinosa/phecomp/data/CRG/20120502_FDF_CRG/20120502_FDF_CRG/20120511_FDF_CRG_c12.mtb	3611	2423	WWFF	food_fat	4	73547	1336804412	1	0.16	0.00222222222222222	5687	1
2	Food 2	Intake 4	23	76065	1336806930	/users/cn/jespinosa/phecomp/data/CRG/20120502_FDF_CRG/20120502_FDF_CRG/20120511_FDF_CRG_c12.mtb	3617	231	WWFF	food_fat	4	76042	1336806907	1	0.12	0.00521739130434783	5688	1
2	Food 2	Intake 4	16	76312	1336807177	/users/cn/jespinosa/phecomp/data/CRG/20120502_FDF_CRG/20120502_FDF_CRG/20120511_FDF_CRG_c12.mtb	3620	462	WWFF	food_fat	4	76296	1336807161	1	0.100000000000001	0.00625000000000006	5689	1
2	Food 2	Intake 4	18	76792	1336807657	/users/cn/jespinosa/phecomp/data/CRG/20120502_FDF_CRG/20120502_FDF_CRG/20120511_FDF_CRG_c12.mtb	3622	337	WWFF	food_fat	4	76774	1336807639	1	0.04	0.00222222222222222	5690	1
2	Food 2	Intake 4	17	77146	1336808011	/users/cn/jespinosa/phecomp/data/CRG/20120502_FDF_CRG/20120502_FDF_CRG/20120511_FDF_CRG_c12.mtb	3623	750	WWFF	food_fat	4	77129	1336807994	1	0.0999999999999996	0.00588235294117645	5691	1
2	Drink 2	Intake 2	28	77163	1336808028	/users/cn/jespinosa/phecomp/data/CRG/20120502_FDF_CRG/20120502_FDF_CRG/20120511_FDF_CRG_c12.mtb	1307	NA	WWFF	water	2	77135	1336808000	1	0.0600000000000001	0.00214285714285715	5692	1
2	Drink 1	Intake 1	17	77174	1336808039	/users/cn/jespinosa/phecomp/data/CRG/20120502_FDF_CRG/20120502_FDF_CRG/20120511_FDF_CRG_c12.mtb	862	NA	WWFF	water	1	77157	1336808022	1	0.02	0.00117647058823529	5693	1
2	Food 2	Intake 4	36	77932	1336808797	/users/cn/jespinosa/phecomp/data/CRG/20120502_FDF_CRG/20120502_FDF_CRG/20120511_FDF_CRG_c12.mtb	3627	1122	WWFF	food_fat	4	77896	1336808761	1	0.0200000000000005	0.000555555555555569	5694	1
2	Food 2	Intake 4	49	79103	1336809968	/users/cn/jespinosa/phecomp/data/CRG/20120502_FDF_CRG/20120502_FDF_CRG/20120511_FDF_CRG_c12.mtb	3633	465	WWFF	food_fat	4	79054	1336809919	1	0.0999999999999996	0.0020408163265306	5695	1
2	Drink 1	Intake 1	36	79172	1336810037	/users/cn/jespinosa/phecomp/data/CRG/20120502_FDF_CRG/20120502_FDF_CRG/20120511_FDF_CRG_c12.mtb	863	NA	WWFF	water	1	79136	1336810001	1	0.0800000000000001	0.00222222222222222	5696	1
2	Drink 1	Intake 1	11	79277	1336810142	/users/cn/jespinosa/phecomp/data/CRG/20120502_FDF_CRG/20120502_FDF_CRG/20120511_FDF_CRG_c12.mtb	864	NA	WWFF	water	1	79266	1336810131	1	0.0599999999999998	0.00545454545454544	5697	1
2	Food 2	Intake 4	22	79590	1336810455	/users/cn/jespinosa/phecomp/data/CRG/20120502_FDF_CRG/20120502_FDF_CRG/20120511_FDF_CRG_c12.mtb	3637	1434	WWFF	food_fat	4	79568	1336810433	1	0.0200000000000005	0.000909090909090932	5698	1
2	Food 2	Intake 4	18	81042	1336811907	/users/cn/jespinosa/phecomp/data/CRG/20120502_FDF_CRG/20120502_FDF_CRG/20120511_FDF_CRG_c12.mtb	3641	2297	WWFF	food_fat	4	81024	1336811889	1	0.0200000000000005	0.00111111111111114	5699	1
2	Food 2	Intake 4	14	83353	1336814218	/users/cn/jespinosa/phecomp/data/CRG/20120502_FDF_CRG/20120502_FDF_CRG/20120511_FDF_CRG_c12.mtb	3649	189	WWFF	food_fat	4	83339	1336814204	1	0.0599999999999996	0.00428571428571426	5700	1
2	Food 2	Intake 4	15	83557	1336814422	/users/cn/jespinosa/phecomp/data/CRG/20120502_FDF_CRG/20120502_FDF_CRG/20120511_FDF_CRG_c12.mtb	3651	370	WWFF	food_fat	4	83542	1336814407	1	0.04	0.00266666666666667	5701	1
2	Food 2	Intake 4	11	83938	1336814803	/users/cn/jespinosa/phecomp/data/CRG/20120502_FDF_CRG/20120502_FDF_CRG/20120511_FDF_CRG_c12.mtb	3656	132	WWFF	food_fat	4	83927	1336814792	1	0.04	0.00363636363636364	5702	1
2	Food 2	Intake 4	11	84081	1336814946	/users/cn/jespinosa/phecomp/data/CRG/20120502_FDF_CRG/20120502_FDF_CRG/20120511_FDF_CRG_c12.mtb	3658	40	WWFF	food_fat	4	84070	1336814935	1	0.04	0.00363636363636364	5703	1
2	Food 2	Intake 4	60	84181	1336815046	/users/cn/jespinosa/phecomp/data/CRG/20120502_FDF_CRG/20120502_FDF_CRG/20120511_FDF_CRG_c12.mtb	3659	24	WWFF	food_fat	4	84121	1336814986	1	0.0599999999999996	0.000999999999999993	5704	1
2	Food 2	Intake 4	49	84254	1336815119	/users/cn/jespinosa/phecomp/data/CRG/20120502_FDF_CRG/20120502_FDF_CRG/20120511_FDF_CRG_c12.mtb	3660	1141	WWFF	food_fat	4	84205	1336815070	1	0.0999999999999996	0.0020408163265306	5705	1
2	Food 2	Intake 4	18	85413	1336816278	/users/cn/jespinosa/phecomp/data/CRG/20120502_FDF_CRG/20120502_FDF_CRG/20120511_FDF_CRG_c12.mtb	3663	568	WWFF	food_fat	4	85395	1336816260	1	0.0200000000000005	0.00111111111111114	5706	1
2	Food 2	Intake 4	16	85997	1336816862	/users/cn/jespinosa/phecomp/data/CRG/20120502_FDF_CRG/20120502_FDF_CRG/20120511_FDF_CRG_c12.mtb	3666	215	WWFF	food_fat	4	85981	1336816846	1	0.0800000000000001	0.00500000000000001	5707	1
2	Food 2	Intake 4	24	86236	1336817101	/users/cn/jespinosa/phecomp/data/CRG/20120502_FDF_CRG/20120502_FDF_CRG/20120511_FDF_CRG_c12.mtb	3667	595	WWFF	food_fat	4	86212	1336817077	1	0.0200000000000005	0.000833333333333354	5708	1
2	Food 2	Intake 4	26	86857	1336817722	/users/cn/jespinosa/phecomp/data/CRG/20120502_FDF_CRG/20120502_FDF_CRG/20120511_FDF_CRG_c12.mtb	3670	615	WWFF	food_fat	4	86831	1336817696	1	0.04	0.00153846153846154	5709	1
2	Food 2	Intake 4	11	87483	1336818348	/users/cn/jespinosa/phecomp/data/CRG/20120502_FDF_CRG/20120502_FDF_CRG/20120511_FDF_CRG_c12.mtb	3673	1319	WWFF	food_fat	4	87472	1336818337	1	0.0599999999999996	0.00545454545454542	5710	1
2	Food 2	Intake 4	12	88814	1336819679	/users/cn/jespinosa/phecomp/data/CRG/20120502_FDF_CRG/20120502_FDF_CRG/20120511_FDF_CRG_c12.mtb	3679	2237	WWFF	food_fat	4	88802	1336819667	1	0.0399999999999991	0.00333333333333326	5711	1
2	Food 2	Intake 4	29	91080	1336821945	/users/cn/jespinosa/phecomp/data/CRG/20120502_FDF_CRG/20120502_FDF_CRG/20120511_FDF_CRG_c12.mtb	3689	119	WWFF	food_fat	4	91051	1336821916	1	0.0999999999999996	0.00344827586206895	5712	1
2	Food 2	Intake 4	40	91239	1336822104	/users/cn/jespinosa/phecomp/data/CRG/20120502_FDF_CRG/20120502_FDF_CRG/20120511_FDF_CRG_c12.mtb	3690	COLL	WWFF	food_fat	4	91199	1336822064	1	0.16	0.004	5713	1
2	Food 1	Intake 3	20	91225	1336822090	/users/cn/jespinosa/phecomp/data/CRG/20120502_FDF_CRG/20120502_FDF_CRG/20120511_FDF_CRG_c12.mtb	2552	257	WWFF	food_fat	3	91205	1336822070	1	0.0200000000000014	0.00100000000000007	5714	1
2	Drink 1	Intake 1	43	91274	1336822139	/users/cn/jespinosa/phecomp/data/CRG/20120502_FDF_CRG/20120502_FDF_CRG/20120511_FDF_CRG_c12.mtb	865	NA	WWFF	water	1	91231	1336822096	1	0.1	0.00232558139534884	5715	1
2	Food 2	Intake 4	23	91505	1336822370	/users/cn/jespinosa/phecomp/data/CRG/20120502_FDF_CRG/20120502_FDF_CRG/20120511_FDF_CRG_c12.mtb	3693	652	WWFF	food_fat	4	91482	1336822347	1	0.119999999999999	0.00521739130434778	5716	1
2	Drink 1	Intake 1	28	91523	1336822388	/users/cn/jespinosa/phecomp/data/CRG/20120502_FDF_CRG/20120502_FDF_CRG/20120511_FDF_CRG_c12.mtb	866	NA	WWFF	water	1	91495	1336822360	1	0.0599999999999998	0.00214285714285714	5717	1
2	Drink 1	Intake 1	16	91762	1336822627	/users/cn/jespinosa/phecomp/data/CRG/20120502_FDF_CRG/20120502_FDF_CRG/20120511_FDF_CRG_c12.mtb	867	NA	WWFF	water	1	91746	1336822611	1	0.02	0.00125	5718	1
2	Drink 1	Intake 1	43	92102	1336822967	/users/cn/jespinosa/phecomp/data/CRG/20120502_FDF_CRG/20120502_FDF_CRG/20120511_FDF_CRG_c12.mtb	868	NA	WWFF	water	1	92059	1336822924	1	0.0800000000000001	0.00186046511627907	5719	1
2	Food 2	Intake 4	34	92191	1336823056	/users/cn/jespinosa/phecomp/data/CRG/20120502_FDF_CRG/20120502_FDF_CRG/20120511_FDF_CRG_c12.mtb	3697	16	WWFF	food_fat	4	92157	1336823022	1	0.04	0.00117647058823529	5720	1
2	Food 2	Intake 4	127	92334	1336823199	/users/cn/jespinosa/phecomp/data/CRG/20120502_FDF_CRG/20120502_FDF_CRG/20120511_FDF_CRG_c12.mtb	3698	155	WWFF	food_fat	4	92207	1336823072	1	0.0600000000000005	0.000472440944881894	5721	1
2	Food 2	Intake 4	16	92505	1336823370	/users/cn/jespinosa/phecomp/data/CRG/20120502_FDF_CRG/20120502_FDF_CRG/20120511_FDF_CRG_c12.mtb	3701	36	WWFF	food_fat	4	92489	1336823354	1	0.04	0.0025	5722	1
2	Food 2	Intake 4	289	92830	1336823695	/users/cn/jespinosa/phecomp/data/CRG/20120502_FDF_CRG/20120502_FDF_CRG/20120511_FDF_CRG_c12.mtb	3702	39	WWFF	food_fat	4	92541	1336823406	1	0.16	0.00055363321799308	5723	1
2	Food 2	Intake 4	12	92881	1336823746	/users/cn/jespinosa/phecomp/data/CRG/20120502_FDF_CRG/20120502_FDF_CRG/20120511_FDF_CRG_c12.mtb	3704	593	WWFF	food_fat	4	92869	1336823734	1	0.04	0.00333333333333333	5724	1
2	Food 2	Intake 4	12	93486	1336824351	/users/cn/jespinosa/phecomp/data/CRG/20120502_FDF_CRG/20120502_FDF_CRG/20120511_FDF_CRG_c12.mtb	3707	403	WWFF	food_fat	4	93474	1336824339	1	0.04	0.00333333333333333	5725	1
2	Food 2	Intake 4	17	93906	1336824771	/users/cn/jespinosa/phecomp/data/CRG/20120502_FDF_CRG/20120502_FDF_CRG/20120511_FDF_CRG_c12.mtb	3710	1651	WWFF	food_fat	4	93889	1336824754	1	0.04	0.00235294117647059	5726	1
2	Food 2	Intake 4	23	95580	1336826445	/users/cn/jespinosa/phecomp/data/CRG/20120502_FDF_CRG/20120502_FDF_CRG/20120511_FDF_CRG_c12.mtb	3715	781	WWFF	food_fat	4	95557	1336826422	1	0.04	0.00173913043478261	5727	1
2	Food 2	Intake 4	21	96382	1336827247	/users/cn/jespinosa/phecomp/data/CRG/20120502_FDF_CRG/20120502_FDF_CRG/20120511_FDF_CRG_c12.mtb	3717	1296	WWFF	food_fat	4	96361	1336827226	1	0.0200000000000005	0.000952380952380976	5728	1
2	Food 2	Intake 4	139	97817	1336828682	/users/cn/jespinosa/phecomp/data/CRG/20120502_FDF_CRG/20120502_FDF_CRG/20120511_FDF_CRG_c12.mtb	3722	COLL	WWFF	food_fat	4	97678	1336828543	1	0.14	0.00100719424460432	5729	1
2	Food 1	Intake 3	114	97807	1336828672	/users/cn/jespinosa/phecomp/data/CRG/20120502_FDF_CRG/20120502_FDF_CRG/20120511_FDF_CRG_c12.mtb	2554	44	WWFF	food_fat	3	97693	1336828558	1	0.0399999999999991	0.000350877192982448	5730	1
2	Food 2	Intake 4	64	97915	1336828780	/users/cn/jespinosa/phecomp/data/CRG/20120502_FDF_CRG/20120502_FDF_CRG/20120511_FDF_CRG_c12.mtb	3723	13	WWFF	food_fat	4	97851	1336828716	1	0.0200000000000005	0.000312500000000008	5731	1
2	Food 2	Intake 4	57	97985	1336828850	/users/cn/jespinosa/phecomp/data/CRG/20120502_FDF_CRG/20120502_FDF_CRG/20120511_FDF_CRG_c12.mtb	3724	77	WWFF	food_fat	4	97928	1336828793	1	0.0999999999999996	0.00175438596491227	5732	1
2	Food 2	Intake 4	280	98342	1336829207	/users/cn/jespinosa/phecomp/data/CRG/20120502_FDF_CRG/20120502_FDF_CRG/20120511_FDF_CRG_c12.mtb	3726	95	WWFF	food_fat	4	98062	1336828927	1	0.04	0.000142857142857143	5733	1
2	Drink 2	Intake 2	12	98305	1336829170	/users/cn/jespinosa/phecomp/data/CRG/20120502_FDF_CRG/20120502_FDF_CRG/20120511_FDF_CRG_c12.mtb	1312	NA	WWFF	water	2	98293	1336829158	1	0.02	0.00166666666666667	5734	1
2	Food 2	Intake 4	21	98458	1336829323	/users/cn/jespinosa/phecomp/data/CRG/20120502_FDF_CRG/20120502_FDF_CRG/20120511_FDF_CRG_c12.mtb	3728	120	WWFF	food_fat	4	98437	1336829302	1	0.0200000000000005	0.000952380952380976	5735	1
2	Food 2	Intake 4	20	98598	1336829463	/users/cn/jespinosa/phecomp/data/CRG/20120502_FDF_CRG/20120502_FDF_CRG/20120511_FDF_CRG_c12.mtb	3731	1487	WWFF	food_fat	4	98578	1336829443	1	0.0200000000000005	0.00100000000000002	5736	1
2	Food 2	Intake 4	15	100100	1336830965	/users/cn/jespinosa/phecomp/data/CRG/20120502_FDF_CRG/20120502_FDF_CRG/20120511_FDF_CRG_c12.mtb	3735	707	WWFF	food_fat	4	100085	1336830950	1	0.0800000000000001	0.00533333333333334	5737	1
2	Food 2	Intake 4	14	100821	1336831686	/users/cn/jespinosa/phecomp/data/CRG/20120502_FDF_CRG/20120502_FDF_CRG/20120511_FDF_CRG_c12.mtb	3737	449	WWFF	food_fat	4	100807	1336831672	1	0.0599999999999996	0.00428571428571426	5738	1
2	Food 2	Intake 4	20	101290	1336832155	/users/cn/jespinosa/phecomp/data/CRG/20120502_FDF_CRG/20120502_FDF_CRG/20120511_FDF_CRG_c12.mtb	3738	557	WWFF	food_fat	4	101270	1336832135	1	0.0800000000000001	0.00400000000000001	5739	1
2	Food 2	Intake 4	9	101856	1336832721	/users/cn/jespinosa/phecomp/data/CRG/20120502_FDF_CRG/20120502_FDF_CRG/20120511_FDF_CRG_c12.mtb	3743	98	WWFF	food_fat	4	101847	1336832712	1	0.04	0.00444444444444444	5740	1
2	Food 2	Intake 4	17	101971	1336832836	/users/cn/jespinosa/phecomp/data/CRG/20120502_FDF_CRG/20120502_FDF_CRG/20120511_FDF_CRG_c12.mtb	3744	345	WWFF	food_fat	4	101954	1336832819	1	0.0200000000000005	0.00117647058823532	5741	1
2	Food 2	Intake 4	13	102329	1336833194	/users/cn/jespinosa/phecomp/data/CRG/20120502_FDF_CRG/20120502_FDF_CRG/20120511_FDF_CRG_c12.mtb	3747	633	WWFF	food_fat	4	102316	1336833181	1	0.0200000000000005	0.00153846153846158	5742	1
2	Food 2	Intake 4	26	102988	1336833853	/users/cn/jespinosa/phecomp/data/CRG/20120502_FDF_CRG/20120502_FDF_CRG/20120511_FDF_CRG_c12.mtb	3749	421	WWFF	food_fat	4	102962	1336833827	1	0.0800000000000001	0.00307692307692308	5743	1
2	Food 2	Intake 4	20	103429	1336834294	/users/cn/jespinosa/phecomp/data/CRG/20120502_FDF_CRG/20120502_FDF_CRG/20120511_FDF_CRG_c12.mtb	3752	2356	WWFF	food_fat	4	103409	1336834274	1	0.04	0.002	5744	1
2	Food 2	Intake 4	10	105795	1336836660	/users/cn/jespinosa/phecomp/data/CRG/20120502_FDF_CRG/20120502_FDF_CRG/20120511_FDF_CRG_c12.mtb	3764	212	WWFF	food_fat	4	105785	1336836650	1	0.04	0.004	5745	1
2	Food 2	Intake 4	28	106035	1336836900	/users/cn/jespinosa/phecomp/data/CRG/20120502_FDF_CRG/20120502_FDF_CRG/20120511_FDF_CRG_c12.mtb	3766	15	WWFF	food_fat	4	106007	1336836872	1	0.0600000000000005	0.00214285714285716	5746	1
2	Food 2	Intake 4	12	106062	1336836927	/users/cn/jespinosa/phecomp/data/CRG/20120502_FDF_CRG/20120502_FDF_CRG/20120511_FDF_CRG_c12.mtb	3767	125	WWFF	food_fat	4	106050	1336836915	1	0.04	0.00333333333333333	5747	1
2	Food 2	Intake 4	26	106213	1336837078	/users/cn/jespinosa/phecomp/data/CRG/20120502_FDF_CRG/20120502_FDF_CRG/20120511_FDF_CRG_c12.mtb	3770	453	WWFF	food_fat	4	106187	1336837052	1	0.04	0.00153846153846154	5748	1
2	Food 2	Intake 4	37	106703	1336837568	/users/cn/jespinosa/phecomp/data/CRG/20120502_FDF_CRG/20120502_FDF_CRG/20120511_FDF_CRG_c12.mtb	3777	148	WWFF	food_fat	4	106666	1336837531	1	0.300000000000001	0.00810810810810813	5749	1
2	Drink 1	Intake 1	44	106738	1336837603	/users/cn/jespinosa/phecomp/data/CRG/20120502_FDF_CRG/20120502_FDF_CRG/20120511_FDF_CRG_c12.mtb	869	NA	WWFF	water	1	106694	1336837559	1	0.14	0.00318181818181818	5750	1
2	Food 2	Intake 4	16	106867	1336837732	/users/cn/jespinosa/phecomp/data/CRG/20120502_FDF_CRG/20120502_FDF_CRG/20120511_FDF_CRG_c12.mtb	3780	1929	WWFF	food_fat	4	106851	1336837716	1	0.140000000000001	0.00875000000000006	5751	1
2	Food 2	Intake 4	25	108821	1336839686	/users/cn/jespinosa/phecomp/data/CRG/20120502_FDF_CRG/20120502_FDF_CRG/20120511_FDF_CRG_c12.mtb	3785	102	WWFF	food_fat	4	108796	1336839661	1	0.0599999999999996	0.00239999999999998	5752	1
2	Food 2	Intake 4	22	108945	1336839810	/users/cn/jespinosa/phecomp/data/CRG/20120502_FDF_CRG/20120502_FDF_CRG/20120511_FDF_CRG_c12.mtb	3786	2273	WWFF	food_fat	4	108923	1336839788	1	0.0800000000000001	0.00363636363636364	5753	1
2	Food 2	Intake 4	10	111228	1336842093	/users/cn/jespinosa/phecomp/data/CRG/20120502_FDF_CRG/20120502_FDF_CRG/20120511_FDF_CRG_c12.mtb	3797	1136	WWFF	food_fat	4	111218	1336842083	1	0.0200000000000005	0.00200000000000005	5754	1
2	Food 2	Intake 4	89	112453	1336843318	/users/cn/jespinosa/phecomp/data/CRG/20120502_FDF_CRG/20120502_FDF_CRG/20120511_FDF_CRG_c12.mtb	3800	8	WWFF	food_fat	4	112364	1336843229	1	0.26	0.00292134831460674	5755	1
2	Drink 2	Intake 2	21	112415	1336843280	/users/cn/jespinosa/phecomp/data/CRG/20120502_FDF_CRG/20120502_FDF_CRG/20120511_FDF_CRG_c12.mtb	1313	NA	WWFF	water	2	112394	1336843259	1	0.0600000000000001	0.00285714285714286	5756	1
2	Food 2	Intake 4	29	112490	1336843355	/users/cn/jespinosa/phecomp/data/CRG/20120502_FDF_CRG/20120502_FDF_CRG/20120511_FDF_CRG_c12.mtb	3801	25	WWFF	food_fat	4	112461	1336843326	1	0.0600000000000005	0.0020689655172414	5757	1
2	Food 2	Intake 4	12	112527	1336843392	/users/cn/jespinosa/phecomp/data/CRG/20120502_FDF_CRG/20120502_FDF_CRG/20120511_FDF_CRG_c12.mtb	3802	104	WWFF	food_fat	4	112515	1336843380	1	0.04	0.00333333333333333	5758	1
2	Food 2	Intake 4	72	112703	1336843568	/users/cn/jespinosa/phecomp/data/CRG/20120502_FDF_CRG/20120502_FDF_CRG/20120511_FDF_CRG_c12.mtb	3803	58	WWFF	food_fat	4	112631	1336843496	1	0.04	0.000555555555555556	5759	1
2	Food 2	Intake 4	27	112788	1336843653	/users/cn/jespinosa/phecomp/data/CRG/20120502_FDF_CRG/20120502_FDF_CRG/20120511_FDF_CRG_c12.mtb	3804	266	WWFF	food_fat	4	112761	1336843626	1	0.04	0.00148148148148148	5760	1
2	Food 2	Intake 4	39	113093	1336843958	/users/cn/jespinosa/phecomp/data/CRG/20120502_FDF_CRG/20120502_FDF_CRG/20120511_FDF_CRG_c12.mtb	3808	22	WWFF	food_fat	4	113054	1336843919	1	0.0999999999999996	0.00256410256410255	5761	1
2	Food 2	Intake 4	12	113127	1336843992	/users/cn/jespinosa/phecomp/data/CRG/20120502_FDF_CRG/20120502_FDF_CRG/20120511_FDF_CRG_c12.mtb	3809	419	WWFF	food_fat	4	113115	1336843980	1	0.04	0.00333333333333333	5762	1
2	Food 2	Intake 4	12	113558	1336844423	/users/cn/jespinosa/phecomp/data/CRG/20120502_FDF_CRG/20120502_FDF_CRG/20120511_FDF_CRG_c12.mtb	3810	96	WWFF	food_fat	4	113546	1336844411	1	0.04	0.00333333333333333	5763	1
2	Food 2	Intake 4	29	113683	1336844548	/users/cn/jespinosa/phecomp/data/CRG/20120502_FDF_CRG/20120502_FDF_CRG/20120511_FDF_CRG_c12.mtb	3811	1405	WWFF	food_fat	4	113654	1336844519	1	0.12	0.00413793103448276	5764	1
2	Food 2	Intake 4	85	115173	1336846038	/users/cn/jespinosa/phecomp/data/CRG/20120502_FDF_CRG/20120502_FDF_CRG/20120511_FDF_CRG_c12.mtb	3819	28	WWFF	food_fat	4	115088	1336845953	1	0.0600000000000005	0.000705882352941182	5765	1
2	Food 2	Intake 4	21	115222	1336846087	/users/cn/jespinosa/phecomp/data/CRG/20120502_FDF_CRG/20120502_FDF_CRG/20120511_FDF_CRG_c12.mtb	3820	38	WWFF	food_fat	4	115201	1336846066	1	0.04	0.0019047619047619	5766	1
2	Food 2	Intake 4	33	115293	1336846158	/users/cn/jespinosa/phecomp/data/CRG/20120502_FDF_CRG/20120502_FDF_CRG/20120511_FDF_CRG_c12.mtb	3821	59	WWFF	food_fat	4	115260	1336846125	1	0.0599999999999996	0.00181818181818181	5767	1
2	Food 2	Intake 4	9	115361	1336846226	/users/cn/jespinosa/phecomp/data/CRG/20120502_FDF_CRG/20120502_FDF_CRG/20120511_FDF_CRG_c12.mtb	3822	177	WWFF	food_fat	4	115352	1336846217	1	0.0600000000000005	0.00666666666666672	5768	1
2	Food 2	Intake 4	186	115724	1336846589	/users/cn/jespinosa/phecomp/data/CRG/20120502_FDF_CRG/20120502_FDF_CRG/20120511_FDF_CRG_c12.mtb	3825	260	WWFF	food_fat	4	115538	1336846403	1	0.0800000000000001	0.000430107526881721	5769	1
2	Food 2	Intake 4	44	116028	1336846893	/users/cn/jespinosa/phecomp/data/CRG/20120502_FDF_CRG/20120502_FDF_CRG/20120511_FDF_CRG_c12.mtb	3829	143	WWFF	food_fat	4	115984	1336846849	1	0.0599999999999996	0.00136363636363635	5770	1
2	Food 2	Intake 4	37	116208	1336847073	/users/cn/jespinosa/phecomp/data/CRG/20120502_FDF_CRG/20120502_FDF_CRG/20120511_FDF_CRG_c12.mtb	3832	385	WWFF	food_fat	4	116171	1336847036	1	0.180000000000001	0.00486486486486489	5771	1
2	Food 2	Intake 4	19	116612	1336847477	/users/cn/jespinosa/phecomp/data/CRG/20120502_FDF_CRG/20120502_FDF_CRG/20120511_FDF_CRG_c12.mtb	3834	349	WWFF	food_fat	4	116593	1336847458	1	0.04	0.00210526315789474	5772	1
2	Food 2	Intake 4	12	116973	1336847838	/users/cn/jespinosa/phecomp/data/CRG/20120502_FDF_CRG/20120502_FDF_CRG/20120511_FDF_CRG_c12.mtb	3837	140	WWFF	food_fat	4	116961	1336847826	1	0.0600000000000005	0.00500000000000004	5773	1
2	Food 2	Intake 4	11	117124	1336847989	/users/cn/jespinosa/phecomp/data/CRG/20120502_FDF_CRG/20120502_FDF_CRG/20120511_FDF_CRG_c12.mtb	3838	896	WWFF	food_fat	4	117113	1336847978	1	0.0599999999999996	0.00545454545454542	5774	1
2	Food 2	Intake 4	36	118056	1336848921	/users/cn/jespinosa/phecomp/data/CRG/20120502_FDF_CRG/20120502_FDF_CRG/20120511_FDF_CRG_c12.mtb	3842	158	WWFF	food_fat	4	118020	1336848885	1	0.18	0.005	5775	1
2	Food 2	Intake 4	14	118228	1336849093	/users/cn/jespinosa/phecomp/data/CRG/20120502_FDF_CRG/20120502_FDF_CRG/20120511_FDF_CRG_c12.mtb	3845	226	WWFF	food_fat	4	118214	1336849079	1	0.0800000000000001	0.00571428571428572	5776	1
2	Food 2	Intake 4	33	118487	1336849352	/users/cn/jespinosa/phecomp/data/CRG/20120502_FDF_CRG/20120502_FDF_CRG/20120511_FDF_CRG_c12.mtb	3850	144	WWFF	food_fat	4	118454	1336849319	1	0.0999999999999996	0.00303030303030302	5777	1
2	Food 2	Intake 4	13	118644	1336849509	/users/cn/jespinosa/phecomp/data/CRG/20120502_FDF_CRG/20120502_FDF_CRG/20120511_FDF_CRG_c12.mtb	3851	407	WWFF	food_fat	4	118631	1336849496	1	0.0200000000000005	0.00153846153846158	5778	1
2	Drink 2	Intake 2	16	118690	1336849555	/users/cn/jespinosa/phecomp/data/CRG/20120502_FDF_CRG/20120502_FDF_CRG/20120511_FDF_CRG_c12.mtb	1316	NA	WWFF	water	2	118674	1336849539	1	0.02	0.00125	5779	1
2	Food 2	Intake 4	155	119206	1336850071	/users/cn/jespinosa/phecomp/data/CRG/20120502_FDF_CRG/20120502_FDF_CRG/20120511_FDF_CRG_c12.mtb	3853	37	WWFF	food_fat	4	119051	1336849916	1	0.0799999999999992	0.000516129032258059	5780	1
2	Food 2	Intake 4	185	119428	1336850293	/users/cn/jespinosa/phecomp/data/CRG/20120502_FDF_CRG/20120502_FDF_CRG/20120511_FDF_CRG_c12.mtb	3854	128	WWFF	food_fat	4	119243	1336850108	1	0.0600000000000005	0.000324324324324327	5781	1
2	Food 2	Intake 4	19	119575	1336850440	/users/cn/jespinosa/phecomp/data/CRG/20120502_FDF_CRG/20120502_FDF_CRG/20120511_FDF_CRG_c12.mtb	3856	7	WWFF	food_fat	4	119556	1336850421	1	0.0800000000000001	0.00421052631578948	5782	1
2	Food 2	Intake 4	178	119760	1336850625	/users/cn/jespinosa/phecomp/data/CRG/20120502_FDF_CRG/20120502_FDF_CRG/20120511_FDF_CRG_c12.mtb	3857	88	WWFF	food_fat	4	119582	1336850447	1	0.100000000000001	0.000561797752808994	5783	1
2	Food 2	Intake 4	155	120003	1336850868	/users/cn/jespinosa/phecomp/data/CRG/20120502_FDF_CRG/20120502_FDF_CRG/20120511_FDF_CRG_c12.mtb	3858	COLL	WWFF	food_fat	4	119848	1336850713	1	0.22	0.00141935483870968	5784	1
2	Food 1	Intake 3	17	119866	1336850731	/users/cn/jespinosa/phecomp/data/CRG/20120502_FDF_CRG/20120502_FDF_CRG/20120511_FDF_CRG_c12.mtb	2556	159	WWFF	food_fat	3	119849	1336850714	1	0.0200000000000014	0.00117647058823538	5785	1
2	Food 2	Intake 4	13	120038	1336850903	/users/cn/jespinosa/phecomp/data/CRG/20120502_FDF_CRG/20120502_FDF_CRG/20120511_FDF_CRG_c12.mtb	3859	51	WWFF	food_fat	4	120025	1336850890	1	0.04	0.00307692307692308	5786	1
2	Food 2	Intake 4	97	120186	1336851051	/users/cn/jespinosa/phecomp/data/CRG/20120502_FDF_CRG/20120502_FDF_CRG/20120511_FDF_CRG_c12.mtb	3860	6	WWFF	food_fat	4	120089	1336850954	1	0.04	0.000412371134020619	5787	1
2	Drink 1	Intake 1	30	120203	1336851068	/users/cn/jespinosa/phecomp/data/CRG/20120502_FDF_CRG/20120502_FDF_CRG/20120511_FDF_CRG_c12.mtb	872	NA	WWFF	water	1	120173	1336851038	1	0.04	0.00133333333333333	5788	1
2	Food 2	Intake 4	187	120379	1336851244	/users/cn/jespinosa/phecomp/data/CRG/20120502_FDF_CRG/20120502_FDF_CRG/20120511_FDF_CRG_c12.mtb	3861	87	WWFF	food_fat	4	120192	1336851057	1	0.48	0.0025668449197861	5789	1
2	Food 2	Intake 4	138	120604	1336851469	/users/cn/jespinosa/phecomp/data/CRG/20120502_FDF_CRG/20120502_FDF_CRG/20120511_FDF_CRG_c12.mtb	3862	553	WWFF	food_fat	4	120466	1336851331	1	0.56	0.00405797101449275	5790	1
2	Food 2	Intake 4	46	121203	1336852068	/users/cn/jespinosa/phecomp/data/CRG/20120502_FDF_CRG/20120502_FDF_CRG/20120511_FDF_CRG_c12.mtb	3866	25	WWFF	food_fat	4	121157	1336852022	1	0.14	0.00304347826086957	5791	1
2	Food 2	Intake 4	120	121348	1336852213	/users/cn/jespinosa/phecomp/data/CRG/20120502_FDF_CRG/20120502_FDF_CRG/20120511_FDF_CRG_c12.mtb	3867	7	WWFF	food_fat	4	121228	1336852093	1	0.04	0.000333333333333333	5792	1
2	Drink 1	Intake 1	20	121287	1336852152	/users/cn/jespinosa/phecomp/data/CRG/20120502_FDF_CRG/20120502_FDF_CRG/20120511_FDF_CRG_c12.mtb	873	NA	WWFF	water	1	121267	1336852132	1	0.02	0.001	5793	1
2	Food 2	Intake 4	226	121581	1336852446	/users/cn/jespinosa/phecomp/data/CRG/20120502_FDF_CRG/20120502_FDF_CRG/20120511_FDF_CRG_c12.mtb	3868	154	WWFF	food_fat	4	121355	1336852220	1	0.22	0.000973451327433628	5794	1
2	Drink 1	Intake 1	24	121594	1336852459	/users/cn/jespinosa/phecomp/data/CRG/20120502_FDF_CRG/20120502_FDF_CRG/20120511_FDF_CRG_c12.mtb	874	NA	WWFF	water	1	121570	1336852435	1	0.02	0.000833333333333333	5795	1
2	Food 2	Intake 4	150	121885	1336852750	/users/cn/jespinosa/phecomp/data/CRG/20120502_FDF_CRG/20120502_FDF_CRG/20120511_FDF_CRG_c12.mtb	3870	82	WWFF	food_fat	4	121735	1336852600	1	0.0600000000000005	0.000400000000000003	5796	1
2	Food 2	Intake 4	120	122087	1336852952	/users/cn/jespinosa/phecomp/data/CRG/20120502_FDF_CRG/20120502_FDF_CRG/20120511_FDF_CRG_c12.mtb	3872	165	WWFF	food_fat	4	121967	1336852832	1	0.04	0.000333333333333333	5797	1
2	Food 2	Intake 4	13	122265	1336853130	/users/cn/jespinosa/phecomp/data/CRG/20120502_FDF_CRG/20120502_FDF_CRG/20120511_FDF_CRG_c12.mtb	3874	104	WWFF	food_fat	4	122252	1336853117	1	0.04	0.00307692307692308	5798	1
2	Food 2	Intake 4	17	122386	1336853251	/users/cn/jespinosa/phecomp/data/CRG/20120502_FDF_CRG/20120502_FDF_CRG/20120511_FDF_CRG_c12.mtb	3875	329	WWFF	food_fat	4	122369	1336853234	1	0.04	0.00235294117647059	5799	1
2	Food 2	Intake 4	14	122729	1336853594	/users/cn/jespinosa/phecomp/data/CRG/20120502_FDF_CRG/20120502_FDF_CRG/20120511_FDF_CRG_c12.mtb	3877	976	WWFF	food_fat	4	122715	1336853580	1	0.0599999999999996	0.00428571428571426	5800	1
2	Drink 1	Intake 1	20	122903	1336853768	/users/cn/jespinosa/phecomp/data/CRG/20120502_FDF_CRG/20120502_FDF_CRG/20120511_FDF_CRG_c12.mtb	875	NA	WWFF	water	1	122883	1336853748	1	0.0399999999999998	0.00199999999999999	5801	1
2	Food 2	Intake 4	252	123957	1336854822	/users/cn/jespinosa/phecomp/data/CRG/20120502_FDF_CRG/20120502_FDF_CRG/20120511_FDF_CRG_c12.mtb	3881	33	WWFF	food_fat	4	123705	1336854570	1	2.28	0.00904761904761905	5802	1
2	Food 2	Intake 4	218	124208	1336855073	/users/cn/jespinosa/phecomp/data/CRG/20120502_FDF_CRG/20120502_FDF_CRG/20120511_FDF_CRG_c12.mtb	3882	183	WWFF	food_fat	4	123990	1336854855	1	0.699999999999999	0.00321100917431192	5803	1
2	Drink 1	Intake 1	15	124100	1336854965	/users/cn/jespinosa/phecomp/data/CRG/20120502_FDF_CRG/20120502_FDF_CRG/20120511_FDF_CRG_c12.mtb	877	NA	WWFF	water	1	124085	1336854950	1	0.02	0.00133333333333333	5804	1
2	Food 2	Intake 4	255	124646	1336855511	/users/cn/jespinosa/phecomp/data/CRG/20120502_FDF_CRG/20120502_FDF_CRG/20120511_FDF_CRG_c12.mtb	3884	39	WWFF	food_fat	4	124391	1336855256	1	0.16	0.000627450980392157	5805	1
2	Food 2	Intake 4	563	125248	1336856113	/users/cn/jespinosa/phecomp/data/CRG/20120502_FDF_CRG/20120502_FDF_CRG/20120511_FDF_CRG_c12.mtb	3885	358	WWFF	food_fat	4	124685	1336855550	1	0.16	0.000284191829484902	5806	1
2	Drink 1	Intake 1	20	124751	1336855616	/users/cn/jespinosa/phecomp/data/CRG/20120502_FDF_CRG/20120502_FDF_CRG/20120511_FDF_CRG_c12.mtb	879	NA	WWFF	water	1	124731	1336855596	1	0.02	0.001	5807	1
2	Drink 2	Intake 2	101	125083	1336855948	/users/cn/jespinosa/phecomp/data/CRG/20120502_FDF_CRG/20120502_FDF_CRG/20120511_FDF_CRG_c12.mtb	1325	NA	WWFF	water	2	124982	1336855847	1	0.0599999999999999	0.000594059405940593	5808	1
2	Drink 2	Intake 2	12	125128	1336855993	/users/cn/jespinosa/phecomp/data/CRG/20120502_FDF_CRG/20120502_FDF_CRG/20120511_FDF_CRG_c12.mtb	1326	NA	WWFF	water	2	125116	1336855981	1	0.02	0.00166666666666667	5809	1
2	Food 2	Intake 4	567	126173	1336857038	/users/cn/jespinosa/phecomp/data/CRG/20120502_FDF_CRG/20120502_FDF_CRG/20120511_FDF_CRG_c12.mtb	3887	4	WWFF	food_fat	4	125606	1336856471	1	0.119999999999999	0.00021164021164021	5810	1
2	Food 2	Intake 4	81	126258	1336857123	/users/cn/jespinosa/phecomp/data/CRG/20120502_FDF_CRG/20120502_FDF_CRG/20120511_FDF_CRG_c12.mtb	3888	1983	WWFF	food_fat	4	126177	1336857042	1	0.0400000000000009	0.000493827160493838	5811	1
2	Food 2	Intake 4	71	128312	1336859177	/users/cn/jespinosa/phecomp/data/CRG/20120502_FDF_CRG/20120502_FDF_CRG/20120511_FDF_CRG_c12.mtb	3911	16	WWFF	food_fat	4	128241	1336859106	1	0.24	0.00338028169014084	5812	1
2	Drink 2	Intake 2	24	128275	1336859140	/users/cn/jespinosa/phecomp/data/CRG/20120502_FDF_CRG/20120502_FDF_CRG/20120511_FDF_CRG_c12.mtb	1328	NA	WWFF	water	2	128251	1336859116	1	0.02	0.000833333333333333	5813	1
2	Food 2	Intake 4	12	128340	1336859205	/users/cn/jespinosa/phecomp/data/CRG/20120502_FDF_CRG/20120502_FDF_CRG/20120511_FDF_CRG_c12.mtb	3912	290	WWFF	food_fat	4	128328	1336859193	1	0.0399999999999991	0.00333333333333326	5814	1
2	Food 2	Intake 4	12	128642	1336859507	/users/cn/jespinosa/phecomp/data/CRG/20120502_FDF_CRG/20120502_FDF_CRG/20120511_FDF_CRG_c12.mtb	3913	381	WWFF	food_fat	4	128630	1336859495	1	0.0400000000000009	0.00333333333333341	5815	1
2	Food 2	Intake 4	221	129244	1336860109	/users/cn/jespinosa/phecomp/data/CRG/20120502_FDF_CRG/20120502_FDF_CRG/20120511_FDF_CRG_c12.mtb	3917	16	WWFF	food_fat	4	129023	1336859888	1	0.0600000000000005	0.000271493212669686	5816	1
2	Food 2	Intake 4	222	129482	1336860347	/users/cn/jespinosa/phecomp/data/CRG/20120502_FDF_CRG/20120502_FDF_CRG/20120511_FDF_CRG_c12.mtb	3918	825	WWFF	food_fat	4	129260	1336860125	1	0.4	0.0018018018018018	5817	1
2	Drink 2	Intake 2	39	130245	1336861110	/users/cn/jespinosa/phecomp/data/CRG/20120502_FDF_CRG/20120502_FDF_CRG/20120511_FDF_CRG_c12.mtb	1334	NA	WWFF	water	2	130206	1336861071	1	0.02	0.000512820512820513	5818	1
2	Drink 1	Intake 1	51	130289	1336861154	/users/cn/jespinosa/phecomp/data/CRG/20120502_FDF_CRG/20120502_FDF_CRG/20120511_FDF_CRG_c12.mtb	883	NA	WWFF	water	1	130238	1336861103	1	0.0799999999999998	0.00156862745098039	5819	1
2	Food 2	Intake 4	369	130676	1336861541	/users/cn/jespinosa/phecomp/data/CRG/20120502_FDF_CRG/20120502_FDF_CRG/20120511_FDF_CRG_c12.mtb	3921	COLL	WWFF	food_fat	4	130307	1336861172	1	0.640000000000001	0.00173441734417344	5820	1
2	Food 1	Intake 3	46	130584	1336861449	/users/cn/jespinosa/phecomp/data/CRG/20120502_FDF_CRG/20120502_FDF_CRG/20120511_FDF_CRG_c12.mtb	2568	107	WWFF	food_fat	3	130538	1336861403	1	0.0200000000000014	0.000434782608695683	5821	1
2	Food 2	Intake 4	23	130714	1336861579	/users/cn/jespinosa/phecomp/data/CRG/20120502_FDF_CRG/20120502_FDF_CRG/20120511_FDF_CRG_c12.mtb	3922	34	WWFF	food_fat	4	130691	1336861556	1	0.0399999999999991	0.00173913043478257	5822	1
2	Food 2	Intake 4	407	131155	1336862020	/users/cn/jespinosa/phecomp/data/CRG/20120502_FDF_CRG/20120502_FDF_CRG/20120511_FDF_CRG_c12.mtb	3923	27	WWFF	food_fat	4	130748	1336861613	1	0.119999999999999	0.000294840294840292	5823	1
2	Food 2	Intake 4	37	131219	1336862084	/users/cn/jespinosa/phecomp/data/CRG/20120502_FDF_CRG/20120502_FDF_CRG/20120511_FDF_CRG_c12.mtb	3924	206	WWFF	food_fat	4	131182	1336862047	1	0.0200000000000014	0.000540540540540578	5824	1
2	Food 2	Intake 4	110	131535	1336862400	/users/cn/jespinosa/phecomp/data/CRG/20120502_FDF_CRG/20120502_FDF_CRG/20120511_FDF_CRG_c12.mtb	3926	756	WWFF	food_fat	4	131425	1336862290	1	0.0800000000000001	0.000727272727272728	5825	1
2	Food 2	Intake 4	28	132319	1336863184	/users/cn/jespinosa/phecomp/data/CRG/20120502_FDF_CRG/20120502_FDF_CRG/20120511_FDF_CRG_c12.mtb	3931	237	WWFF	food_fat	4	132291	1336863156	1	0.0800000000000001	0.00285714285714286	5826	1
2	Food 2	Intake 4	30	132586	1336863451	/users/cn/jespinosa/phecomp/data/CRG/20120502_FDF_CRG/20120502_FDF_CRG/20120511_FDF_CRG_c12.mtb	3932	6	WWFF	food_fat	4	132556	1336863421	1	0.0200000000000014	0.000666666666666713	5827	1
2	Food 2	Intake 4	53	132645	1336863510	/users/cn/jespinosa/phecomp/data/CRG/20120502_FDF_CRG/20120502_FDF_CRG/20120511_FDF_CRG_c12.mtb	3933	151	WWFF	food_fat	4	132592	1336863457	1	0.0599999999999987	0.00113207547169809	5828	1
2	Food 2	Intake 4	17	132813	1336863678	/users/cn/jespinosa/phecomp/data/CRG/20120502_FDF_CRG/20120502_FDF_CRG/20120511_FDF_CRG_c12.mtb	3934	1783	WWFF	food_fat	4	132796	1336863661	1	0.0400000000000009	0.00235294117647064	5829	1
2	Food 2	Intake 4	72	134668	1336865533	/users/cn/jespinosa/phecomp/data/CRG/20120502_FDF_CRG/20120502_FDF_CRG/20120511_FDF_CRG_c12.mtb	3937	478	WWFF	food_fat	4	134596	1336865461	1	0.0600000000000005	0.00083333333333334	5830	1
2	Food 2	Intake 4	19	135165	1336866030	/users/cn/jespinosa/phecomp/data/CRG/20120502_FDF_CRG/20120502_FDF_CRG/20120511_FDF_CRG_c12.mtb	3941	41	WWFF	food_fat	4	135146	1336866011	1	0.0400000000000009	0.00210526315789478	5831	1
2	Food 2	Intake 4	26	135232	1336866097	/users/cn/jespinosa/phecomp/data/CRG/20120502_FDF_CRG/20120502_FDF_CRG/20120511_FDF_CRG_c12.mtb	3942	379	WWFF	food_fat	4	135206	1336866071	1	0.0800000000000001	0.00307692307692308	5832	1
2	Food 2	Intake 4	17	135628	1336866493	/users/cn/jespinosa/phecomp/data/CRG/20120502_FDF_CRG/20120502_FDF_CRG/20120511_FDF_CRG_c12.mtb	3945	342	WWFF	food_fat	4	135611	1336866476	1	0.220000000000001	0.0129411764705883	5833	1
2	Drink 2	Intake 2	27	135642	1336866507	/users/cn/jespinosa/phecomp/data/CRG/20120502_FDF_CRG/20120502_FDF_CRG/20120511_FDF_CRG_c12.mtb	1336	NA	WWFF	water	2	135615	1336866480	1	0.1	0.0037037037037037	5834	1
2	Food 2	Intake 4	23	135993	1336866858	/users/cn/jespinosa/phecomp/data/CRG/20120502_FDF_CRG/20120502_FDF_CRG/20120511_FDF_CRG_c12.mtb	3947	621	WWFF	food_fat	4	135970	1336866835	1	0.16	0.00695652173913044	5835	1
2	Food 2	Intake 4	335	136949	1336867814	/users/cn/jespinosa/phecomp/data/CRG/20120502_FDF_CRG/20120502_FDF_CRG/20120511_FDF_CRG_c12.mtb	3951	8	WWFF	food_fat	4	136614	1336867479	1	0.0399999999999991	0.000119402985074624	5836	1
2	Drink 1	Intake 1	12	136758	1336867623	/users/cn/jespinosa/phecomp/data/CRG/20120502_FDF_CRG/20120502_FDF_CRG/20120511_FDF_CRG_c12.mtb	884	NA	WWFF	water	1	136746	1336867611	1	0.04	0.00333333333333333	5837	1
2	Food 2	Intake 4	293	137250	1336868115	/users/cn/jespinosa/phecomp/data/CRG/20120502_FDF_CRG/20120502_FDF_CRG/20120511_FDF_CRG_c12.mtb	3952	COLL	WWFF	food_fat	4	136957	1336867822	1	0.0999999999999996	0.000341296928327644	5838	1
2	Food 1	Intake 3	67	137247	1336868112	/users/cn/jespinosa/phecomp/data/CRG/20120502_FDF_CRG/20120502_FDF_CRG/20120511_FDF_CRG_c12.mtb	2573	49	WWFF	food_fat	3	137180	1336868045	1	0.0800000000000001	0.00119402985074627	5839	1
2	Food 2	Intake 4	349	137645	1336868510	/users/cn/jespinosa/phecomp/data/CRG/20120502_FDF_CRG/20120502_FDF_CRG/20120511_FDF_CRG_c12.mtb	3953	COLL	WWFF	food_fat	4	137296	1336868161	1	0.140000000000001	0.00040114613180516	5840	1
2	Drink 2	Intake 2	31	137330	1336868195	/users/cn/jespinosa/phecomp/data/CRG/20120502_FDF_CRG/20120502_FDF_CRG/20120511_FDF_CRG_c12.mtb	1340	NA	WWFF	water	2	137299	1336868164	1	0.02	0.000645161290322581	5841	1
2	Food 1	Intake 3	311	137643	1336868508	/users/cn/jespinosa/phecomp/data/CRG/20120502_FDF_CRG/20120502_FDF_CRG/20120511_FDF_CRG_c12.mtb	2574	81	WWFF	food_fat	3	137332	1336868197	1	0.94	0.00302250803858521	5842	1
2	Food 1	Intake 3	91	137815	1336868680	/users/cn/jespinosa/phecomp/data/CRG/20120502_FDF_CRG/20120502_FDF_CRG/20120511_FDF_CRG_c12.mtb	2575	68	WWFF	food_fat	3	137724	1336868589	1	1.16	0.0127472527472527	5843	1
2	Drink 2	Intake 2	29	137840	1336868705	/users/cn/jespinosa/phecomp/data/CRG/20120502_FDF_CRG/20120502_FDF_CRG/20120511_FDF_CRG_c12.mtb	1341	NA	WWFF	water	2	137811	1336868676	1	0.04	0.00137931034482759	5844	1
2	Food 1	Intake 3	45	137928	1336868793	/users/cn/jespinosa/phecomp/data/CRG/20120502_FDF_CRG/20120502_FDF_CRG/20120511_FDF_CRG_c12.mtb	2576	21	WWFF	food_fat	3	137883	1336868748	1	0.52	0.0115555555555556	5845	1
2	Food 1	Intake 3	181	138130	1336868995	/users/cn/jespinosa/phecomp/data/CRG/20120502_FDF_CRG/20120502_FDF_CRG/20120511_FDF_CRG_c12.mtb	2577	650	WWFF	food_fat	3	137949	1336868814	1	2.22	0.0122651933701657	5846	1
2	Drink 2	Intake 2	23	138627	1336869492	/users/cn/jespinosa/phecomp/data/CRG/20120502_FDF_CRG/20120502_FDF_CRG/20120511_FDF_CRG_c12.mtb	1342	NA	WWFF	water	2	138604	1336869469	1	0.02	0.000869565217391304	5847	1
2	Food 2	Intake 4	17	138797	1336869662	/users/cn/jespinosa/phecomp/data/CRG/20120502_FDF_CRG/20120502_FDF_CRG/20120511_FDF_CRG_c12.mtb	3964	376	WWFF	food_fat	4	138780	1336869645	1	0.0599999999999987	0.00352941176470581	5848	1
2	Food 2	Intake 4	18	139191	1336870056	/users/cn/jespinosa/phecomp/data/CRG/20120502_FDF_CRG/20120502_FDF_CRG/20120511_FDF_CRG_c12.mtb	3967	169	WWFF	food_fat	4	139173	1336870038	1	0.0399999999999991	0.00222222222222217	5849	1
2	Food 2	Intake 4	50	139410	1336870275	/users/cn/jespinosa/phecomp/data/CRG/20120502_FDF_CRG/20120502_FDF_CRG/20120511_FDF_CRG_c12.mtb	3969	548	WWFF	food_fat	4	139360	1336870225	1	0.0400000000000009	0.000800000000000018	5850	1
2	Food 2	Intake 4	14	139972	1336870837	/users/cn/jespinosa/phecomp/data/CRG/20120502_FDF_CRG/20120502_FDF_CRG/20120511_FDF_CRG_c12.mtb	3976	849	WWFF	food_fat	4	139958	1336870823	1	0.0600000000000005	0.00428571428571432	5851	1
2	Food 2	Intake 4	15	140836	1336871701	/users/cn/jespinosa/phecomp/data/CRG/20120502_FDF_CRG/20120502_FDF_CRG/20120511_FDF_CRG_c12.mtb	3980	25	WWFF	food_fat	4	140821	1336871686	1	0.0600000000000005	0.00400000000000003	5852	1
2	Food 2	Intake 4	92	140953	1336871818	/users/cn/jespinosa/phecomp/data/CRG/20120502_FDF_CRG/20120502_FDF_CRG/20120511_FDF_CRG_c12.mtb	3981	981	WWFF	food_fat	4	140861	1336871726	1	0.0600000000000005	0.000652173913043484	5853	1
2	Food 2	Intake 4	20	141954	1336872819	/users/cn/jespinosa/phecomp/data/CRG/20120502_FDF_CRG/20120502_FDF_CRG/20120511_FDF_CRG_c12.mtb	3986	1167	WWFF	food_fat	4	141934	1336872799	1	0.0400000000000009	0.00200000000000005	5854	1
2	Drink 2	Intake 2	20	142770	1336873635	/users/cn/jespinosa/phecomp/data/CRG/20120502_FDF_CRG/20120502_FDF_CRG/20120511_FDF_CRG_c12.mtb	1346	NA	WWFF	water	2	142750	1336873615	1	0.0599999999999998	0.00299999999999999	5855	1
2	Food 2	Intake 4	17	143138	1336874003	/users/cn/jespinosa/phecomp/data/CRG/20120502_FDF_CRG/20120502_FDF_CRG/20120511_FDF_CRG_c12.mtb	3989	892	WWFF	food_fat	4	143121	1336873986	1	0.0200000000000014	0.00117647058823538	5856	1
2	Food 2	Intake 4	15	144045	1336874910	/users/cn/jespinosa/phecomp/data/CRG/20120502_FDF_CRG/20120502_FDF_CRG/20120511_FDF_CRG_c12.mtb	3997	30	WWFF	food_fat	4	144030	1336874895	1	0.0400000000000009	0.00266666666666673	5857	1
2	Food 2	Intake 4	12	144087	1336874952	/users/cn/jespinosa/phecomp/data/CRG/20120502_FDF_CRG/20120502_FDF_CRG/20120511_FDF_CRG_c12.mtb	3999	213	WWFF	food_fat	4	144075	1336874940	1	0.0600000000000005	0.00500000000000004	5858	1
2	Food 2	Intake 4	25	144325	1336875190	/users/cn/jespinosa/phecomp/data/CRG/20120502_FDF_CRG/20120502_FDF_CRG/20120511_FDF_CRG_c12.mtb	4002	38	WWFF	food_fat	4	144300	1336875165	1	0.0600000000000005	0.00240000000000002	5859	1
2	Food 2	Intake 4	12	144375	1336875240	/users/cn/jespinosa/phecomp/data/CRG/20120502_FDF_CRG/20120502_FDF_CRG/20120511_FDF_CRG_c12.mtb	4004	491	WWFF	food_fat	4	144363	1336875228	1	0.0600000000000005	0.00500000000000004	5860	1
2	Food 2	Intake 4	22	144888	1336875753	/users/cn/jespinosa/phecomp/data/CRG/20120502_FDF_CRG/20120502_FDF_CRG/20120511_FDF_CRG_c12.mtb	4007	4	WWFF	food_fat	4	144866	1336875731	1	0.0600000000000005	0.00272727272727275	5861	1
2	Food 2	Intake 4	12	144904	1336875769	/users/cn/jespinosa/phecomp/data/CRG/20120502_FDF_CRG/20120502_FDF_CRG/20120511_FDF_CRG_c12.mtb	4008	570	WWFF	food_fat	4	144892	1336875757	1	0.0399999999999991	0.00333333333333326	5862	1
2	Food 2	Intake 4	22	145496	1336876361	/users/cn/jespinosa/phecomp/data/CRG/20120502_FDF_CRG/20120502_FDF_CRG/20120511_FDF_CRG_c12.mtb	4013	268	WWFF	food_fat	4	145474	1336876339	1	0.0600000000000005	0.00272727272727275	5863	1
2	Drink 2	Intake 2	18	145559	1336876424	/users/cn/jespinosa/phecomp/data/CRG/20120502_FDF_CRG/20120502_FDF_CRG/20120511_FDF_CRG_c12.mtb	1347	NA	WWFF	water	2	145541	1336876406	1	0.04	0.00222222222222222	5864	1
2	Food 2	Intake 4	66	145830	1336876695	/users/cn/jespinosa/phecomp/data/CRG/20120502_FDF_CRG/20120502_FDF_CRG/20120511_FDF_CRG_c12.mtb	4015	590	WWFF	food_fat	4	145764	1336876629	1	0.0400000000000009	0.00060606060606062	5865	1
2	Food 1	Intake 3	142	146562	1336877427	/users/cn/jespinosa/phecomp/data/CRG/20120502_FDF_CRG/20120502_FDF_CRG/20120511_FDF_CRG_c12.mtb	2580	26	WWFF	food_fat	3	146420	1336877285	1	0.100000000000001	0.000704225352112683	5866	1
2	Food 1	Intake 3	192	146780	1336877645	/users/cn/jespinosa/phecomp/data/CRG/20120502_FDF_CRG/20120502_FDF_CRG/20120511_FDF_CRG_c12.mtb	2581	46	WWFF	food_fat	3	146588	1336877453	1	1.02	0.0053125	5867	1
2	Food 2	Intake 4	384	147210	1336878075	/users/cn/jespinosa/phecomp/data/CRG/20120502_FDF_CRG/20120502_FDF_CRG/20120511_FDF_CRG_c12.mtb	4020	COLL	WWFF	food_fat	4	146826	1336877691	1	0.0999999999999996	0.000260416666666666	5868	1
2	Food 1	Intake 3	96	146930	1336877795	/users/cn/jespinosa/phecomp/data/CRG/20120502_FDF_CRG/20120502_FDF_CRG/20120511_FDF_CRG_c12.mtb	2582	286	WWFF	food_fat	3	146834	1336877699	1	1.5	0.015625	5869	1
2	Drink 2	Intake 2	18	146945	1336877810	/users/cn/jespinosa/phecomp/data/CRG/20120502_FDF_CRG/20120502_FDF_CRG/20120511_FDF_CRG_c12.mtb	1349	NA	WWFF	water	2	146927	1336877792	1	0.02	0.00111111111111111	5870	1
2	Food 2	Intake 4	424	147640	1336878505	/users/cn/jespinosa/phecomp/data/CRG/20120502_FDF_CRG/20120502_FDF_CRG/20120511_FDF_CRG_c12.mtb	4021	406	WWFF	food_fat	4	147216	1336878081	1	0.0400000000000009	9.43396226415116e-05	5871	1
2	Drink 1	Intake 1	20	147241	1336878106	/users/cn/jespinosa/phecomp/data/CRG/20120502_FDF_CRG/20120502_FDF_CRG/20120511_FDF_CRG_c12.mtb	888	NA	WWFF	water	1	147221	1336878086	1	0.0600000000000001	0.00300000000000001	5872	1
2	Drink 1	Intake 1	11	147634	1336878499	/users/cn/jespinosa/phecomp/data/CRG/20120502_FDF_CRG/20120502_FDF_CRG/20120511_FDF_CRG_c12.mtb	889	NA	WWFF	water	1	147623	1336878488	1	0.02	0.00181818181818182	5873	1
2	Food 2	Intake 4	198	148244	1336879109	/users/cn/jespinosa/phecomp/data/CRG/20120502_FDF_CRG/20120502_FDF_CRG/20120511_FDF_CRG_c12.mtb	4027	256	WWFF	food_fat	4	148046	1336878911	1	0.120000000000001	0.000606060606060611	5874	1
2	Food 2	Intake 4	20	148520	1336879385	/users/cn/jespinosa/phecomp/data/CRG/20120502_FDF_CRG/20120502_FDF_CRG/20120511_FDF_CRG_c12.mtb	4030	988	WWFF	food_fat	4	148500	1336879365	1	0.0600000000000005	0.00300000000000002	5875	1
2	Food 2	Intake 4	14	149522	1336880387	/users/cn/jespinosa/phecomp/data/CRG/20120502_FDF_CRG/20120502_FDF_CRG/20120511_FDF_CRG_c12.mtb	4038	1697	WWFF	food_fat	4	149508	1336880373	1	0.0600000000000005	0.00428571428571432	5876	1
2	Food 2	Intake 4	15	151234	1336882099	/users/cn/jespinosa/phecomp/data/CRG/20120502_FDF_CRG/20120502_FDF_CRG/20120511_FDF_CRG_c12.mtb	4048	463	WWFF	food_fat	4	151219	1336882084	1	0.0600000000000005	0.00400000000000003	5877	1
2	Food 2	Intake 4	22	151719	1336882584	/users/cn/jespinosa/phecomp/data/CRG/20120502_FDF_CRG/20120502_FDF_CRG/20120511_FDF_CRG_c12.mtb	4051	47	WWFF	food_fat	4	151697	1336882562	1	0.0399999999999991	0.00181818181818178	5878	1
2	Food 2	Intake 4	27	151793	1336882658	/users/cn/jespinosa/phecomp/data/CRG/20120502_FDF_CRG/20120502_FDF_CRG/20120511_FDF_CRG_c12.mtb	4052	215	WWFF	food_fat	4	151766	1336882631	1	0.0399999999999991	0.00148148148148145	5879	1
2	Food 2	Intake 4	13	152021	1336882886	/users/cn/jespinosa/phecomp/data/CRG/20120502_FDF_CRG/20120502_FDF_CRG/20120511_FDF_CRG_c12.mtb	4053	231	WWFF	food_fat	4	152008	1336882873	1	0.0200000000000014	0.00153846153846165	5880	1
2	Drink 2	Intake 2	16	152231	1336883096	/users/cn/jespinosa/phecomp/data/CRG/20120502_FDF_CRG/20120502_FDF_CRG/20120511_FDF_CRG_c12.mtb	1352	NA	WWFF	water	2	152215	1336883080	1	0.02	0.00125	5881	1
2	Food 1	Intake 3	28	152280	1336883145	/users/cn/jespinosa/phecomp/data/CRG/20120502_FDF_CRG/20120502_FDF_CRG/20120511_FDF_CRG_c12.mtb	2586	468	WWFF	food_fat	3	152252	1336883117	1	0.0800000000000001	0.00285714285714286	5882	1
2	Drink 1	Intake 1	17	152471	1336883336	/users/cn/jespinosa/phecomp/data/CRG/20120502_FDF_CRG/20120502_FDF_CRG/20120511_FDF_CRG_c12.mtb	891	NA	WWFF	water	1	152454	1336883319	1	0.04	0.00235294117647059	5883	1
2	Food 2	Intake 4	17	152765	1336883630	/users/cn/jespinosa/phecomp/data/CRG/20120502_FDF_CRG/20120502_FDF_CRG/20120511_FDF_CRG_c12.mtb	4058	90	WWFF	food_fat	4	152748	1336883613	1	0.0600000000000005	0.00352941176470591	5884	1
2	Food 1	Intake 3	48	152903	1336883768	/users/cn/jespinosa/phecomp/data/CRG/20120502_FDF_CRG/20120502_FDF_CRG/20120511_FDF_CRG_c12.mtb	2588	127	WWFF	food_fat	3	152855	1336883720	1	0.0999999999999979	0.00208333333333329	5885	1
2	Drink 2	Intake 2	21	152944	1336883809	/users/cn/jespinosa/phecomp/data/CRG/20120502_FDF_CRG/20120502_FDF_CRG/20120511_FDF_CRG_c12.mtb	1355	NA	WWFF	water	2	152923	1336883788	1	0.02	0.000952380952380952	5886	1
2	Drink 1	Intake 1	18	152955	1336883820	/users/cn/jespinosa/phecomp/data/CRG/20120502_FDF_CRG/20120502_FDF_CRG/20120511_FDF_CRG_c12.mtb	892	NA	WWFF	water	1	152937	1336883802	1	0.02	0.00111111111111111	5887	1
2	Food 2	Intake 4	308	153338	1336884203	/users/cn/jespinosa/phecomp/data/CRG/20120502_FDF_CRG/20120502_FDF_CRG/20120511_FDF_CRG_c12.mtb	4061	COLL	WWFF	food_fat	4	153030	1336883895	1	0.120000000000001	0.000389610389610393	5888	1
2	Food 1	Intake 3	48	153097	1336883962	/users/cn/jespinosa/phecomp/data/CRG/20120502_FDF_CRG/20120502_FDF_CRG/20120511_FDF_CRG_c12.mtb	2591	1780	WWFF	food_fat	3	153049	1336883914	1	0.180000000000003	0.00375000000000006	5889	1
2	Drink 1	Intake 1	28	153269	1336884134	/users/cn/jespinosa/phecomp/data/CRG/20120502_FDF_CRG/20120502_FDF_CRG/20120511_FDF_CRG_c12.mtb	893	NA	WWFF	water	1	153241	1336884106	1	0.04	0.00142857142857143	5890	1
2	Drink 2	Intake 2	25	154499	1336885364	/users/cn/jespinosa/phecomp/data/CRG/20120502_FDF_CRG/20120502_FDF_CRG/20120511_FDF_CRG_c12.mtb	1356	NA	WWFF	water	2	154474	1336885339	1	0.04	0.0016	5891	1
2	Food 2	Intake 4	612	155489	1336886354	/users/cn/jespinosa/phecomp/data/CRG/20120502_FDF_CRG/20120502_FDF_CRG/20120511_FDF_CRG_c12.mtb	4071	5	WWFF	food_fat	4	154877	1336885742	1	0.219999999999999	0.000359477124183005	5892	1
2	Food 2	Intake 4	15	155509	1336886374	/users/cn/jespinosa/phecomp/data/CRG/20120502_FDF_CRG/20120502_FDF_CRG/20120511_FDF_CRG_c12.mtb	4072	207	WWFF	food_fat	4	155494	1336886359	1	0.0600000000000005	0.00400000000000003	5893	1
2	Food 2	Intake 4	81	155797	1336886662	/users/cn/jespinosa/phecomp/data/CRG/20120502_FDF_CRG/20120502_FDF_CRG/20120511_FDF_CRG_c12.mtb	4074	204	WWFF	food_fat	4	155716	1336886581	1	0.0600000000000005	0.000740740740740747	5894	1
2	Food 2	Intake 4	302	156303	1336887168	/users/cn/jespinosa/phecomp/data/CRG/20120502_FDF_CRG/20120502_FDF_CRG/20120511_FDF_CRG_c12.mtb	4077	770	WWFF	food_fat	4	156001	1336886866	1	0.0600000000000005	0.000198675496688743	5895	1
2	Drink 1	Intake 1	30	156091	1336886956	/users/cn/jespinosa/phecomp/data/CRG/20120502_FDF_CRG/20120502_FDF_CRG/20120511_FDF_CRG_c12.mtb	895	NA	WWFF	water	1	156061	1336886926	1	0.04	0.00133333333333333	5896	1
2	Food 2	Intake 4	278	157351	1336888216	/users/cn/jespinosa/phecomp/data/CRG/20120502_FDF_CRG/20120502_FDF_CRG/20120511_FDF_CRG_c12.mtb	4079	606	WWFF	food_fat	4	157073	1336887938	1	0.0999999999999996	0.000359712230215826	5897	1
2	Food 2	Intake 4	19	157976	1336888841	/users/cn/jespinosa/phecomp/data/CRG/20120502_FDF_CRG/20120502_FDF_CRG/20120511_FDF_CRG_c12.mtb	4084	403	WWFF	food_fat	4	157957	1336888822	1	0.0200000000000014	0.00105263157894744	5898	1
2	Food 2	Intake 4	23	158402	1336889267	/users/cn/jespinosa/phecomp/data/CRG/20120502_FDF_CRG/20120502_FDF_CRG/20120511_FDF_CRG_c12.mtb	4090	101	WWFF	food_fat	4	158379	1336889244	1	0.0400000000000009	0.00173913043478265	5899	1
2	Food 2	Intake 4	62	158565	1336889430	/users/cn/jespinosa/phecomp/data/CRG/20120502_FDF_CRG/20120502_FDF_CRG/20120511_FDF_CRG_c12.mtb	4091	1571	WWFF	food_fat	4	158503	1336889368	1	0.119999999999999	0.00193548387096773	5900	1
2	Food 2	Intake 4	40	160176	1336891041	/users/cn/jespinosa/phecomp/data/CRG/20120502_FDF_CRG/20120502_FDF_CRG/20120511_FDF_CRG_c12.mtb	4094	562	WWFF	food_fat	4	160136	1336891001	1	0.0200000000000014	0.000500000000000035	5901	1
2	Food 2	Intake 4	44	160782	1336891647	/users/cn/jespinosa/phecomp/data/CRG/20120502_FDF_CRG/20120502_FDF_CRG/20120511_FDF_CRG_c12.mtb	4096	1077	WWFF	food_fat	4	160738	1336891603	1	0.0800000000000001	0.00181818181818182	5902	1
2	Drink 2	Intake 2	13	160974	1336891839	/users/cn/jespinosa/phecomp/data/CRG/20120502_FDF_CRG/20120502_FDF_CRG/20120511_FDF_CRG_c12.mtb	1361	NA	WWFF	water	2	160961	1336891826	1	0.0599999999999998	0.0046153846153846	5903	1
2	Food 2	Intake 4	28	161887	1336892752	/users/cn/jespinosa/phecomp/data/CRG/20120502_FDF_CRG/20120502_FDF_CRG/20120511_FDF_CRG_c12.mtb	4099	221	WWFF	food_fat	4	161859	1336892724	1	0.0800000000000001	0.00285714285714286	5904	1
2	Food 2	Intake 4	14	162122	1336892987	/users/cn/jespinosa/phecomp/data/CRG/20120502_FDF_CRG/20120502_FDF_CRG/20120511_FDF_CRG_c12.mtb	4103	27	WWFF	food_fat	4	162108	1336892973	1	0.0600000000000005	0.00428571428571432	5905	1
2	Food 2	Intake 4	68	162217	1336893082	/users/cn/jespinosa/phecomp/data/CRG/20120502_FDF_CRG/20120502_FDF_CRG/20120511_FDF_CRG_c12.mtb	4104	266	WWFF	food_fat	4	162149	1336893014	1	0.0600000000000005	0.000882352941176478	5906	1
2	Food 2	Intake 4	20	162503	1336893368	/users/cn/jespinosa/phecomp/data/CRG/20120502_FDF_CRG/20120502_FDF_CRG/20120511_FDF_CRG_c12.mtb	4106	1636	WWFF	food_fat	4	162483	1336893348	1	0.119999999999999	0.00599999999999995	5907	1
2	Food 2	Intake 4	9	164148	1336895013	/users/cn/jespinosa/phecomp/data/CRG/20120502_FDF_CRG/20120502_FDF_CRG/20120511_FDF_CRG_c12.mtb	4111	686	WWFF	food_fat	4	164139	1336895004	1	0.0399999999999991	0.00444444444444434	5908	1
2	Food 2	Intake 4	25	164859	1336895724	/users/cn/jespinosa/phecomp/data/CRG/20120502_FDF_CRG/20120502_FDF_CRG/20120511_FDF_CRG_c12.mtb	4115	4	WWFF	food_fat	4	164834	1336895699	1	0.0399999999999991	0.00159999999999996	5909	1
2	Food 2	Intake 4	13	164876	1336895741	/users/cn/jespinosa/phecomp/data/CRG/20120502_FDF_CRG/20120502_FDF_CRG/20120511_FDF_CRG_c12.mtb	4116	11	WWFF	food_fat	4	164863	1336895728	1	0.0600000000000005	0.00461538461538465	5910	1
2	Food 2	Intake 4	73	164960	1336895825	/users/cn/jespinosa/phecomp/data/CRG/20120502_FDF_CRG/20120502_FDF_CRG/20120511_FDF_CRG_c12.mtb	4117	607	WWFF	food_fat	4	164887	1336895752	1	0.219999999999999	0.00301369863013697	5911	1
2	Food 2	Intake 4	13	165580	1336896445	/users/cn/jespinosa/phecomp/data/CRG/20120502_FDF_CRG/20120502_FDF_CRG/20120511_FDF_CRG_c12.mtb	4119	537	WWFF	food_fat	4	165567	1336896432	1	0.0200000000000014	0.00153846153846165	5912	1
2	Food 1	Intake 3	49	166166	1336897031	/users/cn/jespinosa/phecomp/data/CRG/20120502_FDF_CRG/20120502_FDF_CRG/20120511_FDF_CRG_c12.mtb	2596	188	WWFF	food_fat	3	166117	1336896982	1	0.0799999999999983	0.00163265306122445	5913	1
2	Drink 1	Intake 1	34	166230	1336897095	/users/cn/jespinosa/phecomp/data/CRG/20120502_FDF_CRG/20120502_FDF_CRG/20120511_FDF_CRG_c12.mtb	897	NA	WWFF	water	1	166196	1336897061	1	0.12	0.00352941176470588	5914	1
2	Food 2	Intake 4	48	166402	1336897267	/users/cn/jespinosa/phecomp/data/CRG/20120502_FDF_CRG/20120502_FDF_CRG/20120511_FDF_CRG_c12.mtb	4124	1841	WWFF	food_fat	4	166354	1336897219	1	0.0400000000000009	0.000833333333333352	5915	1
2	Food 2	Intake 4	33	168276	1336899141	/users/cn/jespinosa/phecomp/data/CRG/20120502_FDF_CRG/20120502_FDF_CRG/20120511_FDF_CRG_c12.mtb	4130	20	WWFF	food_fat	4	168243	1336899108	1	0.0399999999999991	0.00121212121212118	5916	1
2	Food 2	Intake 4	46	168342	1336899207	/users/cn/jespinosa/phecomp/data/CRG/20120502_FDF_CRG/20120502_FDF_CRG/20120511_FDF_CRG_c12.mtb	4131	6	WWFF	food_fat	4	168296	1336899161	1	0.220000000000001	0.0047826086956522	5917	1
2	Food 2	Intake 4	48	168396	1336899261	/users/cn/jespinosa/phecomp/data/CRG/20120502_FDF_CRG/20120502_FDF_CRG/20120511_FDF_CRG_c12.mtb	4132	568	WWFF	food_fat	4	168348	1336899213	1	0.0400000000000009	0.000833333333333352	5918	1
2	Food 2	Intake 4	16	168980	1336899845	/users/cn/jespinosa/phecomp/data/CRG/20120502_FDF_CRG/20120502_FDF_CRG/20120511_FDF_CRG_c12.mtb	4135	1305	WWFF	food_fat	4	168964	1336899829	1	0.0799999999999983	0.00499999999999989	5919	1
2	Food 1	Intake 3	25	170310	1336901175	/users/cn/jespinosa/phecomp/data/CRG/20120502_FDF_CRG/20120502_FDF_CRG/20120511_FDF_CRG_c12.mtb	2597	17	WWFF	food_fat	3	170285	1336901150	1	0.0599999999999987	0.00239999999999995	5920	1
2	Food 2	Intake 4	32	170359	1336901224	/users/cn/jespinosa/phecomp/data/CRG/20120502_FDF_CRG/20120502_FDF_CRG/20120511_FDF_CRG_c12.mtb	4139	541	WWFF	food_fat	4	170327	1336901192	1	0.0800000000000001	0.0025	5921	1
2	Food 2	Intake 4	44	170944	1336901809	/users/cn/jespinosa/phecomp/data/CRG/20120502_FDF_CRG/20120502_FDF_CRG/20120511_FDF_CRG_c12.mtb	4143	117	WWFF	food_fat	4	170900	1336901765	1	0.16	0.00363636363636364	5922	1
2	Drink 2	Intake 2	35	170965	1336901830	/users/cn/jespinosa/phecomp/data/CRG/20120502_FDF_CRG/20120502_FDF_CRG/20120511_FDF_CRG_c12.mtb	1362	NA	WWFF	water	2	170930	1336901795	1	0.12	0.00342857142857143	5923	1
2	Food 2	Intake 4	18	171079	1336901944	/users/cn/jespinosa/phecomp/data/CRG/20120502_FDF_CRG/20120502_FDF_CRG/20120511_FDF_CRG_c12.mtb	4145	31	WWFF	food_fat	4	171061	1336901926	1	0.0400000000000009	0.00222222222222227	5924	1
2	Food 2	Intake 4	11	171121	1336901986	/users/cn/jespinosa/phecomp/data/CRG/20120502_FDF_CRG/20120502_FDF_CRG/20120511_FDF_CRG_c12.mtb	4146	306	WWFF	food_fat	4	171110	1336901975	1	0.0399999999999991	0.00363636363636355	5925	1
2	Food 2	Intake 4	14	171441	1336902306	/users/cn/jespinosa/phecomp/data/CRG/20120502_FDF_CRG/20120502_FDF_CRG/20120511_FDF_CRG_c12.mtb	4149	1229	WWFF	food_fat	4	171427	1336902292	1	0.0400000000000009	0.00285714285714292	5926	1
2	Food 2	Intake 4	25	172695	1336903560	/users/cn/jespinosa/phecomp/data/CRG/20120502_FDF_CRG/20120502_FDF_CRG/20120511_FDF_CRG_c12.mtb	4153	477	WWFF	food_fat	4	172670	1336903535	1	0.0800000000000001	0.0032	5927	1
2	Food 2	Intake 4	15	173187	1336904052	/users/cn/jespinosa/phecomp/data/CRG/20120502_FDF_CRG/20120502_FDF_CRG/20120511_FDF_CRG_c12.mtb	4156	248	WWFF	food_fat	4	173172	1336904037	1	0.0200000000000014	0.00133333333333343	5928	1
2	Food 1	Intake 3	19	173454	1336904319	/users/cn/jespinosa/phecomp/data/CRG/20120502_FDF_CRG/20120502_FDF_CRG/20120511_FDF_CRG_c12.mtb	2598	371	WWFF	food_fat	3	173435	1336904300	1	0.0600000000000023	0.00315789473684223	5929	1
2	Food 2	Intake 4	13	173838	1336904703	/users/cn/jespinosa/phecomp/data/CRG/20120502_FDF_CRG/20120502_FDF_CRG/20120511_FDF_CRG_c12.mtb	4159	1058	WWFF	food_fat	4	173825	1336904690	1	0.0599999999999987	0.00461538461538452	5930	1
2	Food 2	Intake 4	18	174914	1336905779	/users/cn/jespinosa/phecomp/data/CRG/20120502_FDF_CRG/20120502_FDF_CRG/20120511_FDF_CRG_c12.mtb	4165	778	WWFF	food_fat	4	174896	1336905761	1	0.0200000000000014	0.00111111111111119	5931	1
2	Food 2	Intake 4	31	175723	1336906588	/users/cn/jespinosa/phecomp/data/CRG/20120502_FDF_CRG/20120502_FDF_CRG/20120511_FDF_CRG_c12.mtb	4168	COLL	WWFF	food_fat	4	175692	1336906557	1	0.18	0.00580645161290323	5932	1
2	Food 1	Intake 3	14	175721	1336906586	/users/cn/jespinosa/phecomp/data/CRG/20120502_FDF_CRG/20120502_FDF_CRG/20120511_FDF_CRG_c12.mtb	2599	19	WWFF	food_fat	3	175707	1336906572	1	0.0399999999999991	0.00285714285714279	5933	1
2	Food 2	Intake 4	39	175779	1336906644	/users/cn/jespinosa/phecomp/data/CRG/20120502_FDF_CRG/20120502_FDF_CRG/20120511_FDF_CRG_c12.mtb	4169	30	WWFF	food_fat	4	175740	1336906605	1	0.0800000000000001	0.00205128205128205	5934	1
2	Food 2	Intake 4	25	175834	1336906699	/users/cn/jespinosa/phecomp/data/CRG/20120502_FDF_CRG/20120502_FDF_CRG/20120511_FDF_CRG_c12.mtb	4170	62	WWFF	food_fat	4	175809	1336906674	1	0.119999999999999	0.00479999999999996	5935	1
2	Food 2	Intake 4	33	175929	1336906794	/users/cn/jespinosa/phecomp/data/CRG/20120502_FDF_CRG/20120502_FDF_CRG/20120511_FDF_CRG_c12.mtb	4171	2493	WWFF	food_fat	4	175896	1336906761	1	0.0600000000000005	0.00181818181818183	5936	1
2	Drink 2	Intake 2	18	178031	1336908896	/users/cn/jespinosa/phecomp/data/CRG/20120502_FDF_CRG/20120502_FDF_CRG/20120511_FDF_CRG_c12.mtb	1363	NA	WWFF	water	2	178013	1336908878	1	0.0600000000000001	0.00333333333333334	5937	1
2	Food 2	Intake 4	173	178595	1336909460	/users/cn/jespinosa/phecomp/data/CRG/20120502_FDF_CRG/20120502_FDF_CRG/20120511_FDF_CRG_c12.mtb	4184	302	WWFF	food_fat	4	178422	1336909287	1	0.0600000000000005	0.000346820809248558	5938	1
2	Drink 2	Intake 2	12	178504	1336909369	/users/cn/jespinosa/phecomp/data/CRG/20120502_FDF_CRG/20120502_FDF_CRG/20120511_FDF_CRG_c12.mtb	1364	NA	WWFF	water	2	178492	1336909357	1	0.04	0.00333333333333333	5939	1
2	Drink 1	Intake 1	15	178748	1336909613	/users/cn/jespinosa/phecomp/data/CRG/20120502_FDF_CRG/20120502_FDF_CRG/20120511_FDF_CRG_c12.mtb	899	NA	WWFF	water	1	178733	1336909598	1	0.0399999999999996	0.00266666666666664	5940	1
2	Food 2	Intake 4	150	179047	1336909912	/users/cn/jespinosa/phecomp/data/CRG/20120502_FDF_CRG/20120502_FDF_CRG/20120511_FDF_CRG_c12.mtb	4186	65	WWFF	food_fat	4	178897	1336909762	1	0.0600000000000005	0.000400000000000003	5941	1
2	Food 2	Intake 4	91	179203	1336910068	/users/cn/jespinosa/phecomp/data/CRG/20120502_FDF_CRG/20120502_FDF_CRG/20120511_FDF_CRG_c12.mtb	4189	647	WWFF	food_fat	4	179112	1336909977	1	0.0400000000000009	0.000439560439560449	5942	1
2	Drink 2	Intake 2	27	179387	1336910252	/users/cn/jespinosa/phecomp/data/CRG/20120502_FDF_CRG/20120502_FDF_CRG/20120511_FDF_CRG_c12.mtb	1366	NA	WWFF	water	2	179360	1336910225	1	0.0800000000000001	0.00296296296296297	5943	1
2	Food 2	Intake 4	33	179883	1336910748	/users/cn/jespinosa/phecomp/data/CRG/20120502_FDF_CRG/20120502_FDF_CRG/20120511_FDF_CRG_c12.mtb	4193	667	WWFF	food_fat	4	179850	1336910715	1	0.0399999999999991	0.00121212121212118	5944	1
2	Food 2	Intake 4	20	180570	1336911435	/users/cn/jespinosa/phecomp/data/CRG/20120502_FDF_CRG/20120502_FDF_CRG/20120511_FDF_CRG_c12.mtb	4198	3810	WWFF	food_fat	4	180550	1336911415	1	0.0999999999999996	0.00499999999999998	5945	1
2	Food 2	Intake 4	12	184392	1336915257	/users/cn/jespinosa/phecomp/data/CRG/20120502_FDF_CRG/20120502_FDF_CRG/20120511_FDF_CRG_c12.mtb	4209	683	WWFF	food_fat	4	184380	1336915245	1	0.0200000000000014	0.00166666666666678	5946	1
2	Food 2	Intake 4	29	185104	1336915969	/users/cn/jespinosa/phecomp/data/CRG/20120502_FDF_CRG/20120502_FDF_CRG/20120511_FDF_CRG_c12.mtb	4212	1069	WWFF	food_fat	4	185075	1336915940	1	0.0600000000000005	0.0020689655172414	5947	1
2	Food 2	Intake 4	105	186278	1336917143	/users/cn/jespinosa/phecomp/data/CRG/20120502_FDF_CRG/20120502_FDF_CRG/20120511_FDF_CRG_c12.mtb	4214	COLL	WWFF	food_fat	4	186173	1336917038	1	0.139999999999999	0.00133333333333332	5948	1
2	Food 1	Intake 3	21	186255	1336917120	/users/cn/jespinosa/phecomp/data/CRG/20120502_FDF_CRG/20120502_FDF_CRG/20120511_FDF_CRG_c12.mtb	2602	6	WWFF	food_fat	3	186234	1336917099	1	0.0399999999999991	0.00190476190476186	5949	1
2	Food 1	Intake 3	17	186278	1336917143	/users/cn/jespinosa/phecomp/data/CRG/20120502_FDF_CRG/20120502_FDF_CRG/20120511_FDF_CRG_c12.mtb	2603	12	WWFF	food_fat	3	186261	1336917126	1	0.0400000000000027	0.00235294117647075	5950	1
2	Food 2	Intake 4	10	186300	1336917165	/users/cn/jespinosa/phecomp/data/CRG/20120502_FDF_CRG/20120502_FDF_CRG/20120511_FDF_CRG_c12.mtb	4215	43	WWFF	food_fat	4	186290	1336917155	1	0.0200000000000014	0.00200000000000014	5951	1
2	Food 2	Intake 4	27	186370	1336917235	/users/cn/jespinosa/phecomp/data/CRG/20120502_FDF_CRG/20120502_FDF_CRG/20120511_FDF_CRG_c12.mtb	4216	301	WWFF	food_fat	4	186343	1336917208	1	0.0800000000000001	0.00296296296296297	5952	1
2	Food 2	Intake 4	34	186705	1336917570	/users/cn/jespinosa/phecomp/data/CRG/20120502_FDF_CRG/20120502_FDF_CRG/20120511_FDF_CRG_c12.mtb	4219	161	WWFF	food_fat	4	186671	1336917536	1	0.0600000000000005	0.00176470588235296	5953	1
2	Food 2	Intake 4	17	186883	1336917748	/users/cn/jespinosa/phecomp/data/CRG/20120502_FDF_CRG/20120502_FDF_CRG/20120511_FDF_CRG_c12.mtb	4222	1353	WWFF	food_fat	4	186866	1336917731	1	0.0400000000000009	0.00235294117647064	5954	1
2	Food 2	Intake 4	18	188254	1336919119	/users/cn/jespinosa/phecomp/data/CRG/20120502_FDF_CRG/20120502_FDF_CRG/20120511_FDF_CRG_c12.mtb	4226	1280	WWFF	food_fat	4	188236	1336919101	1	0.120000000000001	0.00666666666666672	5955	1
2	Food 1	Intake 3	44	189578	1336920443	/users/cn/jespinosa/phecomp/data/CRG/20120502_FDF_CRG/20120502_FDF_CRG/20120511_FDF_CRG_c12.mtb	2604	128	WWFF	food_fat	3	189534	1336920399	1	0.119999999999997	0.00272727272727266	5956	1
2	Food 2	Intake 4	28	189734	1336920599	/users/cn/jespinosa/phecomp/data/CRG/20120502_FDF_CRG/20120502_FDF_CRG/20120511_FDF_CRG_c12.mtb	4230	1498	WWFF	food_fat	4	189706	1336920571	1	0.0400000000000009	0.00142857142857146	5957	1
2	Food 2	Intake 4	11	191243	1336922108	/users/cn/jespinosa/phecomp/data/CRG/20120502_FDF_CRG/20120502_FDF_CRG/20120511_FDF_CRG_c12.mtb	4238	369	WWFF	food_fat	4	191232	1336922097	1	0.0400000000000009	0.00363636363636372	5958	1
2	Food 2	Intake 4	16	191628	1336922493	/users/cn/jespinosa/phecomp/data/CRG/20120502_FDF_CRG/20120502_FDF_CRG/20120511_FDF_CRG_c12.mtb	4239	979	WWFF	food_fat	4	191612	1336922477	1	0.0399999999999991	0.00249999999999994	5959	1
2	Food 2	Intake 4	10	192617	1336923482	/users/cn/jespinosa/phecomp/data/CRG/20120502_FDF_CRG/20120502_FDF_CRG/20120511_FDF_CRG_c12.mtb	4244	347	WWFF	food_fat	4	192607	1336923472	1	0.0200000000000014	0.00200000000000014	5960	1
2	Food 2	Intake 4	25	192989	1336923854	/users/cn/jespinosa/phecomp/data/CRG/20120502_FDF_CRG/20120502_FDF_CRG/20120511_FDF_CRG_c12.mtb	4247	44	WWFF	food_fat	4	192964	1336923829	1	0.0600000000000005	0.00240000000000002	5961	1
2	Food 2	Intake 4	33	193066	1336923931	/users/cn/jespinosa/phecomp/data/CRG/20120502_FDF_CRG/20120502_FDF_CRG/20120511_FDF_CRG_c12.mtb	4249	108	WWFF	food_fat	4	193033	1336923898	1	0.220000000000001	0.0066666666666667	5962	1
2	Drink 2	Intake 2	25	193083	1336923948	/users/cn/jespinosa/phecomp/data/CRG/20120502_FDF_CRG/20120502_FDF_CRG/20120511_FDF_CRG_c12.mtb	1367	NA	WWFF	water	2	193058	1336923923	1	0.0599999999999998	0.00239999999999999	5963	1
2	Food 1	Intake 3	17	193191	1336924056	/users/cn/jespinosa/phecomp/data/CRG/20120502_FDF_CRG/20120502_FDF_CRG/20120511_FDF_CRG_c12.mtb	2607	443	WWFF	food_fat	3	193174	1336924039	1	0.0400000000000027	0.00235294117647075	5964	1
2	Drink 1	Intake 1	21	193219	1336924084	/users/cn/jespinosa/phecomp/data/CRG/20120502_FDF_CRG/20120502_FDF_CRG/20120511_FDF_CRG_c12.mtb	900	NA	WWFF	water	1	193198	1336924063	1	0.04	0.0019047619047619	5965	1
2	Drink 1	Intake 1	18	193396	1336924261	/users/cn/jespinosa/phecomp/data/CRG/20120502_FDF_CRG/20120502_FDF_CRG/20120511_FDF_CRG_c12.mtb	901	NA	WWFF	water	1	193378	1336924243	1	0.04	0.00222222222222222	5966	1
2	Food 2	Intake 4	43	193677	1336924542	/users/cn/jespinosa/phecomp/data/CRG/20120502_FDF_CRG/20120502_FDF_CRG/20120511_FDF_CRG_c12.mtb	4254	519	WWFF	food_fat	4	193634	1336924499	1	0.0799999999999983	0.00186046511627903	5967	1
2	Drink 1	Intake 1	13	193968	1336924833	/users/cn/jespinosa/phecomp/data/CRG/20120502_FDF_CRG/20120502_FDF_CRG/20120511_FDF_CRG_c12.mtb	902	NA	WWFF	water	1	193955	1336924820	1	0.0600000000000001	0.00461538461538462	5968	1
2	Food 2	Intake 4	20	194216	1336925081	/users/cn/jespinosa/phecomp/data/CRG/20120502_FDF_CRG/20120502_FDF_CRG/20120511_FDF_CRG_c12.mtb	4261	232	WWFF	food_fat	4	194196	1336925061	1	0.0400000000000009	0.00200000000000005	5969	1
2	Food 2	Intake 4	20	194468	1336925333	/users/cn/jespinosa/phecomp/data/CRG/20120502_FDF_CRG/20120502_FDF_CRG/20120511_FDF_CRG_c12.mtb	4263	2317	WWFF	food_fat	4	194448	1336925313	1	0.0399999999999991	0.00199999999999995	5970	1
2	Food 1	Intake 3	64	196849	1336927714	/users/cn/jespinosa/phecomp/data/CRG/20120502_FDF_CRG/20120502_FDF_CRG/20120511_FDF_CRG_c12.mtb	2609	22	WWFF	food_fat	3	196785	1336927650	1	0.0999999999999979	0.00156249999999997	5971	1
2	Food 2	Intake 4	49	196920	1336927785	/users/cn/jespinosa/phecomp/data/CRG/20120502_FDF_CRG/20120502_FDF_CRG/20120511_FDF_CRG_c12.mtb	4270	36	WWFF	food_fat	4	196871	1336927736	1	0.120000000000001	0.00244897959183675	5972	1
2	Food 2	Intake 4	25	196981	1336927846	/users/cn/jespinosa/phecomp/data/CRG/20120502_FDF_CRG/20120502_FDF_CRG/20120511_FDF_CRG_c12.mtb	4271	300	WWFF	food_fat	4	196956	1336927821	1	0.0399999999999991	0.00159999999999996	5973	1
2	Food 2	Intake 4	31	197312	1336928177	/users/cn/jespinosa/phecomp/data/CRG/20120502_FDF_CRG/20120502_FDF_CRG/20120511_FDF_CRG_c12.mtb	4272	651	WWFF	food_fat	4	197281	1336928146	1	0.0200000000000014	0.000645161290322626	5974	1
2	Food 1	Intake 3	35	197998	1336928863	/users/cn/jespinosa/phecomp/data/CRG/20120502_FDF_CRG/20120502_FDF_CRG/20120511_FDF_CRG_c12.mtb	2610	647	WWFF	food_fat	3	197963	1336928828	1	0.0400000000000027	0.00114285714285722	5975	1
2	Food 2	Intake 4	21	198666	1336929531	/users/cn/jespinosa/phecomp/data/CRG/20120502_FDF_CRG/20120502_FDF_CRG/20120511_FDF_CRG_c12.mtb	4277	344	WWFF	food_fat	4	198645	1336929510	1	0.119999999999999	0.00571428571428567	5976	1
2	Food 2	Intake 4	19	199029	1336929894	/users/cn/jespinosa/phecomp/data/CRG/20120502_FDF_CRG/20120502_FDF_CRG/20120511_FDF_CRG_c12.mtb	4280	544	WWFF	food_fat	4	199010	1336929875	1	0.0200000000000014	0.00105263157894744	5977	1
2	Food 2	Intake 4	43	199616	1336930481	/users/cn/jespinosa/phecomp/data/CRG/20120502_FDF_CRG/20120502_FDF_CRG/20120511_FDF_CRG_c12.mtb	4284	375	WWFF	food_fat	4	199573	1336930438	1	0.0399999999999991	0.000930232558139514	5978	1
2	Food 2	Intake 4	11	200002	1336930867	/users/cn/jespinosa/phecomp/data/CRG/20120502_FDF_CRG/20120502_FDF_CRG/20120511_FDF_CRG_c12.mtb	4289	82	WWFF	food_fat	4	199991	1336930856	1	0.0200000000000014	0.00181818181818195	5979	1
2	Food 2	Intake 4	54	200138	1336931003	/users/cn/jespinosa/phecomp/data/CRG/20120502_FDF_CRG/20120502_FDF_CRG/20120511_FDF_CRG_c12.mtb	4291	39	WWFF	food_fat	4	200084	1336930949	1	0.0799999999999983	0.00148148148148145	5980	1
2	Food 2	Intake 4	26	200203	1336931068	/users/cn/jespinosa/phecomp/data/CRG/20120502_FDF_CRG/20120502_FDF_CRG/20120511_FDF_CRG_c12.mtb	4292	135	WWFF	food_fat	4	200177	1336931042	1	0.0600000000000005	0.00230769230769233	5981	1
2	Food 2	Intake 4	10	200348	1336931213	/users/cn/jespinosa/phecomp/data/CRG/20120502_FDF_CRG/20120502_FDF_CRG/20120511_FDF_CRG_c12.mtb	4295	14	WWFF	food_fat	4	200338	1336931203	1	0.0399999999999991	0.00399999999999991	5982	1
2	Food 2	Intake 4	10	200372	1336931237	/users/cn/jespinosa/phecomp/data/CRG/20120502_FDF_CRG/20120502_FDF_CRG/20120511_FDF_CRG_c12.mtb	4296	257	WWFF	food_fat	4	200362	1336931227	1	0.0600000000000005	0.00600000000000005	5983	1
2	Food 2	Intake 4	28	200657	1336931522	/users/cn/jespinosa/phecomp/data/CRG/20120502_FDF_CRG/20120502_FDF_CRG/20120511_FDF_CRG_c12.mtb	4298	699	WWFF	food_fat	4	200629	1336931494	1	0.0800000000000001	0.00285714285714286	5984	1
2	Food 2	Intake 4	15	201371	1336932236	/users/cn/jespinosa/phecomp/data/CRG/20120502_FDF_CRG/20120502_FDF_CRG/20120511_FDF_CRG_c12.mtb	4301	582	WWFF	food_fat	4	201356	1336932221	1	0.0600000000000005	0.00400000000000003	5985	1
2	Food 2	Intake 4	20	201973	1336932838	/users/cn/jespinosa/phecomp/data/CRG/20120502_FDF_CRG/20120502_FDF_CRG/20120511_FDF_CRG_c12.mtb	4305	281	WWFF	food_fat	4	201953	1336932818	1	0.0400000000000009	0.00200000000000005	5986	1
2	Food 2	Intake 4	25	202279	1336933144	/users/cn/jespinosa/phecomp/data/CRG/20120502_FDF_CRG/20120502_FDF_CRG/20120511_FDF_CRG_c12.mtb	4308	173	WWFF	food_fat	4	202254	1336933119	1	0.0399999999999991	0.00159999999999996	5987	1
2	Food 2	Intake 4	55	202507	1336933372	/users/cn/jespinosa/phecomp/data/CRG/20120502_FDF_CRG/20120502_FDF_CRG/20120511_FDF_CRG_c12.mtb	4310	55	WWFF	food_fat	4	202452	1336933317	1	0.0600000000000005	0.0010909090909091	5988	1
2	Food 2	Intake 4	487	203049	1336933914	/users/cn/jespinosa/phecomp/data/CRG/20120502_FDF_CRG/20120502_FDF_CRG/20120511_FDF_CRG_c12.mtb	4311	441	WWFF	food_fat	4	202562	1336933427	1	0.140000000000001	0.000287474332648873	5989	1
2	Food 2	Intake 4	38	203528	1336934393	/users/cn/jespinosa/phecomp/data/CRG/20120502_FDF_CRG/20120502_FDF_CRG/20120511_FDF_CRG_c12.mtb	4316	4	WWFF	food_fat	4	203490	1336934355	1	0.120000000000001	0.00315789473684213	5990	1
2	Food 2	Intake 4	59	203591	1336934456	/users/cn/jespinosa/phecomp/data/CRG/20120502_FDF_CRG/20120502_FDF_CRG/20120511_FDF_CRG_c12.mtb	4317	5	WWFF	food_fat	4	203532	1336934397	1	0.0599999999999987	0.00101694915254235	5991	1
2	Food 2	Intake 4	279	203875	1336934740	/users/cn/jespinosa/phecomp/data/CRG/20120502_FDF_CRG/20120502_FDF_CRG/20120511_FDF_CRG_c12.mtb	4318	173	WWFF	food_fat	4	203596	1336934461	1	0.100000000000001	0.000358422939068104	5992	1
2	Food 2	Intake 4	51	204099	1336934964	/users/cn/jespinosa/phecomp/data/CRG/20120502_FDF_CRG/20120502_FDF_CRG/20120511_FDF_CRG_c12.mtb	4320	133	WWFF	food_fat	4	204048	1336934913	1	0.0999999999999996	0.00196078431372548	5993	1
2	Food 2	Intake 4	26	204258	1336935123	/users/cn/jespinosa/phecomp/data/CRG/20120502_FDF_CRG/20120502_FDF_CRG/20120511_FDF_CRG_c12.mtb	4323	75	WWFF	food_fat	4	204232	1336935097	1	0.0600000000000005	0.00230769230769233	5994	1
2	Food 2	Intake 4	25	204358	1336935223	/users/cn/jespinosa/phecomp/data/CRG/20120502_FDF_CRG/20120502_FDF_CRG/20120511_FDF_CRG_c12.mtb	4324	366	WWFF	food_fat	4	204333	1336935198	1	0.0800000000000001	0.0032	5995	1
2	Drink 2	Intake 2	26	204455	1336935320	/users/cn/jespinosa/phecomp/data/CRG/20120502_FDF_CRG/20120502_FDF_CRG/20120511_FDF_CRG_c12.mtb	1374	NA	WWFF	water	2	204429	1336935294	1	0.02	0.000769230769230769	5996	1
2	Food 2	Intake 4	19	204743	1336935608	/users/cn/jespinosa/phecomp/data/CRG/20120502_FDF_CRG/20120502_FDF_CRG/20120511_FDF_CRG_c12.mtb	4327	83	WWFF	food_fat	4	204724	1336935589	1	0.0400000000000009	0.00210526315789478	5997	1
2	Food 2	Intake 4	70	204896	1336935761	/users/cn/jespinosa/phecomp/data/CRG/20120502_FDF_CRG/20120502_FDF_CRG/20120511_FDF_CRG_c12.mtb	4328	466	WWFF	food_fat	4	204826	1336935691	1	0.0599999999999987	0.000857142857142839	5998	1
2	Food 2	Intake 4	13	205375	1336936240	/users/cn/jespinosa/phecomp/data/CRG/20120502_FDF_CRG/20120502_FDF_CRG/20120511_FDF_CRG_c12.mtb	4334	78	WWFF	food_fat	4	205362	1336936227	1	0.0400000000000009	0.00307692307692315	5999	1
2	Food 2	Intake 4	22	205475	1336936340	/users/cn/jespinosa/phecomp/data/CRG/20120502_FDF_CRG/20120502_FDF_CRG/20120511_FDF_CRG_c12.mtb	4335	481	WWFF	food_fat	4	205453	1336936318	1	0.0399999999999991	0.00181818181818178	6000	1
2	Food 2	Intake 4	127	206083	1336936948	/users/cn/jespinosa/phecomp/data/CRG/20120502_FDF_CRG/20120502_FDF_CRG/20120511_FDF_CRG_c12.mtb	4341	161	WWFF	food_fat	4	205956	1336936821	1	0.0399999999999991	0.000314960629921253	6001	1
2	Food 2	Intake 4	25	206269	1336937134	/users/cn/jespinosa/phecomp/data/CRG/20120502_FDF_CRG/20120502_FDF_CRG/20120511_FDF_CRG_c12.mtb	4342	2054	WWFF	food_fat	4	206244	1336937109	1	0.100000000000001	0.00400000000000004	6002	1
2	Food 2	Intake 4	10	208333	1336939198	/users/cn/jespinosa/phecomp/data/CRG/20120502_FDF_CRG/20120502_FDF_CRG/20120511_FDF_CRG_c12.mtb	4353	92	WWFF	food_fat	4	208323	1336939188	1	0.0400000000000009	0.00400000000000009	6003	1
2	Food 2	Intake 4	13	208438	1336939303	/users/cn/jespinosa/phecomp/data/CRG/20120502_FDF_CRG/20120502_FDF_CRG/20120511_FDF_CRG_c12.mtb	4355	173	WWFF	food_fat	4	208425	1336939290	1	0.0600000000000005	0.00461538461538465	6004	1
2	Food 2	Intake 4	24	208635	1336939500	/users/cn/jespinosa/phecomp/data/CRG/20120502_FDF_CRG/20120502_FDF_CRG/20120511_FDF_CRG_c12.mtb	4357	1361	WWFF	food_fat	4	208611	1336939476	1	0.120000000000001	0.00500000000000004	6005	1
2	Drink 1	Intake 1	14	209504	1336940369	/users/cn/jespinosa/phecomp/data/CRG/20120502_FDF_CRG/20120502_FDF_CRG/20120511_FDF_CRG_c12.mtb	906	NA	WWFF	water	1	209490	1336940355	1	0.0600000000000001	0.00428571428571429	6006	1
2	Food 2	Intake 4	34	210030	1336940895	/users/cn/jespinosa/phecomp/data/CRG/20120502_FDF_CRG/20120502_FDF_CRG/20120511_FDF_CRG_c12.mtb	4359	284	WWFF	food_fat	4	209996	1336940861	1	0.0200000000000014	0.000588235294117688	6007	1
2	Food 2	Intake 4	85	210399	1336941264	/users/cn/jespinosa/phecomp/data/CRG/20120502_FDF_CRG/20120502_FDF_CRG/20120511_FDF_CRG_c12.mtb	4361	75	WWFF	food_fat	4	210314	1336941179	1	0.0600000000000005	0.000705882352941182	6008	1
2	Food 2	Intake 4	15	210489	1336941354	/users/cn/jespinosa/phecomp/data/CRG/20120502_FDF_CRG/20120502_FDF_CRG/20120511_FDF_CRG_c12.mtb	4362	104	WWFF	food_fat	4	210474	1336941339	1	0.0400000000000009	0.00266666666666673	6009	1
2	Food 2	Intake 4	168	210761	1336941626	/users/cn/jespinosa/phecomp/data/CRG/20120502_FDF_CRG/20120502_FDF_CRG/20120511_FDF_CRG_c12.mtb	4364	189	WWFF	food_fat	4	210593	1336941458	1	0.260000000000002	0.00154761904761906	6010	1
2	Food 2	Intake 4	200	211150	1336942015	/users/cn/jespinosa/phecomp/data/CRG/20120502_FDF_CRG/20120502_FDF_CRG/20120511_FDF_CRG_c12.mtb	4366	154	WWFF	food_fat	4	210950	1336941815	1	0.120000000000001	0.000600000000000005	6011	1
2	Food 2	Intake 4	93	211397	1336942262	/users/cn/jespinosa/phecomp/data/CRG/20120502_FDF_CRG/20120502_FDF_CRG/20120511_FDF_CRG_c12.mtb	4369	5	WWFF	food_fat	4	211304	1336942169	1	0.0600000000000005	0.000645161290322586	6012	1
2	Food 2	Intake 4	383	211785	1336942650	/users/cn/jespinosa/phecomp/data/CRG/20120502_FDF_CRG/20120502_FDF_CRG/20120511_FDF_CRG_c12.mtb	4370	982	WWFF	food_fat	4	211402	1336942267	1	0.220000000000001	0.000574412532637078	6013	1
2	Drink 1	Intake 1	27	211727	1336942592	/users/cn/jespinosa/phecomp/data/CRG/20120502_FDF_CRG/20120502_FDF_CRG/20120511_FDF_CRG_c12.mtb	908	NA	WWFF	water	1	211700	1336942565	1	0.1	0.0037037037037037	6014	1
2	Drink 2	Intake 2	54	212159	1336943024	/users/cn/jespinosa/phecomp/data/CRG/20120502_FDF_CRG/20120502_FDF_CRG/20120511_FDF_CRG_c12.mtb	1378	NA	WWFF	water	2	212105	1336942970	1	0.02	0.00037037037037037	6015	1
2	Food 2	Intake 4	23	212790	1336943655	/users/cn/jespinosa/phecomp/data/CRG/20120502_FDF_CRG/20120502_FDF_CRG/20120511_FDF_CRG_c12.mtb	4373	6	WWFF	food_fat	4	212767	1336943632	1	0.0399999999999991	0.00173913043478257	6016	1
2	Food 2	Intake 4	318	213114	1336943979	/users/cn/jespinosa/phecomp/data/CRG/20120502_FDF_CRG/20120502_FDF_CRG/20120511_FDF_CRG_c12.mtb	4374	158	WWFF	food_fat	4	212796	1336943661	1	0.0600000000000005	0.00018867924528302	6017	1
2	Food 2	Intake 4	233	213505	1336944370	/users/cn/jespinosa/phecomp/data/CRG/20120502_FDF_CRG/20120502_FDF_CRG/20120511_FDF_CRG_c12.mtb	4379	96	WWFF	food_fat	4	213272	1336944137	1	0.0800000000000001	0.000343347639484979	6018	1
2	Food 2	Intake 4	77	213678	1336944543	/users/cn/jespinosa/phecomp/data/CRG/20120502_FDF_CRG/20120502_FDF_CRG/20120511_FDF_CRG_c12.mtb	4381	620	WWFF	food_fat	4	213601	1336944466	1	0.119999999999999	0.00155844155844155	6019	1
2	Food 2	Intake 4	316	214614	1336945479	/users/cn/jespinosa/phecomp/data/CRG/20120502_FDF_CRG/20120502_FDF_CRG/20120511_FDF_CRG_c12.mtb	4385	12	WWFF	food_fat	4	214298	1336945163	1	0.0200000000000014	6.32911392405108e-05	6020	1
2	Drink 1	Intake 1	25	214338	1336945203	/users/cn/jespinosa/phecomp/data/CRG/20120502_FDF_CRG/20120502_FDF_CRG/20120511_FDF_CRG_c12.mtb	913	NA	WWFF	water	1	214313	1336945178	1	0.02	0.0008	6021	1
2	Food 2	Intake 4	557	215183	1336946048	/users/cn/jespinosa/phecomp/data/CRG/20120502_FDF_CRG/20120502_FDF_CRG/20120511_FDF_CRG_c12.mtb	4386	24	WWFF	food_fat	4	214626	1336945491	1	0.0399999999999991	7.18132854578081e-05	6022	1
2	Food 2	Intake 4	45	215252	1336946117	/users/cn/jespinosa/phecomp/data/CRG/20120502_FDF_CRG/20120502_FDF_CRG/20120511_FDF_CRG_c12.mtb	4387	705	WWFF	food_fat	4	215207	1336946072	1	0.0999999999999996	0.00222222222222221	6023	1
2	Drink 1	Intake 1	30	215974	1336946839	/users/cn/jespinosa/phecomp/data/CRG/20120502_FDF_CRG/20120502_FDF_CRG/20120511_FDF_CRG_c12.mtb	914	NA	WWFF	water	1	215944	1336946809	1	0.04	0.00133333333333333	6024	1
2	Food 2	Intake 4	288	216245	1336947110	/users/cn/jespinosa/phecomp/data/CRG/20120502_FDF_CRG/20120502_FDF_CRG/20120511_FDF_CRG_c12.mtb	4390	92	WWFF	food_fat	4	215957	1336946822	1	0.0800000000000001	0.000277777777777778	6025	1
2	Drink 2	Intake 2	21	216032	1336946897	/users/cn/jespinosa/phecomp/data/CRG/20120502_FDF_CRG/20120502_FDF_CRG/20120511_FDF_CRG_c12.mtb	1384	NA	WWFF	water	2	216011	1336946876	1	0.02	0.000952380952380952	6026	1
2	Food 2	Intake 4	140	216477	1336947342	/users/cn/jespinosa/phecomp/data/CRG/20120502_FDF_CRG/20120502_FDF_CRG/20120511_FDF_CRG_c12.mtb	4392	738	WWFF	food_fat	4	216337	1336947202	1	0.200000000000001	0.00142857142857144	6027	1
2	Food 2	Intake 4	30	217245	1336948110	/users/cn/jespinosa/phecomp/data/CRG/20120502_FDF_CRG/20120502_FDF_CRG/20120511_FDF_CRG_c12.mtb	4395	141	WWFF	food_fat	4	217215	1336948080	1	0.0400000000000009	0.00133333333333336	6028	1
2	Food 2	Intake 4	379	217765	1336948630	/users/cn/jespinosa/phecomp/data/CRG/20120502_FDF_CRG/20120502_FDF_CRG/20120511_FDF_CRG_c12.mtb	4398	566	WWFF	food_fat	4	217386	1336948251	1	0.119999999999999	0.000316622691292873	6029	1
2	Drink 1	Intake 1	17	217482	1336948347	/users/cn/jespinosa/phecomp/data/CRG/20120502_FDF_CRG/20120502_FDF_CRG/20120511_FDF_CRG_c12.mtb	916	NA	WWFF	water	1	217465	1336948330	1	0.02	0.00117647058823529	6030	1
2	Drink 2	Intake 2	17	218093	1336948958	/users/cn/jespinosa/phecomp/data/CRG/20120502_FDF_CRG/20120502_FDF_CRG/20120511_FDF_CRG_c12.mtb	1386	NA	WWFF	water	2	218076	1336948941	1	0.02	0.00117647058823529	6031	1
2	Drink 1	Intake 1	8	218105	1336948970	/users/cn/jespinosa/phecomp/data/CRG/20120502_FDF_CRG/20120502_FDF_CRG/20120511_FDF_CRG_c12.mtb	917	NA	WWFF	water	1	218097	1336948962	1	0.02	0.0025	6032	1
2	Food 2	Intake 4	387	218718	1336949583	/users/cn/jespinosa/phecomp/data/CRG/20120502_FDF_CRG/20120502_FDF_CRG/20120511_FDF_CRG_c12.mtb	4401	14	WWFF	food_fat	4	218331	1336949196	1	0.0800000000000001	0.00020671834625323	6033	1
2	Food 2	Intake 4	133	218865	1336949730	/users/cn/jespinosa/phecomp/data/CRG/20120502_FDF_CRG/20120502_FDF_CRG/20120511_FDF_CRG_c12.mtb	4402	4	WWFF	food_fat	4	218732	1336949597	1	0.0999999999999996	0.000751879699248117	6034	1
2	Food 2	Intake 4	58	218927	1336949792	/users/cn/jespinosa/phecomp/data/CRG/20120502_FDF_CRG/20120502_FDF_CRG/20120511_FDF_CRG_c12.mtb	4403	5	WWFF	food_fat	4	218869	1336949734	1	0.0399999999999991	0.000689655172413778	6035	1
2	Food 2	Intake 4	746	219678	1336950543	/users/cn/jespinosa/phecomp/data/CRG/20120502_FDF_CRG/20120502_FDF_CRG/20120511_FDF_CRG_c12.mtb	4404	427	WWFF	food_fat	4	218932	1336949797	1	0.0200000000000014	2.68096514745327e-05	6036	1
2	Food 2	Intake 4	33	220138	1336951003	/users/cn/jespinosa/phecomp/data/CRG/20120502_FDF_CRG/20120502_FDF_CRG/20120511_FDF_CRG_c12.mtb	4407	439	WWFF	food_fat	4	220105	1336950970	1	0.0400000000000009	0.00121212121212124	6037	1
2	Food 2	Intake 4	422	220999	1336951864	/users/cn/jespinosa/phecomp/data/CRG/20120502_FDF_CRG/20120502_FDF_CRG/20120511_FDF_CRG_c12.mtb	4412	440	WWFF	food_fat	4	220577	1336951442	1	0.0400000000000009	9.4786729857822e-05	6038	1
2	Food 2	Intake 4	20	221459	1336952324	/users/cn/jespinosa/phecomp/data/CRG/20120502_FDF_CRG/20120502_FDF_CRG/20120511_FDF_CRG_c12.mtb	4417	6	WWFF	food_fat	4	221439	1336952304	1	0.0800000000000001	0.00400000000000001	6039	1
2	Food 2	Intake 4	26	221491	1336952356	/users/cn/jespinosa/phecomp/data/CRG/20120502_FDF_CRG/20120502_FDF_CRG/20120511_FDF_CRG_c12.mtb	4418	1180	WWFF	food_fat	4	221465	1336952330	1	0.0999999999999996	0.00384615384615383	6040	1
2	Food 2	Intake 4	45	222716	1336953581	/users/cn/jespinosa/phecomp/data/CRG/20120502_FDF_CRG/20120502_FDF_CRG/20120511_FDF_CRG_c12.mtb	4422	423	WWFF	food_fat	4	222671	1336953536	1	0.0599999999999987	0.0013333333333333	6041	1
2	Food 2	Intake 4	8	223147	1336954012	/users/cn/jespinosa/phecomp/data/CRG/20120502_FDF_CRG/20120502_FDF_CRG/20120511_FDF_CRG_c12.mtb	4423	1000	WWFF	food_fat	4	223139	1336954004	1	0.0200000000000014	0.00250000000000017	6042	1
2	Drink 2	Intake 2	19	223826	1336954691	/users/cn/jespinosa/phecomp/data/CRG/20120502_FDF_CRG/20120502_FDF_CRG/20120511_FDF_CRG_c12.mtb	1391	NA	WWFF	water	2	223807	1336954672	1	0.0599999999999998	0.00315789473684209	6043	1
2	Food 2	Intake 4	32	224179	1336955044	/users/cn/jespinosa/phecomp/data/CRG/20120502_FDF_CRG/20120502_FDF_CRG/20120511_FDF_CRG_c12.mtb	4428	331	WWFF	food_fat	4	224147	1336955012	1	0.0400000000000009	0.00125000000000003	6044	1
2	Food 2	Intake 4	63	224573	1336955438	/users/cn/jespinosa/phecomp/data/CRG/20120502_FDF_CRG/20120502_FDF_CRG/20120511_FDF_CRG_c12.mtb	4431	7	WWFF	food_fat	4	224510	1336955375	1	0.0600000000000005	0.00095238095238096	6045	1
2	Food 2	Intake 4	331	224911	1336955776	/users/cn/jespinosa/phecomp/data/CRG/20120502_FDF_CRG/20120502_FDF_CRG/20120511_FDF_CRG_c12.mtb	4432	225	WWFF	food_fat	4	224580	1336955445	1	0.139999999999999	0.000422960725075526	6046	1
2	Drink 2	Intake 2	15	224675	1336955540	/users/cn/jespinosa/phecomp/data/CRG/20120502_FDF_CRG/20120502_FDF_CRG/20120511_FDF_CRG_c12.mtb	1393	NA	WWFF	water	2	224660	1336955525	1	0.04	0.00266666666666667	6047	1
2	Drink 1	Intake 1	61	224894	1336955759	/users/cn/jespinosa/phecomp/data/CRG/20120502_FDF_CRG/20120502_FDF_CRG/20120511_FDF_CRG_c12.mtb	921	NA	WWFF	water	1	224833	1336955698	1	0.0599999999999996	0.000983606557377043	6048	1
2	Food 2	Intake 4	463	225599	1336956464	/users/cn/jespinosa/phecomp/data/CRG/20120502_FDF_CRG/20120502_FDF_CRG/20120511_FDF_CRG_c12.mtb	4435	12	WWFF	food_fat	4	225136	1336956001	1	0.120000000000001	0.000259179265658749	6049	1
2	Food 2	Intake 4	252	225863	1336956728	/users/cn/jespinosa/phecomp/data/CRG/20120502_FDF_CRG/20120502_FDF_CRG/20120511_FDF_CRG_c12.mtb	4436	10	WWFF	food_fat	4	225611	1336956476	1	0.0399999999999991	0.000158730158730155	6050	1
2	Food 2	Intake 4	30	225903	1336956768	/users/cn/jespinosa/phecomp/data/CRG/20120502_FDF_CRG/20120502_FDF_CRG/20120511_FDF_CRG_c12.mtb	4437	407	WWFF	food_fat	4	225873	1336956738	1	0.0400000000000009	0.00133333333333336	6051	1
2	Food 2	Intake 4	75	226385	1336957250	/users/cn/jespinosa/phecomp/data/CRG/20120502_FDF_CRG/20120502_FDF_CRG/20120511_FDF_CRG_c12.mtb	4441	523	WWFF	food_fat	4	226310	1336957175	1	0.0400000000000009	0.000533333333333345	6052	1
2	Food 2	Intake 4	14	226922	1336957787	/users/cn/jespinosa/phecomp/data/CRG/20120502_FDF_CRG/20120502_FDF_CRG/20120511_FDF_CRG_c12.mtb	4443	356	WWFF	food_fat	4	226908	1336957773	1	0.0400000000000009	0.00285714285714292	6053	1
2	Drink 2	Intake 2	23	227217	1336958082	/users/cn/jespinosa/phecomp/data/CRG/20120502_FDF_CRG/20120502_FDF_CRG/20120511_FDF_CRG_c12.mtb	1395	NA	WWFF	water	2	227194	1336958059	1	0.02	0.000869565217391304	6054	1
2	Food 2	Intake 4	14	227292	1336958157	/users/cn/jespinosa/phecomp/data/CRG/20120502_FDF_CRG/20120502_FDF_CRG/20120511_FDF_CRG_c12.mtb	4446	853	WWFF	food_fat	4	227278	1336958143	1	0.0600000000000005	0.00428571428571432	6055	1
2	Food 2	Intake 4	14	228159	1336959024	/users/cn/jespinosa/phecomp/data/CRG/20120502_FDF_CRG/20120502_FDF_CRG/20120511_FDF_CRG_c12.mtb	4456	1128	WWFF	food_fat	4	228145	1336959010	1	0.0800000000000001	0.00571428571428572	6056	1
2	Food 2	Intake 4	69	229356	1336960221	/users/cn/jespinosa/phecomp/data/CRG/20120502_FDF_CRG/20120502_FDF_CRG/20120511_FDF_CRG_c12.mtb	4459	44	WWFF	food_fat	4	229287	1336960152	1	0.119999999999999	0.00173913043478259	6057	1
2	Food 2	Intake 4	31	229431	1336960296	/users/cn/jespinosa/phecomp/data/CRG/20120502_FDF_CRG/20120502_FDF_CRG/20120511_FDF_CRG_c12.mtb	4461	296	WWFF	food_fat	4	229400	1336960265	1	0.0400000000000009	0.00129032258064519	6058	1
2	Food 2	Intake 4	20	229747	1336960612	/users/cn/jespinosa/phecomp/data/CRG/20120502_FDF_CRG/20120502_FDF_CRG/20120511_FDF_CRG_c12.mtb	4464	58	WWFF	food_fat	4	229727	1336960592	1	0.0399999999999991	0.00199999999999995	6059	1
2	Food 2	Intake 4	25	229830	1336960695	/users/cn/jespinosa/phecomp/data/CRG/20120502_FDF_CRG/20120502_FDF_CRG/20120511_FDF_CRG_c12.mtb	4465	320	WWFF	food_fat	4	229805	1336960670	1	0.0800000000000001	0.0032	6060	1
2	Food 2	Intake 4	34	230184	1336961049	/users/cn/jespinosa/phecomp/data/CRG/20120502_FDF_CRG/20120502_FDF_CRG/20120511_FDF_CRG_c12.mtb	4466	591	WWFF	food_fat	4	230150	1336961015	1	0.0200000000000014	0.000588235294117688	6061	1
2	Food 2	Intake 4	29	230804	1336961669	/users/cn/jespinosa/phecomp/data/CRG/20120502_FDF_CRG/20120502_FDF_CRG/20120511_FDF_CRG_c12.mtb	4468	45	WWFF	food_fat	4	230775	1336961640	1	0.0800000000000001	0.00275862068965518	6062	1
2	Food 2	Intake 4	12	230861	1336961726	/users/cn/jespinosa/phecomp/data/CRG/20120502_FDF_CRG/20120502_FDF_CRG/20120511_FDF_CRG_c12.mtb	4470	274	WWFF	food_fat	4	230849	1336961714	1	0.0600000000000005	0.00500000000000004	6063	1
2	Food 2	Intake 4	16	231151	1336962016	/users/cn/jespinosa/phecomp/data/CRG/20120502_FDF_CRG/20120502_FDF_CRG/20120511_FDF_CRG_c12.mtb	4472	544	WWFF	food_fat	4	231135	1336962000	1	0.0200000000000014	0.00125000000000009	6064	1
2	Drink 1	Intake 1	18	231312	1336962177	/users/cn/jespinosa/phecomp/data/CRG/20120502_FDF_CRG/20120502_FDF_CRG/20120511_FDF_CRG_c12.mtb	923	NA	WWFF	water	1	231294	1336962159	1	0.0200000000000005	0.00111111111111114	6065	1
2	Food 2	Intake 4	14	231709	1336962574	/users/cn/jespinosa/phecomp/data/CRG/20120502_FDF_CRG/20120502_FDF_CRG/20120511_FDF_CRG_c12.mtb	4477	99	WWFF	food_fat	4	231695	1336962560	1	0.0399999999999991	0.00285714285714279	6066	1
2	Food 2	Intake 4	31	231839	1336962704	/users/cn/jespinosa/phecomp/data/CRG/20120502_FDF_CRG/20120502_FDF_CRG/20120511_FDF_CRG_c12.mtb	4478	1838	WWFF	food_fat	4	231808	1336962673	1	0.0400000000000009	0.00129032258064519	6067	1
2	Drink 1	Intake 1	13	233350	1336964215	/users/cn/jespinosa/phecomp/data/CRG/20120502_FDF_CRG/20120502_FDF_CRG/20120511_FDF_CRG_c12.mtb	924	NA	WWFF	water	1	233337	1336964202	1	0.0799999999999996	0.00615384615384612	6068	1
2	Food 2	Intake 4	28	233705	1336964570	/users/cn/jespinosa/phecomp/data/CRG/20120502_FDF_CRG/20120502_FDF_CRG/20120511_FDF_CRG_c12.mtb	4487	16	WWFF	food_fat	4	233677	1336964542	1	0.0800000000000001	0.00285714285714286	6069	1
2	Food 2	Intake 4	12	233733	1336964598	/users/cn/jespinosa/phecomp/data/CRG/20120502_FDF_CRG/20120502_FDF_CRG/20120511_FDF_CRG_c12.mtb	4488	23	WWFF	food_fat	4	233721	1336964586	1	0.0599999999999987	0.00499999999999989	6070	1
2	Food 2	Intake 4	163	233919	1336964784	/users/cn/jespinosa/phecomp/data/CRG/20120502_FDF_CRG/20120502_FDF_CRG/20120511_FDF_CRG_c12.mtb	4489	53	WWFF	food_fat	4	233756	1336964621	1	1.34	0.00822085889570552	6071	1
2	Food 2	Intake 4	73	234045	1336964910	/users/cn/jespinosa/phecomp/data/CRG/20120502_FDF_CRG/20120502_FDF_CRG/20120511_FDF_CRG_c12.mtb	4490	667	WWFF	food_fat	4	233972	1336964837	1	0.0600000000000005	0.000821917808219185	6072	1
2	Drink 1	Intake 1	31	234090	1336964955	/users/cn/jespinosa/phecomp/data/CRG/20120502_FDF_CRG/20120502_FDF_CRG/20120511_FDF_CRG_c12.mtb	927	NA	WWFF	water	1	234059	1336964924	1	0.0800000000000001	0.00258064516129033	6073	1
2	Food 2	Intake 4	10	234722	1336965587	/users/cn/jespinosa/phecomp/data/CRG/20120502_FDF_CRG/20120502_FDF_CRG/20120511_FDF_CRG_c12.mtb	4493	662	WWFF	food_fat	4	234712	1336965577	1	0.0399999999999991	0.00399999999999991	6074	1
2	Food 2	Intake 4	9	235393	1336966258	/users/cn/jespinosa/phecomp/data/CRG/20120502_FDF_CRG/20120502_FDF_CRG/20120511_FDF_CRG_c12.mtb	4497	1748	WWFF	food_fat	4	235384	1336966249	1	0.0400000000000009	0.00444444444444455	6075	1
2	Food 2	Intake 4	18	237159	1336968024	/users/cn/jespinosa/phecomp/data/CRG/20120502_FDF_CRG/20120502_FDF_CRG/20120511_FDF_CRG_c12.mtb	4502	3546	WWFF	food_fat	4	237141	1336968006	1	0.0200000000000014	0.00111111111111119	6076	1
2	Drink 1	Intake 1	18	238949	1336969814	/users/cn/jespinosa/phecomp/data/CRG/20120502_FDF_CRG/20120502_FDF_CRG/20120511_FDF_CRG_c12.mtb	928	NA	WWFF	water	1	238931	1336969796	1	0.02	0.00111111111111111	6077	1
2	Drink 1	Intake 1	14	239604	1336970469	/users/cn/jespinosa/phecomp/data/CRG/20120502_FDF_CRG/20120502_FDF_CRG/20120511_FDF_CRG_c12.mtb	929	NA	WWFF	water	1	239590	1336970455	1	0.0600000000000001	0.00428571428571429	6078	1
2	Food 2	Intake 4	14	240719	1336971584	/users/cn/jespinosa/phecomp/data/CRG/20120502_FDF_CRG/20120502_FDF_CRG/20120511_FDF_CRG_c12.mtb	4515	72	WWFF	food_fat	4	240705	1336971570	1	0.0399999999999991	0.00285714285714279	6079	1
2	Food 2	Intake 4	31	240822	1336971687	/users/cn/jespinosa/phecomp/data/CRG/20120502_FDF_CRG/20120502_FDF_CRG/20120511_FDF_CRG_c12.mtb	4517	90	WWFF	food_fat	4	240791	1336971656	1	0.0399999999999991	0.00129032258064513	6080	1
2	Food 2	Intake 4	19	240931	1336971796	/users/cn/jespinosa/phecomp/data/CRG/20120502_FDF_CRG/20120502_FDF_CRG/20120511_FDF_CRG_c12.mtb	4518	6592	WWFF	food_fat	4	240912	1336971777	1	0.0399999999999991	0.00210526315789469	6081	1
2	Drink 1	Intake 1	25	241143	1336972008	/users/cn/jespinosa/phecomp/data/CRG/20120502_FDF_CRG/20120502_FDF_CRG/20120511_FDF_CRG_c12.mtb	930	NA	WWFF	water	1	241118	1336971983	1	0.0600000000000001	0.0024	6082	1
2	Drink 1	Intake 1	18	241352	1336972217	/users/cn/jespinosa/phecomp/data/CRG/20120502_FDF_CRG/20120502_FDF_CRG/20120511_FDF_CRG_c12.mtb	931	NA	WWFF	water	1	241334	1336972199	1	0.02	0.00111111111111111	6083	1
2	Drink 1	Intake 1	15	242111	1336972976	/users/cn/jespinosa/phecomp/data/CRG/20120502_FDF_CRG/20120502_FDF_CRG/20120511_FDF_CRG_c12.mtb	932	NA	WWFF	water	1	242096	1336972961	1	0.04	0.00266666666666667	6084	1
2	Drink 1	Intake 1	13	242621	1336973486	/users/cn/jespinosa/phecomp/data/CRG/20120502_FDF_CRG/20120502_FDF_CRG/20120511_FDF_CRG_c12.mtb	933	NA	WWFF	water	1	242608	1336973473	1	0.04	0.00307692307692308	6085	1
2	Food 2	Intake 4	15	247538	1336978403	/users/cn/jespinosa/phecomp/data/CRG/20120502_FDF_CRG/20120502_FDF_CRG/20120511_FDF_CRG_c12.mtb	4542	1235	WWFF	food_fat	4	247523	1336978388	1	0.0400000000000009	0.00266666666666673	6086	1
2	Drink 1	Intake 1	22	247550	1336978415	/users/cn/jespinosa/phecomp/data/CRG/20120502_FDF_CRG/20120502_FDF_CRG/20120511_FDF_CRG_c12.mtb	936	NA	WWFF	water	1	247528	1336978393	1	0.0800000000000001	0.00363636363636364	6087	1
2	Food 2	Intake 4	39	248812	1336979677	/users/cn/jespinosa/phecomp/data/CRG/20120502_FDF_CRG/20120502_FDF_CRG/20120511_FDF_CRG_c12.mtb	4546	96	WWFF	food_fat	4	248773	1336979638	1	0.0600000000000005	0.00153846153846155	6088	1
2	Drink 1	Intake 1	28	248844	1336979709	/users/cn/jespinosa/phecomp/data/CRG/20120502_FDF_CRG/20120502_FDF_CRG/20120511_FDF_CRG_c12.mtb	937	NA	WWFF	water	1	248816	1336979681	1	0.0399999999999996	0.00142857142857141	6089	1
2	Food 2	Intake 4	74	248982	1336979847	/users/cn/jespinosa/phecomp/data/CRG/20120502_FDF_CRG/20120502_FDF_CRG/20120511_FDF_CRG_c12.mtb	4548	34	WWFF	food_fat	4	248908	1336979773	1	0.100000000000001	0.00135135135135136	6090	1
2	Food 2	Intake 4	11	249027	1336979892	/users/cn/jespinosa/phecomp/data/CRG/20120502_FDF_CRG/20120502_FDF_CRG/20120511_FDF_CRG_c12.mtb	4550	2174	WWFF	food_fat	4	249016	1336979881	1	0.0400000000000009	0.00363636363636372	6091	1
2	Food 2	Intake 4	12	251213	1336982078	/users/cn/jespinosa/phecomp/data/CRG/20120502_FDF_CRG/20120502_FDF_CRG/20120511_FDF_CRG_c12.mtb	4552	10233	WWFF	food_fat	4	251201	1336982066	1	0.0399999999999991	0.00333333333333326	6092	1
2	Food 1	Intake 3	25	163	1336992336	/users/cn/jespinosa/phecomp/data/CRG/20120502_FDF_CRG/20120502_FDF_CRG/20120514_FDF_CRG_c12.mtb	3291	259	WWFF	food_fat	3	138	1336992311	1	0.2	0.008	6093	1
2	Food 1	Intake 3	23	445	1336992618	/users/cn/jespinosa/phecomp/data/CRG/20120502_FDF_CRG/20120502_FDF_CRG/20120514_FDF_CRG_c12.mtb	3293	51	WWFF	food_fat	3	422	1336992595	1	0.04	0.00173913043478261	6094	1
2	Food 1	Intake 3	36	532	1336992705	/users/cn/jespinosa/phecomp/data/CRG/20120502_FDF_CRG/20120502_FDF_CRG/20120514_FDF_CRG_c12.mtb	3294	170	WWFF	food_fat	3	496	1336992669	1	0.02	0.000555555555555556	6095	1
2	Food 1	Intake 3	20	722	1336992895	/users/cn/jespinosa/phecomp/data/CRG/20120502_FDF_CRG/20120502_FDF_CRG/20120514_FDF_CRG_c12.mtb	3297	177	WWFF	food_fat	3	702	1336992875	1	0.02	0.001	6096	1
2	Food 1	Intake 3	10	909	1336993082	/users/cn/jespinosa/phecomp/data/CRG/20120502_FDF_CRG/20120502_FDF_CRG/20120514_FDF_CRG_c12.mtb	3298	35	WWFF	food_fat	3	899	1336993072	1	0.02	0.002	6097	1
2	Food 1	Intake 3	27	971	1336993144	/users/cn/jespinosa/phecomp/data/CRG/20120502_FDF_CRG/20120502_FDF_CRG/20120514_FDF_CRG_c12.mtb	3299	11	WWFF	food_fat	3	944	1336993117	1	0.06	0.00222222222222222	6098	1
2	Food 1	Intake 3	22	1004	1336993177	/users/cn/jespinosa/phecomp/data/CRG/20120502_FDF_CRG/20120502_FDF_CRG/20120514_FDF_CRG_c12.mtb	3300	670	WWFF	food_fat	3	982	1336993155	1	0.06	0.00272727272727273	6099	1
2	Food 1	Intake 3	24	1698	1336993871	/users/cn/jespinosa/phecomp/data/CRG/20120502_FDF_CRG/20120502_FDF_CRG/20120514_FDF_CRG_c12.mtb	3301	110	WWFF	food_fat	3	1674	1336993847	1	0.38	0.0158333333333333	6100	1
2	Food 1	Intake 3	60	1868	1336994041	/users/cn/jespinosa/phecomp/data/CRG/20120502_FDF_CRG/20120502_FDF_CRG/20120514_FDF_CRG_c12.mtb	3302	82	WWFF	food_fat	3	1808	1336993981	1	0.16	0.00266666666666667	6101	1
2	Food 2	Intake 4	24	1974	1336994147	/users/cn/jespinosa/phecomp/data/CRG/20120502_FDF_CRG/20120502_FDF_CRG/20120514_FDF_CRG_c12.mtb	5125	13	WWFF	food_fat	4	1950	1336994123	1	0.26	0.0108333333333333	6102	1
2	Food 2	Intake 4	45	2032	1336994205	/users/cn/jespinosa/phecomp/data/CRG/20120502_FDF_CRG/20120502_FDF_CRG/20120514_FDF_CRG_c12.mtb	5126	367	WWFF	food_fat	4	1987	1336994160	1	0.48	0.0106666666666667	6103	1
2	Food 2	Intake 4	26	2425	1336994598	/users/cn/jespinosa/phecomp/data/CRG/20120502_FDF_CRG/20120502_FDF_CRG/20120514_FDF_CRG_c12.mtb	5128	COLL	WWFF	food_fat	4	2399	1336994572	1	0.02	0.000769230769230769	6104	1
2	Food 1	Intake 3	47	2461	1336994634	/users/cn/jespinosa/phecomp/data/CRG/20120502_FDF_CRG/20120502_FDF_CRG/20120514_FDF_CRG_c12.mtb	3306	341	WWFF	food_fat	3	2414	1336994587	1	0.14	0.00297872340425532	6105	1
2	Food 1	Intake 3	13	2815	1336994988	/users/cn/jespinosa/phecomp/data/CRG/20120502_FDF_CRG/20120502_FDF_CRG/20120514_FDF_CRG_c12.mtb	3308	2009	WWFF	food_fat	3	2802	1336994975	1	0.02	0.00153846153846154	6106	1
2	Drink 2	Intake 2	16	3199	1336995372	/users/cn/jespinosa/phecomp/data/CRG/20120502_FDF_CRG/20120502_FDF_CRG/20120514_FDF_CRG_c12.mtb	1454	NA	WWFF	water	2	3183	1336995356	1	0.02	0.00125	6107	1
2	Food 1	Intake 3	16	4840	1336997013	/users/cn/jespinosa/phecomp/data/CRG/20120502_FDF_CRG/20120502_FDF_CRG/20120514_FDF_CRG_c12.mtb	3310	17992	WWFF	food_fat	3	4824	1336996997	1	0.04	0.0025	6108	1
2	Drink 2	Intake 2	22	12139	1337004312	/users/cn/jespinosa/phecomp/data/CRG/20120502_FDF_CRG/20120502_FDF_CRG/20120514_FDF_CRG_c12.mtb	1458	NA	WWFF	water	2	12117	1337004290	1	0.12	0.00545454545454545	6109	1
2	Drink 1	Intake 1	20	21531	1337013704	/users/cn/jespinosa/phecomp/data/CRG/20120502_FDF_CRG/20120502_FDF_CRG/20120514_FDF_CRG_c12.mtb	1029	NA	WWFF	water	1	21511	1337013684	1	0.08	0.004	6110	1
2	Drink 1	Intake 1	13	22555	1337014728	/users/cn/jespinosa/phecomp/data/CRG/20120502_FDF_CRG/20120502_FDF_CRG/20120514_FDF_CRG_c12.mtb	1031	NA	WWFF	water	1	22542	1337014715	1	0.04	0.00307692307692308	6111	1
2	Drink 2	Intake 2	26	22827	1337015000	/users/cn/jespinosa/phecomp/data/CRG/20120502_FDF_CRG/20120502_FDF_CRG/20120514_FDF_CRG_c12.mtb	1461	NA	WWFF	water	2	22801	1337014974	1	0.08	0.00307692307692308	6112	1
2	Food 2	Intake 4	31	22863	1337015036	/users/cn/jespinosa/phecomp/data/CRG/20120502_FDF_CRG/20120502_FDF_CRG/20120514_FDF_CRG_c12.mtb	5135	COLL	WWFF	food_fat	4	22832	1337015005	1	0.02	0.000645161290322581	6113	1
2	Food 1	Intake 3	70	22924	1337015097	/users/cn/jespinosa/phecomp/data/CRG/20120502_FDF_CRG/20120502_FDF_CRG/20120514_FDF_CRG_c12.mtb	3315	4	WWFF	food_fat	3	22854	1337015027	1	0.02	0.000285714285714286	6114	1
2	Food 1	Intake 3	52	22980	1337015153	/users/cn/jespinosa/phecomp/data/CRG/20120502_FDF_CRG/20120502_FDF_CRG/20120514_FDF_CRG_c12.mtb	3316	4728	WWFF	food_fat	3	22928	1337015101	1	0.18	0.00346153846153846	6115	1
2	Food 1	Intake 3	16	27724	1337019897	/users/cn/jespinosa/phecomp/data/CRG/20120502_FDF_CRG/20120502_FDF_CRG/20120514_FDF_CRG_c12.mtb	3317	21	WWFF	food_fat	3	27708	1337019881	1	0.02	0.00125	6116	1
2	Food 2	Intake 4	47	27792	1337019965	/users/cn/jespinosa/phecomp/data/CRG/20120502_FDF_CRG/20120502_FDF_CRG/20120514_FDF_CRG_c12.mtb	5137	80	WWFF	food_fat	4	27745	1337019918	1	0.0599999999999999	0.00127659574468085	6117	1
2	Food 1	Intake 3	57	27929	1337020102	/users/cn/jespinosa/phecomp/data/CRG/20120502_FDF_CRG/20120502_FDF_CRG/20120514_FDF_CRG_c12.mtb	3319	26	WWFF	food_fat	3	27872	1337020045	1	0.04	0.000701754385964912	6118	1
2	Food 1	Intake 3	43	27998	1337020171	/users/cn/jespinosa/phecomp/data/CRG/20120502_FDF_CRG/20120502_FDF_CRG/20120514_FDF_CRG_c12.mtb	3320	551	WWFF	food_fat	3	27955	1337020128	1	0.02	0.000465116279069767	6119	1
2	Drink 2	Intake 2	26	28086	1337020259	/users/cn/jespinosa/phecomp/data/CRG/20120502_FDF_CRG/20120502_FDF_CRG/20120514_FDF_CRG_c12.mtb	1463	NA	WWFF	water	2	28060	1337020233	1	0.1	0.00384615384615385	6120	1
2	Drink 2	Intake 2	20	28469	1337020642	/users/cn/jespinosa/phecomp/data/CRG/20120502_FDF_CRG/20120502_FDF_CRG/20120514_FDF_CRG_c12.mtb	1464	NA	WWFF	water	2	28449	1337020622	1	0.04	0.002	6121	1
2	Food 1	Intake 3	30	28579	1337020752	/users/cn/jespinosa/phecomp/data/CRG/20120502_FDF_CRG/20120502_FDF_CRG/20120514_FDF_CRG_c12.mtb	3321	1161	WWFF	food_fat	3	28549	1337020722	1	0.0800000000000001	0.00266666666666667	6122	1
2	Food 1	Intake 3	15	29755	1337021928	/users/cn/jespinosa/phecomp/data/CRG/20120502_FDF_CRG/20120502_FDF_CRG/20120514_FDF_CRG_c12.mtb	3322	2753	WWFF	food_fat	3	29740	1337021913	1	0.02	0.00133333333333333	6123	1
2	Drink 2	Intake 2	10	29872	1337022045	/users/cn/jespinosa/phecomp/data/CRG/20120502_FDF_CRG/20120502_FDF_CRG/20120514_FDF_CRG_c12.mtb	1465	NA	WWFF	water	2	29862	1337022035	1	0.02	0.002	6124	1
2	Drink 2	Intake 2	34	31073	1337023246	/users/cn/jespinosa/phecomp/data/CRG/20120502_FDF_CRG/20120502_FDF_CRG/20120514_FDF_CRG_c12.mtb	1466	NA	WWFF	water	2	31039	1337023212	1	0.04	0.00117647058823529	6125	1
2	Food 1	Intake 3	15	32523	1337024696	/users/cn/jespinosa/phecomp/data/CRG/20120502_FDF_CRG/20120502_FDF_CRG/20120514_FDF_CRG_c12.mtb	3325	819	WWFF	food_fat	3	32508	1337024681	1	0.02	0.00133333333333333	6126	1
2	Drink 1	Intake 1	23	32543	1337024716	/users/cn/jespinosa/phecomp/data/CRG/20120502_FDF_CRG/20120502_FDF_CRG/20120514_FDF_CRG_c12.mtb	1033	NA	WWFF	water	1	32520	1337024693	1	0.02	0.000869565217391304	6127	1
2	Drink 2	Intake 2	26	32944	1337025117	/users/cn/jespinosa/phecomp/data/CRG/20120502_FDF_CRG/20120502_FDF_CRG/20120514_FDF_CRG_c12.mtb	1467	NA	WWFF	water	2	32918	1337025091	1	0.1	0.00384615384615385	6128	1
2	Food 1	Intake 3	87	33429	1337025602	/users/cn/jespinosa/phecomp/data/CRG/20120502_FDF_CRG/20120502_FDF_CRG/20120514_FDF_CRG_c12.mtb	3329	986	WWFF	food_fat	3	33342	1337025515	1	0.0999999999999999	0.00114942528735632	6129	1
2	Drink 2	Intake 2	33	33487	1337025660	/users/cn/jespinosa/phecomp/data/CRG/20120502_FDF_CRG/20120502_FDF_CRG/20120514_FDF_CRG_c12.mtb	1468	NA	WWFF	water	2	33454	1337025627	1	0.02	0.000606060606060606	6130	1
2	Food 1	Intake 3	23	34438	1337026611	/users/cn/jespinosa/phecomp/data/CRG/20120502_FDF_CRG/20120502_FDF_CRG/20120514_FDF_CRG_c12.mtb	3330	81	WWFF	food_fat	3	34415	1337026588	1	0.02	0.000869565217391304	6131	1
2	Food 1	Intake 3	71	34590	1337026763	/users/cn/jespinosa/phecomp/data/CRG/20120502_FDF_CRG/20120502_FDF_CRG/20120514_FDF_CRG_c12.mtb	3332	19	WWFF	food_fat	3	34519	1337026692	1	0.0600000000000001	0.000845070422535213	6132	1
2	Food 1	Intake 3	176	34785	1337026958	/users/cn/jespinosa/phecomp/data/CRG/20120502_FDF_CRG/20120502_FDF_CRG/20120514_FDF_CRG_c12.mtb	3333	67	WWFF	food_fat	3	34609	1337026782	1	0.2	0.00113636363636364	6133	1
2	Food 1	Intake 3	141	34993	1337027166	/users/cn/jespinosa/phecomp/data/CRG/20120502_FDF_CRG/20120502_FDF_CRG/20120514_FDF_CRG_c12.mtb	3334	596	WWFF	food_fat	3	34852	1337027025	1	0.16	0.00113475177304965	6134	1
2	Drink 2	Intake 2	28	35570	1337027743	/users/cn/jespinosa/phecomp/data/CRG/20120502_FDF_CRG/20120502_FDF_CRG/20120514_FDF_CRG_c12.mtb	1470	NA	WWFF	water	2	35542	1337027715	1	0.08	0.00285714285714286	6135	1
2	Food 1	Intake 3	84	35673	1337027846	/users/cn/jespinosa/phecomp/data/CRG/20120502_FDF_CRG/20120502_FDF_CRG/20120514_FDF_CRG_c12.mtb	3335	14	WWFF	food_fat	3	35589	1337027762	1	0.2	0.00238095238095238	6136	1
2	Food 1	Intake 3	149	35836	1337028009	/users/cn/jespinosa/phecomp/data/CRG/20120502_FDF_CRG/20120502_FDF_CRG/20120514_FDF_CRG_c12.mtb	3336	144	WWFF	food_fat	3	35687	1337027860	1	0.92	0.0061744966442953	6137	1
2	Food 1	Intake 3	16	35996	1337028169	/users/cn/jespinosa/phecomp/data/CRG/20120502_FDF_CRG/20120502_FDF_CRG/20120514_FDF_CRG_c12.mtb	3337	59	WWFF	food_fat	3	35980	1337028153	1	0.0200000000000005	0.00125000000000003	6138	1
2	Food 1	Intake 3	15	36070	1337028243	/users/cn/jespinosa/phecomp/data/CRG/20120502_FDF_CRG/20120502_FDF_CRG/20120514_FDF_CRG_c12.mtb	3338	19	WWFF	food_fat	3	36055	1337028228	1	0.0999999999999996	0.00666666666666664	6139	1
2	Food 1	Intake 3	220	36309	1337028482	/users/cn/jespinosa/phecomp/data/CRG/20120502_FDF_CRG/20120502_FDF_CRG/20120514_FDF_CRG_c12.mtb	3339	COLL	WWFF	food_fat	3	36089	1337028262	1	0.9	0.00409090909090909	6140	1
2	Food 2	Intake 4	18	36143	1337028316	/users/cn/jespinosa/phecomp/data/CRG/20120502_FDF_CRG/20120502_FDF_CRG/20120514_FDF_CRG_c12.mtb	5148	310	WWFF	food_fat	4	36125	1337028298	1	0.02	0.00111111111111111	6141	1
2	Drink 2	Intake 2	25	36434	1337028607	/users/cn/jespinosa/phecomp/data/CRG/20120502_FDF_CRG/20120502_FDF_CRG/20120514_FDF_CRG_c12.mtb	1471	NA	WWFF	water	2	36409	1337028582	1	0.08	0.0032	6142	1
2	Food 1	Intake 3	50	36503	1337028676	/users/cn/jespinosa/phecomp/data/CRG/20120502_FDF_CRG/20120502_FDF_CRG/20120514_FDF_CRG_c12.mtb	3340	COLL	WWFF	food_fat	3	36453	1337028626	1	0.0599999999999996	0.00119999999999999	6143	1
2	Food 2	Intake 4	26	36521	1337028694	/users/cn/jespinosa/phecomp/data/CRG/20120502_FDF_CRG/20120502_FDF_CRG/20120514_FDF_CRG_c12.mtb	5149	COLL	WWFF	food_fat	4	36495	1337028668	1	0.04	0.00153846153846154	6144	1
2	Food 1	Intake 3	137	36646	1337028819	/users/cn/jespinosa/phecomp/data/CRG/20120502_FDF_CRG/20120502_FDF_CRG/20120514_FDF_CRG_c12.mtb	3341	264	WWFF	food_fat	3	36509	1337028682	1	0.24	0.00175182481751825	6145	1
2	Food 1	Intake 3	254	37164	1337029337	/users/cn/jespinosa/phecomp/data/CRG/20120502_FDF_CRG/20120502_FDF_CRG/20120514_FDF_CRG_c12.mtb	3342	416	WWFF	food_fat	3	36910	1337029083	1	1.62	0.00637795275590551	6146	1
2	Drink 2	Intake 2	15	37571	1337029744	/users/cn/jespinosa/phecomp/data/CRG/20120502_FDF_CRG/20120502_FDF_CRG/20120514_FDF_CRG_c12.mtb	1472	NA	WWFF	water	2	37556	1337029729	1	0.02	0.00133333333333333	6147	1
2	Food 1	Intake 3	86	37666	1337029839	/users/cn/jespinosa/phecomp/data/CRG/20120502_FDF_CRG/20120502_FDF_CRG/20120514_FDF_CRG_c12.mtb	3343	17553	WWFF	food_fat	3	37580	1337029753	1	1.68	0.0195348837209302	6148	1
2	Drink 2	Intake 2	19	39575	1337031748	/users/cn/jespinosa/phecomp/data/CRG/20120502_FDF_CRG/20120502_FDF_CRG/20120514_FDF_CRG_c12.mtb	1474	NA	WWFF	water	2	39556	1337031729	1	0.0600000000000001	0.00315789473684211	6149	1
2	Drink 2	Intake 2	37	40171	1337032344	/users/cn/jespinosa/phecomp/data/CRG/20120502_FDF_CRG/20120502_FDF_CRG/20120514_FDF_CRG_c12.mtb	1475	NA	WWFF	water	2	40134	1337032307	1	0.0399999999999999	0.00108108108108108	6150	1
2	Drink 2	Intake 2	14	43945	1337036118	/users/cn/jespinosa/phecomp/data/CRG/20120502_FDF_CRG/20120502_FDF_CRG/20120514_FDF_CRG_c12.mtb	1477	NA	WWFF	water	2	43931	1337036104	1	0.04	0.00285714285714286	6151	1
2	Drink 2	Intake 2	14	47543	1337039716	/users/cn/jespinosa/phecomp/data/CRG/20120502_FDF_CRG/20120502_FDF_CRG/20120514_FDF_CRG_c12.mtb	1478	NA	WWFF	water	2	47529	1337039702	1	0.0600000000000001	0.00428571428571429	6152	1
2	Drink 1	Intake 1	24	52677	1337044850	/users/cn/jespinosa/phecomp/data/CRG/20120502_FDF_CRG/20120502_FDF_CRG/20120514_FDF_CRG_c12.mtb	1035	NA	WWFF	water	1	52653	1337044826	1	0.06	0.0025	6153	1
2	Drink 2	Intake 2	19	53985	1337046158	/users/cn/jespinosa/phecomp/data/CRG/20120502_FDF_CRG/20120502_FDF_CRG/20120514_FDF_CRG_c12.mtb	1480	NA	WWFF	water	2	53966	1337046139	1	0.0800000000000001	0.00421052631578948	6154	1
2	Food 2	Intake 4	76	55295	1337047468	/users/cn/jespinosa/phecomp/data/CRG/20120502_FDF_CRG/20120502_FDF_CRG/20120514_FDF_CRG_c12.mtb	5154	38	WWFF	food_fat	4	55219	1337047392	1	0.0399999999999999	0.000526315789473683	6155	1
2	Food 2	Intake 4	123	55456	1337047629	/users/cn/jespinosa/phecomp/data/CRG/20120502_FDF_CRG/20120502_FDF_CRG/20120514_FDF_CRG_c12.mtb	5155	472	WWFF	food_fat	4	55333	1337047506	1	0.28	0.00227642276422764	6156	1
2	Drink 2	Intake 2	25	55931	1337048104	/users/cn/jespinosa/phecomp/data/CRG/20120502_FDF_CRG/20120502_FDF_CRG/20120514_FDF_CRG_c12.mtb	1483	NA	WWFF	water	2	55906	1337048079	1	0.04	0.0016	6157	1
2	Food 2	Intake 4	87	56015	1337048188	/users/cn/jespinosa/phecomp/data/CRG/20120502_FDF_CRG/20120502_FDF_CRG/20120514_FDF_CRG_c12.mtb	5157	375	WWFF	food_fat	4	55928	1337048101	1	0.0800000000000001	0.000919540229885059	6158	1
2	Food 2	Intake 4	83	56473	1337048646	/users/cn/jespinosa/phecomp/data/CRG/20120502_FDF_CRG/20120502_FDF_CRG/20120514_FDF_CRG_c12.mtb	5158	962	WWFF	food_fat	4	56390	1337048563	1	0.0999999999999999	0.00120481927710843	6159	1
2	Food 1	Intake 3	168	57603	1337049776	/users/cn/jespinosa/phecomp/data/CRG/20120502_FDF_CRG/20120502_FDF_CRG/20120514_FDF_CRG_c12.mtb	3352	20	WWFF	food_fat	3	57435	1337049608	1	1.26	0.0075	6160	1
2	Food 1	Intake 3	37	57660	1337049833	/users/cn/jespinosa/phecomp/data/CRG/20120502_FDF_CRG/20120502_FDF_CRG/20120514_FDF_CRG_c12.mtb	3353	COLL	WWFF	food_fat	3	57623	1337049796	1	0.0999999999999996	0.00270270270270269	6161	1
2	Food 2	Intake 4	33	57684	1337049857	/users/cn/jespinosa/phecomp/data/CRG/20120502_FDF_CRG/20120502_FDF_CRG/20120514_FDF_CRG_c12.mtb	5159	COLL	WWFF	food_fat	4	57651	1337049824	1	0.0600000000000001	0.00181818181818182	6162	1
2	Food 1	Intake 3	44	57717	1337049890	/users/cn/jespinosa/phecomp/data/CRG/20120502_FDF_CRG/20120502_FDF_CRG/20120514_FDF_CRG_c12.mtb	3354	COLL	WWFF	food_fat	3	57673	1337049846	1	0.0600000000000005	0.00136363636363638	6163	1
2	Food 2	Intake 4	33	57740	1337049913	/users/cn/jespinosa/phecomp/data/CRG/20120502_FDF_CRG/20120502_FDF_CRG/20120514_FDF_CRG_c12.mtb	5160	24951	WWFF	food_fat	4	57707	1337049880	1	0.02	0.000606060606060606	6164	1
2	Drink 2	Intake 2	36	57888	1337050061	/users/cn/jespinosa/phecomp/data/CRG/20120502_FDF_CRG/20120502_FDF_CRG/20120514_FDF_CRG_c12.mtb	1484	NA	WWFF	water	2	57852	1337050025	1	0.0600000000000001	0.00166666666666667	6165	1
2	Drink 1	Intake 1	12	62948	1337055121	/users/cn/jespinosa/phecomp/data/CRG/20120502_FDF_CRG/20120502_FDF_CRG/20120514_FDF_CRG_c12.mtb	1038	NA	WWFF	water	1	62936	1337055109	1	0.04	0.00333333333333333	6166	1
2	Drink 2	Intake 2	18	65452	1337057625	/users/cn/jespinosa/phecomp/data/CRG/20120502_FDF_CRG/20120502_FDF_CRG/20120514_FDF_CRG_c12.mtb	1485	NA	WWFF	water	2	65434	1337057607	1	0.0399999999999998	0.00222222222222221	6167	1
2	Drink 2	Intake 2	31	66149	1337058322	/users/cn/jespinosa/phecomp/data/CRG/20120502_FDF_CRG/20120502_FDF_CRG/20120514_FDF_CRG_c12.mtb	1486	NA	WWFF	water	2	66118	1337058291	1	0.0600000000000001	0.00193548387096775	6168	1
2	Drink 2	Intake 2	23	66427	1337058600	/users/cn/jespinosa/phecomp/data/CRG/20120502_FDF_CRG/20120502_FDF_CRG/20120514_FDF_CRG_c12.mtb	1487	NA	WWFF	water	2	66404	1337058577	1	0.0600000000000001	0.00260869565217392	6169	1
2	Drink 2	Intake 2	31	67258	1337059431	/users/cn/jespinosa/phecomp/data/CRG/20120502_FDF_CRG/20120502_FDF_CRG/20120514_FDF_CRG_c12.mtb	1488	NA	WWFF	water	2	67227	1337059400	1	0.12	0.00387096774193548	6170	1
2	Drink 2	Intake 2	19	74960	1337067133	/users/cn/jespinosa/phecomp/data/CRG/20120502_FDF_CRG/20120502_FDF_CRG/20120514_FDF_CRG_c12.mtb	1490	NA	WWFF	water	2	74941	1337067114	1	0.04	0.00210526315789474	6171	1
2	Drink 2	Intake 2	100	82239	1337074412	/users/cn/jespinosa/phecomp/data/CRG/20120502_FDF_CRG/20120502_FDF_CRG/20120514_FDF_CRG_c12.mtb	1491	NA	WWFF	water	2	82139	1337074312	1	0.0800000000000001	0.000800000000000001	6172	1
2	Drink 1	Intake 1	20	82266	1337074439	/users/cn/jespinosa/phecomp/data/CRG/20120502_FDF_CRG/20120502_FDF_CRG/20120514_FDF_CRG_c12.mtb	1040	NA	WWFF	water	1	82246	1337074419	1	0.02	0.001	6173	1
2	Drink 2	Intake 2	15	82340	1337074513	/users/cn/jespinosa/phecomp/data/CRG/20120502_FDF_CRG/20120502_FDF_CRG/20120514_FDF_CRG_c12.mtb	1492	NA	WWFF	water	2	82325	1337074498	1	0.0600000000000001	0.00400000000000001	6174	1
2	Food 2	Intake 4	15	82706	1337074879	/users/cn/jespinosa/phecomp/data/CRG/20120502_FDF_CRG/20120502_FDF_CRG/20120514_FDF_CRG_c12.mtb	5169	24472	WWFF	food_fat	4	82691	1337074864	1	0.02	0.00133333333333333	6175	1
2	Drink 2	Intake 2	15	83649	1337075822	/users/cn/jespinosa/phecomp/data/CRG/20120502_FDF_CRG/20120502_FDF_CRG/20120514_FDF_CRG_c12.mtb	1493	NA	WWFF	water	2	83634	1337075807	1	0.04	0.00266666666666667	6176	1
2	Drink 2	Intake 2	18	83919	1337076092	/users/cn/jespinosa/phecomp/data/CRG/20120502_FDF_CRG/20120502_FDF_CRG/20120514_FDF_CRG_c12.mtb	1495	NA	WWFF	water	2	83901	1337076074	1	0.02	0.00111111111111111	6177	1
2	Drink 1	Intake 1	21	93944	1337086117	/users/cn/jespinosa/phecomp/data/CRG/20120502_FDF_CRG/20120502_FDF_CRG/20120514_FDF_CRG_c12.mtb	1041	NA	WWFF	water	1	93923	1337086096	1	0.08	0.00380952380952381	6178	1
2	Food 2	Intake 4	15	107193	1337099366	/users/cn/jespinosa/phecomp/data/CRG/20120502_FDF_CRG/20120502_FDF_CRG/20120514_FDF_CRG_c12.mtb	5172	6112	WWFF	food_fat	4	107178	1337099351	1	0.04	0.00266666666666667	6179	1
2	Drink 1	Intake 1	13	107286	1337099459	/users/cn/jespinosa/phecomp/data/CRG/20120502_FDF_CRG/20120502_FDF_CRG/20120514_FDF_CRG_c12.mtb	1042	NA	WWFF	water	1	107273	1337099446	1	0.02	0.00153846153846154	6180	1
2	Drink 2	Intake 2	24	107317	1337099490	/users/cn/jespinosa/phecomp/data/CRG/20120502_FDF_CRG/20120502_FDF_CRG/20120514_FDF_CRG_c12.mtb	1498	NA	WWFF	water	2	107293	1337099466	1	0.02	0.000833333333333333	6181	1
2	Food 1	Intake 3	15	113320	1337105493	/users/cn/jespinosa/phecomp/data/CRG/20120502_FDF_CRG/20120502_FDF_CRG/20120514_FDF_CRG_c12.mtb	3365	14	WWFF	food_fat	3	113305	1337105478	1	0.0400000000000009	0.00266666666666673	6182	1
2	Food 1	Intake 3	39	113373	1337105546	/users/cn/jespinosa/phecomp/data/CRG/20120502_FDF_CRG/20120502_FDF_CRG/20120514_FDF_CRG_c12.mtb	3366	1198	WWFF	food_fat	3	113334	1337105507	1	0.0800000000000001	0.00205128205128205	6183	1
2	Drink 2	Intake 2	49	114441	1337106614	/users/cn/jespinosa/phecomp/data/CRG/20120502_FDF_CRG/20120502_FDF_CRG/20120514_FDF_CRG_c12.mtb	1499	NA	WWFF	water	2	114392	1337106565	1	0.0599999999999998	0.00122448979591836	6184	1
2	Food 2	Intake 4	25	114596	1337106769	/users/cn/jespinosa/phecomp/data/CRG/20120502_FDF_CRG/20120502_FDF_CRG/20120514_FDF_CRG_c12.mtb	5176	6	WWFF	food_fat	4	114571	1337106744	1	0.04	0.0016	6185	1
2	Food 2	Intake 4	109	114711	1337106884	/users/cn/jespinosa/phecomp/data/CRG/20120502_FDF_CRG/20120502_FDF_CRG/20120514_FDF_CRG_c12.mtb	5177	1444	WWFF	food_fat	4	114602	1337106775	1	0.02	0.00018348623853211	6186	1
2	Drink 2	Intake 2	26	114898	1337107071	/users/cn/jespinosa/phecomp/data/CRG/20120502_FDF_CRG/20120502_FDF_CRG/20120514_FDF_CRG_c12.mtb	1500	NA	WWFF	water	2	114872	1337107045	1	0.04	0.00153846153846154	6187	1
2	Drink 2	Intake 2	31	115200	1337107373	/users/cn/jespinosa/phecomp/data/CRG/20120502_FDF_CRG/20120502_FDF_CRG/20120514_FDF_CRG_c12.mtb	1501	NA	WWFF	water	2	115169	1337107342	1	0.0599999999999998	0.00193548387096774	6188	1
2	Drink 2	Intake 2	29	115500	1337107673	/users/cn/jespinosa/phecomp/data/CRG/20120502_FDF_CRG/20120502_FDF_CRG/20120514_FDF_CRG_c12.mtb	1502	NA	WWFF	water	2	115471	1337107644	1	0.0600000000000001	0.00206896551724138	6189	1
2	Food 2	Intake 4	45	116200	1337108373	/users/cn/jespinosa/phecomp/data/CRG/20120502_FDF_CRG/20120502_FDF_CRG/20120514_FDF_CRG_c12.mtb	5182	84	WWFF	food_fat	4	116155	1337108328	1	0.02	0.000444444444444444	6190	1
2	Food 2	Intake 4	58	116342	1337108515	/users/cn/jespinosa/phecomp/data/CRG/20120502_FDF_CRG/20120502_FDF_CRG/20120514_FDF_CRG_c12.mtb	5184	175	WWFF	food_fat	4	116284	1337108457	1	0.02	0.000344827586206897	6191	1
2	Food 2	Intake 4	41	116558	1337108731	/users/cn/jespinosa/phecomp/data/CRG/20120502_FDF_CRG/20120502_FDF_CRG/20120514_FDF_CRG_c12.mtb	5187	159	WWFF	food_fat	4	116517	1337108690	1	0.02	0.00048780487804878	6192	1
2	Food 2	Intake 4	86	116803	1337108976	/users/cn/jespinosa/phecomp/data/CRG/20120502_FDF_CRG/20120502_FDF_CRG/20120514_FDF_CRG_c12.mtb	5189	1730	WWFF	food_fat	4	116717	1337108890	1	0.0799999999999998	0.000930232558139532	6193	1
2	Drink 2	Intake 2	22	117724	1337109897	/users/cn/jespinosa/phecomp/data/CRG/20120502_FDF_CRG/20120502_FDF_CRG/20120514_FDF_CRG_c12.mtb	1505	NA	WWFF	water	2	117702	1337109875	1	0.0800000000000001	0.00363636363636364	6194	1
2	Food 2	Intake 4	94	118627	1337110800	/users/cn/jespinosa/phecomp/data/CRG/20120502_FDF_CRG/20120502_FDF_CRG/20120514_FDF_CRG_c12.mtb	5193	17	WWFF	food_fat	4	118533	1337110706	1	0.16	0.00170212765957447	6195	1
2	Food 2	Intake 4	82	118726	1337110899	/users/cn/jespinosa/phecomp/data/CRG/20120502_FDF_CRG/20120502_FDF_CRG/20120514_FDF_CRG_c12.mtb	5194	3318	WWFF	food_fat	4	118644	1337110817	1	0.02	0.00024390243902439	6196	1
2	Drink 2	Intake 2	25	119803	1337111976	/users/cn/jespinosa/phecomp/data/CRG/20120502_FDF_CRG/20120502_FDF_CRG/20120514_FDF_CRG_c12.mtb	1507	NA	WWFF	water	2	119778	1337111951	1	0.02	0.0008	6197	1
2	Drink 2	Intake 2	10	121487	1337113660	/users/cn/jespinosa/phecomp/data/CRG/20120502_FDF_CRG/20120502_FDF_CRG/20120514_FDF_CRG_c12.mtb	1510	NA	WWFF	water	2	121477	1337113650	1	0.04	0.004	6198	1
2	Food 2	Intake 4	39	122083	1337114256	/users/cn/jespinosa/phecomp/data/CRG/20120502_FDF_CRG/20120502_FDF_CRG/20120514_FDF_CRG_c12.mtb	5197	5	WWFF	food_fat	4	122044	1337114217	1	0.0800000000000001	0.00205128205128205	6199	1
2	Food 2	Intake 4	20	122108	1337114281	/users/cn/jespinosa/phecomp/data/CRG/20120502_FDF_CRG/20120502_FDF_CRG/20120514_FDF_CRG_c12.mtb	5198	3099	WWFF	food_fat	4	122088	1337114261	1	0.02	0.001	6200	1
2	Drink 2	Intake 2	15	122842	1337115015	/users/cn/jespinosa/phecomp/data/CRG/20120502_FDF_CRG/20120502_FDF_CRG/20120514_FDF_CRG_c12.mtb	1511	NA	WWFF	water	2	122827	1337115000	1	0.02	0.00133333333333333	6201	1
2	Food 1	Intake 3	23	125230	1337117403	/users/cn/jespinosa/phecomp/data/CRG/20120502_FDF_CRG/20120502_FDF_CRG/20120514_FDF_CRG_c12.mtb	3383	6075	WWFF	food_fat	3	125207	1337117380	1	0.0400000000000009	0.00173913043478265	6202	1
2	Drink 2	Intake 2	23	128698	1337120871	/users/cn/jespinosa/phecomp/data/CRG/20120502_FDF_CRG/20120502_FDF_CRG/20120514_FDF_CRG_c12.mtb	1512	NA	WWFF	water	2	128675	1337120848	1	0.12	0.00521739130434783	6203	1
2	Drink 2	Intake 2	15	129922	1337122095	/users/cn/jespinosa/phecomp/data/CRG/20120502_FDF_CRG/20120502_FDF_CRG/20120514_FDF_CRG_c12.mtb	1513	NA	WWFF	water	2	129907	1337122080	1	0.04	0.00266666666666667	6204	1
2	Food 1	Intake 3	15	131320	1337123493	/users/cn/jespinosa/phecomp/data/CRG/20120502_FDF_CRG/20120502_FDF_CRG/20120514_FDF_CRG_c12.mtb	3387	1496	WWFF	food_fat	3	131305	1337123478	1	0.0200000000000014	0.00133333333333343	6205	1
2	Drink 2	Intake 2	13	132056	1337124229	/users/cn/jespinosa/phecomp/data/CRG/20120502_FDF_CRG/20120502_FDF_CRG/20120514_FDF_CRG_c12.mtb	1514	NA	WWFF	water	2	132043	1337124216	1	0.04	0.00307692307692308	6206	1
2	Food 1	Intake 3	34	132850	1337125023	/users/cn/jespinosa/phecomp/data/CRG/20120502_FDF_CRG/20120502_FDF_CRG/20120514_FDF_CRG_c12.mtb	3389	441	WWFF	food_fat	3	132816	1337124989	1	0.0599999999999987	0.0017647058823529	6207	1
2	Food 1	Intake 3	32	133323	1337125496	/users/cn/jespinosa/phecomp/data/CRG/20120502_FDF_CRG/20120502_FDF_CRG/20120514_FDF_CRG_c12.mtb	3391	435	WWFF	food_fat	3	133291	1337125464	1	0.0200000000000014	0.000625000000000044	6208	1
2	Drink 2	Intake 2	28	133613	1337125786	/users/cn/jespinosa/phecomp/data/CRG/20120502_FDF_CRG/20120502_FDF_CRG/20120514_FDF_CRG_c12.mtb	1515	NA	WWFF	water	2	133585	1337125758	1	0.0599999999999996	0.00214285714285713	6209	1
2	Food 2	Intake 4	39	133797	1337125970	/users/cn/jespinosa/phecomp/data/CRG/20120502_FDF_CRG/20120502_FDF_CRG/20120514_FDF_CRG_c12.mtb	5208	12901	WWFF	food_fat	4	133758	1337125931	1	0.02	0.000512820512820513	6210	1
2	Drink 2	Intake 2	22	134049	1337126222	/users/cn/jespinosa/phecomp/data/CRG/20120502_FDF_CRG/20120502_FDF_CRG/20120514_FDF_CRG_c12.mtb	1516	NA	WWFF	water	2	134027	1337126200	1	0.04	0.00181818181818182	6211	1
2	Drink 1	Intake 1	28	134890	1337127063	/users/cn/jespinosa/phecomp/data/CRG/20120502_FDF_CRG/20120502_FDF_CRG/20120514_FDF_CRG_c12.mtb	1048	NA	WWFF	water	1	134862	1337127035	1	0.06	0.00214285714285714	6212	1
2	Drink 2	Intake 2	20	139666	1337131839	/users/cn/jespinosa/phecomp/data/CRG/20120502_FDF_CRG/20120502_FDF_CRG/20120514_FDF_CRG_c12.mtb	1519	NA	WWFF	water	2	139646	1337131819	1	0.02	0.001	6213	1
2	Drink 2	Intake 2	24	140271	1337132444	/users/cn/jespinosa/phecomp/data/CRG/20120502_FDF_CRG/20120502_FDF_CRG/20120514_FDF_CRG_c12.mtb	1520	NA	WWFF	water	2	140247	1337132420	1	0.0800000000000001	0.00333333333333334	6214	1
2	Drink 2	Intake 2	15	142923	1337135096	/users/cn/jespinosa/phecomp/data/CRG/20120502_FDF_CRG/20120502_FDF_CRG/20120514_FDF_CRG_c12.mtb	1522	NA	WWFF	water	2	142908	1337135081	1	0.0600000000000001	0.00400000000000001	6215	1
2	Drink 2	Intake 2	16	143554	1337135727	/users/cn/jespinosa/phecomp/data/CRG/20120502_FDF_CRG/20120502_FDF_CRG/20120514_FDF_CRG_c12.mtb	1523	NA	WWFF	water	2	143538	1337135711	1	0.02	0.00125	6216	1
2	Drink 2	Intake 2	17	144797	1337136970	/users/cn/jespinosa/phecomp/data/CRG/20120502_FDF_CRG/20120502_FDF_CRG/20120514_FDF_CRG_c12.mtb	1524	NA	WWFF	water	2	144780	1337136953	1	0.02	0.00117647058823529	6217	1
2	Food 2	Intake 4	26	146724	1337138897	/users/cn/jespinosa/phecomp/data/CRG/20120502_FDF_CRG/20120502_FDF_CRG/20120514_FDF_CRG_c12.mtb	5212	260	WWFF	food_fat	4	146698	1337138871	1	0.02	0.000769230769230769	6218	1
2	Drink 2	Intake 2	29	146990	1337139163	/users/cn/jespinosa/phecomp/data/CRG/20120502_FDF_CRG/20120502_FDF_CRG/20120514_FDF_CRG_c12.mtb	1526	NA	WWFF	water	2	146961	1337139134	1	0.0600000000000001	0.00206896551724138	6219	1
2	Food 1	Intake 3	39	147023	1337139196	/users/cn/jespinosa/phecomp/data/CRG/20120502_FDF_CRG/20120502_FDF_CRG/20120514_FDF_CRG_c12.mtb	3403	COLL	WWFF	food_fat	3	146984	1337139157	1	0.0399999999999991	0.001025641025641	6220	1
2	Food 2	Intake 4	40	147051	1337139224	/users/cn/jespinosa/phecomp/data/CRG/20120502_FDF_CRG/20120502_FDF_CRG/20120514_FDF_CRG_c12.mtb	5215	4100	WWFF	food_fat	4	147011	1337139184	1	0.02	0.0005	6221	1
2	Drink 2	Intake 2	21	147424	1337139597	/users/cn/jespinosa/phecomp/data/CRG/20120502_FDF_CRG/20120502_FDF_CRG/20120514_FDF_CRG_c12.mtb	1527	NA	WWFF	water	2	147403	1337139576	1	0.0600000000000001	0.00285714285714286	6222	1
2	Drink 2	Intake 2	11	149185	1337141358	/users/cn/jespinosa/phecomp/data/CRG/20120502_FDF_CRG/20120502_FDF_CRG/20120514_FDF_CRG_c12.mtb	1529	NA	WWFF	water	2	149174	1337141347	1	0.04	0.00363636363636364	6223	1
2	Food 1	Intake 3	15	151166	1337143339	/users/cn/jespinosa/phecomp/data/CRG/20120502_FDF_CRG/20120502_FDF_CRG/20120514_FDF_CRG_c12.mtb	3408	798	WWFF	food_fat	3	151151	1337143324	1	0.0400000000000009	0.00266666666666673	6224	1
2	Drink 2	Intake 2	21	151696	1337143869	/users/cn/jespinosa/phecomp/data/CRG/20120502_FDF_CRG/20120502_FDF_CRG/20120514_FDF_CRG_c12.mtb	1530	NA	WWFF	water	2	151675	1337143848	1	0.0599999999999996	0.00285714285714284	6225	1
2	Food 2	Intake 4	17	151981	1337144154	/users/cn/jespinosa/phecomp/data/CRG/20120502_FDF_CRG/20120502_FDF_CRG/20120514_FDF_CRG_c12.mtb	5221	255	WWFF	food_fat	4	151964	1337144137	1	0.02	0.00117647058823529	6226	1
2	Drink 2	Intake 2	22	152194	1337144367	/users/cn/jespinosa/phecomp/data/CRG/20120502_FDF_CRG/20120502_FDF_CRG/20120514_FDF_CRG_c12.mtb	1531	NA	WWFF	water	2	152172	1337144345	1	0.04	0.00181818181818182	6227	1
2	Food 2	Intake 4	102	152338	1337144511	/users/cn/jespinosa/phecomp/data/CRG/20120502_FDF_CRG/20120502_FDF_CRG/20120514_FDF_CRG_c12.mtb	5223	184	WWFF	food_fat	4	152236	1337144409	1	0.02	0.000196078431372549	6228	1
2	Food 2	Intake 4	30	152552	1337144725	/users/cn/jespinosa/phecomp/data/CRG/20120502_FDF_CRG/20120502_FDF_CRG/20120514_FDF_CRG_c12.mtb	5226	6	WWFF	food_fat	4	152522	1337144695	1	0.02	0.000666666666666667	6229	1
2	Food 2	Intake 4	34	152592	1337144765	/users/cn/jespinosa/phecomp/data/CRG/20120502_FDF_CRG/20120502_FDF_CRG/20120514_FDF_CRG_c12.mtb	5227	30	WWFF	food_fat	4	152558	1337144731	1	0.02	0.000588235294117647	6230	1
2	Food 2	Intake 4	20	152642	1337144815	/users/cn/jespinosa/phecomp/data/CRG/20120502_FDF_CRG/20120502_FDF_CRG/20120514_FDF_CRG_c12.mtb	5228	41	WWFF	food_fat	4	152622	1337144795	1	0.02	0.001	6231	1
2	Food 2	Intake 4	126	152809	1337144982	/users/cn/jespinosa/phecomp/data/CRG/20120502_FDF_CRG/20120502_FDF_CRG/20120514_FDF_CRG_c12.mtb	5229	1543	WWFF	food_fat	4	152683	1337144856	1	0.02	0.000158730158730159	6232	1
2	Drink 2	Intake 2	19	153121	1337145294	/users/cn/jespinosa/phecomp/data/CRG/20120502_FDF_CRG/20120502_FDF_CRG/20120514_FDF_CRG_c12.mtb	1532	NA	WWFF	water	2	153102	1337145275	1	0.04	0.00210526315789474	6233	1
2	Drink 2	Intake 2	33	153573	1337145746	/users/cn/jespinosa/phecomp/data/CRG/20120502_FDF_CRG/20120502_FDF_CRG/20120514_FDF_CRG_c12.mtb	1533	NA	WWFF	water	2	153540	1337145713	1	0.0800000000000001	0.00242424242424243	6234	1
2	Drink 2	Intake 2	17	153996	1337146169	/users/cn/jespinosa/phecomp/data/CRG/20120502_FDF_CRG/20120502_FDF_CRG/20120514_FDF_CRG_c12.mtb	1534	NA	WWFF	water	2	153979	1337146152	1	0.02	0.00117647058823529	6235	1
2	Food 2	Intake 4	129	154481	1337146654	/users/cn/jespinosa/phecomp/data/CRG/20120502_FDF_CRG/20120502_FDF_CRG/20120514_FDF_CRG_c12.mtb	5232	6705	WWFF	food_fat	4	154352	1337146525	1	0.02	0.000155038759689922	6236	1
2	Food 1	Intake 3	30	161216	1337153389	/users/cn/jespinosa/phecomp/data/CRG/20120502_FDF_CRG/20120502_FDF_CRG/20120514_FDF_CRG_c12.mtb	3418	24	WWFF	food_fat	3	161186	1337153359	1	0.0200000000000014	0.000666666666666713	6237	1
2	Food 2	Intake 4	68	161308	1337153481	/users/cn/jespinosa/phecomp/data/CRG/20120502_FDF_CRG/20120502_FDF_CRG/20120514_FDF_CRG_c12.mtb	5233	10494	WWFF	food_fat	4	161240	1337153413	1	0.0600000000000001	0.000882352941176472	6238	1
2	Food 2	Intake 4	20	716	1337163995	/users/cn/jespinosa/phecomp/data/CRG/20120502_FDF_CRG/20120502_FDF_CRG/20120516_FDF_CRG_c12.mtb	5420	107	WWFF	food_fat	4	696	1337163975	1	0.06	0.003	6239	1
2	Food 2	Intake 4	69	892	1337164171	/users/cn/jespinosa/phecomp/data/CRG/20120502_FDF_CRG/20120502_FDF_CRG/20120516_FDF_CRG_c12.mtb	5421	COLL	WWFF	food_fat	4	823	1337164102	1	0.12	0.00173913043478261	6240	1
2	Food 1	Intake 3	52	933	1337164212	/users/cn/jespinosa/phecomp/data/CRG/20120502_FDF_CRG/20120502_FDF_CRG/20120516_FDF_CRG_c12.mtb	3693	30	WWFF	food_fat	3	881	1337164160	1	0.72	0.0138461538461538	6241	1
2	Food 1	Intake 3	147	1110	1337164389	/users/cn/jespinosa/phecomp/data/CRG/20120502_FDF_CRG/20120502_FDF_CRG/20120516_FDF_CRG_c12.mtb	3694	COLL	WWFF	food_fat	3	963	1337164242	1	1.32	0.00897959183673469	6242	1
2	Food 2	Intake 4	18	1057	1337164336	/users/cn/jespinosa/phecomp/data/CRG/20120502_FDF_CRG/20120502_FDF_CRG/20120516_FDF_CRG_c12.mtb	5423	59	WWFF	food_fat	4	1039	1337164318	1	0.02	0.00111111111111111	6243	1
2	Food 1	Intake 3	26	1142	1337164421	/users/cn/jespinosa/phecomp/data/CRG/20120502_FDF_CRG/20120502_FDF_CRG/20120516_FDF_CRG_c12.mtb	3695	82	WWFF	food_fat	3	1116	1337164395	1	0.0800000000000001	0.00307692307692308	6244	1
2	Drink 1	Intake 1	15	1214	1337164493	/users/cn/jespinosa/phecomp/data/CRG/20120502_FDF_CRG/20120502_FDF_CRG/20120516_FDF_CRG_c12.mtb	1092	NA	WWFF	water	1	1199	1337164478	1	0.02	0.00133333333333333	6245	1
2	Food 1	Intake 3	98	1322	1337164601	/users/cn/jespinosa/phecomp/data/CRG/20120502_FDF_CRG/20120502_FDF_CRG/20120516_FDF_CRG_c12.mtb	3696	COLL	WWFF	food_fat	3	1224	1337164503	1	0.86	0.00877551020408163	6246	1
2	Food 2	Intake 4	86	1402	1337164681	/users/cn/jespinosa/phecomp/data/CRG/20120502_FDF_CRG/20120502_FDF_CRG/20120516_FDF_CRG_c12.mtb	5426	COLL	WWFF	food_fat	4	1316	1337164595	1	0.32	0.00372093023255814	6247	1
2	Food 1	Intake 3	39	1379	1337164658	/users/cn/jespinosa/phecomp/data/CRG/20120502_FDF_CRG/20120502_FDF_CRG/20120516_FDF_CRG_c12.mtb	3697	128	WWFF	food_fat	3	1340	1337164619	1	0.04	0.00102564102564103	6248	1
2	Food 1	Intake 3	230	1737	1337165016	/users/cn/jespinosa/phecomp/data/CRG/20120502_FDF_CRG/20120502_FDF_CRG/20120516_FDF_CRG_c12.mtb	3698	173	WWFF	food_fat	3	1507	1337164786	1	2.62	0.0113913043478261	6249	1
2	Drink 2	Intake 2	21	1870	1337165149	/users/cn/jespinosa/phecomp/data/CRG/20120502_FDF_CRG/20120502_FDF_CRG/20120516_FDF_CRG_c12.mtb	1576	NA	WWFF	water	2	1849	1337165128	1	0.08	0.00380952380952381	6250	1
2	Food 1	Intake 3	69	1979	1337165258	/users/cn/jespinosa/phecomp/data/CRG/20120502_FDF_CRG/20120502_FDF_CRG/20120516_FDF_CRG_c12.mtb	3699	635	WWFF	food_fat	3	1910	1337165189	1	0.600000000000001	0.00869565217391306	6251	1
2	Food 2	Intake 4	18	2632	1337165911	/users/cn/jespinosa/phecomp/data/CRG/20120502_FDF_CRG/20120502_FDF_CRG/20120516_FDF_CRG_c12.mtb	5427	7706	WWFF	food_fat	4	2614	1337165893	1	0.02	0.00111111111111111	6252	1
2	Drink 2	Intake 2	66	2719	1337165998	/users/cn/jespinosa/phecomp/data/CRG/20120502_FDF_CRG/20120502_FDF_CRG/20120516_FDF_CRG_c12.mtb	1579	NA	WWFF	water	2	2653	1337165932	1	0.02	0.000303030303030303	6253	1
2	Drink 2	Intake 2	14	8753	1337172032	/users/cn/jespinosa/phecomp/data/CRG/20120502_FDF_CRG/20120502_FDF_CRG/20120516_FDF_CRG_c12.mtb	1580	NA	WWFF	water	2	8739	1337172018	1	0.04	0.00285714285714286	6254	1
2	Food 1	Intake 3	14	10352	1337173631	/users/cn/jespinosa/phecomp/data/CRG/20120502_FDF_CRG/20120502_FDF_CRG/20120516_FDF_CRG_c12.mtb	3701	12870	WWFF	food_fat	3	10338	1337173617	1	0.04	0.00285714285714286	6255	1
2	Drink 2	Intake 2	11	10409	1337173688	/users/cn/jespinosa/phecomp/data/CRG/20120502_FDF_CRG/20120502_FDF_CRG/20120516_FDF_CRG_c12.mtb	1581	NA	WWFF	water	2	10398	1337173677	1	0.04	0.00363636363636364	6256	1
2	Drink 1	Intake 1	26	11033	1337174312	/users/cn/jespinosa/phecomp/data/CRG/20120502_FDF_CRG/20120502_FDF_CRG/20120516_FDF_CRG_c12.mtb	1094	NA	WWFF	water	1	11007	1337174286	1	0.08	0.00307692307692308	6257	1
2	Food 1	Intake 3	15	23237	1337186516	/users/cn/jespinosa/phecomp/data/CRG/20120502_FDF_CRG/20120502_FDF_CRG/20120516_FDF_CRG_c12.mtb	3703	1598	WWFF	food_fat	3	23222	1337186501	1	0.0200000000000005	0.00133333333333337	6258	1
2	Food 1	Intake 3	17	24852	1337188131	/users/cn/jespinosa/phecomp/data/CRG/20120502_FDF_CRG/20120502_FDF_CRG/20120516_FDF_CRG_c12.mtb	3704	1532	WWFF	food_fat	3	24835	1337188114	1	0.04	0.00235294117647059	6259	1
2	Food 1	Intake 3	9	26393	1337189672	/users/cn/jespinosa/phecomp/data/CRG/20120502_FDF_CRG/20120502_FDF_CRG/20120516_FDF_CRG_c12.mtb	3705	3605	WWFF	food_fat	3	26384	1337189663	1	0.04	0.00444444444444444	6260	1
2	Drink 2	Intake 2	20	27818	1337191097	/users/cn/jespinosa/phecomp/data/CRG/20120502_FDF_CRG/20120502_FDF_CRG/20120516_FDF_CRG_c12.mtb	1583	NA	WWFF	water	2	27798	1337191077	1	0.1	0.005	6261	1
2	Drink 2	Intake 2	16	29856	1337193135	/users/cn/jespinosa/phecomp/data/CRG/20120502_FDF_CRG/20120502_FDF_CRG/20120516_FDF_CRG_c12.mtb	1584	NA	WWFF	water	2	29840	1337193119	1	0.08	0.005	6262	1
2	Food 1	Intake 3	15	30013	1337193292	/users/cn/jespinosa/phecomp/data/CRG/20120502_FDF_CRG/20120502_FDF_CRG/20120516_FDF_CRG_c12.mtb	3707	744	WWFF	food_fat	3	29998	1337193277	1	0.0599999999999996	0.00399999999999997	6263	1
2	Drink 2	Intake 2	43	30592	1337193871	/users/cn/jespinosa/phecomp/data/CRG/20120502_FDF_CRG/20120502_FDF_CRG/20120516_FDF_CRG_c12.mtb	1585	NA	WWFF	water	2	30549	1337193828	1	0.1	0.00232558139534884	6264	1
2	Food 1	Intake 3	12	30769	1337194048	/users/cn/jespinosa/phecomp/data/CRG/20120502_FDF_CRG/20120502_FDF_CRG/20120516_FDF_CRG_c12.mtb	3709	3074	WWFF	food_fat	3	30757	1337194036	1	0.04	0.00333333333333333	6265	1
2	Drink 2	Intake 2	18	31214	1337194493	/users/cn/jespinosa/phecomp/data/CRG/20120502_FDF_CRG/20120502_FDF_CRG/20120516_FDF_CRG_c12.mtb	1586	NA	WWFF	water	2	31196	1337194475	1	0.08	0.00444444444444444	6266	1
2	Drink 2	Intake 2	20	33702	1337196981	/users/cn/jespinosa/phecomp/data/CRG/20120502_FDF_CRG/20120502_FDF_CRG/20120516_FDF_CRG_c12.mtb	1587	NA	WWFF	water	2	33682	1337196961	1	0.0599999999999999	0.00299999999999999	6267	1
2	Food 1	Intake 3	27	33870	1337197149	/users/cn/jespinosa/phecomp/data/CRG/20120502_FDF_CRG/20120502_FDF_CRG/20120516_FDF_CRG_c12.mtb	3710	10	WWFF	food_fat	3	33843	1337197122	1	0.04	0.00148148148148148	6268	1
2	Food 1	Intake 3	12	33892	1337197171	/users/cn/jespinosa/phecomp/data/CRG/20120502_FDF_CRG/20120502_FDF_CRG/20120516_FDF_CRG_c12.mtb	3711	2636	WWFF	food_fat	3	33880	1337197159	1	0.04	0.00333333333333333	6269	1
2	Drink 2	Intake 2	13	34841	1337198120	/users/cn/jespinosa/phecomp/data/CRG/20120502_FDF_CRG/20120502_FDF_CRG/20120516_FDF_CRG_c12.mtb	1588	NA	WWFF	water	2	34828	1337198107	1	0.02	0.00153846153846154	6270	1
2	Drink 2	Intake 2	19	35345	1337198624	/users/cn/jespinosa/phecomp/data/CRG/20120502_FDF_CRG/20120502_FDF_CRG/20120516_FDF_CRG_c12.mtb	1589	NA	WWFF	water	2	35326	1337198605	1	0.0600000000000001	0.00315789473684211	6271	1
2	Food 1	Intake 3	14	36542	1337199821	/users/cn/jespinosa/phecomp/data/CRG/20120502_FDF_CRG/20120502_FDF_CRG/20120516_FDF_CRG_c12.mtb	3713	439	WWFF	food_fat	3	36528	1337199807	1	0.0600000000000005	0.00428571428571432	6272	1
2	Food 1	Intake 3	77	37058	1337200337	/users/cn/jespinosa/phecomp/data/CRG/20120502_FDF_CRG/20120502_FDF_CRG/20120516_FDF_CRG_c12.mtb	3714	37	WWFF	food_fat	3	36981	1337200260	1	0.16	0.00207792207792208	6273	1
2	Food 2	Intake 4	149	37244	1337200523	/users/cn/jespinosa/phecomp/data/CRG/20120502_FDF_CRG/20120502_FDF_CRG/20120516_FDF_CRG_c12.mtb	5434	498	WWFF	food_fat	4	37095	1337200374	1	0.08	0.000536912751677852	6274	1
2	Food 1	Intake 3	33	37775	1337201054	/users/cn/jespinosa/phecomp/data/CRG/20120502_FDF_CRG/20120502_FDF_CRG/20120516_FDF_CRG_c12.mtb	3717	75	WWFF	food_fat	3	37742	1337201021	1	0.119999999999999	0.00363636363636361	6275	1
2	Drink 2	Intake 2	26	37851	1337201130	/users/cn/jespinosa/phecomp/data/CRG/20120502_FDF_CRG/20120502_FDF_CRG/20120516_FDF_CRG_c12.mtb	1591	NA	WWFF	water	2	37825	1337201104	1	0.08	0.00307692307692308	6276	1
2	Food 1	Intake 3	52	37902	1337201181	/users/cn/jespinosa/phecomp/data/CRG/20120502_FDF_CRG/20120502_FDF_CRG/20120516_FDF_CRG_c12.mtb	3718	COLL	WWFF	food_fat	3	37850	1337201129	1	0.0600000000000005	0.00115384615384616	6277	1
2	Food 2	Intake 4	57	37950	1337201229	/users/cn/jespinosa/phecomp/data/CRG/20120502_FDF_CRG/20120502_FDF_CRG/20120516_FDF_CRG_c12.mtb	5437	11	WWFF	food_fat	4	37893	1337201172	1	0.02	0.000350877192982456	6278	1
2	Food 2	Intake 4	42	38003	1337201282	/users/cn/jespinosa/phecomp/data/CRG/20120502_FDF_CRG/20120502_FDF_CRG/20120516_FDF_CRG_c12.mtb	5438	204	WWFF	food_fat	4	37961	1337201240	1	0.08	0.0019047619047619	6279	1
2	Food 2	Intake 4	55	38262	1337201541	/users/cn/jespinosa/phecomp/data/CRG/20120502_FDF_CRG/20120502_FDF_CRG/20120516_FDF_CRG_c12.mtb	5441	7	WWFF	food_fat	4	38207	1337201486	1	0.02	0.000363636363636364	6280	1
2	Food 1	Intake 3	141	38410	1337201689	/users/cn/jespinosa/phecomp/data/CRG/20120502_FDF_CRG/20120502_FDF_CRG/20120516_FDF_CRG_c12.mtb	3719	2172	WWFF	food_fat	3	38269	1337201548	1	1.66	0.0117730496453901	6281	1
2	Drink 2	Intake 2	47	38553	1337201832	/users/cn/jespinosa/phecomp/data/CRG/20120502_FDF_CRG/20120502_FDF_CRG/20120516_FDF_CRG_c12.mtb	1592	NA	WWFF	water	2	38506	1337201785	1	0.04	0.000851063829787234	6282	1
2	Drink 1	Intake 1	13	38987	1337202266	/users/cn/jespinosa/phecomp/data/CRG/20120502_FDF_CRG/20120502_FDF_CRG/20120516_FDF_CRG_c12.mtb	1095	NA	WWFF	water	1	38974	1337202253	1	0.02	0.00153846153846154	6283	1
2	Food 2	Intake 4	101	40683	1337203962	/users/cn/jespinosa/phecomp/data/CRG/20120502_FDF_CRG/20120502_FDF_CRG/20120516_FDF_CRG_c12.mtb	5445	4437	WWFF	food_fat	4	40582	1337203861	1	0.1	0.00099009900990099	6284	1
2	Food 2	Intake 4	94	45214	1337208493	/users/cn/jespinosa/phecomp/data/CRG/20120502_FDF_CRG/20120502_FDF_CRG/20120516_FDF_CRG_c12.mtb	5448	310	WWFF	food_fat	4	45120	1337208399	1	0.0600000000000001	0.000638297872340427	6285	1
2	Drink 2	Intake 2	16	45382	1337208661	/users/cn/jespinosa/phecomp/data/CRG/20120502_FDF_CRG/20120502_FDF_CRG/20120516_FDF_CRG_c12.mtb	1596	NA	WWFF	water	2	45366	1337208645	1	0.04	0.0025	6286	1
2	Food 2	Intake 4	91	45615	1337208894	/users/cn/jespinosa/phecomp/data/CRG/20120502_FDF_CRG/20120502_FDF_CRG/20120516_FDF_CRG_c12.mtb	5450	1587	WWFF	food_fat	4	45524	1337208803	1	0.02	0.00021978021978022	6287	1
2	Drink 2	Intake 2	17	46309	1337209588	/users/cn/jespinosa/phecomp/data/CRG/20120502_FDF_CRG/20120502_FDF_CRG/20120516_FDF_CRG_c12.mtb	1598	NA	WWFF	water	2	46292	1337209571	1	0.0600000000000001	0.00352941176470589	6288	1
2	Food 1	Intake 3	21	47223	1337210502	/users/cn/jespinosa/phecomp/data/CRG/20120502_FDF_CRG/20120502_FDF_CRG/20120516_FDF_CRG_c12.mtb	3724	6	WWFF	food_fat	3	47202	1337210481	1	0.0800000000000001	0.00380952380952381	6289	1
2	Food 1	Intake 3	23	47252	1337210531	/users/cn/jespinosa/phecomp/data/CRG/20120502_FDF_CRG/20120502_FDF_CRG/20120516_FDF_CRG_c12.mtb	3725	713	WWFF	food_fat	3	47229	1337210508	1	0.0600000000000005	0.00260869565217393	6290	1
2	Food 2	Intake 4	28	47993	1337211272	/users/cn/jespinosa/phecomp/data/CRG/20120502_FDF_CRG/20120502_FDF_CRG/20120516_FDF_CRG_c12.mtb	5455	96	WWFF	food_fat	4	47965	1337211244	1	0.1	0.00357142857142857	6291	1
2	Food 2	Intake 4	71	48160	1337211439	/users/cn/jespinosa/phecomp/data/CRG/20120502_FDF_CRG/20120502_FDF_CRG/20120516_FDF_CRG_c12.mtb	5456	4806	WWFF	food_fat	4	48089	1337211368	1	0.42	0.00591549295774648	6292	1
2	Drink 2	Intake 2	22	49437	1337212716	/users/cn/jespinosa/phecomp/data/CRG/20120502_FDF_CRG/20120502_FDF_CRG/20120516_FDF_CRG_c12.mtb	1600	NA	WWFF	water	2	49415	1337212694	1	0.02	0.000909090909090909	6293	1
2	Drink 1	Intake 1	18	52597	1337215876	/users/cn/jespinosa/phecomp/data/CRG/20120502_FDF_CRG/20120502_FDF_CRG/20120516_FDF_CRG_c12.mtb	1096	NA	WWFF	water	1	52579	1337215858	1	0.04	0.00222222222222222	6294	1
2	Drink 2	Intake 2	22	52955	1337216234	/users/cn/jespinosa/phecomp/data/CRG/20120502_FDF_CRG/20120502_FDF_CRG/20120516_FDF_CRG_c12.mtb	1601	NA	WWFF	water	2	52933	1337216212	1	0.02	0.000909090909090909	6295	1
2	Food 2	Intake 4	73	53039	1337216318	/users/cn/jespinosa/phecomp/data/CRG/20120502_FDF_CRG/20120502_FDF_CRG/20120516_FDF_CRG_c12.mtb	5458	354	WWFF	food_fat	4	52966	1337216245	1	0.04	0.000547945205479452	6296	1
2	Drink 2	Intake 2	16	53167	1337216446	/users/cn/jespinosa/phecomp/data/CRG/20120502_FDF_CRG/20120502_FDF_CRG/20120516_FDF_CRG_c12.mtb	1602	NA	WWFF	water	2	53151	1337216430	1	0.04	0.0025	6297	1
2	Drink 2	Intake 2	29	53357	1337216636	/users/cn/jespinosa/phecomp/data/CRG/20120502_FDF_CRG/20120502_FDF_CRG/20120516_FDF_CRG_c12.mtb	1603	NA	WWFF	water	2	53328	1337216607	1	0.0800000000000001	0.00275862068965518	6298	1
2	Food 2	Intake 4	133	53526	1337216805	/users/cn/jespinosa/phecomp/data/CRG/20120502_FDF_CRG/20120502_FDF_CRG/20120516_FDF_CRG_c12.mtb	5460	9581	WWFF	food_fat	4	53393	1337216672	1	0.04	0.000300751879699248	6299	1
2	Drink 1	Intake 1	20	57061	1337220340	/users/cn/jespinosa/phecomp/data/CRG/20120502_FDF_CRG/20120502_FDF_CRG/20120516_FDF_CRG_c12.mtb	1100	NA	WWFF	water	1	57041	1337220320	1	0.02	0.001	6300	1
2	Drink 2	Intake 2	10	57129	1337220408	/users/cn/jespinosa/phecomp/data/CRG/20120502_FDF_CRG/20120502_FDF_CRG/20120516_FDF_CRG_c12.mtb	1606	NA	WWFF	water	2	57119	1337220398	1	0.02	0.002	6301	1
2	Food 2	Intake 4	33	63140	1337226419	/users/cn/jespinosa/phecomp/data/CRG/20120502_FDF_CRG/20120502_FDF_CRG/20120516_FDF_CRG_c12.mtb	5462	3624	WWFF	food_fat	4	63107	1337226386	1	0.02	0.000606060606060606	6302	1
2	Drink 2	Intake 2	42	63757	1337227036	/users/cn/jespinosa/phecomp/data/CRG/20120502_FDF_CRG/20120502_FDF_CRG/20120516_FDF_CRG_c12.mtb	1607	NA	WWFF	water	2	63715	1337226994	1	0.0999999999999999	0.00238095238095238	6303	1
2	Drink 2	Intake 2	12	64158	1337227437	/users/cn/jespinosa/phecomp/data/CRG/20120502_FDF_CRG/20120502_FDF_CRG/20120516_FDF_CRG_c12.mtb	1609	NA	WWFF	water	2	64146	1337227425	1	0.02	0.00166666666666667	6304	1
2	Drink 2	Intake 2	15	64770	1337228049	/users/cn/jespinosa/phecomp/data/CRG/20120502_FDF_CRG/20120502_FDF_CRG/20120516_FDF_CRG_c12.mtb	1610	NA	WWFF	water	2	64755	1337228034	1	0.0600000000000001	0.00400000000000001	6305	1
2	Drink 2	Intake 2	22	64824	1337228103	/users/cn/jespinosa/phecomp/data/CRG/20120502_FDF_CRG/20120502_FDF_CRG/20120516_FDF_CRG_c12.mtb	1611	NA	WWFF	water	2	64802	1337228081	1	0.0599999999999998	0.00272727272727272	6306	1
2	Food 2	Intake 4	11	66775	1337230054	/users/cn/jespinosa/phecomp/data/CRG/20120502_FDF_CRG/20120502_FDF_CRG/20120516_FDF_CRG_c12.mtb	5468	16	WWFF	food_fat	4	66764	1337230043	1	0.02	0.00181818181818182	6307	1
2	Food 2	Intake 4	39	66830	1337230109	/users/cn/jespinosa/phecomp/data/CRG/20120502_FDF_CRG/20120502_FDF_CRG/20120516_FDF_CRG_c12.mtb	5469	334	WWFF	food_fat	4	66791	1337230070	1	0.02	0.000512820512820513	6308	1
2	Drink 2	Intake 2	12	67145	1337230424	/users/cn/jespinosa/phecomp/data/CRG/20120502_FDF_CRG/20120502_FDF_CRG/20120516_FDF_CRG_c12.mtb	1612	NA	WWFF	water	2	67133	1337230412	1	0.02	0.00166666666666667	6309	1
2	Food 2	Intake 4	94	67258	1337230537	/users/cn/jespinosa/phecomp/data/CRG/20120502_FDF_CRG/20120502_FDF_CRG/20120516_FDF_CRG_c12.mtb	5470	611	WWFF	food_fat	4	67164	1337230443	1	0.04	0.000425531914893617	6310	1
2	Drink 2	Intake 2	20	67729	1337231008	/users/cn/jespinosa/phecomp/data/CRG/20120502_FDF_CRG/20120502_FDF_CRG/20120516_FDF_CRG_c12.mtb	1613	NA	WWFF	water	2	67709	1337230988	1	0.0600000000000001	0.00300000000000001	6311	1
2	Food 2	Intake 4	120	67989	1337231268	/users/cn/jespinosa/phecomp/data/CRG/20120502_FDF_CRG/20120502_FDF_CRG/20120516_FDF_CRG_c12.mtb	5474	1453	WWFF	food_fat	4	67869	1337231148	1	0.02	0.000166666666666667	6312	1
2	Drink 2	Intake 2	14	68439	1337231718	/users/cn/jespinosa/phecomp/data/CRG/20120502_FDF_CRG/20120502_FDF_CRG/20120516_FDF_CRG_c12.mtb	1614	NA	WWFF	water	2	68425	1337231704	1	0.02	0.00142857142857143	6313	1
2	Food 1	Intake 3	39	69481	1337232760	/users/cn/jespinosa/phecomp/data/CRG/20120502_FDF_CRG/20120502_FDF_CRG/20120516_FDF_CRG_c12.mtb	3739	33	WWFF	food_fat	3	69442	1337232721	1	0.0600000000000005	0.00153846153846155	6314	1
2	Food 1	Intake 3	20	69534	1337232813	/users/cn/jespinosa/phecomp/data/CRG/20120502_FDF_CRG/20120502_FDF_CRG/20120516_FDF_CRG_c12.mtb	3740	29	WWFF	food_fat	3	69514	1337232793	1	0.159999999999998	0.0079999999999999	6315	1
2	Food 2	Intake 4	36	69599	1337232878	/users/cn/jespinosa/phecomp/data/CRG/20120502_FDF_CRG/20120502_FDF_CRG/20120516_FDF_CRG_c12.mtb	5477	6254	WWFF	food_fat	4	69563	1337232842	1	0.02	0.000555555555555556	6316	1
2	Drink 2	Intake 2	32	69645	1337232924	/users/cn/jespinosa/phecomp/data/CRG/20120502_FDF_CRG/20120502_FDF_CRG/20120516_FDF_CRG_c12.mtb	1615	NA	WWFF	water	2	69613	1337232892	1	0.02	0.000625	6317	1
2	Food 1	Intake 3	36	75889	1337239168	/users/cn/jespinosa/phecomp/data/CRG/20120502_FDF_CRG/20120502_FDF_CRG/20120516_FDF_CRG_c12.mtb	3743	7669	WWFF	food_fat	3	75853	1337239132	1	0.120000000000001	0.00333333333333336	6318	1
2	Drink 2	Intake 2	24	82060	1337245339	/users/cn/jespinosa/phecomp/data/CRG/20120502_FDF_CRG/20120502_FDF_CRG/20120516_FDF_CRG_c12.mtb	1616	NA	WWFF	water	2	82036	1337245315	1	0.12	0.005	6319	1
2	Food 1	Intake 3	13	83571	1337246850	/users/cn/jespinosa/phecomp/data/CRG/20120502_FDF_CRG/20120502_FDF_CRG/20120516_FDF_CRG_c12.mtb	3745	27911	WWFF	food_fat	3	83558	1337246837	1	0.0400000000000009	0.00307692307692315	6320	1
2	Drink 2	Intake 2	20	84071	1337247350	/users/cn/jespinosa/phecomp/data/CRG/20120502_FDF_CRG/20120502_FDF_CRG/20120516_FDF_CRG_c12.mtb	1617	NA	WWFF	water	2	84051	1337247330	1	0.0800000000000001	0.00400000000000001	6321	1
2	Drink 2	Intake 2	9	85393	1337248672	/users/cn/jespinosa/phecomp/data/CRG/20120502_FDF_CRG/20120502_FDF_CRG/20120516_FDF_CRG_c12.mtb	1619	NA	WWFF	water	2	85384	1337248663	1	0.04	0.00444444444444444	6322	1
2	Drink 2	Intake 2	24	103859	1337267138	/users/cn/jespinosa/phecomp/data/CRG/20120502_FDF_CRG/20120502_FDF_CRG/20120516_FDF_CRG_c12.mtb	1625	NA	WWFF	water	2	103835	1337267114	1	0.12	0.005	6323	1
2	Drink 1	Intake 1	34	103921	1337267200	/users/cn/jespinosa/phecomp/data/CRG/20120502_FDF_CRG/20120502_FDF_CRG/20120516_FDF_CRG_c12.mtb	1101	NA	WWFF	water	1	103887	1337267166	1	0.04	0.00117647058823529	6324	1
2	Food 1	Intake 3	21	111503	1337274782	/users/cn/jespinosa/phecomp/data/CRG/20120502_FDF_CRG/20120502_FDF_CRG/20120516_FDF_CRG_c12.mtb	3753	2867	WWFF	food_fat	3	111482	1337274761	1	0.0999999999999996	0.00476190476190474	6325	1
2	Drink 2	Intake 2	38	112632	1337275911	/users/cn/jespinosa/phecomp/data/CRG/20120502_FDF_CRG/20120502_FDF_CRG/20120516_FDF_CRG_c12.mtb	1626	NA	WWFF	water	2	112594	1337275873	1	0.16	0.00421052631578947	6326	1
2	Food 1	Intake 3	15	114385	1337277664	/users/cn/jespinosa/phecomp/data/CRG/20120502_FDF_CRG/20120502_FDF_CRG/20120516_FDF_CRG_c12.mtb	3754	1129	WWFF	food_fat	3	114370	1337277649	1	0.540000000000001	0.0360000000000001	6327	1
2	Drink 1	Intake 1	13	115254	1337278533	/users/cn/jespinosa/phecomp/data/CRG/20120502_FDF_CRG/20120502_FDF_CRG/20120516_FDF_CRG_c12.mtb	1102	NA	WWFF	water	1	115241	1337278520	1	0.02	0.00153846153846154	6328	1
2	Food 2	Intake 4	25	115539	1337278818	/users/cn/jespinosa/phecomp/data/CRG/20120502_FDF_CRG/20120502_FDF_CRG/20120516_FDF_CRG_c12.mtb	5482	946	WWFF	food_fat	4	115514	1337278793	1	0.22	0.0088	6329	1
2	Drink 2	Intake 2	33	115627	1337278906	/users/cn/jespinosa/phecomp/data/CRG/20120502_FDF_CRG/20120502_FDF_CRG/20120516_FDF_CRG_c12.mtb	1627	NA	WWFF	water	2	115594	1337278873	1	0.04	0.00121212121212121	6330	1
2	Drink 2	Intake 2	13	115765	1337279044	/users/cn/jespinosa/phecomp/data/CRG/20120502_FDF_CRG/20120502_FDF_CRG/20120516_FDF_CRG_c12.mtb	1628	NA	WWFF	water	2	115752	1337279031	1	0.02	0.00153846153846154	6331	1
2	Food 1	Intake 3	20	116505	1337279784	/users/cn/jespinosa/phecomp/data/CRG/20120502_FDF_CRG/20120502_FDF_CRG/20120516_FDF_CRG_c12.mtb	3759	10814	WWFF	food_fat	3	116485	1337279764	1	0.0399999999999991	0.00199999999999995	6332	1
2	Drink 1	Intake 1	17	116821	1337280100	/users/cn/jespinosa/phecomp/data/CRG/20120502_FDF_CRG/20120502_FDF_CRG/20120516_FDF_CRG_c12.mtb	1103	NA	WWFF	water	1	116804	1337280083	1	0.06	0.00352941176470588	6333	1
2	Drink 2	Intake 2	22	117494	1337280773	/users/cn/jespinosa/phecomp/data/CRG/20120502_FDF_CRG/20120502_FDF_CRG/20120516_FDF_CRG_c12.mtb	1630	NA	WWFF	water	2	117472	1337280751	1	0.04	0.00181818181818182	6334	1
2	Drink 1	Intake 1	17	119304	1337282583	/users/cn/jespinosa/phecomp/data/CRG/20120502_FDF_CRG/20120502_FDF_CRG/20120516_FDF_CRG_c12.mtb	1104	NA	WWFF	water	1	119287	1337282566	1	0.02	0.00117647058823529	6335	1
2	Drink 2	Intake 2	89	126879	1337290158	/users/cn/jespinosa/phecomp/data/CRG/20120502_FDF_CRG/20120502_FDF_CRG/20120516_FDF_CRG_c12.mtb	1634	NA	WWFF	water	2	126790	1337290069	1	0.0600000000000001	0.000674157303370788	6336	1
2	Food 1	Intake 3	103	127422	1337290701	/users/cn/jespinosa/phecomp/data/CRG/20120502_FDF_CRG/20120502_FDF_CRG/20120516_FDF_CRG_c12.mtb	3769	2849	WWFF	food_fat	3	127319	1337290598	1	0.0600000000000005	0.000582524271844665	6337	1
2	Drink 2	Intake 2	15	129330	1337292609	/users/cn/jespinosa/phecomp/data/CRG/20120502_FDF_CRG/20120502_FDF_CRG/20120516_FDF_CRG_c12.mtb	1637	NA	WWFF	water	2	129315	1337292594	1	0.04	0.00266666666666667	6338	1
2	Drink 2	Intake 2	15	129529	1337292808	/users/cn/jespinosa/phecomp/data/CRG/20120502_FDF_CRG/20120502_FDF_CRG/20120516_FDF_CRG_c12.mtb	1638	NA	WWFF	water	2	129514	1337292793	1	0.0399999999999996	0.00266666666666664	6339	1
2	Food 1	Intake 3	17	130288	1337293567	/users/cn/jespinosa/phecomp/data/CRG/20120502_FDF_CRG/20120502_FDF_CRG/20120516_FDF_CRG_c12.mtb	3772	286	WWFF	food_fat	3	130271	1337293550	1	0.0999999999999996	0.00588235294117645	6340	1
2	Food 2	Intake 4	39	130613	1337293892	/users/cn/jespinosa/phecomp/data/CRG/20120502_FDF_CRG/20120502_FDF_CRG/20120516_FDF_CRG_c12.mtb	5499	22861	WWFF	food_fat	4	130574	1337293853	1	0.02	0.000512820512820513	6341	1
2	Drink 2	Intake 2	15	133257	1337296536	/users/cn/jespinosa/phecomp/data/CRG/20120502_FDF_CRG/20120502_FDF_CRG/20120516_FDF_CRG_c12.mtb	1640	NA	WWFF	water	2	133242	1337296521	1	0.0200000000000005	0.00133333333333337	6342	1
2	Drink 2	Intake 2	14	134729	1337298008	/users/cn/jespinosa/phecomp/data/CRG/20120502_FDF_CRG/20120502_FDF_CRG/20120516_FDF_CRG_c12.mtb	1641	NA	WWFF	water	2	134715	1337297994	1	0.0599999999999996	0.00428571428571426	6343	1
2	Drink 2	Intake 2	15	136450	1337299729	/users/cn/jespinosa/phecomp/data/CRG/20120502_FDF_CRG/20120502_FDF_CRG/20120516_FDF_CRG_c12.mtb	1644	NA	WWFF	water	2	136435	1337299714	1	0.04	0.00266666666666667	6344	1
2	Drink 2	Intake 2	15	136703	1337299982	/users/cn/jespinosa/phecomp/data/CRG/20120502_FDF_CRG/20120502_FDF_CRG/20120516_FDF_CRG_c12.mtb	1645	NA	WWFF	water	2	136688	1337299967	1	0.02	0.00133333333333333	6345	1
2	Drink 2	Intake 2	33	144311	1337307590	/users/cn/jespinosa/phecomp/data/CRG/20120502_FDF_CRG/20120502_FDF_CRG/20120516_FDF_CRG_c12.mtb	1646	NA	WWFF	water	2	144278	1337307557	1	0.1	0.00303030303030303	6346	1
2	Drink 2	Intake 2	25	145310	1337308589	/users/cn/jespinosa/phecomp/data/CRG/20120502_FDF_CRG/20120502_FDF_CRG/20120516_FDF_CRG_c12.mtb	1648	NA	WWFF	water	2	145285	1337308564	1	0.1	0.004	6347	1
2	Drink 2	Intake 2	20	151251	1337314530	/users/cn/jespinosa/phecomp/data/CRG/20120502_FDF_CRG/20120502_FDF_CRG/20120516_FDF_CRG_c12.mtb	1649	NA	WWFF	water	2	151231	1337314510	1	0.0600000000000001	0.00300000000000001	6348	1
2	Drink 1	Intake 1	15	151625	1337314904	/users/cn/jespinosa/phecomp/data/CRG/20120502_FDF_CRG/20120502_FDF_CRG/20120516_FDF_CRG_c12.mtb	1114	NA	WWFF	water	1	151610	1337314889	1	0.02	0.00133333333333333	6349	1
2	Drink 1	Intake 1	19	151905	1337315184	/users/cn/jespinosa/phecomp/data/CRG/20120502_FDF_CRG/20120502_FDF_CRG/20120516_FDF_CRG_c12.mtb	1115	NA	WWFF	water	1	151886	1337315165	1	0.06	0.00315789473684211	6350	1
2	Drink 2	Intake 2	12	151993	1337315272	/users/cn/jespinosa/phecomp/data/CRG/20120502_FDF_CRG/20120502_FDF_CRG/20120516_FDF_CRG_c12.mtb	1650	NA	WWFF	water	2	151981	1337315260	1	0.04	0.00333333333333333	6351	1
2	Food 2	Intake 4	174	153648	1337316927	/users/cn/jespinosa/phecomp/data/CRG/20120502_FDF_CRG/20120502_FDF_CRG/20120516_FDF_CRG_c12.mtb	5513	323	WWFF	food_fat	4	153474	1337316753	1	0.02	0.000114942528735632	6352	1
2	Food 2	Intake 4	80	154051	1337317330	/users/cn/jespinosa/phecomp/data/CRG/20120502_FDF_CRG/20120502_FDF_CRG/20120516_FDF_CRG_c12.mtb	5514	897	WWFF	food_fat	4	153971	1337317250	1	0.02	0.00025	6353	1
2	Drink 2	Intake 2	12	154399	1337317678	/users/cn/jespinosa/phecomp/data/CRG/20120502_FDF_CRG/20120502_FDF_CRG/20120516_FDF_CRG_c12.mtb	1651	NA	WWFF	water	2	154387	1337317666	1	0.04	0.00333333333333333	6354	1
2	Food 2	Intake 4	116	155064	1337318343	/users/cn/jespinosa/phecomp/data/CRG/20120502_FDF_CRG/20120502_FDF_CRG/20120516_FDF_CRG_c12.mtb	5518	72	WWFF	food_fat	4	154948	1337318227	1	0.04	0.000344827586206897	6355	1
2	Food 2	Intake 4	75	155211	1337318490	/users/cn/jespinosa/phecomp/data/CRG/20120502_FDF_CRG/20120502_FDF_CRG/20120516_FDF_CRG_c12.mtb	5519	542	WWFF	food_fat	4	155136	1337318415	1	0.02	0.000266666666666667	6356	1
2	Drink 2	Intake 2	14	155286	1337318565	/users/cn/jespinosa/phecomp/data/CRG/20120502_FDF_CRG/20120502_FDF_CRG/20120516_FDF_CRG_c12.mtb	1652	NA	WWFF	water	2	155272	1337318551	1	0.04	0.00285714285714286	6357	1
2	Food 2	Intake 4	95	155848	1337319127	/users/cn/jespinosa/phecomp/data/CRG/20120502_FDF_CRG/20120502_FDF_CRG/20120516_FDF_CRG_c12.mtb	5521	31501	WWFF	food_fat	4	155753	1337319032	1	0.02	0.000210526315789474	6358	1
2	Drink 2	Intake 2	25	157129	1337320408	/users/cn/jespinosa/phecomp/data/CRG/20120502_FDF_CRG/20120502_FDF_CRG/20120516_FDF_CRG_c12.mtb	1655	NA	WWFF	water	2	157104	1337320383	1	0.1	0.004	6359	1
2	Drink 2	Intake 2	25	6400	1337338915	/users/cn/jespinosa/phecomp/data/CRG/20120502_FDF_CRG/20120502_FDF_CRG/20120518_FDF_CRG_c12.mtb	1659	NA	WWFF	water	2	6375	1337338890	1	0.08	0.0032	6360	1
2	Drink 2	Intake 2	23	12989	1337345504	/users/cn/jespinosa/phecomp/data/CRG/20120502_FDF_CRG/20120502_FDF_CRG/20120518_FDF_CRG_c12.mtb	1660	NA	WWFF	water	2	12966	1337345481	1	0.12	0.00521739130434783	6361	1
2	Drink 2	Intake 2	22	18098	1337350613	/users/cn/jespinosa/phecomp/data/CRG/20120502_FDF_CRG/20120502_FDF_CRG/20120518_FDF_CRG_c12.mtb	1661	NA	WWFF	water	2	18076	1337350591	1	0.06	0.00272727272727273	6362	1
2	Food 1	Intake 3	91	18204	1337350719	/users/cn/jespinosa/phecomp/data/CRG/20120502_FDF_CRG/20120502_FDF_CRG/20120518_FDF_CRG_c12.mtb	3795	COLL	WWFF	food_fat	3	18113	1337350628	1	0.5	0.00549450549450549	6363	1
2	Food 2	Intake 4	65	18261	1337350776	/users/cn/jespinosa/phecomp/data/CRG/20120502_FDF_CRG/20120502_FDF_CRG/20120518_FDF_CRG_c12.mtb	5522	18	WWFF	food_fat	4	18196	1337350711	1	0.32	0.00492307692307692	6364	1
2	Food 1	Intake 3	31	18310	1337350825	/users/cn/jespinosa/phecomp/data/CRG/20120502_FDF_CRG/20120502_FDF_CRG/20120518_FDF_CRG_c12.mtb	3796	21	WWFF	food_fat	3	18279	1337350794	1	0.34	0.0109677419354839	6365	1
2	Drink 2	Intake 2	21	18328	1337350843	/users/cn/jespinosa/phecomp/data/CRG/20120502_FDF_CRG/20120502_FDF_CRG/20120518_FDF_CRG_c12.mtb	1662	NA	WWFF	water	2	18307	1337350822	1	0.04	0.0019047619047619	6366	1
2	Food 2	Intake 4	84	18415	1337350930	/users/cn/jespinosa/phecomp/data/CRG/20120502_FDF_CRG/20120502_FDF_CRG/20120518_FDF_CRG_c12.mtb	5523	394	WWFF	food_fat	4	18331	1337350846	1	0.2	0.00238095238095238	6367	1
2	Drink 1	Intake 1	18	18589	1337351104	/users/cn/jespinosa/phecomp/data/CRG/20120502_FDF_CRG/20120502_FDF_CRG/20120518_FDF_CRG_c12.mtb	1118	NA	WWFF	water	1	18571	1337351086	1	0.06	0.00333333333333333	6368	1
2	Food 1	Intake 3	14	18823	1337351338	/users/cn/jespinosa/phecomp/data/CRG/20120502_FDF_CRG/20120502_FDF_CRG/20120518_FDF_CRG_c12.mtb	3798	16	WWFF	food_fat	3	18809	1337351324	1	0.02	0.00142857142857143	6369	1
2	Food 2	Intake 4	50	18889	1337351404	/users/cn/jespinosa/phecomp/data/CRG/20120502_FDF_CRG/20120502_FDF_CRG/20120518_FDF_CRG_c12.mtb	5524	11	WWFF	food_fat	4	18839	1337351354	1	0.46	0.0092	6370	1
2	Food 2	Intake 4	50	18950	1337351465	/users/cn/jespinosa/phecomp/data/CRG/20120502_FDF_CRG/20120502_FDF_CRG/20120518_FDF_CRG_c12.mtb	5525	COLL	WWFF	food_fat	4	18900	1337351415	1	0.4	0.008	6371	1
2	Food 1	Intake 3	29	18968	1337351483	/users/cn/jespinosa/phecomp/data/CRG/20120502_FDF_CRG/20120502_FDF_CRG/20120518_FDF_CRG_c12.mtb	3800	31	WWFF	food_fat	3	18939	1337351454	1	0.0600000000000001	0.00206896551724138	6372	1
2	Drink 2	Intake 2	18	18999	1337351514	/users/cn/jespinosa/phecomp/data/CRG/20120502_FDF_CRG/20120502_FDF_CRG/20120518_FDF_CRG_c12.mtb	1663	NA	WWFF	water	2	18981	1337351496	1	0.04	0.00222222222222222	6373	1
2	Food 2	Intake 4	94	19093	1337351608	/users/cn/jespinosa/phecomp/data/CRG/20120502_FDF_CRG/20120502_FDF_CRG/20120518_FDF_CRG_c12.mtb	5526	COLL	WWFF	food_fat	4	18999	1337351514	1	1.3	0.0138297872340426	6374	1
2	Food 1	Intake 3	129	19218	1337351733	/users/cn/jespinosa/phecomp/data/CRG/20120502_FDF_CRG/20120502_FDF_CRG/20120518_FDF_CRG_c12.mtb	3801	14	WWFF	food_fat	3	19089	1337351604	1	1.12	0.00868217054263566	6375	1
2	Food 1	Intake 3	68	19300	1337351815	/users/cn/jespinosa/phecomp/data/CRG/20120502_FDF_CRG/20120502_FDF_CRG/20120518_FDF_CRG_c12.mtb	3802	8142	WWFF	food_fat	3	19232	1337351747	1	0.66	0.00970588235294118	6376	1
2	Food 1	Intake 3	34	27476	1337359991	/users/cn/jespinosa/phecomp/data/CRG/20120502_FDF_CRG/20120502_FDF_CRG/20120518_FDF_CRG_c12.mtb	3803	4	WWFF	food_fat	3	27442	1337359957	1	0.0999999999999996	0.00294117647058822	6377	1
2	Food 1	Intake 3	15	27495	1337360010	/users/cn/jespinosa/phecomp/data/CRG/20120502_FDF_CRG/20120502_FDF_CRG/20120518_FDF_CRG_c12.mtb	3804	6513	WWFF	food_fat	3	27480	1337359995	1	0.0600000000000001	0.00400000000000001	6378	1
2	Drink 2	Intake 2	22	29338	1337361853	/users/cn/jespinosa/phecomp/data/CRG/20120502_FDF_CRG/20120502_FDF_CRG/20120518_FDF_CRG_c12.mtb	1664	NA	WWFF	water	2	29316	1337361831	1	0.08	0.00363636363636364	6379	1
2	Drink 2	Intake 2	21	32425	1337364940	/users/cn/jespinosa/phecomp/data/CRG/20120502_FDF_CRG/20120502_FDF_CRG/20120518_FDF_CRG_c12.mtb	1665	NA	WWFF	water	2	32404	1337364919	1	0.06	0.00285714285714286	6380	1
2	Drink 2	Intake 2	15	34006	1337366521	/users/cn/jespinosa/phecomp/data/CRG/20120502_FDF_CRG/20120502_FDF_CRG/20120518_FDF_CRG_c12.mtb	1666	NA	WWFF	water	2	33991	1337366506	1	0.04	0.00266666666666667	6381	1
2	Food 1	Intake 3	21	34029	1337366544	/users/cn/jespinosa/phecomp/data/CRG/20120502_FDF_CRG/20120502_FDF_CRG/20120518_FDF_CRG_c12.mtb	3806	30	WWFF	food_fat	3	34008	1337366523	1	0.0600000000000001	0.00285714285714286	6382	1
2	Food 1	Intake 3	49	34108	1337366623	/users/cn/jespinosa/phecomp/data/CRG/20120502_FDF_CRG/20120502_FDF_CRG/20120518_FDF_CRG_c12.mtb	3807	358	WWFF	food_fat	3	34059	1337366574	1	0.48	0.00979591836734694	6383	1
2	Drink 2	Intake 2	26	34450	1337366965	/users/cn/jespinosa/phecomp/data/CRG/20120502_FDF_CRG/20120502_FDF_CRG/20120518_FDF_CRG_c12.mtb	1667	NA	WWFF	water	2	34424	1337366939	1	0.08	0.00307692307692308	6384	1
2	Food 2	Intake 4	35	34501	1337367016	/users/cn/jespinosa/phecomp/data/CRG/20120502_FDF_CRG/20120502_FDF_CRG/20120518_FDF_CRG_c12.mtb	5531	541	WWFF	food_fat	4	34466	1337366981	1	0.02	0.000571428571428571	6385	1
2	Food 1	Intake 3	68	35110	1337367625	/users/cn/jespinosa/phecomp/data/CRG/20120502_FDF_CRG/20120502_FDF_CRG/20120518_FDF_CRG_c12.mtb	3810	2918	WWFF	food_fat	3	35042	1337367557	1	0.3	0.00441176470588235	6386	1
2	Drink 2	Intake 2	34	36038	1337368553	/users/cn/jespinosa/phecomp/data/CRG/20120502_FDF_CRG/20120502_FDF_CRG/20120518_FDF_CRG_c12.mtb	1670	NA	WWFF	water	2	36004	1337368519	1	0.0600000000000001	0.00176470588235294	6387	1
2	Drink 2	Intake 2	23	37085	1337369600	/users/cn/jespinosa/phecomp/data/CRG/20120502_FDF_CRG/20120502_FDF_CRG/20120518_FDF_CRG_c12.mtb	1671	NA	WWFF	water	2	37062	1337369577	1	0.08	0.00347826086956522	6388	1
2	Food 1	Intake 3	20	38048	1337370563	/users/cn/jespinosa/phecomp/data/CRG/20120502_FDF_CRG/20120502_FDF_CRG/20120518_FDF_CRG_c12.mtb	3812	7534	WWFF	food_fat	3	38028	1337370543	1	0.0599999999999996	0.00299999999999998	6389	1
2	Drink 2	Intake 2	16	39380	1337371895	/users/cn/jespinosa/phecomp/data/CRG/20120502_FDF_CRG/20120502_FDF_CRG/20120518_FDF_CRG_c12.mtb	1675	NA	WWFF	water	2	39364	1337371879	1	0.04	0.0025	6390	1
2	Drink 1	Intake 1	17	41886	1337374401	/users/cn/jespinosa/phecomp/data/CRG/20120502_FDF_CRG/20120502_FDF_CRG/20120518_FDF_CRG_c12.mtb	1121	NA	WWFF	water	1	41869	1337374384	1	0.02	0.00117647058823529	6391	1
2	Drink 2	Intake 2	19	41906	1337374421	/users/cn/jespinosa/phecomp/data/CRG/20120502_FDF_CRG/20120502_FDF_CRG/20120518_FDF_CRG_c12.mtb	1676	NA	WWFF	water	2	41887	1337374402	1	0.02	0.00105263157894737	6392	1
2	Food 1	Intake 3	31	45613	1337378128	/users/cn/jespinosa/phecomp/data/CRG/20120502_FDF_CRG/20120502_FDF_CRG/20120518_FDF_CRG_c12.mtb	3813	6	WWFF	food_fat	3	45582	1337378097	1	0.0800000000000001	0.00258064516129033	6393	1
2	Food 1	Intake 3	14	45633	1337378148	/users/cn/jespinosa/phecomp/data/CRG/20120502_FDF_CRG/20120502_FDF_CRG/20120518_FDF_CRG_c12.mtb	3814	4	WWFF	food_fat	3	45619	1337378134	1	0.0800000000000001	0.00571428571428572	6394	1
2	Food 1	Intake 3	14	45651	1337378166	/users/cn/jespinosa/phecomp/data/CRG/20120502_FDF_CRG/20120502_FDF_CRG/20120518_FDF_CRG_c12.mtb	3815	359	WWFF	food_fat	3	45637	1337378152	1	0.04	0.00285714285714286	6395	1
2	Food 1	Intake 3	17	46027	1337378542	/users/cn/jespinosa/phecomp/data/CRG/20120502_FDF_CRG/20120502_FDF_CRG/20120518_FDF_CRG_c12.mtb	3816	3669	WWFF	food_fat	3	46010	1337378525	1	0.02	0.00117647058823529	6396	1
2	Drink 2	Intake 2	21	46507	1337379022	/users/cn/jespinosa/phecomp/data/CRG/20120502_FDF_CRG/20120502_FDF_CRG/20120518_FDF_CRG_c12.mtb	1677	NA	WWFF	water	2	46486	1337379001	1	0.1	0.00476190476190476	6397	1
2	Drink 2	Intake 2	14	48218	1337380733	/users/cn/jespinosa/phecomp/data/CRG/20120502_FDF_CRG/20120502_FDF_CRG/20120518_FDF_CRG_c12.mtb	1678	NA	WWFF	water	2	48204	1337380719	1	0.0599999999999999	0.00428571428571428	6398	1
2	Drink 2	Intake 2	14	49669	1337382184	/users/cn/jespinosa/phecomp/data/CRG/20120502_FDF_CRG/20120502_FDF_CRG/20120518_FDF_CRG_c12.mtb	1679	NA	WWFF	water	2	49655	1337382170	1	0.02	0.00142857142857143	6399	1
2	Food 1	Intake 3	54	49750	1337382265	/users/cn/jespinosa/phecomp/data/CRG/20120502_FDF_CRG/20120502_FDF_CRG/20120518_FDF_CRG_c12.mtb	3817	697	WWFF	food_fat	3	49696	1337382211	1	0.14	0.00259259259259259	6400	1
2	Drink 2	Intake 2	16	50172	1337382687	/users/cn/jespinosa/phecomp/data/CRG/20120502_FDF_CRG/20120502_FDF_CRG/20120518_FDF_CRG_c12.mtb	1681	NA	WWFF	water	2	50156	1337382671	1	0.02	0.00125	6401	1
2	Food 1	Intake 3	33	50480	1337382995	/users/cn/jespinosa/phecomp/data/CRG/20120502_FDF_CRG/20120502_FDF_CRG/20120518_FDF_CRG_c12.mtb	3819	5702	WWFF	food_fat	3	50447	1337382962	1	0.04	0.00121212121212121	6402	1
2	Drink 2	Intake 2	23	50726	1337383241	/users/cn/jespinosa/phecomp/data/CRG/20120502_FDF_CRG/20120502_FDF_CRG/20120518_FDF_CRG_c12.mtb	1683	NA	WWFF	water	2	50703	1337383218	1	0.0600000000000001	0.00260869565217392	6403	1
2	Drink 2	Intake 2	11	51177	1337383692	/users/cn/jespinosa/phecomp/data/CRG/20120502_FDF_CRG/20120502_FDF_CRG/20120518_FDF_CRG_c12.mtb	1684	NA	WWFF	water	2	51166	1337383681	1	0.04	0.00363636363636364	6404	1
2	Drink 2	Intake 2	21	52153	1337384668	/users/cn/jespinosa/phecomp/data/CRG/20120502_FDF_CRG/20120502_FDF_CRG/20120518_FDF_CRG_c12.mtb	1686	NA	WWFF	water	2	52132	1337384647	1	0.04	0.0019047619047619	6405	1
2	Food 1	Intake 3	12	56194	1337388709	/users/cn/jespinosa/phecomp/data/CRG/20120502_FDF_CRG/20120502_FDF_CRG/20120518_FDF_CRG_c12.mtb	3823	1773	WWFF	food_fat	3	56182	1337388697	1	0.04	0.00333333333333333	6406	1
2	Food 1	Intake 3	22	57989	1337390504	/users/cn/jespinosa/phecomp/data/CRG/20120502_FDF_CRG/20120502_FDF_CRG/20120518_FDF_CRG_c12.mtb	3824	3724	WWFF	food_fat	3	57967	1337390482	1	0.04	0.00181818181818182	6407	1
2	Drink 2	Intake 2	14	58021	1337390536	/users/cn/jespinosa/phecomp/data/CRG/20120502_FDF_CRG/20120502_FDF_CRG/20120518_FDF_CRG_c12.mtb	1688	NA	WWFF	water	2	58007	1337390522	1	0.0399999999999998	0.00285714285714284	6408	1
2	Drink 2	Intake 2	19	58883	1337391398	/users/cn/jespinosa/phecomp/data/CRG/20120502_FDF_CRG/20120502_FDF_CRG/20120518_FDF_CRG_c12.mtb	1689	NA	WWFF	water	2	58864	1337391379	1	0.0800000000000001	0.00421052631578948	6409	1
2	Food 1	Intake 3	15	61728	1337394243	/users/cn/jespinosa/phecomp/data/CRG/20120502_FDF_CRG/20120502_FDF_CRG/20120518_FDF_CRG_c12.mtb	3827	11	WWFF	food_fat	3	61713	1337394228	1	0.0600000000000005	0.00400000000000003	6410	1
2	Food 1	Intake 3	23	61762	1337394277	/users/cn/jespinosa/phecomp/data/CRG/20120502_FDF_CRG/20120502_FDF_CRG/20120518_FDF_CRG_c12.mtb	3828	9	WWFF	food_fat	3	61739	1337394254	1	0.0599999999999996	0.0026086956521739	6411	1
2	Food 1	Intake 3	14	61785	1337394300	/users/cn/jespinosa/phecomp/data/CRG/20120502_FDF_CRG/20120502_FDF_CRG/20120518_FDF_CRG_c12.mtb	3829	6553	WWFF	food_fat	3	61771	1337394286	1	0.04	0.00285714285714286	6412	1
2	Drink 2	Intake 2	13	64158	1337396673	/users/cn/jespinosa/phecomp/data/CRG/20120502_FDF_CRG/20120502_FDF_CRG/20120518_FDF_CRG_c12.mtb	1690	NA	WWFF	water	2	64145	1337396660	1	0.0800000000000001	0.00615384615384616	6413	1
2	Food 1	Intake 3	17	68355	1337400870	/users/cn/jespinosa/phecomp/data/CRG/20120502_FDF_CRG/20120502_FDF_CRG/20120518_FDF_CRG_c12.mtb	3830	1353	WWFF	food_fat	3	68338	1337400853	1	0.0200000000000005	0.00117647058823532	6414	1
2	Drink 2	Intake 2	14	68907	1337401422	/users/cn/jespinosa/phecomp/data/CRG/20120502_FDF_CRG/20120502_FDF_CRG/20120518_FDF_CRG_c12.mtb	1692	NA	WWFF	water	2	68893	1337401408	1	0.04	0.00285714285714286	6415	1
2	Drink 2	Intake 2	19	69541	1337402056	/users/cn/jespinosa/phecomp/data/CRG/20120502_FDF_CRG/20120502_FDF_CRG/20120518_FDF_CRG_c12.mtb	1693	NA	WWFF	water	2	69522	1337402037	1	0.04	0.00210526315789474	6416	1
2	Drink 2	Intake 2	21	69666	1337402181	/users/cn/jespinosa/phecomp/data/CRG/20120502_FDF_CRG/20120502_FDF_CRG/20120518_FDF_CRG_c12.mtb	1694	NA	WWFF	water	2	69645	1337402160	1	0.0600000000000001	0.00285714285714286	6417	1
2	Food 2	Intake 4	33	69741	1337402256	/users/cn/jespinosa/phecomp/data/CRG/20120502_FDF_CRG/20120502_FDF_CRG/20120518_FDF_CRG_c12.mtb	5550	720	WWFF	food_fat	4	69708	1337402223	1	0.0800000000000001	0.00242424242424243	6418	1
2	Drink 2	Intake 2	14	70252	1337402767	/users/cn/jespinosa/phecomp/data/CRG/20120502_FDF_CRG/20120502_FDF_CRG/20120518_FDF_CRG_c12.mtb	1695	NA	WWFF	water	2	70238	1337402753	1	0.02	0.00142857142857143	6419	1
2	Drink 2	Intake 2	36	70467	1337402982	/users/cn/jespinosa/phecomp/data/CRG/20120502_FDF_CRG/20120502_FDF_CRG/20120518_FDF_CRG_c12.mtb	1696	NA	WWFF	water	2	70431	1337402946	1	0.02	0.000555555555555556	6420	1
2	Food 2	Intake 4	24	70485	1337403000	/users/cn/jespinosa/phecomp/data/CRG/20120502_FDF_CRG/20120502_FDF_CRG/20120518_FDF_CRG_c12.mtb	5554	2510	WWFF	food_fat	4	70461	1337402976	1	0.0599999999999996	0.00249999999999998	6421	1
2	Drink 2	Intake 2	20	71226	1337403741	/users/cn/jespinosa/phecomp/data/CRG/20120502_FDF_CRG/20120502_FDF_CRG/20120518_FDF_CRG_c12.mtb	1697	NA	WWFF	water	2	71206	1337403721	1	0.0600000000000001	0.00300000000000001	6422	1
2	Drink 2	Intake 2	20	71798	1337404313	/users/cn/jespinosa/phecomp/data/CRG/20120502_FDF_CRG/20120502_FDF_CRG/20120518_FDF_CRG_c12.mtb	1698	NA	WWFF	water	2	71778	1337404293	1	0.04	0.002	6423	1
2	Food 2	Intake 4	31	73026	1337405541	/users/cn/jespinosa/phecomp/data/CRG/20120502_FDF_CRG/20120502_FDF_CRG/20120518_FDF_CRG_c12.mtb	5557	COLL	WWFF	food_fat	4	72995	1337405510	1	0.04	0.00129032258064516	6424	1
2	Food 1	Intake 3	33	73052	1337405567	/users/cn/jespinosa/phecomp/data/CRG/20120502_FDF_CRG/20120502_FDF_CRG/20120518_FDF_CRG_c12.mtb	3837	112	WWFF	food_fat	3	73019	1337405534	1	0.0599999999999996	0.00181818181818181	6425	1
2	Food 1	Intake 3	17	73181	1337405696	/users/cn/jespinosa/phecomp/data/CRG/20120502_FDF_CRG/20120502_FDF_CRG/20120518_FDF_CRG_c12.mtb	3838	8412	WWFF	food_fat	3	73164	1337405679	1	0.04	0.00235294117647059	6426	1
2	Drink 2	Intake 2	26	73900	1337406415	/users/cn/jespinosa/phecomp/data/CRG/20120502_FDF_CRG/20120502_FDF_CRG/20120518_FDF_CRG_c12.mtb	1699	NA	WWFF	water	2	73874	1337406389	1	0.0599999999999998	0.0023076923076923	6427	1
2	Food 1	Intake 3	15	81608	1337414123	/users/cn/jespinosa/phecomp/data/CRG/20120502_FDF_CRG/20120502_FDF_CRG/20120518_FDF_CRG_c12.mtb	3839	58	WWFF	food_fat	3	81593	1337414108	1	0.0200000000000005	0.00133333333333337	6428	1
2	Food 1	Intake 3	15	81681	1337414196	/users/cn/jespinosa/phecomp/data/CRG/20120502_FDF_CRG/20120502_FDF_CRG/20120518_FDF_CRG_c12.mtb	3841	2045	WWFF	food_fat	3	81666	1337414181	1	0.04	0.00266666666666667	6429	1
2	Food 1	Intake 3	17	83743	1337416258	/users/cn/jespinosa/phecomp/data/CRG/20120502_FDF_CRG/20120502_FDF_CRG/20120518_FDF_CRG_c12.mtb	3842	5203	WWFF	food_fat	3	83726	1337416241	1	0.04	0.00235294117647059	6430	1
2	Drink 2	Intake 2	28	86673	1337419188	/users/cn/jespinosa/phecomp/data/CRG/20120502_FDF_CRG/20120502_FDF_CRG/20120518_FDF_CRG_c12.mtb	1700	NA	WWFF	water	2	86645	1337419160	1	0.12	0.00428571428571429	6431	1
2	Food 1	Intake 3	14	88960	1337421475	/users/cn/jespinosa/phecomp/data/CRG/20120502_FDF_CRG/20120502_FDF_CRG/20120518_FDF_CRG_c12.mtb	3845	4439	WWFF	food_fat	3	88946	1337421461	1	0.0800000000000001	0.00571428571428572	6432	1
2	Food 1	Intake 3	34	93433	1337425948	/users/cn/jespinosa/phecomp/data/CRG/20120502_FDF_CRG/20120502_FDF_CRG/20120518_FDF_CRG_c12.mtb	3846	1550	WWFF	food_fat	3	93399	1337425914	1	0.04	0.00117647058823529	6433	1
2	Food 1	Intake 3	38	95021	1337427536	/users/cn/jespinosa/phecomp/data/CRG/20120502_FDF_CRG/20120502_FDF_CRG/20120518_FDF_CRG_c12.mtb	3848	29	WWFF	food_fat	3	94983	1337427498	1	0.0800000000000001	0.00210526315789474	6434	1
2	Food 1	Intake 3	16	95066	1337427581	/users/cn/jespinosa/phecomp/data/CRG/20120502_FDF_CRG/20120502_FDF_CRG/20120518_FDF_CRG_c12.mtb	3849	4024	WWFF	food_fat	3	95050	1337427565	1	0.0200000000000005	0.00125000000000003	6435	1
2	Drink 1	Intake 1	23	95139	1337427654	/users/cn/jespinosa/phecomp/data/CRG/20120502_FDF_CRG/20120502_FDF_CRG/20120518_FDF_CRG_c12.mtb	1126	NA	WWFF	water	1	95116	1337427631	1	0.1	0.00434782608695652	6436	1
2	Drink 1	Intake 1	18	96311	1337428826	/users/cn/jespinosa/phecomp/data/CRG/20120502_FDF_CRG/20120502_FDF_CRG/20120518_FDF_CRG_c12.mtb	1127	NA	WWFF	water	1	96293	1337428808	1	0.06	0.00333333333333333	6437	1
2	Food 1	Intake 3	20	99110	1337431625	/users/cn/jespinosa/phecomp/data/CRG/20120502_FDF_CRG/20120502_FDF_CRG/20120518_FDF_CRG_c12.mtb	3851	3326	WWFF	food_fat	3	99090	1337431605	1	0.0600000000000005	0.00300000000000002	6438	1
2	Food 1	Intake 3	27	102463	1337434978	/users/cn/jespinosa/phecomp/data/CRG/20120502_FDF_CRG/20120502_FDF_CRG/20120518_FDF_CRG_c12.mtb	3853	1675	WWFF	food_fat	3	102436	1337434951	1	0.0800000000000001	0.00296296296296297	6439	1
2	Drink 2	Intake 2	19	103515	1337436030	/users/cn/jespinosa/phecomp/data/CRG/20120502_FDF_CRG/20120502_FDF_CRG/20120518_FDF_CRG_c12.mtb	1701	NA	WWFF	water	2	103496	1337436011	1	0.0600000000000001	0.00315789473684211	6440	1
2	Drink 2	Intake 2	16	103774	1337436289	/users/cn/jespinosa/phecomp/data/CRG/20120502_FDF_CRG/20120502_FDF_CRG/20120518_FDF_CRG_c12.mtb	1702	NA	WWFF	water	2	103758	1337436273	1	0.02	0.00125	6441	1
2	Drink 2	Intake 2	13	103893	1337436408	/users/cn/jespinosa/phecomp/data/CRG/20120502_FDF_CRG/20120502_FDF_CRG/20120518_FDF_CRG_c12.mtb	1703	NA	WWFF	water	2	103880	1337436395	1	0.04	0.00307692307692308	6442	1
2	Drink 2	Intake 2	20	104131	1337436646	/users/cn/jespinosa/phecomp/data/CRG/20120502_FDF_CRG/20120502_FDF_CRG/20120518_FDF_CRG_c12.mtb	1704	NA	WWFF	water	2	104111	1337436626	1	0.04	0.002	6443	1
2	Food 2	Intake 4	34	104172	1337436687	/users/cn/jespinosa/phecomp/data/CRG/20120502_FDF_CRG/20120502_FDF_CRG/20120518_FDF_CRG_c12.mtb	5561	6754	WWFF	food_fat	4	104138	1337436653	1	0.04	0.00117647058823529	6444	1
2	Food 1	Intake 3	39	110965	1337443480	/users/cn/jespinosa/phecomp/data/CRG/20120502_FDF_CRG/20120502_FDF_CRG/20120518_FDF_CRG_c12.mtb	3855	2154	WWFF	food_fat	3	110926	1337443441	1	0.0800000000000001	0.00205128205128205	6445	1
2	Food 1	Intake 3	15	113134	1337445649	/users/cn/jespinosa/phecomp/data/CRG/20120502_FDF_CRG/20120502_FDF_CRG/20120518_FDF_CRG_c12.mtb	3856	1151	WWFF	food_fat	3	113119	1337445634	1	0.0599999999999996	0.00399999999999997	6446	1
2	Drink 2	Intake 2	22	114292	1337446807	/users/cn/jespinosa/phecomp/data/CRG/20120502_FDF_CRG/20120502_FDF_CRG/20120518_FDF_CRG_c12.mtb	1705	NA	WWFF	water	2	114270	1337446785	1	0.0800000000000001	0.00363636363636364	6447	1
2	Food 1	Intake 3	15	114300	1337446815	/users/cn/jespinosa/phecomp/data/CRG/20120502_FDF_CRG/20120502_FDF_CRG/20120518_FDF_CRG_c12.mtb	3857	2161	WWFF	food_fat	3	114285	1337446800	1	0.04	0.00266666666666667	6448	1
2	Food 1	Intake 3	17	116478	1337448993	/users/cn/jespinosa/phecomp/data/CRG/20120502_FDF_CRG/20120502_FDF_CRG/20120518_FDF_CRG_c12.mtb	3858	1474	WWFF	food_fat	3	116461	1337448976	1	0.0200000000000005	0.00117647058823532	6449	1
2	Food 2	Intake 4	26	117978	1337450493	/users/cn/jespinosa/phecomp/data/CRG/20120502_FDF_CRG/20120502_FDF_CRG/20120518_FDF_CRG_c12.mtb	5562	COLL	WWFF	food_fat	4	117952	1337450467	1	0.02	0.000769230769230769	6450	1
2	Food 1	Intake 3	21	117997	1337450512	/users/cn/jespinosa/phecomp/data/CRG/20120502_FDF_CRG/20120502_FDF_CRG/20120518_FDF_CRG_c12.mtb	3859	11	WWFF	food_fat	3	117976	1337450491	1	0.0599999999999996	0.00285714285714284	6451	1
2	Food 1	Intake 3	18	118026	1337450541	/users/cn/jespinosa/phecomp/data/CRG/20120502_FDF_CRG/20120502_FDF_CRG/20120518_FDF_CRG_c12.mtb	3860	5064	WWFF	food_fat	3	118008	1337450523	1	0.0200000000000005	0.00111111111111114	6452	1
2	Drink 2	Intake 2	21	120124	1337452639	/users/cn/jespinosa/phecomp/data/CRG/20120502_FDF_CRG/20120502_FDF_CRG/20120518_FDF_CRG_c12.mtb	1706	NA	WWFF	water	2	120103	1337452618	1	0.02	0.000952380952380952	6453	1
2	Drink 1	Intake 1	15	120207	1337452722	/users/cn/jespinosa/phecomp/data/CRG/20120502_FDF_CRG/20120502_FDF_CRG/20120518_FDF_CRG_c12.mtb	1129	NA	WWFF	water	1	120192	1337452707	1	0.04	0.00266666666666667	6454	1
2	Drink 1	Intake 1	12	120301	1337452816	/users/cn/jespinosa/phecomp/data/CRG/20120502_FDF_CRG/20120502_FDF_CRG/20120518_FDF_CRG_c12.mtb	1130	NA	WWFF	water	1	120289	1337452804	1	0.04	0.00333333333333333	6455	1
2	Drink 2	Intake 2	20	121552	1337454067	/users/cn/jespinosa/phecomp/data/CRG/20120502_FDF_CRG/20120502_FDF_CRG/20120518_FDF_CRG_c12.mtb	1708	NA	WWFF	water	2	121532	1337454047	1	0.0600000000000001	0.00300000000000001	6456	1
2	Drink 2	Intake 2	13	122594	1337455109	/users/cn/jespinosa/phecomp/data/CRG/20120502_FDF_CRG/20120502_FDF_CRG/20120518_FDF_CRG_c12.mtb	1709	NA	WWFF	water	2	122581	1337455096	1	0.02	0.00153846153846154	6457	1
2	Food 2	Intake 4	42	123132	1337455647	/users/cn/jespinosa/phecomp/data/CRG/20120502_FDF_CRG/20120502_FDF_CRG/20120518_FDF_CRG_c12.mtb	5570	3334	WWFF	food_fat	4	123090	1337455605	1	0.22	0.00523809523809524	6458	1
2	Drink 2	Intake 2	14	123758	1337456273	/users/cn/jespinosa/phecomp/data/CRG/20120502_FDF_CRG/20120502_FDF_CRG/20120518_FDF_CRG_c12.mtb	1711	NA	WWFF	water	2	123744	1337456259	1	0.0600000000000001	0.00428571428571429	6459	1
2	Food 2	Intake 4	54	126520	1337459035	/users/cn/jespinosa/phecomp/data/CRG/20120502_FDF_CRG/20120502_FDF_CRG/20120518_FDF_CRG_c12.mtb	5571	6019	WWFF	food_fat	4	126466	1337458981	1	0.02	0.00037037037037037	6460	1
2	Drink 2	Intake 2	12	131558	1337464073	/users/cn/jespinosa/phecomp/data/CRG/20120502_FDF_CRG/20120502_FDF_CRG/20120518_FDF_CRG_c12.mtb	1714	NA	WWFF	water	2	131546	1337464061	1	0.0399999999999996	0.0033333333333333	6461	1
2	Food 2	Intake 4	23	132562	1337465077	/users/cn/jespinosa/phecomp/data/CRG/20120502_FDF_CRG/20120502_FDF_CRG/20120518_FDF_CRG_c12.mtb	5573	3206	WWFF	food_fat	4	132539	1337465054	1	0.02	0.000869565217391304	6462	1
2	Drink 1	Intake 1	18	132672	1337465187	/users/cn/jespinosa/phecomp/data/CRG/20120502_FDF_CRG/20120502_FDF_CRG/20120518_FDF_CRG_c12.mtb	1134	NA	WWFF	water	1	132654	1337465169	1	0.02	0.00111111111111111	6463	1
2	Drink 2	Intake 2	12	133516	1337466031	/users/cn/jespinosa/phecomp/data/CRG/20120502_FDF_CRG/20120502_FDF_CRG/20120518_FDF_CRG_c12.mtb	1717	NA	WWFF	water	2	133504	1337466019	1	0.04	0.00333333333333333	6464	1
2	Drink 2	Intake 2	25	133783	1337466298	/users/cn/jespinosa/phecomp/data/CRG/20120502_FDF_CRG/20120502_FDF_CRG/20120518_FDF_CRG_c12.mtb	1718	NA	WWFF	water	2	133758	1337466273	1	0.0600000000000001	0.0024	6465	1
2	Drink 2	Intake 2	26	134082	1337466597	/users/cn/jespinosa/phecomp/data/CRG/20120502_FDF_CRG/20120502_FDF_CRG/20120518_FDF_CRG_c12.mtb	1719	NA	WWFF	water	2	134056	1337466571	1	0.02	0.000769230769230769	6466	1
2	Food 1	Intake 3	43	135811	1337468326	/users/cn/jespinosa/phecomp/data/CRG/20120502_FDF_CRG/20120502_FDF_CRG/20120518_FDF_CRG_c12.mtb	3870	3457	WWFF	food_fat	3	135768	1337468283	1	0.0599999999999996	0.00139534883720929	6467	1
2	Drink 2	Intake 2	20	137824	1337470339	/users/cn/jespinosa/phecomp/data/CRG/20120502_FDF_CRG/20120502_FDF_CRG/20120518_FDF_CRG_c12.mtb	1720	NA	WWFF	water	2	137804	1337470319	1	0.0600000000000001	0.00300000000000001	6468	1
2	Food 2	Intake 4	23	139291	1337471806	/users/cn/jespinosa/phecomp/data/CRG/20120502_FDF_CRG/20120502_FDF_CRG/20120518_FDF_CRG_c12.mtb	5579	1541	WWFF	food_fat	4	139268	1337471783	1	0.02	0.000869565217391304	6469	1
2	Drink 1	Intake 1	13	139642	1337472157	/users/cn/jespinosa/phecomp/data/CRG/20120502_FDF_CRG/20120502_FDF_CRG/20120518_FDF_CRG_c12.mtb	1135	NA	WWFF	water	1	139629	1337472144	1	0.04	0.00307692307692308	6470	1
2	Drink 2	Intake 2	22	139979	1337472494	/users/cn/jespinosa/phecomp/data/CRG/20120502_FDF_CRG/20120502_FDF_CRG/20120518_FDF_CRG_c12.mtb	1721	NA	WWFF	water	2	139957	1337472472	1	0.04	0.00181818181818182	6471	1
2	Drink 2	Intake 2	30	140132	1337472647	/users/cn/jespinosa/phecomp/data/CRG/20120502_FDF_CRG/20120502_FDF_CRG/20120518_FDF_CRG_c12.mtb	1724	NA	WWFF	water	2	140102	1337472617	1	0.02	0.000666666666666667	6472	1
2	Food 2	Intake 4	116	140948	1337473463	/users/cn/jespinosa/phecomp/data/CRG/20120502_FDF_CRG/20120502_FDF_CRG/20120518_FDF_CRG_c12.mtb	5581	2534	WWFF	food_fat	4	140832	1337473347	1	0.0399999999999996	0.000344827586206893	6473	1
2	Drink 2	Intake 2	12	141025	1337473540	/users/cn/jespinosa/phecomp/data/CRG/20120502_FDF_CRG/20120502_FDF_CRG/20120518_FDF_CRG_c12.mtb	1726	NA	WWFF	water	2	141013	1337473528	1	0.04	0.00333333333333333	6474	1
2	Drink 2	Intake 2	23	141728	1337474243	/users/cn/jespinosa/phecomp/data/CRG/20120502_FDF_CRG/20120502_FDF_CRG/20120518_FDF_CRG_c12.mtb	1727	NA	WWFF	water	2	141705	1337474220	1	0.04	0.00173913043478261	6475	1
2	Food 2	Intake 4	33	143515	1337476030	/users/cn/jespinosa/phecomp/data/CRG/20120502_FDF_CRG/20120502_FDF_CRG/20120518_FDF_CRG_c12.mtb	5584	514	WWFF	food_fat	4	143482	1337475997	1	0.12	0.00363636363636364	6476	1
2	Food 2	Intake 4	46	144075	1337476590	/users/cn/jespinosa/phecomp/data/CRG/20120502_FDF_CRG/20120502_FDF_CRG/20120518_FDF_CRG_c12.mtb	5585	6838	WWFF	food_fat	4	144029	1337476544	1	0.02	0.000434782608695652	6477	1
2	Drink 2	Intake 2	69	144495	1337477010	/users/cn/jespinosa/phecomp/data/CRG/20120502_FDF_CRG/20120502_FDF_CRG/20120518_FDF_CRG_c12.mtb	1731	NA	WWFF	water	2	144426	1337476941	1	0.02	0.000289855072463768	6478	1
2	Drink 2	Intake 2	52	144560	1337477075	/users/cn/jespinosa/phecomp/data/CRG/20120502_FDF_CRG/20120502_FDF_CRG/20120518_FDF_CRG_c12.mtb	1732	NA	WWFF	water	2	144508	1337477023	1	0.02	0.000384615384615385	6479	1
2	Drink 2	Intake 2	12	145638	1337478153	/users/cn/jespinosa/phecomp/data/CRG/20120502_FDF_CRG/20120502_FDF_CRG/20120518_FDF_CRG_c12.mtb	1736	NA	WWFF	water	2	145626	1337478141	1	0.04	0.00333333333333333	6480	1
2	Food 1	Intake 3	33	150946	1337483461	/users/cn/jespinosa/phecomp/data/CRG/20120502_FDF_CRG/20120502_FDF_CRG/20120518_FDF_CRG_c12.mtb	3879	6095	WWFF	food_fat	3	150913	1337483428	1	0.0200000000000005	0.000606060606060621	6481	1
2	Drink 2	Intake 2	22	156207	1337488722	/users/cn/jespinosa/phecomp/data/CRG/20120502_FDF_CRG/20120502_FDF_CRG/20120518_FDF_CRG_c12.mtb	1737	NA	WWFF	water	2	156185	1337488700	1	0.0599999999999996	0.00272727272727271	6482	1
2	Drink 2	Intake 2	13	156715	1337489230	/users/cn/jespinosa/phecomp/data/CRG/20120502_FDF_CRG/20120502_FDF_CRG/20120518_FDF_CRG_c12.mtb	1738	NA	WWFF	water	2	156702	1337489217	1	0.04	0.00307692307692308	6483	1
2	Food 2	Intake 4	41	157082	1337489597	/users/cn/jespinosa/phecomp/data/CRG/20120502_FDF_CRG/20120502_FDF_CRG/20120518_FDF_CRG_c12.mtb	5588	9727	WWFF	food_fat	4	157041	1337489556	1	0.04	0.000975609756097561	6484	1
2	Drink 2	Intake 2	20	157205	1337489720	/users/cn/jespinosa/phecomp/data/CRG/20120502_FDF_CRG/20120502_FDF_CRG/20120518_FDF_CRG_c12.mtb	1739	NA	WWFF	water	2	157185	1337489700	1	0.0200000000000005	0.00100000000000002	6485	1
2	Drink 2	Intake 2	35	157783	1337490298	/users/cn/jespinosa/phecomp/data/CRG/20120502_FDF_CRG/20120502_FDF_CRG/20120518_FDF_CRG_c12.mtb	1740	NA	WWFF	water	2	157748	1337490263	1	0.0999999999999996	0.00285714285714285	6486	1
2	Drink 2	Intake 2	14	158483	1337490998	/users/cn/jespinosa/phecomp/data/CRG/20120502_FDF_CRG/20120502_FDF_CRG/20120518_FDF_CRG_c12.mtb	1742	NA	WWFF	water	2	158469	1337490984	1	0.0600000000000001	0.00428571428571429	6487	1
2	Drink 2	Intake 2	22	158536	1337491051	/users/cn/jespinosa/phecomp/data/CRG/20120502_FDF_CRG/20120502_FDF_CRG/20120518_FDF_CRG_c12.mtb	1743	NA	WWFF	water	2	158514	1337491029	1	0.04	0.00181818181818182	6488	1
2	Drink 2	Intake 2	20	159608	1337492123	/users/cn/jespinosa/phecomp/data/CRG/20120502_FDF_CRG/20120502_FDF_CRG/20120518_FDF_CRG_c12.mtb	1744	NA	WWFF	water	2	159588	1337492103	1	0.02	0.001	6489	1
2	Drink 2	Intake 2	22	163556	1337496071	/users/cn/jespinosa/phecomp/data/CRG/20120502_FDF_CRG/20120502_FDF_CRG/20120518_FDF_CRG_c12.mtb	1746	NA	WWFF	water	2	163534	1337496049	1	0.0600000000000001	0.00272727272727273	6490	1
2	Drink 1	Intake 1	19	164741	1337497256	/users/cn/jespinosa/phecomp/data/CRG/20120502_FDF_CRG/20120502_FDF_CRG/20120518_FDF_CRG_c12.mtb	1138	NA	WWFF	water	1	164722	1337497237	1	0.02	0.00105263157894737	6491	1
2	Drink 2	Intake 2	10	165844	1337498359	/users/cn/jespinosa/phecomp/data/CRG/20120502_FDF_CRG/20120502_FDF_CRG/20120518_FDF_CRG_c12.mtb	1747	NA	WWFF	water	2	165834	1337498349	1	0.04	0.004	6492	1
2	Food 2	Intake 4	17	166826	1337499341	/users/cn/jespinosa/phecomp/data/CRG/20120502_FDF_CRG/20120502_FDF_CRG/20120518_FDF_CRG_c12.mtb	5593	6584	WWFF	food_fat	4	166809	1337499324	1	0.04	0.00235294117647059	6493	1
2	Food 2	Intake 4	16	173426	1337505941	/users/cn/jespinosa/phecomp/data/CRG/20120502_FDF_CRG/20120502_FDF_CRG/20120518_FDF_CRG_c12.mtb	5594	4193	WWFF	food_fat	4	173410	1337505925	1	0.02	0.00125	6494	1
2	Drink 1	Intake 1	20	175656	1337508171	/users/cn/jespinosa/phecomp/data/CRG/20120502_FDF_CRG/20120502_FDF_CRG/20120518_FDF_CRG_c12.mtb	1139	NA	WWFF	water	1	175636	1337508151	1	0.04	0.002	6495	1
2	Food 2	Intake 4	33	177652	1337510167	/users/cn/jespinosa/phecomp/data/CRG/20120502_FDF_CRG/20120502_FDF_CRG/20120518_FDF_CRG_c12.mtb	5595	4642	WWFF	food_fat	4	177619	1337510134	1	0.0600000000000001	0.00181818181818182	6496	1
2	Drink 1	Intake 1	13	177892	1337510407	/users/cn/jespinosa/phecomp/data/CRG/20120502_FDF_CRG/20120502_FDF_CRG/20120518_FDF_CRG_c12.mtb	1140	NA	WWFF	water	1	177879	1337510394	1	0.04	0.00307692307692308	6497	1
2	Drink 2	Intake 2	19	177910	1337510425	/users/cn/jespinosa/phecomp/data/CRG/20120502_FDF_CRG/20120502_FDF_CRG/20120518_FDF_CRG_c12.mtb	1749	NA	WWFF	water	2	177891	1337510406	1	0.02	0.00105263157894737	6498	1
2	Food 2	Intake 4	58	182352	1337514867	/users/cn/jespinosa/phecomp/data/CRG/20120502_FDF_CRG/20120502_FDF_CRG/20120518_FDF_CRG_c12.mtb	5596	4370	WWFF	food_fat	4	182294	1337514809	1	0.14	0.00241379310344828	6499	1
2	Drink 2	Intake 2	13	184149	1337516664	/users/cn/jespinosa/phecomp/data/CRG/20120502_FDF_CRG/20120502_FDF_CRG/20120518_FDF_CRG_c12.mtb	1750	NA	WWFF	water	2	184136	1337516651	1	0.04	0.00307692307692308	6500	1
2	Food 2	Intake 4	17	186739	1337519254	/users/cn/jespinosa/phecomp/data/CRG/20120502_FDF_CRG/20120502_FDF_CRG/20120518_FDF_CRG_c12.mtb	5598	3915	WWFF	food_fat	4	186722	1337519237	1	0.04	0.00235294117647059	6501	1
2	Food 1	Intake 3	55	190709	1337523224	/users/cn/jespinosa/phecomp/data/CRG/20120502_FDF_CRG/20120502_FDF_CRG/20120518_FDF_CRG_c12.mtb	3892	55	WWFF	food_fat	3	190654	1337523169	1	0.0599999999999996	0.00109090909090908	6502	1
2	Food 2	Intake 4	26	190790	1337523305	/users/cn/jespinosa/phecomp/data/CRG/20120502_FDF_CRG/20120502_FDF_CRG/20120518_FDF_CRG_c12.mtb	5599	4820	WWFF	food_fat	4	190764	1337523279	1	0.0599999999999996	0.00230769230769229	6503	1
2	Drink 1	Intake 1	28	191701	1337524216	/users/cn/jespinosa/phecomp/data/CRG/20120502_FDF_CRG/20120502_FDF_CRG/20120518_FDF_CRG_c12.mtb	1141	NA	WWFF	water	1	191673	1337524188	1	0.0599999999999999	0.00214285714285714	6504	1
2	Food 2	Intake 4	34	195644	1337528159	/users/cn/jespinosa/phecomp/data/CRG/20120502_FDF_CRG/20120502_FDF_CRG/20120518_FDF_CRG_c12.mtb	5600	21	WWFF	food_fat	4	195610	1337528125	1	0.1	0.00294117647058824	6505	1
2	Food 2	Intake 4	19	195684	1337528199	/users/cn/jespinosa/phecomp/data/CRG/20120502_FDF_CRG/20120502_FDF_CRG/20120518_FDF_CRG_c12.mtb	5601	15	WWFF	food_fat	4	195665	1337528180	1	0.04	0.00210526315789474	6506	1
2	Food 2	Intake 4	21	195720	1337528235	/users/cn/jespinosa/phecomp/data/CRG/20120502_FDF_CRG/20120502_FDF_CRG/20120518_FDF_CRG_c12.mtb	5602	8543	WWFF	food_fat	4	195699	1337528214	1	0.02	0.000952380952380952	6507	1
2	Drink 1	Intake 1	25	197567	1337530082	/users/cn/jespinosa/phecomp/data/CRG/20120502_FDF_CRG/20120502_FDF_CRG/20120518_FDF_CRG_c12.mtb	1142	NA	WWFF	water	1	197542	1337530057	1	0.0600000000000001	0.0024	6508	1
2	Drink 1	Intake 1	23	200857	1337533372	/users/cn/jespinosa/phecomp/data/CRG/20120502_FDF_CRG/20120502_FDF_CRG/20120518_FDF_CRG_c12.mtb	1143	NA	WWFF	water	1	200834	1337533349	1	0.1	0.00434782608695652	6509	1
2	Food 2	Intake 4	54	204317	1337536832	/users/cn/jespinosa/phecomp/data/CRG/20120502_FDF_CRG/20120502_FDF_CRG/20120518_FDF_CRG_c12.mtb	5603	3113	WWFF	food_fat	4	204263	1337536778	1	0.16	0.00296296296296296	6510	1
2	Drink 2	Intake 2	22	206318	1337538833	/users/cn/jespinosa/phecomp/data/CRG/20120502_FDF_CRG/20120502_FDF_CRG/20120518_FDF_CRG_c12.mtb	1752	NA	WWFF	water	2	206296	1337538811	1	0.0600000000000001	0.00272727272727273	6511	1
2	Drink 1	Intake 1	47	206427	1337538942	/users/cn/jespinosa/phecomp/data/CRG/20120502_FDF_CRG/20120502_FDF_CRG/20120518_FDF_CRG_c12.mtb	1145	NA	WWFF	water	1	206380	1337538895	1	0.02	0.000425531914893617	6512	1
2	Drink 2	Intake 2	14	207374	1337539889	/users/cn/jespinosa/phecomp/data/CRG/20120502_FDF_CRG/20120502_FDF_CRG/20120518_FDF_CRG_c12.mtb	1754	NA	WWFF	water	2	207360	1337539875	1	0.0600000000000001	0.00428571428571429	6513	1
2	Food 2	Intake 4	17	207447	1337539962	/users/cn/jespinosa/phecomp/data/CRG/20120502_FDF_CRG/20120502_FDF_CRG/20120518_FDF_CRG_c12.mtb	5608	852	WWFF	food_fat	4	207430	1337539945	1	0.04	0.00235294117647059	6514	1
2	Drink 2	Intake 2	25	207768	1337540283	/users/cn/jespinosa/phecomp/data/CRG/20120502_FDF_CRG/20120502_FDF_CRG/20120518_FDF_CRG_c12.mtb	1756	NA	WWFF	water	2	207743	1337540258	1	0.0399999999999996	0.00159999999999998	6515	1
2	Drink 1	Intake 1	22	208275	1337540790	/users/cn/jespinosa/phecomp/data/CRG/20120502_FDF_CRG/20120502_FDF_CRG/20120518_FDF_CRG_c12.mtb	1146	NA	WWFF	water	1	208253	1337540768	1	0.0399999999999999	0.00181818181818181	6516	1
2	Food 2	Intake 4	92	208391	1337540906	/users/cn/jespinosa/phecomp/data/CRG/20120502_FDF_CRG/20120502_FDF_CRG/20120518_FDF_CRG_c12.mtb	5610	3457	WWFF	food_fat	4	208299	1337540814	1	0.0800000000000001	0.000869565217391305	6517	1
2	Drink 2	Intake 2	42	209147	1337541662	/users/cn/jespinosa/phecomp/data/CRG/20120502_FDF_CRG/20120502_FDF_CRG/20120518_FDF_CRG_c12.mtb	1758	NA	WWFF	water	2	209105	1337541620	1	0.04	0.000952380952380952	6518	1
2	Food 2	Intake 4	26	211874	1337544389	/users/cn/jespinosa/phecomp/data/CRG/20120502_FDF_CRG/20120502_FDF_CRG/20120518_FDF_CRG_c12.mtb	5612	121	WWFF	food_fat	4	211848	1337544363	1	0.04	0.00153846153846154	6519	1
2	Food 2	Intake 4	55	212050	1337544565	/users/cn/jespinosa/phecomp/data/CRG/20120502_FDF_CRG/20120502_FDF_CRG/20120518_FDF_CRG_c12.mtb	5613	7554	WWFF	food_fat	4	211995	1337544510	1	0.0200000000000005	0.000363636363636373	6520	1
2	Drink 2	Intake 2	17	215332	1337547847	/users/cn/jespinosa/phecomp/data/CRG/20120502_FDF_CRG/20120502_FDF_CRG/20120518_FDF_CRG_c12.mtb	1760	NA	WWFF	water	2	215315	1337547830	1	0.04	0.00235294117647059	6521	1
2	Drink 2	Intake 2	13	215679	1337548194	/users/cn/jespinosa/phecomp/data/CRG/20120502_FDF_CRG/20120502_FDF_CRG/20120518_FDF_CRG_c12.mtb	1761	NA	WWFF	water	2	215666	1337548181	1	0.02	0.00153846153846154	6522	1
2	Drink 2	Intake 2	23	215980	1337548495	/users/cn/jespinosa/phecomp/data/CRG/20120502_FDF_CRG/20120502_FDF_CRG/20120518_FDF_CRG_c12.mtb	1762	NA	WWFF	water	2	215957	1337548472	1	0.04	0.00173913043478261	6523	1
2	Drink 2	Intake 2	15	216006	1337548521	/users/cn/jespinosa/phecomp/data/CRG/20120502_FDF_CRG/20120502_FDF_CRG/20120518_FDF_CRG_c12.mtb	1763	NA	WWFF	water	2	215991	1337548506	1	0.04	0.00266666666666667	6524	1
2	Food 2	Intake 4	16	219620	1337552135	/users/cn/jespinosa/phecomp/data/CRG/20120502_FDF_CRG/20120502_FDF_CRG/20120518_FDF_CRG_c12.mtb	5616	43	WWFF	food_fat	4	219604	1337552119	1	0.04	0.0025	6525	1
2	Food 2	Intake 4	20	219683	1337552198	/users/cn/jespinosa/phecomp/data/CRG/20120502_FDF_CRG/20120502_FDF_CRG/20120518_FDF_CRG_c12.mtb	5617	149	WWFF	food_fat	4	219663	1337552178	1	0.04	0.002	6526	1
2	Food 2	Intake 4	94	219926	1337552441	/users/cn/jespinosa/phecomp/data/CRG/20120502_FDF_CRG/20120502_FDF_CRG/20120518_FDF_CRG_c12.mtb	5619	857	WWFF	food_fat	4	219832	1337552347	1	0.0999999999999996	0.00106382978723404	6527	1
2	Drink 1	Intake 1	23	220684	1337553199	/users/cn/jespinosa/phecomp/data/CRG/20120502_FDF_CRG/20120502_FDF_CRG/20120518_FDF_CRG_c12.mtb	1147	NA	WWFF	water	1	220661	1337553176	1	0.04	0.00173913043478261	6528	1
2	Food 2	Intake 4	62	220845	1337553360	/users/cn/jespinosa/phecomp/data/CRG/20120502_FDF_CRG/20120502_FDF_CRG/20120518_FDF_CRG_c12.mtb	5621	1130	WWFF	food_fat	4	220783	1337553298	1	0.140000000000001	0.00225806451612905	6529	1
2	Drink 2	Intake 2	20	221090	1337553605	/users/cn/jespinosa/phecomp/data/CRG/20120502_FDF_CRG/20120502_FDF_CRG/20120518_FDF_CRG_c12.mtb	1766	NA	WWFF	water	2	221070	1337553585	1	0.0600000000000001	0.00300000000000001	6530	1
2	Drink 1	Intake 1	25	221386	1337553901	/users/cn/jespinosa/phecomp/data/CRG/20120502_FDF_CRG/20120502_FDF_CRG/20120518_FDF_CRG_c12.mtb	1148	NA	WWFF	water	1	221361	1337553876	1	0.0599999999999999	0.0024	6531	1
2	Drink 2	Intake 2	13	221925	1337554440	/users/cn/jespinosa/phecomp/data/CRG/20120502_FDF_CRG/20120502_FDF_CRG/20120518_FDF_CRG_c12.mtb	1767	NA	WWFF	water	2	221912	1337554427	1	0.04	0.00307692307692308	6532	1
2	Food 1	Intake 3	75	222050	1337554565	/users/cn/jespinosa/phecomp/data/CRG/20120502_FDF_CRG/20120502_FDF_CRG/20120518_FDF_CRG_c12.mtb	3901	283	WWFF	food_fat	3	221975	1337554490	1	0.0200000000000005	0.000266666666666673	6533	1
2	Food 2	Intake 4	55	222388	1337554903	/users/cn/jespinosa/phecomp/data/CRG/20120502_FDF_CRG/20120502_FDF_CRG/20120518_FDF_CRG_c12.mtb	5622	5357	WWFF	food_fat	4	222333	1337554848	1	0.04	0.000727272727272727	6534	1
2	Drink 2	Intake 2	19	227697	1337560212	/users/cn/jespinosa/phecomp/data/CRG/20120502_FDF_CRG/20120502_FDF_CRG/20120518_FDF_CRG_c12.mtb	1769	NA	WWFF	water	2	227678	1337560193	1	0.02	0.00105263157894737	6535	1
2	Food 2	Intake 4	44	227789	1337560304	/users/cn/jespinosa/phecomp/data/CRG/20120502_FDF_CRG/20120502_FDF_CRG/20120518_FDF_CRG_c12.mtb	5625	570	WWFF	food_fat	4	227745	1337560260	1	0.0200000000000005	0.000454545454545466	6536	1
2	Drink 2	Intake 2	13	227798	1337560313	/users/cn/jespinosa/phecomp/data/CRG/20120502_FDF_CRG/20120502_FDF_CRG/20120518_FDF_CRG_c12.mtb	1770	NA	WWFF	water	2	227785	1337560300	1	0.02	0.00153846153846154	6537	1
2	Food 2	Intake 4	60	228419	1337560934	/users/cn/jespinosa/phecomp/data/CRG/20120502_FDF_CRG/20120502_FDF_CRG/20120518_FDF_CRG_c12.mtb	5628	12	WWFF	food_fat	4	228359	1337560874	1	0.0200000000000005	0.000333333333333342	6538	1
2	Food 1	Intake 3	79	228510	1337561025	/users/cn/jespinosa/phecomp/data/CRG/20120502_FDF_CRG/20120502_FDF_CRG/20120518_FDF_CRG_c12.mtb	3908	3941	WWFF	food_fat	3	228431	1337560946	1	0.0200000000000005	0.000253164556962032	6539	1
2	Drink 2	Intake 2	36	228626	1337561141	/users/cn/jespinosa/phecomp/data/CRG/20120502_FDF_CRG/20120502_FDF_CRG/20120518_FDF_CRG_c12.mtb	1772	NA	WWFF	water	2	228590	1337561105	1	0.0600000000000001	0.00166666666666667	6540	1
2	Drink 2	Intake 2	18	228809	1337561324	/users/cn/jespinosa/phecomp/data/CRG/20120502_FDF_CRG/20120502_FDF_CRG/20120518_FDF_CRG_c12.mtb	1773	NA	WWFF	water	2	228791	1337561306	1	0.0599999999999996	0.00333333333333331	6541	1
2	Drink 2	Intake 2	15	229438	1337561953	/users/cn/jespinosa/phecomp/data/CRG/20120502_FDF_CRG/20120502_FDF_CRG/20120518_FDF_CRG_c12.mtb	1774	NA	WWFF	water	2	229423	1337561938	1	0.04	0.00266666666666667	6542	1
2	Food 2	Intake 4	34	232485	1337565000	/users/cn/jespinosa/phecomp/data/CRG/20120502_FDF_CRG/20120502_FDF_CRG/20120518_FDF_CRG_c12.mtb	5629	2358	WWFF	food_fat	4	232451	1337564966	1	0.0599999999999996	0.00176470588235293	6543	1
2	Food 2	Intake 4	25	234868	1337567383	/users/cn/jespinosa/phecomp/data/CRG/20120502_FDF_CRG/20120502_FDF_CRG/20120518_FDF_CRG_c12.mtb	5630	2230	WWFF	food_fat	4	234843	1337567358	1	0.0200000000000005	0.00080000000000002	6544	1
2	Drink 2	Intake 2	15	236118	1337568633	/users/cn/jespinosa/phecomp/data/CRG/20120502_FDF_CRG/20120502_FDF_CRG/20120518_FDF_CRG_c12.mtb	1776	NA	WWFF	water	2	236103	1337568618	1	0.0600000000000001	0.00400000000000001	6545	1
2	Food 2	Intake 4	22	237120	1337569635	/users/cn/jespinosa/phecomp/data/CRG/20120502_FDF_CRG/20120502_FDF_CRG/20120518_FDF_CRG_c12.mtb	5632	1500	WWFF	food_fat	4	237098	1337569613	1	0.0200000000000005	0.000909090909090932	6546	1
2	Food 2	Intake 4	102	238722	1337571237	/users/cn/jespinosa/phecomp/data/CRG/20120502_FDF_CRG/20120502_FDF_CRG/20120518_FDF_CRG_c12.mtb	5634	562	WWFF	food_fat	4	238620	1337571135	1	0.0399999999999991	0.000392156862745089	6547	1
2	Drink 2	Intake 2	24	239088	1337571603	/users/cn/jespinosa/phecomp/data/CRG/20120502_FDF_CRG/20120502_FDF_CRG/20120518_FDF_CRG_c12.mtb	1777	NA	WWFF	water	2	239064	1337571579	1	0.0800000000000001	0.00333333333333334	6548	1
2	Food 2	Intake 4	33	239317	1337571832	/users/cn/jespinosa/phecomp/data/CRG/20120502_FDF_CRG/20120502_FDF_CRG/20120518_FDF_CRG_c12.mtb	5637	4856	WWFF	food_fat	4	239284	1337571799	1	0.0200000000000005	0.000606060606060621	6549	1
2	Drink 2	Intake 2	12	239622	1337572137	/users/cn/jespinosa/phecomp/data/CRG/20120502_FDF_CRG/20120502_FDF_CRG/20120518_FDF_CRG_c12.mtb	1778	NA	WWFF	water	2	239610	1337572125	1	0.02	0.00166666666666667	6550	1
2	Drink 2	Intake 2	15	239959	1337572474	/users/cn/jespinosa/phecomp/data/CRG/20120502_FDF_CRG/20120502_FDF_CRG/20120518_FDF_CRG_c12.mtb	1779	NA	WWFF	water	2	239944	1337572459	1	0.04	0.00266666666666667	6551	1
2	Drink 1	Intake 1	24	241932	1337574447	/users/cn/jespinosa/phecomp/data/CRG/20120502_FDF_CRG/20120502_FDF_CRG/20120518_FDF_CRG_c12.mtb	1152	NA	WWFF	water	1	241908	1337574423	1	0.04	0.00166666666666667	6552	1
2	Food 2	Intake 4	45	244218	1337576733	/users/cn/jespinosa/phecomp/data/CRG/20120502_FDF_CRG/20120502_FDF_CRG/20120518_FDF_CRG_c12.mtb	5640	2004	WWFF	food_fat	4	244173	1337576688	1	0.0599999999999996	0.00133333333333332	6553	1
2	Drink 2	Intake 2	13	244722	1337577237	/users/cn/jespinosa/phecomp/data/CRG/20120502_FDF_CRG/20120502_FDF_CRG/20120518_FDF_CRG_c12.mtb	1781	NA	WWFF	water	2	244709	1337577224	1	0.04	0.00307692307692308	6554	1
2	Drink 2	Intake 2	23	245158	1337577673	/users/cn/jespinosa/phecomp/data/CRG/20120502_FDF_CRG/20120502_FDF_CRG/20120518_FDF_CRG_c12.mtb	1782	NA	WWFF	water	2	245135	1337577650	1	0.0599999999999996	0.0026086956521739	6555	1
2	Drink 1	Intake 1	16	245235	1337577750	/users/cn/jespinosa/phecomp/data/CRG/20120502_FDF_CRG/20120502_FDF_CRG/20120518_FDF_CRG_c12.mtb	1154	NA	WWFF	water	1	245219	1337577734	1	0.02	0.00125	6556	1
2	Drink 2	Intake 2	18	245775	1337578290	/users/cn/jespinosa/phecomp/data/CRG/20120502_FDF_CRG/20120502_FDF_CRG/20120518_FDF_CRG_c12.mtb	1783	NA	WWFF	water	2	245757	1337578272	1	0.0800000000000001	0.00444444444444445	6557	1
2	Food 2	Intake 4	29	246251	1337578766	/users/cn/jespinosa/phecomp/data/CRG/20120502_FDF_CRG/20120502_FDF_CRG/20120518_FDF_CRG_c12.mtb	5646	5574	WWFF	food_fat	4	246222	1337578737	1	0.0200000000000005	0.00068965517241381	6558	1
2	Food 2	Intake 4	16	251841	1337584356	/users/cn/jespinosa/phecomp/data/CRG/20120502_FDF_CRG/20120502_FDF_CRG/20120518_FDF_CRG_c12.mtb	5648	29	WWFF	food_fat	4	251825	1337584340	1	0.0600000000000005	0.00375000000000003	6559	1
2	Food 2	Intake 4	13	251883	1337584398	/users/cn/jespinosa/phecomp/data/CRG/20120502_FDF_CRG/20120502_FDF_CRG/20120518_FDF_CRG_c12.mtb	5649	25	WWFF	food_fat	4	251870	1337584385	1	0.04	0.00307692307692308	6560	1
2	Food 2	Intake 4	15	251923	1337584438	/users/cn/jespinosa/phecomp/data/CRG/20120502_FDF_CRG/20120502_FDF_CRG/20120518_FDF_CRG_c12.mtb	5650	8292	WWFF	food_fat	4	251908	1337584423	1	0.0599999999999996	0.00399999999999997	6561	1
2	Drink 2	Intake 2	14	254639	1337587154	/users/cn/jespinosa/phecomp/data/CRG/20120502_FDF_CRG/20120502_FDF_CRG/20120518_FDF_CRG_c12.mtb	1784	NA	WWFF	water	2	254625	1337587140	1	0.0800000000000001	0.00571428571428572	6562	1
2	Food 2	Intake 4	41	260256	1337592771	/users/cn/jespinosa/phecomp/data/CRG/20120502_FDF_CRG/20120502_FDF_CRG/20120518_FDF_CRG_c12.mtb	5651	9335	WWFF	food_fat	4	260215	1337592730	1	0.12	0.00292682926829268	6563	1
2	Drink 2	Intake 2	13	261429	1337593944	/users/cn/jespinosa/phecomp/data/CRG/20120502_FDF_CRG/20120502_FDF_CRG/20120518_FDF_CRG_c12.mtb	1786	NA	WWFF	water	2	261416	1337593931	1	0.0600000000000005	0.00461538461538465	6564	1
2	Drink 2	Intake 2	27	261465	1337593980	/users/cn/jespinosa/phecomp/data/CRG/20120502_FDF_CRG/20120502_FDF_CRG/20120518_FDF_CRG_c12.mtb	1787	NA	WWFF	water	2	261438	1337593953	1	0.04	0.00148148148148148	6565	1
2	Food 1	Intake 3	38	200	1337602144	/users/cn/jespinosa/phecomp/data/CRG/20120502_FDF_CRG/20120502_FDF_CRG/20120521_FDF_CRG_c12.mtb	5639	15	WWFF	food_fat	3	162	1337602106	1	0.42	0.0110526315789474	6566	1
2	Food 1	Intake 3	54	269	1337602213	/users/cn/jespinosa/phecomp/data/CRG/20120502_FDF_CRG/20120502_FDF_CRG/20120521_FDF_CRG_c12.mtb	5640	COLL	WWFF	food_fat	3	215	1337602159	1	0.12	0.00222222222222222	6567	1
2	Food 2	Intake 4	61	319	1337602263	/users/cn/jespinosa/phecomp/data/CRG/20120502_FDF_CRG/20120502_FDF_CRG/20120521_FDF_CRG_c12.mtb	7087	COLL	WWFF	food_fat	4	258	1337602202	1	0.1	0.00163934426229508	6568	1
2	Food 1	Intake 3	62	372	1337602316	/users/cn/jespinosa/phecomp/data/CRG/20120502_FDF_CRG/20120502_FDF_CRG/20120521_FDF_CRG_c12.mtb	5641	COLL	WWFF	food_fat	3	310	1337602254	1	0.4	0.00645161290322581	6569	1
2	Food 2	Intake 4	15	342	1337602286	/users/cn/jespinosa/phecomp/data/CRG/20120502_FDF_CRG/20120502_FDF_CRG/20120521_FDF_CRG_c12.mtb	7088	52	WWFF	food_fat	4	327	1337602271	1	0.04	0.00266666666666667	6570	1
2	Food 2	Intake 4	46	440	1337602384	/users/cn/jespinosa/phecomp/data/CRG/20120502_FDF_CRG/20120502_FDF_CRG/20120521_FDF_CRG_c12.mtb	7089	COLL	WWFF	food_fat	4	394	1337602338	1	0.06	0.00130434782608696	6571	1
2	Food 1	Intake 3	29	457	1337602401	/users/cn/jespinosa/phecomp/data/CRG/20120502_FDF_CRG/20120502_FDF_CRG/20120521_FDF_CRG_c12.mtb	5642	COLL	WWFF	food_fat	3	428	1337602372	1	0.32	0.0110344827586207	6572	1
2	Food 2	Intake 4	82	530	1337602474	/users/cn/jespinosa/phecomp/data/CRG/20120502_FDF_CRG/20120502_FDF_CRG/20120521_FDF_CRG_c12.mtb	7090	COLL	WWFF	food_fat	4	448	1337602392	1	0.6	0.00731707317073171	6573	1
2	Food 1	Intake 3	39	509	1337602453	/users/cn/jespinosa/phecomp/data/CRG/20120502_FDF_CRG/20120502_FDF_CRG/20120521_FDF_CRG_c12.mtb	5643	9	WWFF	food_fat	3	470	1337602414	1	0.16	0.0041025641025641	6574	1
2	Food 1	Intake 3	54	572	1337602516	/users/cn/jespinosa/phecomp/data/CRG/20120502_FDF_CRG/20120502_FDF_CRG/20120521_FDF_CRG_c12.mtb	5644	16	WWFF	food_fat	3	518	1337602462	1	0.78	0.0144444444444444	6575	1
2	Food 2	Intake 4	69	657	1337602601	/users/cn/jespinosa/phecomp/data/CRG/20120502_FDF_CRG/20120502_FDF_CRG/20120521_FDF_CRG_c12.mtb	7092	COLL	WWFF	food_fat	4	588	1337602532	1	0.28	0.00405797101449275	6576	1
2	Food 1	Intake 3	61	651	1337602595	/users/cn/jespinosa/phecomp/data/CRG/20120502_FDF_CRG/20120502_FDF_CRG/20120521_FDF_CRG_c12.mtb	5645	44	WWFF	food_fat	3	590	1337602534	1	0.02	0.000327868852459016	6577	1
2	Food 1	Intake 3	55	750	1337602694	/users/cn/jespinosa/phecomp/data/CRG/20120502_FDF_CRG/20120502_FDF_CRG/20120521_FDF_CRG_c12.mtb	5646	COLL	WWFF	food_fat	3	695	1337602639	1	0.2	0.00363636363636364	6578	1
2	Food 2	Intake 4	63	791	1337602735	/users/cn/jespinosa/phecomp/data/CRG/20120502_FDF_CRG/20120502_FDF_CRG/20120521_FDF_CRG_c12.mtb	7094	COLL	WWFF	food_fat	4	728	1337602672	1	0.2	0.00317460317460317	6579	1
2	Food 1	Intake 3	69	840	1337602784	/users/cn/jespinosa/phecomp/data/CRG/20120502_FDF_CRG/20120502_FDF_CRG/20120521_FDF_CRG_c12.mtb	5647	COLL	WWFF	food_fat	3	771	1337602715	1	0.12	0.00173913043478261	6580	1
2	Food 2	Intake 4	16	818	1337602762	/users/cn/jespinosa/phecomp/data/CRG/20120502_FDF_CRG/20120502_FDF_CRG/20120521_FDF_CRG_c12.mtb	7095	11	WWFF	food_fat	4	802	1337602746	1	0.02	0.00125	6581	1
2	Food 2	Intake 4	49	878	1337602822	/users/cn/jespinosa/phecomp/data/CRG/20120502_FDF_CRG/20120502_FDF_CRG/20120521_FDF_CRG_c12.mtb	7096	COLL	WWFF	food_fat	4	829	1337602773	1	0.72	0.0146938775510204	6582	1
2	Food 1	Intake 3	52	900	1337602844	/users/cn/jespinosa/phecomp/data/CRG/20120502_FDF_CRG/20120502_FDF_CRG/20120521_FDF_CRG_c12.mtb	5648	COLL	WWFF	food_fat	3	848	1337602792	1	0.4	0.00769230769230769	6583	1
2	Food 2	Intake 4	26	916	1337602860	/users/cn/jespinosa/phecomp/data/CRG/20120502_FDF_CRG/20120502_FDF_CRG/20120521_FDF_CRG_c12.mtb	7097	82	WWFF	food_fat	4	890	1337602834	1	0.02	0.000769230769230769	6584	1
2	Food 2	Intake 4	83	1081	1337603025	/users/cn/jespinosa/phecomp/data/CRG/20120502_FDF_CRG/20120502_FDF_CRG/20120521_FDF_CRG_c12.mtb	7098	93	WWFF	food_fat	4	998	1337602942	1	0.32	0.00385542168674699	6585	1
2	Food 1	Intake 3	27	1201	1337603145	/users/cn/jespinosa/phecomp/data/CRG/20120502_FDF_CRG/20120502_FDF_CRG/20120521_FDF_CRG_c12.mtb	5650	14	WWFF	food_fat	3	1174	1337603118	1	0.02	0.000740740740740741	6586	1
2	Food 2	Intake 4	130	1345	1337603289	/users/cn/jespinosa/phecomp/data/CRG/20120502_FDF_CRG/20120502_FDF_CRG/20120521_FDF_CRG_c12.mtb	7099	COLL	WWFF	food_fat	4	1215	1337603159	1	1.44	0.0110769230769231	6587	1
2	Food 1	Intake 3	46	1378	1337603322	/users/cn/jespinosa/phecomp/data/CRG/20120502_FDF_CRG/20120502_FDF_CRG/20120521_FDF_CRG_c12.mtb	5651	COLL	WWFF	food_fat	3	1332	1337603276	1	0.0800000000000001	0.00173913043478261	6588	1
2	Food 2	Intake 4	34	1410	1337603354	/users/cn/jespinosa/phecomp/data/CRG/20120502_FDF_CRG/20120502_FDF_CRG/20120521_FDF_CRG_c12.mtb	7100	157	WWFF	food_fat	4	1376	1337603320	1	0.28	0.00823529411764706	6589	1
2	Food 2	Intake 4	54	1621	1337603565	/users/cn/jespinosa/phecomp/data/CRG/20120502_FDF_CRG/20120502_FDF_CRG/20120521_FDF_CRG_c12.mtb	7101	15	WWFF	food_fat	4	1567	1337603511	1	0.4	0.00740740740740741	6590	1
2	Food 1	Intake 3	25	1661	1337603605	/users/cn/jespinosa/phecomp/data/CRG/20120502_FDF_CRG/20120502_FDF_CRG/20120521_FDF_CRG_c12.mtb	5653	8	WWFF	food_fat	3	1636	1337603580	1	0.0800000000000001	0.0032	6591	1
2	Food 2	Intake 4	29	1698	1337603642	/users/cn/jespinosa/phecomp/data/CRG/20120502_FDF_CRG/20120502_FDF_CRG/20120521_FDF_CRG_c12.mtb	7102	61	WWFF	food_fat	4	1669	1337603613	1	0.04	0.00137931034482759	6592	1
2	Food 2	Intake 4	160	1919	1337603863	/users/cn/jespinosa/phecomp/data/CRG/20120502_FDF_CRG/20120502_FDF_CRG/20120521_FDF_CRG_c12.mtb	7103	118	WWFF	food_fat	4	1759	1337603703	1	0.12	0.00075	6593	1
2	Food 2	Intake 4	76	2113	1337604057	/users/cn/jespinosa/phecomp/data/CRG/20120502_FDF_CRG/20120502_FDF_CRG/20120521_FDF_CRG_c12.mtb	7105	75	WWFF	food_fat	4	2037	1337603981	1	0.58	0.00763157894736842	6594	1
2	Food 2	Intake 4	106	2294	1337604238	/users/cn/jespinosa/phecomp/data/CRG/20120502_FDF_CRG/20120502_FDF_CRG/20120521_FDF_CRG_c12.mtb	7107	895	WWFF	food_fat	4	2188	1337604132	1	0.44	0.00415094339622642	6595	1
2	Food 2	Intake 4	12	3201	1337605145	/users/cn/jespinosa/phecomp/data/CRG/20120502_FDF_CRG/20120502_FDF_CRG/20120521_FDF_CRG_c12.mtb	7108	255	WWFF	food_fat	4	3189	1337605133	1	0.0200000000000005	0.00166666666666671	6596	1
2	Food 2	Intake 4	14	3470	1337605414	/users/cn/jespinosa/phecomp/data/CRG/20120502_FDF_CRG/20120502_FDF_CRG/20120521_FDF_CRG_c12.mtb	7110	17	WWFF	food_fat	4	3456	1337605400	1	0.0200000000000005	0.00142857142857146	6597	1
2	Food 1	Intake 3	65	3552	1337605496	/users/cn/jespinosa/phecomp/data/CRG/20120502_FDF_CRG/20120502_FDF_CRG/20120521_FDF_CRG_c12.mtb	5659	291	WWFF	food_fat	3	3487	1337605431	1	0.1	0.00153846153846154	6598	1
2	Drink 1	Intake 1	20	3622	1337605566	/users/cn/jespinosa/phecomp/data/CRG/20120502_FDF_CRG/20120502_FDF_CRG/20120521_FDF_CRG_c12.mtb	1325	NA	WWFF	water	1	3602	1337605546	1	0.04	0.002	6599	1
2	Food 2	Intake 4	77	3920	1337605864	/users/cn/jespinosa/phecomp/data/CRG/20120502_FDF_CRG/20120502_FDF_CRG/20120521_FDF_CRG_c12.mtb	7113	70	WWFF	food_fat	4	3843	1337605787	1	0.18	0.00233766233766234	6600	1
2	Food 1	Intake 3	68	4058	1337606002	/users/cn/jespinosa/phecomp/data/CRG/20120502_FDF_CRG/20120502_FDF_CRG/20120521_FDF_CRG_c12.mtb	5661	COLL	WWFF	food_fat	3	3990	1337605934	1	0.0399999999999996	0.000588235294117641	6601	1
2	Food 2	Intake 4	124	4171	1337606115	/users/cn/jespinosa/phecomp/data/CRG/20120502_FDF_CRG/20120502_FDF_CRG/20120521_FDF_CRG_c12.mtb	7115	14713	WWFF	food_fat	4	4047	1337605991	1	0.0400000000000009	0.000322580645161298	6602	1
2	Drink 2	Intake 2	20	12249	1337614193	/users/cn/jespinosa/phecomp/data/CRG/20120502_FDF_CRG/20120502_FDF_CRG/20120521_FDF_CRG_c12.mtb	1965	NA	WWFF	water	2	12229	1337614173	1	0.08	0.004	6603	1
2	Drink 2	Intake 2	35	17054	1337618998	/users/cn/jespinosa/phecomp/data/CRG/20120502_FDF_CRG/20120502_FDF_CRG/20120521_FDF_CRG_c12.mtb	1966	NA	WWFF	water	2	17019	1337618963	1	0.12	0.00342857142857143	6604	1
2	Drink 2	Intake 2	12	18842	1337620786	/users/cn/jespinosa/phecomp/data/CRG/20120502_FDF_CRG/20120502_FDF_CRG/20120521_FDF_CRG_c12.mtb	1967	NA	WWFF	water	2	18830	1337620774	1	0.04	0.00333333333333333	6605	1
2	Food 2	Intake 4	22	18906	1337620850	/users/cn/jespinosa/phecomp/data/CRG/20120502_FDF_CRG/20120502_FDF_CRG/20120521_FDF_CRG_c12.mtb	7117	126	WWFF	food_fat	4	18884	1337620828	1	0.0200000000000005	0.000909090909090932	6606	1
2	Drink 2	Intake 2	20	19008	1337620952	/users/cn/jespinosa/phecomp/data/CRG/20120502_FDF_CRG/20120502_FDF_CRG/20120521_FDF_CRG_c12.mtb	1968	NA	WWFF	water	2	18988	1337620932	1	0.02	0.001	6607	1
2	Food 1	Intake 3	42	19074	1337621018	/users/cn/jespinosa/phecomp/data/CRG/20120502_FDF_CRG/20120502_FDF_CRG/20120521_FDF_CRG_c12.mtb	5663	13	WWFF	food_fat	3	19032	1337620976	1	0.1	0.00238095238095238	6608	1
2	Food 2	Intake 4	11	19098	1337621042	/users/cn/jespinosa/phecomp/data/CRG/20120502_FDF_CRG/20120502_FDF_CRG/20120521_FDF_CRG_c12.mtb	7121	4675	WWFF	food_fat	4	19087	1337621031	1	0.0600000000000005	0.0054545454545455	6609	1
2	Drink 2	Intake 2	20	19228	1337621172	/users/cn/jespinosa/phecomp/data/CRG/20120502_FDF_CRG/20120502_FDF_CRG/20120521_FDF_CRG_c12.mtb	1969	NA	WWFF	water	2	19208	1337621152	1	0.08	0.004	6610	1
2	Food 2	Intake 4	52	23825	1337625769	/users/cn/jespinosa/phecomp/data/CRG/20120502_FDF_CRG/20120502_FDF_CRG/20120521_FDF_CRG_c12.mtb	7124	6	WWFF	food_fat	4	23773	1337625717	1	0.04	0.000769230769230769	6611	1
2	Drink 2	Intake 2	14	23841	1337625785	/users/cn/jespinosa/phecomp/data/CRG/20120502_FDF_CRG/20120502_FDF_CRG/20120521_FDF_CRG_c12.mtb	1970	NA	WWFF	water	2	23827	1337625771	1	0.06	0.00428571428571429	6612	1
2	Food 2	Intake 4	36	23867	1337625811	/users/cn/jespinosa/phecomp/data/CRG/20120502_FDF_CRG/20120502_FDF_CRG/20120521_FDF_CRG_c12.mtb	7125	199	WWFF	food_fat	4	23831	1337625775	1	0.0200000000000005	0.000555555555555569	6613	1
2	Drink 2	Intake 2	22	24000	1337625944	/users/cn/jespinosa/phecomp/data/CRG/20120502_FDF_CRG/20120502_FDF_CRG/20120521_FDF_CRG_c12.mtb	1972	NA	WWFF	water	2	23978	1337625922	1	0.04	0.00181818181818182	6614	1
2	Food 2	Intake 4	12	24078	1337626022	/users/cn/jespinosa/phecomp/data/CRG/20120502_FDF_CRG/20120502_FDF_CRG/20120521_FDF_CRG_c12.mtb	7129	33	WWFF	food_fat	4	24066	1337626010	1	0.0399999999999991	0.00333333333333326	6615	1
2	Food 2	Intake 4	46	24157	1337626101	/users/cn/jespinosa/phecomp/data/CRG/20120502_FDF_CRG/20120502_FDF_CRG/20120521_FDF_CRG_c12.mtb	7131	46	WWFF	food_fat	4	24111	1337626055	1	0.0600000000000005	0.00130434782608697	6616	1
2	Food 2	Intake 4	229	24432	1337626376	/users/cn/jespinosa/phecomp/data/CRG/20120502_FDF_CRG/20120502_FDF_CRG/20120521_FDF_CRG_c12.mtb	7132	117	WWFF	food_fat	4	24203	1337626147	1	0.32	0.00139737991266376	6617	1
2	Drink 2	Intake 2	30	24554	1337626498	/users/cn/jespinosa/phecomp/data/CRG/20120502_FDF_CRG/20120502_FDF_CRG/20120521_FDF_CRG_c12.mtb	1973	NA	WWFF	water	2	24524	1337626468	1	0.06	0.002	6618	1
2	Food 2	Intake 4	124	24673	1337626617	/users/cn/jespinosa/phecomp/data/CRG/20120502_FDF_CRG/20120502_FDF_CRG/20120521_FDF_CRG_c12.mtb	7134	100	WWFF	food_fat	4	24549	1337626493	1	0.46	0.00370967741935484	6619	1
2	Food 2	Intake 4	31	24804	1337626748	/users/cn/jespinosa/phecomp/data/CRG/20120502_FDF_CRG/20120502_FDF_CRG/20120521_FDF_CRG_c12.mtb	7136	241	WWFF	food_fat	4	24773	1337626717	1	0.04	0.00129032258064516	6620	1
2	Drink 2	Intake 2	13	24809	1337626753	/users/cn/jespinosa/phecomp/data/CRG/20120502_FDF_CRG/20120502_FDF_CRG/20120521_FDF_CRG_c12.mtb	1974	NA	WWFF	water	2	24796	1337626740	1	0.04	0.00307692307692308	6621	1
2	Food 2	Intake 4	60	25105	1337627049	/users/cn/jespinosa/phecomp/data/CRG/20120502_FDF_CRG/20120502_FDF_CRG/20120521_FDF_CRG_c12.mtb	7138	86	WWFF	food_fat	4	25045	1337626989	1	0.04	0.000666666666666667	6622	1
2	Food 2	Intake 4	20	25211	1337627155	/users/cn/jespinosa/phecomp/data/CRG/20120502_FDF_CRG/20120502_FDF_CRG/20120521_FDF_CRG_c12.mtb	7140	641	WWFF	food_fat	4	25191	1337627135	1	0.0200000000000005	0.00100000000000002	6623	1
2	Food 2	Intake 4	46	25898	1337627842	/users/cn/jespinosa/phecomp/data/CRG/20120502_FDF_CRG/20120502_FDF_CRG/20120521_FDF_CRG_c12.mtb	7148	COLL	WWFF	food_fat	4	25852	1337627796	1	0.0200000000000005	0.000434782608695663	6624	1
2	Food 1	Intake 3	31	25896	1337627840	/users/cn/jespinosa/phecomp/data/CRG/20120502_FDF_CRG/20120502_FDF_CRG/20120521_FDF_CRG_c12.mtb	5671	389	WWFF	food_fat	3	25865	1337627809	1	0.02	0.000645161290322581	6625	1
2	Drink 2	Intake 2	38	25941	1337627885	/users/cn/jespinosa/phecomp/data/CRG/20120502_FDF_CRG/20120502_FDF_CRG/20120521_FDF_CRG_c12.mtb	1976	NA	WWFF	water	2	25903	1337627847	1	0.02	0.000526315789473684	6626	1
2	Food 1	Intake 3	15	26300	1337628244	/users/cn/jespinosa/phecomp/data/CRG/20120502_FDF_CRG/20120502_FDF_CRG/20120521_FDF_CRG_c12.mtb	5672	1194	WWFF	food_fat	3	26285	1337628229	1	0.04	0.00266666666666667	6627	1
2	Drink 2	Intake 2	46	26493	1337628437	/users/cn/jespinosa/phecomp/data/CRG/20120502_FDF_CRG/20120502_FDF_CRG/20120521_FDF_CRG_c12.mtb	1977	NA	WWFF	water	2	26447	1337628391	1	0.0399999999999999	0.000869565217391302	6628	1
2	Food 2	Intake 4	10	27504	1337629448	/users/cn/jespinosa/phecomp/data/CRG/20120502_FDF_CRG/20120502_FDF_CRG/20120521_FDF_CRG_c12.mtb	7156	1103	WWFF	food_fat	4	27494	1337629438	1	0.0200000000000005	0.00200000000000005	6629	1
2	Food 1	Intake 3	27	28634	1337630578	/users/cn/jespinosa/phecomp/data/CRG/20120502_FDF_CRG/20120502_FDF_CRG/20120521_FDF_CRG_c12.mtb	5673	8	WWFF	food_fat	3	28607	1337630551	1	0.0600000000000001	0.00222222222222223	6630	1
2	Food 1	Intake 3	29	28671	1337630615	/users/cn/jespinosa/phecomp/data/CRG/20120502_FDF_CRG/20120502_FDF_CRG/20120521_FDF_CRG_c12.mtb	5674	1700	WWFF	food_fat	3	28642	1337630586	1	0.04	0.00137931034482759	6631	1
2	Food 1	Intake 3	41	30412	1337632356	/users/cn/jespinosa/phecomp/data/CRG/20120502_FDF_CRG/20120502_FDF_CRG/20120521_FDF_CRG_c12.mtb	5675	17	WWFF	food_fat	3	30371	1337632315	1	0.1	0.0024390243902439	6632	1
2	Food 2	Intake 4	13	30442	1337632386	/users/cn/jespinosa/phecomp/data/CRG/20120502_FDF_CRG/20120502_FDF_CRG/20120521_FDF_CRG_c12.mtb	7162	2189	WWFF	food_fat	4	30429	1337632373	1	0.04	0.00307692307692308	6633	1
2	Drink 2	Intake 2	29	30460	1337632404	/users/cn/jespinosa/phecomp/data/CRG/20120502_FDF_CRG/20120502_FDF_CRG/20120521_FDF_CRG_c12.mtb	1979	NA	WWFF	water	2	30431	1337632375	1	0.04	0.00137931034482759	6634	1
2	Drink 2	Intake 2	11	31181	1337633125	/users/cn/jespinosa/phecomp/data/CRG/20120502_FDF_CRG/20120502_FDF_CRG/20120521_FDF_CRG_c12.mtb	1980	NA	WWFF	water	2	31170	1337633114	1	0.04	0.00363636363636364	6635	1
2	Food 2	Intake 4	20	32651	1337634595	/users/cn/jespinosa/phecomp/data/CRG/20120502_FDF_CRG/20120502_FDF_CRG/20120521_FDF_CRG_c12.mtb	7166	1105	WWFF	food_fat	4	32631	1337634575	1	0.0599999999999996	0.00299999999999998	6636	1
2	Drink 2	Intake 2	25	32667	1337634611	/users/cn/jespinosa/phecomp/data/CRG/20120502_FDF_CRG/20120502_FDF_CRG/20120521_FDF_CRG_c12.mtb	1981	NA	WWFF	water	2	32642	1337634586	1	0.08	0.0032	6637	1
2	Food 1	Intake 3	11	33767	1337635711	/users/cn/jespinosa/phecomp/data/CRG/20120502_FDF_CRG/20120502_FDF_CRG/20120521_FDF_CRG_c12.mtb	5676	6	WWFF	food_fat	3	33756	1337635700	1	0.04	0.00363636363636364	6638	1
2	Food 1	Intake 3	17	33790	1337635734	/users/cn/jespinosa/phecomp/data/CRG/20120502_FDF_CRG/20120502_FDF_CRG/20120521_FDF_CRG_c12.mtb	5677	2171	WWFF	food_fat	3	33773	1337635717	1	0.04	0.00235294117647059	6639	1
2	Drink 2	Intake 2	20	34600	1337636544	/users/cn/jespinosa/phecomp/data/CRG/20120502_FDF_CRG/20120502_FDF_CRG/20120521_FDF_CRG_c12.mtb	1982	NA	WWFF	water	2	34580	1337636524	1	0.04	0.002	6640	1
2	Drink 2	Intake 2	16	35393	1337637337	/users/cn/jespinosa/phecomp/data/CRG/20120502_FDF_CRG/20120502_FDF_CRG/20120521_FDF_CRG_c12.mtb	1983	NA	WWFF	water	2	35377	1337637321	1	0.0599999999999999	0.00374999999999999	6641	1
2	Food 1	Intake 3	18	35979	1337637923	/users/cn/jespinosa/phecomp/data/CRG/20120502_FDF_CRG/20120502_FDF_CRG/20120521_FDF_CRG_c12.mtb	5678	20	WWFF	food_fat	3	35961	1337637905	1	0.0800000000000001	0.00444444444444445	6642	1
2	Food 1	Intake 3	15	36014	1337637958	/users/cn/jespinosa/phecomp/data/CRG/20120502_FDF_CRG/20120502_FDF_CRG/20120521_FDF_CRG_c12.mtb	5679	2073	WWFF	food_fat	3	35999	1337637943	1	0.0399999999999996	0.00266666666666664	6643	1
2	Food 1	Intake 3	27	38114	1337640058	/users/cn/jespinosa/phecomp/data/CRG/20120502_FDF_CRG/20120502_FDF_CRG/20120521_FDF_CRG_c12.mtb	5680	259	WWFF	food_fat	3	38087	1337640031	1	0.02	0.000740740740740741	6644	1
2	Drink 2	Intake 2	18	38157	1337640101	/users/cn/jespinosa/phecomp/data/CRG/20120502_FDF_CRG/20120502_FDF_CRG/20120521_FDF_CRG_c12.mtb	1984	NA	WWFF	water	2	38139	1337640083	1	0.02	0.00111111111111111	6645	1
2	Drink 2	Intake 2	55	38278	1337640222	/users/cn/jespinosa/phecomp/data/CRG/20120502_FDF_CRG/20120502_FDF_CRG/20120521_FDF_CRG_c12.mtb	1986	NA	WWFF	water	2	38223	1337640167	1	0.04	0.000727272727272727	6646	1
2	Food 2	Intake 4	44	38417	1337640361	/users/cn/jespinosa/phecomp/data/CRG/20120502_FDF_CRG/20120502_FDF_CRG/20120521_FDF_CRG_c12.mtb	7178	268	WWFF	food_fat	4	38373	1337640317	1	0.0600000000000005	0.00136363636363638	6647	1
2	Food 2	Intake 4	33	38718	1337640662	/users/cn/jespinosa/phecomp/data/CRG/20120502_FDF_CRG/20120502_FDF_CRG/20120521_FDF_CRG_c12.mtb	7181	587	WWFF	food_fat	4	38685	1337640629	1	0.0200000000000005	0.000606060606060621	6648	1
2	Drink 2	Intake 2	32	38794	1337640738	/users/cn/jespinosa/phecomp/data/CRG/20120502_FDF_CRG/20120502_FDF_CRG/20120521_FDF_CRG_c12.mtb	1990	NA	WWFF	water	2	38762	1337640706	1	0.04	0.00125	6649	1
2	Drink 2	Intake 2	16	39050	1337640994	/users/cn/jespinosa/phecomp/data/CRG/20120502_FDF_CRG/20120502_FDF_CRG/20120521_FDF_CRG_c12.mtb	1991	NA	WWFF	water	2	39034	1337640978	1	0.04	0.0025	6650	1
2	Drink 2	Intake 2	21	39306	1337641250	/users/cn/jespinosa/phecomp/data/CRG/20120502_FDF_CRG/20120502_FDF_CRG/20120521_FDF_CRG_c12.mtb	1992	NA	WWFF	water	2	39285	1337641229	1	0.04	0.0019047619047619	6651	1
2	Food 2	Intake 4	62	39367	1337641311	/users/cn/jespinosa/phecomp/data/CRG/20120502_FDF_CRG/20120502_FDF_CRG/20120521_FDF_CRG_c12.mtb	7186	181	WWFF	food_fat	4	39305	1337641249	1	0.0999999999999996	0.00161290322580645	6652	1
2	Food 2	Intake 4	15	39563	1337641507	/users/cn/jespinosa/phecomp/data/CRG/20120502_FDF_CRG/20120502_FDF_CRG/20120521_FDF_CRG_c12.mtb	7187	897	WWFF	food_fat	4	39548	1337641492	1	0.0200000000000005	0.00133333333333337	6653	1
2	Drink 2	Intake 2	15	39880	1337641824	/users/cn/jespinosa/phecomp/data/CRG/20120502_FDF_CRG/20120502_FDF_CRG/20120521_FDF_CRG_c12.mtb	1993	NA	WWFF	water	2	39865	1337641809	1	0.04	0.00266666666666667	6654	1
2	Food 2	Intake 4	12	40472	1337642416	/users/cn/jespinosa/phecomp/data/CRG/20120502_FDF_CRG/20120502_FDF_CRG/20120521_FDF_CRG_c12.mtb	7189	331	WWFF	food_fat	4	40460	1337642404	1	0.0200000000000005	0.00166666666666671	6655	1
2	Drink 2	Intake 2	17	40594	1337642538	/users/cn/jespinosa/phecomp/data/CRG/20120502_FDF_CRG/20120502_FDF_CRG/20120521_FDF_CRG_c12.mtb	1996	NA	WWFF	water	2	40577	1337642521	1	0.02	0.00117647058823529	6656	1
2	Food 2	Intake 4	12	40815	1337642759	/users/cn/jespinosa/phecomp/data/CRG/20120502_FDF_CRG/20120502_FDF_CRG/20120521_FDF_CRG_c12.mtb	7193	2468	WWFF	food_fat	4	40803	1337642747	1	0.0400000000000009	0.00333333333333341	6657	1
2	Drink 2	Intake 2	12	41200	1337643144	/users/cn/jespinosa/phecomp/data/CRG/20120502_FDF_CRG/20120502_FDF_CRG/20120521_FDF_CRG_c12.mtb	1997	NA	WWFF	water	2	41188	1337643132	1	0.02	0.00166666666666667	6658	1
2	Food 1	Intake 3	15	43298	1337645242	/users/cn/jespinosa/phecomp/data/CRG/20120502_FDF_CRG/20120502_FDF_CRG/20120521_FDF_CRG_c12.mtb	5684	14	WWFF	food_fat	3	43283	1337645227	1	0.04	0.00266666666666667	6659	1
2	Food 1	Intake 3	38	43350	1337645294	/users/cn/jespinosa/phecomp/data/CRG/20120502_FDF_CRG/20120502_FDF_CRG/20120521_FDF_CRG_c12.mtb	5685	2755	WWFF	food_fat	3	43312	1337645256	1	0.1	0.00263157894736842	6660	1
2	Food 1	Intake 3	17	46122	1337648066	/users/cn/jespinosa/phecomp/data/CRG/20120502_FDF_CRG/20120502_FDF_CRG/20120521_FDF_CRG_c12.mtb	5686	2236	WWFF	food_fat	3	46105	1337648049	1	0.02	0.00117647058823529	6661	1
2	Drink 2	Intake 2	22	46227	1337648171	/users/cn/jespinosa/phecomp/data/CRG/20120502_FDF_CRG/20120502_FDF_CRG/20120521_FDF_CRG_c12.mtb	1999	NA	WWFF	water	2	46205	1337648149	1	0.0600000000000001	0.00272727272727273	6662	1
2	Drink 2	Intake 2	20	46488	1337648432	/users/cn/jespinosa/phecomp/data/CRG/20120502_FDF_CRG/20120502_FDF_CRG/20120521_FDF_CRG_c12.mtb	2000	NA	WWFF	water	2	46468	1337648412	1	0.04	0.002	6663	1
2	Food 1	Intake 3	37	48395	1337650339	/users/cn/jespinosa/phecomp/data/CRG/20120502_FDF_CRG/20120502_FDF_CRG/20120521_FDF_CRG_c12.mtb	5688	1429	WWFF	food_fat	3	48358	1337650302	1	0.0800000000000001	0.00216216216216216	6664	1
2	Food 2	Intake 4	14	49838	1337651782	/users/cn/jespinosa/phecomp/data/CRG/20120502_FDF_CRG/20120502_FDF_CRG/20120521_FDF_CRG_c12.mtb	7211	1406	WWFF	food_fat	4	49824	1337651768	1	0.0599999999999996	0.00428571428571426	6665	1
2	Drink 2	Intake 2	13	49848	1337651792	/users/cn/jespinosa/phecomp/data/CRG/20120502_FDF_CRG/20120502_FDF_CRG/20120521_FDF_CRG_c12.mtb	2001	NA	WWFF	water	2	49835	1337651779	1	0.0600000000000001	0.00461538461538462	6666	1
2	Food 2	Intake 4	14	51258	1337653202	/users/cn/jespinosa/phecomp/data/CRG/20120502_FDF_CRG/20120502_FDF_CRG/20120521_FDF_CRG_c12.mtb	7214	392	WWFF	food_fat	4	51244	1337653188	1	0.04	0.00285714285714286	6667	1
2	Food 2	Intake 4	61	51711	1337653655	/users/cn/jespinosa/phecomp/data/CRG/20120502_FDF_CRG/20120502_FDF_CRG/20120521_FDF_CRG_c12.mtb	7215	24	WWFF	food_fat	4	51650	1337653594	1	0.0800000000000001	0.00131147540983607	6668	1
2	Drink 2	Intake 2	17	51741	1337653685	/users/cn/jespinosa/phecomp/data/CRG/20120502_FDF_CRG/20120502_FDF_CRG/20120521_FDF_CRG_c12.mtb	2002	NA	WWFF	water	2	51724	1337653668	1	0.0399999999999998	0.00235294117647058	6669	1
2	Food 2	Intake 4	171	51906	1337653850	/users/cn/jespinosa/phecomp/data/CRG/20120502_FDF_CRG/20120502_FDF_CRG/20120521_FDF_CRG_c12.mtb	7216	COLL	WWFF	food_fat	4	51735	1337653679	1	0.04	0.000233918128654971	6670	1
2	Food 1	Intake 3	37	51801	1337653745	/users/cn/jespinosa/phecomp/data/CRG/20120502_FDF_CRG/20120502_FDF_CRG/20120521_FDF_CRG_c12.mtb	5689	813	WWFF	food_fat	3	51764	1337653708	1	0.0200000000000005	0.000540540540540554	6671	1
2	Food 2	Intake 4	14	52628	1337654572	/users/cn/jespinosa/phecomp/data/CRG/20120502_FDF_CRG/20120502_FDF_CRG/20120521_FDF_CRG_c12.mtb	7223	48	WWFF	food_fat	4	52614	1337654558	1	0.04	0.00285714285714286	6672	1
2	Drink 2	Intake 2	21	52638	1337654582	/users/cn/jespinosa/phecomp/data/CRG/20120502_FDF_CRG/20120502_FDF_CRG/20120521_FDF_CRG_c12.mtb	2004	NA	WWFF	water	2	52617	1337654561	1	0.04	0.0019047619047619	6673	1
2	Drink 2	Intake 2	18	52685	1337654629	/users/cn/jespinosa/phecomp/data/CRG/20120502_FDF_CRG/20120502_FDF_CRG/20120521_FDF_CRG_c12.mtb	2005	NA	WWFF	water	2	52667	1337654611	1	0.04	0.00222222222222222	6674	1
2	Food 2	Intake 4	90	52766	1337654710	/users/cn/jespinosa/phecomp/data/CRG/20120502_FDF_CRG/20120502_FDF_CRG/20120521_FDF_CRG_c12.mtb	7224	125	WWFF	food_fat	4	52676	1337654620	1	0.0200000000000005	0.000222222222222228	6675	1
2	Food 2	Intake 4	18	52909	1337654853	/users/cn/jespinosa/phecomp/data/CRG/20120502_FDF_CRG/20120502_FDF_CRG/20120521_FDF_CRG_c12.mtb	7226	5394	WWFF	food_fat	4	52891	1337654835	1	0.04	0.00222222222222222	6676	1
2	Drink 2	Intake 2	17	53530	1337655474	/users/cn/jespinosa/phecomp/data/CRG/20120502_FDF_CRG/20120502_FDF_CRG/20120521_FDF_CRG_c12.mtb	2006	NA	WWFF	water	2	53513	1337655457	1	0.0600000000000001	0.00352941176470589	6677	1
2	Drink 2	Intake 2	15	53554	1337655498	/users/cn/jespinosa/phecomp/data/CRG/20120502_FDF_CRG/20120502_FDF_CRG/20120521_FDF_CRG_c12.mtb	2007	NA	WWFF	water	2	53539	1337655483	1	0.02	0.00133333333333333	6678	1
2	Drink 2	Intake 2	10	54007	1337655951	/users/cn/jespinosa/phecomp/data/CRG/20120502_FDF_CRG/20120502_FDF_CRG/20120521_FDF_CRG_c12.mtb	2008	NA	WWFF	water	2	53997	1337655941	1	0.04	0.004	6679	1
2	Drink 2	Intake 2	18	58169	1337660113	/users/cn/jespinosa/phecomp/data/CRG/20120502_FDF_CRG/20120502_FDF_CRG/20120521_FDF_CRG_c12.mtb	2009	NA	WWFF	water	2	58151	1337660095	1	0.0600000000000001	0.00333333333333334	6680	1
2	Food 2	Intake 4	14	58317	1337660261	/users/cn/jespinosa/phecomp/data/CRG/20120502_FDF_CRG/20120502_FDF_CRG/20120521_FDF_CRG_c12.mtb	7234	313	WWFF	food_fat	4	58303	1337660247	1	0.04	0.00285714285714286	6681	1
2	Food 2	Intake 4	58	58688	1337660632	/users/cn/jespinosa/phecomp/data/CRG/20120502_FDF_CRG/20120502_FDF_CRG/20120521_FDF_CRG_c12.mtb	7238	29	WWFF	food_fat	4	58630	1337660574	1	0.0200000000000005	0.000344827586206905	6682	1
2	Food 2	Intake 4	42	58759	1337660703	/users/cn/jespinosa/phecomp/data/CRG/20120502_FDF_CRG/20120502_FDF_CRG/20120521_FDF_CRG_c12.mtb	7239	1263	WWFF	food_fat	4	58717	1337660661	1	0.0200000000000005	0.000476190476190488	6683	1
2	Drink 2	Intake 2	49	58797	1337660741	/users/cn/jespinosa/phecomp/data/CRG/20120502_FDF_CRG/20120502_FDF_CRG/20120521_FDF_CRG_c12.mtb	2011	NA	WWFF	water	2	58748	1337660692	1	0.04	0.000816326530612245	6684	1
2	Drink 2	Intake 2	44	59022	1337660966	/users/cn/jespinosa/phecomp/data/CRG/20120502_FDF_CRG/20120502_FDF_CRG/20120521_FDF_CRG_c12.mtb	2013	NA	WWFF	water	2	58978	1337660922	1	0.02	0.000454545454545455	6685	1
2	Food 2	Intake 4	24	60046	1337661990	/users/cn/jespinosa/phecomp/data/CRG/20120502_FDF_CRG/20120502_FDF_CRG/20120521_FDF_CRG_c12.mtb	7248	527	WWFF	food_fat	4	60022	1337661966	1	0.0599999999999996	0.00249999999999998	6686	1
2	Food 2	Intake 4	13	60586	1337662530	/users/cn/jespinosa/phecomp/data/CRG/20120502_FDF_CRG/20120502_FDF_CRG/20120521_FDF_CRG_c12.mtb	7250	3016	WWFF	food_fat	4	60573	1337662517	1	0.04	0.00307692307692308	6687	1
2	Drink 2	Intake 2	21	63453	1337665397	/users/cn/jespinosa/phecomp/data/CRG/20120502_FDF_CRG/20120502_FDF_CRG/20120521_FDF_CRG_c12.mtb	2015	NA	WWFF	water	2	63432	1337665376	1	0.02	0.000952380952380952	6688	1
2	Drink 2	Intake 2	15	63497	1337665441	/users/cn/jespinosa/phecomp/data/CRG/20120502_FDF_CRG/20120502_FDF_CRG/20120521_FDF_CRG_c12.mtb	2016	NA	WWFF	water	2	63482	1337665426	1	0.02	0.00133333333333333	6689	1
2	Food 2	Intake 4	13	63615	1337665559	/users/cn/jespinosa/phecomp/data/CRG/20120502_FDF_CRG/20120502_FDF_CRG/20120521_FDF_CRG_c12.mtb	7260	113	WWFF	food_fat	4	63602	1337665546	1	0.04	0.00307692307692308	6690	1
2	Food 1	Intake 3	64	63792	1337665736	/users/cn/jespinosa/phecomp/data/CRG/20120502_FDF_CRG/20120502_FDF_CRG/20120521_FDF_CRG_c12.mtb	5702	1060	WWFF	food_fat	3	63728	1337665672	1	0.0200000000000005	0.000312500000000008	6691	1
2	Drink 2	Intake 2	12	63883	1337665827	/users/cn/jespinosa/phecomp/data/CRG/20120502_FDF_CRG/20120502_FDF_CRG/20120521_FDF_CRG_c12.mtb	2017	NA	WWFF	water	2	63871	1337665815	1	0.04	0.00333333333333333	6692	1
2	Drink 2	Intake 2	20	63978	1337665922	/users/cn/jespinosa/phecomp/data/CRG/20120502_FDF_CRG/20120502_FDF_CRG/20120521_FDF_CRG_c12.mtb	2018	NA	WWFF	water	2	63958	1337665902	1	0.02	0.001	6693	1
2	Drink 2	Intake 2	22	64165	1337666109	/users/cn/jespinosa/phecomp/data/CRG/20120502_FDF_CRG/20120502_FDF_CRG/20120521_FDF_CRG_c12.mtb	2019	NA	WWFF	water	2	64143	1337666087	1	0.0399999999999998	0.00181818181818181	6694	1
2	Drink 2	Intake 2	16	64451	1337666395	/users/cn/jespinosa/phecomp/data/CRG/20120502_FDF_CRG/20120502_FDF_CRG/20120521_FDF_CRG_c12.mtb	2020	NA	WWFF	water	2	64435	1337666379	1	0.04	0.0025	6695	1
2	Food 2	Intake 4	140	64992	1337666936	/users/cn/jespinosa/phecomp/data/CRG/20120502_FDF_CRG/20120502_FDF_CRG/20120521_FDF_CRG_c12.mtb	7272	COLL	WWFF	food_fat	4	64852	1337666796	1	0.0200000000000005	0.000142857142857146	6696	1
2	Food 1	Intake 3	39	65020	1337666964	/users/cn/jespinosa/phecomp/data/CRG/20120502_FDF_CRG/20120502_FDF_CRG/20120521_FDF_CRG_c12.mtb	5707	COLL	WWFF	food_fat	3	64981	1337666925	1	0.0200000000000005	0.000512820512820526	6697	1
2	Food 2	Intake 4	12	65021	1337666965	/users/cn/jespinosa/phecomp/data/CRG/20120502_FDF_CRG/20120502_FDF_CRG/20120521_FDF_CRG_c12.mtb	7273	215	WWFF	food_fat	4	65009	1337666953	1	0.04	0.00333333333333333	6698	1
2	Food 2	Intake 4	19	65255	1337667199	/users/cn/jespinosa/phecomp/data/CRG/20120502_FDF_CRG/20120502_FDF_CRG/20120521_FDF_CRG_c12.mtb	7275	12016	WWFF	food_fat	4	65236	1337667180	1	0.04	0.00210526315789474	6699	1
2	Drink 2	Intake 2	19	76108	1337678052	/users/cn/jespinosa/phecomp/data/CRG/20120502_FDF_CRG/20120502_FDF_CRG/20120521_FDF_CRG_c12.mtb	2021	NA	WWFF	water	2	76089	1337678033	1	0.0800000000000001	0.00421052631578948	6700	1
2	Drink 2	Intake 2	18	76394	1337678338	/users/cn/jespinosa/phecomp/data/CRG/20120502_FDF_CRG/20120502_FDF_CRG/20120521_FDF_CRG_c12.mtb	2022	NA	WWFF	water	2	76376	1337678320	1	0.0800000000000001	0.00444444444444445	6701	1
2	Drink 2	Intake 2	16	77156	1337679100	/users/cn/jespinosa/phecomp/data/CRG/20120502_FDF_CRG/20120502_FDF_CRG/20120521_FDF_CRG_c12.mtb	2023	NA	WWFF	water	2	77140	1337679084	1	0.02	0.00125	6702	1
2	Food 2	Intake 4	13	77284	1337679228	/users/cn/jespinosa/phecomp/data/CRG/20120502_FDF_CRG/20120502_FDF_CRG/20120521_FDF_CRG_c12.mtb	7287	392	WWFF	food_fat	4	77271	1337679215	1	0.0600000000000005	0.00461538461538465	6703	1
2	Drink 2	Intake 2	15	77314	1337679258	/users/cn/jespinosa/phecomp/data/CRG/20120502_FDF_CRG/20120502_FDF_CRG/20120521_FDF_CRG_c12.mtb	2024	NA	WWFF	water	2	77299	1337679243	1	0.04	0.00266666666666667	6704	1
2	Food 2	Intake 4	18	77694	1337679638	/users/cn/jespinosa/phecomp/data/CRG/20120502_FDF_CRG/20120502_FDF_CRG/20120521_FDF_CRG_c12.mtb	7290	2895	WWFF	food_fat	4	77676	1337679620	1	0.0200000000000005	0.00111111111111114	6705	1
2	Food 2	Intake 4	12	80601	1337682545	/users/cn/jespinosa/phecomp/data/CRG/20120502_FDF_CRG/20120502_FDF_CRG/20120521_FDF_CRG_c12.mtb	7293	10789	WWFF	food_fat	4	80589	1337682533	1	0.04	0.00333333333333333	6706	1
2	Drink 2	Intake 2	30	86662	1337688606	/users/cn/jespinosa/phecomp/data/CRG/20120502_FDF_CRG/20120502_FDF_CRG/20120521_FDF_CRG_c12.mtb	2025	NA	WWFF	water	2	86632	1337688576	1	0.0800000000000001	0.00266666666666667	6707	1
2	Food 2	Intake 4	15	91405	1337693349	/users/cn/jespinosa/phecomp/data/CRG/20120502_FDF_CRG/20120502_FDF_CRG/20120521_FDF_CRG_c12.mtb	7299	27	WWFF	food_fat	4	91390	1337693334	1	0.04	0.00266666666666667	6708	1
2	Food 2	Intake 4	11	91443	1337693387	/users/cn/jespinosa/phecomp/data/CRG/20120502_FDF_CRG/20120502_FDF_CRG/20120521_FDF_CRG_c12.mtb	7300	59	WWFF	food_fat	4	91432	1337693376	1	0.0399999999999991	0.00363636363636355	6709	1
2	Food 2	Intake 4	14	91516	1337693460	/users/cn/jespinosa/phecomp/data/CRG/20120502_FDF_CRG/20120502_FDF_CRG/20120521_FDF_CRG_c12.mtb	7302	3189	WWFF	food_fat	4	91502	1337693446	1	0.0599999999999996	0.00428571428571426	6710	1
2	Drink 1	Intake 1	34	91543	1337693487	/users/cn/jespinosa/phecomp/data/CRG/20120502_FDF_CRG/20120502_FDF_CRG/20120521_FDF_CRG_c12.mtb	1330	NA	WWFF	water	1	91509	1337693453	1	0.04	0.00117647058823529	6711	1
2	Food 1	Intake 3	33	94738	1337696682	/users/cn/jespinosa/phecomp/data/CRG/20120502_FDF_CRG/20120502_FDF_CRG/20120521_FDF_CRG_c12.mtb	5714	4638	WWFF	food_fat	3	94705	1337696649	1	0.0200000000000005	0.000606060606060621	6712	1
2	Food 2	Intake 4	12	99388	1337701332	/users/cn/jespinosa/phecomp/data/CRG/20120502_FDF_CRG/20120502_FDF_CRG/20120521_FDF_CRG_c12.mtb	7309	166	WWFF	food_fat	4	99376	1337701320	1	0.0399999999999991	0.00333333333333326	6713	1
2	Drink 2	Intake 2	15	99411	1337701355	/users/cn/jespinosa/phecomp/data/CRG/20120502_FDF_CRG/20120502_FDF_CRG/20120521_FDF_CRG_c12.mtb	2026	NA	WWFF	water	2	99396	1337701340	1	0.04	0.00266666666666667	6714	1
2	Food 2	Intake 4	14	99568	1337701512	/users/cn/jespinosa/phecomp/data/CRG/20120502_FDF_CRG/20120502_FDF_CRG/20120521_FDF_CRG_c12.mtb	7312	261	WWFF	food_fat	4	99554	1337701498	1	0.04	0.00285714285714286	6715	1
2	Drink 1	Intake 1	18	99597	1337701541	/users/cn/jespinosa/phecomp/data/CRG/20120502_FDF_CRG/20120502_FDF_CRG/20120521_FDF_CRG_c12.mtb	1331	NA	WWFF	water	1	99579	1337701523	1	0.04	0.00222222222222222	6716	1
2	Drink 2	Intake 2	17	99752	1337701696	/users/cn/jespinosa/phecomp/data/CRG/20120502_FDF_CRG/20120502_FDF_CRG/20120521_FDF_CRG_c12.mtb	2027	NA	WWFF	water	2	99735	1337701679	1	0.02	0.00117647058823529	6717	1
2	Food 2	Intake 4	12	99841	1337701785	/users/cn/jespinosa/phecomp/data/CRG/20120502_FDF_CRG/20120502_FDF_CRG/20120521_FDF_CRG_c12.mtb	7315	125	WWFF	food_fat	4	99829	1337701773	1	0.04	0.00333333333333333	6718	1
2	Drink 2	Intake 2	17	99879	1337701823	/users/cn/jespinosa/phecomp/data/CRG/20120502_FDF_CRG/20120502_FDF_CRG/20120521_FDF_CRG_c12.mtb	2028	NA	WWFF	water	2	99862	1337701806	1	0.04	0.00235294117647059	6719	1
2	Food 2	Intake 4	14	99980	1337701924	/users/cn/jespinosa/phecomp/data/CRG/20120502_FDF_CRG/20120502_FDF_CRG/20120521_FDF_CRG_c12.mtb	7317	227	WWFF	food_fat	4	99966	1337701910	1	0.0599999999999996	0.00428571428571426	6720	1
2	Food 2	Intake 4	57	100264	1337702208	/users/cn/jespinosa/phecomp/data/CRG/20120502_FDF_CRG/20120502_FDF_CRG/20120521_FDF_CRG_c12.mtb	7321	371	WWFF	food_fat	4	100207	1337702151	1	0.0200000000000005	0.000350877192982465	6721	1
2	Food 2	Intake 4	17	100652	1337702596	/users/cn/jespinosa/phecomp/data/CRG/20120502_FDF_CRG/20120502_FDF_CRG/20120521_FDF_CRG_c12.mtb	7322	4022	WWFF	food_fat	4	100635	1337702579	1	0.0399999999999991	0.00235294117647054	6722	1
2	Food 2	Intake 4	51	104725	1337706669	/users/cn/jespinosa/phecomp/data/CRG/20120502_FDF_CRG/20120502_FDF_CRG/20120521_FDF_CRG_c12.mtb	7323	3288	WWFF	food_fat	4	104674	1337706618	1	0.12	0.00235294117647059	6723	1
2	Food 2	Intake 4	31	108044	1337709988	/users/cn/jespinosa/phecomp/data/CRG/20120502_FDF_CRG/20120502_FDF_CRG/20120521_FDF_CRG_c12.mtb	7324	1224	WWFF	food_fat	4	108013	1337709957	1	0.0200000000000005	0.000645161290322597	6724	1
2	Drink 2	Intake 2	15	108115	1337710059	/users/cn/jespinosa/phecomp/data/CRG/20120502_FDF_CRG/20120502_FDF_CRG/20120521_FDF_CRG_c12.mtb	2030	NA	WWFF	water	2	108100	1337710044	1	0.04	0.00266666666666667	6725	1
2	Food 2	Intake 4	13	109281	1337711225	/users/cn/jespinosa/phecomp/data/CRG/20120502_FDF_CRG/20120502_FDF_CRG/20120521_FDF_CRG_c12.mtb	7325	1211	WWFF	food_fat	4	109268	1337711212	1	0.04	0.00307692307692308	6726	1
2	Food 2	Intake 4	17	110509	1337712453	/users/cn/jespinosa/phecomp/data/CRG/20120502_FDF_CRG/20120502_FDF_CRG/20120521_FDF_CRG_c12.mtb	7328	416	WWFF	food_fat	4	110492	1337712436	1	0.0200000000000005	0.00117647058823532	6727	1
2	Food 2	Intake 4	15	110940	1337712884	/users/cn/jespinosa/phecomp/data/CRG/20120502_FDF_CRG/20120502_FDF_CRG/20120521_FDF_CRG_c12.mtb	7330	2163	WWFF	food_fat	4	110925	1337712869	1	0.0200000000000005	0.00133333333333337	6728	1
2	Drink 2	Intake 2	51	111453	1337713397	/users/cn/jespinosa/phecomp/data/CRG/20120502_FDF_CRG/20120502_FDF_CRG/20120521_FDF_CRG_c12.mtb	2035	NA	WWFF	water	2	111402	1337713346	1	0.04	0.000784313725490196	6729	1
2	Drink 2	Intake 2	16	112005	1337713949	/users/cn/jespinosa/phecomp/data/CRG/20120502_FDF_CRG/20120502_FDF_CRG/20120521_FDF_CRG_c12.mtb	2036	NA	WWFF	water	2	111989	1337713933	1	0.04	0.0025	6730	1
2	Food 2	Intake 4	15	113118	1337715062	/users/cn/jespinosa/phecomp/data/CRG/20120502_FDF_CRG/20120502_FDF_CRG/20120521_FDF_CRG_c12.mtb	7333	440	WWFF	food_fat	4	113103	1337715047	1	0.04	0.00266666666666667	6731	1
2	Food 1	Intake 3	11	113569	1337715513	/users/cn/jespinosa/phecomp/data/CRG/20120502_FDF_CRG/20120502_FDF_CRG/20120521_FDF_CRG_c12.mtb	5724	436	WWFF	food_fat	3	113558	1337715502	1	0.0200000000000005	0.00181818181818186	6732	1
2	Drink 2	Intake 2	17	113881	1337715825	/users/cn/jespinosa/phecomp/data/CRG/20120502_FDF_CRG/20120502_FDF_CRG/20120521_FDF_CRG_c12.mtb	2037	NA	WWFF	water	2	113864	1337715808	1	0.02	0.00117647058823529	6733	1
2	Food 2	Intake 4	15	114020	1337715964	/users/cn/jespinosa/phecomp/data/CRG/20120502_FDF_CRG/20120502_FDF_CRG/20120521_FDF_CRG_c12.mtb	7335	1936	WWFF	food_fat	4	114005	1337715949	1	0.04	0.00266666666666667	6734	1
2	Food 2	Intake 4	15	115971	1337717915	/users/cn/jespinosa/phecomp/data/CRG/20120502_FDF_CRG/20120502_FDF_CRG/20120521_FDF_CRG_c12.mtb	7336	3206	WWFF	food_fat	4	115956	1337717900	1	0.04	0.00266666666666667	6735	1
2	Food 2	Intake 4	15	119192	1337721136	/users/cn/jespinosa/phecomp/data/CRG/20120502_FDF_CRG/20120502_FDF_CRG/20120521_FDF_CRG_c12.mtb	7337	9	WWFF	food_fat	4	119177	1337721121	1	0.0200000000000005	0.00133333333333337	6736	1
2	Food 2	Intake 4	14	119215	1337721159	/users/cn/jespinosa/phecomp/data/CRG/20120502_FDF_CRG/20120502_FDF_CRG/20120521_FDF_CRG_c12.mtb	7338	3313	WWFF	food_fat	4	119201	1337721145	1	0.04	0.00285714285714286	6737	1
2	Drink 2	Intake 2	13	120554	1337722498	/users/cn/jespinosa/phecomp/data/CRG/20120502_FDF_CRG/20120502_FDF_CRG/20120521_FDF_CRG_c12.mtb	2038	NA	WWFF	water	2	120541	1337722485	1	0.02	0.00153846153846154	6738	1
2	Food 2	Intake 4	15	122543	1337724487	/users/cn/jespinosa/phecomp/data/CRG/20120502_FDF_CRG/20120502_FDF_CRG/20120521_FDF_CRG_c12.mtb	7340	91	WWFF	food_fat	4	122528	1337724472	1	0.04	0.00266666666666667	6739	1
2	Food 2	Intake 4	15	122649	1337724593	/users/cn/jespinosa/phecomp/data/CRG/20120502_FDF_CRG/20120502_FDF_CRG/20120521_FDF_CRG_c12.mtb	7341	1832	WWFF	food_fat	4	122634	1337724578	1	0.0599999999999996	0.00399999999999997	6740	1
2	Drink 1	Intake 1	17	123269	1337725213	/users/cn/jespinosa/phecomp/data/CRG/20120502_FDF_CRG/20120502_FDF_CRG/20120521_FDF_CRG_c12.mtb	1334	NA	WWFF	water	1	123252	1337725196	1	0.02	0.00117647058823529	6741	1
2	Drink 2	Intake 2	16	123390	1337725334	/users/cn/jespinosa/phecomp/data/CRG/20120502_FDF_CRG/20120502_FDF_CRG/20120521_FDF_CRG_c12.mtb	2041	NA	WWFF	water	2	123374	1337725318	1	0.02	0.00125	6742	1
2	Drink 2	Intake 2	55	123461	1337725405	/users/cn/jespinosa/phecomp/data/CRG/20120502_FDF_CRG/20120502_FDF_CRG/20120521_FDF_CRG_c12.mtb	2042	NA	WWFF	water	2	123406	1337725350	1	0.02	0.000363636363636364	6743	1
2	Drink 2	Intake 2	16	123681	1337725625	/users/cn/jespinosa/phecomp/data/CRG/20120502_FDF_CRG/20120502_FDF_CRG/20120521_FDF_CRG_c12.mtb	2043	NA	WWFF	water	2	123665	1337725609	1	0.04	0.0025	6744	1
2	Drink 2	Intake 2	12	124010	1337725954	/users/cn/jespinosa/phecomp/data/CRG/20120502_FDF_CRG/20120502_FDF_CRG/20120521_FDF_CRG_c12.mtb	2044	NA	WWFF	water	2	123998	1337725942	1	0.04	0.00333333333333333	6745	1
2	Drink 1	Intake 1	21	124331	1337726275	/users/cn/jespinosa/phecomp/data/CRG/20120502_FDF_CRG/20120502_FDF_CRG/20120521_FDF_CRG_c12.mtb	1335	NA	WWFF	water	1	124310	1337726254	1	0.04	0.0019047619047619	6746	1
2	Drink 2	Intake 2	13	124346	1337726290	/users/cn/jespinosa/phecomp/data/CRG/20120502_FDF_CRG/20120502_FDF_CRG/20120521_FDF_CRG_c12.mtb	2045	NA	WWFF	water	2	124333	1337726277	1	0.04	0.00307692307692308	6747	1
2	Food 2	Intake 4	35	124516	1337726460	/users/cn/jespinosa/phecomp/data/CRG/20120502_FDF_CRG/20120502_FDF_CRG/20120521_FDF_CRG_c12.mtb	7347	1718	WWFF	food_fat	4	124481	1337726425	1	0.04	0.00114285714285714	6748	1
2	Drink 2	Intake 2	28	126044	1337727988	/users/cn/jespinosa/phecomp/data/CRG/20120502_FDF_CRG/20120502_FDF_CRG/20120521_FDF_CRG_c12.mtb	2046	NA	WWFF	water	2	126016	1337727960	1	0.04	0.00142857142857143	6749	1
2	Food 2	Intake 4	15	126249	1337728193	/users/cn/jespinosa/phecomp/data/CRG/20120502_FDF_CRG/20120502_FDF_CRG/20120521_FDF_CRG_c12.mtb	7349	1734	WWFF	food_fat	4	126234	1337728178	1	0.0800000000000001	0.00533333333333334	6750	1
2	Food 2	Intake 4	15	127998	1337729942	/users/cn/jespinosa/phecomp/data/CRG/20120502_FDF_CRG/20120502_FDF_CRG/20120521_FDF_CRG_c12.mtb	7350	3479	WWFF	food_fat	4	127983	1337729927	1	0.0800000000000001	0.00533333333333334	6751	1
2	Drink 2	Intake 2	13	128496	1337730440	/users/cn/jespinosa/phecomp/data/CRG/20120502_FDF_CRG/20120502_FDF_CRG/20120521_FDF_CRG_c12.mtb	2047	NA	WWFF	water	2	128483	1337730427	1	0.04	0.00307692307692308	6752	1
2	Drink 2	Intake 2	15	131386	1337733330	/users/cn/jespinosa/phecomp/data/CRG/20120502_FDF_CRG/20120502_FDF_CRG/20120521_FDF_CRG_c12.mtb	2048	NA	WWFF	water	2	131371	1337733315	1	0.04	0.00266666666666667	6753	1
2	Food 2	Intake 4	30	131507	1337733451	/users/cn/jespinosa/phecomp/data/CRG/20120502_FDF_CRG/20120502_FDF_CRG/20120521_FDF_CRG_c12.mtb	7352	3484	WWFF	food_fat	4	131477	1337733421	1	0.0599999999999996	0.00199999999999999	6754	1
2	Drink 2	Intake 2	41	132243	1337734187	/users/cn/jespinosa/phecomp/data/CRG/20120502_FDF_CRG/20120502_FDF_CRG/20120521_FDF_CRG_c12.mtb	2049	NA	WWFF	water	2	132202	1337734146	1	0.0599999999999996	0.00146341463414633	6755	1
2	Drink 2	Intake 2	14	133231	1337735175	/users/cn/jespinosa/phecomp/data/CRG/20120502_FDF_CRG/20120502_FDF_CRG/20120521_FDF_CRG_c12.mtb	2050	NA	WWFF	water	2	133217	1337735161	1	0.04	0.00285714285714286	6756	1
2	Drink 2	Intake 2	13	133673	1337735617	/users/cn/jespinosa/phecomp/data/CRG/20120502_FDF_CRG/20120502_FDF_CRG/20120521_FDF_CRG_c12.mtb	2051	NA	WWFF	water	2	133660	1337735604	1	0.04	0.00307692307692308	6757	1
2	Food 2	Intake 4	15	135006	1337736950	/users/cn/jespinosa/phecomp/data/CRG/20120502_FDF_CRG/20120502_FDF_CRG/20120521_FDF_CRG_c12.mtb	7359	4246	WWFF	food_fat	4	134991	1337736935	1	0.04	0.00266666666666667	6758	1
2	Food 2	Intake 4	16	139268	1337741212	/users/cn/jespinosa/phecomp/data/CRG/20120502_FDF_CRG/20120502_FDF_CRG/20120521_FDF_CRG_c12.mtb	7360	469	WWFF	food_fat	4	139252	1337741196	1	0.04	0.0025	6759	1
2	Drink 2	Intake 2	28	139393	1337741337	/users/cn/jespinosa/phecomp/data/CRG/20120502_FDF_CRG/20120502_FDF_CRG/20120521_FDF_CRG_c12.mtb	2052	NA	WWFF	water	2	139365	1337741309	1	0.04	0.00142857142857143	6760	1
2	Drink 1	Intake 1	24	139501	1337741445	/users/cn/jespinosa/phecomp/data/CRG/20120502_FDF_CRG/20120502_FDF_CRG/20120521_FDF_CRG_c12.mtb	1337	NA	WWFF	water	1	139477	1337741421	1	0.02	0.000833333333333333	6761	1
2	Drink 2	Intake 2	15	139552	1337741496	/users/cn/jespinosa/phecomp/data/CRG/20120502_FDF_CRG/20120502_FDF_CRG/20120521_FDF_CRG_c12.mtb	2053	NA	WWFF	water	2	139537	1337741481	1	0.02	0.00133333333333333	6762	1
2	Food 2	Intake 4	31	139768	1337741712	/users/cn/jespinosa/phecomp/data/CRG/20120502_FDF_CRG/20120502_FDF_CRG/20120521_FDF_CRG_c12.mtb	7362	2556	WWFF	food_fat	4	139737	1337741681	1	0.0200000000000005	0.000645161290322597	6763	1
2	Drink 2	Intake 2	13	139806	1337741750	/users/cn/jespinosa/phecomp/data/CRG/20120502_FDF_CRG/20120502_FDF_CRG/20120521_FDF_CRG_c12.mtb	2054	NA	WWFF	water	2	139793	1337741737	1	0.04	0.00307692307692308	6764	1
2	Food 2	Intake 4	21	142345	1337744289	/users/cn/jespinosa/phecomp/data/CRG/20120502_FDF_CRG/20120502_FDF_CRG/20120521_FDF_CRG_c12.mtb	7363	206	WWFF	food_fat	4	142324	1337744268	1	0.04	0.0019047619047619	6765	1
2	Food 2	Intake 4	15	142566	1337744510	/users/cn/jespinosa/phecomp/data/CRG/20120502_FDF_CRG/20120502_FDF_CRG/20120521_FDF_CRG_c12.mtb	7364	14	WWFF	food_fat	4	142551	1337744495	1	0.0399999999999991	0.00266666666666661	6766	1
2	Food 2	Intake 4	36	142616	1337744560	/users/cn/jespinosa/phecomp/data/CRG/20120502_FDF_CRG/20120502_FDF_CRG/20120521_FDF_CRG_c12.mtb	7365	4354	WWFF	food_fat	4	142580	1337744524	1	0.0200000000000005	0.000555555555555569	6767	1
2	Drink 2	Intake 2	21	142801	1337744745	/users/cn/jespinosa/phecomp/data/CRG/20120502_FDF_CRG/20120502_FDF_CRG/20120521_FDF_CRG_c12.mtb	2055	NA	WWFF	water	2	142780	1337744724	1	0.04	0.0019047619047619	6768	1
2	Food 2	Intake 4	8	146978	1337748922	/users/cn/jespinosa/phecomp/data/CRG/20120502_FDF_CRG/20120502_FDF_CRG/20120521_FDF_CRG_c12.mtb	7370	467	WWFF	food_fat	4	146970	1337748914	1	0.0200000000000005	0.00250000000000006	6769	1
2	Food 1	Intake 3	12	147457	1337749401	/users/cn/jespinosa/phecomp/data/CRG/20120502_FDF_CRG/20120502_FDF_CRG/20120521_FDF_CRG_c12.mtb	5740	938	WWFF	food_fat	3	147445	1337749389	1	0.0200000000000005	0.00166666666666671	6770	1
2	Drink 2	Intake 2	20	148110	1337750054	/users/cn/jespinosa/phecomp/data/CRG/20120502_FDF_CRG/20120502_FDF_CRG/20120521_FDF_CRG_c12.mtb	2056	NA	WWFF	water	2	148090	1337750034	1	0.0600000000000001	0.00300000000000001	6771	1
2	Drink 2	Intake 2	40	148235	1337750179	/users/cn/jespinosa/phecomp/data/CRG/20120502_FDF_CRG/20120502_FDF_CRG/20120521_FDF_CRG_c12.mtb	2057	NA	WWFF	water	2	148195	1337750139	1	0.04	0.001	6772	1
2	Food 2	Intake 4	15	148410	1337750354	/users/cn/jespinosa/phecomp/data/CRG/20120502_FDF_CRG/20120502_FDF_CRG/20120521_FDF_CRG_c12.mtb	7375	3191	WWFF	food_fat	4	148395	1337750339	1	0.0800000000000001	0.00533333333333334	6773	1
2	Drink 1	Intake 1	15	149392	1337751336	/users/cn/jespinosa/phecomp/data/CRG/20120502_FDF_CRG/20120502_FDF_CRG/20120521_FDF_CRG_c12.mtb	1339	NA	WWFF	water	1	149377	1337751321	1	0.04	0.00266666666666667	6774	1
2	Drink 2	Intake 2	10	151601	1337753545	/users/cn/jespinosa/phecomp/data/CRG/20120502_FDF_CRG/20120502_FDF_CRG/20120521_FDF_CRG_c12.mtb	2059	NA	WWFF	water	2	151591	1337753535	1	0.02	0.002	6775	1
2	Food 2	Intake 4	37	151638	1337753582	/users/cn/jespinosa/phecomp/data/CRG/20120502_FDF_CRG/20120502_FDF_CRG/20120521_FDF_CRG_c12.mtb	7379	138	WWFF	food_fat	4	151601	1337753545	1	0.0200000000000014	0.000540540540540578	6776	1
2	Food 1	Intake 3	52	151828	1337753772	/users/cn/jespinosa/phecomp/data/CRG/20120502_FDF_CRG/20120502_FDF_CRG/20120521_FDF_CRG_c12.mtb	5744	1012	WWFF	food_fat	3	151776	1337753720	1	0.0200000000000005	0.000384615384615394	6777	1
2	Drink 2	Intake 2	14	152029	1337753973	/users/cn/jespinosa/phecomp/data/CRG/20120502_FDF_CRG/20120502_FDF_CRG/20120521_FDF_CRG_c12.mtb	2060	NA	WWFF	water	2	152015	1337753959	1	0.0600000000000001	0.00428571428571429	6778	1
2	Drink 2	Intake 2	12	152579	1337754523	/users/cn/jespinosa/phecomp/data/CRG/20120502_FDF_CRG/20120502_FDF_CRG/20120521_FDF_CRG_c12.mtb	2061	NA	WWFF	water	2	152567	1337754511	1	0.02	0.00166666666666667	6779	1
2	Food 2	Intake 4	18	152858	1337754802	/users/cn/jespinosa/phecomp/data/CRG/20120502_FDF_CRG/20120502_FDF_CRG/20120521_FDF_CRG_c12.mtb	7380	4456	WWFF	food_fat	4	152840	1337754784	1	0.0399999999999991	0.00222222222222217	6780	1
2	Food 2	Intake 4	29	157343	1337759287	/users/cn/jespinosa/phecomp/data/CRG/20120502_FDF_CRG/20120502_FDF_CRG/20120521_FDF_CRG_c12.mtb	7382	LAST	WWFF	food_fat	4	157314	1337759258	1	0.0400000000000009	0.00137931034482762	6781	1
2	Drink 2	Intake 2	36	161299	1337763243	/users/cn/jespinosa/phecomp/data/CRG/20120502_FDF_CRG/20120502_FDF_CRG/20120521_FDF_CRG_c12.mtb	2062	LAST	WWFF	water	2	161263	1337763207	1	0.0799999999999996	0.00222222222222221	6782	1
2	Drink 2	Intake 2	40	1654	1335959662	/users/cn/jespinosa/phecomp/data/CRG/20120502_FDF_CRG/20120502_FDF_CRG/20120502_FDF_CRG_c12.mtb	106	NA	WWSS	water	2	1614	1335959622	1	0.02	0.0005	4790	1
2	Food 1	Intake 3	68	1850	1335959858	/users/cn/jespinosa/phecomp/data/CRG/20120502_FDF_CRG/20120502_FDF_CRG/20120502_FDF_CRG_c12.mtb	212	1160	WWSS	food_sc	3	1782	1335959790	1	0.02	0.000294117647058824	4791	1
2	Food 1	Intake 3	33	3043	1335961051	/users/cn/jespinosa/phecomp/data/CRG/20120502_FDF_CRG/20120502_FDF_CRG/20120502_FDF_CRG_c12.mtb	214	4	WWSS	food_sc	3	3010	1335961018	1	0.02	0.000606060606060606	4792	1
2	Food 1	Intake 3	52	3099	1335961107	/users/cn/jespinosa/phecomp/data/CRG/20120502_FDF_CRG/20120502_FDF_CRG/20120502_FDF_CRG_c12.mtb	215	8797	WWSS	food_sc	3	3047	1335961055	1	0.02	0.000384615384615385	4793	1
2	Drink 1	Intake 1	18	3641	1335961649	/users/cn/jespinosa/phecomp/data/CRG/20120502_FDF_CRG/20120502_FDF_CRG/20120502_FDF_CRG_c12.mtb	118	NA	WWSS	water	1	3623	1335961631	1	0.02	0.00111111111111111	4794	1
2	Drink 2	Intake 2	21	4513	1335962521	/users/cn/jespinosa/phecomp/data/CRG/20120502_FDF_CRG/20120502_FDF_CRG/20120502_FDF_CRG_c12.mtb	120	NA	WWSS	water	2	4492	1335962500	1	0.02	0.000952380952380952	4795	1
2	Drink 2	Intake 2	50	4780	1335962788	/users/cn/jespinosa/phecomp/data/CRG/20120502_FDF_CRG/20120502_FDF_CRG/20120502_FDF_CRG_c12.mtb	123	NA	WWSS	water	2	4730	1335962738	1	0.02	0.0004	4796	1
2	Drink 2	Intake 2	20	4822	1335962830	/users/cn/jespinosa/phecomp/data/CRG/20120502_FDF_CRG/20120502_FDF_CRG/20120502_FDF_CRG_c12.mtb	124	NA	WWSS	water	2	4802	1335962810	1	0.02	0.001	4797	1
2	Drink 2	Intake 2	20	5725	1335963733	/users/cn/jespinosa/phecomp/data/CRG/20120502_FDF_CRG/20120502_FDF_CRG/20120502_FDF_CRG_c12.mtb	129	NA	WWSS	water	2	5705	1335963713	1	0.02	0.001	4798	1
2	Food 1	Intake 3	153	12049	1335970057	/users/cn/jespinosa/phecomp/data/CRG/20120502_FDF_CRG/20120502_FDF_CRG/20120502_FDF_CRG_c12.mtb	227	3272	WWSS	food_sc	3	11896	1335969904	1	0.06	0.000392156862745098	4799	1
2	Food 2	Intake 4	202	15523	1335973531	/users/cn/jespinosa/phecomp/data/CRG/20120502_FDF_CRG/20120502_FDF_CRG/20120502_FDF_CRG_c12.mtb	485	150	WWSS	food_sc	4	15321	1335973329	1	0.06	0.000297029702970297	4800	1
2	Food 2	Intake 4	67	15740	1335973748	/users/cn/jespinosa/phecomp/data/CRG/20120502_FDF_CRG/20120502_FDF_CRG/20120502_FDF_CRG_c12.mtb	486	15	WWSS	food_sc	4	15673	1335973681	1	0.02	0.000298507462686567	4801	1
2	Food 2	Intake 4	19	15774	1335973782	/users/cn/jespinosa/phecomp/data/CRG/20120502_FDF_CRG/20120502_FDF_CRG/20120502_FDF_CRG_c12.mtb	487	4878	WWSS	food_sc	4	15755	1335973763	1	0.02	0.00105263157894737	4802	1
2	Food 1	Intake 3	553	21205	1335979213	/users/cn/jespinosa/phecomp/data/CRG/20120502_FDF_CRG/20120502_FDF_CRG/20120502_FDF_CRG_c12.mtb	234	3465	WWSS	food_sc	3	20652	1335978660	1	0.14	0.000253164556962025	4803	1
2	Drink 2	Intake 2	22	21225	1335979233	/users/cn/jespinosa/phecomp/data/CRG/20120502_FDF_CRG/20120502_FDF_CRG/20120502_FDF_CRG_c12.mtb	136	NA	WWSS	water	2	21203	1335979211	1	0.02	0.000909090909090909	4804	1
2	Drink 1	Intake 1	17	21435	1335979443	/users/cn/jespinosa/phecomp/data/CRG/20120502_FDF_CRG/20120502_FDF_CRG/20120502_FDF_CRG_c12.mtb	120	NA	WWSS	water	1	21418	1335979426	1	0.02	0.00117647058823529	4805	1
2	Drink 2	Intake 2	39	21721	1335979729	/users/cn/jespinosa/phecomp/data/CRG/20120502_FDF_CRG/20120502_FDF_CRG/20120502_FDF_CRG_c12.mtb	138	NA	WWSS	water	2	21682	1335979690	1	0.02	0.000512820512820513	4806	1
2	Drink 2	Intake 2	36	21845	1335979853	/users/cn/jespinosa/phecomp/data/CRG/20120502_FDF_CRG/20120502_FDF_CRG/20120502_FDF_CRG_c12.mtb	139	NA	WWSS	water	2	21809	1335979817	1	0.04	0.00111111111111111	4807	1
2	Drink 1	Intake 1	19	21879	1335979887	/users/cn/jespinosa/phecomp/data/CRG/20120502_FDF_CRG/20120502_FDF_CRG/20120502_FDF_CRG_c12.mtb	121	NA	WWSS	water	1	21860	1335979868	1	0.02	0.00105263157894737	4808	1
2	Food 2	Intake 4	346	25016	1335983024	/users/cn/jespinosa/phecomp/data/CRG/20120502_FDF_CRG/20120502_FDF_CRG/20120502_FDF_CRG_c12.mtb	492	1595	WWSS	food_sc	4	24670	1335982678	1	0.08	0.00023121387283237	4809	1
2	Food 1	Intake 3	120	26731	1335984739	/users/cn/jespinosa/phecomp/data/CRG/20120502_FDF_CRG/20120502_FDF_CRG/20120502_FDF_CRG_c12.mtb	239	788	WWSS	food_sc	3	26611	1335984619	1	0.06	0.0005	4810	1
2	Drink 2	Intake 2	18	26904	1335984912	/users/cn/jespinosa/phecomp/data/CRG/20120502_FDF_CRG/20120502_FDF_CRG/20120502_FDF_CRG_c12.mtb	142	NA	WWSS	water	2	26886	1335984894	1	0.02	0.00111111111111111	4811	1
2	Food 2	Intake 4	176	27695	1335985703	/users/cn/jespinosa/phecomp/data/CRG/20120502_FDF_CRG/20120502_FDF_CRG/20120502_FDF_CRG_c12.mtb	494	191	WWSS	food_sc	4	27519	1335985527	1	0.02	0.000113636363636364	4812	1
2	Food 2	Intake 4	97	27983	1335985991	/users/cn/jespinosa/phecomp/data/CRG/20120502_FDF_CRG/20120502_FDF_CRG/20120502_FDF_CRG_c12.mtb	496	294	WWSS	food_sc	4	27886	1335985894	1	0.02	0.000206185567010309	4813	1
2	Food 1	Intake 3	168	28445	1335986453	/users/cn/jespinosa/phecomp/data/CRG/20120502_FDF_CRG/20120502_FDF_CRG/20120502_FDF_CRG_c12.mtb	244	1316	WWSS	food_sc	3	28277	1335986285	1	0.04	0.000238095238095238	4814	1
2	Drink 2	Intake 2	39	28807	1335986815	/users/cn/jespinosa/phecomp/data/CRG/20120502_FDF_CRG/20120502_FDF_CRG/20120502_FDF_CRG_c12.mtb	148	NA	WWSS	water	2	28768	1335986776	1	0.04	0.00102564102564103	4815	1
2	Food 1	Intake 3	214	29975	1335987983	/users/cn/jespinosa/phecomp/data/CRG/20120502_FDF_CRG/20120502_FDF_CRG/20120502_FDF_CRG_c12.mtb	246	660	WWSS	food_sc	3	29761	1335987769	1	0.06	0.000280373831775701	4816	1
2	Drink 2	Intake 2	23	30128	1335988136	/users/cn/jespinosa/phecomp/data/CRG/20120502_FDF_CRG/20120502_FDF_CRG/20120502_FDF_CRG_c12.mtb	149	NA	WWSS	water	2	30105	1335988113	1	0.06	0.00260869565217391	4817	1
2	Drink 1	Intake 1	17	30630	1335988638	/users/cn/jespinosa/phecomp/data/CRG/20120502_FDF_CRG/20120502_FDF_CRG/20120502_FDF_CRG_c12.mtb	124	NA	WWSS	water	1	30613	1335988621	1	0.04	0.00235294117647059	4818	1
2	Food 1	Intake 3	742	31377	1335989385	/users/cn/jespinosa/phecomp/data/CRG/20120502_FDF_CRG/20120502_FDF_CRG/20120502_FDF_CRG_c12.mtb	252	8	WWSS	food_sc	3	30635	1335988643	1	0.2	0.000269541778975741	4819	1
2	Food 1	Intake 3	44	31429	1335989437	/users/cn/jespinosa/phecomp/data/CRG/20120502_FDF_CRG/20120502_FDF_CRG/20120502_FDF_CRG_c12.mtb	253	155	WWSS	food_sc	3	31385	1335989393	1	0.02	0.000454545454545455	4820	1
2	Drink 2	Intake 2	29	31512	1335989520	/users/cn/jespinosa/phecomp/data/CRG/20120502_FDF_CRG/20120502_FDF_CRG/20120502_FDF_CRG_c12.mtb	150	NA	WWSS	water	2	31483	1335989491	1	0.04	0.00137931034482759	4821	1
2	Drink 2	Intake 2	25	31577	1335989585	/users/cn/jespinosa/phecomp/data/CRG/20120502_FDF_CRG/20120502_FDF_CRG/20120502_FDF_CRG_c12.mtb	152	NA	WWSS	water	2	31552	1335989560	1	0.02	0.0008	4822	1
2	Food 1	Intake 3	81	31665	1335989673	/users/cn/jespinosa/phecomp/data/CRG/20120502_FDF_CRG/20120502_FDF_CRG/20120502_FDF_CRG_c12.mtb	254	851	WWSS	food_sc	3	31584	1335989592	1	0.02	0.000246913580246914	4823	1
2	Drink 2	Intake 2	19	31708	1335989716	/users/cn/jespinosa/phecomp/data/CRG/20120502_FDF_CRG/20120502_FDF_CRG/20120502_FDF_CRG_c12.mtb	153	NA	WWSS	water	2	31689	1335989697	1	0.06	0.00315789473684211	4824	1
2	Drink 1	Intake 1	17	31782	1335989790	/users/cn/jespinosa/phecomp/data/CRG/20120502_FDF_CRG/20120502_FDF_CRG/20120502_FDF_CRG_c12.mtb	125	NA	WWSS	water	1	31765	1335989773	1	0.06	0.00352941176470588	4825	1
2	Drink 2	Intake 2	43	32502	1335990510	/users/cn/jespinosa/phecomp/data/CRG/20120502_FDF_CRG/20120502_FDF_CRG/20120502_FDF_CRG_c12.mtb	160	NA	WWSS	water	2	32459	1335990467	1	0.02	0.000465116279069767	4826	1
2	Food 2	Intake 4	17	32533	1335990541	/users/cn/jespinosa/phecomp/data/CRG/20120502_FDF_CRG/20120502_FDF_CRG/20120502_FDF_CRG_c12.mtb	502	2849	WWSS	food_sc	4	32516	1335990524	1	0.02	0.00117647058823529	4827	1
2	Food 1	Intake 3	17	35399	1335993407	/users/cn/jespinosa/phecomp/data/CRG/20120502_FDF_CRG/20120502_FDF_CRG/20120502_FDF_CRG_c12.mtb	261	1121	WWSS	food_sc	3	35382	1335993390	1	0.02	0.00117647058823529	4828	1
2	Food 1	Intake 3	158	36678	1335994686	/users/cn/jespinosa/phecomp/data/CRG/20120502_FDF_CRG/20120502_FDF_CRG/20120502_FDF_CRG_c12.mtb	263	1476	WWSS	food_sc	3	36520	1335994528	1	0.0399999999999999	0.000253164556962025	4829	1
2	Drink 2	Intake 2	24	36784	1335994792	/users/cn/jespinosa/phecomp/data/CRG/20120502_FDF_CRG/20120502_FDF_CRG/20120502_FDF_CRG_c12.mtb	169	NA	WWSS	water	2	36760	1335994768	1	0.02	0.000833333333333333	4830	1
2	Food 1	Intake 3	48	38202	1335996210	/users/cn/jespinosa/phecomp/data/CRG/20120502_FDF_CRG/20120502_FDF_CRG/20120502_FDF_CRG_c12.mtb	266	7	WWSS	food_sc	3	38154	1335996162	1	0.02	0.000416666666666667	4831	1
2	Food 1	Intake 3	112	38321	1335996329	/users/cn/jespinosa/phecomp/data/CRG/20120502_FDF_CRG/20120502_FDF_CRG/20120502_FDF_CRG_c12.mtb	267	1447	WWSS	food_sc	3	38209	1335996217	1	0.02	0.000178571428571429	4832	1
2	Food 1	Intake 3	188	39956	1335997964	/users/cn/jespinosa/phecomp/data/CRG/20120502_FDF_CRG/20120502_FDF_CRG/20120502_FDF_CRG_c12.mtb	274	2098	WWSS	food_sc	3	39768	1335997776	1	0.02	0.000106382978723404	4833	1
2	Drink 2	Intake 2	16	39976	1335997984	/users/cn/jespinosa/phecomp/data/CRG/20120502_FDF_CRG/20120502_FDF_CRG/20120502_FDF_CRG_c12.mtb	175	NA	WWSS	water	2	39960	1335997968	1	0.02	0.00125	4834	1
2	Food 1	Intake 3	149	42203	1336000211	/users/cn/jespinosa/phecomp/data/CRG/20120502_FDF_CRG/20120502_FDF_CRG/20120502_FDF_CRG_c12.mtb	280	1852	WWSS	food_sc	3	42054	1336000062	1	0.02	0.000134228187919463	4835	1
2	Drink 2	Intake 2	23	42476	1336000484	/users/cn/jespinosa/phecomp/data/CRG/20120502_FDF_CRG/20120502_FDF_CRG/20120502_FDF_CRG_c12.mtb	191	NA	WWSS	water	2	42453	1336000461	1	0.02	0.000869565217391304	4836	1
2	Drink 1	Intake 1	20	42732	1336000740	/users/cn/jespinosa/phecomp/data/CRG/20120502_FDF_CRG/20120502_FDF_CRG/20120502_FDF_CRG_c12.mtb	134	NA	WWSS	water	1	42712	1336000720	1	0.04	0.002	4837	1
2	Drink 1	Intake 1	34	42954	1336000962	/users/cn/jespinosa/phecomp/data/CRG/20120502_FDF_CRG/20120502_FDF_CRG/20120502_FDF_CRG_c12.mtb	135	NA	WWSS	water	1	42920	1336000928	1	0.04	0.00117647058823529	4838	1
2	Food 2	Intake 4	859	44914	1336002922	/users/cn/jespinosa/phecomp/data/CRG/20120502_FDF_CRG/20120502_FDF_CRG/20120502_FDF_CRG_c12.mtb	520	7365	WWSS	food_sc	4	44055	1336002063	1	0.24	0.000279394644935972	4839	1
2	Drink 1	Intake 1	25	44973	1336002981	/users/cn/jespinosa/phecomp/data/CRG/20120502_FDF_CRG/20120502_FDF_CRG/20120502_FDF_CRG_c12.mtb	137	NA	WWSS	water	1	44948	1336002956	1	0.08	0.0032	4840	1
2	Drink 1	Intake 1	17	45079	1336003087	/users/cn/jespinosa/phecomp/data/CRG/20120502_FDF_CRG/20120502_FDF_CRG/20120502_FDF_CRG_c12.mtb	138	NA	WWSS	water	1	45062	1336003070	1	0.04	0.00235294117647059	4841	1
2	Drink 1	Intake 1	24	45175	1336003183	/users/cn/jespinosa/phecomp/data/CRG/20120502_FDF_CRG/20120502_FDF_CRG/20120502_FDF_CRG_c12.mtb	139	NA	WWSS	water	1	45151	1336003159	1	0.04	0.00166666666666667	4842	1
2	Drink 2	Intake 2	31	45301	1336003309	/users/cn/jespinosa/phecomp/data/CRG/20120502_FDF_CRG/20120502_FDF_CRG/20120502_FDF_CRG_c12.mtb	204	NA	WWSS	water	2	45270	1336003278	1	0.02	0.000645161290322581	4843	1
2	Drink 1	Intake 1	20	45452	1336003460	/users/cn/jespinosa/phecomp/data/CRG/20120502_FDF_CRG/20120502_FDF_CRG/20120502_FDF_CRG_c12.mtb	140	NA	WWSS	water	1	45432	1336003440	1	0.06	0.003	4844	1
2	Food 2	Intake 4	54	52333	1336010341	/users/cn/jespinosa/phecomp/data/CRG/20120502_FDF_CRG/20120502_FDF_CRG/20120502_FDF_CRG_c12.mtb	523	15	WWSS	food_sc	4	52279	1336010287	1	0.02	0.00037037037037037	4845	1
2	Food 2	Intake 4	470	52818	1336010826	/users/cn/jespinosa/phecomp/data/CRG/20120502_FDF_CRG/20120502_FDF_CRG/20120502_FDF_CRG_c12.mtb	524	21	WWSS	food_sc	4	52348	1336010356	1	0.1	0.000212765957446809	4846	1
2	Food 2	Intake 4	148	52987	1336010995	/users/cn/jespinosa/phecomp/data/CRG/20120502_FDF_CRG/20120502_FDF_CRG/20120502_FDF_CRG_c12.mtb	525	542	WWSS	food_sc	4	52839	1336010847	1	0.02	0.000135135135135135	4847	1
2	Drink 1	Intake 1	26	53007	1336011015	/users/cn/jespinosa/phecomp/data/CRG/20120502_FDF_CRG/20120502_FDF_CRG/20120502_FDF_CRG_c12.mtb	141	NA	WWSS	water	1	52981	1336010989	1	0.1	0.00384615384615385	4848	1
2	Drink 2	Intake 2	45	53403	1336011411	/users/cn/jespinosa/phecomp/data/CRG/20120502_FDF_CRG/20120502_FDF_CRG/20120502_FDF_CRG_c12.mtb	209	NA	WWSS	water	2	53358	1336011366	1	0.04	0.000888888888888889	4849	1
2	Food 2	Intake 4	705	54234	1336012242	/users/cn/jespinosa/phecomp/data/CRG/20120502_FDF_CRG/20120502_FDF_CRG/20120502_FDF_CRG_c12.mtb	529	141	WWSS	food_sc	4	53529	1336011537	1	0.16	0.000226950354609929	4850	1
2	Drink 1	Intake 1	28	54281	1336012289	/users/cn/jespinosa/phecomp/data/CRG/20120502_FDF_CRG/20120502_FDF_CRG/20120502_FDF_CRG_c12.mtb	142	NA	WWSS	water	1	54253	1336012261	1	0.1	0.00357142857142857	4851	1
2	Food 2	Intake 4	24	54399	1336012407	/users/cn/jespinosa/phecomp/data/CRG/20120502_FDF_CRG/20120502_FDF_CRG/20120502_FDF_CRG_c12.mtb	530	341	WWSS	food_sc	4	54375	1336012383	1	0.02	0.000833333333333333	4852	1
2	Drink 1	Intake 1	30	54630	1336012638	/users/cn/jespinosa/phecomp/data/CRG/20120502_FDF_CRG/20120502_FDF_CRG/20120502_FDF_CRG_c12.mtb	144	NA	WWSS	water	1	54600	1336012608	1	0.1	0.00333333333333333	4853	1
2	Food 2	Intake 4	108	54848	1336012856	/users/cn/jespinosa/phecomp/data/CRG/20120502_FDF_CRG/20120502_FDF_CRG/20120502_FDF_CRG_c12.mtb	531	22	WWSS	food_sc	4	54740	1336012748	1	0.0599999999999999	0.000555555555555555	4854	1
2	Food 2	Intake 4	197	55067	1336013075	/users/cn/jespinosa/phecomp/data/CRG/20120502_FDF_CRG/20120502_FDF_CRG/20120502_FDF_CRG_c12.mtb	532	7364	WWSS	food_sc	4	54870	1336012878	1	0.0600000000000001	0.000304568527918782	4855	1
2	Drink 2	Intake 2	28	55101	1336013109	/users/cn/jespinosa/phecomp/data/CRG/20120502_FDF_CRG/20120502_FDF_CRG/20120502_FDF_CRG_c12.mtb	213	NA	WWSS	water	2	55073	1336013081	1	0.02	0.000714285714285714	4856	1
2	Drink 1	Intake 1	25	55167	1336013175	/users/cn/jespinosa/phecomp/data/CRG/20120502_FDF_CRG/20120502_FDF_CRG/20120502_FDF_CRG_c12.mtb	145	NA	WWSS	water	1	55142	1336013150	1	0.04	0.0016	4857	1
2	Drink 2	Intake 2	11	55380	1336013388	/users/cn/jespinosa/phecomp/data/CRG/20120502_FDF_CRG/20120502_FDF_CRG/20120502_FDF_CRG_c12.mtb	215	NA	WWSS	water	2	55369	1336013377	1	0.02	0.00181818181818182	4858	1
2	Drink 1	Intake 1	22	56616	1336014624	/users/cn/jespinosa/phecomp/data/CRG/20120502_FDF_CRG/20120502_FDF_CRG/20120502_FDF_CRG_c12.mtb	148	NA	WWSS	water	1	56594	1336014602	1	0.0599999999999999	0.00272727272727272	4859	1
2	Food 2	Intake 4	202	62633	1336020641	/users/cn/jespinosa/phecomp/data/CRG/20120502_FDF_CRG/20120502_FDF_CRG/20120502_FDF_CRG_c12.mtb	539	73	WWSS	food_sc	4	62431	1336020439	1	0.02	9.9009900990099e-05	4860	1
2	Drink 1	Intake 1	54	62688	1336020696	/users/cn/jespinosa/phecomp/data/CRG/20120502_FDF_CRG/20120502_FDF_CRG/20120502_FDF_CRG_c12.mtb	151	NA	WWSS	water	1	62634	1336020642	1	0.1	0.00185185185185185	4861	1
2	Drink 2	Intake 2	15	62701	1336020709	/users/cn/jespinosa/phecomp/data/CRG/20120502_FDF_CRG/20120502_FDF_CRG/20120502_FDF_CRG_c12.mtb	226	NA	WWSS	water	2	62686	1336020694	1	0.02	0.00133333333333333	4862	1
2	Food 2	Intake 4	218	62924	1336020932	/users/cn/jespinosa/phecomp/data/CRG/20120502_FDF_CRG/20120502_FDF_CRG/20120502_FDF_CRG_c12.mtb	540	2381	WWSS	food_sc	4	62706	1336020714	1	0.0600000000000001	0.000275229357798166	4863	1
2	Drink 1	Intake 1	21	63064	1336021072	/users/cn/jespinosa/phecomp/data/CRG/20120502_FDF_CRG/20120502_FDF_CRG/20120502_FDF_CRG_c12.mtb	153	NA	WWSS	water	1	63043	1336021051	1	0.0600000000000001	0.00285714285714286	4864	1
2	Drink 1	Intake 1	35	64022	1336022030	/users/cn/jespinosa/phecomp/data/CRG/20120502_FDF_CRG/20120502_FDF_CRG/20120502_FDF_CRG_c12.mtb	155	NA	WWSS	water	1	63987	1336021995	1	0.1	0.00285714285714286	4865	1
2	Drink 1	Intake 1	30	64105	1336022113	/users/cn/jespinosa/phecomp/data/CRG/20120502_FDF_CRG/20120502_FDF_CRG/20120502_FDF_CRG_c12.mtb	157	NA	WWSS	water	1	64075	1336022083	1	0.0599999999999998	0.00199999999999999	4866	1
2	Food 2	Intake 4	21	65326	1336023334	/users/cn/jespinosa/phecomp/data/CRG/20120502_FDF_CRG/20120502_FDF_CRG/20120502_FDF_CRG_c12.mtb	552	5979	WWSS	food_sc	4	65305	1336023313	1	0.02	0.000952380952380952	4867	1
2	Drink 2	Intake 2	15	71274	1336029282	/users/cn/jespinosa/phecomp/data/CRG/20120502_FDF_CRG/20120502_FDF_CRG/20120502_FDF_CRG_c12.mtb	244	NA	WWSS	water	2	71259	1336029267	1	0.02	0.00133333333333333	4868	1
2	Food 2	Intake 4	541	71846	1336029854	/users/cn/jespinosa/phecomp/data/CRG/20120502_FDF_CRG/20120502_FDF_CRG/20120502_FDF_CRG_c12.mtb	554	56	WWSS	food_sc	4	71305	1336029313	1	0.02	3.69685767097967e-05	4869	1
2	Food 2	Intake 4	193	72095	1336030103	/users/cn/jespinosa/phecomp/data/CRG/20120502_FDF_CRG/20120502_FDF_CRG/20120502_FDF_CRG_c12.mtb	555	34	WWSS	food_sc	4	71902	1336029910	1	0.02	0.000103626943005181	4870	1
2	Food 2	Intake 4	114	72243	1336030251	/users/cn/jespinosa/phecomp/data/CRG/20120502_FDF_CRG/20120502_FDF_CRG/20120502_FDF_CRG_c12.mtb	556	19513	WWSS	food_sc	4	72129	1336030137	1	0.02	0.000175438596491228	4871	1
2	Drink 2	Intake 2	41	72465	1336030473	/users/cn/jespinosa/phecomp/data/CRG/20120502_FDF_CRG/20120502_FDF_CRG/20120502_FDF_CRG_c12.mtb	249	NA	WWSS	water	2	72424	1336030432	1	0.0399999999999999	0.000975609756097558	4872	1
2	Drink 2	Intake 2	36	72685	1336030693	/users/cn/jespinosa/phecomp/data/CRG/20120502_FDF_CRG/20120502_FDF_CRG/20120502_FDF_CRG_c12.mtb	250	NA	WWSS	water	2	72649	1336030657	1	0.04	0.00111111111111111	4873	1
2	Drink 2	Intake 2	26	83865	1336041873	/users/cn/jespinosa/phecomp/data/CRG/20120502_FDF_CRG/20120502_FDF_CRG/20120502_FDF_CRG_c12.mtb	256	NA	WWSS	water	2	83839	1336041847	1	0.02	0.000769230769230769	4874	1
2	Food 2	Intake 4	157	91913	1336049921	/users/cn/jespinosa/phecomp/data/CRG/20120502_FDF_CRG/20120502_FDF_CRG/20120502_FDF_CRG_c12.mtb	562	16994	WWSS	food_sc	4	91756	1336049764	1	0.02	0.000127388535031847	4875	1
2	Drink 1	Intake 1	23	93479	1336051487	/users/cn/jespinosa/phecomp/data/CRG/20120502_FDF_CRG/20120502_FDF_CRG/20120502_FDF_CRG_c12.mtb	161	NA	WWSS	water	1	93456	1336051464	1	0.02	0.000869565217391304	4876	1
2	Food 1	Intake 3	139	109046	1336067054	/users/cn/jespinosa/phecomp/data/CRG/20120502_FDF_CRG/20120502_FDF_CRG/20120502_FDF_CRG_c12.mtb	307	30	WWSS	food_sc	3	108907	1336066915	1	0.02	0.000143884892086331	4877	1
2	Food 1	Intake 3	673	109749	1336067757	/users/cn/jespinosa/phecomp/data/CRG/20120502_FDF_CRG/20120502_FDF_CRG/20120502_FDF_CRG_c12.mtb	308	16	WWSS	food_sc	3	109076	1336067084	1	0.14	0.000208023774145617	4878	1
2	Food 1	Intake 3	48	109813	1336067821	/users/cn/jespinosa/phecomp/data/CRG/20120502_FDF_CRG/20120502_FDF_CRG/20120502_FDF_CRG_c12.mtb	309	3078	WWSS	food_sc	3	109765	1336067773	1	0.02	0.000416666666666667	4879	1
2	Drink 1	Intake 1	31	109879	1336067887	/users/cn/jespinosa/phecomp/data/CRG/20120502_FDF_CRG/20120502_FDF_CRG/20120502_FDF_CRG_c12.mtb	162	NA	WWSS	water	1	109848	1336067856	1	0.0600000000000001	0.00193548387096775	4880	1
2	Drink 1	Intake 1	20	110015	1336068023	/users/cn/jespinosa/phecomp/data/CRG/20120502_FDF_CRG/20120502_FDF_CRG/20120502_FDF_CRG_c12.mtb	163	NA	WWSS	water	1	109995	1336068003	1	0.04	0.002	4881	1
2	Food 1	Intake 3	267	113158	1336071166	/users/cn/jespinosa/phecomp/data/CRG/20120502_FDF_CRG/20120502_FDF_CRG/20120502_FDF_CRG_c12.mtb	315	547	WWSS	food_sc	3	112891	1336070899	1	0.02	7.49063670411985e-05	4882	1
2	Food 1	Intake 3	186	113891	1336071899	/users/cn/jespinosa/phecomp/data/CRG/20120502_FDF_CRG/20120502_FDF_CRG/20120502_FDF_CRG_c12.mtb	316	76	WWSS	food_sc	3	113705	1336071713	1	0.04	0.00021505376344086	4883	1
2	Food 1	Intake 3	254	114221	1336072229	/users/cn/jespinosa/phecomp/data/CRG/20120502_FDF_CRG/20120502_FDF_CRG/20120502_FDF_CRG_c12.mtb	317	604	WWSS	food_sc	3	113967	1336071975	1	0.0800000000000001	0.00031496062992126	4884	1
2	Drink 2	Intake 2	39	114482	1336072490	/users/cn/jespinosa/phecomp/data/CRG/20120502_FDF_CRG/20120502_FDF_CRG/20120502_FDF_CRG_c12.mtb	272	NA	WWSS	water	2	114443	1336072451	1	0.04	0.00102564102564103	4885	1
2	Food 1	Intake 3	350	115175	1336073183	/users/cn/jespinosa/phecomp/data/CRG/20120502_FDF_CRG/20120502_FDF_CRG/20120502_FDF_CRG_c12.mtb	319	783	WWSS	food_sc	3	114825	1336072833	1	0.12	0.000342857142857143	4886	1
2	Drink 2	Intake 2	38	115215	1336073223	/users/cn/jespinosa/phecomp/data/CRG/20120502_FDF_CRG/20120502_FDF_CRG/20120502_FDF_CRG_c12.mtb	275	NA	WWSS	water	2	115177	1336073185	1	0.1	0.00263157894736842	4887	1
2	Drink 2	Intake 2	97	115694	1336073702	/users/cn/jespinosa/phecomp/data/CRG/20120502_FDF_CRG/20120502_FDF_CRG/20120502_FDF_CRG_c12.mtb	277	NA	WWSS	water	2	115597	1336073605	1	0.0399999999999999	0.000412371134020617	4888	1
2	Food 1	Intake 3	192	116150	1336074158	/users/cn/jespinosa/phecomp/data/CRG/20120502_FDF_CRG/20120502_FDF_CRG/20120502_FDF_CRG_c12.mtb	323	313	WWSS	food_sc	3	115958	1336073966	1	0.02	0.000104166666666667	4889	1
2	Drink 1	Intake 1	24	116456	1336074464	/users/cn/jespinosa/phecomp/data/CRG/20120502_FDF_CRG/20120502_FDF_CRG/20120502_FDF_CRG_c12.mtb	171	NA	WWSS	water	1	116432	1336074440	1	0.02	0.000833333333333333	4890	1
2	Food 1	Intake 3	141	116604	1336074612	/users/cn/jespinosa/phecomp/data/CRG/20120502_FDF_CRG/20120502_FDF_CRG/20120502_FDF_CRG_c12.mtb	325	321	WWSS	food_sc	3	116463	1336074471	1	0.02	0.000141843971631206	4891	1
2	Food 1	Intake 3	319	117244	1336075252	/users/cn/jespinosa/phecomp/data/CRG/20120502_FDF_CRG/20120502_FDF_CRG/20120502_FDF_CRG_c12.mtb	326	11	WWSS	food_sc	3	116925	1336074933	1	0.0599999999999998	0.00018808777429467	4892	1
2	Food 1	Intake 3	37	117292	1336075300	/users/cn/jespinosa/phecomp/data/CRG/20120502_FDF_CRG/20120502_FDF_CRG/20120502_FDF_CRG_c12.mtb	327	2576	WWSS	food_sc	3	117255	1336075263	1	0.02	0.000540540540540541	4893	1
2	Drink 2	Intake 2	31	117433	1336075441	/users/cn/jespinosa/phecomp/data/CRG/20120502_FDF_CRG/20120502_FDF_CRG/20120502_FDF_CRG_c12.mtb	285	NA	WWSS	water	2	117402	1336075410	1	0.0600000000000001	0.00193548387096775	4894	1
2	Drink 2	Intake 2	28	117786	1336075794	/users/cn/jespinosa/phecomp/data/CRG/20120502_FDF_CRG/20120502_FDF_CRG/20120502_FDF_CRG_c12.mtb	286	NA	WWSS	water	2	117758	1336075766	1	0.02	0.000714285714285714	4895	1
2	Food 1	Intake 3	124	119992	1336078000	/users/cn/jespinosa/phecomp/data/CRG/20120502_FDF_CRG/20120502_FDF_CRG/20120502_FDF_CRG_c12.mtb	333	24	WWSS	food_sc	3	119868	1336077876	1	0.02	0.000161290322580645	4896	1
2	Food 1	Intake 3	541	120557	1336078565	/users/cn/jespinosa/phecomp/data/CRG/20120502_FDF_CRG/20120502_FDF_CRG/20120502_FDF_CRG_c12.mtb	334	3251	WWSS	food_sc	3	120016	1336078024	1	0.0600000000000001	0.00011090573012939	4897	1
2	Drink 2	Intake 2	49	123649	1336081657	/users/cn/jespinosa/phecomp/data/CRG/20120502_FDF_CRG/20120502_FDF_CRG/20120502_FDF_CRG_c12.mtb	291	NA	WWSS	water	2	123600	1336081608	1	0.02	0.000408163265306122	4898	1
2	Food 1	Intake 3	245	124053	1336082061	/users/cn/jespinosa/phecomp/data/CRG/20120502_FDF_CRG/20120502_FDF_CRG/20120502_FDF_CRG_c12.mtb	338	77	WWSS	food_sc	3	123808	1336081816	1	0.04	0.000163265306122449	4899	1
2	Food 1	Intake 3	185	124315	1336082323	/users/cn/jespinosa/phecomp/data/CRG/20120502_FDF_CRG/20120502_FDF_CRG/20120502_FDF_CRG_c12.mtb	339	630	WWSS	food_sc	3	124130	1336082138	1	0.02	0.000108108108108108	4900	1
2	Drink 1	Intake 1	58	124932	1336082940	/users/cn/jespinosa/phecomp/data/CRG/20120502_FDF_CRG/20120502_FDF_CRG/20120502_FDF_CRG_c12.mtb	176	NA	WWSS	water	1	124874	1336082882	1	0.02	0.000344827586206897	4901	1
2	Food 1	Intake 3	594	125539	1336083547	/users/cn/jespinosa/phecomp/data/CRG/20120502_FDF_CRG/20120502_FDF_CRG/20120502_FDF_CRG_c12.mtb	340	708	WWSS	food_sc	3	124945	1336082953	1	0.12	0.000202020202020202	4902	1
2	Drink 2	Intake 2	40	125581	1336083589	/users/cn/jespinosa/phecomp/data/CRG/20120502_FDF_CRG/20120502_FDF_CRG/20120502_FDF_CRG_c12.mtb	298	NA	WWSS	water	2	125541	1336083549	1	0.12	0.003	4903	1
2	Drink 2	Intake 2	47	126255	1336084263	/users/cn/jespinosa/phecomp/data/CRG/20120502_FDF_CRG/20120502_FDF_CRG/20120502_FDF_CRG_c12.mtb	303	NA	WWSS	water	2	126208	1336084216	1	0.02	0.000425531914893617	4904	1
2	Food 1	Intake 3	571	126818	1336084826	/users/cn/jespinosa/phecomp/data/CRG/20120502_FDF_CRG/20120502_FDF_CRG/20120502_FDF_CRG_c12.mtb	343	83	WWSS	food_sc	3	126247	1336084255	1	0.12	0.00021015761821366	4905	1
2	Drink 2	Intake 2	39	126856	1336084864	/users/cn/jespinosa/phecomp/data/CRG/20120502_FDF_CRG/20120502_FDF_CRG/20120502_FDF_CRG_c12.mtb	304	NA	WWSS	water	2	126817	1336084825	1	0.1	0.00256410256410256	4906	1
2	Food 1	Intake 3	144	127045	1336085053	/users/cn/jespinosa/phecomp/data/CRG/20120502_FDF_CRG/20120502_FDF_CRG/20120502_FDF_CRG_c12.mtb	344	847	WWSS	food_sc	3	126901	1336084909	1	0.04	0.000277777777777778	4907	1
2	Drink 2	Intake 2	21	127063	1336085071	/users/cn/jespinosa/phecomp/data/CRG/20120502_FDF_CRG/20120502_FDF_CRG/20120502_FDF_CRG_c12.mtb	305	NA	WWSS	water	2	127042	1336085050	1	0.0600000000000001	0.00285714285714286	4908	1
2	Drink 2	Intake 2	26	127808	1336085816	/users/cn/jespinosa/phecomp/data/CRG/20120502_FDF_CRG/20120502_FDF_CRG/20120502_FDF_CRG_c12.mtb	311	NA	WWSS	water	2	127782	1336085790	1	0.0399999999999998	0.00153846153846153	4909	1
2	Food 1	Intake 3	380	128272	1336086280	/users/cn/jespinosa/phecomp/data/CRG/20120502_FDF_CRG/20120502_FDF_CRG/20120502_FDF_CRG_c12.mtb	346	38	WWSS	food_sc	3	127892	1336085900	1	0.0599999999999998	0.000157894736842105	4910	1
2	Food 1	Intake 3	204	128514	1336086522	/users/cn/jespinosa/phecomp/data/CRG/20120502_FDF_CRG/20120502_FDF_CRG/20120502_FDF_CRG_c12.mtb	347	498	WWSS	food_sc	3	128310	1336086318	1	0.04	0.000196078431372549	4911	1
2	Drink 2	Intake 2	16	128526	1336086534	/users/cn/jespinosa/phecomp/data/CRG/20120502_FDF_CRG/20120502_FDF_CRG/20120502_FDF_CRG_c12.mtb	314	NA	WWSS	water	2	128510	1336086518	1	0.04	0.0025	4912	1
2	Drink 2	Intake 2	22	128739	1336086747	/users/cn/jespinosa/phecomp/data/CRG/20120502_FDF_CRG/20120502_FDF_CRG/20120502_FDF_CRG_c12.mtb	315	NA	WWSS	water	2	128717	1336086725	1	0.0600000000000001	0.00272727272727273	4913	1
2	Food 1	Intake 3	487	129499	1336087507	/users/cn/jespinosa/phecomp/data/CRG/20120502_FDF_CRG/20120502_FDF_CRG/20120502_FDF_CRG_c12.mtb	353	2264	WWSS	food_sc	3	129012	1336087020	1	0.2	0.000410677618069815	4914	1
2	Drink 2	Intake 2	36	129534	1336087542	/users/cn/jespinosa/phecomp/data/CRG/20120502_FDF_CRG/20120502_FDF_CRG/20120502_FDF_CRG_c12.mtb	317	NA	WWSS	water	2	129498	1336087506	1	0.0800000000000001	0.00222222222222222	4915	1
2	Drink 2	Intake 2	55	130179	1336088187	/users/cn/jespinosa/phecomp/data/CRG/20120502_FDF_CRG/20120502_FDF_CRG/20120502_FDF_CRG_c12.mtb	320	NA	WWSS	water	2	130124	1336088132	1	0.0600000000000001	0.00109090909090909	4916	1
2	Drink 2	Intake 2	57	130471	1336088479	/users/cn/jespinosa/phecomp/data/CRG/20120502_FDF_CRG/20120502_FDF_CRG/20120502_FDF_CRG_c12.mtb	322	NA	WWSS	water	2	130414	1336088422	1	0.04	0.000701754385964912	4917	1
2	Drink 2	Intake 2	17	131454	1336089462	/users/cn/jespinosa/phecomp/data/CRG/20120502_FDF_CRG/20120502_FDF_CRG/20120502_FDF_CRG_c12.mtb	329	NA	WWSS	water	2	131437	1336089445	1	0.02	0.00117647058823529	4918	1
2	Food 1	Intake 3	137	131900	1336089908	/users/cn/jespinosa/phecomp/data/CRG/20120502_FDF_CRG/20120502_FDF_CRG/20120502_FDF_CRG_c12.mtb	360	5825	WWSS	food_sc	3	131763	1336089771	1	0.02	0.000145985401459854	4919	1
2	Drink 2	Intake 2	26	132102	1336090110	/users/cn/jespinosa/phecomp/data/CRG/20120502_FDF_CRG/20120502_FDF_CRG/20120502_FDF_CRG_c12.mtb	330	NA	WWSS	water	2	132076	1336090084	1	0.0399999999999998	0.00153846153846153	4920	1
2	Drink 2	Intake 2	10	132157	1336090165	/users/cn/jespinosa/phecomp/data/CRG/20120502_FDF_CRG/20120502_FDF_CRG/20120502_FDF_CRG_c12.mtb	331	NA	WWSS	water	2	132147	1336090155	1	0.02	0.002	4921	1
2	Food 1	Intake 3	391	138116	1336096124	/users/cn/jespinosa/phecomp/data/CRG/20120502_FDF_CRG/20120502_FDF_CRG/20120502_FDF_CRG_c12.mtb	372	492	WWSS	food_sc	3	137725	1336095733	1	0.0800000000000001	0.00020460358056266	4922	1
2	Drink 1	Intake 1	84	138342	1336096350	/users/cn/jespinosa/phecomp/data/CRG/20120502_FDF_CRG/20120502_FDF_CRG/20120502_FDF_CRG_c12.mtb	189	NA	WWSS	water	1	138258	1336096266	1	0.0399999999999998	0.000476190476190474	4923	1
2	Drink 1	Intake 1	29	138532	1336096540	/users/cn/jespinosa/phecomp/data/CRG/20120502_FDF_CRG/20120502_FDF_CRG/20120502_FDF_CRG_c12.mtb	190	NA	WWSS	water	1	138503	1336096511	1	0.04	0.00137931034482759	4924	1
2	Drink 1	Intake 1	42	138580	1336096588	/users/cn/jespinosa/phecomp/data/CRG/20120502_FDF_CRG/20120502_FDF_CRG/20120502_FDF_CRG_c12.mtb	191	NA	WWSS	water	1	138538	1336096546	1	0.0600000000000001	0.00142857142857143	4925	1
2	Food 2	Intake 4	476	139084	1336097092	/users/cn/jespinosa/phecomp/data/CRG/20120502_FDF_CRG/20120502_FDF_CRG/20120502_FDF_CRG_c12.mtb	589	421	WWSS	food_sc	4	138608	1336096616	1	0.0999999999999999	0.000210084033613445	4926	1
2	Drink 2	Intake 2	24	139113	1336097121	/users/cn/jespinosa/phecomp/data/CRG/20120502_FDF_CRG/20120502_FDF_CRG/20120502_FDF_CRG_c12.mtb	342	NA	WWSS	water	2	139089	1336097097	1	0.04	0.00166666666666667	4927	1
2	Drink 2	Intake 2	20	139229	1336097237	/users/cn/jespinosa/phecomp/data/CRG/20120502_FDF_CRG/20120502_FDF_CRG/20120502_FDF_CRG_c12.mtb	343	NA	WWSS	water	2	139209	1336097217	1	0.0399999999999998	0.00199999999999999	4928	1
2	Drink 2	Intake 2	23	139485	1336097493	/users/cn/jespinosa/phecomp/data/CRG/20120502_FDF_CRG/20120502_FDF_CRG/20120502_FDF_CRG_c12.mtb	345	NA	WWSS	water	2	139462	1336097470	1	0.04	0.00173913043478261	4929	1
2	Food 2	Intake 4	158	139663	1336097671	/users/cn/jespinosa/phecomp/data/CRG/20120502_FDF_CRG/20120502_FDF_CRG/20120502_FDF_CRG_c12.mtb	590	4259	WWSS	food_sc	4	139505	1336097513	1	0.02	0.000126582278481013	4930	1
2	Drink 2	Intake 2	23	139704	1336097712	/users/cn/jespinosa/phecomp/data/CRG/20120502_FDF_CRG/20120502_FDF_CRG/20120502_FDF_CRG_c12.mtb	346	NA	WWSS	water	2	139681	1336097689	1	0.02	0.000869565217391304	4931	1
2	Food 2	Intake 4	20	143942	1336101950	/users/cn/jespinosa/phecomp/data/CRG/20120502_FDF_CRG/20120502_FDF_CRG/20120502_FDF_CRG_c12.mtb	591	990	WWSS	food_sc	4	143922	1336101930	1	0.02	0.001	4932	1
2	Food 1	Intake 3	536	145468	1336103476	/users/cn/jespinosa/phecomp/data/CRG/20120502_FDF_CRG/20120502_FDF_CRG/20120502_FDF_CRG_c12.mtb	379	839	WWSS	food_sc	3	144932	1336102940	1	0.0800000000000001	0.000149253731343284	4933	1
2	Drink 1	Intake 1	21	145584	1336103592	/users/cn/jespinosa/phecomp/data/CRG/20120502_FDF_CRG/20120502_FDF_CRG/20120502_FDF_CRG_c12.mtb	194	NA	WWSS	water	1	145563	1336103571	1	0.0600000000000001	0.00285714285714286	4934	1
2	Drink 2	Intake 2	24	146262	1336104270	/users/cn/jespinosa/phecomp/data/CRG/20120502_FDF_CRG/20120502_FDF_CRG/20120502_FDF_CRG_c12.mtb	353	NA	WWSS	water	2	146238	1336104246	1	0.02	0.000833333333333333	4935	1
2	Drink 2	Intake 2	16	146296	1336104304	/users/cn/jespinosa/phecomp/data/CRG/20120502_FDF_CRG/20120502_FDF_CRG/20120502_FDF_CRG_c12.mtb	354	NA	WWSS	water	2	146280	1336104288	1	0.02	0.00125	4936	1
2	Food 1	Intake 3	501	146808	1336104816	/users/cn/jespinosa/phecomp/data/CRG/20120502_FDF_CRG/20120502_FDF_CRG/20120502_FDF_CRG_c12.mtb	382	3640	WWSS	food_sc	3	146307	1336104315	1	0.0599999999999996	0.000119760479041915	4937	1
2	Drink 2	Intake 2	17	146822	1336104830	/users/cn/jespinosa/phecomp/data/CRG/20120502_FDF_CRG/20120502_FDF_CRG/20120502_FDF_CRG_c12.mtb	355	NA	WWSS	water	2	146805	1336104813	1	0.04	0.00235294117647059	4938	1
2	Drink 1	Intake 1	15	147102	1336105110	/users/cn/jespinosa/phecomp/data/CRG/20120502_FDF_CRG/20120502_FDF_CRG/20120502_FDF_CRG_c12.mtb	197	NA	WWSS	water	1	147087	1336105095	1	0.02	0.00133333333333333	4939	1
2	Food 2	Intake 4	132	150580	1336108588	/users/cn/jespinosa/phecomp/data/CRG/20120502_FDF_CRG/20120502_FDF_CRG/20120502_FDF_CRG_c12.mtb	603	194	WWSS	food_sc	4	150448	1336108456	1	0.02	0.000151515151515152	4940	1
2	Food 2	Intake 4	558	151332	1336109340	/users/cn/jespinosa/phecomp/data/CRG/20120502_FDF_CRG/20120502_FDF_CRG/20120502_FDF_CRG_c12.mtb	606	349	WWSS	food_sc	4	150774	1336108782	1	0.18	0.00032258064516129	4941	1
2	Drink 1	Intake 1	23	151464	1336109472	/users/cn/jespinosa/phecomp/data/CRG/20120502_FDF_CRG/20120502_FDF_CRG/20120502_FDF_CRG_c12.mtb	199	NA	WWSS	water	1	151441	1336109449	1	0.1	0.00434782608695652	4942	1
2	Drink 1	Intake 1	17	151489	1336109497	/users/cn/jespinosa/phecomp/data/CRG/20120502_FDF_CRG/20120502_FDF_CRG/20120502_FDF_CRG_c12.mtb	200	NA	WWSS	water	1	151472	1336109480	1	0.02	0.00117647058823529	4943	1
2	Drink 1	Intake 1	21	151633	1336109641	/users/cn/jespinosa/phecomp/data/CRG/20120502_FDF_CRG/20120502_FDF_CRG/20120502_FDF_CRG_c12.mtb	201	NA	WWSS	water	1	151612	1336109620	1	0.0399999999999998	0.0019047619047619	4944	1
2	Food 2	Intake 4	256	151937	1336109945	/users/cn/jespinosa/phecomp/data/CRG/20120502_FDF_CRG/20120502_FDF_CRG/20120502_FDF_CRG_c12.mtb	608	939	WWSS	food_sc	4	151681	1336109689	1	0.1	0.000390625	4945	1
2	Drink 2	Intake 2	24	152084	1336110092	/users/cn/jespinosa/phecomp/data/CRG/20120502_FDF_CRG/20120502_FDF_CRG/20120502_FDF_CRG_c12.mtb	359	NA	WWSS	water	2	152060	1336110068	1	0.0600000000000001	0.0025	4946	1
2	Drink 1	Intake 1	34	152338	1336110346	/users/cn/jespinosa/phecomp/data/CRG/20120502_FDF_CRG/20120502_FDF_CRG/20120502_FDF_CRG_c12.mtb	202	NA	WWSS	water	1	152304	1336110312	1	0.12	0.00352941176470588	4947	1
2	Drink 2	Intake 2	22	152872	1336110880	/users/cn/jespinosa/phecomp/data/CRG/20120502_FDF_CRG/20120502_FDF_CRG/20120502_FDF_CRG_c12.mtb	362	NA	WWSS	water	2	152850	1336110858	1	0.02	0.000909090909090909	4948	1
2	Food 2	Intake 4	256	153132	1336111140	/users/cn/jespinosa/phecomp/data/CRG/20120502_FDF_CRG/20120502_FDF_CRG/20120502_FDF_CRG_c12.mtb	610	14544	WWSS	food_sc	4	152876	1336110884	1	0.04	0.00015625	4949	1
2	Drink 2	Intake 2	44	154286	1336112294	/users/cn/jespinosa/phecomp/data/CRG/20120502_FDF_CRG/20120502_FDF_CRG/20120502_FDF_CRG_c12.mtb	370	NA	WWSS	water	2	154242	1336112250	1	0.02	0.000454545454545455	4950	1
2	Food 2	Intake 4	157	3655	1336125841	/users/cn/jespinosa/phecomp/data/CRG/20120502_FDF_CRG/20120502_FDF_CRG/20120504_FDF_CRG_c12.mtb	978	17	WWSS	food_sc	4	3498	1336125684	1	0.02	0.000127388535031847	4951	1
2	Food 2	Intake 4	57	3729	1336125915	/users/cn/jespinosa/phecomp/data/CRG/20120502_FDF_CRG/20120502_FDF_CRG/20120504_FDF_CRG_c12.mtb	979	21936	WWSS	food_sc	4	3672	1336125858	1	0.02	0.000350877192982456	4952	1
2	Food 2	Intake 4	95	25760	1336147946	/users/cn/jespinosa/phecomp/data/CRG/20120502_FDF_CRG/20120502_FDF_CRG/20120504_FDF_CRG_c12.mtb	984	28	WWSS	food_sc	4	25665	1336147851	1	0.04	0.000421052631578947	4953	1
2	Food 2	Intake 4	419	26207	1336148393	/users/cn/jespinosa/phecomp/data/CRG/20120502_FDF_CRG/20120502_FDF_CRG/20120504_FDF_CRG_c12.mtb	985	307	WWSS	food_sc	4	25788	1336147974	1	0.16	0.000381861575178998	4954	1
2	Drink 1	Intake 1	17	26246	1336148432	/users/cn/jespinosa/phecomp/data/CRG/20120502_FDF_CRG/20120502_FDF_CRG/20120504_FDF_CRG_c12.mtb	352	NA	WWSS	water	1	26229	1336148415	1	0.02	0.00117647058823529	4955	1
2	Drink 1	Intake 1	16	26322	1336148508	/users/cn/jespinosa/phecomp/data/CRG/20120502_FDF_CRG/20120502_FDF_CRG/20120504_FDF_CRG_c12.mtb	353	NA	WWSS	water	1	26306	1336148492	1	0.04	0.0025	4956	1
2	Drink 1	Intake 1	19	26396	1336148582	/users/cn/jespinosa/phecomp/data/CRG/20120502_FDF_CRG/20120502_FDF_CRG/20120504_FDF_CRG_c12.mtb	354	NA	WWSS	water	1	26377	1336148563	1	0.02	0.00105263157894737	4957	1
2	Drink 2	Intake 2	26	26472	1336148658	/users/cn/jespinosa/phecomp/data/CRG/20120502_FDF_CRG/20120502_FDF_CRG/20120504_FDF_CRG_c12.mtb	551	NA	WWSS	water	2	26446	1336148632	1	0.02	0.000769230769230769	4958	1
2	Food 2	Intake 4	66	26580	1336148766	/users/cn/jespinosa/phecomp/data/CRG/20120502_FDF_CRG/20120502_FDF_CRG/20120504_FDF_CRG_c12.mtb	986	6531	WWSS	food_sc	4	26514	1336148700	1	0.04	0.000606060606060606	4959	1
2	Drink 2	Intake 2	12	26705	1336148891	/users/cn/jespinosa/phecomp/data/CRG/20120502_FDF_CRG/20120502_FDF_CRG/20120504_FDF_CRG_c12.mtb	552	NA	WWSS	water	2	26693	1336148879	1	0.04	0.00333333333333333	4960	1
2	Drink 2	Intake 2	12	28205	1336150391	/users/cn/jespinosa/phecomp/data/CRG/20120502_FDF_CRG/20120502_FDF_CRG/20120504_FDF_CRG_c12.mtb	553	NA	WWSS	water	2	28193	1336150379	1	0.06	0.005	4961	1
2	Food 2	Intake 4	330	33441	1336155627	/users/cn/jespinosa/phecomp/data/CRG/20120502_FDF_CRG/20120502_FDF_CRG/20120504_FDF_CRG_c12.mtb	990	90	WWSS	food_sc	4	33111	1336155297	1	0.06	0.000181818181818182	4962	1
2	Food 2	Intake 4	541	34072	1336156258	/users/cn/jespinosa/phecomp/data/CRG/20120502_FDF_CRG/20120502_FDF_CRG/20120504_FDF_CRG_c12.mtb	991	345	WWSS	food_sc	4	33531	1336155717	1	0.06	0.00011090573012939	4963	1
2	Food 2	Intake 4	441	34858	1336157044	/users/cn/jespinosa/phecomp/data/CRG/20120502_FDF_CRG/20120502_FDF_CRG/20120504_FDF_CRG_c12.mtb	993	508	WWSS	food_sc	4	34417	1336156603	1	0.06	0.000136054421768707	4964	1
2	Drink 1	Intake 1	15	35094	1336157280	/users/cn/jespinosa/phecomp/data/CRG/20120502_FDF_CRG/20120502_FDF_CRG/20120504_FDF_CRG_c12.mtb	356	NA	WWSS	water	1	35079	1336157265	1	0.04	0.00266666666666667	4965	1
2	Drink 2	Intake 2	13	35279	1336157465	/users/cn/jespinosa/phecomp/data/CRG/20120502_FDF_CRG/20120502_FDF_CRG/20120504_FDF_CRG_c12.mtb	555	NA	WWSS	water	2	35266	1336157452	1	0.02	0.00153846153846154	4966	1
2	Food 2	Intake 4	246	35612	1336157798	/users/cn/jespinosa/phecomp/data/CRG/20120502_FDF_CRG/20120502_FDF_CRG/20120504_FDF_CRG_c12.mtb	996	660	WWSS	food_sc	4	35366	1336157552	1	0.04	0.00016260162601626	4967	1
2	Drink 2	Intake 2	11	35862	1336158048	/users/cn/jespinosa/phecomp/data/CRG/20120502_FDF_CRG/20120502_FDF_CRG/20120504_FDF_CRG_c12.mtb	556	NA	WWSS	water	2	35851	1336158037	1	0.02	0.00181818181818182	4968	1
2	Drink 1	Intake 1	40	35897	1336158083	/users/cn/jespinosa/phecomp/data/CRG/20120502_FDF_CRG/20120502_FDF_CRG/20120504_FDF_CRG_c12.mtb	358	NA	WWSS	water	1	35857	1336158043	1	0.04	0.001	4969	1
2	Food 2	Intake 4	277	36549	1336158735	/users/cn/jespinosa/phecomp/data/CRG/20120502_FDF_CRG/20120502_FDF_CRG/20120504_FDF_CRG_c12.mtb	1001	296	WWSS	food_sc	4	36272	1336158458	1	0.02	7.2202166064982e-05	4970	1
2	Food 2	Intake 4	627	37472	1336159658	/users/cn/jespinosa/phecomp/data/CRG/20120502_FDF_CRG/20120502_FDF_CRG/20120504_FDF_CRG_c12.mtb	1005	1219	WWSS	food_sc	4	36845	1336159031	1	0.08	0.000127591706539075	4971	1
2	Drink 2	Intake 2	15	37706	1336159892	/users/cn/jespinosa/phecomp/data/CRG/20120502_FDF_CRG/20120502_FDF_CRG/20120504_FDF_CRG_c12.mtb	560	NA	WWSS	water	2	37691	1336159877	1	0.02	0.00133333333333333	4972	1
2	Drink 2	Intake 2	18	38087	1336160273	/users/cn/jespinosa/phecomp/data/CRG/20120502_FDF_CRG/20120502_FDF_CRG/20120504_FDF_CRG_c12.mtb	562	NA	WWSS	water	2	38069	1336160255	1	0.02	0.00111111111111111	4973	1
2	Food 2	Intake 4	151	38842	1336161028	/users/cn/jespinosa/phecomp/data/CRG/20120502_FDF_CRG/20120502_FDF_CRG/20120504_FDF_CRG_c12.mtb	1010	201	WWSS	food_sc	4	38691	1336160877	1	0.02	0.000132450331125828	4974	1
2	Food 1	Intake 3	160	39203	1336161389	/users/cn/jespinosa/phecomp/data/CRG/20120502_FDF_CRG/20120502_FDF_CRG/20120504_FDF_CRG_c12.mtb	523	11	WWSS	food_sc	3	39043	1336161229	1	0.06	0.000375	4975	1
2	Food 1	Intake 3	528	39742	1336161928	/users/cn/jespinosa/phecomp/data/CRG/20120502_FDF_CRG/20120502_FDF_CRG/20120504_FDF_CRG_c12.mtb	524	130	WWSS	food_sc	3	39214	1336161400	1	0.16	0.000303030303030303	4976	1
2	Drink 2	Intake 2	24	39762	1336161948	/users/cn/jespinosa/phecomp/data/CRG/20120502_FDF_CRG/20120502_FDF_CRG/20120504_FDF_CRG_c12.mtb	564	NA	WWSS	water	2	39738	1336161924	1	0.08	0.00333333333333333	4977	1
2	Drink 2	Intake 2	16	39849	1336162035	/users/cn/jespinosa/phecomp/data/CRG/20120502_FDF_CRG/20120502_FDF_CRG/20120504_FDF_CRG_c12.mtb	565	NA	WWSS	water	2	39833	1336162019	1	0.02	0.00125	4978	1
2	Food 1	Intake 3	240	40112	1336162298	/users/cn/jespinosa/phecomp/data/CRG/20120502_FDF_CRG/20120502_FDF_CRG/20120504_FDF_CRG_c12.mtb	526	390	WWSS	food_sc	3	39872	1336162058	1	0.02	8.33333333333333e-05	4979	1
2	Drink 1	Intake 1	11	40122	1336162308	/users/cn/jespinosa/phecomp/data/CRG/20120502_FDF_CRG/20120502_FDF_CRG/20120504_FDF_CRG_c12.mtb	360	NA	WWSS	water	1	40111	1336162297	1	0.04	0.00363636363636364	4980	1
2	Food 1	Intake 3	88	40590	1336162776	/users/cn/jespinosa/phecomp/data/CRG/20120502_FDF_CRG/20120502_FDF_CRG/20120504_FDF_CRG_c12.mtb	527	162	WWSS	food_sc	3	40502	1336162688	1	0.02	0.000227272727272727	4981	1
2	Food 1	Intake 3	205	40957	1336163143	/users/cn/jespinosa/phecomp/data/CRG/20120502_FDF_CRG/20120502_FDF_CRG/20120504_FDF_CRG_c12.mtb	529	1301	WWSS	food_sc	3	40752	1336162938	1	0.02	9.75609756097561e-05	4982	1
2	Drink 2	Intake 2	21	40982	1336163168	/users/cn/jespinosa/phecomp/data/CRG/20120502_FDF_CRG/20120502_FDF_CRG/20120504_FDF_CRG_c12.mtb	566	NA	WWSS	water	2	40961	1336163147	1	0.04	0.0019047619047619	4983	1
2	Drink 1	Intake 1	10	41059	1336163245	/users/cn/jespinosa/phecomp/data/CRG/20120502_FDF_CRG/20120502_FDF_CRG/20120504_FDF_CRG_c12.mtb	361	NA	WWSS	water	1	41049	1336163235	1	0.04	0.004	4984	1
2	Food 1	Intake 3	584	42842	1336165028	/users/cn/jespinosa/phecomp/data/CRG/20120502_FDF_CRG/20120502_FDF_CRG/20120504_FDF_CRG_c12.mtb	531	238	WWSS	food_sc	3	42258	1336164444	1	0.14	0.00023972602739726	4985	1
2	Drink 1	Intake 1	31	43057	1336165243	/users/cn/jespinosa/phecomp/data/CRG/20120502_FDF_CRG/20120502_FDF_CRG/20120504_FDF_CRG_c12.mtb	362	NA	WWSS	water	1	43026	1336165212	1	0.06	0.00193548387096774	4986	1
2	Food 1	Intake 3	819	43899	1336166085	/users/cn/jespinosa/phecomp/data/CRG/20120502_FDF_CRG/20120502_FDF_CRG/20120504_FDF_CRG_c12.mtb	534	532	WWSS	food_sc	3	43080	1336165266	1	0.18	0.00021978021978022	4987	1
2	Drink 2	Intake 2	22	43917	1336166103	/users/cn/jespinosa/phecomp/data/CRG/20120502_FDF_CRG/20120502_FDF_CRG/20120504_FDF_CRG_c12.mtb	568	NA	WWSS	water	2	43895	1336166081	1	0.08	0.00363636363636364	4988	1
2	Drink 2	Intake 2	15	43991	1336166177	/users/cn/jespinosa/phecomp/data/CRG/20120502_FDF_CRG/20120502_FDF_CRG/20120504_FDF_CRG_c12.mtb	569	NA	WWSS	water	2	43976	1336166162	1	0.02	0.00133333333333333	4989	1
2	Food 1	Intake 3	709	45140	1336167326	/users/cn/jespinosa/phecomp/data/CRG/20120502_FDF_CRG/20120502_FDF_CRG/20120504_FDF_CRG_c12.mtb	539	562	WWSS	food_sc	3	44431	1336166617	1	0.18	0.000253878702397743	4990	1
2	Drink 1	Intake 1	22	45157	1336167343	/users/cn/jespinosa/phecomp/data/CRG/20120502_FDF_CRG/20120502_FDF_CRG/20120504_FDF_CRG_c12.mtb	363	NA	WWSS	water	1	45135	1336167321	1	0.06	0.00272727272727273	4991	1
2	Drink 2	Intake 2	17	45381	1336167567	/users/cn/jespinosa/phecomp/data/CRG/20120502_FDF_CRG/20120502_FDF_CRG/20120504_FDF_CRG_c12.mtb	571	NA	WWSS	water	2	45364	1336167550	1	0.04	0.00235294117647059	4992	1
2	Drink 2	Intake 2	21	45670	1336167856	/users/cn/jespinosa/phecomp/data/CRG/20120502_FDF_CRG/20120502_FDF_CRG/20120504_FDF_CRG_c12.mtb	572	NA	WWSS	water	2	45649	1336167835	1	0.02	0.000952380952380952	4993	1
2	Food 1	Intake 3	262	45964	1336168150	/users/cn/jespinosa/phecomp/data/CRG/20120502_FDF_CRG/20120502_FDF_CRG/20120504_FDF_CRG_c12.mtb	542	665	WWSS	food_sc	3	45702	1336167888	1	0.0599999999999999	0.000229007633587786	4994	1
2	Drink 2	Intake 2	27	45983	1336168169	/users/cn/jespinosa/phecomp/data/CRG/20120502_FDF_CRG/20120502_FDF_CRG/20120504_FDF_CRG_c12.mtb	573	NA	WWSS	water	2	45956	1336168142	1	0.04	0.00148148148148148	4995	1
2	Food 1	Intake 3	46	46675	1336168861	/users/cn/jespinosa/phecomp/data/CRG/20120502_FDF_CRG/20120502_FDF_CRG/20120504_FDF_CRG_c12.mtb	544	77	WWSS	food_sc	3	46629	1336168815	1	0.02	0.000434782608695652	4996	1
2	Drink 2	Intake 2	23	46721	1336168907	/users/cn/jespinosa/phecomp/data/CRG/20120502_FDF_CRG/20120502_FDF_CRG/20120504_FDF_CRG_c12.mtb	574	NA	WWSS	water	2	46698	1336168884	1	0.02	0.000869565217391304	4997	1
2	Drink 1	Intake 1	17	46718	1336168904	/users/cn/jespinosa/phecomp/data/CRG/20120502_FDF_CRG/20120502_FDF_CRG/20120504_FDF_CRG_c12.mtb	365	NA	WWSS	water	1	46701	1336168887	1	0.02	0.00117647058823529	4998	1
2	Food 1	Intake 3	243	46995	1336169181	/users/cn/jespinosa/phecomp/data/CRG/20120502_FDF_CRG/20120502_FDF_CRG/20120504_FDF_CRG_c12.mtb	545	86	WWSS	food_sc	3	46752	1336168938	1	0.04	0.000164609053497942	4999	1
2	Drink 2	Intake 2	13	47038	1336169224	/users/cn/jespinosa/phecomp/data/CRG/20120502_FDF_CRG/20120502_FDF_CRG/20120504_FDF_CRG_c12.mtb	575	NA	WWSS	water	2	47025	1336169211	1	0.0399999999999999	0.00307692307692307	5000	1
2	Food 1	Intake 3	73	47154	1336169340	/users/cn/jespinosa/phecomp/data/CRG/20120502_FDF_CRG/20120502_FDF_CRG/20120504_FDF_CRG_c12.mtb	546	1060	WWSS	food_sc	3	47081	1336169267	1	0.02	0.000273972602739726	5001	1
2	Drink 2	Intake 2	15	47183	1336169369	/users/cn/jespinosa/phecomp/data/CRG/20120502_FDF_CRG/20120502_FDF_CRG/20120504_FDF_CRG_c12.mtb	576	NA	WWSS	water	2	47168	1336169354	1	0.02	0.00133333333333333	5002	1
2	Drink 1	Intake 1	16	47562	1336169748	/users/cn/jespinosa/phecomp/data/CRG/20120502_FDF_CRG/20120502_FDF_CRG/20120504_FDF_CRG_c12.mtb	366	NA	WWSS	water	1	47546	1336169732	1	0.06	0.00375	5003	1
2	Food 1	Intake 3	269	48483	1336170669	/users/cn/jespinosa/phecomp/data/CRG/20120502_FDF_CRG/20120502_FDF_CRG/20120504_FDF_CRG_c12.mtb	550	3495	WWSS	food_sc	3	48214	1336170400	1	0.0399999999999999	0.000148698884758364	5004	1
2	Drink 2	Intake 2	19	48699	1336170885	/users/cn/jespinosa/phecomp/data/CRG/20120502_FDF_CRG/20120502_FDF_CRG/20120504_FDF_CRG_c12.mtb	579	NA	WWSS	water	2	48680	1336170866	1	0.02	0.00105263157894737	5005	1
2	Food 1	Intake 3	593	52571	1336174757	/users/cn/jespinosa/phecomp/data/CRG/20120502_FDF_CRG/20120502_FDF_CRG/20120504_FDF_CRG_c12.mtb	553	279	WWSS	food_sc	3	51978	1336174164	1	0.1	0.000168634064080944	5006	1
2	Drink 1	Intake 1	16	52845	1336175031	/users/cn/jespinosa/phecomp/data/CRG/20120502_FDF_CRG/20120502_FDF_CRG/20120504_FDF_CRG_c12.mtb	369	NA	WWSS	water	1	52829	1336175015	1	0.02	0.00125	5007	1
2	Food 1	Intake 3	306	53156	1336175342	/users/cn/jespinosa/phecomp/data/CRG/20120502_FDF_CRG/20120502_FDF_CRG/20120504_FDF_CRG_c12.mtb	555	38	WWSS	food_sc	3	52850	1336175036	1	0.04	0.000130718954248366	5008	1
2	Drink 2	Intake 2	26	53175	1336175361	/users/cn/jespinosa/phecomp/data/CRG/20120502_FDF_CRG/20120502_FDF_CRG/20120504_FDF_CRG_c12.mtb	580	NA	WWSS	water	2	53149	1336175335	1	0.0599999999999999	0.0023076923076923	5009	1
2	Food 1	Intake 3	760	53954	1336176140	/users/cn/jespinosa/phecomp/data/CRG/20120502_FDF_CRG/20120502_FDF_CRG/20120504_FDF_CRG_c12.mtb	556	688	WWSS	food_sc	3	53194	1336175380	1	0.28	0.000368421052631579	5010	1
2	Drink 2	Intake 2	39	54011	1336176197	/users/cn/jespinosa/phecomp/data/CRG/20120502_FDF_CRG/20120502_FDF_CRG/20120504_FDF_CRG_c12.mtb	581	NA	WWSS	water	2	53972	1336176158	1	0.0800000000000001	0.00205128205128205	5011	1
2	Drink 1	Intake 1	23	54072	1336176258	/users/cn/jespinosa/phecomp/data/CRG/20120502_FDF_CRG/20120502_FDF_CRG/20120504_FDF_CRG_c12.mtb	370	NA	WWSS	water	1	54049	1336176235	1	0.08	0.00347826086956522	5012	1
2	Drink 1	Intake 1	23	54259	1336176445	/users/cn/jespinosa/phecomp/data/CRG/20120502_FDF_CRG/20120502_FDF_CRG/20120504_FDF_CRG_c12.mtb	371	NA	WWSS	water	1	54236	1336176422	1	0.0399999999999999	0.0017391304347826	5013	1
2	Drink 2	Intake 2	16	54270	1336176456	/users/cn/jespinosa/phecomp/data/CRG/20120502_FDF_CRG/20120502_FDF_CRG/20120504_FDF_CRG_c12.mtb	582	NA	WWSS	water	2	54254	1336176440	1	0.02	0.00125	5014	1
2	Food 1	Intake 3	176	54818	1336177004	/users/cn/jespinosa/phecomp/data/CRG/20120502_FDF_CRG/20120502_FDF_CRG/20120504_FDF_CRG_c12.mtb	558	1310	WWSS	food_sc	3	54642	1336176828	1	0.04	0.000227272727272727	5015	1
2	Drink 1	Intake 1	16	54905	1336177091	/users/cn/jespinosa/phecomp/data/CRG/20120502_FDF_CRG/20120502_FDF_CRG/20120504_FDF_CRG_c12.mtb	372	NA	WWSS	water	1	54889	1336177075	1	0.02	0.00125	5016	1
2	Drink 2	Intake 2	9	55356	1336177542	/users/cn/jespinosa/phecomp/data/CRG/20120502_FDF_CRG/20120502_FDF_CRG/20120504_FDF_CRG_c12.mtb	586	NA	WWSS	water	2	55347	1336177533	1	0.02	0.00222222222222222	5017	1
2	Drink 2	Intake 2	16	55676	1336177862	/users/cn/jespinosa/phecomp/data/CRG/20120502_FDF_CRG/20120502_FDF_CRG/20120504_FDF_CRG_c12.mtb	587	NA	WWSS	water	2	55660	1336177846	1	0.02	0.00125	5018	1
2	Food 1	Intake 3	131	56259	1336178445	/users/cn/jespinosa/phecomp/data/CRG/20120502_FDF_CRG/20120502_FDF_CRG/20120504_FDF_CRG_c12.mtb	561	83	WWSS	food_sc	3	56128	1336178314	1	0.1	0.000763358778625954	5019	1
2	Food 1	Intake 3	219	56561	1336178747	/users/cn/jespinosa/phecomp/data/CRG/20120502_FDF_CRG/20120502_FDF_CRG/20120504_FDF_CRG_c12.mtb	562	6406	WWSS	food_sc	3	56342	1336178528	1	0.0800000000000001	0.000365296803652968	5020	1
2	Drink 2	Intake 2	15	56601	1336178787	/users/cn/jespinosa/phecomp/data/CRG/20120502_FDF_CRG/20120502_FDF_CRG/20120504_FDF_CRG_c12.mtb	588	NA	WWSS	water	2	56586	1336178772	1	0.04	0.00266666666666667	5021	1
2	Drink 2	Intake 2	18	57058	1336179244	/users/cn/jespinosa/phecomp/data/CRG/20120502_FDF_CRG/20120502_FDF_CRG/20120504_FDF_CRG_c12.mtb	589	NA	WWSS	water	2	57040	1336179226	1	0.0399999999999999	0.00222222222222222	5022	1
2	Drink 2	Intake 2	19	57290	1336179476	/users/cn/jespinosa/phecomp/data/CRG/20120502_FDF_CRG/20120502_FDF_CRG/20120504_FDF_CRG_c12.mtb	590	NA	WWSS	water	2	57271	1336179457	1	0.04	0.00210526315789474	5023	1
2	Food 1	Intake 3	390	63357	1336185543	/users/cn/jespinosa/phecomp/data/CRG/20120502_FDF_CRG/20120502_FDF_CRG/20120504_FDF_CRG_c12.mtb	563	12806	WWSS	food_sc	3	62967	1336185153	1	0.48	0.00123076923076923	5024	1
2	Drink 1	Intake 1	17	63813	1336185999	/users/cn/jespinosa/phecomp/data/CRG/20120502_FDF_CRG/20120502_FDF_CRG/20120504_FDF_CRG_c12.mtb	373	NA	WWSS	water	1	63796	1336185982	1	0.04	0.00235294117647059	5025	1
2	Drink 1	Intake 1	17	63839	1336186025	/users/cn/jespinosa/phecomp/data/CRG/20120502_FDF_CRG/20120502_FDF_CRG/20120504_FDF_CRG_c12.mtb	374	NA	WWSS	water	1	63822	1336186008	1	0.02	0.00117647058823529	5026	1
2	Drink 2	Intake 2	33	63923	1336186109	/users/cn/jespinosa/phecomp/data/CRG/20120502_FDF_CRG/20120502_FDF_CRG/20120504_FDF_CRG_c12.mtb	593	NA	WWSS	water	2	63890	1336186076	1	0.02	0.000606060606060606	5027	1
2	Drink 1	Intake 1	43	63963	1336186149	/users/cn/jespinosa/phecomp/data/CRG/20120502_FDF_CRG/20120502_FDF_CRG/20120504_FDF_CRG_c12.mtb	375	NA	WWSS	water	1	63920	1336186106	1	0.0399999999999999	0.000930232558139532	5028	1
2	Drink 1	Intake 1	28	64053	1336186239	/users/cn/jespinosa/phecomp/data/CRG/20120502_FDF_CRG/20120502_FDF_CRG/20120504_FDF_CRG_c12.mtb	376	NA	WWSS	water	1	64025	1336186211	1	0.04	0.00142857142857143	5029	1
2	Drink 2	Intake 2	27	64802	1336186988	/users/cn/jespinosa/phecomp/data/CRG/20120502_FDF_CRG/20120502_FDF_CRG/20120504_FDF_CRG_c12.mtb	595	NA	WWSS	water	2	64775	1336186961	1	0.0600000000000001	0.00222222222222223	5030	1
2	Drink 1	Intake 1	16	65239	1336187425	/users/cn/jespinosa/phecomp/data/CRG/20120502_FDF_CRG/20120502_FDF_CRG/20120504_FDF_CRG_c12.mtb	377	NA	WWSS	water	1	65223	1336187409	1	0.08	0.005	5031	1
2	Drink 2	Intake 2	21	65428	1336187614	/users/cn/jespinosa/phecomp/data/CRG/20120502_FDF_CRG/20120502_FDF_CRG/20120504_FDF_CRG_c12.mtb	597	NA	WWSS	water	2	65407	1336187593	1	0.04	0.0019047619047619	5032	1
2	Drink 1	Intake 1	27	66253	1336188439	/users/cn/jespinosa/phecomp/data/CRG/20120502_FDF_CRG/20120502_FDF_CRG/20120504_FDF_CRG_c12.mtb	378	NA	WWSS	water	1	66226	1336188412	1	0.04	0.00148148148148148	5033	1
2	Drink 1	Intake 1	16	72146	1336194332	/users/cn/jespinosa/phecomp/data/CRG/20120502_FDF_CRG/20120502_FDF_CRG/20120504_FDF_CRG_c12.mtb	379	NA	WWSS	water	1	72130	1336194316	1	0.04	0.0025	5034	1
2	Drink 1	Intake 1	17	72472	1336194658	/users/cn/jespinosa/phecomp/data/CRG/20120502_FDF_CRG/20120502_FDF_CRG/20120504_FDF_CRG_c12.mtb	381	NA	WWSS	water	1	72455	1336194641	1	0.02	0.00117647058823529	5035	1
2	Drink 2	Intake 2	17	72577	1336194763	/users/cn/jespinosa/phecomp/data/CRG/20120502_FDF_CRG/20120502_FDF_CRG/20120504_FDF_CRG_c12.mtb	606	NA	WWSS	water	2	72560	1336194746	1	0.02	0.00117647058823529	5036	1
2	Food 1	Intake 3	89	76252	1336198438	/users/cn/jespinosa/phecomp/data/CRG/20120502_FDF_CRG/20120502_FDF_CRG/20120504_FDF_CRG_c12.mtb	575	8	WWSS	food_sc	3	76163	1336198349	1	0.02	0.000224719101123596	5037	1
2	Food 1	Intake 3	224	76484	1336198670	/users/cn/jespinosa/phecomp/data/CRG/20120502_FDF_CRG/20120502_FDF_CRG/20120504_FDF_CRG_c12.mtb	576	5242	WWSS	food_sc	3	76260	1336198446	1	0.04	0.000178571428571429	5038	1
2	Drink 2	Intake 2	15	80959	1336203145	/users/cn/jespinosa/phecomp/data/CRG/20120502_FDF_CRG/20120502_FDF_CRG/20120504_FDF_CRG_c12.mtb	611	NA	WWSS	water	2	80944	1336203130	1	0.02	0.00133333333333333	5039	1
2	Food 1	Intake 3	636	82362	1336204548	/users/cn/jespinosa/phecomp/data/CRG/20120502_FDF_CRG/20120502_FDF_CRG/20120504_FDF_CRG_c12.mtb	579	6350	WWSS	food_sc	3	81726	1336203912	1	0.0600000000000001	9.43396226415096e-05	5040	1
2	Drink 1	Intake 1	21	82416	1336204602	/users/cn/jespinosa/phecomp/data/CRG/20120502_FDF_CRG/20120502_FDF_CRG/20120504_FDF_CRG_c12.mtb	384	NA	WWSS	water	1	82395	1336204581	1	0.0399999999999999	0.0019047619047619	5041	1
2	Drink 1	Intake 1	14	82582	1336204768	/users/cn/jespinosa/phecomp/data/CRG/20120502_FDF_CRG/20120502_FDF_CRG/20120504_FDF_CRG_c12.mtb	385	NA	WWSS	water	1	82568	1336204754	1	0.04	0.00285714285714286	5042	1
2	Food 2	Intake 4	47	88759	1336210945	/users/cn/jespinosa/phecomp/data/CRG/20120502_FDF_CRG/20120502_FDF_CRG/20120504_FDF_CRG_c12.mtb	1034	433	WWSS	food_sc	4	88712	1336210898	1	0.02	0.000425531914893617	5043	1
2	Food 1	Intake 3	330	89522	1336211708	/users/cn/jespinosa/phecomp/data/CRG/20120502_FDF_CRG/20120502_FDF_CRG/20120504_FDF_CRG_c12.mtb	582	11052	WWSS	food_sc	3	89192	1336211378	1	0.02	6.06060606060606e-05	5044	1
2	Drink 1	Intake 1	16	89726	1336211912	/users/cn/jespinosa/phecomp/data/CRG/20120502_FDF_CRG/20120502_FDF_CRG/20120504_FDF_CRG_c12.mtb	386	NA	WWSS	water	1	89710	1336211896	1	0.04	0.0025	5045	1
2	Food 2	Intake 4	72	100646	1336222832	/users/cn/jespinosa/phecomp/data/CRG/20120502_FDF_CRG/20120502_FDF_CRG/20120504_FDF_CRG_c12.mtb	1040	12612	WWSS	food_sc	4	100574	1336222760	1	0.02	0.000277777777777778	5046	1
2	Food 2	Intake 4	247	113505	1336235691	/users/cn/jespinosa/phecomp/data/CRG/20120502_FDF_CRG/20120502_FDF_CRG/20120504_FDF_CRG_c12.mtb	1044	149	WWSS	food_sc	4	113258	1336235444	1	0.02	8.09716599190283e-05	5047	1
2	Food 2	Intake 4	501	114155	1336236341	/users/cn/jespinosa/phecomp/data/CRG/20120502_FDF_CRG/20120502_FDF_CRG/20120504_FDF_CRG_c12.mtb	1046	5206	WWSS	food_sc	4	113654	1336235840	1	0.0399999999999999	7.98403193612772e-05	5048	1
2	Food 1	Intake 3	800	120161	1336242347	/users/cn/jespinosa/phecomp/data/CRG/20120502_FDF_CRG/20120502_FDF_CRG/20120504_FDF_CRG_c12.mtb	592	817	WWSS	food_sc	3	119361	1336241547	1	0.0600000000000001	7.50000000000001e-05	5049	1
2	Food 1	Intake 3	123	121101	1336243287	/users/cn/jespinosa/phecomp/data/CRG/20120502_FDF_CRG/20120502_FDF_CRG/20120504_FDF_CRG_c12.mtb	594	COLL	WWSS	food_sc	3	120978	1336243164	1	0.02	0.00016260162601626	5050	1
2	Food 2	Intake 4	462	121556	1336243742	/users/cn/jespinosa/phecomp/data/CRG/20120502_FDF_CRG/20120502_FDF_CRG/20120504_FDF_CRG_c12.mtb	1053	341	WWSS	food_sc	4	121094	1336243280	1	0.0800000000000001	0.000173160173160173	5051	1
2	Drink 2	Intake 2	35	121625	1336243811	/users/cn/jespinosa/phecomp/data/CRG/20120502_FDF_CRG/20120502_FDF_CRG/20120504_FDF_CRG_c12.mtb	620	NA	WWSS	water	2	121590	1336243776	1	0.04	0.00114285714285714	5052	1
2	Drink 2	Intake 2	22	121847	1336244033	/users/cn/jespinosa/phecomp/data/CRG/20120502_FDF_CRG/20120502_FDF_CRG/20120504_FDF_CRG_c12.mtb	621	NA	WWSS	water	2	121825	1336244011	1	0.02	0.000909090909090909	5053	1
2	Drink 1	Intake 1	16	121859	1336244045	/users/cn/jespinosa/phecomp/data/CRG/20120502_FDF_CRG/20120502_FDF_CRG/20120504_FDF_CRG_c12.mtb	390	NA	WWSS	water	1	121843	1336244029	1	0.02	0.00125	5054	1
2	Food 2	Intake 4	445	122342	1336244528	/users/cn/jespinosa/phecomp/data/CRG/20120502_FDF_CRG/20120502_FDF_CRG/20120504_FDF_CRG_c12.mtb	1056	330	WWSS	food_sc	4	121897	1336244083	1	0.0399999999999999	8.9887640449438e-05	5055	1
2	Drink 2	Intake 2	37	122371	1336244557	/users/cn/jespinosa/phecomp/data/CRG/20120502_FDF_CRG/20120502_FDF_CRG/20120504_FDF_CRG_c12.mtb	622	NA	WWSS	water	2	122334	1336244520	1	0.1	0.0027027027027027	5056	1
2	Drink 2	Intake 2	20	122644	1336244830	/users/cn/jespinosa/phecomp/data/CRG/20120502_FDF_CRG/20120502_FDF_CRG/20120504_FDF_CRG_c12.mtb	623	NA	WWSS	water	2	122624	1336244810	1	0.02	0.001	5057	1
2	Food 2	Intake 4	317	122989	1336245175	/users/cn/jespinosa/phecomp/data/CRG/20120502_FDF_CRG/20120502_FDF_CRG/20120504_FDF_CRG_c12.mtb	1057	936	WWSS	food_sc	4	122672	1336244858	1	0.02	6.30914826498423e-05	5058	1
2	Drink 2	Intake 2	22	123144	1336245330	/users/cn/jespinosa/phecomp/data/CRG/20120502_FDF_CRG/20120502_FDF_CRG/20120504_FDF_CRG_c12.mtb	624	NA	WWSS	water	2	123122	1336245308	1	0.0399999999999998	0.00181818181818181	5059	1
2	Food 2	Intake 4	465	124390	1336246576	/users/cn/jespinosa/phecomp/data/CRG/20120502_FDF_CRG/20120502_FDF_CRG/20120504_FDF_CRG_c12.mtb	1060	123	WWSS	food_sc	4	123925	1336246111	1	0.0600000000000001	0.000129032258064516	5060	1
2	Drink 2	Intake 2	20	124446	1336246632	/users/cn/jespinosa/phecomp/data/CRG/20120502_FDF_CRG/20120502_FDF_CRG/20120504_FDF_CRG_c12.mtb	625	NA	WWSS	water	2	124426	1336246612	1	0.02	0.001	5061	1
2	Food 2	Intake 4	326	124839	1336247025	/users/cn/jespinosa/phecomp/data/CRG/20120502_FDF_CRG/20120502_FDF_CRG/20120504_FDF_CRG_c12.mtb	1061	28	WWSS	food_sc	4	124513	1336246699	1	0.0399999999999999	0.000122699386503067	5062	1
2	Drink 2	Intake 2	16	124854	1336247040	/users/cn/jespinosa/phecomp/data/CRG/20120502_FDF_CRG/20120502_FDF_CRG/20120504_FDF_CRG_c12.mtb	626	NA	WWSS	water	2	124838	1336247024	1	0.02	0.00125	5063	1
2	Food 2	Intake 4	854	125721	1336247907	/users/cn/jespinosa/phecomp/data/CRG/20120502_FDF_CRG/20120502_FDF_CRG/20120504_FDF_CRG_c12.mtb	1062	83	WWSS	food_sc	4	124867	1336247053	1	0.18	0.000210772833723653	5064	1
2	Drink 2	Intake 2	36	125755	1336247941	/users/cn/jespinosa/phecomp/data/CRG/20120502_FDF_CRG/20120502_FDF_CRG/20120504_FDF_CRG_c12.mtb	627	NA	WWSS	water	2	125719	1336247905	1	0.12	0.00333333333333333	5065	1
2	Drink 1	Intake 1	21	125787	1336247973	/users/cn/jespinosa/phecomp/data/CRG/20120502_FDF_CRG/20120502_FDF_CRG/20120504_FDF_CRG_c12.mtb	392	NA	WWSS	water	1	125766	1336247952	1	0.04	0.0019047619047619	5066	1
2	Food 2	Intake 4	442	126246	1336248432	/users/cn/jespinosa/phecomp/data/CRG/20120502_FDF_CRG/20120502_FDF_CRG/20120504_FDF_CRG_c12.mtb	1063	147	WWSS	food_sc	4	125804	1336247990	1	0.0999999999999999	0.000226244343891402	5067	1
2	Drink 2	Intake 2	41	126277	1336248463	/users/cn/jespinosa/phecomp/data/CRG/20120502_FDF_CRG/20120502_FDF_CRG/20120504_FDF_CRG_c12.mtb	628	NA	WWSS	water	2	126236	1336248422	1	0.1	0.0024390243902439	5068	1
2	Food 2	Intake 4	284	126677	1336248863	/users/cn/jespinosa/phecomp/data/CRG/20120502_FDF_CRG/20120502_FDF_CRG/20120504_FDF_CRG_c12.mtb	1065	1771	WWSS	food_sc	4	126393	1336248579	1	0.04	0.000140845070422535	5069	1
2	Drink 2	Intake 2	26	126702	1336248888	/users/cn/jespinosa/phecomp/data/CRG/20120502_FDF_CRG/20120502_FDF_CRG/20120504_FDF_CRG_c12.mtb	629	NA	WWSS	water	2	126676	1336248862	1	0.0799999999999998	0.00307692307692307	5070	1
2	Food 2	Intake 4	661	129109	1336251295	/users/cn/jespinosa/phecomp/data/CRG/20120502_FDF_CRG/20120502_FDF_CRG/20120504_FDF_CRG_c12.mtb	1068	1919	WWSS	food_sc	4	128448	1336250634	1	0.2	0.000302571860816944	5071	1
2	Drink 2	Intake 2	38	129145	1336251331	/users/cn/jespinosa/phecomp/data/CRG/20120502_FDF_CRG/20120502_FDF_CRG/20120504_FDF_CRG_c12.mtb	631	NA	WWSS	water	2	129107	1336251293	1	0.0999999999999999	0.00263157894736842	5072	1
2	Drink 1	Intake 1	19	129486	1336251672	/users/cn/jespinosa/phecomp/data/CRG/20120502_FDF_CRG/20120502_FDF_CRG/20120504_FDF_CRG_c12.mtb	393	NA	WWSS	water	1	129467	1336251653	1	0.04	0.00210526315789474	5073	1
2	Drink 2	Intake 2	12	130175	1336252361	/users/cn/jespinosa/phecomp/data/CRG/20120502_FDF_CRG/20120502_FDF_CRG/20120504_FDF_CRG_c12.mtb	636	NA	WWSS	water	2	130163	1336252349	1	0.04	0.00333333333333333	5074	1
2	Food 2	Intake 4	482	131510	1336253696	/users/cn/jespinosa/phecomp/data/CRG/20120502_FDF_CRG/20120502_FDF_CRG/20120504_FDF_CRG_c12.mtb	1074	606	WWSS	food_sc	4	131028	1336253214	1	0.02	4.149377593361e-05	5075	1
2	Food 2	Intake 4	167	132283	1336254469	/users/cn/jespinosa/phecomp/data/CRG/20120502_FDF_CRG/20120502_FDF_CRG/20120504_FDF_CRG_c12.mtb	1080	526	WWSS	food_sc	4	132116	1336254302	1	0.02	0.000119760479041916	5076	1
2	Drink 2	Intake 2	20	132306	1336254492	/users/cn/jespinosa/phecomp/data/CRG/20120502_FDF_CRG/20120502_FDF_CRG/20120504_FDF_CRG_c12.mtb	637	NA	WWSS	water	2	132286	1336254472	1	0.02	0.001	5077	1
2	Food 2	Intake 4	677	133486	1336255672	/users/cn/jespinosa/phecomp/data/CRG/20120502_FDF_CRG/20120502_FDF_CRG/20120504_FDF_CRG_c12.mtb	1082	135	WWSS	food_sc	4	132809	1336254995	1	0.0800000000000001	0.000118168389955687	5078	1
2	Drink 2	Intake 2	21	133503	1336255689	/users/cn/jespinosa/phecomp/data/CRG/20120502_FDF_CRG/20120502_FDF_CRG/20120504_FDF_CRG_c12.mtb	638	NA	WWSS	water	2	133482	1336255668	1	0.0800000000000001	0.00380952380952381	5079	1
2	Drink 2	Intake 2	15	133563	1336255749	/users/cn/jespinosa/phecomp/data/CRG/20120502_FDF_CRG/20120502_FDF_CRG/20120504_FDF_CRG_c12.mtb	639	NA	WWSS	water	2	133548	1336255734	1	0.04	0.00266666666666667	5080	1
2	Food 2	Intake 4	733	134354	1336256540	/users/cn/jespinosa/phecomp/data/CRG/20120502_FDF_CRG/20120502_FDF_CRG/20120504_FDF_CRG_c12.mtb	1084	31	WWSS	food_sc	4	133621	1336255807	1	0.0999999999999999	0.000136425648021828	5081	1
2	Drink 2	Intake 2	36	134380	1336256566	/users/cn/jespinosa/phecomp/data/CRG/20120502_FDF_CRG/20120502_FDF_CRG/20120504_FDF_CRG_c12.mtb	640	NA	WWSS	water	2	134344	1336256530	1	0.1	0.00277777777777778	5082	1
2	Food 2	Intake 4	39	134424	1336256610	/users/cn/jespinosa/phecomp/data/CRG/20120502_FDF_CRG/20120502_FDF_CRG/20120504_FDF_CRG_c12.mtb	1085	751	WWSS	food_sc	4	134385	1336256571	1	0.02	0.000512820512820513	5083	1
2	Drink 2	Intake 2	24	134458	1336256644	/users/cn/jespinosa/phecomp/data/CRG/20120502_FDF_CRG/20120502_FDF_CRG/20120504_FDF_CRG_c12.mtb	641	NA	WWSS	water	2	134434	1336256620	1	0.0600000000000001	0.0025	5084	1
2	Drink 2	Intake 2	17	135043	1336257229	/users/cn/jespinosa/phecomp/data/CRG/20120502_FDF_CRG/20120502_FDF_CRG/20120504_FDF_CRG_c12.mtb	642	NA	WWSS	water	2	135026	1336257212	1	0.04	0.00235294117647059	5085	1
2	Food 2	Intake 4	369	135544	1336257730	/users/cn/jespinosa/phecomp/data/CRG/20120502_FDF_CRG/20120502_FDF_CRG/20120504_FDF_CRG_c12.mtb	1087	101	WWSS	food_sc	4	135175	1336257361	1	0.04	0.00010840108401084	5086	1
2	Drink 2	Intake 2	22	135571	1336257757	/users/cn/jespinosa/phecomp/data/CRG/20120502_FDF_CRG/20120502_FDF_CRG/20120504_FDF_CRG_c12.mtb	643	NA	WWSS	water	2	135549	1336257735	1	0.02	0.000909090909090909	5087	1
2	Food 2	Intake 4	197	135842	1336258028	/users/cn/jespinosa/phecomp/data/CRG/20120502_FDF_CRG/20120502_FDF_CRG/20120504_FDF_CRG_c12.mtb	1089	3050	WWSS	food_sc	4	135645	1336257831	1	0.02	0.000101522842639594	5088	1
2	Food 2	Intake 4	1672	140564	1336262750	/users/cn/jespinosa/phecomp/data/CRG/20120502_FDF_CRG/20120502_FDF_CRG/20120504_FDF_CRG_c12.mtb	1094	442	WWSS	food_sc	4	138892	1336261078	1	0.44	0.000263157894736842	5089	1
2	Drink 2	Intake 2	41	140653	1336262839	/users/cn/jespinosa/phecomp/data/CRG/20120502_FDF_CRG/20120502_FDF_CRG/20120504_FDF_CRG_c12.mtb	644	NA	WWSS	water	2	140612	1336262798	1	0.14	0.00341463414634146	5090	1
2	Drink 2	Intake 2	29	140909	1336263095	/users/cn/jespinosa/phecomp/data/CRG/20120502_FDF_CRG/20120502_FDF_CRG/20120504_FDF_CRG_c12.mtb	645	NA	WWSS	water	2	140880	1336263066	1	0.0600000000000001	0.00206896551724138	5091	1
2	Food 2	Intake 4	313	141319	1336263505	/users/cn/jespinosa/phecomp/data/CRG/20120502_FDF_CRG/20120502_FDF_CRG/20120504_FDF_CRG_c12.mtb	1097	5	WWSS	food_sc	4	141006	1336263192	1	0.2	0.000638977635782748	5092	1
2	Food 2	Intake 4	32	141356	1336263542	/users/cn/jespinosa/phecomp/data/CRG/20120502_FDF_CRG/20120502_FDF_CRG/20120504_FDF_CRG_c12.mtb	1098	11531	WWSS	food_sc	4	141324	1336263510	1	0.3	0.009375	5093	1
2	Drink 1	Intake 1	20	141535	1336263721	/users/cn/jespinosa/phecomp/data/CRG/20120502_FDF_CRG/20120502_FDF_CRG/20120504_FDF_CRG_c12.mtb	395	NA	WWSS	water	1	141515	1336263701	1	0.12	0.006	5094	1
2	Drink 2	Intake 2	36	141586	1336263772	/users/cn/jespinosa/phecomp/data/CRG/20120502_FDF_CRG/20120502_FDF_CRG/20120504_FDF_CRG_c12.mtb	646	NA	WWSS	water	2	141550	1336263736	1	0.0600000000000001	0.00166666666666667	5095	1
2	Drink 2	Intake 2	20	141612	1336263798	/users/cn/jespinosa/phecomp/data/CRG/20120502_FDF_CRG/20120502_FDF_CRG/20120504_FDF_CRG_c12.mtb	647	NA	WWSS	water	2	141592	1336263778	1	0.02	0.001	5096	1
2	Drink 2	Intake 2	23	141837	1336264023	/users/cn/jespinosa/phecomp/data/CRG/20120502_FDF_CRG/20120502_FDF_CRG/20120504_FDF_CRG_c12.mtb	648	NA	WWSS	water	2	141814	1336264000	1	0.02	0.000869565217391304	5097	1
2	Drink 2	Intake 2	18	141929	1336264115	/users/cn/jespinosa/phecomp/data/CRG/20120502_FDF_CRG/20120502_FDF_CRG/20120504_FDF_CRG_c12.mtb	650	NA	WWSS	water	2	141911	1336264097	1	0.04	0.00222222222222222	5098	1
2	Drink 2	Intake 2	17	142150	1336264336	/users/cn/jespinosa/phecomp/data/CRG/20120502_FDF_CRG/20120502_FDF_CRG/20120504_FDF_CRG_c12.mtb	652	NA	WWSS	water	2	142133	1336264319	1	0.04	0.00235294117647059	5099	1
2	Drink 2	Intake 2	60	142542	1336264728	/users/cn/jespinosa/phecomp/data/CRG/20120502_FDF_CRG/20120502_FDF_CRG/20120504_FDF_CRG_c12.mtb	653	NA	WWSS	water	2	142482	1336264668	1	0.0600000000000001	0.001	5100	1
2	Drink 2	Intake 2	30	142898	1336265084	/users/cn/jespinosa/phecomp/data/CRG/20120502_FDF_CRG/20120502_FDF_CRG/20120504_FDF_CRG_c12.mtb	656	NA	WWSS	water	2	142868	1336265054	1	0.0599999999999996	0.00199999999999999	5101	1
2	Drink 2	Intake 2	20	143279	1336265465	/users/cn/jespinosa/phecomp/data/CRG/20120502_FDF_CRG/20120502_FDF_CRG/20120504_FDF_CRG_c12.mtb	657	NA	WWSS	water	2	143259	1336265445	1	0.04	0.002	5102	1
2	Drink 1	Intake 1	9	143768	1336265954	/users/cn/jespinosa/phecomp/data/CRG/20120502_FDF_CRG/20120502_FDF_CRG/20120504_FDF_CRG_c12.mtb	397	NA	WWSS	water	1	143759	1336265945	1	0.04	0.00444444444444444	5103	1
2	Drink 2	Intake 2	65	144079	1336266265	/users/cn/jespinosa/phecomp/data/CRG/20120502_FDF_CRG/20120502_FDF_CRG/20120504_FDF_CRG_c12.mtb	660	NA	WWSS	water	2	144014	1336266200	1	0.0200000000000005	0.000307692307692315	5104	1
2	Food 2	Intake 4	69	152956	1336275142	/users/cn/jespinosa/phecomp/data/CRG/20120502_FDF_CRG/20120502_FDF_CRG/20120504_FDF_CRG_c12.mtb	1106	4164	WWSS	food_sc	4	152887	1336275073	1	0.0200000000000005	0.000289855072463775	5105	1
2	Drink 1	Intake 1	12	154447	1336276633	/users/cn/jespinosa/phecomp/data/CRG/20120502_FDF_CRG/20120502_FDF_CRG/20120504_FDF_CRG_c12.mtb	400	NA	WWSS	water	1	154435	1336276621	1	0.04	0.00333333333333333	5106	1
2	Drink 2	Intake 2	30	157115	1336279301	/users/cn/jespinosa/phecomp/data/CRG/20120502_FDF_CRG/20120502_FDF_CRG/20120504_FDF_CRG_c12.mtb	672	NA	WWSS	water	2	157085	1336279271	1	0.0399999999999996	0.00133333333333332	5107	1
2	Food 2	Intake 4	440	157560	1336279746	/users/cn/jespinosa/phecomp/data/CRG/20120502_FDF_CRG/20120502_FDF_CRG/20120504_FDF_CRG_c12.mtb	1126	33	WWSS	food_sc	4	157120	1336279306	1	0.04	9.09090909090909e-05	5108	1
2	Food 2	Intake 4	963	158556	1336280742	/users/cn/jespinosa/phecomp/data/CRG/20120502_FDF_CRG/20120502_FDF_CRG/20120504_FDF_CRG_c12.mtb	1127	72	WWSS	food_sc	4	157593	1336279779	1	0.16	0.000166147455867082	5109	1
2	Drink 2	Intake 2	34	158594	1336280780	/users/cn/jespinosa/phecomp/data/CRG/20120502_FDF_CRG/20120502_FDF_CRG/20120504_FDF_CRG_c12.mtb	674	NA	WWSS	water	2	158560	1336280746	1	0.12	0.00352941176470588	5110	1
2	Food 2	Intake 4	282	158910	1336281096	/users/cn/jespinosa/phecomp/data/CRG/20120502_FDF_CRG/20120502_FDF_CRG/20120504_FDF_CRG_c12.mtb	1128	297	WWSS	food_sc	4	158628	1336280814	1	0.04	0.000141843971631206	5111	1
2	Drink 2	Intake 2	38	158942	1336281128	/users/cn/jespinosa/phecomp/data/CRG/20120502_FDF_CRG/20120502_FDF_CRG/20120504_FDF_CRG_c12.mtb	675	NA	WWSS	water	2	158904	1336281090	1	0.1	0.00263157894736842	5112	1
2	Food 2	Intake 4	461	159668	1336281854	/users/cn/jespinosa/phecomp/data/CRG/20120502_FDF_CRG/20120502_FDF_CRG/20120504_FDF_CRG_c12.mtb	1130	66	WWSS	food_sc	4	159207	1336281393	1	0.1	0.000216919739696312	5113	1
2	Drink 2	Intake 2	27	159700	1336281886	/users/cn/jespinosa/phecomp/data/CRG/20120502_FDF_CRG/20120502_FDF_CRG/20120504_FDF_CRG_c12.mtb	676	NA	WWSS	water	2	159673	1336281859	1	0.0600000000000001	0.00222222222222223	5114	1
2	Food 2	Intake 4	282	160016	1336282202	/users/cn/jespinosa/phecomp/data/CRG/20120502_FDF_CRG/20120502_FDF_CRG/20120504_FDF_CRG_c12.mtb	1131	78	WWSS	food_sc	4	159734	1336281920	1	0.04	0.000141843971631206	5115	1
2	Drink 2	Intake 2	17	160033	1336282219	/users/cn/jespinosa/phecomp/data/CRG/20120502_FDF_CRG/20120502_FDF_CRG/20120504_FDF_CRG_c12.mtb	677	NA	WWSS	water	2	160016	1336282202	1	0.0800000000000001	0.00470588235294118	5116	1
2	Food 2	Intake 4	326	160420	1336282606	/users/cn/jespinosa/phecomp/data/CRG/20120502_FDF_CRG/20120502_FDF_CRG/20120504_FDF_CRG_c12.mtb	1132	36	WWSS	food_sc	4	160094	1336282280	1	0.0800000000000001	0.000245398773006135	5117	1
2	Drink 2	Intake 2	12	160458	1336282644	/users/cn/jespinosa/phecomp/data/CRG/20120502_FDF_CRG/20120502_FDF_CRG/20120504_FDF_CRG_c12.mtb	678	NA	WWSS	water	2	160446	1336282632	1	0.04	0.00333333333333333	5118	1
2	Food 2	Intake 4	292	160748	1336282934	/users/cn/jespinosa/phecomp/data/CRG/20120502_FDF_CRG/20120502_FDF_CRG/20120504_FDF_CRG_c12.mtb	1133	202	WWSS	food_sc	4	160456	1336282642	1	0.0799999999999996	0.000273972602739725	5119	1
2	Drink 2	Intake 2	22	160855	1336283041	/users/cn/jespinosa/phecomp/data/CRG/20120502_FDF_CRG/20120502_FDF_CRG/20120504_FDF_CRG_c12.mtb	679	NA	WWSS	water	2	160833	1336283019	1	0.0399999999999996	0.0018181818181818	5120	1
2	Food 2	Intake 4	101	161051	1336283237	/users/cn/jespinosa/phecomp/data/CRG/20120502_FDF_CRG/20120502_FDF_CRG/20120504_FDF_CRG_c12.mtb	1135	7205	WWSS	food_sc	4	160950	1336283136	1	0.02	0.000198019801980198	5121	1
2	Food 2	Intake 4	271	168527	1336290713	/users/cn/jespinosa/phecomp/data/CRG/20120502_FDF_CRG/20120502_FDF_CRG/20120504_FDF_CRG_c12.mtb	1141	55	WWSS	food_sc	4	168256	1336290442	1	0.0600000000000001	0.000221402214022141	5122	1
2	Food 2	Intake 4	202	168784	1336290970	/users/cn/jespinosa/phecomp/data/CRG/20120502_FDF_CRG/20120502_FDF_CRG/20120504_FDF_CRG_c12.mtb	1142	11345	WWSS	food_sc	4	168582	1336290768	1	0.04	0.000198019801980198	5123	1
2	Drink 2	Intake 2	25	168833	1336291019	/users/cn/jespinosa/phecomp/data/CRG/20120502_FDF_CRG/20120502_FDF_CRG/20120504_FDF_CRG_c12.mtb	682	NA	WWSS	water	2	168808	1336290994	1	0.04	0.0016	5124	1
2	Drink 2	Intake 2	13	169655	1336291841	/users/cn/jespinosa/phecomp/data/CRG/20120502_FDF_CRG/20120502_FDF_CRG/20120504_FDF_CRG_c12.mtb	683	NA	WWSS	water	2	169642	1336291828	1	0.02	0.00153846153846154	5125	1
2	Food 2	Intake 4	942	181071	1336303257	/users/cn/jespinosa/phecomp/data/CRG/20120502_FDF_CRG/20120502_FDF_CRG/20120504_FDF_CRG_c12.mtb	1145	9068	WWSS	food_sc	4	180129	1336302315	1	0.28	0.00029723991507431	5126	1
2	Drink 1	Intake 1	20	181145	1336303331	/users/cn/jespinosa/phecomp/data/CRG/20120502_FDF_CRG/20120502_FDF_CRG/20120504_FDF_CRG_c12.mtb	403	NA	WWSS	water	1	181125	1336303311	1	0.1	0.005	5127	1
2	Drink 1	Intake 1	12	181464	1336303650	/users/cn/jespinosa/phecomp/data/CRG/20120502_FDF_CRG/20120502_FDF_CRG/20120504_FDF_CRG_c12.mtb	404	NA	WWSS	water	1	181452	1336303638	1	0.04	0.00333333333333333	5128	1
2	Drink 1	Intake 1	15	181558	1336303744	/users/cn/jespinosa/phecomp/data/CRG/20120502_FDF_CRG/20120502_FDF_CRG/20120504_FDF_CRG_c12.mtb	405	NA	WWSS	water	1	181543	1336303729	1	0.02	0.00133333333333333	5129	1
2	Food 2	Intake 4	891	191030	1336313216	/users/cn/jespinosa/phecomp/data/CRG/20120502_FDF_CRG/20120502_FDF_CRG/20120504_FDF_CRG_c12.mtb	1150	7541	WWSS	food_sc	4	190139	1336312325	1	0.3	0.000336700336700337	5130	1
2	Drink 1	Intake 1	18	191073	1336313259	/users/cn/jespinosa/phecomp/data/CRG/20120502_FDF_CRG/20120502_FDF_CRG/20120504_FDF_CRG_c12.mtb	406	NA	WWSS	water	1	191055	1336313241	1	0.04	0.00222222222222222	5131	1
2	Food 2	Intake 4	494	199065	1336321251	/users/cn/jespinosa/phecomp/data/CRG/20120502_FDF_CRG/20120502_FDF_CRG/20120504_FDF_CRG_c12.mtb	1151	7927	WWSS	food_sc	4	198571	1336320757	1	0.540000000000001	0.00109311740890688	5132	1
2	Drink 2	Intake 2	34	199542	1336321728	/users/cn/jespinosa/phecomp/data/CRG/20120502_FDF_CRG/20120502_FDF_CRG/20120504_FDF_CRG_c12.mtb	685	NA	WWSS	water	2	199508	1336321694	1	0.04	0.00117647058823529	5133	1
2	Drink 1	Intake 1	18	199593	1336321779	/users/cn/jespinosa/phecomp/data/CRG/20120502_FDF_CRG/20120502_FDF_CRG/20120504_FDF_CRG_c12.mtb	407	NA	WWSS	water	1	199575	1336321761	1	0.04	0.00222222222222222	5134	1
2	Drink 2	Intake 2	24	199965	1336322151	/users/cn/jespinosa/phecomp/data/CRG/20120502_FDF_CRG/20120502_FDF_CRG/20120504_FDF_CRG_c12.mtb	688	NA	WWSS	water	2	199941	1336322127	1	0.02	0.000833333333333333	5135	1
2	Drink 1	Intake 1	20	200132	1336322318	/users/cn/jespinosa/phecomp/data/CRG/20120502_FDF_CRG/20120502_FDF_CRG/20120504_FDF_CRG_c12.mtb	408	NA	WWSS	water	1	200112	1336322298	1	0.0600000000000001	0.00300000000000001	5136	1
2	Food 2	Intake 4	218	207210	1336329396	/users/cn/jespinosa/phecomp/data/CRG/20120502_FDF_CRG/20120502_FDF_CRG/20120504_FDF_CRG_c12.mtb	1158	44	WWSS	food_sc	4	206992	1336329178	1	0.0200000000000005	9.17431192660573e-05	5137	1
2	Food 2	Intake 4	182	207436	1336329622	/users/cn/jespinosa/phecomp/data/CRG/20120502_FDF_CRG/20120502_FDF_CRG/20120504_FDF_CRG_c12.mtb	1159	888	WWSS	food_sc	4	207254	1336329440	1	0.04	0.00021978021978022	5138	1
2	Food 2	Intake 4	21	208345	1336330531	/users/cn/jespinosa/phecomp/data/CRG/20120502_FDF_CRG/20120502_FDF_CRG/20120504_FDF_CRG_c12.mtb	1165	132	WWSS	food_sc	4	208324	1336330510	1	0.0200000000000005	0.000952380952380976	5139	1
2	Food 2	Intake 4	298	208775	1336330961	/users/cn/jespinosa/phecomp/data/CRG/20120502_FDF_CRG/20120502_FDF_CRG/20120504_FDF_CRG_c12.mtb	1166	389	WWSS	food_sc	4	208477	1336330663	1	0.04	0.000134228187919463	5140	1
2	Food 2	Intake 4	791	209955	1336332141	/users/cn/jespinosa/phecomp/data/CRG/20120502_FDF_CRG/20120502_FDF_CRG/20120504_FDF_CRG_c12.mtb	1169	911	WWSS	food_sc	4	209164	1336331350	1	0.16	0.000202275600505689	5141	1
2	Drink 2	Intake 2	22	209969	1336332155	/users/cn/jespinosa/phecomp/data/CRG/20120502_FDF_CRG/20120502_FDF_CRG/20120504_FDF_CRG_c12.mtb	693	NA	WWSS	water	2	209947	1336332133	1	0.04	0.00181818181818182	5142	1
2	Food 2	Intake 4	149	211015	1336333201	/users/cn/jespinosa/phecomp/data/CRG/20120502_FDF_CRG/20120502_FDF_CRG/20120504_FDF_CRG_c12.mtb	1179	33	WWSS	food_sc	4	210866	1336333052	1	0.0200000000000005	0.000134228187919466	5143	1
2	Drink 1	Intake 1	16	211033	1336333219	/users/cn/jespinosa/phecomp/data/CRG/20120502_FDF_CRG/20120502_FDF_CRG/20120504_FDF_CRG_c12.mtb	412	NA	WWSS	water	1	211017	1336333203	1	0.0599999999999998	0.00374999999999999	5144	1
2	Food 2	Intake 4	1200	212248	1336334434	/users/cn/jespinosa/phecomp/data/CRG/20120502_FDF_CRG/20120502_FDF_CRG/20120504_FDF_CRG_c12.mtb	1180	1905	WWSS	food_sc	4	211048	1336333234	1	0.3	0.00025	5145	1
2	Drink 2	Intake 2	42	212284	1336334470	/users/cn/jespinosa/phecomp/data/CRG/20120502_FDF_CRG/20120502_FDF_CRG/20120504_FDF_CRG_c12.mtb	696	NA	WWSS	water	2	212242	1336334428	1	0.1	0.00238095238095238	5146	1
2	Drink 1	Intake 1	24	212359	1336334545	/users/cn/jespinosa/phecomp/data/CRG/20120502_FDF_CRG/20120502_FDF_CRG/20120504_FDF_CRG_c12.mtb	413	NA	WWSS	water	1	212335	1336334521	1	0.0800000000000001	0.00333333333333334	5147	1
2	Food 2	Intake 4	123	214276	1336336462	/users/cn/jespinosa/phecomp/data/CRG/20120502_FDF_CRG/20120502_FDF_CRG/20120504_FDF_CRG_c12.mtb	1183	368	WWSS	food_sc	4	214153	1336336339	1	0.0200000000000005	0.000162601626016264	5148	1
2	Drink 2	Intake 2	12	214518	1336336704	/users/cn/jespinosa/phecomp/data/CRG/20120502_FDF_CRG/20120502_FDF_CRG/20120504_FDF_CRG_c12.mtb	704	NA	WWSS	water	2	214506	1336336692	1	0.02	0.00166666666666667	5149	1
2	Food 2	Intake 4	640	215284	1336337470	/users/cn/jespinosa/phecomp/data/CRG/20120502_FDF_CRG/20120502_FDF_CRG/20120504_FDF_CRG_c12.mtb	1186	2846	WWSS	food_sc	4	214644	1336336830	1	0.0600000000000005	9.37500000000008e-05	5150	1
2	Drink 2	Intake 2	26	215302	1336337488	/users/cn/jespinosa/phecomp/data/CRG/20120502_FDF_CRG/20120502_FDF_CRG/20120504_FDF_CRG_c12.mtb	705	NA	WWSS	water	2	215276	1336337462	1	0.0600000000000001	0.00230769230769231	5151	1
2	Drink 1	Intake 1	16	215975	1336338161	/users/cn/jespinosa/phecomp/data/CRG/20120502_FDF_CRG/20120502_FDF_CRG/20120504_FDF_CRG_c12.mtb	415	NA	WWSS	water	1	215959	1336338145	1	0.0399999999999998	0.00249999999999999	5152	1
2	Drink 1	Intake 1	22	216155	1336338341	/users/cn/jespinosa/phecomp/data/CRG/20120502_FDF_CRG/20120502_FDF_CRG/20120504_FDF_CRG_c12.mtb	416	NA	WWSS	water	1	216133	1336338319	1	0.02	0.000909090909090909	5153	1
2	Food 2	Intake 4	1111	219241	1336341427	/users/cn/jespinosa/phecomp/data/CRG/20120502_FDF_CRG/20120502_FDF_CRG/20120504_FDF_CRG_c12.mtb	1201	23	WWSS	food_sc	4	218130	1336340316	1	0.14	0.000126012601260126	5154	1
2	Food 2	Intake 4	203	219467	1336341653	/users/cn/jespinosa/phecomp/data/CRG/20120502_FDF_CRG/20120502_FDF_CRG/20120504_FDF_CRG_c12.mtb	1202	1561	WWSS	food_sc	4	219264	1336341450	1	0.0200000000000005	9.85221674876872e-05	5155	1
2	Drink 2	Intake 2	12	219470	1336341656	/users/cn/jespinosa/phecomp/data/CRG/20120502_FDF_CRG/20120502_FDF_CRG/20120504_FDF_CRG_c12.mtb	710	NA	WWSS	water	2	219458	1336341644	1	0.04	0.00333333333333333	5156	1
2	Food 2	Intake 4	586	221614	1336343800	/users/cn/jespinosa/phecomp/data/CRG/20120502_FDF_CRG/20120502_FDF_CRG/20120504_FDF_CRG_c12.mtb	1203	14	WWSS	food_sc	4	221028	1336343214	1	0.0599999999999996	0.000102389078498293	5157	1
2	Food 2	Intake 4	522	222150	1336344336	/users/cn/jespinosa/phecomp/data/CRG/20120502_FDF_CRG/20120502_FDF_CRG/20120504_FDF_CRG_c12.mtb	1204	3617	WWSS	food_sc	4	221628	1336343814	1	0.12	0.000229885057471264	5158	1
2	Drink 2	Intake 2	18	222159	1336344345	/users/cn/jespinosa/phecomp/data/CRG/20120502_FDF_CRG/20120502_FDF_CRG/20120504_FDF_CRG_c12.mtb	711	NA	WWSS	water	2	222141	1336344327	1	0.04	0.00222222222222222	5159	1
2	Drink 2	Intake 2	19	222251	1336344437	/users/cn/jespinosa/phecomp/data/CRG/20120502_FDF_CRG/20120502_FDF_CRG/20120504_FDF_CRG_c12.mtb	712	NA	WWSS	water	2	222232	1336344418	1	0.0600000000000001	0.00315789473684211	5160	1
2	Drink 1	Intake 1	25	222519	1336344705	/users/cn/jespinosa/phecomp/data/CRG/20120502_FDF_CRG/20120502_FDF_CRG/20120504_FDF_CRG_c12.mtb	419	NA	WWSS	water	1	222494	1336344680	1	0.04	0.0016	5161	1
2	Food 2	Intake 4	434	226201	1336348387	/users/cn/jespinosa/phecomp/data/CRG/20120502_FDF_CRG/20120502_FDF_CRG/20120504_FDF_CRG_c12.mtb	1217	1785	WWSS	food_sc	4	225767	1336347953	1	0.0200000000000005	4.60829493087569e-05	5162	1
2	Drink 1	Intake 1	16	226742	1336348928	/users/cn/jespinosa/phecomp/data/CRG/20120502_FDF_CRG/20120502_FDF_CRG/20120504_FDF_CRG_c12.mtb	422	NA	WWSS	water	1	226726	1336348912	1	0.02	0.00125	5163	1
2	Drink 1	Intake 1	20	227522	1336349708	/users/cn/jespinosa/phecomp/data/CRG/20120502_FDF_CRG/20120502_FDF_CRG/20120504_FDF_CRG_c12.mtb	423	NA	WWSS	water	1	227502	1336349688	1	0.02	0.001	5164	1
2	Food 2	Intake 4	539	228525	1336350711	/users/cn/jespinosa/phecomp/data/CRG/20120502_FDF_CRG/20120502_FDF_CRG/20120504_FDF_CRG_c12.mtb	1226	21	WWSS	food_sc	4	227986	1336350172	1	0.0200000000000005	3.71057513914666e-05	5165	1
2	Food 2	Intake 4	1083	229629	1336351815	/users/cn/jespinosa/phecomp/data/CRG/20120502_FDF_CRG/20120502_FDF_CRG/20120504_FDF_CRG_c12.mtb	1227	5945	WWSS	food_sc	4	228546	1336350732	1	0.22	0.000203139427516159	5166	1
2	Drink 2	Intake 2	36	229659	1336351845	/users/cn/jespinosa/phecomp/data/CRG/20120502_FDF_CRG/20120502_FDF_CRG/20120504_FDF_CRG_c12.mtb	723	NA	WWSS	water	2	229623	1336351809	1	0.1	0.00277777777777778	5167	1
2	Drink 2	Intake 2	22	229691	1336351877	/users/cn/jespinosa/phecomp/data/CRG/20120502_FDF_CRG/20120502_FDF_CRG/20120504_FDF_CRG_c12.mtb	724	NA	WWSS	water	2	229669	1336351855	1	0.0600000000000001	0.00272727272727273	5168	1
2	Drink 1	Intake 1	17	229750	1336351936	/users/cn/jespinosa/phecomp/data/CRG/20120502_FDF_CRG/20120502_FDF_CRG/20120504_FDF_CRG_c12.mtb	424	NA	WWSS	water	1	229733	1336351919	1	0.02	0.00117647058823529	5169	1
2	Drink 1	Intake 1	20	230183	1336352369	/users/cn/jespinosa/phecomp/data/CRG/20120502_FDF_CRG/20120502_FDF_CRG/20120504_FDF_CRG_c12.mtb	425	NA	WWSS	water	1	230163	1336352349	1	0.0600000000000001	0.00300000000000001	5170	1
2	Food 2	Intake 4	1061	236635	1336358821	/users/cn/jespinosa/phecomp/data/CRG/20120502_FDF_CRG/20120502_FDF_CRG/20120504_FDF_CRG_c12.mtb	1235	383	WWSS	food_sc	4	235574	1336357760	1	0.26	0.000245051837888784	5171	1
2	Drink 2	Intake 2	33	236661	1336358847	/users/cn/jespinosa/phecomp/data/CRG/20120502_FDF_CRG/20120502_FDF_CRG/20120504_FDF_CRG_c12.mtb	726	NA	WWSS	water	2	236628	1336358814	1	0.12	0.00363636363636364	5172	1
2	Drink 2	Intake 2	25	236695	1336358881	/users/cn/jespinosa/phecomp/data/CRG/20120502_FDF_CRG/20120502_FDF_CRG/20120504_FDF_CRG_c12.mtb	727	NA	WWSS	water	2	236670	1336358856	1	0.0599999999999996	0.00239999999999998	5173	1
2	Drink 1	Intake 1	19	236846	1336359032	/users/cn/jespinosa/phecomp/data/CRG/20120502_FDF_CRG/20120502_FDF_CRG/20120504_FDF_CRG_c12.mtb	426	NA	WWSS	water	1	236827	1336359013	1	0.02	0.00105263157894737	5174	1
2	Drink 2	Intake 2	18	236899	1336359085	/users/cn/jespinosa/phecomp/data/CRG/20120502_FDF_CRG/20120502_FDF_CRG/20120504_FDF_CRG_c12.mtb	728	NA	WWSS	water	2	236881	1336359067	1	0.04	0.00222222222222222	5175	1
2	Drink 2	Intake 2	60	236968	1336359154	/users/cn/jespinosa/phecomp/data/CRG/20120502_FDF_CRG/20120502_FDF_CRG/20120504_FDF_CRG_c12.mtb	729	NA	WWSS	water	2	236908	1336359094	1	0.0200000000000005	0.000333333333333342	5176	1
2	Drink 2	Intake 2	44	237018	1336359204	/users/cn/jespinosa/phecomp/data/CRG/20120502_FDF_CRG/20120502_FDF_CRG/20120504_FDF_CRG_c12.mtb	730	NA	WWSS	water	2	236974	1336359160	1	0.04	0.000909090909090909	5177	1
2	Food 2	Intake 4	590	237608	1336359794	/users/cn/jespinosa/phecomp/data/CRG/20120502_FDF_CRG/20120502_FDF_CRG/20120504_FDF_CRG_c12.mtb	1237	5241	WWSS	food_sc	4	237018	1336359204	1	0.220000000000001	0.000372881355932205	5178	1
2	Drink 2	Intake 2	32	237638	1336359824	/users/cn/jespinosa/phecomp/data/CRG/20120502_FDF_CRG/20120502_FDF_CRG/20120504_FDF_CRG_c12.mtb	731	NA	WWSS	water	2	237606	1336359792	1	0.0800000000000001	0.0025	5179	1
2	Drink 1	Intake 1	16	238040	1336360226	/users/cn/jespinosa/phecomp/data/CRG/20120502_FDF_CRG/20120502_FDF_CRG/20120504_FDF_CRG_c12.mtb	428	NA	WWSS	water	1	238024	1336360210	1	0.0600000000000001	0.00375000000000001	5180	1
2	Food 2	Intake 4	749	243598	1336365784	/users/cn/jespinosa/phecomp/data/CRG/20120502_FDF_CRG/20120502_FDF_CRG/20120504_FDF_CRG_c12.mtb	1241	455	WWSS	food_sc	4	242849	1336365035	1	0.22	0.000293724966622163	5181	1
2	Drink 1	Intake 1	18	243624	1336365810	/users/cn/jespinosa/phecomp/data/CRG/20120502_FDF_CRG/20120502_FDF_CRG/20120504_FDF_CRG_c12.mtb	429	NA	WWSS	water	1	243606	1336365792	1	0.04	0.00222222222222222	5182	1
2	Drink 2	Intake 2	25	243689	1336365875	/users/cn/jespinosa/phecomp/data/CRG/20120502_FDF_CRG/20120502_FDF_CRG/20120504_FDF_CRG_c12.mtb	737	NA	WWSS	water	2	243664	1336365850	1	0.04	0.0016	5183	1
2	Drink 2	Intake 2	45	243988	1336366174	/users/cn/jespinosa/phecomp/data/CRG/20120502_FDF_CRG/20120502_FDF_CRG/20120504_FDF_CRG_c12.mtb	738	NA	WWSS	water	2	243943	1336366129	1	0.0800000000000001	0.00177777777777778	5184	1
2	Food 2	Intake 4	662	244715	1336366901	/users/cn/jespinosa/phecomp/data/CRG/20120502_FDF_CRG/20120502_FDF_CRG/20120504_FDF_CRG_c12.mtb	1242	448	WWSS	food_sc	4	244053	1336366239	1	0.22	0.000332326283987915	5185	1
2	Drink 2	Intake 2	33	244751	1336366937	/users/cn/jespinosa/phecomp/data/CRG/20120502_FDF_CRG/20120502_FDF_CRG/20120504_FDF_CRG_c12.mtb	740	NA	WWSS	water	2	244718	1336366904	1	0.12	0.00363636363636364	5186	1
2	Drink 1	Intake 1	26	244842	1336367028	/users/cn/jespinosa/phecomp/data/CRG/20120502_FDF_CRG/20120502_FDF_CRG/20120504_FDF_CRG_c12.mtb	430	NA	WWSS	water	1	244816	1336367002	1	0.1	0.00384615384615385	5187	1
2	Food 2	Intake 4	158	245321	1336367507	/users/cn/jespinosa/phecomp/data/CRG/20120502_FDF_CRG/20120502_FDF_CRG/20120504_FDF_CRG_c12.mtb	1243	737	WWSS	food_sc	4	245163	1336367349	1	0.0200000000000005	0.000126582278481016	5188	1
2	Food 2	Intake 4	74	246132	1336368318	/users/cn/jespinosa/phecomp/data/CRG/20120502_FDF_CRG/20120502_FDF_CRG/20120504_FDF_CRG_c12.mtb	1247	6	WWSS	food_sc	4	246058	1336368244	1	0.0200000000000005	0.000270270270270277	5189	1
2	Food 2	Intake 4	390	246528	1336368714	/users/cn/jespinosa/phecomp/data/CRG/20120502_FDF_CRG/20120502_FDF_CRG/20120504_FDF_CRG_c12.mtb	1248	7443	WWSS	food_sc	4	246138	1336368324	1	0.119999999999999	0.000307692307692305	5190	1
2	Drink 2	Intake 2	26	246550	1336368736	/users/cn/jespinosa/phecomp/data/CRG/20120502_FDF_CRG/20120502_FDF_CRG/20120504_FDF_CRG_c12.mtb	747	NA	WWSS	water	2	246524	1336368710	1	0.0999999999999996	0.00384615384615383	5191	1
2	Food 2	Intake 4	504	254475	1336376661	/users/cn/jespinosa/phecomp/data/CRG/20120502_FDF_CRG/20120502_FDF_CRG/20120504_FDF_CRG_c12.mtb	1258	6334	WWSS	food_sc	4	253971	1336376157	1	0.180000000000001	0.000357142857142859	5192	1
2	Drink 2	Intake 2	25	254565	1336376751	/users/cn/jespinosa/phecomp/data/CRG/20120502_FDF_CRG/20120502_FDF_CRG/20120504_FDF_CRG_c12.mtb	750	NA	WWSS	water	2	254540	1336376726	1	0.100000000000001	0.00400000000000004	5193	1
2	Food 2	Intake 4	184	668	1336383179	/users/cn/jespinosa/phecomp/data/CRG/20120502_FDF_CRG/20120502_FDF_CRG/20120507_FDF_CRG_c12.mtb	1425	3847	WWSS	food_sc	4	484	1336382995	1	0.08	0.000434782608695652	5194	1
2	Food 2	Intake 4	316	4831	1336387342	/users/cn/jespinosa/phecomp/data/CRG/20120502_FDF_CRG/20120502_FDF_CRG/20120507_FDF_CRG_c12.mtb	1428	4350	WWSS	food_sc	4	4515	1336387026	1	0.08	0.000253164556962025	5195	1
2	Food 2	Intake 4	132	9313	1336391824	/users/cn/jespinosa/phecomp/data/CRG/20120502_FDF_CRG/20120502_FDF_CRG/20120507_FDF_CRG_c12.mtb	1433	6916	WWSS	food_sc	4	9181	1336391692	1	0.04	0.000303030303030303	5196	1
2	Food 2	Intake 4	211	16440	1336398951	/users/cn/jespinosa/phecomp/data/CRG/20120502_FDF_CRG/20120502_FDF_CRG/20120507_FDF_CRG_c12.mtb	1440	179	WWSS	food_sc	4	16229	1336398740	1	0.02	9.47867298578199e-05	5197	1
2	Food 2	Intake 4	194	16813	1336399324	/users/cn/jespinosa/phecomp/data/CRG/20120502_FDF_CRG/20120502_FDF_CRG/20120507_FDF_CRG_c12.mtb	1441	15828	WWSS	food_sc	4	16619	1336399130	1	0.04	0.000206185567010309	5198	1
2	Drink 2	Intake 2	15	17126	1336399637	/users/cn/jespinosa/phecomp/data/CRG/20120502_FDF_CRG/20120502_FDF_CRG/20120507_FDF_CRG_c12.mtb	850	NA	WWSS	water	2	17111	1336399622	1	0.02	0.00133333333333333	5199	1
2	Food 2	Intake 4	168	32809	1336415320	/users/cn/jespinosa/phecomp/data/CRG/20120502_FDF_CRG/20120502_FDF_CRG/20120507_FDF_CRG_c12.mtb	1453	1536	WWSS	food_sc	4	32641	1336415152	1	0.02	0.000119047619047619	5200	1
2	Food 1	Intake 3	686	35031	1336417542	/users/cn/jespinosa/phecomp/data/CRG/20120502_FDF_CRG/20120502_FDF_CRG/20120507_FDF_CRG_c12.mtb	768	44	WWSS	food_sc	3	34345	1336416856	1	0.08	0.000116618075801749	5201	1
2	Food 1	Intake 3	46	35121	1336417632	/users/cn/jespinosa/phecomp/data/CRG/20120502_FDF_CRG/20120502_FDF_CRG/20120507_FDF_CRG_c12.mtb	769	2493	WWSS	food_sc	3	35075	1336417586	1	0.02	0.000434782608695652	5202	1
2	Drink 2	Intake 2	28	35344	1336417855	/users/cn/jespinosa/phecomp/data/CRG/20120502_FDF_CRG/20120502_FDF_CRG/20120507_FDF_CRG_c12.mtb	853	NA	WWSS	water	2	35316	1336417827	1	0.02	0.000714285714285714	5203	1
2	Drink 2	Intake 2	13	36409	1336418920	/users/cn/jespinosa/phecomp/data/CRG/20120502_FDF_CRG/20120502_FDF_CRG/20120507_FDF_CRG_c12.mtb	855	NA	WWSS	water	2	36396	1336418907	1	0.02	0.00153846153846154	5204	1
2	Food 2	Intake 4	302	37916	1336420427	/users/cn/jespinosa/phecomp/data/CRG/20120502_FDF_CRG/20120502_FDF_CRG/20120507_FDF_CRG_c12.mtb	1462	9	WWSS	food_sc	4	37614	1336420125	1	0.04	0.000132450331125828	5205	1
2	Food 2	Intake 4	104	38029	1336420540	/users/cn/jespinosa/phecomp/data/CRG/20120502_FDF_CRG/20120502_FDF_CRG/20120507_FDF_CRG_c12.mtb	1463	10	WWSS	food_sc	4	37925	1336420436	1	0.08	0.000769230769230769	5206	1
2	Food 2	Intake 4	741	38780	1336421291	/users/cn/jespinosa/phecomp/data/CRG/20120502_FDF_CRG/20120502_FDF_CRG/20120507_FDF_CRG_c12.mtb	1464	37	WWSS	food_sc	4	38039	1336420550	1	0.1	0.000134952766531714	5207	1
2	Drink 2	Intake 2	25	38799	1336421310	/users/cn/jespinosa/phecomp/data/CRG/20120502_FDF_CRG/20120502_FDF_CRG/20120507_FDF_CRG_c12.mtb	857	NA	WWSS	water	2	38774	1336421285	1	0.06	0.0024	5208	1
2	Food 2	Intake 4	245	39062	1336421573	/users/cn/jespinosa/phecomp/data/CRG/20120502_FDF_CRG/20120502_FDF_CRG/20120507_FDF_CRG_c12.mtb	1465	268	WWSS	food_sc	4	38817	1336421328	1	0.04	0.000163265306122449	5209	1
2	Drink 2	Intake 2	30	39084	1336421595	/users/cn/jespinosa/phecomp/data/CRG/20120502_FDF_CRG/20120502_FDF_CRG/20120507_FDF_CRG_c12.mtb	858	NA	WWSS	water	2	39054	1336421565	1	0.1	0.00333333333333333	5210	1
2	Food 2	Intake 4	575	39905	1336422416	/users/cn/jespinosa/phecomp/data/CRG/20120502_FDF_CRG/20120502_FDF_CRG/20120507_FDF_CRG_c12.mtb	1468	1528	WWSS	food_sc	4	39330	1336421841	1	0.2	0.000347826086956522	5211	1
2	Drink 2	Intake 2	25	39924	1336422435	/users/cn/jespinosa/phecomp/data/CRG/20120502_FDF_CRG/20120502_FDF_CRG/20120507_FDF_CRG_c12.mtb	859	NA	WWSS	water	2	39899	1336422410	1	0.06	0.0024	5212	1
2	Drink 2	Intake 2	20	40001	1336422512	/users/cn/jespinosa/phecomp/data/CRG/20120502_FDF_CRG/20120502_FDF_CRG/20120507_FDF_CRG_c12.mtb	860	NA	WWSS	water	2	39981	1336422492	1	0.06	0.003	5213	1
2	Drink 1	Intake 1	20	40023	1336422534	/users/cn/jespinosa/phecomp/data/CRG/20120502_FDF_CRG/20120502_FDF_CRG/20120507_FDF_CRG_c12.mtb	513	NA	WWSS	water	1	40003	1336422514	1	0.02	0.001	5214	1
2	Drink 1	Intake 1	15	41435	1336423946	/users/cn/jespinosa/phecomp/data/CRG/20120502_FDF_CRG/20120502_FDF_CRG/20120507_FDF_CRG_c12.mtb	514	NA	WWSS	water	1	41420	1336423931	1	0.02	0.00133333333333333	5215	1
2	Food 2	Intake 4	887	42320	1336424831	/users/cn/jespinosa/phecomp/data/CRG/20120502_FDF_CRG/20120502_FDF_CRG/20120507_FDF_CRG_c12.mtb	1470	1113	WWSS	food_sc	4	41433	1336423944	1	0.16	0.000180383314543405	5216	1
2	Drink 2	Intake 2	24	42339	1336424850	/users/cn/jespinosa/phecomp/data/CRG/20120502_FDF_CRG/20120502_FDF_CRG/20120507_FDF_CRG_c12.mtb	861	NA	WWSS	water	2	42315	1336424826	1	0.04	0.00166666666666667	5217	1
2	Drink 2	Intake 2	20	42434	1336424945	/users/cn/jespinosa/phecomp/data/CRG/20120502_FDF_CRG/20120502_FDF_CRG/20120507_FDF_CRG_c12.mtb	862	NA	WWSS	water	2	42414	1336424925	1	0.02	0.001	5218	1
2	Drink 2	Intake 2	20	43433	1336425944	/users/cn/jespinosa/phecomp/data/CRG/20120502_FDF_CRG/20120502_FDF_CRG/20120507_FDF_CRG_c12.mtb	863	NA	WWSS	water	2	43413	1336425924	1	0.04	0.002	5219	1
2	Food 2	Intake 4	868	44301	1336426812	/users/cn/jespinosa/phecomp/data/CRG/20120502_FDF_CRG/20120502_FDF_CRG/20120507_FDF_CRG_c12.mtb	1473	41	WWSS	food_sc	4	43433	1336425944	1	0.26	0.000299539170506912	5220	1
2	Drink 2	Intake 2	36	44329	1336426840	/users/cn/jespinosa/phecomp/data/CRG/20120502_FDF_CRG/20120502_FDF_CRG/20120507_FDF_CRG_c12.mtb	864	NA	WWSS	water	2	44293	1336426804	1	0.12	0.00333333333333333	5221	1
2	Food 2	Intake 4	174	44516	1336427027	/users/cn/jespinosa/phecomp/data/CRG/20120502_FDF_CRG/20120502_FDF_CRG/20120507_FDF_CRG_c12.mtb	1474	157	WWSS	food_sc	4	44342	1336426853	1	0.04	0.000229885057471264	5222	1
2	Drink 2	Intake 2	20	44607	1336427118	/users/cn/jespinosa/phecomp/data/CRG/20120502_FDF_CRG/20120502_FDF_CRG/20120507_FDF_CRG_c12.mtb	866	NA	WWSS	water	2	44587	1336427098	1	0.04	0.002	5223	1
2	Food 2	Intake 4	50	44723	1336427234	/users/cn/jespinosa/phecomp/data/CRG/20120502_FDF_CRG/20120502_FDF_CRG/20120507_FDF_CRG_c12.mtb	1475	288	WWSS	food_sc	4	44673	1336427184	1	0.02	0.0004	5224	1
2	Drink 2	Intake 2	16	44883	1336427394	/users/cn/jespinosa/phecomp/data/CRG/20120502_FDF_CRG/20120502_FDF_CRG/20120507_FDF_CRG_c12.mtb	868	NA	WWSS	water	2	44867	1336427378	1	0.02	0.00125	5225	1
2	Drink 2	Intake 2	12	44990	1336427501	/users/cn/jespinosa/phecomp/data/CRG/20120502_FDF_CRG/20120502_FDF_CRG/20120507_FDF_CRG_c12.mtb	869	NA	WWSS	water	2	44978	1336427489	1	0.02	0.00166666666666667	5226	1
2	Food 2	Intake 4	662	45673	1336428184	/users/cn/jespinosa/phecomp/data/CRG/20120502_FDF_CRG/20120502_FDF_CRG/20120507_FDF_CRG_c12.mtb	1478	49	WWSS	food_sc	4	45011	1336427522	1	0.18	0.00027190332326284	5227	1
2	Drink 1	Intake 1	37	45709	1336428220	/users/cn/jespinosa/phecomp/data/CRG/20120502_FDF_CRG/20120502_FDF_CRG/20120507_FDF_CRG_c12.mtb	518	NA	WWSS	water	1	45672	1336428183	1	0.12	0.00324324324324324	5228	1
2	Food 2	Intake 4	91	45813	1336428324	/users/cn/jespinosa/phecomp/data/CRG/20120502_FDF_CRG/20120502_FDF_CRG/20120507_FDF_CRG_c12.mtb	1479	94	WWSS	food_sc	4	45722	1336428233	1	0.02	0.00021978021978022	5229	1
2	Drink 2	Intake 2	15	45825	1336428336	/users/cn/jespinosa/phecomp/data/CRG/20120502_FDF_CRG/20120502_FDF_CRG/20120507_FDF_CRG_c12.mtb	870	NA	WWSS	water	2	45810	1336428321	1	0.0399999999999999	0.00266666666666666	5230	1
2	Food 2	Intake 4	440	46347	1336428858	/users/cn/jespinosa/phecomp/data/CRG/20120502_FDF_CRG/20120502_FDF_CRG/20120507_FDF_CRG_c12.mtb	1480	1233	WWSS	food_sc	4	45907	1336428418	1	0.2	0.000454545454545455	5231	1
2	Drink 2	Intake 2	32	46374	1336428885	/users/cn/jespinosa/phecomp/data/CRG/20120502_FDF_CRG/20120502_FDF_CRG/20120507_FDF_CRG_c12.mtb	871	NA	WWSS	water	2	46342	1336428853	1	0.0800000000000001	0.0025	5232	1
2	Drink 2	Intake 2	19	46931	1336429442	/users/cn/jespinosa/phecomp/data/CRG/20120502_FDF_CRG/20120502_FDF_CRG/20120507_FDF_CRG_c12.mtb	872	NA	WWSS	water	2	46912	1336429423	1	0.0599999999999999	0.0031578947368421	5233	1
2	Drink 1	Intake 1	12	47491	1336430002	/users/cn/jespinosa/phecomp/data/CRG/20120502_FDF_CRG/20120502_FDF_CRG/20120507_FDF_CRG_c12.mtb	519	NA	WWSS	water	1	47479	1336429990	1	0.04	0.00333333333333333	5234	1
2	Food 2	Intake 4	155	47735	1336430246	/users/cn/jespinosa/phecomp/data/CRG/20120502_FDF_CRG/20120502_FDF_CRG/20120507_FDF_CRG_c12.mtb	1483	35	WWSS	food_sc	4	47580	1336430091	1	0.04	0.000258064516129032	5235	1
2	Food 2	Intake 4	193	47963	1336430474	/users/cn/jespinosa/phecomp/data/CRG/20120502_FDF_CRG/20120502_FDF_CRG/20120507_FDF_CRG_c12.mtb	1484	6073	WWSS	food_sc	4	47770	1336430281	1	0.0399999999999998	0.000207253886010362	5236	1
2	Drink 2	Intake 2	18	47982	1336430493	/users/cn/jespinosa/phecomp/data/CRG/20120502_FDF_CRG/20120502_FDF_CRG/20120507_FDF_CRG_c12.mtb	874	NA	WWSS	water	2	47964	1336430475	1	0.02	0.00111111111111111	5237	1
2	Drink 2	Intake 2	20	48919	1336431430	/users/cn/jespinosa/phecomp/data/CRG/20120502_FDF_CRG/20120502_FDF_CRG/20120507_FDF_CRG_c12.mtb	875	NA	WWSS	water	2	48899	1336431410	1	0.04	0.002	5238	1
2	Drink 2	Intake 2	17	54049	1336436560	/users/cn/jespinosa/phecomp/data/CRG/20120502_FDF_CRG/20120502_FDF_CRG/20120507_FDF_CRG_c12.mtb	877	NA	WWSS	water	2	54032	1336436543	1	0.02	0.00117647058823529	5239	1
2	Food 2	Intake 4	1117	55153	1336437664	/users/cn/jespinosa/phecomp/data/CRG/20120502_FDF_CRG/20120502_FDF_CRG/20120507_FDF_CRG_c12.mtb	1488	766	WWSS	food_sc	4	54036	1336436547	1	0.3	0.00026857654431513	5240	1
2	Drink 1	Intake 1	22	55176	1336437687	/users/cn/jespinosa/phecomp/data/CRG/20120502_FDF_CRG/20120502_FDF_CRG/20120507_FDF_CRG_c12.mtb	520	NA	WWSS	water	1	55154	1336437665	1	0.06	0.00272727272727273	5241	1
2	Drink 2	Intake 2	15	55302	1336437813	/users/cn/jespinosa/phecomp/data/CRG/20120502_FDF_CRG/20120502_FDF_CRG/20120507_FDF_CRG_c12.mtb	879	NA	WWSS	water	2	55287	1336437798	1	0.0399999999999999	0.00266666666666666	5242	1
2	Drink 2	Intake 2	38	55431	1336437942	/users/cn/jespinosa/phecomp/data/CRG/20120502_FDF_CRG/20120502_FDF_CRG/20120507_FDF_CRG_c12.mtb	880	NA	WWSS	water	2	55393	1336437904	1	0.04	0.00105263157894737	5243	1
2	Drink 2	Intake 2	30	55643	1336438154	/users/cn/jespinosa/phecomp/data/CRG/20120502_FDF_CRG/20120502_FDF_CRG/20120507_FDF_CRG_c12.mtb	882	NA	WWSS	water	2	55613	1336438124	1	0.04	0.00133333333333333	5244	1
2	Food 2	Intake 4	206	56125	1336438636	/users/cn/jespinosa/phecomp/data/CRG/20120502_FDF_CRG/20120502_FDF_CRG/20120507_FDF_CRG_c12.mtb	1494	4	WWSS	food_sc	4	55919	1336438430	1	0.0800000000000001	0.000388349514563107	5245	1
2	Food 2	Intake 4	128	56257	1336438768	/users/cn/jespinosa/phecomp/data/CRG/20120502_FDF_CRG/20120502_FDF_CRG/20120507_FDF_CRG_c12.mtb	1495	319	WWSS	food_sc	4	56129	1336438640	1	0.0600000000000001	0.000468750000000001	5246	1
2	Drink 2	Intake 2	23	56275	1336438786	/users/cn/jespinosa/phecomp/data/CRG/20120502_FDF_CRG/20120502_FDF_CRG/20120507_FDF_CRG_c12.mtb	886	NA	WWSS	water	2	56252	1336438763	1	0.04	0.00173913043478261	5247	1
2	Drink 1	Intake 1	21	56503	1336439014	/users/cn/jespinosa/phecomp/data/CRG/20120502_FDF_CRG/20120502_FDF_CRG/20120507_FDF_CRG_c12.mtb	521	NA	WWSS	water	1	56482	1336438993	1	0.02	0.000952380952380952	5248	1
2	Food 2	Intake 4	61	56637	1336439148	/users/cn/jespinosa/phecomp/data/CRG/20120502_FDF_CRG/20120502_FDF_CRG/20120507_FDF_CRG_c12.mtb	1497	4396	WWSS	food_sc	4	56576	1336439087	1	0.48	0.00786885245901639	5249	1
2	Drink 2	Intake 2	57	56945	1336439456	/users/cn/jespinosa/phecomp/data/CRG/20120502_FDF_CRG/20120502_FDF_CRG/20120507_FDF_CRG_c12.mtb	890	NA	WWSS	water	2	56888	1336439399	1	0.12	0.00210526315789474	5250	1
2	Drink 2	Intake 2	31	57702	1336440213	/users/cn/jespinosa/phecomp/data/CRG/20120502_FDF_CRG/20120502_FDF_CRG/20120507_FDF_CRG_c12.mtb	891	NA	WWSS	water	2	57671	1336440182	1	0.04	0.00129032258064516	5251	1
2	Drink 1	Intake 1	12	60818	1336443329	/users/cn/jespinosa/phecomp/data/CRG/20120502_FDF_CRG/20120502_FDF_CRG/20120507_FDF_CRG_c12.mtb	522	NA	WWSS	water	1	60806	1336443317	1	0.06	0.005	5252	1
2	Food 2	Intake 4	18	61051	1336443562	/users/cn/jespinosa/phecomp/data/CRG/20120502_FDF_CRG/20120502_FDF_CRG/20120507_FDF_CRG_c12.mtb	1500	5692	WWSS	food_sc	4	61033	1336443544	1	0.02	0.00111111111111111	5253	1
2	Drink 2	Intake 2	58	61473	1336443984	/users/cn/jespinosa/phecomp/data/CRG/20120502_FDF_CRG/20120502_FDF_CRG/20120507_FDF_CRG_c12.mtb	895	NA	WWSS	water	2	61415	1336443926	1	0.02	0.000344827586206897	5254	1
2	Drink 2	Intake 2	16	62014	1336444525	/users/cn/jespinosa/phecomp/data/CRG/20120502_FDF_CRG/20120502_FDF_CRG/20120507_FDF_CRG_c12.mtb	900	NA	WWSS	water	2	61998	1336444509	1	0.02	0.00125	5255	1
2	Drink 1	Intake 1	18	62105	1336444616	/users/cn/jespinosa/phecomp/data/CRG/20120502_FDF_CRG/20120502_FDF_CRG/20120507_FDF_CRG_c12.mtb	523	NA	WWSS	water	1	62087	1336444598	1	0.04	0.00222222222222222	5256	1
2	Food 2	Intake 4	86	66829	1336449340	/users/cn/jespinosa/phecomp/data/CRG/20120502_FDF_CRG/20120502_FDF_CRG/20120507_FDF_CRG_c12.mtb	1505	1410	WWSS	food_sc	4	66743	1336449254	1	0.02	0.000232558139534884	5257	1
2	Food 1	Intake 3	346	68585	1336451096	/users/cn/jespinosa/phecomp/data/CRG/20120502_FDF_CRG/20120502_FDF_CRG/20120507_FDF_CRG_c12.mtb	785	95	WWSS	food_sc	3	68239	1336450750	1	0.08	0.00023121387283237	5258	1
2	Drink 1	Intake 1	15	68604	1336451115	/users/cn/jespinosa/phecomp/data/CRG/20120502_FDF_CRG/20120502_FDF_CRG/20120507_FDF_CRG_c12.mtb	524	NA	WWSS	water	1	68589	1336451100	1	0.02	0.00133333333333333	5259	1
2	Drink 1	Intake 1	11	68657	1336451168	/users/cn/jespinosa/phecomp/data/CRG/20120502_FDF_CRG/20120502_FDF_CRG/20120507_FDF_CRG_c12.mtb	525	NA	WWSS	water	1	68646	1336451157	1	0.04	0.00363636363636364	5260	1
2	Food 1	Intake 3	427	69107	1336451618	/users/cn/jespinosa/phecomp/data/CRG/20120502_FDF_CRG/20120502_FDF_CRG/20120507_FDF_CRG_c12.mtb	787	909	WWSS	food_sc	3	68680	1336451191	1	0.18	0.000421545667447307	5261	1
2	Drink 2	Intake 2	24	69127	1336451638	/users/cn/jespinosa/phecomp/data/CRG/20120502_FDF_CRG/20120502_FDF_CRG/20120507_FDF_CRG_c12.mtb	901	NA	WWSS	water	2	69103	1336451614	1	0.0600000000000001	0.0025	5262	1
2	Drink 2	Intake 2	26	69172	1336451683	/users/cn/jespinosa/phecomp/data/CRG/20120502_FDF_CRG/20120502_FDF_CRG/20120507_FDF_CRG_c12.mtb	902	NA	WWSS	water	2	69146	1336451657	1	0.0599999999999998	0.0023076923076923	5263	1
2	Drink 2	Intake 2	14	69406	1336451917	/users/cn/jespinosa/phecomp/data/CRG/20120502_FDF_CRG/20120502_FDF_CRG/20120507_FDF_CRG_c12.mtb	903	NA	WWSS	water	2	69392	1336451903	1	0.02	0.00142857142857143	5264	1
2	Drink 1	Intake 1	12	69465	1336451976	/users/cn/jespinosa/phecomp/data/CRG/20120502_FDF_CRG/20120502_FDF_CRG/20120507_FDF_CRG_c12.mtb	526	NA	WWSS	water	1	69453	1336451964	1	0.02	0.00166666666666667	5265	1
2	Drink 1	Intake 1	16	69586	1336452097	/users/cn/jespinosa/phecomp/data/CRG/20120502_FDF_CRG/20120502_FDF_CRG/20120507_FDF_CRG_c12.mtb	527	NA	WWSS	water	1	69570	1336452081	1	0.04	0.0025	5266	1
2	Food 1	Intake 3	457	70473	1336452984	/users/cn/jespinosa/phecomp/data/CRG/20120502_FDF_CRG/20120502_FDF_CRG/20120507_FDF_CRG_c12.mtb	793	4393	WWSS	food_sc	3	70016	1336452527	1	0.18	0.000393873085339168	5267	1
2	Drink 2	Intake 2	20	71056	1336453567	/users/cn/jespinosa/phecomp/data/CRG/20120502_FDF_CRG/20120502_FDF_CRG/20120507_FDF_CRG_c12.mtb	906	NA	WWSS	water	2	71036	1336453547	1	0.0600000000000001	0.00300000000000001	5268	1
2	Drink 2	Intake 2	13	71201	1336453712	/users/cn/jespinosa/phecomp/data/CRG/20120502_FDF_CRG/20120502_FDF_CRG/20120507_FDF_CRG_c12.mtb	907	NA	WWSS	water	2	71188	1336453699	1	0.0600000000000001	0.00461538461538462	5269	1
2	Drink 2	Intake 2	20	71500	1336454011	/users/cn/jespinosa/phecomp/data/CRG/20120502_FDF_CRG/20120502_FDF_CRG/20120507_FDF_CRG_c12.mtb	908	NA	WWSS	water	2	71480	1336453991	1	0.02	0.001	5270	1
2	Food 1	Intake 3	294	75160	1336457671	/users/cn/jespinosa/phecomp/data/CRG/20120502_FDF_CRG/20120502_FDF_CRG/20120507_FDF_CRG_c12.mtb	796	3118	WWSS	food_sc	3	74866	1336457377	1	0.1	0.000340136054421769	5271	1
2	Food 1	Intake 3	317	78595	1336461106	/users/cn/jespinosa/phecomp/data/CRG/20120502_FDF_CRG/20120502_FDF_CRG/20120507_FDF_CRG_c12.mtb	797	7	WWSS	food_sc	3	78278	1336460789	1	0.14	0.000441640378548896	5272	1
2	Food 1	Intake 3	41	78643	1336461154	/users/cn/jespinosa/phecomp/data/CRG/20120502_FDF_CRG/20120502_FDF_CRG/20120507_FDF_CRG_c12.mtb	798	1299	WWSS	food_sc	3	78602	1336461113	1	0.02	0.00048780487804878	5273	1
2	Drink 2	Intake 2	22	79206	1336461717	/users/cn/jespinosa/phecomp/data/CRG/20120502_FDF_CRG/20120502_FDF_CRG/20120507_FDF_CRG_c12.mtb	912	NA	WWSS	water	2	79184	1336461695	1	0.02	0.000909090909090909	5274	1
2	Drink 2	Intake 2	195	79696	1336462207	/users/cn/jespinosa/phecomp/data/CRG/20120502_FDF_CRG/20120502_FDF_CRG/20120507_FDF_CRG_c12.mtb	913	NA	WWSS	water	2	79501	1336462012	1	0.02	0.000102564102564103	5275	1
2	Drink 1	Intake 1	35	79876	1336462387	/users/cn/jespinosa/phecomp/data/CRG/20120502_FDF_CRG/20120502_FDF_CRG/20120507_FDF_CRG_c12.mtb	530	NA	WWSS	water	1	79841	1336462352	1	0.04	0.00114285714285714	5276	1
2	Drink 1	Intake 1	15	79911	1336462422	/users/cn/jespinosa/phecomp/data/CRG/20120502_FDF_CRG/20120502_FDF_CRG/20120507_FDF_CRG_c12.mtb	531	NA	WWSS	water	1	79896	1336462407	1	0.02	0.00133333333333333	5277	1
2	Food 1	Intake 3	55	79997	1336462508	/users/cn/jespinosa/phecomp/data/CRG/20120502_FDF_CRG/20120502_FDF_CRG/20120507_FDF_CRG_c12.mtb	802	6	WWSS	food_sc	3	79942	1336462453	1	0.0399999999999999	0.000727272727272725	5278	1
2	Food 1	Intake 3	62	80065	1336462576	/users/cn/jespinosa/phecomp/data/CRG/20120502_FDF_CRG/20120502_FDF_CRG/20120507_FDF_CRG_c12.mtb	803	5193	WWSS	food_sc	3	80003	1336462514	1	0.04	0.000645161290322581	5279	1
2	Food 1	Intake 3	25	85283	1336467794	/users/cn/jespinosa/phecomp/data/CRG/20120502_FDF_CRG/20120502_FDF_CRG/20120507_FDF_CRG_c12.mtb	804	20	WWSS	food_sc	3	85258	1336467769	1	0.02	0.0008	5280	1
2	Food 1	Intake 3	67	85370	1336467881	/users/cn/jespinosa/phecomp/data/CRG/20120502_FDF_CRG/20120502_FDF_CRG/20120507_FDF_CRG_c12.mtb	805	6228	WWSS	food_sc	3	85303	1336467814	1	0.2	0.00298507462686567	5281	1
2	Drink 2	Intake 2	20	85898	1336468409	/users/cn/jespinosa/phecomp/data/CRG/20120502_FDF_CRG/20120502_FDF_CRG/20120507_FDF_CRG_c12.mtb	918	NA	WWSS	water	2	85878	1336468389	1	0.02	0.001	5282	1
2	Drink 1	Intake 1	19	86289	1336468800	/users/cn/jespinosa/phecomp/data/CRG/20120502_FDF_CRG/20120502_FDF_CRG/20120507_FDF_CRG_c12.mtb	532	NA	WWSS	water	1	86270	1336468781	1	0.08	0.00421052631578947	5283	1
2	Food 1	Intake 3	20	91618	1336474129	/users/cn/jespinosa/phecomp/data/CRG/20120502_FDF_CRG/20120502_FDF_CRG/20120507_FDF_CRG_c12.mtb	809	6873	WWSS	food_sc	3	91598	1336474109	1	0.02	0.001	5284	1
2	Food 1	Intake 3	59	98550	1336481061	/users/cn/jespinosa/phecomp/data/CRG/20120502_FDF_CRG/20120502_FDF_CRG/20120507_FDF_CRG_c12.mtb	812	19609	WWSS	food_sc	3	98491	1336481002	1	0.02	0.000338983050847458	5285	1
2	Food 2	Intake 4	121	118280	1336500791	/users/cn/jespinosa/phecomp/data/CRG/20120502_FDF_CRG/20120502_FDF_CRG/20120507_FDF_CRG_c12.mtb	1521	197	WWSS	food_sc	4	118159	1336500670	1	0.02	0.000165289256198347	5286	1
2	Drink 2	Intake 2	20	118474	1336500985	/users/cn/jespinosa/phecomp/data/CRG/20120502_FDF_CRG/20120502_FDF_CRG/20120507_FDF_CRG_c12.mtb	922	NA	WWSS	water	2	118454	1336500965	1	0.02	0.001	5287	1
2	Food 1	Intake 3	592	119069	1336501580	/users/cn/jespinosa/phecomp/data/CRG/20120502_FDF_CRG/20120502_FDF_CRG/20120507_FDF_CRG_c12.mtb	821	518	WWSS	food_sc	3	118477	1336500988	1	0.04	6.75675675675676e-05	5288	1
2	Food 1	Intake 3	364	119951	1336502462	/users/cn/jespinosa/phecomp/data/CRG/20120502_FDF_CRG/20120502_FDF_CRG/20120507_FDF_CRG_c12.mtb	825	511	WWSS	food_sc	3	119587	1336502098	1	0.0600000000000001	0.000164835164835165	5289	1
2	Drink 2	Intake 2	24	120280	1336502791	/users/cn/jespinosa/phecomp/data/CRG/20120502_FDF_CRG/20120502_FDF_CRG/20120507_FDF_CRG_c12.mtb	924	NA	WWSS	water	2	120256	1336502767	1	0.02	0.000833333333333333	5290	1
2	Food 1	Intake 3	514	120976	1336503487	/users/cn/jespinosa/phecomp/data/CRG/20120502_FDF_CRG/20120502_FDF_CRG/20120507_FDF_CRG_c12.mtb	827	857	WWSS	food_sc	3	120462	1336502973	1	0.12	0.000233463035019455	5291	1
2	Drink 2	Intake 2	30	121002	1336503513	/users/cn/jespinosa/phecomp/data/CRG/20120502_FDF_CRG/20120502_FDF_CRG/20120507_FDF_CRG_c12.mtb	926	NA	WWSS	water	2	120972	1336503483	1	0.0399999999999998	0.00133333333333333	5292	1
2	Drink 2	Intake 2	15	121066	1336503577	/users/cn/jespinosa/phecomp/data/CRG/20120502_FDF_CRG/20120502_FDF_CRG/20120507_FDF_CRG_c12.mtb	927	NA	WWSS	water	2	121051	1336503562	1	0.02	0.00133333333333333	5293	1
2	Drink 2	Intake 2	18	121161	1336503672	/users/cn/jespinosa/phecomp/data/CRG/20120502_FDF_CRG/20120502_FDF_CRG/20120507_FDF_CRG_c12.mtb	928	NA	WWSS	water	2	121143	1336503654	1	0.02	0.00111111111111111	5294	1
2	Food 1	Intake 3	242	122075	1336504586	/users/cn/jespinosa/phecomp/data/CRG/20120502_FDF_CRG/20120502_FDF_CRG/20120507_FDF_CRG_c12.mtb	829	14	WWSS	food_sc	3	121833	1336504344	1	0.02	8.26446280991736e-05	5295	1
2	Drink 2	Intake 2	35	122112	1336504623	/users/cn/jespinosa/phecomp/data/CRG/20120502_FDF_CRG/20120502_FDF_CRG/20120507_FDF_CRG_c12.mtb	929	NA	WWSS	water	2	122077	1336504588	1	0.02	0.000571428571428571	5296	1
2	Food 1	Intake 3	18	122107	1336504618	/users/cn/jespinosa/phecomp/data/CRG/20120502_FDF_CRG/20120502_FDF_CRG/20120507_FDF_CRG_c12.mtb	830	99	WWSS	food_sc	3	122089	1336504600	1	0.02	0.00111111111111111	5297	1
2	Food 1	Intake 3	116	122322	1336504833	/users/cn/jespinosa/phecomp/data/CRG/20120502_FDF_CRG/20120502_FDF_CRG/20120507_FDF_CRG_c12.mtb	832	147	WWSS	food_sc	3	122206	1336504717	1	0.02	0.000172413793103448	5298	1
2	Food 1	Intake 3	118	122587	1336505098	/users/cn/jespinosa/phecomp/data/CRG/20120502_FDF_CRG/20120502_FDF_CRG/20120507_FDF_CRG_c12.mtb	834	247	WWSS	food_sc	3	122469	1336504980	1	0.02	0.000169491525423729	5299	1
2	Drink 2	Intake 2	24	122639	1336505150	/users/cn/jespinosa/phecomp/data/CRG/20120502_FDF_CRG/20120502_FDF_CRG/20120507_FDF_CRG_c12.mtb	932	NA	WWSS	water	2	122615	1336505126	1	0.02	0.000833333333333333	5300	1
2	Food 1	Intake 3	152	122986	1336505497	/users/cn/jespinosa/phecomp/data/CRG/20120502_FDF_CRG/20120502_FDF_CRG/20120507_FDF_CRG_c12.mtb	835	844	WWSS	food_sc	3	122834	1336505345	1	0.04	0.000263157894736842	5301	1
2	Drink 2	Intake 2	15	123000	1336505511	/users/cn/jespinosa/phecomp/data/CRG/20120502_FDF_CRG/20120502_FDF_CRG/20120507_FDF_CRG_c12.mtb	933	NA	WWSS	water	2	122985	1336505496	1	0.0399999999999998	0.00266666666666665	5302	1
2	Food 1	Intake 3	482	124312	1336506823	/users/cn/jespinosa/phecomp/data/CRG/20120502_FDF_CRG/20120502_FDF_CRG/20120507_FDF_CRG_c12.mtb	836	723	WWSS	food_sc	3	123830	1336506341	1	0.1	0.00020746887966805	5303	1
2	Drink 1	Intake 1	14	124486	1336506997	/users/cn/jespinosa/phecomp/data/CRG/20120502_FDF_CRG/20120502_FDF_CRG/20120507_FDF_CRG_c12.mtb	534	NA	WWSS	water	1	124472	1336506983	1	0.0599999999999999	0.00428571428571428	5304	1
2	Food 1	Intake 3	249	125284	1336507795	/users/cn/jespinosa/phecomp/data/CRG/20120502_FDF_CRG/20120502_FDF_CRG/20120507_FDF_CRG_c12.mtb	840	490	WWSS	food_sc	3	125035	1336507546	1	0.02	8.03212851405622e-05	5305	1
2	Drink 2	Intake 2	39	125518	1336508029	/users/cn/jespinosa/phecomp/data/CRG/20120502_FDF_CRG/20120502_FDF_CRG/20120507_FDF_CRG_c12.mtb	939	NA	WWSS	water	2	125479	1336507990	1	0.02	0.000512820512820513	5306	1
2	Food 1	Intake 3	837	126611	1336509122	/users/cn/jespinosa/phecomp/data/CRG/20120502_FDF_CRG/20120502_FDF_CRG/20120507_FDF_CRG_c12.mtb	846	1745	WWSS	food_sc	3	125774	1336508285	1	0.28	0.00033452807646356	5307	1
2	Drink 2	Intake 2	38	126646	1336509157	/users/cn/jespinosa/phecomp/data/CRG/20120502_FDF_CRG/20120502_FDF_CRG/20120507_FDF_CRG_c12.mtb	943	NA	WWSS	water	2	126608	1336509119	1	0.1	0.00263157894736842	5308	1
2	Drink 2	Intake 2	21	126689	1336509200	/users/cn/jespinosa/phecomp/data/CRG/20120502_FDF_CRG/20120502_FDF_CRG/20120507_FDF_CRG_c12.mtb	944	NA	WWSS	water	2	126668	1336509179	1	0.04	0.0019047619047619	5309	1
2	Food 1	Intake 3	494	128850	1336511361	/users/cn/jespinosa/phecomp/data/CRG/20120502_FDF_CRG/20120502_FDF_CRG/20120507_FDF_CRG_c12.mtb	849	483	WWSS	food_sc	3	128356	1336510867	1	0.18	0.000364372469635627	5310	1
2	Drink 2	Intake 2	26	128866	1336511377	/users/cn/jespinosa/phecomp/data/CRG/20120502_FDF_CRG/20120502_FDF_CRG/20120507_FDF_CRG_c12.mtb	946	NA	WWSS	water	2	128840	1336511351	1	0.0800000000000001	0.00307692307692308	5311	1
2	Drink 1	Intake 1	26	128914	1336511425	/users/cn/jespinosa/phecomp/data/CRG/20120502_FDF_CRG/20120502_FDF_CRG/20120507_FDF_CRG_c12.mtb	537	NA	WWSS	water	1	128888	1336511399	1	0.0600000000000001	0.00230769230769231	5312	1
2	Drink 2	Intake 2	49	129282	1336511793	/users/cn/jespinosa/phecomp/data/CRG/20120502_FDF_CRG/20120502_FDF_CRG/20120507_FDF_CRG_c12.mtb	950	NA	WWSS	water	2	129233	1336511744	1	0.02	0.000408163265306122	5313	1
2	Food 1	Intake 3	516	129849	1336512360	/users/cn/jespinosa/phecomp/data/CRG/20120502_FDF_CRG/20120502_FDF_CRG/20120507_FDF_CRG_c12.mtb	851	160	WWSS	food_sc	3	129333	1336511844	1	0.24	0.000465116279069767	5314	1
2	Drink 2	Intake 2	34	129888	1336512399	/users/cn/jespinosa/phecomp/data/CRG/20120502_FDF_CRG/20120502_FDF_CRG/20120507_FDF_CRG_c12.mtb	952	NA	WWSS	water	2	129854	1336512365	1	0.1	0.00294117647058824	5315	1
2	Drink 2	Intake 2	20	129987	1336512498	/users/cn/jespinosa/phecomp/data/CRG/20120502_FDF_CRG/20120502_FDF_CRG/20120507_FDF_CRG_c12.mtb	953	NA	WWSS	water	2	129967	1336512478	1	0.04	0.002	5316	1
2	Food 1	Intake 3	65	130074	1336512585	/users/cn/jespinosa/phecomp/data/CRG/20120502_FDF_CRG/20120502_FDF_CRG/20120507_FDF_CRG_c12.mtb	852	1150	WWSS	food_sc	3	130009	1336512520	1	0.02	0.000307692307692308	5317	1
2	Drink 2	Intake 2	17	130106	1336512617	/users/cn/jespinosa/phecomp/data/CRG/20120502_FDF_CRG/20120502_FDF_CRG/20120507_FDF_CRG_c12.mtb	954	NA	WWSS	water	2	130089	1336512600	1	0.02	0.00117647058823529	5318	1
2	Drink 1	Intake 1	17	130411	1336512922	/users/cn/jespinosa/phecomp/data/CRG/20120502_FDF_CRG/20120502_FDF_CRG/20120507_FDF_CRG_c12.mtb	542	NA	WWSS	water	1	130394	1336512905	1	0.04	0.00235294117647059	5319	1
2	Drink 2	Intake 2	20	130912	1336513423	/users/cn/jespinosa/phecomp/data/CRG/20120502_FDF_CRG/20120502_FDF_CRG/20120507_FDF_CRG_c12.mtb	956	NA	WWSS	water	2	130892	1336513403	1	0.0200000000000005	0.00100000000000002	5320	1
2	Food 1	Intake 3	184	131408	1336513919	/users/cn/jespinosa/phecomp/data/CRG/20120502_FDF_CRG/20120502_FDF_CRG/20120507_FDF_CRG_c12.mtb	855	107	WWSS	food_sc	3	131224	1336513735	1	0.1	0.000543478260869565	5321	1
2	Food 1	Intake 3	17	131532	1336514043	/users/cn/jespinosa/phecomp/data/CRG/20120502_FDF_CRG/20120502_FDF_CRG/20120507_FDF_CRG_c12.mtb	856	8644	WWSS	food_sc	3	131515	1336514026	1	0.24	0.0141176470588235	5322	1
2	Drink 2	Intake 2	23	131780	1336514291	/users/cn/jespinosa/phecomp/data/CRG/20120502_FDF_CRG/20120502_FDF_CRG/20120507_FDF_CRG_c12.mtb	957	NA	WWSS	water	2	131757	1336514268	1	0.0399999999999996	0.00173913043478259	5323	1
2	Drink 1	Intake 1	15	132066	1336514577	/users/cn/jespinosa/phecomp/data/CRG/20120502_FDF_CRG/20120502_FDF_CRG/20120507_FDF_CRG_c12.mtb	544	NA	WWSS	water	1	132051	1336514562	1	0.04	0.00266666666666667	5324	1
2	Drink 1	Intake 1	35	132412	1336514923	/users/cn/jespinosa/phecomp/data/CRG/20120502_FDF_CRG/20120502_FDF_CRG/20120507_FDF_CRG_c12.mtb	546	NA	WWSS	water	1	132377	1336514888	1	0.02	0.000571428571428571	5325	1
2	Drink 1	Intake 1	30	132874	1336515385	/users/cn/jespinosa/phecomp/data/CRG/20120502_FDF_CRG/20120502_FDF_CRG/20120507_FDF_CRG_c12.mtb	547	NA	WWSS	water	1	132844	1336515355	1	0.0599999999999999	0.002	5326	1
2	Drink 1	Intake 1	39	133843	1336516354	/users/cn/jespinosa/phecomp/data/CRG/20120502_FDF_CRG/20120502_FDF_CRG/20120507_FDF_CRG_c12.mtb	549	NA	WWSS	water	1	133804	1336516315	1	0.02	0.000512820512820513	5327	1
2	Drink 1	Intake 1	31	133891	1336516402	/users/cn/jespinosa/phecomp/data/CRG/20120502_FDF_CRG/20120502_FDF_CRG/20120507_FDF_CRG_c12.mtb	550	NA	WWSS	water	1	133860	1336516371	1	0.12	0.00387096774193548	5328	1
2	Drink 1	Intake 1	24	134087	1336516598	/users/cn/jespinosa/phecomp/data/CRG/20120502_FDF_CRG/20120502_FDF_CRG/20120507_FDF_CRG_c12.mtb	551	NA	WWSS	water	1	134063	1336516574	1	0.02	0.000833333333333333	5329	1
2	Drink 2	Intake 2	62	134949	1336517460	/users/cn/jespinosa/phecomp/data/CRG/20120502_FDF_CRG/20120502_FDF_CRG/20120507_FDF_CRG_c12.mtb	965	NA	WWSS	water	2	134887	1336517398	1	0.12	0.00193548387096774	5330	1
2	Drink 2	Intake 2	17	140036	1336522547	/users/cn/jespinosa/phecomp/data/CRG/20120502_FDF_CRG/20120502_FDF_CRG/20120507_FDF_CRG_c12.mtb	971	NA	WWSS	water	2	140019	1336522530	1	0.02	0.00117647058823529	5331	1
2	Food 1	Intake 3	149	140325	1336522836	/users/cn/jespinosa/phecomp/data/CRG/20120502_FDF_CRG/20120502_FDF_CRG/20120507_FDF_CRG_c12.mtb	863	620	WWSS	food_sc	3	140176	1336522687	1	0.02	0.000134228187919463	5332	1
2	Drink 1	Intake 1	33	140935	1336523446	/users/cn/jespinosa/phecomp/data/CRG/20120502_FDF_CRG/20120502_FDF_CRG/20120507_FDF_CRG_c12.mtb	554	NA	WWSS	water	1	140902	1336523413	1	0.04	0.00121212121212121	5333	1
2	Food 2	Intake 4	251	141196	1336523707	/users/cn/jespinosa/phecomp/data/CRG/20120502_FDF_CRG/20120502_FDF_CRG/20120507_FDF_CRG_c12.mtb	1552	1179	WWSS	food_sc	4	140945	1336523456	1	0.02	7.96812749003984e-05	5334	1
2	Drink 2	Intake 2	43	142022	1336524533	/users/cn/jespinosa/phecomp/data/CRG/20120502_FDF_CRG/20120502_FDF_CRG/20120507_FDF_CRG_c12.mtb	974	NA	WWSS	water	2	141979	1336524490	1	0.0600000000000001	0.0013953488372093	5335	1
2	Drink 1	Intake 1	21	142049	1336524560	/users/cn/jespinosa/phecomp/data/CRG/20120502_FDF_CRG/20120502_FDF_CRG/20120507_FDF_CRG_c12.mtb	555	NA	WWSS	water	1	142028	1336524539	1	0.0399999999999998	0.0019047619047619	5336	1
2	Food 2	Intake 4	90	142465	1336524976	/users/cn/jespinosa/phecomp/data/CRG/20120502_FDF_CRG/20120502_FDF_CRG/20120507_FDF_CRG_c12.mtb	1560	4139	WWSS	food_sc	4	142375	1336524886	1	0.0200000000000005	0.000222222222222228	5337	1
2	Food 1	Intake 3	1358	147962	1336530473	/users/cn/jespinosa/phecomp/data/CRG/20120502_FDF_CRG/20120502_FDF_CRG/20120507_FDF_CRG_c12.mtb	880	584	WWSS	food_sc	3	146604	1336529115	1	0.32	0.000235640648011782	5338	1
2	Drink 2	Intake 2	18	147997	1336530508	/users/cn/jespinosa/phecomp/data/CRG/20120502_FDF_CRG/20120502_FDF_CRG/20120507_FDF_CRG_c12.mtb	977	NA	WWSS	water	2	147979	1336530490	1	0.02	0.00111111111111111	5339	1
2	Drink 1	Intake 1	14	148005	1336530516	/users/cn/jespinosa/phecomp/data/CRG/20120502_FDF_CRG/20120502_FDF_CRG/20120507_FDF_CRG_c12.mtb	556	NA	WWSS	water	1	147991	1336530502	1	0.02	0.00142857142857143	5340	1
2	Drink 1	Intake 1	14	148073	1336530584	/users/cn/jespinosa/phecomp/data/CRG/20120502_FDF_CRG/20120502_FDF_CRG/20120507_FDF_CRG_c12.mtb	557	NA	WWSS	water	1	148059	1336530570	1	0.04	0.00285714285714286	5341	1
2	Drink 1	Intake 1	20	148106	1336530617	/users/cn/jespinosa/phecomp/data/CRG/20120502_FDF_CRG/20120502_FDF_CRG/20120507_FDF_CRG_c12.mtb	558	NA	WWSS	water	1	148086	1336530597	1	0.04	0.002	5342	1
2	Drink 2	Intake 2	26	148153	1336530664	/users/cn/jespinosa/phecomp/data/CRG/20120502_FDF_CRG/20120502_FDF_CRG/20120507_FDF_CRG_c12.mtb	978	NA	WWSS	water	2	148127	1336530638	1	0.02	0.000769230769230769	5343	1
2	Drink 2	Intake 2	33	148229	1336530740	/users/cn/jespinosa/phecomp/data/CRG/20120502_FDF_CRG/20120502_FDF_CRG/20120507_FDF_CRG_c12.mtb	979	NA	WWSS	water	2	148196	1336530707	1	0.0600000000000001	0.00181818181818182	5344	1
2	Drink 2	Intake 2	16	148288	1336530799	/users/cn/jespinosa/phecomp/data/CRG/20120502_FDF_CRG/20120502_FDF_CRG/20120507_FDF_CRG_c12.mtb	980	NA	WWSS	water	2	148272	1336530783	1	0.02	0.00125	5345	1
2	Drink 1	Intake 1	17	148372	1336530883	/users/cn/jespinosa/phecomp/data/CRG/20120502_FDF_CRG/20120502_FDF_CRG/20120507_FDF_CRG_c12.mtb	559	NA	WWSS	water	1	148355	1336530866	1	0.02	0.00117647058823529	5346	1
2	Food 1	Intake 3	578	149124	1336531635	/users/cn/jespinosa/phecomp/data/CRG/20120502_FDF_CRG/20120502_FDF_CRG/20120507_FDF_CRG_c12.mtb	884	9	WWSS	food_sc	3	148546	1336531057	1	0.18	0.000311418685121107	5347	1
2	Food 1	Intake 3	50	149183	1336531694	/users/cn/jespinosa/phecomp/data/CRG/20120502_FDF_CRG/20120502_FDF_CRG/20120507_FDF_CRG_c12.mtb	885	5420	WWSS	food_sc	3	149133	1336531644	1	0.02	0.0004	5348	1
2	Drink 2	Intake 2	35	149209	1336531720	/users/cn/jespinosa/phecomp/data/CRG/20120502_FDF_CRG/20120502_FDF_CRG/20120507_FDF_CRG_c12.mtb	981	NA	WWSS	water	2	149174	1336531685	1	0.1	0.00285714285714286	5349	1
2	Drink 1	Intake 1	36	149270	1336531781	/users/cn/jespinosa/phecomp/data/CRG/20120502_FDF_CRG/20120502_FDF_CRG/20120507_FDF_CRG_c12.mtb	560	NA	WWSS	water	1	149234	1336531745	1	0.12	0.00333333333333333	5350	1
2	Drink 1	Intake 1	27	149693	1336532204	/users/cn/jespinosa/phecomp/data/CRG/20120502_FDF_CRG/20120502_FDF_CRG/20120507_FDF_CRG_c12.mtb	561	NA	WWSS	water	1	149666	1336532177	1	0.02	0.000740740740740741	5351	1
2	Food 1	Intake 3	166	154769	1336537280	/users/cn/jespinosa/phecomp/data/CRG/20120502_FDF_CRG/20120502_FDF_CRG/20120507_FDF_CRG_c12.mtb	888	9	WWSS	food_sc	3	154603	1336537114	1	0.0200000000000005	0.000120481927710846	5352	1
2	Food 1	Intake 3	57	154835	1336537346	/users/cn/jespinosa/phecomp/data/CRG/20120502_FDF_CRG/20120502_FDF_CRG/20120507_FDF_CRG_c12.mtb	889	4691	WWSS	food_sc	3	154778	1336537289	1	0.38	0.00666666666666667	5353	1
2	Drink 2	Intake 2	22	155409	1336537920	/users/cn/jespinosa/phecomp/data/CRG/20120502_FDF_CRG/20120502_FDF_CRG/20120507_FDF_CRG_c12.mtb	984	NA	WWSS	water	2	155387	1336537898	1	0.04	0.00181818181818182	5354	1
2	Drink 1	Intake 1	23	155856	1336538367	/users/cn/jespinosa/phecomp/data/CRG/20120502_FDF_CRG/20120502_FDF_CRG/20120507_FDF_CRG_c12.mtb	562	NA	WWSS	water	1	155833	1336538344	1	0.12	0.00521739130434783	5355	1
2	Drink 1	Intake 1	17	155983	1336538494	/users/cn/jespinosa/phecomp/data/CRG/20120502_FDF_CRG/20120502_FDF_CRG/20120507_FDF_CRG_c12.mtb	563	NA	WWSS	water	1	155966	1336538477	1	0.04	0.00235294117647059	5356	1
2	Food 1	Intake 3	39	159565	1336542076	/users/cn/jespinosa/phecomp/data/CRG/20120502_FDF_CRG/20120502_FDF_CRG/20120507_FDF_CRG_c12.mtb	890	537	WWSS	food_sc	3	159526	1336542037	1	0.02	0.000512820512820513	5357	1
2	Drink 1	Intake 1	17	159637	1336542148	/users/cn/jespinosa/phecomp/data/CRG/20120502_FDF_CRG/20120502_FDF_CRG/20120507_FDF_CRG_c12.mtb	564	NA	WWSS	water	1	159620	1336542131	1	0.02	0.00117647058823529	5358	1
2	Food 1	Intake 3	120	160222	1336542733	/users/cn/jespinosa/phecomp/data/CRG/20120502_FDF_CRG/20120502_FDF_CRG/20120507_FDF_CRG_c12.mtb	896	LAST	WWSS	food_sc	3	160102	1336542613	1	0.02	0.000166666666666667	5359	1
2	Food 1	Intake 3	31	1527	1336555215	/users/cn/jespinosa/phecomp/data/CRG/20120502_FDF_CRG/20120502_FDF_CRG/20120509_FDF_CRG_c12.mtb	1304	515	WWFF	food_fat	3	1496	1336555184	1	0.12	0.00387096774193548	5360	1
2	Food 2	Intake 4	121	2163	1336555851	/users/cn/jespinosa/phecomp/data/CRG/20120502_FDF_CRG/20120502_FDF_CRG/20120509_FDF_CRG_c12.mtb	2226	162	WWFF	food_fat	4	2042	1336555730	1	0.46	0.00380165289256198	5361	1
2	Food 2	Intake 4	87	2412	1336556100	/users/cn/jespinosa/phecomp/data/CRG/20120502_FDF_CRG/20120502_FDF_CRG/20120509_FDF_CRG_c12.mtb	2228	88	WWFF	food_fat	4	2325	1336556013	1	0.16	0.00183908045977011	5362	1
2	Drink 1	Intake 1	18	2493	1336556181	/users/cn/jespinosa/phecomp/data/CRG/20120502_FDF_CRG/20120502_FDF_CRG/20120509_FDF_CRG_c12.mtb	647	NA	WWFF	water	1	2475	1336556163	1	0.02	0.00111111111111111	5363	1
2	Food 2	Intake 4	27	2527	1336556215	/users/cn/jespinosa/phecomp/data/CRG/20120502_FDF_CRG/20120502_FDF_CRG/20120509_FDF_CRG_c12.mtb	2229	168	WWFF	food_fat	4	2500	1336556188	1	0.02	0.000740740740740741	5364	1
2	Drink 2	Intake 2	23	2688	1336556376	/users/cn/jespinosa/phecomp/data/CRG/20120502_FDF_CRG/20120502_FDF_CRG/20120509_FDF_CRG_c12.mtb	1055	NA	WWFF	water	2	2665	1336556353	1	0.04	0.00173913043478261	5365	1
2	Food 1	Intake 3	97	2792	1336556480	/users/cn/jespinosa/phecomp/data/CRG/20120502_FDF_CRG/20120502_FDF_CRG/20120509_FDF_CRG_c12.mtb	1307	COLL	WWFF	food_fat	3	2695	1336556383	1	0.16	0.00164948453608247	5366	1
2	Food 2	Intake 4	41	2823	1336556511	/users/cn/jespinosa/phecomp/data/CRG/20120502_FDF_CRG/20120502_FDF_CRG/20120509_FDF_CRG_c12.mtb	2230	73	WWFF	food_fat	4	2782	1336556470	1	0.02	0.00048780487804878	5367	1
2	Food 1	Intake 3	34	2930	1336556618	/users/cn/jespinosa/phecomp/data/CRG/20120502_FDF_CRG/20120502_FDF_CRG/20120509_FDF_CRG_c12.mtb	1308	4262	WWFF	food_fat	3	2896	1336556584	1	0.02	0.000588235294117647	5368	1
2	Drink 2	Intake 2	30	3321	1336557009	/users/cn/jespinosa/phecomp/data/CRG/20120502_FDF_CRG/20120502_FDF_CRG/20120509_FDF_CRG_c12.mtb	1058	NA	WWFF	water	2	3291	1336556979	1	0.02	0.000666666666666667	5369	1
2	Drink 2	Intake 2	24	4026	1336557714	/users/cn/jespinosa/phecomp/data/CRG/20120502_FDF_CRG/20120502_FDF_CRG/20120509_FDF_CRG_c12.mtb	1059	NA	WWFF	water	2	4002	1336557690	1	0.04	0.00166666666666667	5370	1
2	Drink 1	Intake 1	18	7149	1336560837	/users/cn/jespinosa/phecomp/data/CRG/20120502_FDF_CRG/20120502_FDF_CRG/20120509_FDF_CRG_c12.mtb	649	NA	WWFF	water	1	7131	1336560819	1	0.02	0.00111111111111111	5371	1
2	Food 1	Intake 3	17	7209	1336560897	/users/cn/jespinosa/phecomp/data/CRG/20120502_FDF_CRG/20120502_FDF_CRG/20120509_FDF_CRG_c12.mtb	1312	286	WWFF	food_fat	3	7192	1336560880	1	0.02	0.00117647058823529	5372	1
2	Drink 2	Intake 2	31	7268	1336560956	/users/cn/jespinosa/phecomp/data/CRG/20120502_FDF_CRG/20120502_FDF_CRG/20120509_FDF_CRG_c12.mtb	1060	NA	WWFF	water	2	7237	1336560925	1	0.02	0.000645161290322581	5373	1
2	Food 2	Intake 4	23	7518	1336561206	/users/cn/jespinosa/phecomp/data/CRG/20120502_FDF_CRG/20120502_FDF_CRG/20120509_FDF_CRG_c12.mtb	2233	6152	WWFF	food_fat	4	7495	1336561183	1	0.0399999999999999	0.0017391304347826	5374	1
2	Drink 2	Intake 2	18	7683	1336561371	/users/cn/jespinosa/phecomp/data/CRG/20120502_FDF_CRG/20120502_FDF_CRG/20120509_FDF_CRG_c12.mtb	1063	NA	WWFF	water	2	7665	1336561353	1	0.02	0.00111111111111111	5375	1
2	Drink 2	Intake 2	20	10235	1336563923	/users/cn/jespinosa/phecomp/data/CRG/20120502_FDF_CRG/20120502_FDF_CRG/20120509_FDF_CRG_c12.mtb	1064	NA	WWFF	water	2	10215	1336563903	1	0.02	0.001	5376	1
2	Drink 2	Intake 2	18	10450	1336564138	/users/cn/jespinosa/phecomp/data/CRG/20120502_FDF_CRG/20120502_FDF_CRG/20120509_FDF_CRG_c12.mtb	1065	NA	WWFF	water	2	10432	1336564120	1	0.06	0.00333333333333333	5377	1
2	Food 1	Intake 3	40	13710	1336567398	/users/cn/jespinosa/phecomp/data/CRG/20120502_FDF_CRG/20120502_FDF_CRG/20120509_FDF_CRG_c12.mtb	1318	9	WWFF	food_fat	3	13670	1336567358	1	0.04	0.001	5378	1
2	Food 1	Intake 3	15	13734	1336567422	/users/cn/jespinosa/phecomp/data/CRG/20120502_FDF_CRG/20120502_FDF_CRG/20120509_FDF_CRG_c12.mtb	1319	2193	WWFF	food_fat	3	13719	1336567407	1	0.04	0.00266666666666667	5379	1
2	Drink 2	Intake 2	33	13834	1336567522	/users/cn/jespinosa/phecomp/data/CRG/20120502_FDF_CRG/20120502_FDF_CRG/20120509_FDF_CRG_c12.mtb	1066	NA	WWFF	water	2	13801	1336567489	1	0.04	0.00121212121212121	5380	1
2	Food 1	Intake 3	22	15949	1336569637	/users/cn/jespinosa/phecomp/data/CRG/20120502_FDF_CRG/20120502_FDF_CRG/20120509_FDF_CRG_c12.mtb	1320	1913	WWFF	food_fat	3	15927	1336569615	1	0.02	0.000909090909090909	5381	1
2	Food 1	Intake 3	29	17891	1336571579	/users/cn/jespinosa/phecomp/data/CRG/20120502_FDF_CRG/20120502_FDF_CRG/20120509_FDF_CRG_c12.mtb	1322	1464	WWFF	food_fat	3	17862	1336571550	1	0.06	0.00206896551724138	5382	1
2	Drink 2	Intake 2	26	18375	1336572063	/users/cn/jespinosa/phecomp/data/CRG/20120502_FDF_CRG/20120502_FDF_CRG/20120509_FDF_CRG_c12.mtb	1067	NA	WWFF	water	2	18349	1336572037	1	0.1	0.00384615384615385	5383	1
2	Food 1	Intake 3	15	19370	1336573058	/users/cn/jespinosa/phecomp/data/CRG/20120502_FDF_CRG/20120502_FDF_CRG/20120509_FDF_CRG_c12.mtb	1325	3250	WWFF	food_fat	3	19355	1336573043	1	0.02	0.00133333333333333	5384	1
2	Food 1	Intake 3	16	22636	1336576324	/users/cn/jespinosa/phecomp/data/CRG/20120502_FDF_CRG/20120502_FDF_CRG/20120509_FDF_CRG_c12.mtb	1327	5	WWFF	food_fat	3	22620	1336576308	1	0.04	0.0025	5385	1
2	Food 1	Intake 3	44	22685	1336576373	/users/cn/jespinosa/phecomp/data/CRG/20120502_FDF_CRG/20120502_FDF_CRG/20120509_FDF_CRG_c12.mtb	1328	2545	WWFF	food_fat	3	22641	1336576329	1	0.02	0.000454545454545455	5386	1
2	Drink 2	Intake 2	57	22890	1336576578	/users/cn/jespinosa/phecomp/data/CRG/20120502_FDF_CRG/20120502_FDF_CRG/20120509_FDF_CRG_c12.mtb	1068	NA	WWFF	water	2	22833	1336576521	1	0.04	0.000701754385964912	5387	1
2	Drink 2	Intake 2	27	23529	1336577217	/users/cn/jespinosa/phecomp/data/CRG/20120502_FDF_CRG/20120502_FDF_CRG/20120509_FDF_CRG_c12.mtb	1069	NA	WWFF	water	2	23502	1336577190	1	0.08	0.00296296296296296	5388	1
2	Food 1	Intake 3	87	25317	1336579005	/users/cn/jespinosa/phecomp/data/CRG/20120502_FDF_CRG/20120502_FDF_CRG/20120509_FDF_CRG_c12.mtb	1331	8158	WWFF	food_fat	3	25230	1336578918	1	0.1	0.00114942528735632	5389	1
2	Drink 2	Intake 2	20	26666	1336580354	/users/cn/jespinosa/phecomp/data/CRG/20120502_FDF_CRG/20120502_FDF_CRG/20120509_FDF_CRG_c12.mtb	1070	NA	WWFF	water	2	26646	1336580334	1	0.02	0.001	5390	1
2	Drink 2	Intake 2	21	31771	1336585459	/users/cn/jespinosa/phecomp/data/CRG/20120502_FDF_CRG/20120502_FDF_CRG/20120509_FDF_CRG_c12.mtb	1071	NA	WWFF	water	2	31750	1336585438	1	0.0600000000000001	0.00285714285714286	5391	1
2	Food 1	Intake 3	45	33520	1336587208	/users/cn/jespinosa/phecomp/data/CRG/20120502_FDF_CRG/20120502_FDF_CRG/20120509_FDF_CRG_c12.mtb	1335	2657	WWFF	food_fat	3	33475	1336587163	1	0.02	0.000444444444444444	5392	1
2	Food 1	Intake 3	86	36263	1336589951	/users/cn/jespinosa/phecomp/data/CRG/20120502_FDF_CRG/20120502_FDF_CRG/20120509_FDF_CRG_c12.mtb	1340	979	WWFF	food_fat	3	36177	1336589865	1	0.1	0.00116279069767442	5393	1
2	Food 1	Intake 3	89	37331	1336591019	/users/cn/jespinosa/phecomp/data/CRG/20120502_FDF_CRG/20120502_FDF_CRG/20120509_FDF_CRG_c12.mtb	1341	651	WWFF	food_fat	3	37242	1336590930	1	0.1	0.00112359550561798	5394	1
2	Food 1	Intake 3	59	38041	1336591729	/users/cn/jespinosa/phecomp/data/CRG/20120502_FDF_CRG/20120502_FDF_CRG/20120509_FDF_CRG_c12.mtb	1342	194	WWFF	food_fat	3	37982	1336591670	1	0.0599999999999999	0.00101694915254237	5395	1
2	Food 1	Intake 3	17	38252	1336591940	/users/cn/jespinosa/phecomp/data/CRG/20120502_FDF_CRG/20120502_FDF_CRG/20120509_FDF_CRG_c12.mtb	1343	926	WWFF	food_fat	3	38235	1336591923	1	0.02	0.00117647058823529	5396	1
2	Drink 2	Intake 2	43	38747	1336592435	/users/cn/jespinosa/phecomp/data/CRG/20120502_FDF_CRG/20120502_FDF_CRG/20120509_FDF_CRG_c12.mtb	1075	NA	WWFF	water	2	38704	1336592392	1	0.12	0.0027906976744186	5397	1
2	Food 1	Intake 3	102	39280	1336592968	/users/cn/jespinosa/phecomp/data/CRG/20120502_FDF_CRG/20120502_FDF_CRG/20120509_FDF_CRG_c12.mtb	1344	1160	WWFF	food_fat	3	39178	1336592866	1	0.12	0.00117647058823529	5398	1
2	Drink 1	Intake 1	13	39606	1336593294	/users/cn/jespinosa/phecomp/data/CRG/20120502_FDF_CRG/20120502_FDF_CRG/20120509_FDF_CRG_c12.mtb	653	NA	WWFF	water	1	39593	1336593281	1	0.02	0.00153846153846154	5399	1
2	Food 1	Intake 3	16	40456	1336594144	/users/cn/jespinosa/phecomp/data/CRG/20120502_FDF_CRG/20120502_FDF_CRG/20120509_FDF_CRG_c12.mtb	1345	947	WWFF	food_fat	3	40440	1336594128	1	0.02	0.00125	5400	1
2	Drink 1	Intake 1	10	40626	1336594314	/users/cn/jespinosa/phecomp/data/CRG/20120502_FDF_CRG/20120502_FDF_CRG/20120509_FDF_CRG_c12.mtb	654	NA	WWFF	water	1	40616	1336594304	1	0.04	0.004	5401	1
2	Drink 2	Intake 2	29	40808	1336594496	/users/cn/jespinosa/phecomp/data/CRG/20120502_FDF_CRG/20120502_FDF_CRG/20120509_FDF_CRG_c12.mtb	1078	NA	WWFF	water	2	40779	1336594467	1	0.0599999999999999	0.00206896551724138	5402	1
2	Food 2	Intake 4	130	41533	1336595221	/users/cn/jespinosa/phecomp/data/CRG/20120502_FDF_CRG/20120502_FDF_CRG/20120509_FDF_CRG_c12.mtb	2239	476	WWFF	food_fat	4	41403	1336595091	1	0.02	0.000153846153846154	5403	1
2	Drink 2	Intake 2	30	41692	1336595380	/users/cn/jespinosa/phecomp/data/CRG/20120502_FDF_CRG/20120502_FDF_CRG/20120509_FDF_CRG_c12.mtb	1079	NA	WWFF	water	2	41662	1336595350	1	0.0600000000000001	0.002	5404	1
2	Food 1	Intake 3	150	42159	1336595847	/users/cn/jespinosa/phecomp/data/CRG/20120502_FDF_CRG/20120502_FDF_CRG/20120509_FDF_CRG_c12.mtb	1348	185	WWFF	food_fat	3	42009	1336595697	1	0.16	0.00106666666666667	5405	1
2	Drink 2	Intake 2	19	42286	1336595974	/users/cn/jespinosa/phecomp/data/CRG/20120502_FDF_CRG/20120502_FDF_CRG/20120509_FDF_CRG_c12.mtb	1082	NA	WWFF	water	2	42267	1336595955	1	0.0800000000000001	0.00421052631578948	5406	1
2	Food 1	Intake 3	208	42552	1336596240	/users/cn/jespinosa/phecomp/data/CRG/20120502_FDF_CRG/20120502_FDF_CRG/20120509_FDF_CRG_c12.mtb	1350	281	WWFF	food_fat	3	42344	1336596032	1	0.48	0.00230769230769231	5407	1
2	Food 1	Intake 3	229	43062	1336596750	/users/cn/jespinosa/phecomp/data/CRG/20120502_FDF_CRG/20120502_FDF_CRG/20120509_FDF_CRG_c12.mtb	1351	317	WWFF	food_fat	3	42833	1336596521	1	0.7	0.00305676855895197	5408	1
2	Food 1	Intake 3	121	43500	1336597188	/users/cn/jespinosa/phecomp/data/CRG/20120502_FDF_CRG/20120502_FDF_CRG/20120509_FDF_CRG_c12.mtb	1352	458	WWFF	food_fat	3	43379	1336597067	1	0.32	0.00264462809917355	5409	1
2	Food 1	Intake 3	120	44078	1336597766	/users/cn/jespinosa/phecomp/data/CRG/20120502_FDF_CRG/20120502_FDF_CRG/20120509_FDF_CRG_c12.mtb	1353	540	WWFF	food_fat	3	43958	1336597646	1	0.3	0.0025	5410	1
2	Food 1	Intake 3	33	44651	1336598339	/users/cn/jespinosa/phecomp/data/CRG/20120502_FDF_CRG/20120502_FDF_CRG/20120509_FDF_CRG_c12.mtb	1355	54	WWFF	food_fat	3	44618	1336598306	1	0.0800000000000001	0.00242424242424243	5411	1
2	Food 1	Intake 3	68	44773	1336598461	/users/cn/jespinosa/phecomp/data/CRG/20120502_FDF_CRG/20120502_FDF_CRG/20120509_FDF_CRG_c12.mtb	1356	1623	WWFF	food_fat	3	44705	1336598393	1	0.0800000000000001	0.0011764705882353	5412	1
2	Drink 2	Intake 2	12	44975	1336598663	/users/cn/jespinosa/phecomp/data/CRG/20120502_FDF_CRG/20120502_FDF_CRG/20120509_FDF_CRG_c12.mtb	1084	NA	WWFF	water	2	44963	1336598651	1	0.02	0.00166666666666667	5413	1
2	Drink 2	Intake 2	21	45976	1336599664	/users/cn/jespinosa/phecomp/data/CRG/20120502_FDF_CRG/20120502_FDF_CRG/20120509_FDF_CRG_c12.mtb	1085	NA	WWFF	water	2	45955	1336599643	1	0.0599999999999999	0.00285714285714285	5414	1
2	Food 1	Intake 3	102	46498	1336600186	/users/cn/jespinosa/phecomp/data/CRG/20120502_FDF_CRG/20120502_FDF_CRG/20120509_FDF_CRG_c12.mtb	1359	2043	WWFF	food_fat	3	46396	1336600084	1	0.0200000000000005	0.000196078431372554	5415	1
2	Food 2	Intake 4	87	48628	1336602316	/users/cn/jespinosa/phecomp/data/CRG/20120502_FDF_CRG/20120502_FDF_CRG/20120509_FDF_CRG_c12.mtb	2248	COLL	WWFF	food_fat	4	48541	1336602229	1	0.02	0.000229885057471264	5416	1
2	Food 1	Intake 3	113	48740	1336602428	/users/cn/jespinosa/phecomp/data/CRG/20120502_FDF_CRG/20120502_FDF_CRG/20120509_FDF_CRG_c12.mtb	1361	13617	WWFF	food_fat	3	48627	1336602315	1	0.44	0.00389380530973451	5417	1
2	Drink 1	Intake 1	19	49260	1336602948	/users/cn/jespinosa/phecomp/data/CRG/20120502_FDF_CRG/20120502_FDF_CRG/20120509_FDF_CRG_c12.mtb	658	NA	WWFF	water	1	49241	1336602929	1	0.04	0.00210526315789474	5418	1
2	Drink 2	Intake 2	15	50027	1336603715	/users/cn/jespinosa/phecomp/data/CRG/20120502_FDF_CRG/20120502_FDF_CRG/20120509_FDF_CRG_c12.mtb	1089	NA	WWFF	water	2	50012	1336603700	1	0.04	0.00266666666666667	5419	1
2	Drink 1	Intake 1	20	50045	1336603733	/users/cn/jespinosa/phecomp/data/CRG/20120502_FDF_CRG/20120502_FDF_CRG/20120509_FDF_CRG_c12.mtb	659	NA	WWFF	water	1	50025	1336603713	1	0.02	0.001	5420	1
2	Drink 2	Intake 2	20	52207	1336605895	/users/cn/jespinosa/phecomp/data/CRG/20120502_FDF_CRG/20120502_FDF_CRG/20120509_FDF_CRG_c12.mtb	1092	NA	WWFF	water	2	52187	1336605875	1	0.04	0.002	5421	1
2	Drink 1	Intake 1	15	52327	1336606015	/users/cn/jespinosa/phecomp/data/CRG/20120502_FDF_CRG/20120502_FDF_CRG/20120509_FDF_CRG_c12.mtb	660	NA	WWFF	water	1	52312	1336606000	1	0.02	0.00133333333333333	5422	1
2	Drink 1	Intake 1	22	53037	1336606725	/users/cn/jespinosa/phecomp/data/CRG/20120502_FDF_CRG/20120502_FDF_CRG/20120509_FDF_CRG_c12.mtb	661	NA	WWFF	water	1	53015	1336606703	1	0.04	0.00181818181818182	5423	1
2	Drink 1	Intake 1	32	53713	1336607401	/users/cn/jespinosa/phecomp/data/CRG/20120502_FDF_CRG/20120502_FDF_CRG/20120509_FDF_CRG_c12.mtb	662	NA	WWFF	water	1	53681	1336607369	1	0.02	0.000625	5424	1
2	Drink 2	Intake 2	15	58958	1336612646	/users/cn/jespinosa/phecomp/data/CRG/20120502_FDF_CRG/20120502_FDF_CRG/20120509_FDF_CRG_c12.mtb	1097	NA	WWFF	water	2	58943	1336612631	1	0.02	0.00133333333333333	5425	1
2	Drink 1	Intake 1	15	59009	1336612697	/users/cn/jespinosa/phecomp/data/CRG/20120502_FDF_CRG/20120502_FDF_CRG/20120509_FDF_CRG_c12.mtb	663	NA	WWFF	water	1	58994	1336612682	1	0.04	0.00266666666666667	5426	1
2	Drink 1	Intake 1	14	59512	1336613200	/users/cn/jespinosa/phecomp/data/CRG/20120502_FDF_CRG/20120502_FDF_CRG/20120509_FDF_CRG_c12.mtb	664	NA	WWFF	water	1	59498	1336613186	1	0.02	0.00142857142857143	5427	1
2	Drink 2	Intake 2	24	60422	1336614110	/users/cn/jespinosa/phecomp/data/CRG/20120502_FDF_CRG/20120502_FDF_CRG/20120509_FDF_CRG_c12.mtb	1098	NA	WWFF	water	2	60398	1336614086	1	0.0600000000000001	0.0025	5428	1
2	Drink 2	Intake 2	20	61913	1336615601	/users/cn/jespinosa/phecomp/data/CRG/20120502_FDF_CRG/20120502_FDF_CRG/20120509_FDF_CRG_c12.mtb	1099	NA	WWFF	water	2	61893	1336615581	1	0.0399999999999998	0.00199999999999999	5429	1
2	Drink 2	Intake 2	22	62272	1336615960	/users/cn/jespinosa/phecomp/data/CRG/20120502_FDF_CRG/20120502_FDF_CRG/20120509_FDF_CRG_c12.mtb	1100	NA	WWFF	water	2	62250	1336615938	1	0.0600000000000001	0.00272727272727273	5430	1
2	Food 1	Intake 3	37	62394	1336616082	/users/cn/jespinosa/phecomp/data/CRG/20120502_FDF_CRG/20120502_FDF_CRG/20120509_FDF_CRG_c12.mtb	1366	656	WWFF	food_fat	3	62357	1336616045	1	0.04	0.00108108108108108	5431	1
2	Drink 1	Intake 1	21	62993	1336616681	/users/cn/jespinosa/phecomp/data/CRG/20120502_FDF_CRG/20120502_FDF_CRG/20120509_FDF_CRG_c12.mtb	665	NA	WWFF	water	1	62972	1336616660	1	0.06	0.00285714285714286	5432	1
2	Food 2	Intake 4	84	63134	1336616822	/users/cn/jespinosa/phecomp/data/CRG/20120502_FDF_CRG/20120502_FDF_CRG/20120509_FDF_CRG_c12.mtb	2257	4370	WWFF	food_fat	4	63050	1336616738	1	0.02	0.000238095238095238	5433	1
2	Drink 2	Intake 2	21	67230	1336620918	/users/cn/jespinosa/phecomp/data/CRG/20120502_FDF_CRG/20120502_FDF_CRG/20120509_FDF_CRG_c12.mtb	1102	NA	WWFF	water	2	67209	1336620897	1	0.04	0.0019047619047619	5434	1
2	Drink 1	Intake 1	16	67496	1336621184	/users/cn/jespinosa/phecomp/data/CRG/20120502_FDF_CRG/20120502_FDF_CRG/20120509_FDF_CRG_c12.mtb	666	NA	WWFF	water	1	67480	1336621168	1	0.04	0.0025	5435	1
2	Food 1	Intake 3	37	67541	1336621229	/users/cn/jespinosa/phecomp/data/CRG/20120502_FDF_CRG/20120502_FDF_CRG/20120509_FDF_CRG_c12.mtb	1367	3771	WWFF	food_fat	3	67504	1336621192	1	0.0200000000000005	0.000540540540540554	5436	1
2	Drink 2	Intake 2	18	67679	1336621367	/users/cn/jespinosa/phecomp/data/CRG/20120502_FDF_CRG/20120502_FDF_CRG/20120509_FDF_CRG_c12.mtb	1103	NA	WWFF	water	2	67661	1336621349	1	0.0600000000000001	0.00333333333333334	5437	1
2	Drink 2	Intake 2	23	68467	1336622155	/users/cn/jespinosa/phecomp/data/CRG/20120502_FDF_CRG/20120502_FDF_CRG/20120509_FDF_CRG_c12.mtb	1104	NA	WWFF	water	2	68444	1336622132	1	0.0599999999999998	0.0026086956521739	5438	1
2	Food 2	Intake 4	65	71377	1336625065	/users/cn/jespinosa/phecomp/data/CRG/20120502_FDF_CRG/20120502_FDF_CRG/20120509_FDF_CRG_c12.mtb	2260	5157	WWFF	food_fat	4	71312	1336625000	1	0.02	0.000307692307692308	5439	1
2	Drink 2	Intake 2	16	71670	1336625358	/users/cn/jespinosa/phecomp/data/CRG/20120502_FDF_CRG/20120502_FDF_CRG/20120509_FDF_CRG_c12.mtb	1105	NA	WWFF	water	2	71654	1336625342	1	0.04	0.0025	5440	1
2	Drink 2	Intake 2	20	72295	1336625983	/users/cn/jespinosa/phecomp/data/CRG/20120502_FDF_CRG/20120502_FDF_CRG/20120509_FDF_CRG_c12.mtb	1108	NA	WWFF	water	2	72275	1336625963	1	0.0600000000000001	0.00300000000000001	5441	1
2	Drink 2	Intake 2	17	72894	1336626582	/users/cn/jespinosa/phecomp/data/CRG/20120502_FDF_CRG/20120502_FDF_CRG/20120509_FDF_CRG_c12.mtb	1109	NA	WWFF	water	2	72877	1336626565	1	0.02	0.00117647058823529	5442	1
2	Drink 2	Intake 2	23	73156	1336626844	/users/cn/jespinosa/phecomp/data/CRG/20120502_FDF_CRG/20120502_FDF_CRG/20120509_FDF_CRG_c12.mtb	1110	NA	WWFF	water	2	73133	1336626821	1	0.02	0.000869565217391304	5443	1
2	Drink 2	Intake 2	20	73552	1336627240	/users/cn/jespinosa/phecomp/data/CRG/20120502_FDF_CRG/20120502_FDF_CRG/20120509_FDF_CRG_c12.mtb	1111	NA	WWFF	water	2	73532	1336627220	1	0.0800000000000001	0.00400000000000001	5444	1
2	Food 2	Intake 4	32	76566	1336630254	/users/cn/jespinosa/phecomp/data/CRG/20120502_FDF_CRG/20120502_FDF_CRG/20120509_FDF_CRG_c12.mtb	2265	11395	WWFF	food_fat	4	76534	1336630222	1	0.02	0.000625	5445	1
2	Drink 2	Intake 2	22	76636	1336630324	/users/cn/jespinosa/phecomp/data/CRG/20120502_FDF_CRG/20120502_FDF_CRG/20120509_FDF_CRG_c12.mtb	1114	NA	WWFF	water	2	76614	1336630302	1	0.04	0.00181818181818182	5446	1
2	Drink 2	Intake 2	31	81258	1336634946	/users/cn/jespinosa/phecomp/data/CRG/20120502_FDF_CRG/20120502_FDF_CRG/20120509_FDF_CRG_c12.mtb	1116	NA	WWFF	water	2	81227	1336634915	1	0.0999999999999999	0.0032258064516129	5447	1
2	Drink 1	Intake 1	9	86830	1336640518	/users/cn/jespinosa/phecomp/data/CRG/20120502_FDF_CRG/20120502_FDF_CRG/20120509_FDF_CRG_c12.mtb	669	NA	WWFF	water	1	86821	1336640509	1	0.02	0.00222222222222222	5448	1
2	Drink 2	Intake 2	37	87562	1336641250	/users/cn/jespinosa/phecomp/data/CRG/20120502_FDF_CRG/20120502_FDF_CRG/20120509_FDF_CRG_c12.mtb	1122	NA	WWFF	water	2	87525	1336641213	1	0.0599999999999998	0.00162162162162162	5449	1
2	Food 1	Intake 3	121	88082	1336641770	/users/cn/jespinosa/phecomp/data/CRG/20120502_FDF_CRG/20120502_FDF_CRG/20120509_FDF_CRG_c12.mtb	1378	331	WWFF	food_fat	3	87961	1336641649	1	0.26	0.00214876033057851	5450	1
2	Drink 2	Intake 2	20	88412	1336642100	/users/cn/jespinosa/phecomp/data/CRG/20120502_FDF_CRG/20120502_FDF_CRG/20120509_FDF_CRG_c12.mtb	1124	NA	WWFF	water	2	88392	1336642080	1	0.02	0.001	5451	1
2	Food 1	Intake 3	49	88462	1336642150	/users/cn/jespinosa/phecomp/data/CRG/20120502_FDF_CRG/20120502_FDF_CRG/20120509_FDF_CRG_c12.mtb	1379	4893	WWFF	food_fat	3	88413	1336642101	1	0.04	0.000816326530612245	5452	1
2	Food 1	Intake 3	12	93367	1336647055	/users/cn/jespinosa/phecomp/data/CRG/20120502_FDF_CRG/20120502_FDF_CRG/20120509_FDF_CRG_c12.mtb	1380	13	WWFF	food_fat	3	93355	1336647043	1	0.04	0.00333333333333333	5453	1
2	Food 1	Intake 3	35	93415	1336647103	/users/cn/jespinosa/phecomp/data/CRG/20120502_FDF_CRG/20120502_FDF_CRG/20120509_FDF_CRG_c12.mtb	1381	1626	WWFF	food_fat	3	93380	1336647068	1	0.04	0.00114285714285714	5454	1
2	Drink 2	Intake 2	26	93460	1336647148	/users/cn/jespinosa/phecomp/data/CRG/20120502_FDF_CRG/20120502_FDF_CRG/20120509_FDF_CRG_c12.mtb	1127	NA	WWFF	water	2	93434	1336647122	1	0.04	0.00153846153846154	5455	1
2	Drink 2	Intake 2	16	94946	1336648634	/users/cn/jespinosa/phecomp/data/CRG/20120502_FDF_CRG/20120502_FDF_CRG/20120509_FDF_CRG_c12.mtb	1128	NA	WWFF	water	2	94930	1336648618	1	0.04	0.0025	5456	1
2	Food 1	Intake 3	59	95100	1336648788	/users/cn/jespinosa/phecomp/data/CRG/20120502_FDF_CRG/20120502_FDF_CRG/20120509_FDF_CRG_c12.mtb	1382	6328	WWFF	food_fat	3	95041	1336648729	1	0.0599999999999996	0.00101694915254237	5457	1
2	Drink 1	Intake 1	20	95226	1336648914	/users/cn/jespinosa/phecomp/data/CRG/20120502_FDF_CRG/20120502_FDF_CRG/20120509_FDF_CRG_c12.mtb	672	NA	WWFF	water	1	95206	1336648894	1	0.04	0.002	5458	1
2	Drink 2	Intake 2	24	95468	1336649156	/users/cn/jespinosa/phecomp/data/CRG/20120502_FDF_CRG/20120502_FDF_CRG/20120509_FDF_CRG_c12.mtb	1129	NA	WWFF	water	2	95444	1336649132	1	0.04	0.00166666666666667	5459	1
2	Drink 2	Intake 2	34	96238	1336649926	/users/cn/jespinosa/phecomp/data/CRG/20120502_FDF_CRG/20120502_FDF_CRG/20120509_FDF_CRG_c12.mtb	1130	NA	WWFF	water	2	96204	1336649892	1	0.02	0.000588235294117647	5460	1
2	Drink 2	Intake 2	13	97016	1336650704	/users/cn/jespinosa/phecomp/data/CRG/20120502_FDF_CRG/20120502_FDF_CRG/20120509_FDF_CRG_c12.mtb	1131	NA	WWFF	water	2	97003	1336650691	1	0.04	0.00307692307692308	5461	1
2	Food 1	Intake 3	16	101444	1336655132	/users/cn/jespinosa/phecomp/data/CRG/20120502_FDF_CRG/20120502_FDF_CRG/20120509_FDF_CRG_c12.mtb	1383	8	WWFF	food_fat	3	101428	1336655116	1	0.04	0.0025	5462	1
2	Food 1	Intake 3	28	101480	1336655168	/users/cn/jespinosa/phecomp/data/CRG/20120502_FDF_CRG/20120502_FDF_CRG/20120509_FDF_CRG_c12.mtb	1384	4	WWFF	food_fat	3	101452	1336655140	1	0.0600000000000005	0.00214285714285716	5463	1
2	Food 1	Intake 3	43	101527	1336655215	/users/cn/jespinosa/phecomp/data/CRG/20120502_FDF_CRG/20120502_FDF_CRG/20120509_FDF_CRG_c12.mtb	1385	2507	WWFF	food_fat	3	101484	1336655172	1	0.0599999999999996	0.00139534883720929	5464	1
2	Food 1	Intake 3	38	104072	1336657760	/users/cn/jespinosa/phecomp/data/CRG/20120502_FDF_CRG/20120502_FDF_CRG/20120509_FDF_CRG_c12.mtb	1386	2260	WWFF	food_fat	3	104034	1336657722	1	0.0800000000000001	0.00210526315789474	5465	1
2	Food 1	Intake 3	23	106355	1336660043	/users/cn/jespinosa/phecomp/data/CRG/20120502_FDF_CRG/20120502_FDF_CRG/20120509_FDF_CRG_c12.mtb	1387	14	WWFF	food_fat	3	106332	1336660020	1	0.04	0.00173913043478261	5466	1
2	Food 2	Intake 4	16	106385	1336660073	/users/cn/jespinosa/phecomp/data/CRG/20120502_FDF_CRG/20120502_FDF_CRG/20120509_FDF_CRG_c12.mtb	2271	2543	WWFF	food_fat	4	106369	1336660057	1	0.28	0.0175	5467	1
2	Drink 2	Intake 2	25	107416	1336661104	/users/cn/jespinosa/phecomp/data/CRG/20120502_FDF_CRG/20120502_FDF_CRG/20120509_FDF_CRG_c12.mtb	1132	NA	WWFF	water	2	107391	1336661079	1	0.0600000000000001	0.0024	5468	1
2	Food 1	Intake 3	36	108964	1336662652	/users/cn/jespinosa/phecomp/data/CRG/20120502_FDF_CRG/20120502_FDF_CRG/20120509_FDF_CRG_c12.mtb	1388	2173	WWFF	food_fat	3	108928	1336662616	1	0.0600000000000005	0.00166666666666668	5469	1
2	Food 1	Intake 3	30	111167	1336664855	/users/cn/jespinosa/phecomp/data/CRG/20120502_FDF_CRG/20120502_FDF_CRG/20120509_FDF_CRG_c12.mtb	1389	11101	WWFF	food_fat	3	111137	1336664825	1	0.0399999999999991	0.0013333333333333	5470	1
2	Drink 1	Intake 1	40	115149	1336668837	/users/cn/jespinosa/phecomp/data/CRG/20120502_FDF_CRG/20120502_FDF_CRG/20120509_FDF_CRG_c12.mtb	673	NA	WWFF	water	1	115109	1336668797	1	0.06	0.0015	5471	1
2	Drink 1	Intake 1	21	121785	1336675473	/users/cn/jespinosa/phecomp/data/CRG/20120502_FDF_CRG/20120502_FDF_CRG/20120509_FDF_CRG_c12.mtb	674	NA	WWFF	water	1	121764	1336675452	1	0.12	0.00571428571428571	5472	1
2	Food 1	Intake 3	60	122328	1336676016	/users/cn/jespinosa/phecomp/data/CRG/20120502_FDF_CRG/20120502_FDF_CRG/20120509_FDF_CRG_c12.mtb	1391	3347	WWFF	food_fat	3	122268	1336675956	1	0.140000000000001	0.00233333333333335	5473	1
2	Drink 2	Intake 2	16	123796	1336677484	/users/cn/jespinosa/phecomp/data/CRG/20120502_FDF_CRG/20120502_FDF_CRG/20120509_FDF_CRG_c12.mtb	1135	NA	WWFF	water	2	123780	1336677468	1	0.02	0.00125	5474	1
2	Drink 2	Intake 2	15	124329	1336678017	/users/cn/jespinosa/phecomp/data/CRG/20120502_FDF_CRG/20120502_FDF_CRG/20120509_FDF_CRG_c12.mtb	1136	NA	WWFF	water	2	124314	1336678002	1	0.04	0.00266666666666667	5475	1
2	Food 2	Intake 4	88	125763	1336679451	/users/cn/jespinosa/phecomp/data/CRG/20120502_FDF_CRG/20120502_FDF_CRG/20120509_FDF_CRG_c12.mtb	2276	326	WWFF	food_fat	4	125675	1336679363	1	0.02	0.000227272727272727	5476	1
2	Food 2	Intake 4	63	126152	1336679840	/users/cn/jespinosa/phecomp/data/CRG/20120502_FDF_CRG/20120502_FDF_CRG/20120509_FDF_CRG_c12.mtb	2278	104	WWFF	food_fat	4	126089	1336679777	1	0.02	0.000317460317460317	5477	1
2	Food 2	Intake 4	96	126352	1336680040	/users/cn/jespinosa/phecomp/data/CRG/20120502_FDF_CRG/20120502_FDF_CRG/20120509_FDF_CRG_c12.mtb	2279	99	WWFF	food_fat	4	126256	1336679944	1	0.0999999999999999	0.00104166666666667	5478	1
2	Food 2	Intake 4	147	126598	1336680286	/users/cn/jespinosa/phecomp/data/CRG/20120502_FDF_CRG/20120502_FDF_CRG/20120509_FDF_CRG_c12.mtb	2280	205	WWFF	food_fat	4	126451	1336680139	1	0.0800000000000001	0.000544217687074831	5479	1
2	Food 2	Intake 4	72	126875	1336680563	/users/cn/jespinosa/phecomp/data/CRG/20120502_FDF_CRG/20120502_FDF_CRG/20120509_FDF_CRG_c12.mtb	2281	871	WWFF	food_fat	4	126803	1336680491	1	0.12	0.00166666666666667	5480	1
2	Food 2	Intake 4	44	127790	1336681478	/users/cn/jespinosa/phecomp/data/CRG/20120502_FDF_CRG/20120502_FDF_CRG/20120509_FDF_CRG_c12.mtb	2284	16	WWFF	food_fat	4	127746	1336681434	1	0.04	0.000909090909090909	5481	1
2	Food 2	Intake 4	129	127935	1336681623	/users/cn/jespinosa/phecomp/data/CRG/20120502_FDF_CRG/20120502_FDF_CRG/20120509_FDF_CRG_c12.mtb	2285	116	WWFF	food_fat	4	127806	1336681494	1	0.14	0.00108527131782946	5482	1
2	Food 2	Intake 4	13	128064	1336681752	/users/cn/jespinosa/phecomp/data/CRG/20120502_FDF_CRG/20120502_FDF_CRG/20120509_FDF_CRG_c12.mtb	2286	295	WWFF	food_fat	4	128051	1336681739	1	0.0600000000000001	0.00461538461538462	5483	1
2	Food 2	Intake 4	16	128375	1336682063	/users/cn/jespinosa/phecomp/data/CRG/20120502_FDF_CRG/20120502_FDF_CRG/20120509_FDF_CRG_c12.mtb	2288	187	WWFF	food_fat	4	128359	1336682047	1	0.02	0.00125	5484	1
2	Drink 2	Intake 2	20	128391	1336682079	/users/cn/jespinosa/phecomp/data/CRG/20120502_FDF_CRG/20120502_FDF_CRG/20120509_FDF_CRG_c12.mtb	1142	NA	WWFF	water	2	128371	1336682059	1	0.02	0.001	5485	1
2	Food 2	Intake 4	14	128576	1336682264	/users/cn/jespinosa/phecomp/data/CRG/20120502_FDF_CRG/20120502_FDF_CRG/20120509_FDF_CRG_c12.mtb	2290	9	WWFF	food_fat	4	128562	1336682250	1	0.04	0.00285714285714286	5486	1
2	Food 2	Intake 4	65	128650	1336682338	/users/cn/jespinosa/phecomp/data/CRG/20120502_FDF_CRG/20120502_FDF_CRG/20120509_FDF_CRG_c12.mtb	2291	121	WWFF	food_fat	4	128585	1336682273	1	0.02	0.000307692307692308	5487	1
2	Food 2	Intake 4	16	128787	1336682475	/users/cn/jespinosa/phecomp/data/CRG/20120502_FDF_CRG/20120502_FDF_CRG/20120509_FDF_CRG_c12.mtb	2293	1827	WWFF	food_fat	4	128771	1336682459	1	0.0600000000000001	0.00375000000000001	5488	1
2	Food 2	Intake 4	20	130634	1336684322	/users/cn/jespinosa/phecomp/data/CRG/20120502_FDF_CRG/20120502_FDF_CRG/20120509_FDF_CRG_c12.mtb	2296	65	WWFF	food_fat	4	130614	1336684302	1	0.02	0.001	5489	1
2	Food 2	Intake 4	35	130734	1336684422	/users/cn/jespinosa/phecomp/data/CRG/20120502_FDF_CRG/20120502_FDF_CRG/20120509_FDF_CRG_c12.mtb	2298	781	WWFF	food_fat	4	130699	1336684387	1	0.1	0.00285714285714286	5490	1
2	Drink 1	Intake 1	12	130979	1336684667	/users/cn/jespinosa/phecomp/data/CRG/20120502_FDF_CRG/20120502_FDF_CRG/20120509_FDF_CRG_c12.mtb	677	NA	WWFF	water	1	130967	1336684655	1	0.04	0.00333333333333333	5491	1
2	Drink 1	Intake 1	21	131323	1336685011	/users/cn/jespinosa/phecomp/data/CRG/20120502_FDF_CRG/20120502_FDF_CRG/20120509_FDF_CRG_c12.mtb	678	NA	WWFF	water	1	131302	1336684990	1	0.0599999999999999	0.00285714285714285	5492	1
2	Food 2	Intake 4	234	131749	1336685437	/users/cn/jespinosa/phecomp/data/CRG/20120502_FDF_CRG/20120502_FDF_CRG/20120509_FDF_CRG_c12.mtb	2302	499	WWFF	food_fat	4	131515	1336685203	1	0.28	0.0011965811965812	5493	1
2	Food 2	Intake 4	61	132309	1336685997	/users/cn/jespinosa/phecomp/data/CRG/20120502_FDF_CRG/20120502_FDF_CRG/20120509_FDF_CRG_c12.mtb	2303	198	WWFF	food_fat	4	132248	1336685936	1	0.02	0.000327868852459016	5494	1
2	Food 2	Intake 4	97	132604	1336686292	/users/cn/jespinosa/phecomp/data/CRG/20120502_FDF_CRG/20120502_FDF_CRG/20120509_FDF_CRG_c12.mtb	2305	11	WWFF	food_fat	4	132507	1336686195	1	0.02	0.000206185567010309	5495	1
2	Food 2	Intake 4	229	132844	1336686532	/users/cn/jespinosa/phecomp/data/CRG/20120502_FDF_CRG/20120502_FDF_CRG/20120509_FDF_CRG_c12.mtb	2306	2593	WWFF	food_fat	4	132615	1336686303	1	0.24	0.00104803493449782	5496	1
2	Drink 2	Intake 2	26	133036	1336686724	/users/cn/jespinosa/phecomp/data/CRG/20120502_FDF_CRG/20120502_FDF_CRG/20120509_FDF_CRG_c12.mtb	1144	NA	WWFF	water	2	133010	1336686698	1	0.0800000000000001	0.00307692307692308	5497	1
2	Food 2	Intake 4	34	135471	1336689159	/users/cn/jespinosa/phecomp/data/CRG/20120502_FDF_CRG/20120502_FDF_CRG/20120509_FDF_CRG_c12.mtb	2308	1226	WWFF	food_fat	4	135437	1336689125	1	0.12	0.00352941176470588	5498	1
2	Food 2	Intake 4	26	136723	1336690411	/users/cn/jespinosa/phecomp/data/CRG/20120502_FDF_CRG/20120502_FDF_CRG/20120509_FDF_CRG_c12.mtb	2310	646	WWFF	food_fat	4	136697	1336690385	1	0.12	0.00461538461538461	5499	1
2	Drink 2	Intake 2	23	136738	1336690426	/users/cn/jespinosa/phecomp/data/CRG/20120502_FDF_CRG/20120502_FDF_CRG/20120509_FDF_CRG_c12.mtb	1145	NA	WWFF	water	2	136715	1336690403	1	0.0599999999999996	0.0026086956521739	5500	1
2	Drink 2	Intake 2	16	136862	1336690550	/users/cn/jespinosa/phecomp/data/CRG/20120502_FDF_CRG/20120502_FDF_CRG/20120509_FDF_CRG_c12.mtb	1146	NA	WWFF	water	2	136846	1336690534	1	0.04	0.0025	5501	1
2	Food 2	Intake 4	91	137460	1336691148	/users/cn/jespinosa/phecomp/data/CRG/20120502_FDF_CRG/20120502_FDF_CRG/20120509_FDF_CRG_c12.mtb	2312	557	WWFF	food_fat	4	137369	1336691057	1	0.0600000000000001	0.00065934065934066	5502	1
2	Drink 1	Intake 1	31	137462	1336691150	/users/cn/jespinosa/phecomp/data/CRG/20120502_FDF_CRG/20120502_FDF_CRG/20120509_FDF_CRG_c12.mtb	680	NA	WWFF	water	1	137431	1336691119	1	0.02	0.000645161290322581	5503	1
2	Drink 1	Intake 1	15	137528	1336691216	/users/cn/jespinosa/phecomp/data/CRG/20120502_FDF_CRG/20120502_FDF_CRG/20120509_FDF_CRG_c12.mtb	681	NA	WWFF	water	1	137513	1336691201	1	0.02	0.00133333333333333	5504	1
2	Food 2	Intake 4	436	138453	1336692141	/users/cn/jespinosa/phecomp/data/CRG/20120502_FDF_CRG/20120502_FDF_CRG/20120509_FDF_CRG_c12.mtb	2318	25	WWFF	food_fat	4	138017	1336691705	1	0.0799999999999998	0.00018348623853211	5505	1
2	Food 2	Intake 4	36	138514	1336692202	/users/cn/jespinosa/phecomp/data/CRG/20120502_FDF_CRG/20120502_FDF_CRG/20120509_FDF_CRG_c12.mtb	2319	370	WWFF	food_fat	4	138478	1336692166	1	0.1	0.00277777777777778	5506	1
2	Drink 1	Intake 1	17	138536	1336692224	/users/cn/jespinosa/phecomp/data/CRG/20120502_FDF_CRG/20120502_FDF_CRG/20120509_FDF_CRG_c12.mtb	682	NA	WWFF	water	1	138519	1336692207	1	0.0399999999999999	0.00235294117647058	5507	1
2	Food 2	Intake 4	92	138976	1336692664	/users/cn/jespinosa/phecomp/data/CRG/20120502_FDF_CRG/20120502_FDF_CRG/20120509_FDF_CRG_c12.mtb	2323	19	WWFF	food_fat	4	138884	1336692572	1	0.04	0.000434782608695652	5508	1
2	Food 2	Intake 4	142	139137	1336692825	/users/cn/jespinosa/phecomp/data/CRG/20120502_FDF_CRG/20120502_FDF_CRG/20120509_FDF_CRG_c12.mtb	2324	155	WWFF	food_fat	4	138995	1336692683	1	0.04	0.00028169014084507	5509	1
2	Food 2	Intake 4	36	139328	1336693016	/users/cn/jespinosa/phecomp/data/CRG/20120502_FDF_CRG/20120502_FDF_CRG/20120509_FDF_CRG_c12.mtb	2327	113	WWFF	food_fat	4	139292	1336692980	1	0.02	0.000555555555555556	5510	1
2	Food 2	Intake 4	122	139563	1336693251	/users/cn/jespinosa/phecomp/data/CRG/20120502_FDF_CRG/20120502_FDF_CRG/20120509_FDF_CRG_c12.mtb	2330	270	WWFF	food_fat	4	139441	1336693129	1	0.0800000000000001	0.000655737704918034	5511	1
2	Food 2	Intake 4	38	139871	1336693559	/users/cn/jespinosa/phecomp/data/CRG/20120502_FDF_CRG/20120502_FDF_CRG/20120509_FDF_CRG_c12.mtb	2332	75	WWFF	food_fat	4	139833	1336693521	1	0.02	0.000526315789473684	5512	1
2	Drink 2	Intake 2	34	139897	1336693585	/users/cn/jespinosa/phecomp/data/CRG/20120502_FDF_CRG/20120502_FDF_CRG/20120509_FDF_CRG_c12.mtb	1148	NA	WWFF	water	2	139863	1336693551	1	0.0600000000000001	0.00176470588235294	5513	1
2	Food 2	Intake 4	58	140004	1336693692	/users/cn/jespinosa/phecomp/data/CRG/20120502_FDF_CRG/20120502_FDF_CRG/20120509_FDF_CRG_c12.mtb	2334	67	WWFF	food_fat	4	139946	1336693634	1	0.04	0.000689655172413793	5514	1
2	Food 2	Intake 4	17	140088	1336693776	/users/cn/jespinosa/phecomp/data/CRG/20120502_FDF_CRG/20120502_FDF_CRG/20120509_FDF_CRG_c12.mtb	2335	416	WWFF	food_fat	4	140071	1336693759	1	0.02	0.00117647058823529	5515	1
2	Food 2	Intake 4	28	140532	1336694220	/users/cn/jespinosa/phecomp/data/CRG/20120502_FDF_CRG/20120502_FDF_CRG/20120509_FDF_CRG_c12.mtb	2338	347	WWFF	food_fat	4	140504	1336694192	1	0.0600000000000001	0.00214285714285715	5516	1
2	Food 2	Intake 4	26	140905	1336694593	/users/cn/jespinosa/phecomp/data/CRG/20120502_FDF_CRG/20120502_FDF_CRG/20120509_FDF_CRG_c12.mtb	2343	236	WWFF	food_fat	4	140879	1336694567	1	0.04	0.00153846153846154	5517	1
2	Food 2	Intake 4	31	141172	1336694860	/users/cn/jespinosa/phecomp/data/CRG/20120502_FDF_CRG/20120502_FDF_CRG/20120509_FDF_CRG_c12.mtb	2345	336	WWFF	food_fat	4	141141	1336694829	1	0.02	0.000645161290322581	5518	1
2	Drink 2	Intake 2	19	141185	1336694873	/users/cn/jespinosa/phecomp/data/CRG/20120502_FDF_CRG/20120502_FDF_CRG/20120509_FDF_CRG_c12.mtb	1149	NA	WWFF	water	2	141166	1336694854	1	0.04	0.00210526315789474	5519	1
2	Food 2	Intake 4	112	141620	1336695308	/users/cn/jespinosa/phecomp/data/CRG/20120502_FDF_CRG/20120502_FDF_CRG/20120509_FDF_CRG_c12.mtb	2348	81	WWFF	food_fat	4	141508	1336695196	1	0.02	0.000178571428571429	5520	1
2	Food 2	Intake 4	38	141739	1336695427	/users/cn/jespinosa/phecomp/data/CRG/20120502_FDF_CRG/20120502_FDF_CRG/20120509_FDF_CRG_c12.mtb	2349	1467	WWFF	food_fat	4	141701	1336695389	1	0.02	0.000526315789473684	5521	1
2	Food 2	Intake 4	118	143324	1336697012	/users/cn/jespinosa/phecomp/data/CRG/20120502_FDF_CRG/20120502_FDF_CRG/20120509_FDF_CRG_c12.mtb	2359	604	WWFF	food_fat	4	143206	1336696894	1	0.0600000000000001	0.000508474576271187	5522	1
2	Drink 2	Intake 2	36	143610	1336697298	/users/cn/jespinosa/phecomp/data/CRG/20120502_FDF_CRG/20120502_FDF_CRG/20120509_FDF_CRG_c12.mtb	1152	NA	WWFF	water	2	143574	1336697262	1	0.02	0.000555555555555556	5523	1
2	Food 2	Intake 4	12	143940	1336697628	/users/cn/jespinosa/phecomp/data/CRG/20120502_FDF_CRG/20120502_FDF_CRG/20120509_FDF_CRG_c12.mtb	2369	111	WWFF	food_fat	4	143928	1336697616	1	0.02	0.00166666666666667	5524	1
2	Food 2	Intake 4	32	144083	1336697771	/users/cn/jespinosa/phecomp/data/CRG/20120502_FDF_CRG/20120502_FDF_CRG/20120509_FDF_CRG_c12.mtb	2371	5513	WWFF	food_fat	4	144051	1336697739	1	0.04	0.00125	5525	1
2	Drink 1	Intake 1	16	146266	1336699954	/users/cn/jespinosa/phecomp/data/CRG/20120502_FDF_CRG/20120502_FDF_CRG/20120509_FDF_CRG_c12.mtb	683	NA	WWFF	water	1	146250	1336699938	1	0.02	0.00125	5526	1
2	Food 2	Intake 4	16	149612	1336703300	/users/cn/jespinosa/phecomp/data/CRG/20120502_FDF_CRG/20120502_FDF_CRG/20120509_FDF_CRG_c12.mtb	2376	299	WWFF	food_fat	4	149596	1336703284	1	0.02	0.00125	5527	1
2	Food 1	Intake 3	31	149942	1336703630	/users/cn/jespinosa/phecomp/data/CRG/20120502_FDF_CRG/20120502_FDF_CRG/20120509_FDF_CRG_c12.mtb	1407	14	WWFF	food_fat	3	149911	1336703599	1	0.0599999999999996	0.00193548387096773	5528	1
2	Food 1	Intake 3	74	150030	1336703718	/users/cn/jespinosa/phecomp/data/CRG/20120502_FDF_CRG/20120502_FDF_CRG/20120509_FDF_CRG_c12.mtb	1408	226	WWFF	food_fat	3	149956	1336703644	1	0.0800000000000001	0.00108108108108108	5529	1
2	Food 1	Intake 3	62	150318	1336704006	/users/cn/jespinosa/phecomp/data/CRG/20120502_FDF_CRG/20120502_FDF_CRG/20120509_FDF_CRG_c12.mtb	1409	COLL	WWFF	food_fat	3	150256	1336703944	1	0.28	0.00451612903225806	5530	1
2	Food 2	Intake 4	44	150340	1336704028	/users/cn/jespinosa/phecomp/data/CRG/20120502_FDF_CRG/20120502_FDF_CRG/20120509_FDF_CRG_c12.mtb	2383	434	WWFF	food_fat	4	150296	1336703984	1	0.0800000000000001	0.00181818181818182	5531	1
2	Food 2	Intake 4	86	150860	1336704548	/users/cn/jespinosa/phecomp/data/CRG/20120502_FDF_CRG/20120502_FDF_CRG/20120509_FDF_CRG_c12.mtb	2388	30	WWFF	food_fat	4	150774	1336704462	1	0.02	0.000232558139534884	5532	1
2	Food 2	Intake 4	282	151172	1336704860	/users/cn/jespinosa/phecomp/data/CRG/20120502_FDF_CRG/20120502_FDF_CRG/20120509_FDF_CRG_c12.mtb	2389	COLL	WWFF	food_fat	4	150890	1336704578	1	0.1	0.000354609929078014	5533	1
2	Food 1	Intake 3	173	151114	1336704802	/users/cn/jespinosa/phecomp/data/CRG/20120502_FDF_CRG/20120502_FDF_CRG/20120509_FDF_CRG_c12.mtb	1410	8	WWFF	food_fat	3	150941	1336704629	1	0.359999999999999	0.00208092485549132	5534	1
2	Food 1	Intake 3	49	151171	1336704859	/users/cn/jespinosa/phecomp/data/CRG/20120502_FDF_CRG/20120502_FDF_CRG/20120509_FDF_CRG_c12.mtb	1411	82	WWFF	food_fat	3	151122	1336704810	1	0.0600000000000005	0.00122448979591838	5535	1
2	Food 2	Intake 4	14	151267	1336704955	/users/cn/jespinosa/phecomp/data/CRG/20120502_FDF_CRG/20120502_FDF_CRG/20120509_FDF_CRG_c12.mtb	2390	68	WWFF	food_fat	4	151253	1336704941	1	0.0599999999999996	0.00428571428571426	5536	1
2	Drink 2	Intake 2	28	151335	1336705023	/users/cn/jespinosa/phecomp/data/CRG/20120502_FDF_CRG/20120502_FDF_CRG/20120509_FDF_CRG_c12.mtb	1154	NA	WWFF	water	2	151307	1336704995	1	0.0800000000000001	0.00285714285714286	5537	1
2	Food 2	Intake 4	173	151508	1336705196	/users/cn/jespinosa/phecomp/data/CRG/20120502_FDF_CRG/20120502_FDF_CRG/20120509_FDF_CRG_c12.mtb	2391	COLL	WWFF	food_fat	4	151335	1336705023	1	0.0600000000000001	0.000346820809248555	5538	1
2	Food 1	Intake 3	136	151503	1336705191	/users/cn/jespinosa/phecomp/data/CRG/20120502_FDF_CRG/20120502_FDF_CRG/20120509_FDF_CRG_c12.mtb	1412	277	WWFF	food_fat	3	151367	1336705055	1	0.4	0.00294117647058824	5539	1
2	Drink 1	Intake 1	23	151754	1336705442	/users/cn/jespinosa/phecomp/data/CRG/20120502_FDF_CRG/20120502_FDF_CRG/20120509_FDF_CRG_c12.mtb	685	NA	WWFF	water	1	151731	1336705419	1	0.0800000000000001	0.00347826086956522	5540	1
2	Food 1	Intake 3	183	151963	1336705651	/users/cn/jespinosa/phecomp/data/CRG/20120502_FDF_CRG/20120502_FDF_CRG/20120509_FDF_CRG_c12.mtb	1413	COLL	WWFF	food_fat	3	151780	1336705468	1	0.38	0.00207650273224044	5541	1
2	Food 2	Intake 4	81	151965	1336705653	/users/cn/jespinosa/phecomp/data/CRG/20120502_FDF_CRG/20120502_FDF_CRG/20120509_FDF_CRG_c12.mtb	2393	218	WWFF	food_fat	4	151884	1336705572	1	0.0800000000000001	0.000987654320987656	5542	1
2	Food 1	Intake 3	66	152249	1336705937	/users/cn/jespinosa/phecomp/data/CRG/20120502_FDF_CRG/20120502_FDF_CRG/20120509_FDF_CRG_c12.mtb	1414	39	WWFF	food_fat	3	152183	1336705871	1	0.14	0.00212121212121212	5543	1
2	Food 2	Intake 4	13	152301	1336705989	/users/cn/jespinosa/phecomp/data/CRG/20120502_FDF_CRG/20120502_FDF_CRG/20120509_FDF_CRG_c12.mtb	2395	101	WWFF	food_fat	4	152288	1336705976	1	0.04	0.00307692307692308	5544	1
2	Food 2	Intake 4	128	152530	1336706218	/users/cn/jespinosa/phecomp/data/CRG/20120502_FDF_CRG/20120502_FDF_CRG/20120509_FDF_CRG_c12.mtb	2398	COLL	WWFF	food_fat	4	152402	1336706090	1	0.04	0.0003125	5545	1
2	Food 1	Intake 3	103	152529	1336706217	/users/cn/jespinosa/phecomp/data/CRG/20120502_FDF_CRG/20120502_FDF_CRG/20120509_FDF_CRG_c12.mtb	1415	116	WWFF	food_fat	3	152426	1336706114	1	0.26	0.00252427184466019	5546	1
2	Food 2	Intake 4	15	152660	1336706348	/users/cn/jespinosa/phecomp/data/CRG/20120502_FDF_CRG/20120502_FDF_CRG/20120509_FDF_CRG_c12.mtb	2399	2207	WWFF	food_fat	4	152645	1336706333	1	0.02	0.00133333333333333	5547	1
2	Drink 2	Intake 2	16	154840	1336708528	/users/cn/jespinosa/phecomp/data/CRG/20120502_FDF_CRG/20120502_FDF_CRG/20120509_FDF_CRG_c12.mtb	1155	NA	WWFF	water	2	154824	1336708512	1	0.02	0.00125	5548	1
2	Food 1	Intake 3	82	154949	1336708637	/users/cn/jespinosa/phecomp/data/CRG/20120502_FDF_CRG/20120502_FDF_CRG/20120509_FDF_CRG_c12.mtb	1416	72	WWFF	food_fat	3	154867	1336708555	1	0.32	0.00390243902439024	5549	1
2	Food 1	Intake 3	62	155083	1336708771	/users/cn/jespinosa/phecomp/data/CRG/20120502_FDF_CRG/20120502_FDF_CRG/20120509_FDF_CRG_c12.mtb	1417	9	WWFF	food_fat	3	155021	1336708709	1	0.12	0.00193548387096774	5550	1
2	Food 1	Intake 3	105	155197	1336708885	/users/cn/jespinosa/phecomp/data/CRG/20120502_FDF_CRG/20120502_FDF_CRG/20120509_FDF_CRG_c12.mtb	1418	COLL	WWFF	food_fat	3	155092	1336708780	1	0.6	0.00571428571428571	5551	1
2	Food 2	Intake 4	149	155315	1336709003	/users/cn/jespinosa/phecomp/data/CRG/20120502_FDF_CRG/20120502_FDF_CRG/20120509_FDF_CRG_c12.mtb	2407	COLL	WWFF	food_fat	4	155166	1336708854	1	0.0799999999999996	0.00053691275167785	5552	1
2	Food 1	Intake 3	109	155315	1336709003	/users/cn/jespinosa/phecomp/data/CRG/20120502_FDF_CRG/20120502_FDF_CRG/20120509_FDF_CRG_c12.mtb	1419	72	WWFF	food_fat	3	155206	1336708894	1	0.78	0.00715596330275229	5553	1
2	Food 2	Intake 4	16	155403	1336709091	/users/cn/jespinosa/phecomp/data/CRG/20120502_FDF_CRG/20120502_FDF_CRG/20120509_FDF_CRG_c12.mtb	2408	32	WWFF	food_fat	4	155387	1336709075	1	0.02	0.00125	5554	1
2	Drink 2	Intake 2	25	155417	1336709105	/users/cn/jespinosa/phecomp/data/CRG/20120502_FDF_CRG/20120502_FDF_CRG/20120509_FDF_CRG_c12.mtb	1156	NA	WWFF	water	2	155392	1336709080	1	0.0800000000000001	0.0032	5555	1
2	Food 1	Intake 3	38	155473	1336709161	/users/cn/jespinosa/phecomp/data/CRG/20120502_FDF_CRG/20120502_FDF_CRG/20120509_FDF_CRG_c12.mtb	1420	67	WWFF	food_fat	3	155435	1336709123	1	0.380000000000001	0.01	5556	1
2	Food 2	Intake 4	365	155905	1336709593	/users/cn/jespinosa/phecomp/data/CRG/20120502_FDF_CRG/20120502_FDF_CRG/20120509_FDF_CRG_c12.mtb	2410	COLL	WWFF	food_fat	4	155540	1336709228	1	0.36	0.000986301369863014	5557	1
2	Food 1	Intake 3	27	155582	1336709270	/users/cn/jespinosa/phecomp/data/CRG/20120502_FDF_CRG/20120502_FDF_CRG/20120509_FDF_CRG_c12.mtb	1421	12	WWFF	food_fat	3	155555	1336709243	1	0.18	0.00666666666666667	5558	1
2	Food 1	Intake 3	123	155717	1336709405	/users/cn/jespinosa/phecomp/data/CRG/20120502_FDF_CRG/20120502_FDF_CRG/20120509_FDF_CRG_c12.mtb	1422	27	WWFF	food_fat	3	155594	1336709282	1	1.22	0.00991869918699187	5559	1
2	Food 1	Intake 3	50	155794	1336709482	/users/cn/jespinosa/phecomp/data/CRG/20120502_FDF_CRG/20120502_FDF_CRG/20120509_FDF_CRG_c12.mtb	1423	222	WWFF	food_fat	3	155744	1336709432	1	0.860000000000001	0.0172	5560	1
2	Food 2	Intake 4	27	156043	1336709731	/users/cn/jespinosa/phecomp/data/CRG/20120502_FDF_CRG/20120502_FDF_CRG/20120509_FDF_CRG_c12.mtb	2411	23	WWFF	food_fat	4	156016	1336709704	1	0.04	0.00148148148148148	5561	1
2	Drink 1	Intake 1	20	156051	1336709739	/users/cn/jespinosa/phecomp/data/CRG/20120502_FDF_CRG/20120502_FDF_CRG/20120509_FDF_CRG_c12.mtb	687	NA	WWFF	water	1	156031	1336709719	1	0.08	0.004	5562	1
2	Food 2	Intake 4	362	156428	1336710116	/users/cn/jespinosa/phecomp/data/CRG/20120502_FDF_CRG/20120502_FDF_CRG/20120509_FDF_CRG_c12.mtb	2412	COLL	WWFF	food_fat	4	156066	1336709754	1	0.7	0.00193370165745856	5563	1
2	Drink 1	Intake 1	16	156110	1336709798	/users/cn/jespinosa/phecomp/data/CRG/20120502_FDF_CRG/20120502_FDF_CRG/20120509_FDF_CRG_c12.mtb	688	NA	WWFF	water	1	156094	1336709782	1	0.02	0.00125	5564	1
2	Food 1	Intake 3	110	156248	1336709936	/users/cn/jespinosa/phecomp/data/CRG/20120502_FDF_CRG/20120502_FDF_CRG/20120509_FDF_CRG_c12.mtb	1425	469	WWFF	food_fat	3	156138	1336709826	1	0.0600000000000005	0.00054545454545455	5565	1
2	Food 2	Intake 4	719	157436	1336711124	/users/cn/jespinosa/phecomp/data/CRG/20120502_FDF_CRG/20120502_FDF_CRG/20120509_FDF_CRG_c12.mtb	2413	622	WWFF	food_fat	4	156717	1336710405	1	0.24	0.000333796940194715	5566	1
2	Drink 2	Intake 2	34	158064	1336711752	/users/cn/jespinosa/phecomp/data/CRG/20120502_FDF_CRG/20120502_FDF_CRG/20120509_FDF_CRG_c12.mtb	1159	NA	WWFF	water	2	158030	1336711718	1	0.02	0.000588235294117647	5567	1
2	Food 2	Intake 4	20	158078	1336711766	/users/cn/jespinosa/phecomp/data/CRG/20120502_FDF_CRG/20120502_FDF_CRG/20120509_FDF_CRG_c12.mtb	2414	608	WWFF	food_fat	4	158058	1336711746	1	0.02	0.001	5568	1
2	Drink 2	Intake 2	15	158634	1336712322	/users/cn/jespinosa/phecomp/data/CRG/20120502_FDF_CRG/20120502_FDF_CRG/20120509_FDF_CRG_c12.mtb	1160	NA	WWFF	water	2	158619	1336712307	1	0.02	0.00133333333333333	5569	1
2	Food 2	Intake 4	646	159332	1336713020	/users/cn/jespinosa/phecomp/data/CRG/20120502_FDF_CRG/20120502_FDF_CRG/20120509_FDF_CRG_c12.mtb	2416	22	WWFF	food_fat	4	158686	1336712374	1	0.18	0.000278637770897833	5570	1
2	Food 2	Intake 4	182	159536	1336713224	/users/cn/jespinosa/phecomp/data/CRG/20120502_FDF_CRG/20120502_FDF_CRG/20120509_FDF_CRG_c12.mtb	2417	244	WWFF	food_fat	4	159354	1336713042	1	0.0800000000000001	0.00043956043956044	5571	1
2	Food 2	Intake 4	168	159948	1336713636	/users/cn/jespinosa/phecomp/data/CRG/20120502_FDF_CRG/20120502_FDF_CRG/20120509_FDF_CRG_c12.mtb	2420	132	WWFF	food_fat	4	159780	1336713468	1	0.0600000000000001	0.000357142857142858	5572	1
2	Drink 2	Intake 2	20	159956	1336713644	/users/cn/jespinosa/phecomp/data/CRG/20120502_FDF_CRG/20120502_FDF_CRG/20120509_FDF_CRG_c12.mtb	1164	NA	WWFF	water	2	159936	1336713624	1	0.0799999999999996	0.00399999999999998	5573	1
2	Food 2	Intake 4	145	160225	1336713913	/users/cn/jespinosa/phecomp/data/CRG/20120502_FDF_CRG/20120502_FDF_CRG/20120509_FDF_CRG_c12.mtb	2422	50	WWFF	food_fat	4	160080	1336713768	1	0.04	0.000275862068965517	5574	1
2	Food 2	Intake 4	200	160475	1336714163	/users/cn/jespinosa/phecomp/data/CRG/20120502_FDF_CRG/20120502_FDF_CRG/20120509_FDF_CRG_c12.mtb	2424	302	WWFF	food_fat	4	160275	1336713963	1	0.0599999999999996	0.000299999999999998	5575	1
2	Food 2	Intake 4	332	161109	1336714797	/users/cn/jespinosa/phecomp/data/CRG/20120502_FDF_CRG/20120502_FDF_CRG/20120509_FDF_CRG_c12.mtb	2427	19	WWFF	food_fat	4	160777	1336714465	1	0.02	6.02409638554217e-05	5576	1
2	Food 2	Intake 4	89	161217	1336714905	/users/cn/jespinosa/phecomp/data/CRG/20120502_FDF_CRG/20120502_FDF_CRG/20120509_FDF_CRG_c12.mtb	2428	1061	WWFF	food_fat	4	161128	1336714816	1	0.04	0.000449438202247191	5577	1
2	Food 2	Intake 4	12	162290	1336715978	/users/cn/jespinosa/phecomp/data/CRG/20120502_FDF_CRG/20120502_FDF_CRG/20120509_FDF_CRG_c12.mtb	2433	172	WWFF	food_fat	4	162278	1336715966	1	0.0399999999999996	0.0033333333333333	5578	1
2	Food 2	Intake 4	26	162488	1336716176	/users/cn/jespinosa/phecomp/data/CRG/20120502_FDF_CRG/20120502_FDF_CRG/20120509_FDF_CRG_c12.mtb	2435	367	WWFF	food_fat	4	162462	1336716150	1	0.02	0.000769230769230769	5579	1
2	Food 2	Intake 4	11	162866	1336716554	/users/cn/jespinosa/phecomp/data/CRG/20120502_FDF_CRG/20120502_FDF_CRG/20120509_FDF_CRG_c12.mtb	2436	603	WWFF	food_fat	4	162855	1336716543	1	0.02	0.00181818181818182	5580	1
2	Food 2	Intake 4	18	163487	1336717175	/users/cn/jespinosa/phecomp/data/CRG/20120502_FDF_CRG/20120502_FDF_CRG/20120509_FDF_CRG_c12.mtb	2438	590	WWFF	food_fat	4	163469	1336717157	1	0.0600000000000001	0.00333333333333334	5581	1
2	Food 2	Intake 4	102	164179	1336717867	/users/cn/jespinosa/phecomp/data/CRG/20120502_FDF_CRG/20120502_FDF_CRG/20120509_FDF_CRG_c12.mtb	2442	511	WWFF	food_fat	4	164077	1336717765	1	0.02	0.000196078431372549	5582	1
2	Drink 2	Intake 2	28	164141	1336717829	/users/cn/jespinosa/phecomp/data/CRG/20120502_FDF_CRG/20120502_FDF_CRG/20120509_FDF_CRG_c12.mtb	1166	NA	WWFF	water	2	164113	1336717801	1	0.0600000000000001	0.00214285714285715	5583	1
2	Food 2	Intake 4	51	164741	1336718429	/users/cn/jespinosa/phecomp/data/CRG/20120502_FDF_CRG/20120502_FDF_CRG/20120509_FDF_CRG_c12.mtb	2444	101	WWFF	food_fat	4	164690	1336718378	1	0.0999999999999996	0.00196078431372548	5584	1
2	Drink 1	Intake 1	33	164762	1336718450	/users/cn/jespinosa/phecomp/data/CRG/20120502_FDF_CRG/20120502_FDF_CRG/20120509_FDF_CRG_c12.mtb	691	NA	WWFF	water	1	164729	1336718417	1	0.1	0.00303030303030303	5585	1
2	Food 2	Intake 4	634	165476	1336719164	/users/cn/jespinosa/phecomp/data/CRG/20120502_FDF_CRG/20120502_FDF_CRG/20120509_FDF_CRG_c12.mtb	2447	284	WWFF	food_fat	4	164842	1336718530	1	0.18	0.00028391167192429	5586	1
2	Food 2	Intake 4	314	166074	1336719762	/users/cn/jespinosa/phecomp/data/CRG/20120502_FDF_CRG/20120502_FDF_CRG/20120509_FDF_CRG_c12.mtb	2451	14	WWFF	food_fat	4	165760	1336719448	1	0.04	0.000127388535031847	5587	1
2	Food 2	Intake 4	57	166145	1336719833	/users/cn/jespinosa/phecomp/data/CRG/20120502_FDF_CRG/20120502_FDF_CRG/20120509_FDF_CRG_c12.mtb	2452	11176	WWFF	food_fat	4	166088	1336719776	1	0.02	0.000350877192982456	5588	1
2	Food 1	Intake 3	73	217	1336731082	/users/cn/jespinosa/phecomp/data/CRG/20120502_FDF_CRG/20120502_FDF_CRG/20120511_FDF_CRG_c12.mtb	2506	93	WWFF	food_fat	3	144	1336731009	1	0.56	0.00767123287671233	5589	1
2	Food 2	Intake 4	36	346	1336731211	/users/cn/jespinosa/phecomp/data/CRG/20120502_FDF_CRG/20120502_FDF_CRG/20120511_FDF_CRG_c12.mtb	3492	COLL	WWFF	food_fat	4	310	1336731175	1	0.42	0.0116666666666667	5590	1
2	Food 1	Intake 3	80	417	1336731282	/users/cn/jespinosa/phecomp/data/CRG/20120502_FDF_CRG/20120502_FDF_CRG/20120511_FDF_CRG_c12.mtb	2507	88	WWFF	food_fat	3	337	1336731202	1	0.32	0.004	5591	1
2	Food 1	Intake 3	97	602	1336731467	/users/cn/jespinosa/phecomp/data/CRG/20120502_FDF_CRG/20120502_FDF_CRG/20120511_FDF_CRG_c12.mtb	2508	84	WWFF	food_fat	3	505	1336731370	1	0.72	0.00742268041237113	5592	1
2	Drink 2	Intake 2	19	683	1336731548	/users/cn/jespinosa/phecomp/data/CRG/20120502_FDF_CRG/20120502_FDF_CRG/20120511_FDF_CRG_c12.mtb	1274	NA	WWFF	water	2	664	1336731529	1	0.06	0.00315789473684211	5593	1
2	Food 1	Intake 3	185	871	1336731736	/users/cn/jespinosa/phecomp/data/CRG/20120502_FDF_CRG/20120502_FDF_CRG/20120511_FDF_CRG_c12.mtb	2509	228	WWFF	food_fat	3	686	1336731551	1	1	0.00540540540540541	5594	1
2	Drink 1	Intake 1	29	969	1336731834	/users/cn/jespinosa/phecomp/data/CRG/20120502_FDF_CRG/20120502_FDF_CRG/20120511_FDF_CRG_c12.mtb	832	NA	WWFF	water	1	940	1336731805	1	0.08	0.00275862068965517	5595	1
2	Food 2	Intake 4	73	1172	1336732037	/users/cn/jespinosa/phecomp/data/CRG/20120502_FDF_CRG/20120502_FDF_CRG/20120511_FDF_CRG_c12.mtb	3493	COLL	WWFF	food_fat	4	1099	1336731964	1	0.04	0.000547945205479452	5596	1
2	Food 1	Intake 3	107	1231	1336732096	/users/cn/jespinosa/phecomp/data/CRG/20120502_FDF_CRG/20120502_FDF_CRG/20120511_FDF_CRG_c12.mtb	2510	31920	WWFF	food_fat	3	1124	1336731989	1	0.42	0.00392523364485981	5597	1
2	Drink 1	Intake 1	13	1336	1336732201	/users/cn/jespinosa/phecomp/data/CRG/20120502_FDF_CRG/20120502_FDF_CRG/20120511_FDF_CRG_c12.mtb	833	NA	WWFF	water	1	1323	1336732188	1	0.06	0.00461538461538461	5598	1
2	Drink 2	Intake 2	21	10141	1336741006	/users/cn/jespinosa/phecomp/data/CRG/20120502_FDF_CRG/20120502_FDF_CRG/20120511_FDF_CRG_c12.mtb	1278	NA	WWFF	water	2	10120	1336740985	1	0.02	0.000952380952380952	5599	1
2	Drink 2	Intake 2	39	10262	1336741127	/users/cn/jespinosa/phecomp/data/CRG/20120502_FDF_CRG/20120502_FDF_CRG/20120511_FDF_CRG_c12.mtb	1279	NA	WWFF	water	2	10223	1336741088	1	0.08	0.00205128205128205	5600	1
2	Drink 2	Intake 2	25	17379	1336748244	/users/cn/jespinosa/phecomp/data/CRG/20120502_FDF_CRG/20120502_FDF_CRG/20120511_FDF_CRG_c12.mtb	1280	NA	WWFF	water	2	17354	1336748219	1	0.06	0.0024	5601	1
2	Drink 1	Intake 1	20	31776	1336762641	/users/cn/jespinosa/phecomp/data/CRG/20120502_FDF_CRG/20120502_FDF_CRG/20120511_FDF_CRG_c12.mtb	834	NA	WWFF	water	1	31756	1336762621	1	0.08	0.004	5602	1
2	Drink 1	Intake 1	18	33137	1336764002	/users/cn/jespinosa/phecomp/data/CRG/20120502_FDF_CRG/20120502_FDF_CRG/20120511_FDF_CRG_c12.mtb	836	NA	WWFF	water	1	33119	1336763984	1	0.02	0.00111111111111111	5603	1
2	Food 2	Intake 4	106	33257	1336764122	/users/cn/jespinosa/phecomp/data/CRG/20120502_FDF_CRG/20120502_FDF_CRG/20120511_FDF_CRG_c12.mtb	3494	241	WWFF	food_fat	4	33151	1336764016	1	0.24	0.00226415094339623	5604	1
2	Food 2	Intake 4	15	33513	1336764378	/users/cn/jespinosa/phecomp/data/CRG/20120502_FDF_CRG/20120502_FDF_CRG/20120511_FDF_CRG_c12.mtb	3495	COLL	WWFF	food_fat	4	33498	1336764363	1	0.02	0.00133333333333333	5605	1
2	Food 1	Intake 3	14	33518	1336764383	/users/cn/jespinosa/phecomp/data/CRG/20120502_FDF_CRG/20120502_FDF_CRG/20120511_FDF_CRG_c12.mtb	2514	220	WWFF	food_fat	3	33504	1336764369	1	0.02	0.00142857142857143	5606	1
2	Food 2	Intake 4	23	33761	1336764626	/users/cn/jespinosa/phecomp/data/CRG/20120502_FDF_CRG/20120502_FDF_CRG/20120511_FDF_CRG_c12.mtb	3497	1	WWFF	food_fat	4	33738	1336764603	1	0.0800000000000001	0.00347826086956522	5607	1
2	Food 1	Intake 3	55	33817	1336764682	/users/cn/jespinosa/phecomp/data/CRG/20120502_FDF_CRG/20120502_FDF_CRG/20120511_FDF_CRG_c12.mtb	2515	17	WWFF	food_fat	3	33762	1336764627	1	0.94	0.0170909090909091	5608	1
2	Drink 2	Intake 2	33	33844	1336764709	/users/cn/jespinosa/phecomp/data/CRG/20120502_FDF_CRG/20120502_FDF_CRG/20120511_FDF_CRG_c12.mtb	1284	NA	WWFF	water	2	33811	1336764676	1	0.02	0.000606060606060606	5609	1
2	Food 1	Intake 3	76	33910	1336764775	/users/cn/jespinosa/phecomp/data/CRG/20120502_FDF_CRG/20120502_FDF_CRG/20120511_FDF_CRG_c12.mtb	2516	6	WWFF	food_fat	3	33834	1336764699	1	0.1	0.00131578947368421	5610	1
2	Food 1	Intake 3	41	33957	1336764822	/users/cn/jespinosa/phecomp/data/CRG/20120502_FDF_CRG/20120502_FDF_CRG/20120511_FDF_CRG_c12.mtb	2517	255	WWFF	food_fat	3	33916	1336764781	1	0.04	0.000975609756097561	5611	1
2	Drink 2	Intake 2	41	34209	1336765074	/users/cn/jespinosa/phecomp/data/CRG/20120502_FDF_CRG/20120502_FDF_CRG/20120511_FDF_CRG_c12.mtb	1285	NA	WWFF	water	2	34168	1336765033	1	0.04	0.000975609756097561	5612	1
2	Food 1	Intake 3	81	34293	1336765158	/users/cn/jespinosa/phecomp/data/CRG/20120502_FDF_CRG/20120502_FDF_CRG/20120511_FDF_CRG_c12.mtb	2518	3966	WWFF	food_fat	3	34212	1336765077	1	0.04	0.000493827160493827	5613	1
2	Drink 2	Intake 2	20	36660	1336767525	/users/cn/jespinosa/phecomp/data/CRG/20120502_FDF_CRG/20120502_FDF_CRG/20120511_FDF_CRG_c12.mtb	1286	NA	WWFF	water	2	36640	1336767505	1	0.04	0.002	5614	1
2	Drink 1	Intake 1	12	36727	1336767592	/users/cn/jespinosa/phecomp/data/CRG/20120502_FDF_CRG/20120502_FDF_CRG/20120511_FDF_CRG_c12.mtb	837	NA	WWFF	water	1	36715	1336767580	1	0.04	0.00333333333333333	5615	1
2	Drink 2	Intake 2	25	37408	1336768273	/users/cn/jespinosa/phecomp/data/CRG/20120502_FDF_CRG/20120502_FDF_CRG/20120511_FDF_CRG_c12.mtb	1287	NA	WWFF	water	2	37383	1336768248	1	0.06	0.0024	5616	1
2	Food 1	Intake 3	25	38284	1336769149	/users/cn/jespinosa/phecomp/data/CRG/20120502_FDF_CRG/20120502_FDF_CRG/20120511_FDF_CRG_c12.mtb	2521	113	WWFF	food_fat	3	38259	1336769124	1	0.0200000000000005	0.00080000000000002	5617	1
2	Drink 2	Intake 2	15	38389	1336769254	/users/cn/jespinosa/phecomp/data/CRG/20120502_FDF_CRG/20120502_FDF_CRG/20120511_FDF_CRG_c12.mtb	1288	NA	WWFF	water	2	38374	1336769239	1	0.02	0.00133333333333333	5618	1
2	Food 2	Intake 4	45	38442	1336769307	/users/cn/jespinosa/phecomp/data/CRG/20120502_FDF_CRG/20120502_FDF_CRG/20120511_FDF_CRG_c12.mtb	3505	559	WWFF	food_fat	4	38397	1336769262	1	0.0399999999999999	0.000888888888888887	5619	1
2	Food 2	Intake 4	13	39014	1336769879	/users/cn/jespinosa/phecomp/data/CRG/20120502_FDF_CRG/20120502_FDF_CRG/20120511_FDF_CRG_c12.mtb	3511	36	WWFF	food_fat	4	39001	1336769866	1	0.02	0.00153846153846154	5620	1
2	Food 1	Intake 3	64	39114	1336769979	/users/cn/jespinosa/phecomp/data/CRG/20120502_FDF_CRG/20120502_FDF_CRG/20120511_FDF_CRG_c12.mtb	2524	171	WWFF	food_fat	3	39050	1336769915	1	1.14	0.0178125	5621	1
2	Drink 2	Intake 2	36	39290	1336770155	/users/cn/jespinosa/phecomp/data/CRG/20120502_FDF_CRG/20120502_FDF_CRG/20120511_FDF_CRG_c12.mtb	1289	NA	WWFF	water	2	39254	1336770119	1	0.08	0.00222222222222222	5622	1
2	Food 1	Intake 3	25	39310	1336770175	/users/cn/jespinosa/phecomp/data/CRG/20120502_FDF_CRG/20120502_FDF_CRG/20120511_FDF_CRG_c12.mtb	2525	143	WWFF	food_fat	3	39285	1336770150	1	0.62	0.0248	5623	1
2	Food 1	Intake 3	69	39522	1336770387	/users/cn/jespinosa/phecomp/data/CRG/20120502_FDF_CRG/20120502_FDF_CRG/20120511_FDF_CRG_c12.mtb	2526	55	WWFF	food_fat	3	39453	1336770318	1	1.36	0.0197101449275362	5624	1
2	Food 2	Intake 4	79	39656	1336770521	/users/cn/jespinosa/phecomp/data/CRG/20120502_FDF_CRG/20120502_FDF_CRG/20120511_FDF_CRG_c12.mtb	3515	COLL	WWFF	food_fat	4	39577	1336770442	1	0.02	0.000253164556962025	5625	1
2	Food 1	Intake 3	33	39611	1336770476	/users/cn/jespinosa/phecomp/data/CRG/20120502_FDF_CRG/20120502_FDF_CRG/20120511_FDF_CRG_c12.mtb	2527	296	WWFF	food_fat	3	39578	1336770443	1	0.04	0.00121212121212121	5626	1
2	Food 2	Intake 4	86	39993	1336770858	/users/cn/jespinosa/phecomp/data/CRG/20120502_FDF_CRG/20120502_FDF_CRG/20120511_FDF_CRG_c12.mtb	3516	34	WWFF	food_fat	4	39907	1336770772	1	0.22	0.00255813953488372	5627	1
2	Food 2	Intake 4	14	40041	1336770906	/users/cn/jespinosa/phecomp/data/CRG/20120502_FDF_CRG/20120502_FDF_CRG/20120511_FDF_CRG_c12.mtb	3517	234	WWFF	food_fat	4	40027	1336770892	1	0.0599999999999998	0.00428571428571427	5628	1
2	Food 2	Intake 4	20	40295	1336771160	/users/cn/jespinosa/phecomp/data/CRG/20120502_FDF_CRG/20120502_FDF_CRG/20120511_FDF_CRG_c12.mtb	3520	199	WWFF	food_fat	4	40275	1336771140	1	0.0399999999999998	0.00199999999999999	5629	1
2	Drink 1	Intake 1	21	40311	1336771176	/users/cn/jespinosa/phecomp/data/CRG/20120502_FDF_CRG/20120502_FDF_CRG/20120511_FDF_CRG_c12.mtb	840	NA	WWFF	water	1	40290	1336771155	1	0.08	0.00380952380952381	5630	1
2	Food 2	Intake 4	22	40516	1336771381	/users/cn/jespinosa/phecomp/data/CRG/20120502_FDF_CRG/20120502_FDF_CRG/20120511_FDF_CRG_c12.mtb	3523	5907	WWFF	food_fat	4	40494	1336771359	1	0.02	0.000909090909090909	5631	1
2	Drink 1	Intake 1	14	45393	1336776258	/users/cn/jespinosa/phecomp/data/CRG/20120502_FDF_CRG/20120502_FDF_CRG/20120511_FDF_CRG_c12.mtb	842	NA	WWFF	water	1	45379	1336776244	1	0.04	0.00285714285714286	5632	1
2	Food 2	Intake 4	12	46435	1336777300	/users/cn/jespinosa/phecomp/data/CRG/20120502_FDF_CRG/20120502_FDF_CRG/20120511_FDF_CRG_c12.mtb	3529	57	WWFF	food_fat	4	46423	1336777288	1	0.0399999999999998	0.00333333333333332	5633	1
2	Food 1	Intake 3	44	46536	1336777401	/users/cn/jespinosa/phecomp/data/CRG/20120502_FDF_CRG/20120502_FDF_CRG/20120511_FDF_CRG_c12.mtb	2530	COLL	WWFF	food_fat	3	46492	1336777357	1	0.42	0.00954545454545454	5634	1
2	Food 2	Intake 4	11	46535	1336777400	/users/cn/jespinosa/phecomp/data/CRG/20120502_FDF_CRG/20120502_FDF_CRG/20120511_FDF_CRG_c12.mtb	3530	56	WWFF	food_fat	4	46524	1336777389	1	0.04	0.00363636363636364	5635	1
2	Food 2	Intake 4	37	46628	1336777493	/users/cn/jespinosa/phecomp/data/CRG/20120502_FDF_CRG/20120502_FDF_CRG/20120511_FDF_CRG_c12.mtb	3531	14	WWFF	food_fat	4	46591	1336777456	1	0.18	0.00486486486486486	5636	1
2	Food 2	Intake 4	29	46671	1336777536	/users/cn/jespinosa/phecomp/data/CRG/20120502_FDF_CRG/20120502_FDF_CRG/20120511_FDF_CRG_c12.mtb	3532	COLL	WWFF	food_fat	4	46642	1336777507	1	0.1	0.00344827586206897	5637	1
2	Food 1	Intake 3	64	46718	1336777583	/users/cn/jespinosa/phecomp/data/CRG/20120502_FDF_CRG/20120502_FDF_CRG/20120511_FDF_CRG_c12.mtb	2531	372	WWFF	food_fat	3	46654	1336777519	1	0.2	0.003125	5638	1
2	Drink 2	Intake 2	42	46952	1336777817	/users/cn/jespinosa/phecomp/data/CRG/20120502_FDF_CRG/20120502_FDF_CRG/20120511_FDF_CRG_c12.mtb	1293	NA	WWFF	water	2	46910	1336777775	1	0.0600000000000001	0.00142857142857143	5639	1
2	Drink 1	Intake 1	34	46997	1336777862	/users/cn/jespinosa/phecomp/data/CRG/20120502_FDF_CRG/20120502_FDF_CRG/20120511_FDF_CRG_c12.mtb	846	NA	WWFF	water	1	46963	1336777828	1	0.1	0.00294117647058824	5640	1
2	Food 2	Intake 4	187	47277	1336778142	/users/cn/jespinosa/phecomp/data/CRG/20120502_FDF_CRG/20120502_FDF_CRG/20120511_FDF_CRG_c12.mtb	3536	9671	WWFF	food_fat	4	47090	1336777955	1	0.5	0.00267379679144385	5641	1
2	Drink 1	Intake 1	33	47511	1336778376	/users/cn/jespinosa/phecomp/data/CRG/20120502_FDF_CRG/20120502_FDF_CRG/20120511_FDF_CRG_c12.mtb	847	NA	WWFF	water	1	47478	1336778343	1	0.04	0.00121212121212121	5642	1
2	Drink 1	Intake 1	18	51944	1336782809	/users/cn/jespinosa/phecomp/data/CRG/20120502_FDF_CRG/20120502_FDF_CRG/20120511_FDF_CRG_c12.mtb	848	NA	WWFF	water	1	51926	1336782791	1	0.02	0.00111111111111111	5643	1
2	Drink 1	Intake 1	31	55194	1336786059	/users/cn/jespinosa/phecomp/data/CRG/20120502_FDF_CRG/20120502_FDF_CRG/20120511_FDF_CRG_c12.mtb	849	NA	WWFF	water	1	55163	1336786028	1	0.08	0.00258064516129032	5644	1
2	Food 1	Intake 3	14	56962	1336787827	/users/cn/jespinosa/phecomp/data/CRG/20120502_FDF_CRG/20120502_FDF_CRG/20120511_FDF_CRG_c12.mtb	2537	213	WWFF	food_fat	3	56948	1336787813	1	0.0200000000000014	0.00142857142857153	5645	1
2	Food 2	Intake 4	217	57392	1336788257	/users/cn/jespinosa/phecomp/data/CRG/20120502_FDF_CRG/20120502_FDF_CRG/20120511_FDF_CRG_c12.mtb	3538	26	WWFF	food_fat	4	57175	1336788040	1	1.18	0.00543778801843318	5646	1
2	Food 2	Intake 4	27	57445	1336788310	/users/cn/jespinosa/phecomp/data/CRG/20120502_FDF_CRG/20120502_FDF_CRG/20120511_FDF_CRG_c12.mtb	3539	20	WWFF	food_fat	4	57418	1336788283	1	0.24	0.00888888888888889	5647	1
2	Food 2	Intake 4	46	57511	1336788376	/users/cn/jespinosa/phecomp/data/CRG/20120502_FDF_CRG/20120502_FDF_CRG/20120511_FDF_CRG_c12.mtb	3540	22	WWFF	food_fat	4	57465	1336788330	1	1.26	0.0273913043478261	5648	1
2	Drink 1	Intake 1	19	57537	1336788402	/users/cn/jespinosa/phecomp/data/CRG/20120502_FDF_CRG/20120502_FDF_CRG/20120511_FDF_CRG_c12.mtb	851	NA	WWFF	water	1	57518	1336788383	1	0.04	0.00210526315789474	5649	1
2	Food 2	Intake 4	150	57683	1336788548	/users/cn/jespinosa/phecomp/data/CRG/20120502_FDF_CRG/20120502_FDF_CRG/20120511_FDF_CRG_c12.mtb	3541	952	WWFF	food_fat	4	57533	1336788398	1	0.720000000000001	0.00480000000000001	5650	1
2	Food 2	Intake 4	105	58740	1336789605	/users/cn/jespinosa/phecomp/data/CRG/20120502_FDF_CRG/20120502_FDF_CRG/20120511_FDF_CRG_c12.mtb	3547	4672	WWFF	food_fat	4	58635	1336789500	1	0.04	0.000380952380952381	5651	1
2	Drink 1	Intake 1	28	59130	1336789995	/users/cn/jespinosa/phecomp/data/CRG/20120502_FDF_CRG/20120502_FDF_CRG/20120511_FDF_CRG_c12.mtb	853	NA	WWFF	water	1	59102	1336789967	1	0.0800000000000001	0.00285714285714286	5652	1
2	Drink 1	Intake 1	17	63349	1336794214	/users/cn/jespinosa/phecomp/data/CRG/20120502_FDF_CRG/20120502_FDF_CRG/20120511_FDF_CRG_c12.mtb	855	NA	WWFF	water	1	63332	1336794197	1	0.02	0.00117647058823529	5653	1
2	Food 2	Intake 4	38	63450	1336794315	/users/cn/jespinosa/phecomp/data/CRG/20120502_FDF_CRG/20120502_FDF_CRG/20120511_FDF_CRG_c12.mtb	3550	33	WWFF	food_fat	4	63412	1336794277	1	0.04	0.00105263157894737	5654	1
2	Food 2	Intake 4	194	63677	1336794542	/users/cn/jespinosa/phecomp/data/CRG/20120502_FDF_CRG/20120502_FDF_CRG/20120511_FDF_CRG_c12.mtb	3551	43	WWFF	food_fat	4	63483	1336794348	1	0.119999999999999	0.000618556701030923	5655	1
2	Food 2	Intake 4	118	63838	1336794703	/users/cn/jespinosa/phecomp/data/CRG/20120502_FDF_CRG/20120502_FDF_CRG/20120511_FDF_CRG_c12.mtb	3552	218	WWFF	food_fat	4	63720	1336794585	1	0.0200000000000005	0.000169491525423733	5656	1
2	Drink 1	Intake 1	40	64041	1336794906	/users/cn/jespinosa/phecomp/data/CRG/20120502_FDF_CRG/20120502_FDF_CRG/20120511_FDF_CRG_c12.mtb	856	NA	WWFF	water	1	64001	1336794866	1	0.0599999999999999	0.0015	5657	1
2	Food 2	Intake 4	82	64138	1336795003	/users/cn/jespinosa/phecomp/data/CRG/20120502_FDF_CRG/20120502_FDF_CRG/20120511_FDF_CRG_c12.mtb	3553	725	WWFF	food_fat	4	64056	1336794921	1	0.0999999999999996	0.00121951219512195	5658	1
2	Drink 2	Intake 2	26	64855	1336795720	/users/cn/jespinosa/phecomp/data/CRG/20120502_FDF_CRG/20120502_FDF_CRG/20120511_FDF_CRG_c12.mtb	1297	NA	WWFF	water	2	64829	1336795694	1	0.0399999999999999	0.00153846153846153	5659	1
2	Food 2	Intake 4	99	64962	1336795827	/users/cn/jespinosa/phecomp/data/CRG/20120502_FDF_CRG/20120502_FDF_CRG/20120511_FDF_CRG_c12.mtb	3555	1989	WWFF	food_fat	4	64863	1336795728	1	0.0600000000000005	0.000606060606060611	5660	1
2	Food 2	Intake 4	12	66963	1336797828	/users/cn/jespinosa/phecomp/data/CRG/20120502_FDF_CRG/20120502_FDF_CRG/20120511_FDF_CRG_c12.mtb	3556	1576	WWFF	food_fat	4	66951	1336797816	1	0.04	0.00333333333333333	5661	1
2	Drink 2	Intake 2	15	68122	1336798987	/users/cn/jespinosa/phecomp/data/CRG/20120502_FDF_CRG/20120502_FDF_CRG/20120511_FDF_CRG_c12.mtb	1298	NA	WWFF	water	2	68107	1336798972	1	0.02	0.00133333333333333	5662	1
2	Food 2	Intake 4	12	68551	1336799416	/users/cn/jespinosa/phecomp/data/CRG/20120502_FDF_CRG/20120502_FDF_CRG/20120511_FDF_CRG_c12.mtb	3559	138	WWFF	food_fat	4	68539	1336799404	1	0.04	0.00333333333333333	5663	1
2	Food 2	Intake 4	60	68749	1336799614	/users/cn/jespinosa/phecomp/data/CRG/20120502_FDF_CRG/20120502_FDF_CRG/20120511_FDF_CRG_c12.mtb	3562	199	WWFF	food_fat	4	68689	1336799554	1	0.0599999999999996	0.000999999999999993	5664	1
2	Food 2	Intake 4	16	68964	1336799829	/users/cn/jespinosa/phecomp/data/CRG/20120502_FDF_CRG/20120502_FDF_CRG/20120511_FDF_CRG_c12.mtb	3564	94	WWFF	food_fat	4	68948	1336799813	1	0.04	0.0025	5665	1
2	Food 2	Intake 4	70	69128	1336799993	/users/cn/jespinosa/phecomp/data/CRG/20120502_FDF_CRG/20120502_FDF_CRG/20120511_FDF_CRG_c12.mtb	3566	31	WWFF	food_fat	4	69058	1336799923	1	0.14	0.002	5666	1
2	Drink 1	Intake 1	29	69164	1336800029	/users/cn/jespinosa/phecomp/data/CRG/20120502_FDF_CRG/20120502_FDF_CRG/20120511_FDF_CRG_c12.mtb	857	NA	WWFF	water	1	69135	1336800000	1	0.0600000000000001	0.00206896551724138	5667	1
2	Food 2	Intake 4	51	69210	1336800075	/users/cn/jespinosa/phecomp/data/CRG/20120502_FDF_CRG/20120502_FDF_CRG/20120511_FDF_CRG_c12.mtb	3567	215	WWFF	food_fat	4	69159	1336800024	1	0.0200000000000005	0.000392156862745108	5668	1
2	Food 2	Intake 4	17	69442	1336800307	/users/cn/jespinosa/phecomp/data/CRG/20120502_FDF_CRG/20120502_FDF_CRG/20120511_FDF_CRG_c12.mtb	3570	57	WWFF	food_fat	4	69425	1336800290	1	0.04	0.00235294117647059	5669	1
2	Food 2	Intake 4	95	69594	1336800459	/users/cn/jespinosa/phecomp/data/CRG/20120502_FDF_CRG/20120502_FDF_CRG/20120511_FDF_CRG_c12.mtb	3572	544	WWFF	food_fat	4	69499	1336800364	1	0.0599999999999996	0.000631578947368417	5670	1
2	Drink 1	Intake 1	26	69825	1336800690	/users/cn/jespinosa/phecomp/data/CRG/20120502_FDF_CRG/20120502_FDF_CRG/20120511_FDF_CRG_c12.mtb	859	NA	WWFF	water	1	69799	1336800664	1	0.0600000000000001	0.00230769230769231	5671	1
2	Food 2	Intake 4	14	70152	1336801017	/users/cn/jespinosa/phecomp/data/CRG/20120502_FDF_CRG/20120502_FDF_CRG/20120511_FDF_CRG_c12.mtb	3578	408	WWFF	food_fat	4	70138	1336801003	1	0.0200000000000005	0.00142857142857146	5672	1
2	Food 2	Intake 4	28	70588	1336801453	/users/cn/jespinosa/phecomp/data/CRG/20120502_FDF_CRG/20120502_FDF_CRG/20120511_FDF_CRG_c12.mtb	3585	7	WWFF	food_fat	4	70560	1336801425	1	0.0200000000000005	0.000714285714285732	5673	1
2	Food 2	Intake 4	35	70630	1336801495	/users/cn/jespinosa/phecomp/data/CRG/20120502_FDF_CRG/20120502_FDF_CRG/20120511_FDF_CRG_c12.mtb	3586	51	WWFF	food_fat	4	70595	1336801460	1	0.0599999999999996	0.0017142857142857	5674	1
2	Drink 1	Intake 1	22	70648	1336801513	/users/cn/jespinosa/phecomp/data/CRG/20120502_FDF_CRG/20120502_FDF_CRG/20120511_FDF_CRG_c12.mtb	860	NA	WWFF	water	1	70626	1336801491	1	0.04	0.00181818181818182	5675	1
2	Food 2	Intake 4	13	70694	1336801559	/users/cn/jespinosa/phecomp/data/CRG/20120502_FDF_CRG/20120502_FDF_CRG/20120511_FDF_CRG_c12.mtb	3587	310	WWFF	food_fat	4	70681	1336801546	1	0.04	0.00307692307692308	5676	1
2	Drink 2	Intake 2	20	70708	1336801573	/users/cn/jespinosa/phecomp/data/CRG/20120502_FDF_CRG/20120502_FDF_CRG/20120511_FDF_CRG_c12.mtb	1305	NA	WWFF	water	2	70688	1336801553	1	0.02	0.001	5677	1
2	Food 2	Intake 4	12	71016	1336801881	/users/cn/jespinosa/phecomp/data/CRG/20120502_FDF_CRG/20120502_FDF_CRG/20120511_FDF_CRG_c12.mtb	3591	135	WWFF	food_fat	4	71004	1336801869	1	0.04	0.00333333333333333	5678	1
2	Food 2	Intake 4	28	71179	1336802044	/users/cn/jespinosa/phecomp/data/CRG/20120502_FDF_CRG/20120502_FDF_CRG/20120511_FDF_CRG_c12.mtb	3593	266	WWFF	food_fat	4	71151	1336802016	1	0.04	0.00142857142857143	5679	1
2	Food 2	Intake 4	136	71581	1336802446	/users/cn/jespinosa/phecomp/data/CRG/20120502_FDF_CRG/20120502_FDF_CRG/20120511_FDF_CRG_c12.mtb	3595	53	WWFF	food_fat	4	71445	1336802310	1	0.0200000000000005	0.000147058823529415	5680	1
2	Food 2	Intake 4	137	71771	1336802636	/users/cn/jespinosa/phecomp/data/CRG/20120502_FDF_CRG/20120502_FDF_CRG/20120511_FDF_CRG_c12.mtb	3596	43	WWFF	food_fat	4	71634	1336802499	1	0.12	0.000875912408759124	5681	1
2	Food 2	Intake 4	121	71935	1336802800	/users/cn/jespinosa/phecomp/data/CRG/20120502_FDF_CRG/20120502_FDF_CRG/20120511_FDF_CRG_c12.mtb	3597	37	WWFF	food_fat	4	71814	1336802679	1	0.0599999999999996	0.000495867768595038	5682	1
2	Food 2	Intake 4	41	72013	1336802878	/users/cn/jespinosa/phecomp/data/CRG/20120502_FDF_CRG/20120502_FDF_CRG/20120511_FDF_CRG_c12.mtb	3598	688	WWFF	food_fat	4	71972	1336802837	1	0.04	0.000975609756097561	5683	1
2	Food 2	Intake 4	13	72714	1336803579	/users/cn/jespinosa/phecomp/data/CRG/20120502_FDF_CRG/20120502_FDF_CRG/20120511_FDF_CRG_c12.mtb	3605	375	WWFF	food_fat	4	72701	1336803566	1	0.04	0.00307692307692308	5684	1
2	Food 2	Intake 4	15	73104	1336803969	/users/cn/jespinosa/phecomp/data/CRG/20120502_FDF_CRG/20120502_FDF_CRG/20120511_FDF_CRG_c12.mtb	3606	388	WWFF	food_fat	4	73089	1336803954	1	0.0200000000000005	0.00133333333333337	5685	1
2	Food 2	Intake 4	32	73524	1336804389	/users/cn/jespinosa/phecomp/data/CRG/20120502_FDF_CRG/20120502_FDF_CRG/20120511_FDF_CRG_c12.mtb	3610	23	WWFF	food_fat	4	73492	1336804357	1	0.0800000000000001	0.0025	5686	1
2	Food 2	Intake 4	72	73619	1336804484	/users/cn/jespinosa/phecomp/data/CRG/20120502_FDF_CRG/20120502_FDF_CRG/20120511_FDF_CRG_c12.mtb	3611	2423	WWFF	food_fat	4	73547	1336804412	1	0.16	0.00222222222222222	5687	1
2	Food 2	Intake 4	23	76065	1336806930	/users/cn/jespinosa/phecomp/data/CRG/20120502_FDF_CRG/20120502_FDF_CRG/20120511_FDF_CRG_c12.mtb	3617	231	WWFF	food_fat	4	76042	1336806907	1	0.12	0.00521739130434783	5688	1
2	Food 2	Intake 4	16	76312	1336807177	/users/cn/jespinosa/phecomp/data/CRG/20120502_FDF_CRG/20120502_FDF_CRG/20120511_FDF_CRG_c12.mtb	3620	462	WWFF	food_fat	4	76296	1336807161	1	0.100000000000001	0.00625000000000006	5689	1
2	Food 2	Intake 4	18	76792	1336807657	/users/cn/jespinosa/phecomp/data/CRG/20120502_FDF_CRG/20120502_FDF_CRG/20120511_FDF_CRG_c12.mtb	3622	337	WWFF	food_fat	4	76774	1336807639	1	0.04	0.00222222222222222	5690	1
2	Food 2	Intake 4	17	77146	1336808011	/users/cn/jespinosa/phecomp/data/CRG/20120502_FDF_CRG/20120502_FDF_CRG/20120511_FDF_CRG_c12.mtb	3623	750	WWFF	food_fat	4	77129	1336807994	1	0.0999999999999996	0.00588235294117645	5691	1
2	Drink 2	Intake 2	28	77163	1336808028	/users/cn/jespinosa/phecomp/data/CRG/20120502_FDF_CRG/20120502_FDF_CRG/20120511_FDF_CRG_c12.mtb	1307	NA	WWFF	water	2	77135	1336808000	1	0.0600000000000001	0.00214285714285715	5692	1
2	Drink 1	Intake 1	17	77174	1336808039	/users/cn/jespinosa/phecomp/data/CRG/20120502_FDF_CRG/20120502_FDF_CRG/20120511_FDF_CRG_c12.mtb	862	NA	WWFF	water	1	77157	1336808022	1	0.02	0.00117647058823529	5693	1
2	Food 2	Intake 4	36	77932	1336808797	/users/cn/jespinosa/phecomp/data/CRG/20120502_FDF_CRG/20120502_FDF_CRG/20120511_FDF_CRG_c12.mtb	3627	1122	WWFF	food_fat	4	77896	1336808761	1	0.0200000000000005	0.000555555555555569	5694	1
2	Food 2	Intake 4	49	79103	1336809968	/users/cn/jespinosa/phecomp/data/CRG/20120502_FDF_CRG/20120502_FDF_CRG/20120511_FDF_CRG_c12.mtb	3633	465	WWFF	food_fat	4	79054	1336809919	1	0.0999999999999996	0.0020408163265306	5695	1
2	Drink 1	Intake 1	36	79172	1336810037	/users/cn/jespinosa/phecomp/data/CRG/20120502_FDF_CRG/20120502_FDF_CRG/20120511_FDF_CRG_c12.mtb	863	NA	WWFF	water	1	79136	1336810001	1	0.0800000000000001	0.00222222222222222	5696	1
2	Drink 1	Intake 1	11	79277	1336810142	/users/cn/jespinosa/phecomp/data/CRG/20120502_FDF_CRG/20120502_FDF_CRG/20120511_FDF_CRG_c12.mtb	864	NA	WWFF	water	1	79266	1336810131	1	0.0599999999999998	0.00545454545454544	5697	1
2	Food 2	Intake 4	22	79590	1336810455	/users/cn/jespinosa/phecomp/data/CRG/20120502_FDF_CRG/20120502_FDF_CRG/20120511_FDF_CRG_c12.mtb	3637	1434	WWFF	food_fat	4	79568	1336810433	1	0.0200000000000005	0.000909090909090932	5698	1
2	Food 2	Intake 4	18	81042	1336811907	/users/cn/jespinosa/phecomp/data/CRG/20120502_FDF_CRG/20120502_FDF_CRG/20120511_FDF_CRG_c12.mtb	3641	2297	WWFF	food_fat	4	81024	1336811889	1	0.0200000000000005	0.00111111111111114	5699	1
2	Food 2	Intake 4	14	83353	1336814218	/users/cn/jespinosa/phecomp/data/CRG/20120502_FDF_CRG/20120502_FDF_CRG/20120511_FDF_CRG_c12.mtb	3649	189	WWFF	food_fat	4	83339	1336814204	1	0.0599999999999996	0.00428571428571426	5700	1
2	Food 2	Intake 4	15	83557	1336814422	/users/cn/jespinosa/phecomp/data/CRG/20120502_FDF_CRG/20120502_FDF_CRG/20120511_FDF_CRG_c12.mtb	3651	370	WWFF	food_fat	4	83542	1336814407	1	0.04	0.00266666666666667	5701	1
2	Food 2	Intake 4	11	83938	1336814803	/users/cn/jespinosa/phecomp/data/CRG/20120502_FDF_CRG/20120502_FDF_CRG/20120511_FDF_CRG_c12.mtb	3656	132	WWFF	food_fat	4	83927	1336814792	1	0.04	0.00363636363636364	5702	1
2	Food 2	Intake 4	11	84081	1336814946	/users/cn/jespinosa/phecomp/data/CRG/20120502_FDF_CRG/20120502_FDF_CRG/20120511_FDF_CRG_c12.mtb	3658	40	WWFF	food_fat	4	84070	1336814935	1	0.04	0.00363636363636364	5703	1
2	Food 2	Intake 4	60	84181	1336815046	/users/cn/jespinosa/phecomp/data/CRG/20120502_FDF_CRG/20120502_FDF_CRG/20120511_FDF_CRG_c12.mtb	3659	24	WWFF	food_fat	4	84121	1336814986	1	0.0599999999999996	0.000999999999999993	5704	1
2	Food 2	Intake 4	49	84254	1336815119	/users/cn/jespinosa/phecomp/data/CRG/20120502_FDF_CRG/20120502_FDF_CRG/20120511_FDF_CRG_c12.mtb	3660	1141	WWFF	food_fat	4	84205	1336815070	1	0.0999999999999996	0.0020408163265306	5705	1
2	Food 2	Intake 4	18	85413	1336816278	/users/cn/jespinosa/phecomp/data/CRG/20120502_FDF_CRG/20120502_FDF_CRG/20120511_FDF_CRG_c12.mtb	3663	568	WWFF	food_fat	4	85395	1336816260	1	0.0200000000000005	0.00111111111111114	5706	1
2	Food 2	Intake 4	16	85997	1336816862	/users/cn/jespinosa/phecomp/data/CRG/20120502_FDF_CRG/20120502_FDF_CRG/20120511_FDF_CRG_c12.mtb	3666	215	WWFF	food_fat	4	85981	1336816846	1	0.0800000000000001	0.00500000000000001	5707	1
2	Food 2	Intake 4	24	86236	1336817101	/users/cn/jespinosa/phecomp/data/CRG/20120502_FDF_CRG/20120502_FDF_CRG/20120511_FDF_CRG_c12.mtb	3667	595	WWFF	food_fat	4	86212	1336817077	1	0.0200000000000005	0.000833333333333354	5708	1
2	Food 2	Intake 4	26	86857	1336817722	/users/cn/jespinosa/phecomp/data/CRG/20120502_FDF_CRG/20120502_FDF_CRG/20120511_FDF_CRG_c12.mtb	3670	615	WWFF	food_fat	4	86831	1336817696	1	0.04	0.00153846153846154	5709	1
2	Food 2	Intake 4	11	87483	1336818348	/users/cn/jespinosa/phecomp/data/CRG/20120502_FDF_CRG/20120502_FDF_CRG/20120511_FDF_CRG_c12.mtb	3673	1319	WWFF	food_fat	4	87472	1336818337	1	0.0599999999999996	0.00545454545454542	5710	1
2	Food 2	Intake 4	12	88814	1336819679	/users/cn/jespinosa/phecomp/data/CRG/20120502_FDF_CRG/20120502_FDF_CRG/20120511_FDF_CRG_c12.mtb	3679	2237	WWFF	food_fat	4	88802	1336819667	1	0.0399999999999991	0.00333333333333326	5711	1
2	Food 2	Intake 4	29	91080	1336821945	/users/cn/jespinosa/phecomp/data/CRG/20120502_FDF_CRG/20120502_FDF_CRG/20120511_FDF_CRG_c12.mtb	3689	119	WWFF	food_fat	4	91051	1336821916	1	0.0999999999999996	0.00344827586206895	5712	1
2	Food 2	Intake 4	40	91239	1336822104	/users/cn/jespinosa/phecomp/data/CRG/20120502_FDF_CRG/20120502_FDF_CRG/20120511_FDF_CRG_c12.mtb	3690	COLL	WWFF	food_fat	4	91199	1336822064	1	0.16	0.004	5713	1
2	Food 1	Intake 3	20	91225	1336822090	/users/cn/jespinosa/phecomp/data/CRG/20120502_FDF_CRG/20120502_FDF_CRG/20120511_FDF_CRG_c12.mtb	2552	257	WWFF	food_fat	3	91205	1336822070	1	0.0200000000000014	0.00100000000000007	5714	1
2	Drink 1	Intake 1	43	91274	1336822139	/users/cn/jespinosa/phecomp/data/CRG/20120502_FDF_CRG/20120502_FDF_CRG/20120511_FDF_CRG_c12.mtb	865	NA	WWFF	water	1	91231	1336822096	1	0.1	0.00232558139534884	5715	1
2	Food 2	Intake 4	23	91505	1336822370	/users/cn/jespinosa/phecomp/data/CRG/20120502_FDF_CRG/20120502_FDF_CRG/20120511_FDF_CRG_c12.mtb	3693	652	WWFF	food_fat	4	91482	1336822347	1	0.119999999999999	0.00521739130434778	5716	1
2	Drink 1	Intake 1	28	91523	1336822388	/users/cn/jespinosa/phecomp/data/CRG/20120502_FDF_CRG/20120502_FDF_CRG/20120511_FDF_CRG_c12.mtb	866	NA	WWFF	water	1	91495	1336822360	1	0.0599999999999998	0.00214285714285714	5717	1
2	Drink 1	Intake 1	16	91762	1336822627	/users/cn/jespinosa/phecomp/data/CRG/20120502_FDF_CRG/20120502_FDF_CRG/20120511_FDF_CRG_c12.mtb	867	NA	WWFF	water	1	91746	1336822611	1	0.02	0.00125	5718	1
2	Drink 1	Intake 1	43	92102	1336822967	/users/cn/jespinosa/phecomp/data/CRG/20120502_FDF_CRG/20120502_FDF_CRG/20120511_FDF_CRG_c12.mtb	868	NA	WWFF	water	1	92059	1336822924	1	0.0800000000000001	0.00186046511627907	5719	1
2	Food 2	Intake 4	34	92191	1336823056	/users/cn/jespinosa/phecomp/data/CRG/20120502_FDF_CRG/20120502_FDF_CRG/20120511_FDF_CRG_c12.mtb	3697	16	WWFF	food_fat	4	92157	1336823022	1	0.04	0.00117647058823529	5720	1
2	Food 2	Intake 4	127	92334	1336823199	/users/cn/jespinosa/phecomp/data/CRG/20120502_FDF_CRG/20120502_FDF_CRG/20120511_FDF_CRG_c12.mtb	3698	155	WWFF	food_fat	4	92207	1336823072	1	0.0600000000000005	0.000472440944881894	5721	1
2	Food 2	Intake 4	16	92505	1336823370	/users/cn/jespinosa/phecomp/data/CRG/20120502_FDF_CRG/20120502_FDF_CRG/20120511_FDF_CRG_c12.mtb	3701	36	WWFF	food_fat	4	92489	1336823354	1	0.04	0.0025	5722	1
2	Food 2	Intake 4	289	92830	1336823695	/users/cn/jespinosa/phecomp/data/CRG/20120502_FDF_CRG/20120502_FDF_CRG/20120511_FDF_CRG_c12.mtb	3702	39	WWFF	food_fat	4	92541	1336823406	1	0.16	0.00055363321799308	5723	1
2	Food 2	Intake 4	12	92881	1336823746	/users/cn/jespinosa/phecomp/data/CRG/20120502_FDF_CRG/20120502_FDF_CRG/20120511_FDF_CRG_c12.mtb	3704	593	WWFF	food_fat	4	92869	1336823734	1	0.04	0.00333333333333333	5724	1
2	Food 2	Intake 4	12	93486	1336824351	/users/cn/jespinosa/phecomp/data/CRG/20120502_FDF_CRG/20120502_FDF_CRG/20120511_FDF_CRG_c12.mtb	3707	403	WWFF	food_fat	4	93474	1336824339	1	0.04	0.00333333333333333	5725	1
2	Food 2	Intake 4	17	93906	1336824771	/users/cn/jespinosa/phecomp/data/CRG/20120502_FDF_CRG/20120502_FDF_CRG/20120511_FDF_CRG_c12.mtb	3710	1651	WWFF	food_fat	4	93889	1336824754	1	0.04	0.00235294117647059	5726	1
2	Food 2	Intake 4	23	95580	1336826445	/users/cn/jespinosa/phecomp/data/CRG/20120502_FDF_CRG/20120502_FDF_CRG/20120511_FDF_CRG_c12.mtb	3715	781	WWFF	food_fat	4	95557	1336826422	1	0.04	0.00173913043478261	5727	1
2	Food 2	Intake 4	21	96382	1336827247	/users/cn/jespinosa/phecomp/data/CRG/20120502_FDF_CRG/20120502_FDF_CRG/20120511_FDF_CRG_c12.mtb	3717	1296	WWFF	food_fat	4	96361	1336827226	1	0.0200000000000005	0.000952380952380976	5728	1
2	Food 2	Intake 4	139	97817	1336828682	/users/cn/jespinosa/phecomp/data/CRG/20120502_FDF_CRG/20120502_FDF_CRG/20120511_FDF_CRG_c12.mtb	3722	COLL	WWFF	food_fat	4	97678	1336828543	1	0.14	0.00100719424460432	5729	1
2	Food 1	Intake 3	114	97807	1336828672	/users/cn/jespinosa/phecomp/data/CRG/20120502_FDF_CRG/20120502_FDF_CRG/20120511_FDF_CRG_c12.mtb	2554	44	WWFF	food_fat	3	97693	1336828558	1	0.0399999999999991	0.000350877192982448	5730	1
2	Food 2	Intake 4	64	97915	1336828780	/users/cn/jespinosa/phecomp/data/CRG/20120502_FDF_CRG/20120502_FDF_CRG/20120511_FDF_CRG_c12.mtb	3723	13	WWFF	food_fat	4	97851	1336828716	1	0.0200000000000005	0.000312500000000008	5731	1
2	Food 2	Intake 4	57	97985	1336828850	/users/cn/jespinosa/phecomp/data/CRG/20120502_FDF_CRG/20120502_FDF_CRG/20120511_FDF_CRG_c12.mtb	3724	77	WWFF	food_fat	4	97928	1336828793	1	0.0999999999999996	0.00175438596491227	5732	1
2	Food 2	Intake 4	280	98342	1336829207	/users/cn/jespinosa/phecomp/data/CRG/20120502_FDF_CRG/20120502_FDF_CRG/20120511_FDF_CRG_c12.mtb	3726	95	WWFF	food_fat	4	98062	1336828927	1	0.04	0.000142857142857143	5733	1
2	Drink 2	Intake 2	12	98305	1336829170	/users/cn/jespinosa/phecomp/data/CRG/20120502_FDF_CRG/20120502_FDF_CRG/20120511_FDF_CRG_c12.mtb	1312	NA	WWFF	water	2	98293	1336829158	1	0.02	0.00166666666666667	5734	1
2	Food 2	Intake 4	21	98458	1336829323	/users/cn/jespinosa/phecomp/data/CRG/20120502_FDF_CRG/20120502_FDF_CRG/20120511_FDF_CRG_c12.mtb	3728	120	WWFF	food_fat	4	98437	1336829302	1	0.0200000000000005	0.000952380952380976	5735	1
2	Food 2	Intake 4	20	98598	1336829463	/users/cn/jespinosa/phecomp/data/CRG/20120502_FDF_CRG/20120502_FDF_CRG/20120511_FDF_CRG_c12.mtb	3731	1487	WWFF	food_fat	4	98578	1336829443	1	0.0200000000000005	0.00100000000000002	5736	1
2	Food 2	Intake 4	15	100100	1336830965	/users/cn/jespinosa/phecomp/data/CRG/20120502_FDF_CRG/20120502_FDF_CRG/20120511_FDF_CRG_c12.mtb	3735	707	WWFF	food_fat	4	100085	1336830950	1	0.0800000000000001	0.00533333333333334	5737	1
2	Food 2	Intake 4	14	100821	1336831686	/users/cn/jespinosa/phecomp/data/CRG/20120502_FDF_CRG/20120502_FDF_CRG/20120511_FDF_CRG_c12.mtb	3737	449	WWFF	food_fat	4	100807	1336831672	1	0.0599999999999996	0.00428571428571426	5738	1
2	Food 2	Intake 4	20	101290	1336832155	/users/cn/jespinosa/phecomp/data/CRG/20120502_FDF_CRG/20120502_FDF_CRG/20120511_FDF_CRG_c12.mtb	3738	557	WWFF	food_fat	4	101270	1336832135	1	0.0800000000000001	0.00400000000000001	5739	1
2	Food 2	Intake 4	9	101856	1336832721	/users/cn/jespinosa/phecomp/data/CRG/20120502_FDF_CRG/20120502_FDF_CRG/20120511_FDF_CRG_c12.mtb	3743	98	WWFF	food_fat	4	101847	1336832712	1	0.04	0.00444444444444444	5740	1
2	Food 2	Intake 4	17	101971	1336832836	/users/cn/jespinosa/phecomp/data/CRG/20120502_FDF_CRG/20120502_FDF_CRG/20120511_FDF_CRG_c12.mtb	3744	345	WWFF	food_fat	4	101954	1336832819	1	0.0200000000000005	0.00117647058823532	5741	1
2	Food 2	Intake 4	13	102329	1336833194	/users/cn/jespinosa/phecomp/data/CRG/20120502_FDF_CRG/20120502_FDF_CRG/20120511_FDF_CRG_c12.mtb	3747	633	WWFF	food_fat	4	102316	1336833181	1	0.0200000000000005	0.00153846153846158	5742	1
2	Food 2	Intake 4	26	102988	1336833853	/users/cn/jespinosa/phecomp/data/CRG/20120502_FDF_CRG/20120502_FDF_CRG/20120511_FDF_CRG_c12.mtb	3749	421	WWFF	food_fat	4	102962	1336833827	1	0.0800000000000001	0.00307692307692308	5743	1
2	Food 2	Intake 4	20	103429	1336834294	/users/cn/jespinosa/phecomp/data/CRG/20120502_FDF_CRG/20120502_FDF_CRG/20120511_FDF_CRG_c12.mtb	3752	2356	WWFF	food_fat	4	103409	1336834274	1	0.04	0.002	5744	1
2	Food 2	Intake 4	10	105795	1336836660	/users/cn/jespinosa/phecomp/data/CRG/20120502_FDF_CRG/20120502_FDF_CRG/20120511_FDF_CRG_c12.mtb	3764	212	WWFF	food_fat	4	105785	1336836650	1	0.04	0.004	5745	1
2	Food 2	Intake 4	28	106035	1336836900	/users/cn/jespinosa/phecomp/data/CRG/20120502_FDF_CRG/20120502_FDF_CRG/20120511_FDF_CRG_c12.mtb	3766	15	WWFF	food_fat	4	106007	1336836872	1	0.0600000000000005	0.00214285714285716	5746	1
2	Food 2	Intake 4	12	106062	1336836927	/users/cn/jespinosa/phecomp/data/CRG/20120502_FDF_CRG/20120502_FDF_CRG/20120511_FDF_CRG_c12.mtb	3767	125	WWFF	food_fat	4	106050	1336836915	1	0.04	0.00333333333333333	5747	1
2	Food 2	Intake 4	26	106213	1336837078	/users/cn/jespinosa/phecomp/data/CRG/20120502_FDF_CRG/20120502_FDF_CRG/20120511_FDF_CRG_c12.mtb	3770	453	WWFF	food_fat	4	106187	1336837052	1	0.04	0.00153846153846154	5748	1
2	Food 2	Intake 4	37	106703	1336837568	/users/cn/jespinosa/phecomp/data/CRG/20120502_FDF_CRG/20120502_FDF_CRG/20120511_FDF_CRG_c12.mtb	3777	148	WWFF	food_fat	4	106666	1336837531	1	0.300000000000001	0.00810810810810813	5749	1
2	Drink 1	Intake 1	44	106738	1336837603	/users/cn/jespinosa/phecomp/data/CRG/20120502_FDF_CRG/20120502_FDF_CRG/20120511_FDF_CRG_c12.mtb	869	NA	WWFF	water	1	106694	1336837559	1	0.14	0.00318181818181818	5750	1
2	Food 2	Intake 4	16	106867	1336837732	/users/cn/jespinosa/phecomp/data/CRG/20120502_FDF_CRG/20120502_FDF_CRG/20120511_FDF_CRG_c12.mtb	3780	1929	WWFF	food_fat	4	106851	1336837716	1	0.140000000000001	0.00875000000000006	5751	1
2	Food 2	Intake 4	25	108821	1336839686	/users/cn/jespinosa/phecomp/data/CRG/20120502_FDF_CRG/20120502_FDF_CRG/20120511_FDF_CRG_c12.mtb	3785	102	WWFF	food_fat	4	108796	1336839661	1	0.0599999999999996	0.00239999999999998	5752	1
2	Food 2	Intake 4	22	108945	1336839810	/users/cn/jespinosa/phecomp/data/CRG/20120502_FDF_CRG/20120502_FDF_CRG/20120511_FDF_CRG_c12.mtb	3786	2273	WWFF	food_fat	4	108923	1336839788	1	0.0800000000000001	0.00363636363636364	5753	1
2	Food 2	Intake 4	10	111228	1336842093	/users/cn/jespinosa/phecomp/data/CRG/20120502_FDF_CRG/20120502_FDF_CRG/20120511_FDF_CRG_c12.mtb	3797	1136	WWFF	food_fat	4	111218	1336842083	1	0.0200000000000005	0.00200000000000005	5754	1
2	Food 2	Intake 4	89	112453	1336843318	/users/cn/jespinosa/phecomp/data/CRG/20120502_FDF_CRG/20120502_FDF_CRG/20120511_FDF_CRG_c12.mtb	3800	8	WWFF	food_fat	4	112364	1336843229	1	0.26	0.00292134831460674	5755	1
2	Drink 2	Intake 2	21	112415	1336843280	/users/cn/jespinosa/phecomp/data/CRG/20120502_FDF_CRG/20120502_FDF_CRG/20120511_FDF_CRG_c12.mtb	1313	NA	WWFF	water	2	112394	1336843259	1	0.0600000000000001	0.00285714285714286	5756	1
2	Food 2	Intake 4	29	112490	1336843355	/users/cn/jespinosa/phecomp/data/CRG/20120502_FDF_CRG/20120502_FDF_CRG/20120511_FDF_CRG_c12.mtb	3801	25	WWFF	food_fat	4	112461	1336843326	1	0.0600000000000005	0.0020689655172414	5757	1
2	Food 2	Intake 4	12	112527	1336843392	/users/cn/jespinosa/phecomp/data/CRG/20120502_FDF_CRG/20120502_FDF_CRG/20120511_FDF_CRG_c12.mtb	3802	104	WWFF	food_fat	4	112515	1336843380	1	0.04	0.00333333333333333	5758	1
2	Food 2	Intake 4	72	112703	1336843568	/users/cn/jespinosa/phecomp/data/CRG/20120502_FDF_CRG/20120502_FDF_CRG/20120511_FDF_CRG_c12.mtb	3803	58	WWFF	food_fat	4	112631	1336843496	1	0.04	0.000555555555555556	5759	1
2	Food 2	Intake 4	27	112788	1336843653	/users/cn/jespinosa/phecomp/data/CRG/20120502_FDF_CRG/20120502_FDF_CRG/20120511_FDF_CRG_c12.mtb	3804	266	WWFF	food_fat	4	112761	1336843626	1	0.04	0.00148148148148148	5760	1
2	Food 2	Intake 4	39	113093	1336843958	/users/cn/jespinosa/phecomp/data/CRG/20120502_FDF_CRG/20120502_FDF_CRG/20120511_FDF_CRG_c12.mtb	3808	22	WWFF	food_fat	4	113054	1336843919	1	0.0999999999999996	0.00256410256410255	5761	1
2	Food 2	Intake 4	12	113127	1336843992	/users/cn/jespinosa/phecomp/data/CRG/20120502_FDF_CRG/20120502_FDF_CRG/20120511_FDF_CRG_c12.mtb	3809	419	WWFF	food_fat	4	113115	1336843980	1	0.04	0.00333333333333333	5762	1
2	Food 2	Intake 4	12	113558	1336844423	/users/cn/jespinosa/phecomp/data/CRG/20120502_FDF_CRG/20120502_FDF_CRG/20120511_FDF_CRG_c12.mtb	3810	96	WWFF	food_fat	4	113546	1336844411	1	0.04	0.00333333333333333	5763	1
2	Food 2	Intake 4	29	113683	1336844548	/users/cn/jespinosa/phecomp/data/CRG/20120502_FDF_CRG/20120502_FDF_CRG/20120511_FDF_CRG_c12.mtb	3811	1405	WWFF	food_fat	4	113654	1336844519	1	0.12	0.00413793103448276	5764	1
2	Food 2	Intake 4	85	115173	1336846038	/users/cn/jespinosa/phecomp/data/CRG/20120502_FDF_CRG/20120502_FDF_CRG/20120511_FDF_CRG_c12.mtb	3819	28	WWFF	food_fat	4	115088	1336845953	1	0.0600000000000005	0.000705882352941182	5765	1
2	Food 2	Intake 4	21	115222	1336846087	/users/cn/jespinosa/phecomp/data/CRG/20120502_FDF_CRG/20120502_FDF_CRG/20120511_FDF_CRG_c12.mtb	3820	38	WWFF	food_fat	4	115201	1336846066	1	0.04	0.0019047619047619	5766	1
2	Food 2	Intake 4	33	115293	1336846158	/users/cn/jespinosa/phecomp/data/CRG/20120502_FDF_CRG/20120502_FDF_CRG/20120511_FDF_CRG_c12.mtb	3821	59	WWFF	food_fat	4	115260	1336846125	1	0.0599999999999996	0.00181818181818181	5767	1
2	Food 2	Intake 4	9	115361	1336846226	/users/cn/jespinosa/phecomp/data/CRG/20120502_FDF_CRG/20120502_FDF_CRG/20120511_FDF_CRG_c12.mtb	3822	177	WWFF	food_fat	4	115352	1336846217	1	0.0600000000000005	0.00666666666666672	5768	1
2	Food 2	Intake 4	186	115724	1336846589	/users/cn/jespinosa/phecomp/data/CRG/20120502_FDF_CRG/20120502_FDF_CRG/20120511_FDF_CRG_c12.mtb	3825	260	WWFF	food_fat	4	115538	1336846403	1	0.0800000000000001	0.000430107526881721	5769	1
2	Food 2	Intake 4	44	116028	1336846893	/users/cn/jespinosa/phecomp/data/CRG/20120502_FDF_CRG/20120502_FDF_CRG/20120511_FDF_CRG_c12.mtb	3829	143	WWFF	food_fat	4	115984	1336846849	1	0.0599999999999996	0.00136363636363635	5770	1
2	Food 2	Intake 4	37	116208	1336847073	/users/cn/jespinosa/phecomp/data/CRG/20120502_FDF_CRG/20120502_FDF_CRG/20120511_FDF_CRG_c12.mtb	3832	385	WWFF	food_fat	4	116171	1336847036	1	0.180000000000001	0.00486486486486489	5771	1
2	Food 2	Intake 4	19	116612	1336847477	/users/cn/jespinosa/phecomp/data/CRG/20120502_FDF_CRG/20120502_FDF_CRG/20120511_FDF_CRG_c12.mtb	3834	349	WWFF	food_fat	4	116593	1336847458	1	0.04	0.00210526315789474	5772	1
2	Food 2	Intake 4	12	116973	1336847838	/users/cn/jespinosa/phecomp/data/CRG/20120502_FDF_CRG/20120502_FDF_CRG/20120511_FDF_CRG_c12.mtb	3837	140	WWFF	food_fat	4	116961	1336847826	1	0.0600000000000005	0.00500000000000004	5773	1
2	Food 2	Intake 4	11	117124	1336847989	/users/cn/jespinosa/phecomp/data/CRG/20120502_FDF_CRG/20120502_FDF_CRG/20120511_FDF_CRG_c12.mtb	3838	896	WWFF	food_fat	4	117113	1336847978	1	0.0599999999999996	0.00545454545454542	5774	1
2	Food 2	Intake 4	36	118056	1336848921	/users/cn/jespinosa/phecomp/data/CRG/20120502_FDF_CRG/20120502_FDF_CRG/20120511_FDF_CRG_c12.mtb	3842	158	WWFF	food_fat	4	118020	1336848885	1	0.18	0.005	5775	1
2	Food 2	Intake 4	14	118228	1336849093	/users/cn/jespinosa/phecomp/data/CRG/20120502_FDF_CRG/20120502_FDF_CRG/20120511_FDF_CRG_c12.mtb	3845	226	WWFF	food_fat	4	118214	1336849079	1	0.0800000000000001	0.00571428571428572	5776	1
2	Food 2	Intake 4	33	118487	1336849352	/users/cn/jespinosa/phecomp/data/CRG/20120502_FDF_CRG/20120502_FDF_CRG/20120511_FDF_CRG_c12.mtb	3850	144	WWFF	food_fat	4	118454	1336849319	1	0.0999999999999996	0.00303030303030302	5777	1
2	Food 2	Intake 4	13	118644	1336849509	/users/cn/jespinosa/phecomp/data/CRG/20120502_FDF_CRG/20120502_FDF_CRG/20120511_FDF_CRG_c12.mtb	3851	407	WWFF	food_fat	4	118631	1336849496	1	0.0200000000000005	0.00153846153846158	5778	1
2	Drink 2	Intake 2	16	118690	1336849555	/users/cn/jespinosa/phecomp/data/CRG/20120502_FDF_CRG/20120502_FDF_CRG/20120511_FDF_CRG_c12.mtb	1316	NA	WWFF	water	2	118674	1336849539	1	0.02	0.00125	5779	1
2	Food 2	Intake 4	155	119206	1336850071	/users/cn/jespinosa/phecomp/data/CRG/20120502_FDF_CRG/20120502_FDF_CRG/20120511_FDF_CRG_c12.mtb	3853	37	WWFF	food_fat	4	119051	1336849916	1	0.0799999999999992	0.000516129032258059	5780	1
2	Food 2	Intake 4	185	119428	1336850293	/users/cn/jespinosa/phecomp/data/CRG/20120502_FDF_CRG/20120502_FDF_CRG/20120511_FDF_CRG_c12.mtb	3854	128	WWFF	food_fat	4	119243	1336850108	1	0.0600000000000005	0.000324324324324327	5781	1
2	Food 2	Intake 4	19	119575	1336850440	/users/cn/jespinosa/phecomp/data/CRG/20120502_FDF_CRG/20120502_FDF_CRG/20120511_FDF_CRG_c12.mtb	3856	7	WWFF	food_fat	4	119556	1336850421	1	0.0800000000000001	0.00421052631578948	5782	1
2	Food 2	Intake 4	178	119760	1336850625	/users/cn/jespinosa/phecomp/data/CRG/20120502_FDF_CRG/20120502_FDF_CRG/20120511_FDF_CRG_c12.mtb	3857	88	WWFF	food_fat	4	119582	1336850447	1	0.100000000000001	0.000561797752808994	5783	1
2	Food 2	Intake 4	155	120003	1336850868	/users/cn/jespinosa/phecomp/data/CRG/20120502_FDF_CRG/20120502_FDF_CRG/20120511_FDF_CRG_c12.mtb	3858	COLL	WWFF	food_fat	4	119848	1336850713	1	0.22	0.00141935483870968	5784	1
2	Food 1	Intake 3	17	119866	1336850731	/users/cn/jespinosa/phecomp/data/CRG/20120502_FDF_CRG/20120502_FDF_CRG/20120511_FDF_CRG_c12.mtb	2556	159	WWFF	food_fat	3	119849	1336850714	1	0.0200000000000014	0.00117647058823538	5785	1
2	Food 2	Intake 4	13	120038	1336850903	/users/cn/jespinosa/phecomp/data/CRG/20120502_FDF_CRG/20120502_FDF_CRG/20120511_FDF_CRG_c12.mtb	3859	51	WWFF	food_fat	4	120025	1336850890	1	0.04	0.00307692307692308	5786	1
2	Food 2	Intake 4	97	120186	1336851051	/users/cn/jespinosa/phecomp/data/CRG/20120502_FDF_CRG/20120502_FDF_CRG/20120511_FDF_CRG_c12.mtb	3860	6	WWFF	food_fat	4	120089	1336850954	1	0.04	0.000412371134020619	5787	1
2	Drink 1	Intake 1	30	120203	1336851068	/users/cn/jespinosa/phecomp/data/CRG/20120502_FDF_CRG/20120502_FDF_CRG/20120511_FDF_CRG_c12.mtb	872	NA	WWFF	water	1	120173	1336851038	1	0.04	0.00133333333333333	5788	1
2	Food 2	Intake 4	187	120379	1336851244	/users/cn/jespinosa/phecomp/data/CRG/20120502_FDF_CRG/20120502_FDF_CRG/20120511_FDF_CRG_c12.mtb	3861	87	WWFF	food_fat	4	120192	1336851057	1	0.48	0.0025668449197861	5789	1
2	Food 2	Intake 4	138	120604	1336851469	/users/cn/jespinosa/phecomp/data/CRG/20120502_FDF_CRG/20120502_FDF_CRG/20120511_FDF_CRG_c12.mtb	3862	553	WWFF	food_fat	4	120466	1336851331	1	0.56	0.00405797101449275	5790	1
2	Food 2	Intake 4	46	121203	1336852068	/users/cn/jespinosa/phecomp/data/CRG/20120502_FDF_CRG/20120502_FDF_CRG/20120511_FDF_CRG_c12.mtb	3866	25	WWFF	food_fat	4	121157	1336852022	1	0.14	0.00304347826086957	5791	1
2	Food 2	Intake 4	120	121348	1336852213	/users/cn/jespinosa/phecomp/data/CRG/20120502_FDF_CRG/20120502_FDF_CRG/20120511_FDF_CRG_c12.mtb	3867	7	WWFF	food_fat	4	121228	1336852093	1	0.04	0.000333333333333333	5792	1
2	Drink 1	Intake 1	20	121287	1336852152	/users/cn/jespinosa/phecomp/data/CRG/20120502_FDF_CRG/20120502_FDF_CRG/20120511_FDF_CRG_c12.mtb	873	NA	WWFF	water	1	121267	1336852132	1	0.02	0.001	5793	1
2	Food 2	Intake 4	226	121581	1336852446	/users/cn/jespinosa/phecomp/data/CRG/20120502_FDF_CRG/20120502_FDF_CRG/20120511_FDF_CRG_c12.mtb	3868	154	WWFF	food_fat	4	121355	1336852220	1	0.22	0.000973451327433628	5794	1
2	Drink 1	Intake 1	24	121594	1336852459	/users/cn/jespinosa/phecomp/data/CRG/20120502_FDF_CRG/20120502_FDF_CRG/20120511_FDF_CRG_c12.mtb	874	NA	WWFF	water	1	121570	1336852435	1	0.02	0.000833333333333333	5795	1
2	Food 2	Intake 4	150	121885	1336852750	/users/cn/jespinosa/phecomp/data/CRG/20120502_FDF_CRG/20120502_FDF_CRG/20120511_FDF_CRG_c12.mtb	3870	82	WWFF	food_fat	4	121735	1336852600	1	0.0600000000000005	0.000400000000000003	5796	1
2	Food 2	Intake 4	120	122087	1336852952	/users/cn/jespinosa/phecomp/data/CRG/20120502_FDF_CRG/20120502_FDF_CRG/20120511_FDF_CRG_c12.mtb	3872	165	WWFF	food_fat	4	121967	1336852832	1	0.04	0.000333333333333333	5797	1
2	Food 2	Intake 4	13	122265	1336853130	/users/cn/jespinosa/phecomp/data/CRG/20120502_FDF_CRG/20120502_FDF_CRG/20120511_FDF_CRG_c12.mtb	3874	104	WWFF	food_fat	4	122252	1336853117	1	0.04	0.00307692307692308	5798	1
2	Food 2	Intake 4	17	122386	1336853251	/users/cn/jespinosa/phecomp/data/CRG/20120502_FDF_CRG/20120502_FDF_CRG/20120511_FDF_CRG_c12.mtb	3875	329	WWFF	food_fat	4	122369	1336853234	1	0.04	0.00235294117647059	5799	1
2	Food 2	Intake 4	14	122729	1336853594	/users/cn/jespinosa/phecomp/data/CRG/20120502_FDF_CRG/20120502_FDF_CRG/20120511_FDF_CRG_c12.mtb	3877	976	WWFF	food_fat	4	122715	1336853580	1	0.0599999999999996	0.00428571428571426	5800	1
2	Drink 1	Intake 1	20	122903	1336853768	/users/cn/jespinosa/phecomp/data/CRG/20120502_FDF_CRG/20120502_FDF_CRG/20120511_FDF_CRG_c12.mtb	875	NA	WWFF	water	1	122883	1336853748	1	0.0399999999999998	0.00199999999999999	5801	1
2	Food 2	Intake 4	252	123957	1336854822	/users/cn/jespinosa/phecomp/data/CRG/20120502_FDF_CRG/20120502_FDF_CRG/20120511_FDF_CRG_c12.mtb	3881	33	WWFF	food_fat	4	123705	1336854570	1	2.28	0.00904761904761905	5802	1
2	Food 2	Intake 4	218	124208	1336855073	/users/cn/jespinosa/phecomp/data/CRG/20120502_FDF_CRG/20120502_FDF_CRG/20120511_FDF_CRG_c12.mtb	3882	183	WWFF	food_fat	4	123990	1336854855	1	0.699999999999999	0.00321100917431192	5803	1
2	Drink 1	Intake 1	15	124100	1336854965	/users/cn/jespinosa/phecomp/data/CRG/20120502_FDF_CRG/20120502_FDF_CRG/20120511_FDF_CRG_c12.mtb	877	NA	WWFF	water	1	124085	1336854950	1	0.02	0.00133333333333333	5804	1
2	Food 2	Intake 4	255	124646	1336855511	/users/cn/jespinosa/phecomp/data/CRG/20120502_FDF_CRG/20120502_FDF_CRG/20120511_FDF_CRG_c12.mtb	3884	39	WWFF	food_fat	4	124391	1336855256	1	0.16	0.000627450980392157	5805	1
2	Food 2	Intake 4	563	125248	1336856113	/users/cn/jespinosa/phecomp/data/CRG/20120502_FDF_CRG/20120502_FDF_CRG/20120511_FDF_CRG_c12.mtb	3885	358	WWFF	food_fat	4	124685	1336855550	1	0.16	0.000284191829484902	5806	1
2	Drink 1	Intake 1	20	124751	1336855616	/users/cn/jespinosa/phecomp/data/CRG/20120502_FDF_CRG/20120502_FDF_CRG/20120511_FDF_CRG_c12.mtb	879	NA	WWFF	water	1	124731	1336855596	1	0.02	0.001	5807	1
2	Drink 2	Intake 2	101	125083	1336855948	/users/cn/jespinosa/phecomp/data/CRG/20120502_FDF_CRG/20120502_FDF_CRG/20120511_FDF_CRG_c12.mtb	1325	NA	WWFF	water	2	124982	1336855847	1	0.0599999999999999	0.000594059405940593	5808	1
2	Drink 2	Intake 2	12	125128	1336855993	/users/cn/jespinosa/phecomp/data/CRG/20120502_FDF_CRG/20120502_FDF_CRG/20120511_FDF_CRG_c12.mtb	1326	NA	WWFF	water	2	125116	1336855981	1	0.02	0.00166666666666667	5809	1
2	Food 2	Intake 4	567	126173	1336857038	/users/cn/jespinosa/phecomp/data/CRG/20120502_FDF_CRG/20120502_FDF_CRG/20120511_FDF_CRG_c12.mtb	3887	4	WWFF	food_fat	4	125606	1336856471	1	0.119999999999999	0.00021164021164021	5810	1
2	Food 2	Intake 4	81	126258	1336857123	/users/cn/jespinosa/phecomp/data/CRG/20120502_FDF_CRG/20120502_FDF_CRG/20120511_FDF_CRG_c12.mtb	3888	1983	WWFF	food_fat	4	126177	1336857042	1	0.0400000000000009	0.000493827160493838	5811	1
2	Food 2	Intake 4	71	128312	1336859177	/users/cn/jespinosa/phecomp/data/CRG/20120502_FDF_CRG/20120502_FDF_CRG/20120511_FDF_CRG_c12.mtb	3911	16	WWFF	food_fat	4	128241	1336859106	1	0.24	0.00338028169014084	5812	1
2	Drink 2	Intake 2	24	128275	1336859140	/users/cn/jespinosa/phecomp/data/CRG/20120502_FDF_CRG/20120502_FDF_CRG/20120511_FDF_CRG_c12.mtb	1328	NA	WWFF	water	2	128251	1336859116	1	0.02	0.000833333333333333	5813	1
2	Food 2	Intake 4	12	128340	1336859205	/users/cn/jespinosa/phecomp/data/CRG/20120502_FDF_CRG/20120502_FDF_CRG/20120511_FDF_CRG_c12.mtb	3912	290	WWFF	food_fat	4	128328	1336859193	1	0.0399999999999991	0.00333333333333326	5814	1
2	Food 2	Intake 4	12	128642	1336859507	/users/cn/jespinosa/phecomp/data/CRG/20120502_FDF_CRG/20120502_FDF_CRG/20120511_FDF_CRG_c12.mtb	3913	381	WWFF	food_fat	4	128630	1336859495	1	0.0400000000000009	0.00333333333333341	5815	1
2	Food 2	Intake 4	221	129244	1336860109	/users/cn/jespinosa/phecomp/data/CRG/20120502_FDF_CRG/20120502_FDF_CRG/20120511_FDF_CRG_c12.mtb	3917	16	WWFF	food_fat	4	129023	1336859888	1	0.0600000000000005	0.000271493212669686	5816	1
2	Food 2	Intake 4	222	129482	1336860347	/users/cn/jespinosa/phecomp/data/CRG/20120502_FDF_CRG/20120502_FDF_CRG/20120511_FDF_CRG_c12.mtb	3918	825	WWFF	food_fat	4	129260	1336860125	1	0.4	0.0018018018018018	5817	1
2	Drink 2	Intake 2	39	130245	1336861110	/users/cn/jespinosa/phecomp/data/CRG/20120502_FDF_CRG/20120502_FDF_CRG/20120511_FDF_CRG_c12.mtb	1334	NA	WWFF	water	2	130206	1336861071	1	0.02	0.000512820512820513	5818	1
2	Drink 1	Intake 1	51	130289	1336861154	/users/cn/jespinosa/phecomp/data/CRG/20120502_FDF_CRG/20120502_FDF_CRG/20120511_FDF_CRG_c12.mtb	883	NA	WWFF	water	1	130238	1336861103	1	0.0799999999999998	0.00156862745098039	5819	1
2	Food 2	Intake 4	369	130676	1336861541	/users/cn/jespinosa/phecomp/data/CRG/20120502_FDF_CRG/20120502_FDF_CRG/20120511_FDF_CRG_c12.mtb	3921	COLL	WWFF	food_fat	4	130307	1336861172	1	0.640000000000001	0.00173441734417344	5820	1
2	Food 1	Intake 3	46	130584	1336861449	/users/cn/jespinosa/phecomp/data/CRG/20120502_FDF_CRG/20120502_FDF_CRG/20120511_FDF_CRG_c12.mtb	2568	107	WWFF	food_fat	3	130538	1336861403	1	0.0200000000000014	0.000434782608695683	5821	1
2	Food 2	Intake 4	23	130714	1336861579	/users/cn/jespinosa/phecomp/data/CRG/20120502_FDF_CRG/20120502_FDF_CRG/20120511_FDF_CRG_c12.mtb	3922	34	WWFF	food_fat	4	130691	1336861556	1	0.0399999999999991	0.00173913043478257	5822	1
2	Food 2	Intake 4	407	131155	1336862020	/users/cn/jespinosa/phecomp/data/CRG/20120502_FDF_CRG/20120502_FDF_CRG/20120511_FDF_CRG_c12.mtb	3923	27	WWFF	food_fat	4	130748	1336861613	1	0.119999999999999	0.000294840294840292	5823	1
2	Food 2	Intake 4	37	131219	1336862084	/users/cn/jespinosa/phecomp/data/CRG/20120502_FDF_CRG/20120502_FDF_CRG/20120511_FDF_CRG_c12.mtb	3924	206	WWFF	food_fat	4	131182	1336862047	1	0.0200000000000014	0.000540540540540578	5824	1
2	Food 2	Intake 4	110	131535	1336862400	/users/cn/jespinosa/phecomp/data/CRG/20120502_FDF_CRG/20120502_FDF_CRG/20120511_FDF_CRG_c12.mtb	3926	756	WWFF	food_fat	4	131425	1336862290	1	0.0800000000000001	0.000727272727272728	5825	1
2	Food 2	Intake 4	28	132319	1336863184	/users/cn/jespinosa/phecomp/data/CRG/20120502_FDF_CRG/20120502_FDF_CRG/20120511_FDF_CRG_c12.mtb	3931	237	WWFF	food_fat	4	132291	1336863156	1	0.0800000000000001	0.00285714285714286	5826	1
2	Food 2	Intake 4	30	132586	1336863451	/users/cn/jespinosa/phecomp/data/CRG/20120502_FDF_CRG/20120502_FDF_CRG/20120511_FDF_CRG_c12.mtb	3932	6	WWFF	food_fat	4	132556	1336863421	1	0.0200000000000014	0.000666666666666713	5827	1
2	Food 2	Intake 4	53	132645	1336863510	/users/cn/jespinosa/phecomp/data/CRG/20120502_FDF_CRG/20120502_FDF_CRG/20120511_FDF_CRG_c12.mtb	3933	151	WWFF	food_fat	4	132592	1336863457	1	0.0599999999999987	0.00113207547169809	5828	1
2	Food 2	Intake 4	17	132813	1336863678	/users/cn/jespinosa/phecomp/data/CRG/20120502_FDF_CRG/20120502_FDF_CRG/20120511_FDF_CRG_c12.mtb	3934	1783	WWFF	food_fat	4	132796	1336863661	1	0.0400000000000009	0.00235294117647064	5829	1
2	Food 2	Intake 4	72	134668	1336865533	/users/cn/jespinosa/phecomp/data/CRG/20120502_FDF_CRG/20120502_FDF_CRG/20120511_FDF_CRG_c12.mtb	3937	478	WWFF	food_fat	4	134596	1336865461	1	0.0600000000000005	0.00083333333333334	5830	1
2	Food 2	Intake 4	19	135165	1336866030	/users/cn/jespinosa/phecomp/data/CRG/20120502_FDF_CRG/20120502_FDF_CRG/20120511_FDF_CRG_c12.mtb	3941	41	WWFF	food_fat	4	135146	1336866011	1	0.0400000000000009	0.00210526315789478	5831	1
2	Food 2	Intake 4	26	135232	1336866097	/users/cn/jespinosa/phecomp/data/CRG/20120502_FDF_CRG/20120502_FDF_CRG/20120511_FDF_CRG_c12.mtb	3942	379	WWFF	food_fat	4	135206	1336866071	1	0.0800000000000001	0.00307692307692308	5832	1
2	Food 2	Intake 4	17	135628	1336866493	/users/cn/jespinosa/phecomp/data/CRG/20120502_FDF_CRG/20120502_FDF_CRG/20120511_FDF_CRG_c12.mtb	3945	342	WWFF	food_fat	4	135611	1336866476	1	0.220000000000001	0.0129411764705883	5833	1
2	Drink 2	Intake 2	27	135642	1336866507	/users/cn/jespinosa/phecomp/data/CRG/20120502_FDF_CRG/20120502_FDF_CRG/20120511_FDF_CRG_c12.mtb	1336	NA	WWFF	water	2	135615	1336866480	1	0.1	0.0037037037037037	5834	1
2	Food 2	Intake 4	23	135993	1336866858	/users/cn/jespinosa/phecomp/data/CRG/20120502_FDF_CRG/20120502_FDF_CRG/20120511_FDF_CRG_c12.mtb	3947	621	WWFF	food_fat	4	135970	1336866835	1	0.16	0.00695652173913044	5835	1
2	Food 2	Intake 4	335	136949	1336867814	/users/cn/jespinosa/phecomp/data/CRG/20120502_FDF_CRG/20120502_FDF_CRG/20120511_FDF_CRG_c12.mtb	3951	8	WWFF	food_fat	4	136614	1336867479	1	0.0399999999999991	0.000119402985074624	5836	1
2	Drink 1	Intake 1	12	136758	1336867623	/users/cn/jespinosa/phecomp/data/CRG/20120502_FDF_CRG/20120502_FDF_CRG/20120511_FDF_CRG_c12.mtb	884	NA	WWFF	water	1	136746	1336867611	1	0.04	0.00333333333333333	5837	1
2	Food 2	Intake 4	293	137250	1336868115	/users/cn/jespinosa/phecomp/data/CRG/20120502_FDF_CRG/20120502_FDF_CRG/20120511_FDF_CRG_c12.mtb	3952	COLL	WWFF	food_fat	4	136957	1336867822	1	0.0999999999999996	0.000341296928327644	5838	1
2	Food 1	Intake 3	67	137247	1336868112	/users/cn/jespinosa/phecomp/data/CRG/20120502_FDF_CRG/20120502_FDF_CRG/20120511_FDF_CRG_c12.mtb	2573	49	WWFF	food_fat	3	137180	1336868045	1	0.0800000000000001	0.00119402985074627	5839	1
2	Food 2	Intake 4	349	137645	1336868510	/users/cn/jespinosa/phecomp/data/CRG/20120502_FDF_CRG/20120502_FDF_CRG/20120511_FDF_CRG_c12.mtb	3953	COLL	WWFF	food_fat	4	137296	1336868161	1	0.140000000000001	0.00040114613180516	5840	1
2	Drink 2	Intake 2	31	137330	1336868195	/users/cn/jespinosa/phecomp/data/CRG/20120502_FDF_CRG/20120502_FDF_CRG/20120511_FDF_CRG_c12.mtb	1340	NA	WWFF	water	2	137299	1336868164	1	0.02	0.000645161290322581	5841	1
2	Food 1	Intake 3	311	137643	1336868508	/users/cn/jespinosa/phecomp/data/CRG/20120502_FDF_CRG/20120502_FDF_CRG/20120511_FDF_CRG_c12.mtb	2574	81	WWFF	food_fat	3	137332	1336868197	1	0.94	0.00302250803858521	5842	1
2	Food 1	Intake 3	91	137815	1336868680	/users/cn/jespinosa/phecomp/data/CRG/20120502_FDF_CRG/20120502_FDF_CRG/20120511_FDF_CRG_c12.mtb	2575	68	WWFF	food_fat	3	137724	1336868589	1	1.16	0.0127472527472527	5843	1
2	Drink 2	Intake 2	29	137840	1336868705	/users/cn/jespinosa/phecomp/data/CRG/20120502_FDF_CRG/20120502_FDF_CRG/20120511_FDF_CRG_c12.mtb	1341	NA	WWFF	water	2	137811	1336868676	1	0.04	0.00137931034482759	5844	1
2	Food 1	Intake 3	45	137928	1336868793	/users/cn/jespinosa/phecomp/data/CRG/20120502_FDF_CRG/20120502_FDF_CRG/20120511_FDF_CRG_c12.mtb	2576	21	WWFF	food_fat	3	137883	1336868748	1	0.52	0.0115555555555556	5845	1
2	Food 1	Intake 3	181	138130	1336868995	/users/cn/jespinosa/phecomp/data/CRG/20120502_FDF_CRG/20120502_FDF_CRG/20120511_FDF_CRG_c12.mtb	2577	650	WWFF	food_fat	3	137949	1336868814	1	2.22	0.0122651933701657	5846	1
2	Drink 2	Intake 2	23	138627	1336869492	/users/cn/jespinosa/phecomp/data/CRG/20120502_FDF_CRG/20120502_FDF_CRG/20120511_FDF_CRG_c12.mtb	1342	NA	WWFF	water	2	138604	1336869469	1	0.02	0.000869565217391304	5847	1
2	Food 2	Intake 4	17	138797	1336869662	/users/cn/jespinosa/phecomp/data/CRG/20120502_FDF_CRG/20120502_FDF_CRG/20120511_FDF_CRG_c12.mtb	3964	376	WWFF	food_fat	4	138780	1336869645	1	0.0599999999999987	0.00352941176470581	5848	1
2	Food 2	Intake 4	18	139191	1336870056	/users/cn/jespinosa/phecomp/data/CRG/20120502_FDF_CRG/20120502_FDF_CRG/20120511_FDF_CRG_c12.mtb	3967	169	WWFF	food_fat	4	139173	1336870038	1	0.0399999999999991	0.00222222222222217	5849	1
2	Food 2	Intake 4	50	139410	1336870275	/users/cn/jespinosa/phecomp/data/CRG/20120502_FDF_CRG/20120502_FDF_CRG/20120511_FDF_CRG_c12.mtb	3969	548	WWFF	food_fat	4	139360	1336870225	1	0.0400000000000009	0.000800000000000018	5850	1
2	Food 2	Intake 4	14	139972	1336870837	/users/cn/jespinosa/phecomp/data/CRG/20120502_FDF_CRG/20120502_FDF_CRG/20120511_FDF_CRG_c12.mtb	3976	849	WWFF	food_fat	4	139958	1336870823	1	0.0600000000000005	0.00428571428571432	5851	1
2	Food 2	Intake 4	15	140836	1336871701	/users/cn/jespinosa/phecomp/data/CRG/20120502_FDF_CRG/20120502_FDF_CRG/20120511_FDF_CRG_c12.mtb	3980	25	WWFF	food_fat	4	140821	1336871686	1	0.0600000000000005	0.00400000000000003	5852	1
2	Food 2	Intake 4	92	140953	1336871818	/users/cn/jespinosa/phecomp/data/CRG/20120502_FDF_CRG/20120502_FDF_CRG/20120511_FDF_CRG_c12.mtb	3981	981	WWFF	food_fat	4	140861	1336871726	1	0.0600000000000005	0.000652173913043484	5853	1
2	Food 2	Intake 4	20	141954	1336872819	/users/cn/jespinosa/phecomp/data/CRG/20120502_FDF_CRG/20120502_FDF_CRG/20120511_FDF_CRG_c12.mtb	3986	1167	WWFF	food_fat	4	141934	1336872799	1	0.0400000000000009	0.00200000000000005	5854	1
2	Drink 2	Intake 2	20	142770	1336873635	/users/cn/jespinosa/phecomp/data/CRG/20120502_FDF_CRG/20120502_FDF_CRG/20120511_FDF_CRG_c12.mtb	1346	NA	WWFF	water	2	142750	1336873615	1	0.0599999999999998	0.00299999999999999	5855	1
2	Food 2	Intake 4	17	143138	1336874003	/users/cn/jespinosa/phecomp/data/CRG/20120502_FDF_CRG/20120502_FDF_CRG/20120511_FDF_CRG_c12.mtb	3989	892	WWFF	food_fat	4	143121	1336873986	1	0.0200000000000014	0.00117647058823538	5856	1
2	Food 2	Intake 4	15	144045	1336874910	/users/cn/jespinosa/phecomp/data/CRG/20120502_FDF_CRG/20120502_FDF_CRG/20120511_FDF_CRG_c12.mtb	3997	30	WWFF	food_fat	4	144030	1336874895	1	0.0400000000000009	0.00266666666666673	5857	1
2	Food 2	Intake 4	12	144087	1336874952	/users/cn/jespinosa/phecomp/data/CRG/20120502_FDF_CRG/20120502_FDF_CRG/20120511_FDF_CRG_c12.mtb	3999	213	WWFF	food_fat	4	144075	1336874940	1	0.0600000000000005	0.00500000000000004	5858	1
2	Food 2	Intake 4	25	144325	1336875190	/users/cn/jespinosa/phecomp/data/CRG/20120502_FDF_CRG/20120502_FDF_CRG/20120511_FDF_CRG_c12.mtb	4002	38	WWFF	food_fat	4	144300	1336875165	1	0.0600000000000005	0.00240000000000002	5859	1
2	Food 2	Intake 4	12	144375	1336875240	/users/cn/jespinosa/phecomp/data/CRG/20120502_FDF_CRG/20120502_FDF_CRG/20120511_FDF_CRG_c12.mtb	4004	491	WWFF	food_fat	4	144363	1336875228	1	0.0600000000000005	0.00500000000000004	5860	1
2	Food 2	Intake 4	22	144888	1336875753	/users/cn/jespinosa/phecomp/data/CRG/20120502_FDF_CRG/20120502_FDF_CRG/20120511_FDF_CRG_c12.mtb	4007	4	WWFF	food_fat	4	144866	1336875731	1	0.0600000000000005	0.00272727272727275	5861	1
2	Food 2	Intake 4	12	144904	1336875769	/users/cn/jespinosa/phecomp/data/CRG/20120502_FDF_CRG/20120502_FDF_CRG/20120511_FDF_CRG_c12.mtb	4008	570	WWFF	food_fat	4	144892	1336875757	1	0.0399999999999991	0.00333333333333326	5862	1
2	Food 2	Intake 4	22	145496	1336876361	/users/cn/jespinosa/phecomp/data/CRG/20120502_FDF_CRG/20120502_FDF_CRG/20120511_FDF_CRG_c12.mtb	4013	268	WWFF	food_fat	4	145474	1336876339	1	0.0600000000000005	0.00272727272727275	5863	1
2	Drink 2	Intake 2	18	145559	1336876424	/users/cn/jespinosa/phecomp/data/CRG/20120502_FDF_CRG/20120502_FDF_CRG/20120511_FDF_CRG_c12.mtb	1347	NA	WWFF	water	2	145541	1336876406	1	0.04	0.00222222222222222	5864	1
2	Food 2	Intake 4	66	145830	1336876695	/users/cn/jespinosa/phecomp/data/CRG/20120502_FDF_CRG/20120502_FDF_CRG/20120511_FDF_CRG_c12.mtb	4015	590	WWFF	food_fat	4	145764	1336876629	1	0.0400000000000009	0.00060606060606062	5865	1
2	Food 1	Intake 3	142	146562	1336877427	/users/cn/jespinosa/phecomp/data/CRG/20120502_FDF_CRG/20120502_FDF_CRG/20120511_FDF_CRG_c12.mtb	2580	26	WWFF	food_fat	3	146420	1336877285	1	0.100000000000001	0.000704225352112683	5866	1
2	Food 1	Intake 3	192	146780	1336877645	/users/cn/jespinosa/phecomp/data/CRG/20120502_FDF_CRG/20120502_FDF_CRG/20120511_FDF_CRG_c12.mtb	2581	46	WWFF	food_fat	3	146588	1336877453	1	1.02	0.0053125	5867	1
2	Food 2	Intake 4	384	147210	1336878075	/users/cn/jespinosa/phecomp/data/CRG/20120502_FDF_CRG/20120502_FDF_CRG/20120511_FDF_CRG_c12.mtb	4020	COLL	WWFF	food_fat	4	146826	1336877691	1	0.0999999999999996	0.000260416666666666	5868	1
2	Food 1	Intake 3	96	146930	1336877795	/users/cn/jespinosa/phecomp/data/CRG/20120502_FDF_CRG/20120502_FDF_CRG/20120511_FDF_CRG_c12.mtb	2582	286	WWFF	food_fat	3	146834	1336877699	1	1.5	0.015625	5869	1
2	Drink 2	Intake 2	18	146945	1336877810	/users/cn/jespinosa/phecomp/data/CRG/20120502_FDF_CRG/20120502_FDF_CRG/20120511_FDF_CRG_c12.mtb	1349	NA	WWFF	water	2	146927	1336877792	1	0.02	0.00111111111111111	5870	1
2	Food 2	Intake 4	424	147640	1336878505	/users/cn/jespinosa/phecomp/data/CRG/20120502_FDF_CRG/20120502_FDF_CRG/20120511_FDF_CRG_c12.mtb	4021	406	WWFF	food_fat	4	147216	1336878081	1	0.0400000000000009	9.43396226415116e-05	5871	1
2	Drink 1	Intake 1	20	147241	1336878106	/users/cn/jespinosa/phecomp/data/CRG/20120502_FDF_CRG/20120502_FDF_CRG/20120511_FDF_CRG_c12.mtb	888	NA	WWFF	water	1	147221	1336878086	1	0.0600000000000001	0.00300000000000001	5872	1
2	Drink 1	Intake 1	11	147634	1336878499	/users/cn/jespinosa/phecomp/data/CRG/20120502_FDF_CRG/20120502_FDF_CRG/20120511_FDF_CRG_c12.mtb	889	NA	WWFF	water	1	147623	1336878488	1	0.02	0.00181818181818182	5873	1
2	Food 2	Intake 4	198	148244	1336879109	/users/cn/jespinosa/phecomp/data/CRG/20120502_FDF_CRG/20120502_FDF_CRG/20120511_FDF_CRG_c12.mtb	4027	256	WWFF	food_fat	4	148046	1336878911	1	0.120000000000001	0.000606060606060611	5874	1
2	Food 2	Intake 4	20	148520	1336879385	/users/cn/jespinosa/phecomp/data/CRG/20120502_FDF_CRG/20120502_FDF_CRG/20120511_FDF_CRG_c12.mtb	4030	988	WWFF	food_fat	4	148500	1336879365	1	0.0600000000000005	0.00300000000000002	5875	1
2	Food 2	Intake 4	14	149522	1336880387	/users/cn/jespinosa/phecomp/data/CRG/20120502_FDF_CRG/20120502_FDF_CRG/20120511_FDF_CRG_c12.mtb	4038	1697	WWFF	food_fat	4	149508	1336880373	1	0.0600000000000005	0.00428571428571432	5876	1
2	Food 2	Intake 4	15	151234	1336882099	/users/cn/jespinosa/phecomp/data/CRG/20120502_FDF_CRG/20120502_FDF_CRG/20120511_FDF_CRG_c12.mtb	4048	463	WWFF	food_fat	4	151219	1336882084	1	0.0600000000000005	0.00400000000000003	5877	1
2	Food 2	Intake 4	22	151719	1336882584	/users/cn/jespinosa/phecomp/data/CRG/20120502_FDF_CRG/20120502_FDF_CRG/20120511_FDF_CRG_c12.mtb	4051	47	WWFF	food_fat	4	151697	1336882562	1	0.0399999999999991	0.00181818181818178	5878	1
2	Food 2	Intake 4	27	151793	1336882658	/users/cn/jespinosa/phecomp/data/CRG/20120502_FDF_CRG/20120502_FDF_CRG/20120511_FDF_CRG_c12.mtb	4052	215	WWFF	food_fat	4	151766	1336882631	1	0.0399999999999991	0.00148148148148145	5879	1
2	Food 2	Intake 4	13	152021	1336882886	/users/cn/jespinosa/phecomp/data/CRG/20120502_FDF_CRG/20120502_FDF_CRG/20120511_FDF_CRG_c12.mtb	4053	231	WWFF	food_fat	4	152008	1336882873	1	0.0200000000000014	0.00153846153846165	5880	1
2	Drink 2	Intake 2	16	152231	1336883096	/users/cn/jespinosa/phecomp/data/CRG/20120502_FDF_CRG/20120502_FDF_CRG/20120511_FDF_CRG_c12.mtb	1352	NA	WWFF	water	2	152215	1336883080	1	0.02	0.00125	5881	1
2	Food 1	Intake 3	28	152280	1336883145	/users/cn/jespinosa/phecomp/data/CRG/20120502_FDF_CRG/20120502_FDF_CRG/20120511_FDF_CRG_c12.mtb	2586	468	WWFF	food_fat	3	152252	1336883117	1	0.0800000000000001	0.00285714285714286	5882	1
2	Drink 1	Intake 1	17	152471	1336883336	/users/cn/jespinosa/phecomp/data/CRG/20120502_FDF_CRG/20120502_FDF_CRG/20120511_FDF_CRG_c12.mtb	891	NA	WWFF	water	1	152454	1336883319	1	0.04	0.00235294117647059	5883	1
2	Food 2	Intake 4	17	152765	1336883630	/users/cn/jespinosa/phecomp/data/CRG/20120502_FDF_CRG/20120502_FDF_CRG/20120511_FDF_CRG_c12.mtb	4058	90	WWFF	food_fat	4	152748	1336883613	1	0.0600000000000005	0.00352941176470591	5884	1
2	Food 1	Intake 3	48	152903	1336883768	/users/cn/jespinosa/phecomp/data/CRG/20120502_FDF_CRG/20120502_FDF_CRG/20120511_FDF_CRG_c12.mtb	2588	127	WWFF	food_fat	3	152855	1336883720	1	0.0999999999999979	0.00208333333333329	5885	1
2	Drink 2	Intake 2	21	152944	1336883809	/users/cn/jespinosa/phecomp/data/CRG/20120502_FDF_CRG/20120502_FDF_CRG/20120511_FDF_CRG_c12.mtb	1355	NA	WWFF	water	2	152923	1336883788	1	0.02	0.000952380952380952	5886	1
2	Drink 1	Intake 1	18	152955	1336883820	/users/cn/jespinosa/phecomp/data/CRG/20120502_FDF_CRG/20120502_FDF_CRG/20120511_FDF_CRG_c12.mtb	892	NA	WWFF	water	1	152937	1336883802	1	0.02	0.00111111111111111	5887	1
2	Food 2	Intake 4	308	153338	1336884203	/users/cn/jespinosa/phecomp/data/CRG/20120502_FDF_CRG/20120502_FDF_CRG/20120511_FDF_CRG_c12.mtb	4061	COLL	WWFF	food_fat	4	153030	1336883895	1	0.120000000000001	0.000389610389610393	5888	1
2	Food 1	Intake 3	48	153097	1336883962	/users/cn/jespinosa/phecomp/data/CRG/20120502_FDF_CRG/20120502_FDF_CRG/20120511_FDF_CRG_c12.mtb	2591	1780	WWFF	food_fat	3	153049	1336883914	1	0.180000000000003	0.00375000000000006	5889	1
2	Drink 1	Intake 1	28	153269	1336884134	/users/cn/jespinosa/phecomp/data/CRG/20120502_FDF_CRG/20120502_FDF_CRG/20120511_FDF_CRG_c12.mtb	893	NA	WWFF	water	1	153241	1336884106	1	0.04	0.00142857142857143	5890	1
2	Drink 2	Intake 2	25	154499	1336885364	/users/cn/jespinosa/phecomp/data/CRG/20120502_FDF_CRG/20120502_FDF_CRG/20120511_FDF_CRG_c12.mtb	1356	NA	WWFF	water	2	154474	1336885339	1	0.04	0.0016	5891	1
2	Food 2	Intake 4	612	155489	1336886354	/users/cn/jespinosa/phecomp/data/CRG/20120502_FDF_CRG/20120502_FDF_CRG/20120511_FDF_CRG_c12.mtb	4071	5	WWFF	food_fat	4	154877	1336885742	1	0.219999999999999	0.000359477124183005	5892	1
2	Food 2	Intake 4	15	155509	1336886374	/users/cn/jespinosa/phecomp/data/CRG/20120502_FDF_CRG/20120502_FDF_CRG/20120511_FDF_CRG_c12.mtb	4072	207	WWFF	food_fat	4	155494	1336886359	1	0.0600000000000005	0.00400000000000003	5893	1
2	Food 2	Intake 4	81	155797	1336886662	/users/cn/jespinosa/phecomp/data/CRG/20120502_FDF_CRG/20120502_FDF_CRG/20120511_FDF_CRG_c12.mtb	4074	204	WWFF	food_fat	4	155716	1336886581	1	0.0600000000000005	0.000740740740740747	5894	1
2	Food 2	Intake 4	302	156303	1336887168	/users/cn/jespinosa/phecomp/data/CRG/20120502_FDF_CRG/20120502_FDF_CRG/20120511_FDF_CRG_c12.mtb	4077	770	WWFF	food_fat	4	156001	1336886866	1	0.0600000000000005	0.000198675496688743	5895	1
2	Drink 1	Intake 1	30	156091	1336886956	/users/cn/jespinosa/phecomp/data/CRG/20120502_FDF_CRG/20120502_FDF_CRG/20120511_FDF_CRG_c12.mtb	895	NA	WWFF	water	1	156061	1336886926	1	0.04	0.00133333333333333	5896	1
2	Food 2	Intake 4	278	157351	1336888216	/users/cn/jespinosa/phecomp/data/CRG/20120502_FDF_CRG/20120502_FDF_CRG/20120511_FDF_CRG_c12.mtb	4079	606	WWFF	food_fat	4	157073	1336887938	1	0.0999999999999996	0.000359712230215826	5897	1
2	Food 2	Intake 4	19	157976	1336888841	/users/cn/jespinosa/phecomp/data/CRG/20120502_FDF_CRG/20120502_FDF_CRG/20120511_FDF_CRG_c12.mtb	4084	403	WWFF	food_fat	4	157957	1336888822	1	0.0200000000000014	0.00105263157894744	5898	1
2	Food 2	Intake 4	23	158402	1336889267	/users/cn/jespinosa/phecomp/data/CRG/20120502_FDF_CRG/20120502_FDF_CRG/20120511_FDF_CRG_c12.mtb	4090	101	WWFF	food_fat	4	158379	1336889244	1	0.0400000000000009	0.00173913043478265	5899	1
2	Food 2	Intake 4	62	158565	1336889430	/users/cn/jespinosa/phecomp/data/CRG/20120502_FDF_CRG/20120502_FDF_CRG/20120511_FDF_CRG_c12.mtb	4091	1571	WWFF	food_fat	4	158503	1336889368	1	0.119999999999999	0.00193548387096773	5900	1
2	Food 2	Intake 4	40	160176	1336891041	/users/cn/jespinosa/phecomp/data/CRG/20120502_FDF_CRG/20120502_FDF_CRG/20120511_FDF_CRG_c12.mtb	4094	562	WWFF	food_fat	4	160136	1336891001	1	0.0200000000000014	0.000500000000000035	5901	1
2	Food 2	Intake 4	44	160782	1336891647	/users/cn/jespinosa/phecomp/data/CRG/20120502_FDF_CRG/20120502_FDF_CRG/20120511_FDF_CRG_c12.mtb	4096	1077	WWFF	food_fat	4	160738	1336891603	1	0.0800000000000001	0.00181818181818182	5902	1
2	Drink 2	Intake 2	13	160974	1336891839	/users/cn/jespinosa/phecomp/data/CRG/20120502_FDF_CRG/20120502_FDF_CRG/20120511_FDF_CRG_c12.mtb	1361	NA	WWFF	water	2	160961	1336891826	1	0.0599999999999998	0.0046153846153846	5903	1
2	Food 2	Intake 4	28	161887	1336892752	/users/cn/jespinosa/phecomp/data/CRG/20120502_FDF_CRG/20120502_FDF_CRG/20120511_FDF_CRG_c12.mtb	4099	221	WWFF	food_fat	4	161859	1336892724	1	0.0800000000000001	0.00285714285714286	5904	1
2	Food 2	Intake 4	14	162122	1336892987	/users/cn/jespinosa/phecomp/data/CRG/20120502_FDF_CRG/20120502_FDF_CRG/20120511_FDF_CRG_c12.mtb	4103	27	WWFF	food_fat	4	162108	1336892973	1	0.0600000000000005	0.00428571428571432	5905	1
2	Food 2	Intake 4	68	162217	1336893082	/users/cn/jespinosa/phecomp/data/CRG/20120502_FDF_CRG/20120502_FDF_CRG/20120511_FDF_CRG_c12.mtb	4104	266	WWFF	food_fat	4	162149	1336893014	1	0.0600000000000005	0.000882352941176478	5906	1
2	Food 2	Intake 4	20	162503	1336893368	/users/cn/jespinosa/phecomp/data/CRG/20120502_FDF_CRG/20120502_FDF_CRG/20120511_FDF_CRG_c12.mtb	4106	1636	WWFF	food_fat	4	162483	1336893348	1	0.119999999999999	0.00599999999999995	5907	1
2	Food 2	Intake 4	9	164148	1336895013	/users/cn/jespinosa/phecomp/data/CRG/20120502_FDF_CRG/20120502_FDF_CRG/20120511_FDF_CRG_c12.mtb	4111	686	WWFF	food_fat	4	164139	1336895004	1	0.0399999999999991	0.00444444444444434	5908	1
2	Food 2	Intake 4	25	164859	1336895724	/users/cn/jespinosa/phecomp/data/CRG/20120502_FDF_CRG/20120502_FDF_CRG/20120511_FDF_CRG_c12.mtb	4115	4	WWFF	food_fat	4	164834	1336895699	1	0.0399999999999991	0.00159999999999996	5909	1
2	Food 2	Intake 4	13	164876	1336895741	/users/cn/jespinosa/phecomp/data/CRG/20120502_FDF_CRG/20120502_FDF_CRG/20120511_FDF_CRG_c12.mtb	4116	11	WWFF	food_fat	4	164863	1336895728	1	0.0600000000000005	0.00461538461538465	5910	1
2	Food 2	Intake 4	73	164960	1336895825	/users/cn/jespinosa/phecomp/data/CRG/20120502_FDF_CRG/20120502_FDF_CRG/20120511_FDF_CRG_c12.mtb	4117	607	WWFF	food_fat	4	164887	1336895752	1	0.219999999999999	0.00301369863013697	5911	1
2	Food 2	Intake 4	13	165580	1336896445	/users/cn/jespinosa/phecomp/data/CRG/20120502_FDF_CRG/20120502_FDF_CRG/20120511_FDF_CRG_c12.mtb	4119	537	WWFF	food_fat	4	165567	1336896432	1	0.0200000000000014	0.00153846153846165	5912	1
2	Food 1	Intake 3	49	166166	1336897031	/users/cn/jespinosa/phecomp/data/CRG/20120502_FDF_CRG/20120502_FDF_CRG/20120511_FDF_CRG_c12.mtb	2596	188	WWFF	food_fat	3	166117	1336896982	1	0.0799999999999983	0.00163265306122445	5913	1
2	Drink 1	Intake 1	34	166230	1336897095	/users/cn/jespinosa/phecomp/data/CRG/20120502_FDF_CRG/20120502_FDF_CRG/20120511_FDF_CRG_c12.mtb	897	NA	WWFF	water	1	166196	1336897061	1	0.12	0.00352941176470588	5914	1
2	Food 2	Intake 4	48	166402	1336897267	/users/cn/jespinosa/phecomp/data/CRG/20120502_FDF_CRG/20120502_FDF_CRG/20120511_FDF_CRG_c12.mtb	4124	1841	WWFF	food_fat	4	166354	1336897219	1	0.0400000000000009	0.000833333333333352	5915	1
2	Food 2	Intake 4	33	168276	1336899141	/users/cn/jespinosa/phecomp/data/CRG/20120502_FDF_CRG/20120502_FDF_CRG/20120511_FDF_CRG_c12.mtb	4130	20	WWFF	food_fat	4	168243	1336899108	1	0.0399999999999991	0.00121212121212118	5916	1
2	Food 2	Intake 4	46	168342	1336899207	/users/cn/jespinosa/phecomp/data/CRG/20120502_FDF_CRG/20120502_FDF_CRG/20120511_FDF_CRG_c12.mtb	4131	6	WWFF	food_fat	4	168296	1336899161	1	0.220000000000001	0.0047826086956522	5917	1
2	Food 2	Intake 4	48	168396	1336899261	/users/cn/jespinosa/phecomp/data/CRG/20120502_FDF_CRG/20120502_FDF_CRG/20120511_FDF_CRG_c12.mtb	4132	568	WWFF	food_fat	4	168348	1336899213	1	0.0400000000000009	0.000833333333333352	5918	1
2	Food 2	Intake 4	16	168980	1336899845	/users/cn/jespinosa/phecomp/data/CRG/20120502_FDF_CRG/20120502_FDF_CRG/20120511_FDF_CRG_c12.mtb	4135	1305	WWFF	food_fat	4	168964	1336899829	1	0.0799999999999983	0.00499999999999989	5919	1
2	Food 1	Intake 3	25	170310	1336901175	/users/cn/jespinosa/phecomp/data/CRG/20120502_FDF_CRG/20120502_FDF_CRG/20120511_FDF_CRG_c12.mtb	2597	17	WWFF	food_fat	3	170285	1336901150	1	0.0599999999999987	0.00239999999999995	5920	1
2	Food 2	Intake 4	32	170359	1336901224	/users/cn/jespinosa/phecomp/data/CRG/20120502_FDF_CRG/20120502_FDF_CRG/20120511_FDF_CRG_c12.mtb	4139	541	WWFF	food_fat	4	170327	1336901192	1	0.0800000000000001	0.0025	5921	1
2	Food 2	Intake 4	44	170944	1336901809	/users/cn/jespinosa/phecomp/data/CRG/20120502_FDF_CRG/20120502_FDF_CRG/20120511_FDF_CRG_c12.mtb	4143	117	WWFF	food_fat	4	170900	1336901765	1	0.16	0.00363636363636364	5922	1
2	Drink 2	Intake 2	35	170965	1336901830	/users/cn/jespinosa/phecomp/data/CRG/20120502_FDF_CRG/20120502_FDF_CRG/20120511_FDF_CRG_c12.mtb	1362	NA	WWFF	water	2	170930	1336901795	1	0.12	0.00342857142857143	5923	1
2	Food 2	Intake 4	18	171079	1336901944	/users/cn/jespinosa/phecomp/data/CRG/20120502_FDF_CRG/20120502_FDF_CRG/20120511_FDF_CRG_c12.mtb	4145	31	WWFF	food_fat	4	171061	1336901926	1	0.0400000000000009	0.00222222222222227	5924	1
2	Food 2	Intake 4	11	171121	1336901986	/users/cn/jespinosa/phecomp/data/CRG/20120502_FDF_CRG/20120502_FDF_CRG/20120511_FDF_CRG_c12.mtb	4146	306	WWFF	food_fat	4	171110	1336901975	1	0.0399999999999991	0.00363636363636355	5925	1
2	Food 2	Intake 4	14	171441	1336902306	/users/cn/jespinosa/phecomp/data/CRG/20120502_FDF_CRG/20120502_FDF_CRG/20120511_FDF_CRG_c12.mtb	4149	1229	WWFF	food_fat	4	171427	1336902292	1	0.0400000000000009	0.00285714285714292	5926	1
2	Food 2	Intake 4	25	172695	1336903560	/users/cn/jespinosa/phecomp/data/CRG/20120502_FDF_CRG/20120502_FDF_CRG/20120511_FDF_CRG_c12.mtb	4153	477	WWFF	food_fat	4	172670	1336903535	1	0.0800000000000001	0.0032	5927	1
2	Food 2	Intake 4	15	173187	1336904052	/users/cn/jespinosa/phecomp/data/CRG/20120502_FDF_CRG/20120502_FDF_CRG/20120511_FDF_CRG_c12.mtb	4156	248	WWFF	food_fat	4	173172	1336904037	1	0.0200000000000014	0.00133333333333343	5928	1
2	Food 1	Intake 3	19	173454	1336904319	/users/cn/jespinosa/phecomp/data/CRG/20120502_FDF_CRG/20120502_FDF_CRG/20120511_FDF_CRG_c12.mtb	2598	371	WWFF	food_fat	3	173435	1336904300	1	0.0600000000000023	0.00315789473684223	5929	1
2	Food 2	Intake 4	13	173838	1336904703	/users/cn/jespinosa/phecomp/data/CRG/20120502_FDF_CRG/20120502_FDF_CRG/20120511_FDF_CRG_c12.mtb	4159	1058	WWFF	food_fat	4	173825	1336904690	1	0.0599999999999987	0.00461538461538452	5930	1
2	Food 2	Intake 4	18	174914	1336905779	/users/cn/jespinosa/phecomp/data/CRG/20120502_FDF_CRG/20120502_FDF_CRG/20120511_FDF_CRG_c12.mtb	4165	778	WWFF	food_fat	4	174896	1336905761	1	0.0200000000000014	0.00111111111111119	5931	1
2	Food 2	Intake 4	31	175723	1336906588	/users/cn/jespinosa/phecomp/data/CRG/20120502_FDF_CRG/20120502_FDF_CRG/20120511_FDF_CRG_c12.mtb	4168	COLL	WWFF	food_fat	4	175692	1336906557	1	0.18	0.00580645161290323	5932	1
2	Food 1	Intake 3	14	175721	1336906586	/users/cn/jespinosa/phecomp/data/CRG/20120502_FDF_CRG/20120502_FDF_CRG/20120511_FDF_CRG_c12.mtb	2599	19	WWFF	food_fat	3	175707	1336906572	1	0.0399999999999991	0.00285714285714279	5933	1
2	Food 2	Intake 4	39	175779	1336906644	/users/cn/jespinosa/phecomp/data/CRG/20120502_FDF_CRG/20120502_FDF_CRG/20120511_FDF_CRG_c12.mtb	4169	30	WWFF	food_fat	4	175740	1336906605	1	0.0800000000000001	0.00205128205128205	5934	1
2	Food 2	Intake 4	25	175834	1336906699	/users/cn/jespinosa/phecomp/data/CRG/20120502_FDF_CRG/20120502_FDF_CRG/20120511_FDF_CRG_c12.mtb	4170	62	WWFF	food_fat	4	175809	1336906674	1	0.119999999999999	0.00479999999999996	5935	1
2	Food 2	Intake 4	33	175929	1336906794	/users/cn/jespinosa/phecomp/data/CRG/20120502_FDF_CRG/20120502_FDF_CRG/20120511_FDF_CRG_c12.mtb	4171	2493	WWFF	food_fat	4	175896	1336906761	1	0.0600000000000005	0.00181818181818183	5936	1
2	Drink 2	Intake 2	18	178031	1336908896	/users/cn/jespinosa/phecomp/data/CRG/20120502_FDF_CRG/20120502_FDF_CRG/20120511_FDF_CRG_c12.mtb	1363	NA	WWFF	water	2	178013	1336908878	1	0.0600000000000001	0.00333333333333334	5937	1
2	Food 2	Intake 4	173	178595	1336909460	/users/cn/jespinosa/phecomp/data/CRG/20120502_FDF_CRG/20120502_FDF_CRG/20120511_FDF_CRG_c12.mtb	4184	302	WWFF	food_fat	4	178422	1336909287	1	0.0600000000000005	0.000346820809248558	5938	1
2	Drink 2	Intake 2	12	178504	1336909369	/users/cn/jespinosa/phecomp/data/CRG/20120502_FDF_CRG/20120502_FDF_CRG/20120511_FDF_CRG_c12.mtb	1364	NA	WWFF	water	2	178492	1336909357	1	0.04	0.00333333333333333	5939	1
2	Drink 1	Intake 1	15	178748	1336909613	/users/cn/jespinosa/phecomp/data/CRG/20120502_FDF_CRG/20120502_FDF_CRG/20120511_FDF_CRG_c12.mtb	899	NA	WWFF	water	1	178733	1336909598	1	0.0399999999999996	0.00266666666666664	5940	1
2	Food 2	Intake 4	150	179047	1336909912	/users/cn/jespinosa/phecomp/data/CRG/20120502_FDF_CRG/20120502_FDF_CRG/20120511_FDF_CRG_c12.mtb	4186	65	WWFF	food_fat	4	178897	1336909762	1	0.0600000000000005	0.000400000000000003	5941	1
2	Food 2	Intake 4	91	179203	1336910068	/users/cn/jespinosa/phecomp/data/CRG/20120502_FDF_CRG/20120502_FDF_CRG/20120511_FDF_CRG_c12.mtb	4189	647	WWFF	food_fat	4	179112	1336909977	1	0.0400000000000009	0.000439560439560449	5942	1
2	Drink 2	Intake 2	27	179387	1336910252	/users/cn/jespinosa/phecomp/data/CRG/20120502_FDF_CRG/20120502_FDF_CRG/20120511_FDF_CRG_c12.mtb	1366	NA	WWFF	water	2	179360	1336910225	1	0.0800000000000001	0.00296296296296297	5943	1
2	Food 2	Intake 4	33	179883	1336910748	/users/cn/jespinosa/phecomp/data/CRG/20120502_FDF_CRG/20120502_FDF_CRG/20120511_FDF_CRG_c12.mtb	4193	667	WWFF	food_fat	4	179850	1336910715	1	0.0399999999999991	0.00121212121212118	5944	1
2	Food 2	Intake 4	20	180570	1336911435	/users/cn/jespinosa/phecomp/data/CRG/20120502_FDF_CRG/20120502_FDF_CRG/20120511_FDF_CRG_c12.mtb	4198	3810	WWFF	food_fat	4	180550	1336911415	1	0.0999999999999996	0.00499999999999998	5945	1
2	Food 2	Intake 4	12	184392	1336915257	/users/cn/jespinosa/phecomp/data/CRG/20120502_FDF_CRG/20120502_FDF_CRG/20120511_FDF_CRG_c12.mtb	4209	683	WWFF	food_fat	4	184380	1336915245	1	0.0200000000000014	0.00166666666666678	5946	1
2	Food 2	Intake 4	29	185104	1336915969	/users/cn/jespinosa/phecomp/data/CRG/20120502_FDF_CRG/20120502_FDF_CRG/20120511_FDF_CRG_c12.mtb	4212	1069	WWFF	food_fat	4	185075	1336915940	1	0.0600000000000005	0.0020689655172414	5947	1
2	Food 2	Intake 4	105	186278	1336917143	/users/cn/jespinosa/phecomp/data/CRG/20120502_FDF_CRG/20120502_FDF_CRG/20120511_FDF_CRG_c12.mtb	4214	COLL	WWFF	food_fat	4	186173	1336917038	1	0.139999999999999	0.00133333333333332	5948	1
2	Food 1	Intake 3	21	186255	1336917120	/users/cn/jespinosa/phecomp/data/CRG/20120502_FDF_CRG/20120502_FDF_CRG/20120511_FDF_CRG_c12.mtb	2602	6	WWFF	food_fat	3	186234	1336917099	1	0.0399999999999991	0.00190476190476186	5949	1
2	Food 1	Intake 3	17	186278	1336917143	/users/cn/jespinosa/phecomp/data/CRG/20120502_FDF_CRG/20120502_FDF_CRG/20120511_FDF_CRG_c12.mtb	2603	12	WWFF	food_fat	3	186261	1336917126	1	0.0400000000000027	0.00235294117647075	5950	1
2	Food 2	Intake 4	10	186300	1336917165	/users/cn/jespinosa/phecomp/data/CRG/20120502_FDF_CRG/20120502_FDF_CRG/20120511_FDF_CRG_c12.mtb	4215	43	WWFF	food_fat	4	186290	1336917155	1	0.0200000000000014	0.00200000000000014	5951	1
2	Food 2	Intake 4	27	186370	1336917235	/users/cn/jespinosa/phecomp/data/CRG/20120502_FDF_CRG/20120502_FDF_CRG/20120511_FDF_CRG_c12.mtb	4216	301	WWFF	food_fat	4	186343	1336917208	1	0.0800000000000001	0.00296296296296297	5952	1
2	Food 2	Intake 4	34	186705	1336917570	/users/cn/jespinosa/phecomp/data/CRG/20120502_FDF_CRG/20120502_FDF_CRG/20120511_FDF_CRG_c12.mtb	4219	161	WWFF	food_fat	4	186671	1336917536	1	0.0600000000000005	0.00176470588235296	5953	1
2	Food 2	Intake 4	17	186883	1336917748	/users/cn/jespinosa/phecomp/data/CRG/20120502_FDF_CRG/20120502_FDF_CRG/20120511_FDF_CRG_c12.mtb	4222	1353	WWFF	food_fat	4	186866	1336917731	1	0.0400000000000009	0.00235294117647064	5954	1
2	Food 2	Intake 4	18	188254	1336919119	/users/cn/jespinosa/phecomp/data/CRG/20120502_FDF_CRG/20120502_FDF_CRG/20120511_FDF_CRG_c12.mtb	4226	1280	WWFF	food_fat	4	188236	1336919101	1	0.120000000000001	0.00666666666666672	5955	1
2	Food 1	Intake 3	44	189578	1336920443	/users/cn/jespinosa/phecomp/data/CRG/20120502_FDF_CRG/20120502_FDF_CRG/20120511_FDF_CRG_c12.mtb	2604	128	WWFF	food_fat	3	189534	1336920399	1	0.119999999999997	0.00272727272727266	5956	1
2	Food 2	Intake 4	28	189734	1336920599	/users/cn/jespinosa/phecomp/data/CRG/20120502_FDF_CRG/20120502_FDF_CRG/20120511_FDF_CRG_c12.mtb	4230	1498	WWFF	food_fat	4	189706	1336920571	1	0.0400000000000009	0.00142857142857146	5957	1
2	Food 2	Intake 4	11	191243	1336922108	/users/cn/jespinosa/phecomp/data/CRG/20120502_FDF_CRG/20120502_FDF_CRG/20120511_FDF_CRG_c12.mtb	4238	369	WWFF	food_fat	4	191232	1336922097	1	0.0400000000000009	0.00363636363636372	5958	1
2	Food 2	Intake 4	16	191628	1336922493	/users/cn/jespinosa/phecomp/data/CRG/20120502_FDF_CRG/20120502_FDF_CRG/20120511_FDF_CRG_c12.mtb	4239	979	WWFF	food_fat	4	191612	1336922477	1	0.0399999999999991	0.00249999999999994	5959	1
2	Food 2	Intake 4	10	192617	1336923482	/users/cn/jespinosa/phecomp/data/CRG/20120502_FDF_CRG/20120502_FDF_CRG/20120511_FDF_CRG_c12.mtb	4244	347	WWFF	food_fat	4	192607	1336923472	1	0.0200000000000014	0.00200000000000014	5960	1
2	Food 2	Intake 4	25	192989	1336923854	/users/cn/jespinosa/phecomp/data/CRG/20120502_FDF_CRG/20120502_FDF_CRG/20120511_FDF_CRG_c12.mtb	4247	44	WWFF	food_fat	4	192964	1336923829	1	0.0600000000000005	0.00240000000000002	5961	1
2	Food 2	Intake 4	33	193066	1336923931	/users/cn/jespinosa/phecomp/data/CRG/20120502_FDF_CRG/20120502_FDF_CRG/20120511_FDF_CRG_c12.mtb	4249	108	WWFF	food_fat	4	193033	1336923898	1	0.220000000000001	0.0066666666666667	5962	1
2	Drink 2	Intake 2	25	193083	1336923948	/users/cn/jespinosa/phecomp/data/CRG/20120502_FDF_CRG/20120502_FDF_CRG/20120511_FDF_CRG_c12.mtb	1367	NA	WWFF	water	2	193058	1336923923	1	0.0599999999999998	0.00239999999999999	5963	1
2	Food 1	Intake 3	17	193191	1336924056	/users/cn/jespinosa/phecomp/data/CRG/20120502_FDF_CRG/20120502_FDF_CRG/20120511_FDF_CRG_c12.mtb	2607	443	WWFF	food_fat	3	193174	1336924039	1	0.0400000000000027	0.00235294117647075	5964	1
2	Drink 1	Intake 1	21	193219	1336924084	/users/cn/jespinosa/phecomp/data/CRG/20120502_FDF_CRG/20120502_FDF_CRG/20120511_FDF_CRG_c12.mtb	900	NA	WWFF	water	1	193198	1336924063	1	0.04	0.0019047619047619	5965	1
2	Drink 1	Intake 1	18	193396	1336924261	/users/cn/jespinosa/phecomp/data/CRG/20120502_FDF_CRG/20120502_FDF_CRG/20120511_FDF_CRG_c12.mtb	901	NA	WWFF	water	1	193378	1336924243	1	0.04	0.00222222222222222	5966	1
2	Food 2	Intake 4	43	193677	1336924542	/users/cn/jespinosa/phecomp/data/CRG/20120502_FDF_CRG/20120502_FDF_CRG/20120511_FDF_CRG_c12.mtb	4254	519	WWFF	food_fat	4	193634	1336924499	1	0.0799999999999983	0.00186046511627903	5967	1
2	Drink 1	Intake 1	13	193968	1336924833	/users/cn/jespinosa/phecomp/data/CRG/20120502_FDF_CRG/20120502_FDF_CRG/20120511_FDF_CRG_c12.mtb	902	NA	WWFF	water	1	193955	1336924820	1	0.0600000000000001	0.00461538461538462	5968	1
2	Food 2	Intake 4	20	194216	1336925081	/users/cn/jespinosa/phecomp/data/CRG/20120502_FDF_CRG/20120502_FDF_CRG/20120511_FDF_CRG_c12.mtb	4261	232	WWFF	food_fat	4	194196	1336925061	1	0.0400000000000009	0.00200000000000005	5969	1
2	Food 2	Intake 4	20	194468	1336925333	/users/cn/jespinosa/phecomp/data/CRG/20120502_FDF_CRG/20120502_FDF_CRG/20120511_FDF_CRG_c12.mtb	4263	2317	WWFF	food_fat	4	194448	1336925313	1	0.0399999999999991	0.00199999999999995	5970	1
2	Food 1	Intake 3	64	196849	1336927714	/users/cn/jespinosa/phecomp/data/CRG/20120502_FDF_CRG/20120502_FDF_CRG/20120511_FDF_CRG_c12.mtb	2609	22	WWFF	food_fat	3	196785	1336927650	1	0.0999999999999979	0.00156249999999997	5971	1
2	Food 2	Intake 4	49	196920	1336927785	/users/cn/jespinosa/phecomp/data/CRG/20120502_FDF_CRG/20120502_FDF_CRG/20120511_FDF_CRG_c12.mtb	4270	36	WWFF	food_fat	4	196871	1336927736	1	0.120000000000001	0.00244897959183675	5972	1
2	Food 2	Intake 4	25	196981	1336927846	/users/cn/jespinosa/phecomp/data/CRG/20120502_FDF_CRG/20120502_FDF_CRG/20120511_FDF_CRG_c12.mtb	4271	300	WWFF	food_fat	4	196956	1336927821	1	0.0399999999999991	0.00159999999999996	5973	1
2	Food 2	Intake 4	31	197312	1336928177	/users/cn/jespinosa/phecomp/data/CRG/20120502_FDF_CRG/20120502_FDF_CRG/20120511_FDF_CRG_c12.mtb	4272	651	WWFF	food_fat	4	197281	1336928146	1	0.0200000000000014	0.000645161290322626	5974	1
2	Food 1	Intake 3	35	197998	1336928863	/users/cn/jespinosa/phecomp/data/CRG/20120502_FDF_CRG/20120502_FDF_CRG/20120511_FDF_CRG_c12.mtb	2610	647	WWFF	food_fat	3	197963	1336928828	1	0.0400000000000027	0.00114285714285722	5975	1
2	Food 2	Intake 4	21	198666	1336929531	/users/cn/jespinosa/phecomp/data/CRG/20120502_FDF_CRG/20120502_FDF_CRG/20120511_FDF_CRG_c12.mtb	4277	344	WWFF	food_fat	4	198645	1336929510	1	0.119999999999999	0.00571428571428567	5976	1
2	Food 2	Intake 4	19	199029	1336929894	/users/cn/jespinosa/phecomp/data/CRG/20120502_FDF_CRG/20120502_FDF_CRG/20120511_FDF_CRG_c12.mtb	4280	544	WWFF	food_fat	4	199010	1336929875	1	0.0200000000000014	0.00105263157894744	5977	1
2	Food 2	Intake 4	43	199616	1336930481	/users/cn/jespinosa/phecomp/data/CRG/20120502_FDF_CRG/20120502_FDF_CRG/20120511_FDF_CRG_c12.mtb	4284	375	WWFF	food_fat	4	199573	1336930438	1	0.0399999999999991	0.000930232558139514	5978	1
2	Food 2	Intake 4	11	200002	1336930867	/users/cn/jespinosa/phecomp/data/CRG/20120502_FDF_CRG/20120502_FDF_CRG/20120511_FDF_CRG_c12.mtb	4289	82	WWFF	food_fat	4	199991	1336930856	1	0.0200000000000014	0.00181818181818195	5979	1
2	Food 2	Intake 4	54	200138	1336931003	/users/cn/jespinosa/phecomp/data/CRG/20120502_FDF_CRG/20120502_FDF_CRG/20120511_FDF_CRG_c12.mtb	4291	39	WWFF	food_fat	4	200084	1336930949	1	0.0799999999999983	0.00148148148148145	5980	1
2	Food 2	Intake 4	26	200203	1336931068	/users/cn/jespinosa/phecomp/data/CRG/20120502_FDF_CRG/20120502_FDF_CRG/20120511_FDF_CRG_c12.mtb	4292	135	WWFF	food_fat	4	200177	1336931042	1	0.0600000000000005	0.00230769230769233	5981	1
2	Food 2	Intake 4	10	200348	1336931213	/users/cn/jespinosa/phecomp/data/CRG/20120502_FDF_CRG/20120502_FDF_CRG/20120511_FDF_CRG_c12.mtb	4295	14	WWFF	food_fat	4	200338	1336931203	1	0.0399999999999991	0.00399999999999991	5982	1
2	Food 2	Intake 4	10	200372	1336931237	/users/cn/jespinosa/phecomp/data/CRG/20120502_FDF_CRG/20120502_FDF_CRG/20120511_FDF_CRG_c12.mtb	4296	257	WWFF	food_fat	4	200362	1336931227	1	0.0600000000000005	0.00600000000000005	5983	1
2	Food 2	Intake 4	28	200657	1336931522	/users/cn/jespinosa/phecomp/data/CRG/20120502_FDF_CRG/20120502_FDF_CRG/20120511_FDF_CRG_c12.mtb	4298	699	WWFF	food_fat	4	200629	1336931494	1	0.0800000000000001	0.00285714285714286	5984	1
2	Food 2	Intake 4	15	201371	1336932236	/users/cn/jespinosa/phecomp/data/CRG/20120502_FDF_CRG/20120502_FDF_CRG/20120511_FDF_CRG_c12.mtb	4301	582	WWFF	food_fat	4	201356	1336932221	1	0.0600000000000005	0.00400000000000003	5985	1
2	Food 2	Intake 4	20	201973	1336932838	/users/cn/jespinosa/phecomp/data/CRG/20120502_FDF_CRG/20120502_FDF_CRG/20120511_FDF_CRG_c12.mtb	4305	281	WWFF	food_fat	4	201953	1336932818	1	0.0400000000000009	0.00200000000000005	5986	1
2	Food 2	Intake 4	25	202279	1336933144	/users/cn/jespinosa/phecomp/data/CRG/20120502_FDF_CRG/20120502_FDF_CRG/20120511_FDF_CRG_c12.mtb	4308	173	WWFF	food_fat	4	202254	1336933119	1	0.0399999999999991	0.00159999999999996	5987	1
2	Food 2	Intake 4	55	202507	1336933372	/users/cn/jespinosa/phecomp/data/CRG/20120502_FDF_CRG/20120502_FDF_CRG/20120511_FDF_CRG_c12.mtb	4310	55	WWFF	food_fat	4	202452	1336933317	1	0.0600000000000005	0.0010909090909091	5988	1
2	Food 2	Intake 4	487	203049	1336933914	/users/cn/jespinosa/phecomp/data/CRG/20120502_FDF_CRG/20120502_FDF_CRG/20120511_FDF_CRG_c12.mtb	4311	441	WWFF	food_fat	4	202562	1336933427	1	0.140000000000001	0.000287474332648873	5989	1
2	Food 2	Intake 4	38	203528	1336934393	/users/cn/jespinosa/phecomp/data/CRG/20120502_FDF_CRG/20120502_FDF_CRG/20120511_FDF_CRG_c12.mtb	4316	4	WWFF	food_fat	4	203490	1336934355	1	0.120000000000001	0.00315789473684213	5990	1
2	Food 2	Intake 4	59	203591	1336934456	/users/cn/jespinosa/phecomp/data/CRG/20120502_FDF_CRG/20120502_FDF_CRG/20120511_FDF_CRG_c12.mtb	4317	5	WWFF	food_fat	4	203532	1336934397	1	0.0599999999999987	0.00101694915254235	5991	1
2	Food 2	Intake 4	279	203875	1336934740	/users/cn/jespinosa/phecomp/data/CRG/20120502_FDF_CRG/20120502_FDF_CRG/20120511_FDF_CRG_c12.mtb	4318	173	WWFF	food_fat	4	203596	1336934461	1	0.100000000000001	0.000358422939068104	5992	1
2	Food 2	Intake 4	51	204099	1336934964	/users/cn/jespinosa/phecomp/data/CRG/20120502_FDF_CRG/20120502_FDF_CRG/20120511_FDF_CRG_c12.mtb	4320	133	WWFF	food_fat	4	204048	1336934913	1	0.0999999999999996	0.00196078431372548	5993	1
2	Food 2	Intake 4	26	204258	1336935123	/users/cn/jespinosa/phecomp/data/CRG/20120502_FDF_CRG/20120502_FDF_CRG/20120511_FDF_CRG_c12.mtb	4323	75	WWFF	food_fat	4	204232	1336935097	1	0.0600000000000005	0.00230769230769233	5994	1
2	Food 2	Intake 4	25	204358	1336935223	/users/cn/jespinosa/phecomp/data/CRG/20120502_FDF_CRG/20120502_FDF_CRG/20120511_FDF_CRG_c12.mtb	4324	366	WWFF	food_fat	4	204333	1336935198	1	0.0800000000000001	0.0032	5995	1
2	Drink 2	Intake 2	26	204455	1336935320	/users/cn/jespinosa/phecomp/data/CRG/20120502_FDF_CRG/20120502_FDF_CRG/20120511_FDF_CRG_c12.mtb	1374	NA	WWFF	water	2	204429	1336935294	1	0.02	0.000769230769230769	5996	1
2	Food 2	Intake 4	19	204743	1336935608	/users/cn/jespinosa/phecomp/data/CRG/20120502_FDF_CRG/20120502_FDF_CRG/20120511_FDF_CRG_c12.mtb	4327	83	WWFF	food_fat	4	204724	1336935589	1	0.0400000000000009	0.00210526315789478	5997	1
2	Food 2	Intake 4	70	204896	1336935761	/users/cn/jespinosa/phecomp/data/CRG/20120502_FDF_CRG/20120502_FDF_CRG/20120511_FDF_CRG_c12.mtb	4328	466	WWFF	food_fat	4	204826	1336935691	1	0.0599999999999987	0.000857142857142839	5998	1
2	Food 2	Intake 4	13	205375	1336936240	/users/cn/jespinosa/phecomp/data/CRG/20120502_FDF_CRG/20120502_FDF_CRG/20120511_FDF_CRG_c12.mtb	4334	78	WWFF	food_fat	4	205362	1336936227	1	0.0400000000000009	0.00307692307692315	5999	1
2	Food 2	Intake 4	22	205475	1336936340	/users/cn/jespinosa/phecomp/data/CRG/20120502_FDF_CRG/20120502_FDF_CRG/20120511_FDF_CRG_c12.mtb	4335	481	WWFF	food_fat	4	205453	1336936318	1	0.0399999999999991	0.00181818181818178	6000	1
2	Food 2	Intake 4	127	206083	1336936948	/users/cn/jespinosa/phecomp/data/CRG/20120502_FDF_CRG/20120502_FDF_CRG/20120511_FDF_CRG_c12.mtb	4341	161	WWFF	food_fat	4	205956	1336936821	1	0.0399999999999991	0.000314960629921253	6001	1
2	Food 2	Intake 4	25	206269	1336937134	/users/cn/jespinosa/phecomp/data/CRG/20120502_FDF_CRG/20120502_FDF_CRG/20120511_FDF_CRG_c12.mtb	4342	2054	WWFF	food_fat	4	206244	1336937109	1	0.100000000000001	0.00400000000000004	6002	1
2	Food 2	Intake 4	10	208333	1336939198	/users/cn/jespinosa/phecomp/data/CRG/20120502_FDF_CRG/20120502_FDF_CRG/20120511_FDF_CRG_c12.mtb	4353	92	WWFF	food_fat	4	208323	1336939188	1	0.0400000000000009	0.00400000000000009	6003	1
2	Food 2	Intake 4	13	208438	1336939303	/users/cn/jespinosa/phecomp/data/CRG/20120502_FDF_CRG/20120502_FDF_CRG/20120511_FDF_CRG_c12.mtb	4355	173	WWFF	food_fat	4	208425	1336939290	1	0.0600000000000005	0.00461538461538465	6004	1
2	Food 2	Intake 4	24	208635	1336939500	/users/cn/jespinosa/phecomp/data/CRG/20120502_FDF_CRG/20120502_FDF_CRG/20120511_FDF_CRG_c12.mtb	4357	1361	WWFF	food_fat	4	208611	1336939476	1	0.120000000000001	0.00500000000000004	6005	1
2	Drink 1	Intake 1	14	209504	1336940369	/users/cn/jespinosa/phecomp/data/CRG/20120502_FDF_CRG/20120502_FDF_CRG/20120511_FDF_CRG_c12.mtb	906	NA	WWFF	water	1	209490	1336940355	1	0.0600000000000001	0.00428571428571429	6006	1
2	Food 2	Intake 4	34	210030	1336940895	/users/cn/jespinosa/phecomp/data/CRG/20120502_FDF_CRG/20120502_FDF_CRG/20120511_FDF_CRG_c12.mtb	4359	284	WWFF	food_fat	4	209996	1336940861	1	0.0200000000000014	0.000588235294117688	6007	1
2	Food 2	Intake 4	85	210399	1336941264	/users/cn/jespinosa/phecomp/data/CRG/20120502_FDF_CRG/20120502_FDF_CRG/20120511_FDF_CRG_c12.mtb	4361	75	WWFF	food_fat	4	210314	1336941179	1	0.0600000000000005	0.000705882352941182	6008	1
2	Food 2	Intake 4	15	210489	1336941354	/users/cn/jespinosa/phecomp/data/CRG/20120502_FDF_CRG/20120502_FDF_CRG/20120511_FDF_CRG_c12.mtb	4362	104	WWFF	food_fat	4	210474	1336941339	1	0.0400000000000009	0.00266666666666673	6009	1
2	Food 2	Intake 4	168	210761	1336941626	/users/cn/jespinosa/phecomp/data/CRG/20120502_FDF_CRG/20120502_FDF_CRG/20120511_FDF_CRG_c12.mtb	4364	189	WWFF	food_fat	4	210593	1336941458	1	0.260000000000002	0.00154761904761906	6010	1
2	Food 2	Intake 4	200	211150	1336942015	/users/cn/jespinosa/phecomp/data/CRG/20120502_FDF_CRG/20120502_FDF_CRG/20120511_FDF_CRG_c12.mtb	4366	154	WWFF	food_fat	4	210950	1336941815	1	0.120000000000001	0.000600000000000005	6011	1
2	Food 2	Intake 4	93	211397	1336942262	/users/cn/jespinosa/phecomp/data/CRG/20120502_FDF_CRG/20120502_FDF_CRG/20120511_FDF_CRG_c12.mtb	4369	5	WWFF	food_fat	4	211304	1336942169	1	0.0600000000000005	0.000645161290322586	6012	1
2	Food 2	Intake 4	383	211785	1336942650	/users/cn/jespinosa/phecomp/data/CRG/20120502_FDF_CRG/20120502_FDF_CRG/20120511_FDF_CRG_c12.mtb	4370	982	WWFF	food_fat	4	211402	1336942267	1	0.220000000000001	0.000574412532637078	6013	1
2	Drink 1	Intake 1	27	211727	1336942592	/users/cn/jespinosa/phecomp/data/CRG/20120502_FDF_CRG/20120502_FDF_CRG/20120511_FDF_CRG_c12.mtb	908	NA	WWFF	water	1	211700	1336942565	1	0.1	0.0037037037037037	6014	1
2	Drink 2	Intake 2	54	212159	1336943024	/users/cn/jespinosa/phecomp/data/CRG/20120502_FDF_CRG/20120502_FDF_CRG/20120511_FDF_CRG_c12.mtb	1378	NA	WWFF	water	2	212105	1336942970	1	0.02	0.00037037037037037	6015	1
2	Food 2	Intake 4	23	212790	1336943655	/users/cn/jespinosa/phecomp/data/CRG/20120502_FDF_CRG/20120502_FDF_CRG/20120511_FDF_CRG_c12.mtb	4373	6	WWFF	food_fat	4	212767	1336943632	1	0.0399999999999991	0.00173913043478257	6016	1
2	Food 2	Intake 4	318	213114	1336943979	/users/cn/jespinosa/phecomp/data/CRG/20120502_FDF_CRG/20120502_FDF_CRG/20120511_FDF_CRG_c12.mtb	4374	158	WWFF	food_fat	4	212796	1336943661	1	0.0600000000000005	0.00018867924528302	6017	1
2	Food 2	Intake 4	233	213505	1336944370	/users/cn/jespinosa/phecomp/data/CRG/20120502_FDF_CRG/20120502_FDF_CRG/20120511_FDF_CRG_c12.mtb	4379	96	WWFF	food_fat	4	213272	1336944137	1	0.0800000000000001	0.000343347639484979	6018	1
2	Food 2	Intake 4	77	213678	1336944543	/users/cn/jespinosa/phecomp/data/CRG/20120502_FDF_CRG/20120502_FDF_CRG/20120511_FDF_CRG_c12.mtb	4381	620	WWFF	food_fat	4	213601	1336944466	1	0.119999999999999	0.00155844155844155	6019	1
2	Food 2	Intake 4	316	214614	1336945479	/users/cn/jespinosa/phecomp/data/CRG/20120502_FDF_CRG/20120502_FDF_CRG/20120511_FDF_CRG_c12.mtb	4385	12	WWFF	food_fat	4	214298	1336945163	1	0.0200000000000014	6.32911392405108e-05	6020	1
2	Drink 1	Intake 1	25	214338	1336945203	/users/cn/jespinosa/phecomp/data/CRG/20120502_FDF_CRG/20120502_FDF_CRG/20120511_FDF_CRG_c12.mtb	913	NA	WWFF	water	1	214313	1336945178	1	0.02	0.0008	6021	1
2	Food 2	Intake 4	557	215183	1336946048	/users/cn/jespinosa/phecomp/data/CRG/20120502_FDF_CRG/20120502_FDF_CRG/20120511_FDF_CRG_c12.mtb	4386	24	WWFF	food_fat	4	214626	1336945491	1	0.0399999999999991	7.18132854578081e-05	6022	1
2	Food 2	Intake 4	45	215252	1336946117	/users/cn/jespinosa/phecomp/data/CRG/20120502_FDF_CRG/20120502_FDF_CRG/20120511_FDF_CRG_c12.mtb	4387	705	WWFF	food_fat	4	215207	1336946072	1	0.0999999999999996	0.00222222222222221	6023	1
2	Drink 1	Intake 1	30	215974	1336946839	/users/cn/jespinosa/phecomp/data/CRG/20120502_FDF_CRG/20120502_FDF_CRG/20120511_FDF_CRG_c12.mtb	914	NA	WWFF	water	1	215944	1336946809	1	0.04	0.00133333333333333	6024	1
2	Food 2	Intake 4	288	216245	1336947110	/users/cn/jespinosa/phecomp/data/CRG/20120502_FDF_CRG/20120502_FDF_CRG/20120511_FDF_CRG_c12.mtb	4390	92	WWFF	food_fat	4	215957	1336946822	1	0.0800000000000001	0.000277777777777778	6025	1
2	Drink 2	Intake 2	21	216032	1336946897	/users/cn/jespinosa/phecomp/data/CRG/20120502_FDF_CRG/20120502_FDF_CRG/20120511_FDF_CRG_c12.mtb	1384	NA	WWFF	water	2	216011	1336946876	1	0.02	0.000952380952380952	6026	1
2	Food 2	Intake 4	140	216477	1336947342	/users/cn/jespinosa/phecomp/data/CRG/20120502_FDF_CRG/20120502_FDF_CRG/20120511_FDF_CRG_c12.mtb	4392	738	WWFF	food_fat	4	216337	1336947202	1	0.200000000000001	0.00142857142857144	6027	1
2	Food 2	Intake 4	30	217245	1336948110	/users/cn/jespinosa/phecomp/data/CRG/20120502_FDF_CRG/20120502_FDF_CRG/20120511_FDF_CRG_c12.mtb	4395	141	WWFF	food_fat	4	217215	1336948080	1	0.0400000000000009	0.00133333333333336	6028	1
2	Food 2	Intake 4	379	217765	1336948630	/users/cn/jespinosa/phecomp/data/CRG/20120502_FDF_CRG/20120502_FDF_CRG/20120511_FDF_CRG_c12.mtb	4398	566	WWFF	food_fat	4	217386	1336948251	1	0.119999999999999	0.000316622691292873	6029	1
2	Drink 1	Intake 1	17	217482	1336948347	/users/cn/jespinosa/phecomp/data/CRG/20120502_FDF_CRG/20120502_FDF_CRG/20120511_FDF_CRG_c12.mtb	916	NA	WWFF	water	1	217465	1336948330	1	0.02	0.00117647058823529	6030	1
2	Drink 2	Intake 2	17	218093	1336948958	/users/cn/jespinosa/phecomp/data/CRG/20120502_FDF_CRG/20120502_FDF_CRG/20120511_FDF_CRG_c12.mtb	1386	NA	WWFF	water	2	218076	1336948941	1	0.02	0.00117647058823529	6031	1
2	Drink 1	Intake 1	8	218105	1336948970	/users/cn/jespinosa/phecomp/data/CRG/20120502_FDF_CRG/20120502_FDF_CRG/20120511_FDF_CRG_c12.mtb	917	NA	WWFF	water	1	218097	1336948962	1	0.02	0.0025	6032	1
2	Food 2	Intake 4	387	218718	1336949583	/users/cn/jespinosa/phecomp/data/CRG/20120502_FDF_CRG/20120502_FDF_CRG/20120511_FDF_CRG_c12.mtb	4401	14	WWFF	food_fat	4	218331	1336949196	1	0.0800000000000001	0.00020671834625323	6033	1
2	Food 2	Intake 4	133	218865	1336949730	/users/cn/jespinosa/phecomp/data/CRG/20120502_FDF_CRG/20120502_FDF_CRG/20120511_FDF_CRG_c12.mtb	4402	4	WWFF	food_fat	4	218732	1336949597	1	0.0999999999999996	0.000751879699248117	6034	1
2	Food 2	Intake 4	58	218927	1336949792	/users/cn/jespinosa/phecomp/data/CRG/20120502_FDF_CRG/20120502_FDF_CRG/20120511_FDF_CRG_c12.mtb	4403	5	WWFF	food_fat	4	218869	1336949734	1	0.0399999999999991	0.000689655172413778	6035	1
2	Food 2	Intake 4	746	219678	1336950543	/users/cn/jespinosa/phecomp/data/CRG/20120502_FDF_CRG/20120502_FDF_CRG/20120511_FDF_CRG_c12.mtb	4404	427	WWFF	food_fat	4	218932	1336949797	1	0.0200000000000014	2.68096514745327e-05	6036	1
2	Food 2	Intake 4	33	220138	1336951003	/users/cn/jespinosa/phecomp/data/CRG/20120502_FDF_CRG/20120502_FDF_CRG/20120511_FDF_CRG_c12.mtb	4407	439	WWFF	food_fat	4	220105	1336950970	1	0.0400000000000009	0.00121212121212124	6037	1
2	Food 2	Intake 4	422	220999	1336951864	/users/cn/jespinosa/phecomp/data/CRG/20120502_FDF_CRG/20120502_FDF_CRG/20120511_FDF_CRG_c12.mtb	4412	440	WWFF	food_fat	4	220577	1336951442	1	0.0400000000000009	9.4786729857822e-05	6038	1
2	Food 2	Intake 4	20	221459	1336952324	/users/cn/jespinosa/phecomp/data/CRG/20120502_FDF_CRG/20120502_FDF_CRG/20120511_FDF_CRG_c12.mtb	4417	6	WWFF	food_fat	4	221439	1336952304	1	0.0800000000000001	0.00400000000000001	6039	1
2	Food 2	Intake 4	26	221491	1336952356	/users/cn/jespinosa/phecomp/data/CRG/20120502_FDF_CRG/20120502_FDF_CRG/20120511_FDF_CRG_c12.mtb	4418	1180	WWFF	food_fat	4	221465	1336952330	1	0.0999999999999996	0.00384615384615383	6040	1
2	Food 2	Intake 4	45	222716	1336953581	/users/cn/jespinosa/phecomp/data/CRG/20120502_FDF_CRG/20120502_FDF_CRG/20120511_FDF_CRG_c12.mtb	4422	423	WWFF	food_fat	4	222671	1336953536	1	0.0599999999999987	0.0013333333333333	6041	1
2	Food 2	Intake 4	8	223147	1336954012	/users/cn/jespinosa/phecomp/data/CRG/20120502_FDF_CRG/20120502_FDF_CRG/20120511_FDF_CRG_c12.mtb	4423	1000	WWFF	food_fat	4	223139	1336954004	1	0.0200000000000014	0.00250000000000017	6042	1
2	Drink 2	Intake 2	19	223826	1336954691	/users/cn/jespinosa/phecomp/data/CRG/20120502_FDF_CRG/20120502_FDF_CRG/20120511_FDF_CRG_c12.mtb	1391	NA	WWFF	water	2	223807	1336954672	1	0.0599999999999998	0.00315789473684209	6043	1
2	Food 2	Intake 4	32	224179	1336955044	/users/cn/jespinosa/phecomp/data/CRG/20120502_FDF_CRG/20120502_FDF_CRG/20120511_FDF_CRG_c12.mtb	4428	331	WWFF	food_fat	4	224147	1336955012	1	0.0400000000000009	0.00125000000000003	6044	1
2	Food 2	Intake 4	63	224573	1336955438	/users/cn/jespinosa/phecomp/data/CRG/20120502_FDF_CRG/20120502_FDF_CRG/20120511_FDF_CRG_c12.mtb	4431	7	WWFF	food_fat	4	224510	1336955375	1	0.0600000000000005	0.00095238095238096	6045	1
2	Food 2	Intake 4	331	224911	1336955776	/users/cn/jespinosa/phecomp/data/CRG/20120502_FDF_CRG/20120502_FDF_CRG/20120511_FDF_CRG_c12.mtb	4432	225	WWFF	food_fat	4	224580	1336955445	1	0.139999999999999	0.000422960725075526	6046	1
2	Drink 2	Intake 2	15	224675	1336955540	/users/cn/jespinosa/phecomp/data/CRG/20120502_FDF_CRG/20120502_FDF_CRG/20120511_FDF_CRG_c12.mtb	1393	NA	WWFF	water	2	224660	1336955525	1	0.04	0.00266666666666667	6047	1
2	Drink 1	Intake 1	61	224894	1336955759	/users/cn/jespinosa/phecomp/data/CRG/20120502_FDF_CRG/20120502_FDF_CRG/20120511_FDF_CRG_c12.mtb	921	NA	WWFF	water	1	224833	1336955698	1	0.0599999999999996	0.000983606557377043	6048	1
2	Food 2	Intake 4	463	225599	1336956464	/users/cn/jespinosa/phecomp/data/CRG/20120502_FDF_CRG/20120502_FDF_CRG/20120511_FDF_CRG_c12.mtb	4435	12	WWFF	food_fat	4	225136	1336956001	1	0.120000000000001	0.000259179265658749	6049	1
2	Food 2	Intake 4	252	225863	1336956728	/users/cn/jespinosa/phecomp/data/CRG/20120502_FDF_CRG/20120502_FDF_CRG/20120511_FDF_CRG_c12.mtb	4436	10	WWFF	food_fat	4	225611	1336956476	1	0.0399999999999991	0.000158730158730155	6050	1
2	Food 2	Intake 4	30	225903	1336956768	/users/cn/jespinosa/phecomp/data/CRG/20120502_FDF_CRG/20120502_FDF_CRG/20120511_FDF_CRG_c12.mtb	4437	407	WWFF	food_fat	4	225873	1336956738	1	0.0400000000000009	0.00133333333333336	6051	1
2	Food 2	Intake 4	75	226385	1336957250	/users/cn/jespinosa/phecomp/data/CRG/20120502_FDF_CRG/20120502_FDF_CRG/20120511_FDF_CRG_c12.mtb	4441	523	WWFF	food_fat	4	226310	1336957175	1	0.0400000000000009	0.000533333333333345	6052	1
2	Food 2	Intake 4	14	226922	1336957787	/users/cn/jespinosa/phecomp/data/CRG/20120502_FDF_CRG/20120502_FDF_CRG/20120511_FDF_CRG_c12.mtb	4443	356	WWFF	food_fat	4	226908	1336957773	1	0.0400000000000009	0.00285714285714292	6053	1
2	Drink 2	Intake 2	23	227217	1336958082	/users/cn/jespinosa/phecomp/data/CRG/20120502_FDF_CRG/20120502_FDF_CRG/20120511_FDF_CRG_c12.mtb	1395	NA	WWFF	water	2	227194	1336958059	1	0.02	0.000869565217391304	6054	1
2	Food 2	Intake 4	14	227292	1336958157	/users/cn/jespinosa/phecomp/data/CRG/20120502_FDF_CRG/20120502_FDF_CRG/20120511_FDF_CRG_c12.mtb	4446	853	WWFF	food_fat	4	227278	1336958143	1	0.0600000000000005	0.00428571428571432	6055	1
2	Food 2	Intake 4	14	228159	1336959024	/users/cn/jespinosa/phecomp/data/CRG/20120502_FDF_CRG/20120502_FDF_CRG/20120511_FDF_CRG_c12.mtb	4456	1128	WWFF	food_fat	4	228145	1336959010	1	0.0800000000000001	0.00571428571428572	6056	1
2	Food 2	Intake 4	69	229356	1336960221	/users/cn/jespinosa/phecomp/data/CRG/20120502_FDF_CRG/20120502_FDF_CRG/20120511_FDF_CRG_c12.mtb	4459	44	WWFF	food_fat	4	229287	1336960152	1	0.119999999999999	0.00173913043478259	6057	1
2	Food 2	Intake 4	31	229431	1336960296	/users/cn/jespinosa/phecomp/data/CRG/20120502_FDF_CRG/20120502_FDF_CRG/20120511_FDF_CRG_c12.mtb	4461	296	WWFF	food_fat	4	229400	1336960265	1	0.0400000000000009	0.00129032258064519	6058	1
2	Food 2	Intake 4	20	229747	1336960612	/users/cn/jespinosa/phecomp/data/CRG/20120502_FDF_CRG/20120502_FDF_CRG/20120511_FDF_CRG_c12.mtb	4464	58	WWFF	food_fat	4	229727	1336960592	1	0.0399999999999991	0.00199999999999995	6059	1
2	Food 2	Intake 4	25	229830	1336960695	/users/cn/jespinosa/phecomp/data/CRG/20120502_FDF_CRG/20120502_FDF_CRG/20120511_FDF_CRG_c12.mtb	4465	320	WWFF	food_fat	4	229805	1336960670	1	0.0800000000000001	0.0032	6060	1
2	Food 2	Intake 4	34	230184	1336961049	/users/cn/jespinosa/phecomp/data/CRG/20120502_FDF_CRG/20120502_FDF_CRG/20120511_FDF_CRG_c12.mtb	4466	591	WWFF	food_fat	4	230150	1336961015	1	0.0200000000000014	0.000588235294117688	6061	1
2	Food 2	Intake 4	29	230804	1336961669	/users/cn/jespinosa/phecomp/data/CRG/20120502_FDF_CRG/20120502_FDF_CRG/20120511_FDF_CRG_c12.mtb	4468	45	WWFF	food_fat	4	230775	1336961640	1	0.0800000000000001	0.00275862068965518	6062	1
2	Food 2	Intake 4	12	230861	1336961726	/users/cn/jespinosa/phecomp/data/CRG/20120502_FDF_CRG/20120502_FDF_CRG/20120511_FDF_CRG_c12.mtb	4470	274	WWFF	food_fat	4	230849	1336961714	1	0.0600000000000005	0.00500000000000004	6063	1
2	Food 2	Intake 4	16	231151	1336962016	/users/cn/jespinosa/phecomp/data/CRG/20120502_FDF_CRG/20120502_FDF_CRG/20120511_FDF_CRG_c12.mtb	4472	544	WWFF	food_fat	4	231135	1336962000	1	0.0200000000000014	0.00125000000000009	6064	1
2	Drink 1	Intake 1	18	231312	1336962177	/users/cn/jespinosa/phecomp/data/CRG/20120502_FDF_CRG/20120502_FDF_CRG/20120511_FDF_CRG_c12.mtb	923	NA	WWFF	water	1	231294	1336962159	1	0.0200000000000005	0.00111111111111114	6065	1
2	Food 2	Intake 4	14	231709	1336962574	/users/cn/jespinosa/phecomp/data/CRG/20120502_FDF_CRG/20120502_FDF_CRG/20120511_FDF_CRG_c12.mtb	4477	99	WWFF	food_fat	4	231695	1336962560	1	0.0399999999999991	0.00285714285714279	6066	1
2	Food 2	Intake 4	31	231839	1336962704	/users/cn/jespinosa/phecomp/data/CRG/20120502_FDF_CRG/20120502_FDF_CRG/20120511_FDF_CRG_c12.mtb	4478	1838	WWFF	food_fat	4	231808	1336962673	1	0.0400000000000009	0.00129032258064519	6067	1
2	Drink 1	Intake 1	13	233350	1336964215	/users/cn/jespinosa/phecomp/data/CRG/20120502_FDF_CRG/20120502_FDF_CRG/20120511_FDF_CRG_c12.mtb	924	NA	WWFF	water	1	233337	1336964202	1	0.0799999999999996	0.00615384615384612	6068	1
2	Food 2	Intake 4	28	233705	1336964570	/users/cn/jespinosa/phecomp/data/CRG/20120502_FDF_CRG/20120502_FDF_CRG/20120511_FDF_CRG_c12.mtb	4487	16	WWFF	food_fat	4	233677	1336964542	1	0.0800000000000001	0.00285714285714286	6069	1
2	Food 2	Intake 4	12	233733	1336964598	/users/cn/jespinosa/phecomp/data/CRG/20120502_FDF_CRG/20120502_FDF_CRG/20120511_FDF_CRG_c12.mtb	4488	23	WWFF	food_fat	4	233721	1336964586	1	0.0599999999999987	0.00499999999999989	6070	1
2	Food 2	Intake 4	163	233919	1336964784	/users/cn/jespinosa/phecomp/data/CRG/20120502_FDF_CRG/20120502_FDF_CRG/20120511_FDF_CRG_c12.mtb	4489	53	WWFF	food_fat	4	233756	1336964621	1	1.34	0.00822085889570552	6071	1
2	Food 2	Intake 4	73	234045	1336964910	/users/cn/jespinosa/phecomp/data/CRG/20120502_FDF_CRG/20120502_FDF_CRG/20120511_FDF_CRG_c12.mtb	4490	667	WWFF	food_fat	4	233972	1336964837	1	0.0600000000000005	0.000821917808219185	6072	1
2	Drink 1	Intake 1	31	234090	1336964955	/users/cn/jespinosa/phecomp/data/CRG/20120502_FDF_CRG/20120502_FDF_CRG/20120511_FDF_CRG_c12.mtb	927	NA	WWFF	water	1	234059	1336964924	1	0.0800000000000001	0.00258064516129033	6073	1
2	Food 2	Intake 4	10	234722	1336965587	/users/cn/jespinosa/phecomp/data/CRG/20120502_FDF_CRG/20120502_FDF_CRG/20120511_FDF_CRG_c12.mtb	4493	662	WWFF	food_fat	4	234712	1336965577	1	0.0399999999999991	0.00399999999999991	6074	1
2	Food 2	Intake 4	9	235393	1336966258	/users/cn/jespinosa/phecomp/data/CRG/20120502_FDF_CRG/20120502_FDF_CRG/20120511_FDF_CRG_c12.mtb	4497	1748	WWFF	food_fat	4	235384	1336966249	1	0.0400000000000009	0.00444444444444455	6075	1
2	Food 2	Intake 4	18	237159	1336968024	/users/cn/jespinosa/phecomp/data/CRG/20120502_FDF_CRG/20120502_FDF_CRG/20120511_FDF_CRG_c12.mtb	4502	3546	WWFF	food_fat	4	237141	1336968006	1	0.0200000000000014	0.00111111111111119	6076	1
2	Drink 1	Intake 1	18	238949	1336969814	/users/cn/jespinosa/phecomp/data/CRG/20120502_FDF_CRG/20120502_FDF_CRG/20120511_FDF_CRG_c12.mtb	928	NA	WWFF	water	1	238931	1336969796	1	0.02	0.00111111111111111	6077	1
2	Drink 1	Intake 1	14	239604	1336970469	/users/cn/jespinosa/phecomp/data/CRG/20120502_FDF_CRG/20120502_FDF_CRG/20120511_FDF_CRG_c12.mtb	929	NA	WWFF	water	1	239590	1336970455	1	0.0600000000000001	0.00428571428571429	6078	1
2	Food 2	Intake 4	14	240719	1336971584	/users/cn/jespinosa/phecomp/data/CRG/20120502_FDF_CRG/20120502_FDF_CRG/20120511_FDF_CRG_c12.mtb	4515	72	WWFF	food_fat	4	240705	1336971570	1	0.0399999999999991	0.00285714285714279	6079	1
2	Food 2	Intake 4	31	240822	1336971687	/users/cn/jespinosa/phecomp/data/CRG/20120502_FDF_CRG/20120502_FDF_CRG/20120511_FDF_CRG_c12.mtb	4517	90	WWFF	food_fat	4	240791	1336971656	1	0.0399999999999991	0.00129032258064513	6080	1
2	Food 2	Intake 4	19	240931	1336971796	/users/cn/jespinosa/phecomp/data/CRG/20120502_FDF_CRG/20120502_FDF_CRG/20120511_FDF_CRG_c12.mtb	4518	6592	WWFF	food_fat	4	240912	1336971777	1	0.0399999999999991	0.00210526315789469	6081	1
2	Drink 1	Intake 1	25	241143	1336972008	/users/cn/jespinosa/phecomp/data/CRG/20120502_FDF_CRG/20120502_FDF_CRG/20120511_FDF_CRG_c12.mtb	930	NA	WWFF	water	1	241118	1336971983	1	0.0600000000000001	0.0024	6082	1
2	Drink 1	Intake 1	18	241352	1336972217	/users/cn/jespinosa/phecomp/data/CRG/20120502_FDF_CRG/20120502_FDF_CRG/20120511_FDF_CRG_c12.mtb	931	NA	WWFF	water	1	241334	1336972199	1	0.02	0.00111111111111111	6083	1
2	Drink 1	Intake 1	15	242111	1336972976	/users/cn/jespinosa/phecomp/data/CRG/20120502_FDF_CRG/20120502_FDF_CRG/20120511_FDF_CRG_c12.mtb	932	NA	WWFF	water	1	242096	1336972961	1	0.04	0.00266666666666667	6084	1
2	Drink 1	Intake 1	13	242621	1336973486	/users/cn/jespinosa/phecomp/data/CRG/20120502_FDF_CRG/20120502_FDF_CRG/20120511_FDF_CRG_c12.mtb	933	NA	WWFF	water	1	242608	1336973473	1	0.04	0.00307692307692308	6085	1
2	Food 2	Intake 4	15	247538	1336978403	/users/cn/jespinosa/phecomp/data/CRG/20120502_FDF_CRG/20120502_FDF_CRG/20120511_FDF_CRG_c12.mtb	4542	1235	WWFF	food_fat	4	247523	1336978388	1	0.0400000000000009	0.00266666666666673	6086	1
2	Drink 1	Intake 1	22	247550	1336978415	/users/cn/jespinosa/phecomp/data/CRG/20120502_FDF_CRG/20120502_FDF_CRG/20120511_FDF_CRG_c12.mtb	936	NA	WWFF	water	1	247528	1336978393	1	0.0800000000000001	0.00363636363636364	6087	1
2	Food 2	Intake 4	39	248812	1336979677	/users/cn/jespinosa/phecomp/data/CRG/20120502_FDF_CRG/20120502_FDF_CRG/20120511_FDF_CRG_c12.mtb	4546	96	WWFF	food_fat	4	248773	1336979638	1	0.0600000000000005	0.00153846153846155	6088	1
2	Drink 1	Intake 1	28	248844	1336979709	/users/cn/jespinosa/phecomp/data/CRG/20120502_FDF_CRG/20120502_FDF_CRG/20120511_FDF_CRG_c12.mtb	937	NA	WWFF	water	1	248816	1336979681	1	0.0399999999999996	0.00142857142857141	6089	1
2	Food 2	Intake 4	74	248982	1336979847	/users/cn/jespinosa/phecomp/data/CRG/20120502_FDF_CRG/20120502_FDF_CRG/20120511_FDF_CRG_c12.mtb	4548	34	WWFF	food_fat	4	248908	1336979773	1	0.100000000000001	0.00135135135135136	6090	1
2	Food 2	Intake 4	11	249027	1336979892	/users/cn/jespinosa/phecomp/data/CRG/20120502_FDF_CRG/20120502_FDF_CRG/20120511_FDF_CRG_c12.mtb	4550	2174	WWFF	food_fat	4	249016	1336979881	1	0.0400000000000009	0.00363636363636372	6091	1
2	Food 2	Intake 4	12	251213	1336982078	/users/cn/jespinosa/phecomp/data/CRG/20120502_FDF_CRG/20120502_FDF_CRG/20120511_FDF_CRG_c12.mtb	4552	10233	WWFF	food_fat	4	251201	1336982066	1	0.0399999999999991	0.00333333333333326	6092	1
2	Food 1	Intake 3	25	163	1336992336	/users/cn/jespinosa/phecomp/data/CRG/20120502_FDF_CRG/20120502_FDF_CRG/20120514_FDF_CRG_c12.mtb	3291	259	WWFF	food_fat	3	138	1336992311	1	0.2	0.008	6093	1
2	Food 1	Intake 3	23	445	1336992618	/users/cn/jespinosa/phecomp/data/CRG/20120502_FDF_CRG/20120502_FDF_CRG/20120514_FDF_CRG_c12.mtb	3293	51	WWFF	food_fat	3	422	1336992595	1	0.04	0.00173913043478261	6094	1
2	Food 1	Intake 3	36	532	1336992705	/users/cn/jespinosa/phecomp/data/CRG/20120502_FDF_CRG/20120502_FDF_CRG/20120514_FDF_CRG_c12.mtb	3294	170	WWFF	food_fat	3	496	1336992669	1	0.02	0.000555555555555556	6095	1
2	Food 1	Intake 3	20	722	1336992895	/users/cn/jespinosa/phecomp/data/CRG/20120502_FDF_CRG/20120502_FDF_CRG/20120514_FDF_CRG_c12.mtb	3297	177	WWFF	food_fat	3	702	1336992875	1	0.02	0.001	6096	1
2	Food 1	Intake 3	10	909	1336993082	/users/cn/jespinosa/phecomp/data/CRG/20120502_FDF_CRG/20120502_FDF_CRG/20120514_FDF_CRG_c12.mtb	3298	35	WWFF	food_fat	3	899	1336993072	1	0.02	0.002	6097	1
2	Food 1	Intake 3	27	971	1336993144	/users/cn/jespinosa/phecomp/data/CRG/20120502_FDF_CRG/20120502_FDF_CRG/20120514_FDF_CRG_c12.mtb	3299	11	WWFF	food_fat	3	944	1336993117	1	0.06	0.00222222222222222	6098	1
2	Food 1	Intake 3	22	1004	1336993177	/users/cn/jespinosa/phecomp/data/CRG/20120502_FDF_CRG/20120502_FDF_CRG/20120514_FDF_CRG_c12.mtb	3300	670	WWFF	food_fat	3	982	1336993155	1	0.06	0.00272727272727273	6099	1
2	Food 1	Intake 3	24	1698	1336993871	/users/cn/jespinosa/phecomp/data/CRG/20120502_FDF_CRG/20120502_FDF_CRG/20120514_FDF_CRG_c12.mtb	3301	110	WWFF	food_fat	3	1674	1336993847	1	0.38	0.0158333333333333	6100	1
2	Food 1	Intake 3	60	1868	1336994041	/users/cn/jespinosa/phecomp/data/CRG/20120502_FDF_CRG/20120502_FDF_CRG/20120514_FDF_CRG_c12.mtb	3302	82	WWFF	food_fat	3	1808	1336993981	1	0.16	0.00266666666666667	6101	1
2	Food 2	Intake 4	24	1974	1336994147	/users/cn/jespinosa/phecomp/data/CRG/20120502_FDF_CRG/20120502_FDF_CRG/20120514_FDF_CRG_c12.mtb	5125	13	WWFF	food_fat	4	1950	1336994123	1	0.26	0.0108333333333333	6102	1
2	Food 2	Intake 4	45	2032	1336994205	/users/cn/jespinosa/phecomp/data/CRG/20120502_FDF_CRG/20120502_FDF_CRG/20120514_FDF_CRG_c12.mtb	5126	367	WWFF	food_fat	4	1987	1336994160	1	0.48	0.0106666666666667	6103	1
2	Food 2	Intake 4	26	2425	1336994598	/users/cn/jespinosa/phecomp/data/CRG/20120502_FDF_CRG/20120502_FDF_CRG/20120514_FDF_CRG_c12.mtb	5128	COLL	WWFF	food_fat	4	2399	1336994572	1	0.02	0.000769230769230769	6104	1
2	Food 1	Intake 3	47	2461	1336994634	/users/cn/jespinosa/phecomp/data/CRG/20120502_FDF_CRG/20120502_FDF_CRG/20120514_FDF_CRG_c12.mtb	3306	341	WWFF	food_fat	3	2414	1336994587	1	0.14	0.00297872340425532	6105	1
2	Food 1	Intake 3	13	2815	1336994988	/users/cn/jespinosa/phecomp/data/CRG/20120502_FDF_CRG/20120502_FDF_CRG/20120514_FDF_CRG_c12.mtb	3308	2009	WWFF	food_fat	3	2802	1336994975	1	0.02	0.00153846153846154	6106	1
2	Drink 2	Intake 2	16	3199	1336995372	/users/cn/jespinosa/phecomp/data/CRG/20120502_FDF_CRG/20120502_FDF_CRG/20120514_FDF_CRG_c12.mtb	1454	NA	WWFF	water	2	3183	1336995356	1	0.02	0.00125	6107	1
2	Food 1	Intake 3	16	4840	1336997013	/users/cn/jespinosa/phecomp/data/CRG/20120502_FDF_CRG/20120502_FDF_CRG/20120514_FDF_CRG_c12.mtb	3310	17992	WWFF	food_fat	3	4824	1336996997	1	0.04	0.0025	6108	1
2	Drink 2	Intake 2	22	12139	1337004312	/users/cn/jespinosa/phecomp/data/CRG/20120502_FDF_CRG/20120502_FDF_CRG/20120514_FDF_CRG_c12.mtb	1458	NA	WWFF	water	2	12117	1337004290	1	0.12	0.00545454545454545	6109	1
2	Drink 1	Intake 1	20	21531	1337013704	/users/cn/jespinosa/phecomp/data/CRG/20120502_FDF_CRG/20120502_FDF_CRG/20120514_FDF_CRG_c12.mtb	1029	NA	WWFF	water	1	21511	1337013684	1	0.08	0.004	6110	1
2	Drink 1	Intake 1	13	22555	1337014728	/users/cn/jespinosa/phecomp/data/CRG/20120502_FDF_CRG/20120502_FDF_CRG/20120514_FDF_CRG_c12.mtb	1031	NA	WWFF	water	1	22542	1337014715	1	0.04	0.00307692307692308	6111	1
2	Drink 2	Intake 2	26	22827	1337015000	/users/cn/jespinosa/phecomp/data/CRG/20120502_FDF_CRG/20120502_FDF_CRG/20120514_FDF_CRG_c12.mtb	1461	NA	WWFF	water	2	22801	1337014974	1	0.08	0.00307692307692308	6112	1
2	Food 2	Intake 4	31	22863	1337015036	/users/cn/jespinosa/phecomp/data/CRG/20120502_FDF_CRG/20120502_FDF_CRG/20120514_FDF_CRG_c12.mtb	5135	COLL	WWFF	food_fat	4	22832	1337015005	1	0.02	0.000645161290322581	6113	1
2	Food 1	Intake 3	70	22924	1337015097	/users/cn/jespinosa/phecomp/data/CRG/20120502_FDF_CRG/20120502_FDF_CRG/20120514_FDF_CRG_c12.mtb	3315	4	WWFF	food_fat	3	22854	1337015027	1	0.02	0.000285714285714286	6114	1
2	Food 1	Intake 3	52	22980	1337015153	/users/cn/jespinosa/phecomp/data/CRG/20120502_FDF_CRG/20120502_FDF_CRG/20120514_FDF_CRG_c12.mtb	3316	4728	WWFF	food_fat	3	22928	1337015101	1	0.18	0.00346153846153846	6115	1
2	Food 1	Intake 3	16	27724	1337019897	/users/cn/jespinosa/phecomp/data/CRG/20120502_FDF_CRG/20120502_FDF_CRG/20120514_FDF_CRG_c12.mtb	3317	21	WWFF	food_fat	3	27708	1337019881	1	0.02	0.00125	6116	1
2	Food 2	Intake 4	47	27792	1337019965	/users/cn/jespinosa/phecomp/data/CRG/20120502_FDF_CRG/20120502_FDF_CRG/20120514_FDF_CRG_c12.mtb	5137	80	WWFF	food_fat	4	27745	1337019918	1	0.0599999999999999	0.00127659574468085	6117	1
2	Food 1	Intake 3	57	27929	1337020102	/users/cn/jespinosa/phecomp/data/CRG/20120502_FDF_CRG/20120502_FDF_CRG/20120514_FDF_CRG_c12.mtb	3319	26	WWFF	food_fat	3	27872	1337020045	1	0.04	0.000701754385964912	6118	1
2	Food 1	Intake 3	43	27998	1337020171	/users/cn/jespinosa/phecomp/data/CRG/20120502_FDF_CRG/20120502_FDF_CRG/20120514_FDF_CRG_c12.mtb	3320	551	WWFF	food_fat	3	27955	1337020128	1	0.02	0.000465116279069767	6119	1
2	Drink 2	Intake 2	26	28086	1337020259	/users/cn/jespinosa/phecomp/data/CRG/20120502_FDF_CRG/20120502_FDF_CRG/20120514_FDF_CRG_c12.mtb	1463	NA	WWFF	water	2	28060	1337020233	1	0.1	0.00384615384615385	6120	1
2	Drink 2	Intake 2	20	28469	1337020642	/users/cn/jespinosa/phecomp/data/CRG/20120502_FDF_CRG/20120502_FDF_CRG/20120514_FDF_CRG_c12.mtb	1464	NA	WWFF	water	2	28449	1337020622	1	0.04	0.002	6121	1
2	Food 1	Intake 3	30	28579	1337020752	/users/cn/jespinosa/phecomp/data/CRG/20120502_FDF_CRG/20120502_FDF_CRG/20120514_FDF_CRG_c12.mtb	3321	1161	WWFF	food_fat	3	28549	1337020722	1	0.0800000000000001	0.00266666666666667	6122	1
2	Food 1	Intake 3	15	29755	1337021928	/users/cn/jespinosa/phecomp/data/CRG/20120502_FDF_CRG/20120502_FDF_CRG/20120514_FDF_CRG_c12.mtb	3322	2753	WWFF	food_fat	3	29740	1337021913	1	0.02	0.00133333333333333	6123	1
2	Drink 2	Intake 2	10	29872	1337022045	/users/cn/jespinosa/phecomp/data/CRG/20120502_FDF_CRG/20120502_FDF_CRG/20120514_FDF_CRG_c12.mtb	1465	NA	WWFF	water	2	29862	1337022035	1	0.02	0.002	6124	1
2	Drink 2	Intake 2	34	31073	1337023246	/users/cn/jespinosa/phecomp/data/CRG/20120502_FDF_CRG/20120502_FDF_CRG/20120514_FDF_CRG_c12.mtb	1466	NA	WWFF	water	2	31039	1337023212	1	0.04	0.00117647058823529	6125	1
2	Food 1	Intake 3	15	32523	1337024696	/users/cn/jespinosa/phecomp/data/CRG/20120502_FDF_CRG/20120502_FDF_CRG/20120514_FDF_CRG_c12.mtb	3325	819	WWFF	food_fat	3	32508	1337024681	1	0.02	0.00133333333333333	6126	1
2	Drink 1	Intake 1	23	32543	1337024716	/users/cn/jespinosa/phecomp/data/CRG/20120502_FDF_CRG/20120502_FDF_CRG/20120514_FDF_CRG_c12.mtb	1033	NA	WWFF	water	1	32520	1337024693	1	0.02	0.000869565217391304	6127	1
2	Drink 2	Intake 2	26	32944	1337025117	/users/cn/jespinosa/phecomp/data/CRG/20120502_FDF_CRG/20120502_FDF_CRG/20120514_FDF_CRG_c12.mtb	1467	NA	WWFF	water	2	32918	1337025091	1	0.1	0.00384615384615385	6128	1
2	Food 1	Intake 3	87	33429	1337025602	/users/cn/jespinosa/phecomp/data/CRG/20120502_FDF_CRG/20120502_FDF_CRG/20120514_FDF_CRG_c12.mtb	3329	986	WWFF	food_fat	3	33342	1337025515	1	0.0999999999999999	0.00114942528735632	6129	1
2	Drink 2	Intake 2	33	33487	1337025660	/users/cn/jespinosa/phecomp/data/CRG/20120502_FDF_CRG/20120502_FDF_CRG/20120514_FDF_CRG_c12.mtb	1468	NA	WWFF	water	2	33454	1337025627	1	0.02	0.000606060606060606	6130	1
2	Food 1	Intake 3	23	34438	1337026611	/users/cn/jespinosa/phecomp/data/CRG/20120502_FDF_CRG/20120502_FDF_CRG/20120514_FDF_CRG_c12.mtb	3330	81	WWFF	food_fat	3	34415	1337026588	1	0.02	0.000869565217391304	6131	1
2	Food 1	Intake 3	71	34590	1337026763	/users/cn/jespinosa/phecomp/data/CRG/20120502_FDF_CRG/20120502_FDF_CRG/20120514_FDF_CRG_c12.mtb	3332	19	WWFF	food_fat	3	34519	1337026692	1	0.0600000000000001	0.000845070422535213	6132	1
2	Food 1	Intake 3	176	34785	1337026958	/users/cn/jespinosa/phecomp/data/CRG/20120502_FDF_CRG/20120502_FDF_CRG/20120514_FDF_CRG_c12.mtb	3333	67	WWFF	food_fat	3	34609	1337026782	1	0.2	0.00113636363636364	6133	1
2	Food 1	Intake 3	141	34993	1337027166	/users/cn/jespinosa/phecomp/data/CRG/20120502_FDF_CRG/20120502_FDF_CRG/20120514_FDF_CRG_c12.mtb	3334	596	WWFF	food_fat	3	34852	1337027025	1	0.16	0.00113475177304965	6134	1
2	Drink 2	Intake 2	28	35570	1337027743	/users/cn/jespinosa/phecomp/data/CRG/20120502_FDF_CRG/20120502_FDF_CRG/20120514_FDF_CRG_c12.mtb	1470	NA	WWFF	water	2	35542	1337027715	1	0.08	0.00285714285714286	6135	1
2	Food 1	Intake 3	84	35673	1337027846	/users/cn/jespinosa/phecomp/data/CRG/20120502_FDF_CRG/20120502_FDF_CRG/20120514_FDF_CRG_c12.mtb	3335	14	WWFF	food_fat	3	35589	1337027762	1	0.2	0.00238095238095238	6136	1
2	Food 1	Intake 3	149	35836	1337028009	/users/cn/jespinosa/phecomp/data/CRG/20120502_FDF_CRG/20120502_FDF_CRG/20120514_FDF_CRG_c12.mtb	3336	144	WWFF	food_fat	3	35687	1337027860	1	0.92	0.0061744966442953	6137	1
2	Food 1	Intake 3	16	35996	1337028169	/users/cn/jespinosa/phecomp/data/CRG/20120502_FDF_CRG/20120502_FDF_CRG/20120514_FDF_CRG_c12.mtb	3337	59	WWFF	food_fat	3	35980	1337028153	1	0.0200000000000005	0.00125000000000003	6138	1
2	Food 1	Intake 3	15	36070	1337028243	/users/cn/jespinosa/phecomp/data/CRG/20120502_FDF_CRG/20120502_FDF_CRG/20120514_FDF_CRG_c12.mtb	3338	19	WWFF	food_fat	3	36055	1337028228	1	0.0999999999999996	0.00666666666666664	6139	1
2	Food 1	Intake 3	220	36309	1337028482	/users/cn/jespinosa/phecomp/data/CRG/20120502_FDF_CRG/20120502_FDF_CRG/20120514_FDF_CRG_c12.mtb	3339	COLL	WWFF	food_fat	3	36089	1337028262	1	0.9	0.00409090909090909	6140	1
2	Food 2	Intake 4	18	36143	1337028316	/users/cn/jespinosa/phecomp/data/CRG/20120502_FDF_CRG/20120502_FDF_CRG/20120514_FDF_CRG_c12.mtb	5148	310	WWFF	food_fat	4	36125	1337028298	1	0.02	0.00111111111111111	6141	1
2	Drink 2	Intake 2	25	36434	1337028607	/users/cn/jespinosa/phecomp/data/CRG/20120502_FDF_CRG/20120502_FDF_CRG/20120514_FDF_CRG_c12.mtb	1471	NA	WWFF	water	2	36409	1337028582	1	0.08	0.0032	6142	1
2	Food 1	Intake 3	50	36503	1337028676	/users/cn/jespinosa/phecomp/data/CRG/20120502_FDF_CRG/20120502_FDF_CRG/20120514_FDF_CRG_c12.mtb	3340	COLL	WWFF	food_fat	3	36453	1337028626	1	0.0599999999999996	0.00119999999999999	6143	1
2	Food 2	Intake 4	26	36521	1337028694	/users/cn/jespinosa/phecomp/data/CRG/20120502_FDF_CRG/20120502_FDF_CRG/20120514_FDF_CRG_c12.mtb	5149	COLL	WWFF	food_fat	4	36495	1337028668	1	0.04	0.00153846153846154	6144	1
2	Food 1	Intake 3	137	36646	1337028819	/users/cn/jespinosa/phecomp/data/CRG/20120502_FDF_CRG/20120502_FDF_CRG/20120514_FDF_CRG_c12.mtb	3341	264	WWFF	food_fat	3	36509	1337028682	1	0.24	0.00175182481751825	6145	1
2	Food 1	Intake 3	254	37164	1337029337	/users/cn/jespinosa/phecomp/data/CRG/20120502_FDF_CRG/20120502_FDF_CRG/20120514_FDF_CRG_c12.mtb	3342	416	WWFF	food_fat	3	36910	1337029083	1	1.62	0.00637795275590551	6146	1
2	Drink 2	Intake 2	15	37571	1337029744	/users/cn/jespinosa/phecomp/data/CRG/20120502_FDF_CRG/20120502_FDF_CRG/20120514_FDF_CRG_c12.mtb	1472	NA	WWFF	water	2	37556	1337029729	1	0.02	0.00133333333333333	6147	1
2	Food 1	Intake 3	86	37666	1337029839	/users/cn/jespinosa/phecomp/data/CRG/20120502_FDF_CRG/20120502_FDF_CRG/20120514_FDF_CRG_c12.mtb	3343	17553	WWFF	food_fat	3	37580	1337029753	1	1.68	0.0195348837209302	6148	1
2	Drink 2	Intake 2	19	39575	1337031748	/users/cn/jespinosa/phecomp/data/CRG/20120502_FDF_CRG/20120502_FDF_CRG/20120514_FDF_CRG_c12.mtb	1474	NA	WWFF	water	2	39556	1337031729	1	0.0600000000000001	0.00315789473684211	6149	1
2	Drink 2	Intake 2	37	40171	1337032344	/users/cn/jespinosa/phecomp/data/CRG/20120502_FDF_CRG/20120502_FDF_CRG/20120514_FDF_CRG_c12.mtb	1475	NA	WWFF	water	2	40134	1337032307	1	0.0399999999999999	0.00108108108108108	6150	1
2	Drink 2	Intake 2	14	43945	1337036118	/users/cn/jespinosa/phecomp/data/CRG/20120502_FDF_CRG/20120502_FDF_CRG/20120514_FDF_CRG_c12.mtb	1477	NA	WWFF	water	2	43931	1337036104	1	0.04	0.00285714285714286	6151	1
2	Drink 2	Intake 2	14	47543	1337039716	/users/cn/jespinosa/phecomp/data/CRG/20120502_FDF_CRG/20120502_FDF_CRG/20120514_FDF_CRG_c12.mtb	1478	NA	WWFF	water	2	47529	1337039702	1	0.0600000000000001	0.00428571428571429	6152	1
2	Drink 1	Intake 1	24	52677	1337044850	/users/cn/jespinosa/phecomp/data/CRG/20120502_FDF_CRG/20120502_FDF_CRG/20120514_FDF_CRG_c12.mtb	1035	NA	WWFF	water	1	52653	1337044826	1	0.06	0.0025	6153	1
2	Drink 2	Intake 2	19	53985	1337046158	/users/cn/jespinosa/phecomp/data/CRG/20120502_FDF_CRG/20120502_FDF_CRG/20120514_FDF_CRG_c12.mtb	1480	NA	WWFF	water	2	53966	1337046139	1	0.0800000000000001	0.00421052631578948	6154	1
2	Food 2	Intake 4	76	55295	1337047468	/users/cn/jespinosa/phecomp/data/CRG/20120502_FDF_CRG/20120502_FDF_CRG/20120514_FDF_CRG_c12.mtb	5154	38	WWFF	food_fat	4	55219	1337047392	1	0.0399999999999999	0.000526315789473683	6155	1
2	Food 2	Intake 4	123	55456	1337047629	/users/cn/jespinosa/phecomp/data/CRG/20120502_FDF_CRG/20120502_FDF_CRG/20120514_FDF_CRG_c12.mtb	5155	472	WWFF	food_fat	4	55333	1337047506	1	0.28	0.00227642276422764	6156	1
2	Drink 2	Intake 2	25	55931	1337048104	/users/cn/jespinosa/phecomp/data/CRG/20120502_FDF_CRG/20120502_FDF_CRG/20120514_FDF_CRG_c12.mtb	1483	NA	WWFF	water	2	55906	1337048079	1	0.04	0.0016	6157	1
2	Food 2	Intake 4	87	56015	1337048188	/users/cn/jespinosa/phecomp/data/CRG/20120502_FDF_CRG/20120502_FDF_CRG/20120514_FDF_CRG_c12.mtb	5157	375	WWFF	food_fat	4	55928	1337048101	1	0.0800000000000001	0.000919540229885059	6158	1
2	Food 2	Intake 4	83	56473	1337048646	/users/cn/jespinosa/phecomp/data/CRG/20120502_FDF_CRG/20120502_FDF_CRG/20120514_FDF_CRG_c12.mtb	5158	962	WWFF	food_fat	4	56390	1337048563	1	0.0999999999999999	0.00120481927710843	6159	1
2	Food 1	Intake 3	168	57603	1337049776	/users/cn/jespinosa/phecomp/data/CRG/20120502_FDF_CRG/20120502_FDF_CRG/20120514_FDF_CRG_c12.mtb	3352	20	WWFF	food_fat	3	57435	1337049608	1	1.26	0.0075	6160	1
2	Food 1	Intake 3	37	57660	1337049833	/users/cn/jespinosa/phecomp/data/CRG/20120502_FDF_CRG/20120502_FDF_CRG/20120514_FDF_CRG_c12.mtb	3353	COLL	WWFF	food_fat	3	57623	1337049796	1	0.0999999999999996	0.00270270270270269	6161	1
2	Food 2	Intake 4	33	57684	1337049857	/users/cn/jespinosa/phecomp/data/CRG/20120502_FDF_CRG/20120502_FDF_CRG/20120514_FDF_CRG_c12.mtb	5159	COLL	WWFF	food_fat	4	57651	1337049824	1	0.0600000000000001	0.00181818181818182	6162	1
2	Food 1	Intake 3	44	57717	1337049890	/users/cn/jespinosa/phecomp/data/CRG/20120502_FDF_CRG/20120502_FDF_CRG/20120514_FDF_CRG_c12.mtb	3354	COLL	WWFF	food_fat	3	57673	1337049846	1	0.0600000000000005	0.00136363636363638	6163	1
2	Food 2	Intake 4	33	57740	1337049913	/users/cn/jespinosa/phecomp/data/CRG/20120502_FDF_CRG/20120502_FDF_CRG/20120514_FDF_CRG_c12.mtb	5160	24951	WWFF	food_fat	4	57707	1337049880	1	0.02	0.000606060606060606	6164	1
2	Drink 2	Intake 2	36	57888	1337050061	/users/cn/jespinosa/phecomp/data/CRG/20120502_FDF_CRG/20120502_FDF_CRG/20120514_FDF_CRG_c12.mtb	1484	NA	WWFF	water	2	57852	1337050025	1	0.0600000000000001	0.00166666666666667	6165	1
2	Drink 1	Intake 1	12	62948	1337055121	/users/cn/jespinosa/phecomp/data/CRG/20120502_FDF_CRG/20120502_FDF_CRG/20120514_FDF_CRG_c12.mtb	1038	NA	WWFF	water	1	62936	1337055109	1	0.04	0.00333333333333333	6166	1
2	Drink 2	Intake 2	18	65452	1337057625	/users/cn/jespinosa/phecomp/data/CRG/20120502_FDF_CRG/20120502_FDF_CRG/20120514_FDF_CRG_c12.mtb	1485	NA	WWFF	water	2	65434	1337057607	1	0.0399999999999998	0.00222222222222221	6167	1
2	Drink 2	Intake 2	31	66149	1337058322	/users/cn/jespinosa/phecomp/data/CRG/20120502_FDF_CRG/20120502_FDF_CRG/20120514_FDF_CRG_c12.mtb	1486	NA	WWFF	water	2	66118	1337058291	1	0.0600000000000001	0.00193548387096775	6168	1
2	Drink 2	Intake 2	23	66427	1337058600	/users/cn/jespinosa/phecomp/data/CRG/20120502_FDF_CRG/20120502_FDF_CRG/20120514_FDF_CRG_c12.mtb	1487	NA	WWFF	water	2	66404	1337058577	1	0.0600000000000001	0.00260869565217392	6169	1
2	Drink 2	Intake 2	31	67258	1337059431	/users/cn/jespinosa/phecomp/data/CRG/20120502_FDF_CRG/20120502_FDF_CRG/20120514_FDF_CRG_c12.mtb	1488	NA	WWFF	water	2	67227	1337059400	1	0.12	0.00387096774193548	6170	1
2	Drink 2	Intake 2	19	74960	1337067133	/users/cn/jespinosa/phecomp/data/CRG/20120502_FDF_CRG/20120502_FDF_CRG/20120514_FDF_CRG_c12.mtb	1490	NA	WWFF	water	2	74941	1337067114	1	0.04	0.00210526315789474	6171	1
2	Drink 2	Intake 2	100	82239	1337074412	/users/cn/jespinosa/phecomp/data/CRG/20120502_FDF_CRG/20120502_FDF_CRG/20120514_FDF_CRG_c12.mtb	1491	NA	WWFF	water	2	82139	1337074312	1	0.0800000000000001	0.000800000000000001	6172	1
2	Drink 1	Intake 1	20	82266	1337074439	/users/cn/jespinosa/phecomp/data/CRG/20120502_FDF_CRG/20120502_FDF_CRG/20120514_FDF_CRG_c12.mtb	1040	NA	WWFF	water	1	82246	1337074419	1	0.02	0.001	6173	1
2	Drink 2	Intake 2	15	82340	1337074513	/users/cn/jespinosa/phecomp/data/CRG/20120502_FDF_CRG/20120502_FDF_CRG/20120514_FDF_CRG_c12.mtb	1492	NA	WWFF	water	2	82325	1337074498	1	0.0600000000000001	0.00400000000000001	6174	1
2	Food 2	Intake 4	15	82706	1337074879	/users/cn/jespinosa/phecomp/data/CRG/20120502_FDF_CRG/20120502_FDF_CRG/20120514_FDF_CRG_c12.mtb	5169	24472	WWFF	food_fat	4	82691	1337074864	1	0.02	0.00133333333333333	6175	1
2	Drink 2	Intake 2	15	83649	1337075822	/users/cn/jespinosa/phecomp/data/CRG/20120502_FDF_CRG/20120502_FDF_CRG/20120514_FDF_CRG_c12.mtb	1493	NA	WWFF	water	2	83634	1337075807	1	0.04	0.00266666666666667	6176	1
2	Drink 2	Intake 2	18	83919	1337076092	/users/cn/jespinosa/phecomp/data/CRG/20120502_FDF_CRG/20120502_FDF_CRG/20120514_FDF_CRG_c12.mtb	1495	NA	WWFF	water	2	83901	1337076074	1	0.02	0.00111111111111111	6177	1
2	Drink 1	Intake 1	21	93944	1337086117	/users/cn/jespinosa/phecomp/data/CRG/20120502_FDF_CRG/20120502_FDF_CRG/20120514_FDF_CRG_c12.mtb	1041	NA	WWFF	water	1	93923	1337086096	1	0.08	0.00380952380952381	6178	1
2	Food 2	Intake 4	15	107193	1337099366	/users/cn/jespinosa/phecomp/data/CRG/20120502_FDF_CRG/20120502_FDF_CRG/20120514_FDF_CRG_c12.mtb	5172	6112	WWFF	food_fat	4	107178	1337099351	1	0.04	0.00266666666666667	6179	1
2	Drink 1	Intake 1	13	107286	1337099459	/users/cn/jespinosa/phecomp/data/CRG/20120502_FDF_CRG/20120502_FDF_CRG/20120514_FDF_CRG_c12.mtb	1042	NA	WWFF	water	1	107273	1337099446	1	0.02	0.00153846153846154	6180	1
2	Drink 2	Intake 2	24	107317	1337099490	/users/cn/jespinosa/phecomp/data/CRG/20120502_FDF_CRG/20120502_FDF_CRG/20120514_FDF_CRG_c12.mtb	1498	NA	WWFF	water	2	107293	1337099466	1	0.02	0.000833333333333333	6181	1
2	Food 1	Intake 3	15	113320	1337105493	/users/cn/jespinosa/phecomp/data/CRG/20120502_FDF_CRG/20120502_FDF_CRG/20120514_FDF_CRG_c12.mtb	3365	14	WWFF	food_fat	3	113305	1337105478	1	0.0400000000000009	0.00266666666666673	6182	1
2	Food 1	Intake 3	39	113373	1337105546	/users/cn/jespinosa/phecomp/data/CRG/20120502_FDF_CRG/20120502_FDF_CRG/20120514_FDF_CRG_c12.mtb	3366	1198	WWFF	food_fat	3	113334	1337105507	1	0.0800000000000001	0.00205128205128205	6183	1
2	Drink 2	Intake 2	49	114441	1337106614	/users/cn/jespinosa/phecomp/data/CRG/20120502_FDF_CRG/20120502_FDF_CRG/20120514_FDF_CRG_c12.mtb	1499	NA	WWFF	water	2	114392	1337106565	1	0.0599999999999998	0.00122448979591836	6184	1
2	Food 2	Intake 4	25	114596	1337106769	/users/cn/jespinosa/phecomp/data/CRG/20120502_FDF_CRG/20120502_FDF_CRG/20120514_FDF_CRG_c12.mtb	5176	6	WWFF	food_fat	4	114571	1337106744	1	0.04	0.0016	6185	1
2	Food 2	Intake 4	109	114711	1337106884	/users/cn/jespinosa/phecomp/data/CRG/20120502_FDF_CRG/20120502_FDF_CRG/20120514_FDF_CRG_c12.mtb	5177	1444	WWFF	food_fat	4	114602	1337106775	1	0.02	0.00018348623853211	6186	1
2	Drink 2	Intake 2	26	114898	1337107071	/users/cn/jespinosa/phecomp/data/CRG/20120502_FDF_CRG/20120502_FDF_CRG/20120514_FDF_CRG_c12.mtb	1500	NA	WWFF	water	2	114872	1337107045	1	0.04	0.00153846153846154	6187	1
2	Drink 2	Intake 2	31	115200	1337107373	/users/cn/jespinosa/phecomp/data/CRG/20120502_FDF_CRG/20120502_FDF_CRG/20120514_FDF_CRG_c12.mtb	1501	NA	WWFF	water	2	115169	1337107342	1	0.0599999999999998	0.00193548387096774	6188	1
2	Drink 2	Intake 2	29	115500	1337107673	/users/cn/jespinosa/phecomp/data/CRG/20120502_FDF_CRG/20120502_FDF_CRG/20120514_FDF_CRG_c12.mtb	1502	NA	WWFF	water	2	115471	1337107644	1	0.0600000000000001	0.00206896551724138	6189	1
2	Food 2	Intake 4	45	116200	1337108373	/users/cn/jespinosa/phecomp/data/CRG/20120502_FDF_CRG/20120502_FDF_CRG/20120514_FDF_CRG_c12.mtb	5182	84	WWFF	food_fat	4	116155	1337108328	1	0.02	0.000444444444444444	6190	1
2	Food 2	Intake 4	58	116342	1337108515	/users/cn/jespinosa/phecomp/data/CRG/20120502_FDF_CRG/20120502_FDF_CRG/20120514_FDF_CRG_c12.mtb	5184	175	WWFF	food_fat	4	116284	1337108457	1	0.02	0.000344827586206897	6191	1
2	Food 2	Intake 4	41	116558	1337108731	/users/cn/jespinosa/phecomp/data/CRG/20120502_FDF_CRG/20120502_FDF_CRG/20120514_FDF_CRG_c12.mtb	5187	159	WWFF	food_fat	4	116517	1337108690	1	0.02	0.00048780487804878	6192	1
2	Food 2	Intake 4	86	116803	1337108976	/users/cn/jespinosa/phecomp/data/CRG/20120502_FDF_CRG/20120502_FDF_CRG/20120514_FDF_CRG_c12.mtb	5189	1730	WWFF	food_fat	4	116717	1337108890	1	0.0799999999999998	0.000930232558139532	6193	1
2	Drink 2	Intake 2	22	117724	1337109897	/users/cn/jespinosa/phecomp/data/CRG/20120502_FDF_CRG/20120502_FDF_CRG/20120514_FDF_CRG_c12.mtb	1505	NA	WWFF	water	2	117702	1337109875	1	0.0800000000000001	0.00363636363636364	6194	1
2	Food 2	Intake 4	94	118627	1337110800	/users/cn/jespinosa/phecomp/data/CRG/20120502_FDF_CRG/20120502_FDF_CRG/20120514_FDF_CRG_c12.mtb	5193	17	WWFF	food_fat	4	118533	1337110706	1	0.16	0.00170212765957447	6195	1
2	Food 2	Intake 4	82	118726	1337110899	/users/cn/jespinosa/phecomp/data/CRG/20120502_FDF_CRG/20120502_FDF_CRG/20120514_FDF_CRG_c12.mtb	5194	3318	WWFF	food_fat	4	118644	1337110817	1	0.02	0.00024390243902439	6196	1
2	Drink 2	Intake 2	25	119803	1337111976	/users/cn/jespinosa/phecomp/data/CRG/20120502_FDF_CRG/20120502_FDF_CRG/20120514_FDF_CRG_c12.mtb	1507	NA	WWFF	water	2	119778	1337111951	1	0.02	0.0008	6197	1
2	Drink 2	Intake 2	10	121487	1337113660	/users/cn/jespinosa/phecomp/data/CRG/20120502_FDF_CRG/20120502_FDF_CRG/20120514_FDF_CRG_c12.mtb	1510	NA	WWFF	water	2	121477	1337113650	1	0.04	0.004	6198	1
2	Food 2	Intake 4	39	122083	1337114256	/users/cn/jespinosa/phecomp/data/CRG/20120502_FDF_CRG/20120502_FDF_CRG/20120514_FDF_CRG_c12.mtb	5197	5	WWFF	food_fat	4	122044	1337114217	1	0.0800000000000001	0.00205128205128205	6199	1
2	Food 2	Intake 4	20	122108	1337114281	/users/cn/jespinosa/phecomp/data/CRG/20120502_FDF_CRG/20120502_FDF_CRG/20120514_FDF_CRG_c12.mtb	5198	3099	WWFF	food_fat	4	122088	1337114261	1	0.02	0.001	6200	1
2	Drink 2	Intake 2	15	122842	1337115015	/users/cn/jespinosa/phecomp/data/CRG/20120502_FDF_CRG/20120502_FDF_CRG/20120514_FDF_CRG_c12.mtb	1511	NA	WWFF	water	2	122827	1337115000	1	0.02	0.00133333333333333	6201	1
2	Food 1	Intake 3	23	125230	1337117403	/users/cn/jespinosa/phecomp/data/CRG/20120502_FDF_CRG/20120502_FDF_CRG/20120514_FDF_CRG_c12.mtb	3383	6075	WWFF	food_fat	3	125207	1337117380	1	0.0400000000000009	0.00173913043478265	6202	1
2	Drink 2	Intake 2	23	128698	1337120871	/users/cn/jespinosa/phecomp/data/CRG/20120502_FDF_CRG/20120502_FDF_CRG/20120514_FDF_CRG_c12.mtb	1512	NA	WWFF	water	2	128675	1337120848	1	0.12	0.00521739130434783	6203	1
2	Drink 2	Intake 2	15	129922	1337122095	/users/cn/jespinosa/phecomp/data/CRG/20120502_FDF_CRG/20120502_FDF_CRG/20120514_FDF_CRG_c12.mtb	1513	NA	WWFF	water	2	129907	1337122080	1	0.04	0.00266666666666667	6204	1
2	Food 1	Intake 3	15	131320	1337123493	/users/cn/jespinosa/phecomp/data/CRG/20120502_FDF_CRG/20120502_FDF_CRG/20120514_FDF_CRG_c12.mtb	3387	1496	WWFF	food_fat	3	131305	1337123478	1	0.0200000000000014	0.00133333333333343	6205	1
2	Drink 2	Intake 2	13	132056	1337124229	/users/cn/jespinosa/phecomp/data/CRG/20120502_FDF_CRG/20120502_FDF_CRG/20120514_FDF_CRG_c12.mtb	1514	NA	WWFF	water	2	132043	1337124216	1	0.04	0.00307692307692308	6206	1
2	Food 1	Intake 3	34	132850	1337125023	/users/cn/jespinosa/phecomp/data/CRG/20120502_FDF_CRG/20120502_FDF_CRG/20120514_FDF_CRG_c12.mtb	3389	441	WWFF	food_fat	3	132816	1337124989	1	0.0599999999999987	0.0017647058823529	6207	1
2	Food 1	Intake 3	32	133323	1337125496	/users/cn/jespinosa/phecomp/data/CRG/20120502_FDF_CRG/20120502_FDF_CRG/20120514_FDF_CRG_c12.mtb	3391	435	WWFF	food_fat	3	133291	1337125464	1	0.0200000000000014	0.000625000000000044	6208	1
2	Drink 2	Intake 2	28	133613	1337125786	/users/cn/jespinosa/phecomp/data/CRG/20120502_FDF_CRG/20120502_FDF_CRG/20120514_FDF_CRG_c12.mtb	1515	NA	WWFF	water	2	133585	1337125758	1	0.0599999999999996	0.00214285714285713	6209	1
2	Food 2	Intake 4	39	133797	1337125970	/users/cn/jespinosa/phecomp/data/CRG/20120502_FDF_CRG/20120502_FDF_CRG/20120514_FDF_CRG_c12.mtb	5208	12901	WWFF	food_fat	4	133758	1337125931	1	0.02	0.000512820512820513	6210	1
2	Drink 2	Intake 2	22	134049	1337126222	/users/cn/jespinosa/phecomp/data/CRG/20120502_FDF_CRG/20120502_FDF_CRG/20120514_FDF_CRG_c12.mtb	1516	NA	WWFF	water	2	134027	1337126200	1	0.04	0.00181818181818182	6211	1
2	Drink 1	Intake 1	28	134890	1337127063	/users/cn/jespinosa/phecomp/data/CRG/20120502_FDF_CRG/20120502_FDF_CRG/20120514_FDF_CRG_c12.mtb	1048	NA	WWFF	water	1	134862	1337127035	1	0.06	0.00214285714285714	6212	1
2	Drink 2	Intake 2	20	139666	1337131839	/users/cn/jespinosa/phecomp/data/CRG/20120502_FDF_CRG/20120502_FDF_CRG/20120514_FDF_CRG_c12.mtb	1519	NA	WWFF	water	2	139646	1337131819	1	0.02	0.001	6213	1
2	Drink 2	Intake 2	24	140271	1337132444	/users/cn/jespinosa/phecomp/data/CRG/20120502_FDF_CRG/20120502_FDF_CRG/20120514_FDF_CRG_c12.mtb	1520	NA	WWFF	water	2	140247	1337132420	1	0.0800000000000001	0.00333333333333334	6214	1
2	Drink 2	Intake 2	15	142923	1337135096	/users/cn/jespinosa/phecomp/data/CRG/20120502_FDF_CRG/20120502_FDF_CRG/20120514_FDF_CRG_c12.mtb	1522	NA	WWFF	water	2	142908	1337135081	1	0.0600000000000001	0.00400000000000001	6215	1
2	Drink 2	Intake 2	16	143554	1337135727	/users/cn/jespinosa/phecomp/data/CRG/20120502_FDF_CRG/20120502_FDF_CRG/20120514_FDF_CRG_c12.mtb	1523	NA	WWFF	water	2	143538	1337135711	1	0.02	0.00125	6216	1
2	Drink 2	Intake 2	17	144797	1337136970	/users/cn/jespinosa/phecomp/data/CRG/20120502_FDF_CRG/20120502_FDF_CRG/20120514_FDF_CRG_c12.mtb	1524	NA	WWFF	water	2	144780	1337136953	1	0.02	0.00117647058823529	6217	1
2	Food 2	Intake 4	26	146724	1337138897	/users/cn/jespinosa/phecomp/data/CRG/20120502_FDF_CRG/20120502_FDF_CRG/20120514_FDF_CRG_c12.mtb	5212	260	WWFF	food_fat	4	146698	1337138871	1	0.02	0.000769230769230769	6218	1
2	Drink 2	Intake 2	29	146990	1337139163	/users/cn/jespinosa/phecomp/data/CRG/20120502_FDF_CRG/20120502_FDF_CRG/20120514_FDF_CRG_c12.mtb	1526	NA	WWFF	water	2	146961	1337139134	1	0.0600000000000001	0.00206896551724138	6219	1
2	Food 1	Intake 3	39	147023	1337139196	/users/cn/jespinosa/phecomp/data/CRG/20120502_FDF_CRG/20120502_FDF_CRG/20120514_FDF_CRG_c12.mtb	3403	COLL	WWFF	food_fat	3	146984	1337139157	1	0.0399999999999991	0.001025641025641	6220	1
2	Food 2	Intake 4	40	147051	1337139224	/users/cn/jespinosa/phecomp/data/CRG/20120502_FDF_CRG/20120502_FDF_CRG/20120514_FDF_CRG_c12.mtb	5215	4100	WWFF	food_fat	4	147011	1337139184	1	0.02	0.0005	6221	1
2	Drink 2	Intake 2	21	147424	1337139597	/users/cn/jespinosa/phecomp/data/CRG/20120502_FDF_CRG/20120502_FDF_CRG/20120514_FDF_CRG_c12.mtb	1527	NA	WWFF	water	2	147403	1337139576	1	0.0600000000000001	0.00285714285714286	6222	1
2	Drink 2	Intake 2	11	149185	1337141358	/users/cn/jespinosa/phecomp/data/CRG/20120502_FDF_CRG/20120502_FDF_CRG/20120514_FDF_CRG_c12.mtb	1529	NA	WWFF	water	2	149174	1337141347	1	0.04	0.00363636363636364	6223	1
2	Food 1	Intake 3	15	151166	1337143339	/users/cn/jespinosa/phecomp/data/CRG/20120502_FDF_CRG/20120502_FDF_CRG/20120514_FDF_CRG_c12.mtb	3408	798	WWFF	food_fat	3	151151	1337143324	1	0.0400000000000009	0.00266666666666673	6224	1
2	Drink 2	Intake 2	21	151696	1337143869	/users/cn/jespinosa/phecomp/data/CRG/20120502_FDF_CRG/20120502_FDF_CRG/20120514_FDF_CRG_c12.mtb	1530	NA	WWFF	water	2	151675	1337143848	1	0.0599999999999996	0.00285714285714284	6225	1
2	Food 2	Intake 4	17	151981	1337144154	/users/cn/jespinosa/phecomp/data/CRG/20120502_FDF_CRG/20120502_FDF_CRG/20120514_FDF_CRG_c12.mtb	5221	255	WWFF	food_fat	4	151964	1337144137	1	0.02	0.00117647058823529	6226	1
2	Drink 2	Intake 2	22	152194	1337144367	/users/cn/jespinosa/phecomp/data/CRG/20120502_FDF_CRG/20120502_FDF_CRG/20120514_FDF_CRG_c12.mtb	1531	NA	WWFF	water	2	152172	1337144345	1	0.04	0.00181818181818182	6227	1
2	Food 2	Intake 4	102	152338	1337144511	/users/cn/jespinosa/phecomp/data/CRG/20120502_FDF_CRG/20120502_FDF_CRG/20120514_FDF_CRG_c12.mtb	5223	184	WWFF	food_fat	4	152236	1337144409	1	0.02	0.000196078431372549	6228	1
2	Food 2	Intake 4	30	152552	1337144725	/users/cn/jespinosa/phecomp/data/CRG/20120502_FDF_CRG/20120502_FDF_CRG/20120514_FDF_CRG_c12.mtb	5226	6	WWFF	food_fat	4	152522	1337144695	1	0.02	0.000666666666666667	6229	1
2	Food 2	Intake 4	34	152592	1337144765	/users/cn/jespinosa/phecomp/data/CRG/20120502_FDF_CRG/20120502_FDF_CRG/20120514_FDF_CRG_c12.mtb	5227	30	WWFF	food_fat	4	152558	1337144731	1	0.02	0.000588235294117647	6230	1
2	Food 2	Intake 4	20	152642	1337144815	/users/cn/jespinosa/phecomp/data/CRG/20120502_FDF_CRG/20120502_FDF_CRG/20120514_FDF_CRG_c12.mtb	5228	41	WWFF	food_fat	4	152622	1337144795	1	0.02	0.001	6231	1
2	Food 2	Intake 4	126	152809	1337144982	/users/cn/jespinosa/phecomp/data/CRG/20120502_FDF_CRG/20120502_FDF_CRG/20120514_FDF_CRG_c12.mtb	5229	1543	WWFF	food_fat	4	152683	1337144856	1	0.02	0.000158730158730159	6232	1
2	Drink 2	Intake 2	19	153121	1337145294	/users/cn/jespinosa/phecomp/data/CRG/20120502_FDF_CRG/20120502_FDF_CRG/20120514_FDF_CRG_c12.mtb	1532	NA	WWFF	water	2	153102	1337145275	1	0.04	0.00210526315789474	6233	1
2	Drink 2	Intake 2	33	153573	1337145746	/users/cn/jespinosa/phecomp/data/CRG/20120502_FDF_CRG/20120502_FDF_CRG/20120514_FDF_CRG_c12.mtb	1533	NA	WWFF	water	2	153540	1337145713	1	0.0800000000000001	0.00242424242424243	6234	1
2	Drink 2	Intake 2	17	153996	1337146169	/users/cn/jespinosa/phecomp/data/CRG/20120502_FDF_CRG/20120502_FDF_CRG/20120514_FDF_CRG_c12.mtb	1534	NA	WWFF	water	2	153979	1337146152	1	0.02	0.00117647058823529	6235	1
2	Food 2	Intake 4	129	154481	1337146654	/users/cn/jespinosa/phecomp/data/CRG/20120502_FDF_CRG/20120502_FDF_CRG/20120514_FDF_CRG_c12.mtb	5232	6705	WWFF	food_fat	4	154352	1337146525	1	0.02	0.000155038759689922	6236	1
2	Food 1	Intake 3	30	161216	1337153389	/users/cn/jespinosa/phecomp/data/CRG/20120502_FDF_CRG/20120502_FDF_CRG/20120514_FDF_CRG_c12.mtb	3418	24	WWFF	food_fat	3	161186	1337153359	1	0.0200000000000014	0.000666666666666713	6237	1
2	Food 2	Intake 4	68	161308	1337153481	/users/cn/jespinosa/phecomp/data/CRG/20120502_FDF_CRG/20120502_FDF_CRG/20120514_FDF_CRG_c12.mtb	5233	10494	WWFF	food_fat	4	161240	1337153413	1	0.0600000000000001	0.000882352941176472	6238	1
2	Food 2	Intake 4	20	716	1337163995	/users/cn/jespinosa/phecomp/data/CRG/20120502_FDF_CRG/20120502_FDF_CRG/20120516_FDF_CRG_c12.mtb	5420	107	WWFF	food_fat	4	696	1337163975	1	0.06	0.003	6239	1
2	Food 2	Intake 4	69	892	1337164171	/users/cn/jespinosa/phecomp/data/CRG/20120502_FDF_CRG/20120502_FDF_CRG/20120516_FDF_CRG_c12.mtb	5421	COLL	WWFF	food_fat	4	823	1337164102	1	0.12	0.00173913043478261	6240	1
2	Food 1	Intake 3	52	933	1337164212	/users/cn/jespinosa/phecomp/data/CRG/20120502_FDF_CRG/20120502_FDF_CRG/20120516_FDF_CRG_c12.mtb	3693	30	WWFF	food_fat	3	881	1337164160	1	0.72	0.0138461538461538	6241	1
2	Food 1	Intake 3	147	1110	1337164389	/users/cn/jespinosa/phecomp/data/CRG/20120502_FDF_CRG/20120502_FDF_CRG/20120516_FDF_CRG_c12.mtb	3694	COLL	WWFF	food_fat	3	963	1337164242	1	1.32	0.00897959183673469	6242	1
2	Food 2	Intake 4	18	1057	1337164336	/users/cn/jespinosa/phecomp/data/CRG/20120502_FDF_CRG/20120502_FDF_CRG/20120516_FDF_CRG_c12.mtb	5423	59	WWFF	food_fat	4	1039	1337164318	1	0.02	0.00111111111111111	6243	1
2	Food 1	Intake 3	26	1142	1337164421	/users/cn/jespinosa/phecomp/data/CRG/20120502_FDF_CRG/20120502_FDF_CRG/20120516_FDF_CRG_c12.mtb	3695	82	WWFF	food_fat	3	1116	1337164395	1	0.0800000000000001	0.00307692307692308	6244	1
2	Drink 1	Intake 1	15	1214	1337164493	/users/cn/jespinosa/phecomp/data/CRG/20120502_FDF_CRG/20120502_FDF_CRG/20120516_FDF_CRG_c12.mtb	1092	NA	WWFF	water	1	1199	1337164478	1	0.02	0.00133333333333333	6245	1
2	Food 1	Intake 3	98	1322	1337164601	/users/cn/jespinosa/phecomp/data/CRG/20120502_FDF_CRG/20120502_FDF_CRG/20120516_FDF_CRG_c12.mtb	3696	COLL	WWFF	food_fat	3	1224	1337164503	1	0.86	0.00877551020408163	6246	1
2	Food 2	Intake 4	86	1402	1337164681	/users/cn/jespinosa/phecomp/data/CRG/20120502_FDF_CRG/20120502_FDF_CRG/20120516_FDF_CRG_c12.mtb	5426	COLL	WWFF	food_fat	4	1316	1337164595	1	0.32	0.00372093023255814	6247	1
2	Food 1	Intake 3	39	1379	1337164658	/users/cn/jespinosa/phecomp/data/CRG/20120502_FDF_CRG/20120502_FDF_CRG/20120516_FDF_CRG_c12.mtb	3697	128	WWFF	food_fat	3	1340	1337164619	1	0.04	0.00102564102564103	6248	1
2	Food 1	Intake 3	230	1737	1337165016	/users/cn/jespinosa/phecomp/data/CRG/20120502_FDF_CRG/20120502_FDF_CRG/20120516_FDF_CRG_c12.mtb	3698	173	WWFF	food_fat	3	1507	1337164786	1	2.62	0.0113913043478261	6249	1
2	Drink 2	Intake 2	21	1870	1337165149	/users/cn/jespinosa/phecomp/data/CRG/20120502_FDF_CRG/20120502_FDF_CRG/20120516_FDF_CRG_c12.mtb	1576	NA	WWFF	water	2	1849	1337165128	1	0.08	0.00380952380952381	6250	1
2	Food 1	Intake 3	69	1979	1337165258	/users/cn/jespinosa/phecomp/data/CRG/20120502_FDF_CRG/20120502_FDF_CRG/20120516_FDF_CRG_c12.mtb	3699	635	WWFF	food_fat	3	1910	1337165189	1	0.600000000000001	0.00869565217391306	6251	1
2	Food 2	Intake 4	18	2632	1337165911	/users/cn/jespinosa/phecomp/data/CRG/20120502_FDF_CRG/20120502_FDF_CRG/20120516_FDF_CRG_c12.mtb	5427	7706	WWFF	food_fat	4	2614	1337165893	1	0.02	0.00111111111111111	6252	1
2	Drink 2	Intake 2	66	2719	1337165998	/users/cn/jespinosa/phecomp/data/CRG/20120502_FDF_CRG/20120502_FDF_CRG/20120516_FDF_CRG_c12.mtb	1579	NA	WWFF	water	2	2653	1337165932	1	0.02	0.000303030303030303	6253	1
2	Drink 2	Intake 2	14	8753	1337172032	/users/cn/jespinosa/phecomp/data/CRG/20120502_FDF_CRG/20120502_FDF_CRG/20120516_FDF_CRG_c12.mtb	1580	NA	WWFF	water	2	8739	1337172018	1	0.04	0.00285714285714286	6254	1
2	Food 1	Intake 3	14	10352	1337173631	/users/cn/jespinosa/phecomp/data/CRG/20120502_FDF_CRG/20120502_FDF_CRG/20120516_FDF_CRG_c12.mtb	3701	12870	WWFF	food_fat	3	10338	1337173617	1	0.04	0.00285714285714286	6255	1
2	Drink 2	Intake 2	11	10409	1337173688	/users/cn/jespinosa/phecomp/data/CRG/20120502_FDF_CRG/20120502_FDF_CRG/20120516_FDF_CRG_c12.mtb	1581	NA	WWFF	water	2	10398	1337173677	1	0.04	0.00363636363636364	6256	1
2	Drink 1	Intake 1	26	11033	1337174312	/users/cn/jespinosa/phecomp/data/CRG/20120502_FDF_CRG/20120502_FDF_CRG/20120516_FDF_CRG_c12.mtb	1094	NA	WWFF	water	1	11007	1337174286	1	0.08	0.00307692307692308	6257	1
2	Food 1	Intake 3	15	23237	1337186516	/users/cn/jespinosa/phecomp/data/CRG/20120502_FDF_CRG/20120502_FDF_CRG/20120516_FDF_CRG_c12.mtb	3703	1598	WWFF	food_fat	3	23222	1337186501	1	0.0200000000000005	0.00133333333333337	6258	1
2	Food 1	Intake 3	17	24852	1337188131	/users/cn/jespinosa/phecomp/data/CRG/20120502_FDF_CRG/20120502_FDF_CRG/20120516_FDF_CRG_c12.mtb	3704	1532	WWFF	food_fat	3	24835	1337188114	1	0.04	0.00235294117647059	6259	1
2	Food 1	Intake 3	9	26393	1337189672	/users/cn/jespinosa/phecomp/data/CRG/20120502_FDF_CRG/20120502_FDF_CRG/20120516_FDF_CRG_c12.mtb	3705	3605	WWFF	food_fat	3	26384	1337189663	1	0.04	0.00444444444444444	6260	1
2	Drink 2	Intake 2	20	27818	1337191097	/users/cn/jespinosa/phecomp/data/CRG/20120502_FDF_CRG/20120502_FDF_CRG/20120516_FDF_CRG_c12.mtb	1583	NA	WWFF	water	2	27798	1337191077	1	0.1	0.005	6261	1
2	Drink 2	Intake 2	16	29856	1337193135	/users/cn/jespinosa/phecomp/data/CRG/20120502_FDF_CRG/20120502_FDF_CRG/20120516_FDF_CRG_c12.mtb	1584	NA	WWFF	water	2	29840	1337193119	1	0.08	0.005	6262	1
2	Food 1	Intake 3	15	30013	1337193292	/users/cn/jespinosa/phecomp/data/CRG/20120502_FDF_CRG/20120502_FDF_CRG/20120516_FDF_CRG_c12.mtb	3707	744	WWFF	food_fat	3	29998	1337193277	1	0.0599999999999996	0.00399999999999997	6263	1
2	Drink 2	Intake 2	43	30592	1337193871	/users/cn/jespinosa/phecomp/data/CRG/20120502_FDF_CRG/20120502_FDF_CRG/20120516_FDF_CRG_c12.mtb	1585	NA	WWFF	water	2	30549	1337193828	1	0.1	0.00232558139534884	6264	1
2	Food 1	Intake 3	12	30769	1337194048	/users/cn/jespinosa/phecomp/data/CRG/20120502_FDF_CRG/20120502_FDF_CRG/20120516_FDF_CRG_c12.mtb	3709	3074	WWFF	food_fat	3	30757	1337194036	1	0.04	0.00333333333333333	6265	1
2	Drink 2	Intake 2	18	31214	1337194493	/users/cn/jespinosa/phecomp/data/CRG/20120502_FDF_CRG/20120502_FDF_CRG/20120516_FDF_CRG_c12.mtb	1586	NA	WWFF	water	2	31196	1337194475	1	0.08	0.00444444444444444	6266	1
2	Drink 2	Intake 2	20	33702	1337196981	/users/cn/jespinosa/phecomp/data/CRG/20120502_FDF_CRG/20120502_FDF_CRG/20120516_FDF_CRG_c12.mtb	1587	NA	WWFF	water	2	33682	1337196961	1	0.0599999999999999	0.00299999999999999	6267	1
2	Food 1	Intake 3	27	33870	1337197149	/users/cn/jespinosa/phecomp/data/CRG/20120502_FDF_CRG/20120502_FDF_CRG/20120516_FDF_CRG_c12.mtb	3710	10	WWFF	food_fat	3	33843	1337197122	1	0.04	0.00148148148148148	6268	1
2	Food 1	Intake 3	12	33892	1337197171	/users/cn/jespinosa/phecomp/data/CRG/20120502_FDF_CRG/20120502_FDF_CRG/20120516_FDF_CRG_c12.mtb	3711	2636	WWFF	food_fat	3	33880	1337197159	1	0.04	0.00333333333333333	6269	1
2	Drink 2	Intake 2	13	34841	1337198120	/users/cn/jespinosa/phecomp/data/CRG/20120502_FDF_CRG/20120502_FDF_CRG/20120516_FDF_CRG_c12.mtb	1588	NA	WWFF	water	2	34828	1337198107	1	0.02	0.00153846153846154	6270	1
2	Drink 2	Intake 2	19	35345	1337198624	/users/cn/jespinosa/phecomp/data/CRG/20120502_FDF_CRG/20120502_FDF_CRG/20120516_FDF_CRG_c12.mtb	1589	NA	WWFF	water	2	35326	1337198605	1	0.0600000000000001	0.00315789473684211	6271	1
2	Food 1	Intake 3	14	36542	1337199821	/users/cn/jespinosa/phecomp/data/CRG/20120502_FDF_CRG/20120502_FDF_CRG/20120516_FDF_CRG_c12.mtb	3713	439	WWFF	food_fat	3	36528	1337199807	1	0.0600000000000005	0.00428571428571432	6272	1
2	Food 1	Intake 3	77	37058	1337200337	/users/cn/jespinosa/phecomp/data/CRG/20120502_FDF_CRG/20120502_FDF_CRG/20120516_FDF_CRG_c12.mtb	3714	37	WWFF	food_fat	3	36981	1337200260	1	0.16	0.00207792207792208	6273	1
2	Food 2	Intake 4	149	37244	1337200523	/users/cn/jespinosa/phecomp/data/CRG/20120502_FDF_CRG/20120502_FDF_CRG/20120516_FDF_CRG_c12.mtb	5434	498	WWFF	food_fat	4	37095	1337200374	1	0.08	0.000536912751677852	6274	1
2	Food 1	Intake 3	33	37775	1337201054	/users/cn/jespinosa/phecomp/data/CRG/20120502_FDF_CRG/20120502_FDF_CRG/20120516_FDF_CRG_c12.mtb	3717	75	WWFF	food_fat	3	37742	1337201021	1	0.119999999999999	0.00363636363636361	6275	1
2	Drink 2	Intake 2	26	37851	1337201130	/users/cn/jespinosa/phecomp/data/CRG/20120502_FDF_CRG/20120502_FDF_CRG/20120516_FDF_CRG_c12.mtb	1591	NA	WWFF	water	2	37825	1337201104	1	0.08	0.00307692307692308	6276	1
2	Food 1	Intake 3	52	37902	1337201181	/users/cn/jespinosa/phecomp/data/CRG/20120502_FDF_CRG/20120502_FDF_CRG/20120516_FDF_CRG_c12.mtb	3718	COLL	WWFF	food_fat	3	37850	1337201129	1	0.0600000000000005	0.00115384615384616	6277	1
2	Food 2	Intake 4	57	37950	1337201229	/users/cn/jespinosa/phecomp/data/CRG/20120502_FDF_CRG/20120502_FDF_CRG/20120516_FDF_CRG_c12.mtb	5437	11	WWFF	food_fat	4	37893	1337201172	1	0.02	0.000350877192982456	6278	1
2	Food 2	Intake 4	42	38003	1337201282	/users/cn/jespinosa/phecomp/data/CRG/20120502_FDF_CRG/20120502_FDF_CRG/20120516_FDF_CRG_c12.mtb	5438	204	WWFF	food_fat	4	37961	1337201240	1	0.08	0.0019047619047619	6279	1
2	Food 2	Intake 4	55	38262	1337201541	/users/cn/jespinosa/phecomp/data/CRG/20120502_FDF_CRG/20120502_FDF_CRG/20120516_FDF_CRG_c12.mtb	5441	7	WWFF	food_fat	4	38207	1337201486	1	0.02	0.000363636363636364	6280	1
2	Food 1	Intake 3	141	38410	1337201689	/users/cn/jespinosa/phecomp/data/CRG/20120502_FDF_CRG/20120502_FDF_CRG/20120516_FDF_CRG_c12.mtb	3719	2172	WWFF	food_fat	3	38269	1337201548	1	1.66	0.0117730496453901	6281	1
2	Drink 2	Intake 2	47	38553	1337201832	/users/cn/jespinosa/phecomp/data/CRG/20120502_FDF_CRG/20120502_FDF_CRG/20120516_FDF_CRG_c12.mtb	1592	NA	WWFF	water	2	38506	1337201785	1	0.04	0.000851063829787234	6282	1
2	Drink 1	Intake 1	13	38987	1337202266	/users/cn/jespinosa/phecomp/data/CRG/20120502_FDF_CRG/20120502_FDF_CRG/20120516_FDF_CRG_c12.mtb	1095	NA	WWFF	water	1	38974	1337202253	1	0.02	0.00153846153846154	6283	1
2	Food 2	Intake 4	101	40683	1337203962	/users/cn/jespinosa/phecomp/data/CRG/20120502_FDF_CRG/20120502_FDF_CRG/20120516_FDF_CRG_c12.mtb	5445	4437	WWFF	food_fat	4	40582	1337203861	1	0.1	0.00099009900990099	6284	1
2	Food 2	Intake 4	94	45214	1337208493	/users/cn/jespinosa/phecomp/data/CRG/20120502_FDF_CRG/20120502_FDF_CRG/20120516_FDF_CRG_c12.mtb	5448	310	WWFF	food_fat	4	45120	1337208399	1	0.0600000000000001	0.000638297872340427	6285	1
2	Drink 2	Intake 2	16	45382	1337208661	/users/cn/jespinosa/phecomp/data/CRG/20120502_FDF_CRG/20120502_FDF_CRG/20120516_FDF_CRG_c12.mtb	1596	NA	WWFF	water	2	45366	1337208645	1	0.04	0.0025	6286	1
2	Food 2	Intake 4	91	45615	1337208894	/users/cn/jespinosa/phecomp/data/CRG/20120502_FDF_CRG/20120502_FDF_CRG/20120516_FDF_CRG_c12.mtb	5450	1587	WWFF	food_fat	4	45524	1337208803	1	0.02	0.00021978021978022	6287	1
2	Drink 2	Intake 2	17	46309	1337209588	/users/cn/jespinosa/phecomp/data/CRG/20120502_FDF_CRG/20120502_FDF_CRG/20120516_FDF_CRG_c12.mtb	1598	NA	WWFF	water	2	46292	1337209571	1	0.0600000000000001	0.00352941176470589	6288	1
2	Food 1	Intake 3	21	47223	1337210502	/users/cn/jespinosa/phecomp/data/CRG/20120502_FDF_CRG/20120502_FDF_CRG/20120516_FDF_CRG_c12.mtb	3724	6	WWFF	food_fat	3	47202	1337210481	1	0.0800000000000001	0.00380952380952381	6289	1
2	Food 1	Intake 3	23	47252	1337210531	/users/cn/jespinosa/phecomp/data/CRG/20120502_FDF_CRG/20120502_FDF_CRG/20120516_FDF_CRG_c12.mtb	3725	713	WWFF	food_fat	3	47229	1337210508	1	0.0600000000000005	0.00260869565217393	6290	1
2	Food 2	Intake 4	28	47993	1337211272	/users/cn/jespinosa/phecomp/data/CRG/20120502_FDF_CRG/20120502_FDF_CRG/20120516_FDF_CRG_c12.mtb	5455	96	WWFF	food_fat	4	47965	1337211244	1	0.1	0.00357142857142857	6291	1
2	Food 2	Intake 4	71	48160	1337211439	/users/cn/jespinosa/phecomp/data/CRG/20120502_FDF_CRG/20120502_FDF_CRG/20120516_FDF_CRG_c12.mtb	5456	4806	WWFF	food_fat	4	48089	1337211368	1	0.42	0.00591549295774648	6292	1
2	Drink 2	Intake 2	22	49437	1337212716	/users/cn/jespinosa/phecomp/data/CRG/20120502_FDF_CRG/20120502_FDF_CRG/20120516_FDF_CRG_c12.mtb	1600	NA	WWFF	water	2	49415	1337212694	1	0.02	0.000909090909090909	6293	1
2	Drink 1	Intake 1	18	52597	1337215876	/users/cn/jespinosa/phecomp/data/CRG/20120502_FDF_CRG/20120502_FDF_CRG/20120516_FDF_CRG_c12.mtb	1096	NA	WWFF	water	1	52579	1337215858	1	0.04	0.00222222222222222	6294	1
2	Drink 2	Intake 2	22	52955	1337216234	/users/cn/jespinosa/phecomp/data/CRG/20120502_FDF_CRG/20120502_FDF_CRG/20120516_FDF_CRG_c12.mtb	1601	NA	WWFF	water	2	52933	1337216212	1	0.02	0.000909090909090909	6295	1
2	Food 2	Intake 4	73	53039	1337216318	/users/cn/jespinosa/phecomp/data/CRG/20120502_FDF_CRG/20120502_FDF_CRG/20120516_FDF_CRG_c12.mtb	5458	354	WWFF	food_fat	4	52966	1337216245	1	0.04	0.000547945205479452	6296	1
2	Drink 2	Intake 2	16	53167	1337216446	/users/cn/jespinosa/phecomp/data/CRG/20120502_FDF_CRG/20120502_FDF_CRG/20120516_FDF_CRG_c12.mtb	1602	NA	WWFF	water	2	53151	1337216430	1	0.04	0.0025	6297	1
2	Drink 2	Intake 2	29	53357	1337216636	/users/cn/jespinosa/phecomp/data/CRG/20120502_FDF_CRG/20120502_FDF_CRG/20120516_FDF_CRG_c12.mtb	1603	NA	WWFF	water	2	53328	1337216607	1	0.0800000000000001	0.00275862068965518	6298	1
2	Food 2	Intake 4	133	53526	1337216805	/users/cn/jespinosa/phecomp/data/CRG/20120502_FDF_CRG/20120502_FDF_CRG/20120516_FDF_CRG_c12.mtb	5460	9581	WWFF	food_fat	4	53393	1337216672	1	0.04	0.000300751879699248	6299	1
2	Drink 1	Intake 1	20	57061	1337220340	/users/cn/jespinosa/phecomp/data/CRG/20120502_FDF_CRG/20120502_FDF_CRG/20120516_FDF_CRG_c12.mtb	1100	NA	WWFF	water	1	57041	1337220320	1	0.02	0.001	6300	1
2	Drink 2	Intake 2	10	57129	1337220408	/users/cn/jespinosa/phecomp/data/CRG/20120502_FDF_CRG/20120502_FDF_CRG/20120516_FDF_CRG_c12.mtb	1606	NA	WWFF	water	2	57119	1337220398	1	0.02	0.002	6301	1
2	Food 2	Intake 4	33	63140	1337226419	/users/cn/jespinosa/phecomp/data/CRG/20120502_FDF_CRG/20120502_FDF_CRG/20120516_FDF_CRG_c12.mtb	5462	3624	WWFF	food_fat	4	63107	1337226386	1	0.02	0.000606060606060606	6302	1
2	Drink 2	Intake 2	42	63757	1337227036	/users/cn/jespinosa/phecomp/data/CRG/20120502_FDF_CRG/20120502_FDF_CRG/20120516_FDF_CRG_c12.mtb	1607	NA	WWFF	water	2	63715	1337226994	1	0.0999999999999999	0.00238095238095238	6303	1
2	Drink 2	Intake 2	12	64158	1337227437	/users/cn/jespinosa/phecomp/data/CRG/20120502_FDF_CRG/20120502_FDF_CRG/20120516_FDF_CRG_c12.mtb	1609	NA	WWFF	water	2	64146	1337227425	1	0.02	0.00166666666666667	6304	1
2	Drink 2	Intake 2	15	64770	1337228049	/users/cn/jespinosa/phecomp/data/CRG/20120502_FDF_CRG/20120502_FDF_CRG/20120516_FDF_CRG_c12.mtb	1610	NA	WWFF	water	2	64755	1337228034	1	0.0600000000000001	0.00400000000000001	6305	1
2	Drink 2	Intake 2	22	64824	1337228103	/users/cn/jespinosa/phecomp/data/CRG/20120502_FDF_CRG/20120502_FDF_CRG/20120516_FDF_CRG_c12.mtb	1611	NA	WWFF	water	2	64802	1337228081	1	0.0599999999999998	0.00272727272727272	6306	1
2	Food 2	Intake 4	11	66775	1337230054	/users/cn/jespinosa/phecomp/data/CRG/20120502_FDF_CRG/20120502_FDF_CRG/20120516_FDF_CRG_c12.mtb	5468	16	WWFF	food_fat	4	66764	1337230043	1	0.02	0.00181818181818182	6307	1
2	Food 2	Intake 4	39	66830	1337230109	/users/cn/jespinosa/phecomp/data/CRG/20120502_FDF_CRG/20120502_FDF_CRG/20120516_FDF_CRG_c12.mtb	5469	334	WWFF	food_fat	4	66791	1337230070	1	0.02	0.000512820512820513	6308	1
2	Drink 2	Intake 2	12	67145	1337230424	/users/cn/jespinosa/phecomp/data/CRG/20120502_FDF_CRG/20120502_FDF_CRG/20120516_FDF_CRG_c12.mtb	1612	NA	WWFF	water	2	67133	1337230412	1	0.02	0.00166666666666667	6309	1
2	Food 2	Intake 4	94	67258	1337230537	/users/cn/jespinosa/phecomp/data/CRG/20120502_FDF_CRG/20120502_FDF_CRG/20120516_FDF_CRG_c12.mtb	5470	611	WWFF	food_fat	4	67164	1337230443	1	0.04	0.000425531914893617	6310	1
2	Drink 2	Intake 2	20	67729	1337231008	/users/cn/jespinosa/phecomp/data/CRG/20120502_FDF_CRG/20120502_FDF_CRG/20120516_FDF_CRG_c12.mtb	1613	NA	WWFF	water	2	67709	1337230988	1	0.0600000000000001	0.00300000000000001	6311	1
2	Food 2	Intake 4	120	67989	1337231268	/users/cn/jespinosa/phecomp/data/CRG/20120502_FDF_CRG/20120502_FDF_CRG/20120516_FDF_CRG_c12.mtb	5474	1453	WWFF	food_fat	4	67869	1337231148	1	0.02	0.000166666666666667	6312	1
2	Drink 2	Intake 2	14	68439	1337231718	/users/cn/jespinosa/phecomp/data/CRG/20120502_FDF_CRG/20120502_FDF_CRG/20120516_FDF_CRG_c12.mtb	1614	NA	WWFF	water	2	68425	1337231704	1	0.02	0.00142857142857143	6313	1
2	Food 1	Intake 3	39	69481	1337232760	/users/cn/jespinosa/phecomp/data/CRG/20120502_FDF_CRG/20120502_FDF_CRG/20120516_FDF_CRG_c12.mtb	3739	33	WWFF	food_fat	3	69442	1337232721	1	0.0600000000000005	0.00153846153846155	6314	1
2	Food 1	Intake 3	20	69534	1337232813	/users/cn/jespinosa/phecomp/data/CRG/20120502_FDF_CRG/20120502_FDF_CRG/20120516_FDF_CRG_c12.mtb	3740	29	WWFF	food_fat	3	69514	1337232793	1	0.159999999999998	0.0079999999999999	6315	1
2	Food 2	Intake 4	36	69599	1337232878	/users/cn/jespinosa/phecomp/data/CRG/20120502_FDF_CRG/20120502_FDF_CRG/20120516_FDF_CRG_c12.mtb	5477	6254	WWFF	food_fat	4	69563	1337232842	1	0.02	0.000555555555555556	6316	1
2	Drink 2	Intake 2	32	69645	1337232924	/users/cn/jespinosa/phecomp/data/CRG/20120502_FDF_CRG/20120502_FDF_CRG/20120516_FDF_CRG_c12.mtb	1615	NA	WWFF	water	2	69613	1337232892	1	0.02	0.000625	6317	1
2	Food 1	Intake 3	36	75889	1337239168	/users/cn/jespinosa/phecomp/data/CRG/20120502_FDF_CRG/20120502_FDF_CRG/20120516_FDF_CRG_c12.mtb	3743	7669	WWFF	food_fat	3	75853	1337239132	1	0.120000000000001	0.00333333333333336	6318	1
2	Drink 2	Intake 2	24	82060	1337245339	/users/cn/jespinosa/phecomp/data/CRG/20120502_FDF_CRG/20120502_FDF_CRG/20120516_FDF_CRG_c12.mtb	1616	NA	WWFF	water	2	82036	1337245315	1	0.12	0.005	6319	1
2	Food 1	Intake 3	13	83571	1337246850	/users/cn/jespinosa/phecomp/data/CRG/20120502_FDF_CRG/20120502_FDF_CRG/20120516_FDF_CRG_c12.mtb	3745	27911	WWFF	food_fat	3	83558	1337246837	1	0.0400000000000009	0.00307692307692315	6320	1
2	Drink 2	Intake 2	20	84071	1337247350	/users/cn/jespinosa/phecomp/data/CRG/20120502_FDF_CRG/20120502_FDF_CRG/20120516_FDF_CRG_c12.mtb	1617	NA	WWFF	water	2	84051	1337247330	1	0.0800000000000001	0.00400000000000001	6321	1
2	Drink 2	Intake 2	9	85393	1337248672	/users/cn/jespinosa/phecomp/data/CRG/20120502_FDF_CRG/20120502_FDF_CRG/20120516_FDF_CRG_c12.mtb	1619	NA	WWFF	water	2	85384	1337248663	1	0.04	0.00444444444444444	6322	1
2	Drink 2	Intake 2	24	103859	1337267138	/users/cn/jespinosa/phecomp/data/CRG/20120502_FDF_CRG/20120502_FDF_CRG/20120516_FDF_CRG_c12.mtb	1625	NA	WWFF	water	2	103835	1337267114	1	0.12	0.005	6323	1
2	Drink 1	Intake 1	34	103921	1337267200	/users/cn/jespinosa/phecomp/data/CRG/20120502_FDF_CRG/20120502_FDF_CRG/20120516_FDF_CRG_c12.mtb	1101	NA	WWFF	water	1	103887	1337267166	1	0.04	0.00117647058823529	6324	1
2	Food 1	Intake 3	21	111503	1337274782	/users/cn/jespinosa/phecomp/data/CRG/20120502_FDF_CRG/20120502_FDF_CRG/20120516_FDF_CRG_c12.mtb	3753	2867	WWFF	food_fat	3	111482	1337274761	1	0.0999999999999996	0.00476190476190474	6325	1
2	Drink 2	Intake 2	38	112632	1337275911	/users/cn/jespinosa/phecomp/data/CRG/20120502_FDF_CRG/20120502_FDF_CRG/20120516_FDF_CRG_c12.mtb	1626	NA	WWFF	water	2	112594	1337275873	1	0.16	0.00421052631578947	6326	1
2	Food 1	Intake 3	15	114385	1337277664	/users/cn/jespinosa/phecomp/data/CRG/20120502_FDF_CRG/20120502_FDF_CRG/20120516_FDF_CRG_c12.mtb	3754	1129	WWFF	food_fat	3	114370	1337277649	1	0.540000000000001	0.0360000000000001	6327	1
2	Drink 1	Intake 1	13	115254	1337278533	/users/cn/jespinosa/phecomp/data/CRG/20120502_FDF_CRG/20120502_FDF_CRG/20120516_FDF_CRG_c12.mtb	1102	NA	WWFF	water	1	115241	1337278520	1	0.02	0.00153846153846154	6328	1
2	Food 2	Intake 4	25	115539	1337278818	/users/cn/jespinosa/phecomp/data/CRG/20120502_FDF_CRG/20120502_FDF_CRG/20120516_FDF_CRG_c12.mtb	5482	946	WWFF	food_fat	4	115514	1337278793	1	0.22	0.0088	6329	1
2	Drink 2	Intake 2	33	115627	1337278906	/users/cn/jespinosa/phecomp/data/CRG/20120502_FDF_CRG/20120502_FDF_CRG/20120516_FDF_CRG_c12.mtb	1627	NA	WWFF	water	2	115594	1337278873	1	0.04	0.00121212121212121	6330	1
2	Drink 2	Intake 2	13	115765	1337279044	/users/cn/jespinosa/phecomp/data/CRG/20120502_FDF_CRG/20120502_FDF_CRG/20120516_FDF_CRG_c12.mtb	1628	NA	WWFF	water	2	115752	1337279031	1	0.02	0.00153846153846154	6331	1
2	Food 1	Intake 3	20	116505	1337279784	/users/cn/jespinosa/phecomp/data/CRG/20120502_FDF_CRG/20120502_FDF_CRG/20120516_FDF_CRG_c12.mtb	3759	10814	WWFF	food_fat	3	116485	1337279764	1	0.0399999999999991	0.00199999999999995	6332	1
2	Drink 1	Intake 1	17	116821	1337280100	/users/cn/jespinosa/phecomp/data/CRG/20120502_FDF_CRG/20120502_FDF_CRG/20120516_FDF_CRG_c12.mtb	1103	NA	WWFF	water	1	116804	1337280083	1	0.06	0.00352941176470588	6333	1
2	Drink 2	Intake 2	22	117494	1337280773	/users/cn/jespinosa/phecomp/data/CRG/20120502_FDF_CRG/20120502_FDF_CRG/20120516_FDF_CRG_c12.mtb	1630	NA	WWFF	water	2	117472	1337280751	1	0.04	0.00181818181818182	6334	1
2	Drink 1	Intake 1	17	119304	1337282583	/users/cn/jespinosa/phecomp/data/CRG/20120502_FDF_CRG/20120502_FDF_CRG/20120516_FDF_CRG_c12.mtb	1104	NA	WWFF	water	1	119287	1337282566	1	0.02	0.00117647058823529	6335	1
2	Drink 2	Intake 2	89	126879	1337290158	/users/cn/jespinosa/phecomp/data/CRG/20120502_FDF_CRG/20120502_FDF_CRG/20120516_FDF_CRG_c12.mtb	1634	NA	WWFF	water	2	126790	1337290069	1	0.0600000000000001	0.000674157303370788	6336	1
2	Food 1	Intake 3	103	127422	1337290701	/users/cn/jespinosa/phecomp/data/CRG/20120502_FDF_CRG/20120502_FDF_CRG/20120516_FDF_CRG_c12.mtb	3769	2849	WWFF	food_fat	3	127319	1337290598	1	0.0600000000000005	0.000582524271844665	6337	1
2	Drink 2	Intake 2	15	129330	1337292609	/users/cn/jespinosa/phecomp/data/CRG/20120502_FDF_CRG/20120502_FDF_CRG/20120516_FDF_CRG_c12.mtb	1637	NA	WWFF	water	2	129315	1337292594	1	0.04	0.00266666666666667	6338	1
2	Drink 2	Intake 2	15	129529	1337292808	/users/cn/jespinosa/phecomp/data/CRG/20120502_FDF_CRG/20120502_FDF_CRG/20120516_FDF_CRG_c12.mtb	1638	NA	WWFF	water	2	129514	1337292793	1	0.0399999999999996	0.00266666666666664	6339	1
2	Food 1	Intake 3	17	130288	1337293567	/users/cn/jespinosa/phecomp/data/CRG/20120502_FDF_CRG/20120502_FDF_CRG/20120516_FDF_CRG_c12.mtb	3772	286	WWFF	food_fat	3	130271	1337293550	1	0.0999999999999996	0.00588235294117645	6340	1
2	Food 2	Intake 4	39	130613	1337293892	/users/cn/jespinosa/phecomp/data/CRG/20120502_FDF_CRG/20120502_FDF_CRG/20120516_FDF_CRG_c12.mtb	5499	22861	WWFF	food_fat	4	130574	1337293853	1	0.02	0.000512820512820513	6341	1
2	Drink 2	Intake 2	15	133257	1337296536	/users/cn/jespinosa/phecomp/data/CRG/20120502_FDF_CRG/20120502_FDF_CRG/20120516_FDF_CRG_c12.mtb	1640	NA	WWFF	water	2	133242	1337296521	1	0.0200000000000005	0.00133333333333337	6342	1
2	Drink 2	Intake 2	14	134729	1337298008	/users/cn/jespinosa/phecomp/data/CRG/20120502_FDF_CRG/20120502_FDF_CRG/20120516_FDF_CRG_c12.mtb	1641	NA	WWFF	water	2	134715	1337297994	1	0.0599999999999996	0.00428571428571426	6343	1
2	Drink 2	Intake 2	15	136450	1337299729	/users/cn/jespinosa/phecomp/data/CRG/20120502_FDF_CRG/20120502_FDF_CRG/20120516_FDF_CRG_c12.mtb	1644	NA	WWFF	water	2	136435	1337299714	1	0.04	0.00266666666666667	6344	1
2	Drink 2	Intake 2	15	136703	1337299982	/users/cn/jespinosa/phecomp/data/CRG/20120502_FDF_CRG/20120502_FDF_CRG/20120516_FDF_CRG_c12.mtb	1645	NA	WWFF	water	2	136688	1337299967	1	0.02	0.00133333333333333	6345	1
2	Drink 2	Intake 2	33	144311	1337307590	/users/cn/jespinosa/phecomp/data/CRG/20120502_FDF_CRG/20120502_FDF_CRG/20120516_FDF_CRG_c12.mtb	1646	NA	WWFF	water	2	144278	1337307557	1	0.1	0.00303030303030303	6346	1
2	Drink 2	Intake 2	25	145310	1337308589	/users/cn/jespinosa/phecomp/data/CRG/20120502_FDF_CRG/20120502_FDF_CRG/20120516_FDF_CRG_c12.mtb	1648	NA	WWFF	water	2	145285	1337308564	1	0.1	0.004	6347	1
2	Drink 2	Intake 2	20	151251	1337314530	/users/cn/jespinosa/phecomp/data/CRG/20120502_FDF_CRG/20120502_FDF_CRG/20120516_FDF_CRG_c12.mtb	1649	NA	WWFF	water	2	151231	1337314510	1	0.0600000000000001	0.00300000000000001	6348	1
2	Drink 1	Intake 1	15	151625	1337314904	/users/cn/jespinosa/phecomp/data/CRG/20120502_FDF_CRG/20120502_FDF_CRG/20120516_FDF_CRG_c12.mtb	1114	NA	WWFF	water	1	151610	1337314889	1	0.02	0.00133333333333333	6349	1
2	Drink 1	Intake 1	19	151905	1337315184	/users/cn/jespinosa/phecomp/data/CRG/20120502_FDF_CRG/20120502_FDF_CRG/20120516_FDF_CRG_c12.mtb	1115	NA	WWFF	water	1	151886	1337315165	1	0.06	0.00315789473684211	6350	1
2	Drink 2	Intake 2	12	151993	1337315272	/users/cn/jespinosa/phecomp/data/CRG/20120502_FDF_CRG/20120502_FDF_CRG/20120516_FDF_CRG_c12.mtb	1650	NA	WWFF	water	2	151981	1337315260	1	0.04	0.00333333333333333	6351	1
2	Food 2	Intake 4	174	153648	1337316927	/users/cn/jespinosa/phecomp/data/CRG/20120502_FDF_CRG/20120502_FDF_CRG/20120516_FDF_CRG_c12.mtb	5513	323	WWFF	food_fat	4	153474	1337316753	1	0.02	0.000114942528735632	6352	1
2	Food 2	Intake 4	80	154051	1337317330	/users/cn/jespinosa/phecomp/data/CRG/20120502_FDF_CRG/20120502_FDF_CRG/20120516_FDF_CRG_c12.mtb	5514	897	WWFF	food_fat	4	153971	1337317250	1	0.02	0.00025	6353	1
2	Drink 2	Intake 2	12	154399	1337317678	/users/cn/jespinosa/phecomp/data/CRG/20120502_FDF_CRG/20120502_FDF_CRG/20120516_FDF_CRG_c12.mtb	1651	NA	WWFF	water	2	154387	1337317666	1	0.04	0.00333333333333333	6354	1
2	Food 2	Intake 4	116	155064	1337318343	/users/cn/jespinosa/phecomp/data/CRG/20120502_FDF_CRG/20120502_FDF_CRG/20120516_FDF_CRG_c12.mtb	5518	72	WWFF	food_fat	4	154948	1337318227	1	0.04	0.000344827586206897	6355	1
2	Food 2	Intake 4	75	155211	1337318490	/users/cn/jespinosa/phecomp/data/CRG/20120502_FDF_CRG/20120502_FDF_CRG/20120516_FDF_CRG_c12.mtb	5519	542	WWFF	food_fat	4	155136	1337318415	1	0.02	0.000266666666666667	6356	1
2	Drink 2	Intake 2	14	155286	1337318565	/users/cn/jespinosa/phecomp/data/CRG/20120502_FDF_CRG/20120502_FDF_CRG/20120516_FDF_CRG_c12.mtb	1652	NA	WWFF	water	2	155272	1337318551	1	0.04	0.00285714285714286	6357	1
2	Food 2	Intake 4	95	155848	1337319127	/users/cn/jespinosa/phecomp/data/CRG/20120502_FDF_CRG/20120502_FDF_CRG/20120516_FDF_CRG_c12.mtb	5521	31501	WWFF	food_fat	4	155753	1337319032	1	0.02	0.000210526315789474	6358	1
2	Drink 2	Intake 2	25	157129	1337320408	/users/cn/jespinosa/phecomp/data/CRG/20120502_FDF_CRG/20120502_FDF_CRG/20120516_FDF_CRG_c12.mtb	1655	NA	WWFF	water	2	157104	1337320383	1	0.1	0.004	6359	1
2	Drink 2	Intake 2	25	6400	1337338915	/users/cn/jespinosa/phecomp/data/CRG/20120502_FDF_CRG/20120502_FDF_CRG/20120518_FDF_CRG_c12.mtb	1659	NA	WWFF	water	2	6375	1337338890	1	0.08	0.0032	6360	1
2	Drink 2	Intake 2	23	12989	1337345504	/users/cn/jespinosa/phecomp/data/CRG/20120502_FDF_CRG/20120502_FDF_CRG/20120518_FDF_CRG_c12.mtb	1660	NA	WWFF	water	2	12966	1337345481	1	0.12	0.00521739130434783	6361	1
2	Drink 2	Intake 2	22	18098	1337350613	/users/cn/jespinosa/phecomp/data/CRG/20120502_FDF_CRG/20120502_FDF_CRG/20120518_FDF_CRG_c12.mtb	1661	NA	WWFF	water	2	18076	1337350591	1	0.06	0.00272727272727273	6362	1
2	Food 1	Intake 3	91	18204	1337350719	/users/cn/jespinosa/phecomp/data/CRG/20120502_FDF_CRG/20120502_FDF_CRG/20120518_FDF_CRG_c12.mtb	3795	COLL	WWFF	food_fat	3	18113	1337350628	1	0.5	0.00549450549450549	6363	1
2	Food 2	Intake 4	65	18261	1337350776	/users/cn/jespinosa/phecomp/data/CRG/20120502_FDF_CRG/20120502_FDF_CRG/20120518_FDF_CRG_c12.mtb	5522	18	WWFF	food_fat	4	18196	1337350711	1	0.32	0.00492307692307692	6364	1
2	Food 1	Intake 3	31	18310	1337350825	/users/cn/jespinosa/phecomp/data/CRG/20120502_FDF_CRG/20120502_FDF_CRG/20120518_FDF_CRG_c12.mtb	3796	21	WWFF	food_fat	3	18279	1337350794	1	0.34	0.0109677419354839	6365	1
2	Drink 2	Intake 2	21	18328	1337350843	/users/cn/jespinosa/phecomp/data/CRG/20120502_FDF_CRG/20120502_FDF_CRG/20120518_FDF_CRG_c12.mtb	1662	NA	WWFF	water	2	18307	1337350822	1	0.04	0.0019047619047619	6366	1
2	Food 2	Intake 4	84	18415	1337350930	/users/cn/jespinosa/phecomp/data/CRG/20120502_FDF_CRG/20120502_FDF_CRG/20120518_FDF_CRG_c12.mtb	5523	394	WWFF	food_fat	4	18331	1337350846	1	0.2	0.00238095238095238	6367	1
2	Drink 1	Intake 1	18	18589	1337351104	/users/cn/jespinosa/phecomp/data/CRG/20120502_FDF_CRG/20120502_FDF_CRG/20120518_FDF_CRG_c12.mtb	1118	NA	WWFF	water	1	18571	1337351086	1	0.06	0.00333333333333333	6368	1
2	Food 1	Intake 3	14	18823	1337351338	/users/cn/jespinosa/phecomp/data/CRG/20120502_FDF_CRG/20120502_FDF_CRG/20120518_FDF_CRG_c12.mtb	3798	16	WWFF	food_fat	3	18809	1337351324	1	0.02	0.00142857142857143	6369	1
2	Food 2	Intake 4	50	18889	1337351404	/users/cn/jespinosa/phecomp/data/CRG/20120502_FDF_CRG/20120502_FDF_CRG/20120518_FDF_CRG_c12.mtb	5524	11	WWFF	food_fat	4	18839	1337351354	1	0.46	0.0092	6370	1
2	Food 2	Intake 4	50	18950	1337351465	/users/cn/jespinosa/phecomp/data/CRG/20120502_FDF_CRG/20120502_FDF_CRG/20120518_FDF_CRG_c12.mtb	5525	COLL	WWFF	food_fat	4	18900	1337351415	1	0.4	0.008	6371	1
2	Food 1	Intake 3	29	18968	1337351483	/users/cn/jespinosa/phecomp/data/CRG/20120502_FDF_CRG/20120502_FDF_CRG/20120518_FDF_CRG_c12.mtb	3800	31	WWFF	food_fat	3	18939	1337351454	1	0.0600000000000001	0.00206896551724138	6372	1
2	Drink 2	Intake 2	18	18999	1337351514	/users/cn/jespinosa/phecomp/data/CRG/20120502_FDF_CRG/20120502_FDF_CRG/20120518_FDF_CRG_c12.mtb	1663	NA	WWFF	water	2	18981	1337351496	1	0.04	0.00222222222222222	6373	1
2	Food 2	Intake 4	94	19093	1337351608	/users/cn/jespinosa/phecomp/data/CRG/20120502_FDF_CRG/20120502_FDF_CRG/20120518_FDF_CRG_c12.mtb	5526	COLL	WWFF	food_fat	4	18999	1337351514	1	1.3	0.0138297872340426	6374	1
2	Food 1	Intake 3	129	19218	1337351733	/users/cn/jespinosa/phecomp/data/CRG/20120502_FDF_CRG/20120502_FDF_CRG/20120518_FDF_CRG_c12.mtb	3801	14	WWFF	food_fat	3	19089	1337351604	1	1.12	0.00868217054263566	6375	1
2	Food 1	Intake 3	68	19300	1337351815	/users/cn/jespinosa/phecomp/data/CRG/20120502_FDF_CRG/20120502_FDF_CRG/20120518_FDF_CRG_c12.mtb	3802	8142	WWFF	food_fat	3	19232	1337351747	1	0.66	0.00970588235294118	6376	1
2	Food 1	Intake 3	34	27476	1337359991	/users/cn/jespinosa/phecomp/data/CRG/20120502_FDF_CRG/20120502_FDF_CRG/20120518_FDF_CRG_c12.mtb	3803	4	WWFF	food_fat	3	27442	1337359957	1	0.0999999999999996	0.00294117647058822	6377	1
2	Food 1	Intake 3	15	27495	1337360010	/users/cn/jespinosa/phecomp/data/CRG/20120502_FDF_CRG/20120502_FDF_CRG/20120518_FDF_CRG_c12.mtb	3804	6513	WWFF	food_fat	3	27480	1337359995	1	0.0600000000000001	0.00400000000000001	6378	1
2	Drink 2	Intake 2	22	29338	1337361853	/users/cn/jespinosa/phecomp/data/CRG/20120502_FDF_CRG/20120502_FDF_CRG/20120518_FDF_CRG_c12.mtb	1664	NA	WWFF	water	2	29316	1337361831	1	0.08	0.00363636363636364	6379	1
2	Drink 2	Intake 2	21	32425	1337364940	/users/cn/jespinosa/phecomp/data/CRG/20120502_FDF_CRG/20120502_FDF_CRG/20120518_FDF_CRG_c12.mtb	1665	NA	WWFF	water	2	32404	1337364919	1	0.06	0.00285714285714286	6380	1
2	Drink 2	Intake 2	15	34006	1337366521	/users/cn/jespinosa/phecomp/data/CRG/20120502_FDF_CRG/20120502_FDF_CRG/20120518_FDF_CRG_c12.mtb	1666	NA	WWFF	water	2	33991	1337366506	1	0.04	0.00266666666666667	6381	1
2	Food 1	Intake 3	21	34029	1337366544	/users/cn/jespinosa/phecomp/data/CRG/20120502_FDF_CRG/20120502_FDF_CRG/20120518_FDF_CRG_c12.mtb	3806	30	WWFF	food_fat	3	34008	1337366523	1	0.0600000000000001	0.00285714285714286	6382	1
2	Food 1	Intake 3	49	34108	1337366623	/users/cn/jespinosa/phecomp/data/CRG/20120502_FDF_CRG/20120502_FDF_CRG/20120518_FDF_CRG_c12.mtb	3807	358	WWFF	food_fat	3	34059	1337366574	1	0.48	0.00979591836734694	6383	1
2	Drink 2	Intake 2	26	34450	1337366965	/users/cn/jespinosa/phecomp/data/CRG/20120502_FDF_CRG/20120502_FDF_CRG/20120518_FDF_CRG_c12.mtb	1667	NA	WWFF	water	2	34424	1337366939	1	0.08	0.00307692307692308	6384	1
2	Food 2	Intake 4	35	34501	1337367016	/users/cn/jespinosa/phecomp/data/CRG/20120502_FDF_CRG/20120502_FDF_CRG/20120518_FDF_CRG_c12.mtb	5531	541	WWFF	food_fat	4	34466	1337366981	1	0.02	0.000571428571428571	6385	1
2	Food 1	Intake 3	68	35110	1337367625	/users/cn/jespinosa/phecomp/data/CRG/20120502_FDF_CRG/20120502_FDF_CRG/20120518_FDF_CRG_c12.mtb	3810	2918	WWFF	food_fat	3	35042	1337367557	1	0.3	0.00441176470588235	6386	1
2	Drink 2	Intake 2	34	36038	1337368553	/users/cn/jespinosa/phecomp/data/CRG/20120502_FDF_CRG/20120502_FDF_CRG/20120518_FDF_CRG_c12.mtb	1670	NA	WWFF	water	2	36004	1337368519	1	0.0600000000000001	0.00176470588235294	6387	1
2	Drink 2	Intake 2	23	37085	1337369600	/users/cn/jespinosa/phecomp/data/CRG/20120502_FDF_CRG/20120502_FDF_CRG/20120518_FDF_CRG_c12.mtb	1671	NA	WWFF	water	2	37062	1337369577	1	0.08	0.00347826086956522	6388	1
2	Food 1	Intake 3	20	38048	1337370563	/users/cn/jespinosa/phecomp/data/CRG/20120502_FDF_CRG/20120502_FDF_CRG/20120518_FDF_CRG_c12.mtb	3812	7534	WWFF	food_fat	3	38028	1337370543	1	0.0599999999999996	0.00299999999999998	6389	1
2	Drink 2	Intake 2	16	39380	1337371895	/users/cn/jespinosa/phecomp/data/CRG/20120502_FDF_CRG/20120502_FDF_CRG/20120518_FDF_CRG_c12.mtb	1675	NA	WWFF	water	2	39364	1337371879	1	0.04	0.0025	6390	1
2	Drink 1	Intake 1	17	41886	1337374401	/users/cn/jespinosa/phecomp/data/CRG/20120502_FDF_CRG/20120502_FDF_CRG/20120518_FDF_CRG_c12.mtb	1121	NA	WWFF	water	1	41869	1337374384	1	0.02	0.00117647058823529	6391	1
2	Drink 2	Intake 2	19	41906	1337374421	/users/cn/jespinosa/phecomp/data/CRG/20120502_FDF_CRG/20120502_FDF_CRG/20120518_FDF_CRG_c12.mtb	1676	NA	WWFF	water	2	41887	1337374402	1	0.02	0.00105263157894737	6392	1
2	Food 1	Intake 3	31	45613	1337378128	/users/cn/jespinosa/phecomp/data/CRG/20120502_FDF_CRG/20120502_FDF_CRG/20120518_FDF_CRG_c12.mtb	3813	6	WWFF	food_fat	3	45582	1337378097	1	0.0800000000000001	0.00258064516129033	6393	1
2	Food 1	Intake 3	14	45633	1337378148	/users/cn/jespinosa/phecomp/data/CRG/20120502_FDF_CRG/20120502_FDF_CRG/20120518_FDF_CRG_c12.mtb	3814	4	WWFF	food_fat	3	45619	1337378134	1	0.0800000000000001	0.00571428571428572	6394	1
2	Food 1	Intake 3	14	45651	1337378166	/users/cn/jespinosa/phecomp/data/CRG/20120502_FDF_CRG/20120502_FDF_CRG/20120518_FDF_CRG_c12.mtb	3815	359	WWFF	food_fat	3	45637	1337378152	1	0.04	0.00285714285714286	6395	1
2	Food 1	Intake 3	17	46027	1337378542	/users/cn/jespinosa/phecomp/data/CRG/20120502_FDF_CRG/20120502_FDF_CRG/20120518_FDF_CRG_c12.mtb	3816	3669	WWFF	food_fat	3	46010	1337378525	1	0.02	0.00117647058823529	6396	1
2	Drink 2	Intake 2	21	46507	1337379022	/users/cn/jespinosa/phecomp/data/CRG/20120502_FDF_CRG/20120502_FDF_CRG/20120518_FDF_CRG_c12.mtb	1677	NA	WWFF	water	2	46486	1337379001	1	0.1	0.00476190476190476	6397	1
2	Drink 2	Intake 2	14	48218	1337380733	/users/cn/jespinosa/phecomp/data/CRG/20120502_FDF_CRG/20120502_FDF_CRG/20120518_FDF_CRG_c12.mtb	1678	NA	WWFF	water	2	48204	1337380719	1	0.0599999999999999	0.00428571428571428	6398	1
2	Drink 2	Intake 2	14	49669	1337382184	/users/cn/jespinosa/phecomp/data/CRG/20120502_FDF_CRG/20120502_FDF_CRG/20120518_FDF_CRG_c12.mtb	1679	NA	WWFF	water	2	49655	1337382170	1	0.02	0.00142857142857143	6399	1
2	Food 1	Intake 3	54	49750	1337382265	/users/cn/jespinosa/phecomp/data/CRG/20120502_FDF_CRG/20120502_FDF_CRG/20120518_FDF_CRG_c12.mtb	3817	697	WWFF	food_fat	3	49696	1337382211	1	0.14	0.00259259259259259	6400	1
2	Drink 2	Intake 2	16	50172	1337382687	/users/cn/jespinosa/phecomp/data/CRG/20120502_FDF_CRG/20120502_FDF_CRG/20120518_FDF_CRG_c12.mtb	1681	NA	WWFF	water	2	50156	1337382671	1	0.02	0.00125	6401	1
2	Food 1	Intake 3	33	50480	1337382995	/users/cn/jespinosa/phecomp/data/CRG/20120502_FDF_CRG/20120502_FDF_CRG/20120518_FDF_CRG_c12.mtb	3819	5702	WWFF	food_fat	3	50447	1337382962	1	0.04	0.00121212121212121	6402	1
2	Drink 2	Intake 2	23	50726	1337383241	/users/cn/jespinosa/phecomp/data/CRG/20120502_FDF_CRG/20120502_FDF_CRG/20120518_FDF_CRG_c12.mtb	1683	NA	WWFF	water	2	50703	1337383218	1	0.0600000000000001	0.00260869565217392	6403	1
2	Drink 2	Intake 2	11	51177	1337383692	/users/cn/jespinosa/phecomp/data/CRG/20120502_FDF_CRG/20120502_FDF_CRG/20120518_FDF_CRG_c12.mtb	1684	NA	WWFF	water	2	51166	1337383681	1	0.04	0.00363636363636364	6404	1
2	Drink 2	Intake 2	21	52153	1337384668	/users/cn/jespinosa/phecomp/data/CRG/20120502_FDF_CRG/20120502_FDF_CRG/20120518_FDF_CRG_c12.mtb	1686	NA	WWFF	water	2	52132	1337384647	1	0.04	0.0019047619047619	6405	1
2	Food 1	Intake 3	12	56194	1337388709	/users/cn/jespinosa/phecomp/data/CRG/20120502_FDF_CRG/20120502_FDF_CRG/20120518_FDF_CRG_c12.mtb	3823	1773	WWFF	food_fat	3	56182	1337388697	1	0.04	0.00333333333333333	6406	1
2	Food 1	Intake 3	22	57989	1337390504	/users/cn/jespinosa/phecomp/data/CRG/20120502_FDF_CRG/20120502_FDF_CRG/20120518_FDF_CRG_c12.mtb	3824	3724	WWFF	food_fat	3	57967	1337390482	1	0.04	0.00181818181818182	6407	1
2	Drink 2	Intake 2	14	58021	1337390536	/users/cn/jespinosa/phecomp/data/CRG/20120502_FDF_CRG/20120502_FDF_CRG/20120518_FDF_CRG_c12.mtb	1688	NA	WWFF	water	2	58007	1337390522	1	0.0399999999999998	0.00285714285714284	6408	1
2	Drink 2	Intake 2	19	58883	1337391398	/users/cn/jespinosa/phecomp/data/CRG/20120502_FDF_CRG/20120502_FDF_CRG/20120518_FDF_CRG_c12.mtb	1689	NA	WWFF	water	2	58864	1337391379	1	0.0800000000000001	0.00421052631578948	6409	1
2	Food 1	Intake 3	15	61728	1337394243	/users/cn/jespinosa/phecomp/data/CRG/20120502_FDF_CRG/20120502_FDF_CRG/20120518_FDF_CRG_c12.mtb	3827	11	WWFF	food_fat	3	61713	1337394228	1	0.0600000000000005	0.00400000000000003	6410	1
2	Food 1	Intake 3	23	61762	1337394277	/users/cn/jespinosa/phecomp/data/CRG/20120502_FDF_CRG/20120502_FDF_CRG/20120518_FDF_CRG_c12.mtb	3828	9	WWFF	food_fat	3	61739	1337394254	1	0.0599999999999996	0.0026086956521739	6411	1
2	Food 1	Intake 3	14	61785	1337394300	/users/cn/jespinosa/phecomp/data/CRG/20120502_FDF_CRG/20120502_FDF_CRG/20120518_FDF_CRG_c12.mtb	3829	6553	WWFF	food_fat	3	61771	1337394286	1	0.04	0.00285714285714286	6412	1
2	Drink 2	Intake 2	13	64158	1337396673	/users/cn/jespinosa/phecomp/data/CRG/20120502_FDF_CRG/20120502_FDF_CRG/20120518_FDF_CRG_c12.mtb	1690	NA	WWFF	water	2	64145	1337396660	1	0.0800000000000001	0.00615384615384616	6413	1
2	Food 1	Intake 3	17	68355	1337400870	/users/cn/jespinosa/phecomp/data/CRG/20120502_FDF_CRG/20120502_FDF_CRG/20120518_FDF_CRG_c12.mtb	3830	1353	WWFF	food_fat	3	68338	1337400853	1	0.0200000000000005	0.00117647058823532	6414	1
2	Drink 2	Intake 2	14	68907	1337401422	/users/cn/jespinosa/phecomp/data/CRG/20120502_FDF_CRG/20120502_FDF_CRG/20120518_FDF_CRG_c12.mtb	1692	NA	WWFF	water	2	68893	1337401408	1	0.04	0.00285714285714286	6415	1
2	Drink 2	Intake 2	19	69541	1337402056	/users/cn/jespinosa/phecomp/data/CRG/20120502_FDF_CRG/20120502_FDF_CRG/20120518_FDF_CRG_c12.mtb	1693	NA	WWFF	water	2	69522	1337402037	1	0.04	0.00210526315789474	6416	1
2	Drink 2	Intake 2	21	69666	1337402181	/users/cn/jespinosa/phecomp/data/CRG/20120502_FDF_CRG/20120502_FDF_CRG/20120518_FDF_CRG_c12.mtb	1694	NA	WWFF	water	2	69645	1337402160	1	0.0600000000000001	0.00285714285714286	6417	1
2	Food 2	Intake 4	33	69741	1337402256	/users/cn/jespinosa/phecomp/data/CRG/20120502_FDF_CRG/20120502_FDF_CRG/20120518_FDF_CRG_c12.mtb	5550	720	WWFF	food_fat	4	69708	1337402223	1	0.0800000000000001	0.00242424242424243	6418	1
2	Drink 2	Intake 2	14	70252	1337402767	/users/cn/jespinosa/phecomp/data/CRG/20120502_FDF_CRG/20120502_FDF_CRG/20120518_FDF_CRG_c12.mtb	1695	NA	WWFF	water	2	70238	1337402753	1	0.02	0.00142857142857143	6419	1
2	Drink 2	Intake 2	36	70467	1337402982	/users/cn/jespinosa/phecomp/data/CRG/20120502_FDF_CRG/20120502_FDF_CRG/20120518_FDF_CRG_c12.mtb	1696	NA	WWFF	water	2	70431	1337402946	1	0.02	0.000555555555555556	6420	1
2	Food 2	Intake 4	24	70485	1337403000	/users/cn/jespinosa/phecomp/data/CRG/20120502_FDF_CRG/20120502_FDF_CRG/20120518_FDF_CRG_c12.mtb	5554	2510	WWFF	food_fat	4	70461	1337402976	1	0.0599999999999996	0.00249999999999998	6421	1
2	Drink 2	Intake 2	20	71226	1337403741	/users/cn/jespinosa/phecomp/data/CRG/20120502_FDF_CRG/20120502_FDF_CRG/20120518_FDF_CRG_c12.mtb	1697	NA	WWFF	water	2	71206	1337403721	1	0.0600000000000001	0.00300000000000001	6422	1
2	Drink 2	Intake 2	20	71798	1337404313	/users/cn/jespinosa/phecomp/data/CRG/20120502_FDF_CRG/20120502_FDF_CRG/20120518_FDF_CRG_c12.mtb	1698	NA	WWFF	water	2	71778	1337404293	1	0.04	0.002	6423	1
2	Food 2	Intake 4	31	73026	1337405541	/users/cn/jespinosa/phecomp/data/CRG/20120502_FDF_CRG/20120502_FDF_CRG/20120518_FDF_CRG_c12.mtb	5557	COLL	WWFF	food_fat	4	72995	1337405510	1	0.04	0.00129032258064516	6424	1
2	Food 1	Intake 3	33	73052	1337405567	/users/cn/jespinosa/phecomp/data/CRG/20120502_FDF_CRG/20120502_FDF_CRG/20120518_FDF_CRG_c12.mtb	3837	112	WWFF	food_fat	3	73019	1337405534	1	0.0599999999999996	0.00181818181818181	6425	1
2	Food 1	Intake 3	17	73181	1337405696	/users/cn/jespinosa/phecomp/data/CRG/20120502_FDF_CRG/20120502_FDF_CRG/20120518_FDF_CRG_c12.mtb	3838	8412	WWFF	food_fat	3	73164	1337405679	1	0.04	0.00235294117647059	6426	1
2	Drink 2	Intake 2	26	73900	1337406415	/users/cn/jespinosa/phecomp/data/CRG/20120502_FDF_CRG/20120502_FDF_CRG/20120518_FDF_CRG_c12.mtb	1699	NA	WWFF	water	2	73874	1337406389	1	0.0599999999999998	0.0023076923076923	6427	1
2	Food 1	Intake 3	15	81608	1337414123	/users/cn/jespinosa/phecomp/data/CRG/20120502_FDF_CRG/20120502_FDF_CRG/20120518_FDF_CRG_c12.mtb	3839	58	WWFF	food_fat	3	81593	1337414108	1	0.0200000000000005	0.00133333333333337	6428	1
2	Food 1	Intake 3	15	81681	1337414196	/users/cn/jespinosa/phecomp/data/CRG/20120502_FDF_CRG/20120502_FDF_CRG/20120518_FDF_CRG_c12.mtb	3841	2045	WWFF	food_fat	3	81666	1337414181	1	0.04	0.00266666666666667	6429	1
2	Food 1	Intake 3	17	83743	1337416258	/users/cn/jespinosa/phecomp/data/CRG/20120502_FDF_CRG/20120502_FDF_CRG/20120518_FDF_CRG_c12.mtb	3842	5203	WWFF	food_fat	3	83726	1337416241	1	0.04	0.00235294117647059	6430	1
2	Drink 2	Intake 2	28	86673	1337419188	/users/cn/jespinosa/phecomp/data/CRG/20120502_FDF_CRG/20120502_FDF_CRG/20120518_FDF_CRG_c12.mtb	1700	NA	WWFF	water	2	86645	1337419160	1	0.12	0.00428571428571429	6431	1
2	Food 1	Intake 3	14	88960	1337421475	/users/cn/jespinosa/phecomp/data/CRG/20120502_FDF_CRG/20120502_FDF_CRG/20120518_FDF_CRG_c12.mtb	3845	4439	WWFF	food_fat	3	88946	1337421461	1	0.0800000000000001	0.00571428571428572	6432	1
2	Food 1	Intake 3	34	93433	1337425948	/users/cn/jespinosa/phecomp/data/CRG/20120502_FDF_CRG/20120502_FDF_CRG/20120518_FDF_CRG_c12.mtb	3846	1550	WWFF	food_fat	3	93399	1337425914	1	0.04	0.00117647058823529	6433	1
2	Food 1	Intake 3	38	95021	1337427536	/users/cn/jespinosa/phecomp/data/CRG/20120502_FDF_CRG/20120502_FDF_CRG/20120518_FDF_CRG_c12.mtb	3848	29	WWFF	food_fat	3	94983	1337427498	1	0.0800000000000001	0.00210526315789474	6434	1
2	Food 1	Intake 3	16	95066	1337427581	/users/cn/jespinosa/phecomp/data/CRG/20120502_FDF_CRG/20120502_FDF_CRG/20120518_FDF_CRG_c12.mtb	3849	4024	WWFF	food_fat	3	95050	1337427565	1	0.0200000000000005	0.00125000000000003	6435	1
2	Drink 1	Intake 1	23	95139	1337427654	/users/cn/jespinosa/phecomp/data/CRG/20120502_FDF_CRG/20120502_FDF_CRG/20120518_FDF_CRG_c12.mtb	1126	NA	WWFF	water	1	95116	1337427631	1	0.1	0.00434782608695652	6436	1
2	Drink 1	Intake 1	18	96311	1337428826	/users/cn/jespinosa/phecomp/data/CRG/20120502_FDF_CRG/20120502_FDF_CRG/20120518_FDF_CRG_c12.mtb	1127	NA	WWFF	water	1	96293	1337428808	1	0.06	0.00333333333333333	6437	1
2	Food 1	Intake 3	20	99110	1337431625	/users/cn/jespinosa/phecomp/data/CRG/20120502_FDF_CRG/20120502_FDF_CRG/20120518_FDF_CRG_c12.mtb	3851	3326	WWFF	food_fat	3	99090	1337431605	1	0.0600000000000005	0.00300000000000002	6438	1
2	Food 1	Intake 3	27	102463	1337434978	/users/cn/jespinosa/phecomp/data/CRG/20120502_FDF_CRG/20120502_FDF_CRG/20120518_FDF_CRG_c12.mtb	3853	1675	WWFF	food_fat	3	102436	1337434951	1	0.0800000000000001	0.00296296296296297	6439	1
2	Drink 2	Intake 2	19	103515	1337436030	/users/cn/jespinosa/phecomp/data/CRG/20120502_FDF_CRG/20120502_FDF_CRG/20120518_FDF_CRG_c12.mtb	1701	NA	WWFF	water	2	103496	1337436011	1	0.0600000000000001	0.00315789473684211	6440	1
2	Drink 2	Intake 2	16	103774	1337436289	/users/cn/jespinosa/phecomp/data/CRG/20120502_FDF_CRG/20120502_FDF_CRG/20120518_FDF_CRG_c12.mtb	1702	NA	WWFF	water	2	103758	1337436273	1	0.02	0.00125	6441	1
2	Drink 2	Intake 2	13	103893	1337436408	/users/cn/jespinosa/phecomp/data/CRG/20120502_FDF_CRG/20120502_FDF_CRG/20120518_FDF_CRG_c12.mtb	1703	NA	WWFF	water	2	103880	1337436395	1	0.04	0.00307692307692308	6442	1
2	Drink 2	Intake 2	20	104131	1337436646	/users/cn/jespinosa/phecomp/data/CRG/20120502_FDF_CRG/20120502_FDF_CRG/20120518_FDF_CRG_c12.mtb	1704	NA	WWFF	water	2	104111	1337436626	1	0.04	0.002	6443	1
2	Food 2	Intake 4	34	104172	1337436687	/users/cn/jespinosa/phecomp/data/CRG/20120502_FDF_CRG/20120502_FDF_CRG/20120518_FDF_CRG_c12.mtb	5561	6754	WWFF	food_fat	4	104138	1337436653	1	0.04	0.00117647058823529	6444	1
2	Food 1	Intake 3	39	110965	1337443480	/users/cn/jespinosa/phecomp/data/CRG/20120502_FDF_CRG/20120502_FDF_CRG/20120518_FDF_CRG_c12.mtb	3855	2154	WWFF	food_fat	3	110926	1337443441	1	0.0800000000000001	0.00205128205128205	6445	1
2	Food 1	Intake 3	15	113134	1337445649	/users/cn/jespinosa/phecomp/data/CRG/20120502_FDF_CRG/20120502_FDF_CRG/20120518_FDF_CRG_c12.mtb	3856	1151	WWFF	food_fat	3	113119	1337445634	1	0.0599999999999996	0.00399999999999997	6446	1
2	Drink 2	Intake 2	22	114292	1337446807	/users/cn/jespinosa/phecomp/data/CRG/20120502_FDF_CRG/20120502_FDF_CRG/20120518_FDF_CRG_c12.mtb	1705	NA	WWFF	water	2	114270	1337446785	1	0.0800000000000001	0.00363636363636364	6447	1
2	Food 1	Intake 3	15	114300	1337446815	/users/cn/jespinosa/phecomp/data/CRG/20120502_FDF_CRG/20120502_FDF_CRG/20120518_FDF_CRG_c12.mtb	3857	2161	WWFF	food_fat	3	114285	1337446800	1	0.04	0.00266666666666667	6448	1
2	Food 1	Intake 3	17	116478	1337448993	/users/cn/jespinosa/phecomp/data/CRG/20120502_FDF_CRG/20120502_FDF_CRG/20120518_FDF_CRG_c12.mtb	3858	1474	WWFF	food_fat	3	116461	1337448976	1	0.0200000000000005	0.00117647058823532	6449	1
2	Food 2	Intake 4	26	117978	1337450493	/users/cn/jespinosa/phecomp/data/CRG/20120502_FDF_CRG/20120502_FDF_CRG/20120518_FDF_CRG_c12.mtb	5562	COLL	WWFF	food_fat	4	117952	1337450467	1	0.02	0.000769230769230769	6450	1
2	Food 1	Intake 3	21	117997	1337450512	/users/cn/jespinosa/phecomp/data/CRG/20120502_FDF_CRG/20120502_FDF_CRG/20120518_FDF_CRG_c12.mtb	3859	11	WWFF	food_fat	3	117976	1337450491	1	0.0599999999999996	0.00285714285714284	6451	1
2	Food 1	Intake 3	18	118026	1337450541	/users/cn/jespinosa/phecomp/data/CRG/20120502_FDF_CRG/20120502_FDF_CRG/20120518_FDF_CRG_c12.mtb	3860	5064	WWFF	food_fat	3	118008	1337450523	1	0.0200000000000005	0.00111111111111114	6452	1
2	Drink 2	Intake 2	21	120124	1337452639	/users/cn/jespinosa/phecomp/data/CRG/20120502_FDF_CRG/20120502_FDF_CRG/20120518_FDF_CRG_c12.mtb	1706	NA	WWFF	water	2	120103	1337452618	1	0.02	0.000952380952380952	6453	1
2	Drink 1	Intake 1	15	120207	1337452722	/users/cn/jespinosa/phecomp/data/CRG/20120502_FDF_CRG/20120502_FDF_CRG/20120518_FDF_CRG_c12.mtb	1129	NA	WWFF	water	1	120192	1337452707	1	0.04	0.00266666666666667	6454	1
2	Drink 1	Intake 1	12	120301	1337452816	/users/cn/jespinosa/phecomp/data/CRG/20120502_FDF_CRG/20120502_FDF_CRG/20120518_FDF_CRG_c12.mtb	1130	NA	WWFF	water	1	120289	1337452804	1	0.04	0.00333333333333333	6455	1
2	Drink 2	Intake 2	20	121552	1337454067	/users/cn/jespinosa/phecomp/data/CRG/20120502_FDF_CRG/20120502_FDF_CRG/20120518_FDF_CRG_c12.mtb	1708	NA	WWFF	water	2	121532	1337454047	1	0.0600000000000001	0.00300000000000001	6456	1
2	Drink 2	Intake 2	13	122594	1337455109	/users/cn/jespinosa/phecomp/data/CRG/20120502_FDF_CRG/20120502_FDF_CRG/20120518_FDF_CRG_c12.mtb	1709	NA	WWFF	water	2	122581	1337455096	1	0.02	0.00153846153846154	6457	1
2	Food 2	Intake 4	42	123132	1337455647	/users/cn/jespinosa/phecomp/data/CRG/20120502_FDF_CRG/20120502_FDF_CRG/20120518_FDF_CRG_c12.mtb	5570	3334	WWFF	food_fat	4	123090	1337455605	1	0.22	0.00523809523809524	6458	1
2	Drink 2	Intake 2	14	123758	1337456273	/users/cn/jespinosa/phecomp/data/CRG/20120502_FDF_CRG/20120502_FDF_CRG/20120518_FDF_CRG_c12.mtb	1711	NA	WWFF	water	2	123744	1337456259	1	0.0600000000000001	0.00428571428571429	6459	1
2	Food 2	Intake 4	54	126520	1337459035	/users/cn/jespinosa/phecomp/data/CRG/20120502_FDF_CRG/20120502_FDF_CRG/20120518_FDF_CRG_c12.mtb	5571	6019	WWFF	food_fat	4	126466	1337458981	1	0.02	0.00037037037037037	6460	1
2	Drink 2	Intake 2	12	131558	1337464073	/users/cn/jespinosa/phecomp/data/CRG/20120502_FDF_CRG/20120502_FDF_CRG/20120518_FDF_CRG_c12.mtb	1714	NA	WWFF	water	2	131546	1337464061	1	0.0399999999999996	0.0033333333333333	6461	1
2	Food 2	Intake 4	23	132562	1337465077	/users/cn/jespinosa/phecomp/data/CRG/20120502_FDF_CRG/20120502_FDF_CRG/20120518_FDF_CRG_c12.mtb	5573	3206	WWFF	food_fat	4	132539	1337465054	1	0.02	0.000869565217391304	6462	1
2	Drink 1	Intake 1	18	132672	1337465187	/users/cn/jespinosa/phecomp/data/CRG/20120502_FDF_CRG/20120502_FDF_CRG/20120518_FDF_CRG_c12.mtb	1134	NA	WWFF	water	1	132654	1337465169	1	0.02	0.00111111111111111	6463	1
2	Drink 2	Intake 2	12	133516	1337466031	/users/cn/jespinosa/phecomp/data/CRG/20120502_FDF_CRG/20120502_FDF_CRG/20120518_FDF_CRG_c12.mtb	1717	NA	WWFF	water	2	133504	1337466019	1	0.04	0.00333333333333333	6464	1
2	Drink 2	Intake 2	25	133783	1337466298	/users/cn/jespinosa/phecomp/data/CRG/20120502_FDF_CRG/20120502_FDF_CRG/20120518_FDF_CRG_c12.mtb	1718	NA	WWFF	water	2	133758	1337466273	1	0.0600000000000001	0.0024	6465	1
2	Drink 2	Intake 2	26	134082	1337466597	/users/cn/jespinosa/phecomp/data/CRG/20120502_FDF_CRG/20120502_FDF_CRG/20120518_FDF_CRG_c12.mtb	1719	NA	WWFF	water	2	134056	1337466571	1	0.02	0.000769230769230769	6466	1
2	Food 1	Intake 3	43	135811	1337468326	/users/cn/jespinosa/phecomp/data/CRG/20120502_FDF_CRG/20120502_FDF_CRG/20120518_FDF_CRG_c12.mtb	3870	3457	WWFF	food_fat	3	135768	1337468283	1	0.0599999999999996	0.00139534883720929	6467	1
2	Drink 2	Intake 2	20	137824	1337470339	/users/cn/jespinosa/phecomp/data/CRG/20120502_FDF_CRG/20120502_FDF_CRG/20120518_FDF_CRG_c12.mtb	1720	NA	WWFF	water	2	137804	1337470319	1	0.0600000000000001	0.00300000000000001	6468	1
2	Food 2	Intake 4	23	139291	1337471806	/users/cn/jespinosa/phecomp/data/CRG/20120502_FDF_CRG/20120502_FDF_CRG/20120518_FDF_CRG_c12.mtb	5579	1541	WWFF	food_fat	4	139268	1337471783	1	0.02	0.000869565217391304	6469	1
2	Drink 1	Intake 1	13	139642	1337472157	/users/cn/jespinosa/phecomp/data/CRG/20120502_FDF_CRG/20120502_FDF_CRG/20120518_FDF_CRG_c12.mtb	1135	NA	WWFF	water	1	139629	1337472144	1	0.04	0.00307692307692308	6470	1
2	Drink 2	Intake 2	22	139979	1337472494	/users/cn/jespinosa/phecomp/data/CRG/20120502_FDF_CRG/20120502_FDF_CRG/20120518_FDF_CRG_c12.mtb	1721	NA	WWFF	water	2	139957	1337472472	1	0.04	0.00181818181818182	6471	1
2	Drink 2	Intake 2	30	140132	1337472647	/users/cn/jespinosa/phecomp/data/CRG/20120502_FDF_CRG/20120502_FDF_CRG/20120518_FDF_CRG_c12.mtb	1724	NA	WWFF	water	2	140102	1337472617	1	0.02	0.000666666666666667	6472	1
2	Food 2	Intake 4	116	140948	1337473463	/users/cn/jespinosa/phecomp/data/CRG/20120502_FDF_CRG/20120502_FDF_CRG/20120518_FDF_CRG_c12.mtb	5581	2534	WWFF	food_fat	4	140832	1337473347	1	0.0399999999999996	0.000344827586206893	6473	1
2	Drink 2	Intake 2	12	141025	1337473540	/users/cn/jespinosa/phecomp/data/CRG/20120502_FDF_CRG/20120502_FDF_CRG/20120518_FDF_CRG_c12.mtb	1726	NA	WWFF	water	2	141013	1337473528	1	0.04	0.00333333333333333	6474	1
2	Drink 2	Intake 2	23	141728	1337474243	/users/cn/jespinosa/phecomp/data/CRG/20120502_FDF_CRG/20120502_FDF_CRG/20120518_FDF_CRG_c12.mtb	1727	NA	WWFF	water	2	141705	1337474220	1	0.04	0.00173913043478261	6475	1
2	Food 2	Intake 4	33	143515	1337476030	/users/cn/jespinosa/phecomp/data/CRG/20120502_FDF_CRG/20120502_FDF_CRG/20120518_FDF_CRG_c12.mtb	5584	514	WWFF	food_fat	4	143482	1337475997	1	0.12	0.00363636363636364	6476	1
2	Food 2	Intake 4	46	144075	1337476590	/users/cn/jespinosa/phecomp/data/CRG/20120502_FDF_CRG/20120502_FDF_CRG/20120518_FDF_CRG_c12.mtb	5585	6838	WWFF	food_fat	4	144029	1337476544	1	0.02	0.000434782608695652	6477	1
2	Drink 2	Intake 2	69	144495	1337477010	/users/cn/jespinosa/phecomp/data/CRG/20120502_FDF_CRG/20120502_FDF_CRG/20120518_FDF_CRG_c12.mtb	1731	NA	WWFF	water	2	144426	1337476941	1	0.02	0.000289855072463768	6478	1
2	Drink 2	Intake 2	52	144560	1337477075	/users/cn/jespinosa/phecomp/data/CRG/20120502_FDF_CRG/20120502_FDF_CRG/20120518_FDF_CRG_c12.mtb	1732	NA	WWFF	water	2	144508	1337477023	1	0.02	0.000384615384615385	6479	1
2	Drink 2	Intake 2	12	145638	1337478153	/users/cn/jespinosa/phecomp/data/CRG/20120502_FDF_CRG/20120502_FDF_CRG/20120518_FDF_CRG_c12.mtb	1736	NA	WWFF	water	2	145626	1337478141	1	0.04	0.00333333333333333	6480	1
2	Food 1	Intake 3	33	150946	1337483461	/users/cn/jespinosa/phecomp/data/CRG/20120502_FDF_CRG/20120502_FDF_CRG/20120518_FDF_CRG_c12.mtb	3879	6095	WWFF	food_fat	3	150913	1337483428	1	0.0200000000000005	0.000606060606060621	6481	1
2	Drink 2	Intake 2	22	156207	1337488722	/users/cn/jespinosa/phecomp/data/CRG/20120502_FDF_CRG/20120502_FDF_CRG/20120518_FDF_CRG_c12.mtb	1737	NA	WWFF	water	2	156185	1337488700	1	0.0599999999999996	0.00272727272727271	6482	1
2	Drink 2	Intake 2	13	156715	1337489230	/users/cn/jespinosa/phecomp/data/CRG/20120502_FDF_CRG/20120502_FDF_CRG/20120518_FDF_CRG_c12.mtb	1738	NA	WWFF	water	2	156702	1337489217	1	0.04	0.00307692307692308	6483	1
2	Food 2	Intake 4	41	157082	1337489597	/users/cn/jespinosa/phecomp/data/CRG/20120502_FDF_CRG/20120502_FDF_CRG/20120518_FDF_CRG_c12.mtb	5588	9727	WWFF	food_fat	4	157041	1337489556	1	0.04	0.000975609756097561	6484	1
2	Drink 2	Intake 2	20	157205	1337489720	/users/cn/jespinosa/phecomp/data/CRG/20120502_FDF_CRG/20120502_FDF_CRG/20120518_FDF_CRG_c12.mtb	1739	NA	WWFF	water	2	157185	1337489700	1	0.0200000000000005	0.00100000000000002	6485	1
2	Drink 2	Intake 2	35	157783	1337490298	/users/cn/jespinosa/phecomp/data/CRG/20120502_FDF_CRG/20120502_FDF_CRG/20120518_FDF_CRG_c12.mtb	1740	NA	WWFF	water	2	157748	1337490263	1	0.0999999999999996	0.00285714285714285	6486	1
2	Drink 2	Intake 2	14	158483	1337490998	/users/cn/jespinosa/phecomp/data/CRG/20120502_FDF_CRG/20120502_FDF_CRG/20120518_FDF_CRG_c12.mtb	1742	NA	WWFF	water	2	158469	1337490984	1	0.0600000000000001	0.00428571428571429	6487	1
2	Drink 2	Intake 2	22	158536	1337491051	/users/cn/jespinosa/phecomp/data/CRG/20120502_FDF_CRG/20120502_FDF_CRG/20120518_FDF_CRG_c12.mtb	1743	NA	WWFF	water	2	158514	1337491029	1	0.04	0.00181818181818182	6488	1
2	Drink 2	Intake 2	20	159608	1337492123	/users/cn/jespinosa/phecomp/data/CRG/20120502_FDF_CRG/20120502_FDF_CRG/20120518_FDF_CRG_c12.mtb	1744	NA	WWFF	water	2	159588	1337492103	1	0.02	0.001	6489	1
2	Drink 2	Intake 2	22	163556	1337496071	/users/cn/jespinosa/phecomp/data/CRG/20120502_FDF_CRG/20120502_FDF_CRG/20120518_FDF_CRG_c12.mtb	1746	NA	WWFF	water	2	163534	1337496049	1	0.0600000000000001	0.00272727272727273	6490	1
2	Drink 1	Intake 1	19	164741	1337497256	/users/cn/jespinosa/phecomp/data/CRG/20120502_FDF_CRG/20120502_FDF_CRG/20120518_FDF_CRG_c12.mtb	1138	NA	WWFF	water	1	164722	1337497237	1	0.02	0.00105263157894737	6491	1
2	Drink 2	Intake 2	10	165844	1337498359	/users/cn/jespinosa/phecomp/data/CRG/20120502_FDF_CRG/20120502_FDF_CRG/20120518_FDF_CRG_c12.mtb	1747	NA	WWFF	water	2	165834	1337498349	1	0.04	0.004	6492	1
2	Food 2	Intake 4	17	166826	1337499341	/users/cn/jespinosa/phecomp/data/CRG/20120502_FDF_CRG/20120502_FDF_CRG/20120518_FDF_CRG_c12.mtb	5593	6584	WWFF	food_fat	4	166809	1337499324	1	0.04	0.00235294117647059	6493	1
2	Food 2	Intake 4	16	173426	1337505941	/users/cn/jespinosa/phecomp/data/CRG/20120502_FDF_CRG/20120502_FDF_CRG/20120518_FDF_CRG_c12.mtb	5594	4193	WWFF	food_fat	4	173410	1337505925	1	0.02	0.00125	6494	1
2	Drink 1	Intake 1	20	175656	1337508171	/users/cn/jespinosa/phecomp/data/CRG/20120502_FDF_CRG/20120502_FDF_CRG/20120518_FDF_CRG_c12.mtb	1139	NA	WWFF	water	1	175636	1337508151	1	0.04	0.002	6495	1
2	Food 2	Intake 4	33	177652	1337510167	/users/cn/jespinosa/phecomp/data/CRG/20120502_FDF_CRG/20120502_FDF_CRG/20120518_FDF_CRG_c12.mtb	5595	4642	WWFF	food_fat	4	177619	1337510134	1	0.0600000000000001	0.00181818181818182	6496	1
2	Drink 1	Intake 1	13	177892	1337510407	/users/cn/jespinosa/phecomp/data/CRG/20120502_FDF_CRG/20120502_FDF_CRG/20120518_FDF_CRG_c12.mtb	1140	NA	WWFF	water	1	177879	1337510394	1	0.04	0.00307692307692308	6497	1
2	Drink 2	Intake 2	19	177910	1337510425	/users/cn/jespinosa/phecomp/data/CRG/20120502_FDF_CRG/20120502_FDF_CRG/20120518_FDF_CRG_c12.mtb	1749	NA	WWFF	water	2	177891	1337510406	1	0.02	0.00105263157894737	6498	1
2	Food 2	Intake 4	58	182352	1337514867	/users/cn/jespinosa/phecomp/data/CRG/20120502_FDF_CRG/20120502_FDF_CRG/20120518_FDF_CRG_c12.mtb	5596	4370	WWFF	food_fat	4	182294	1337514809	1	0.14	0.00241379310344828	6499	1
2	Drink 2	Intake 2	13	184149	1337516664	/users/cn/jespinosa/phecomp/data/CRG/20120502_FDF_CRG/20120502_FDF_CRG/20120518_FDF_CRG_c12.mtb	1750	NA	WWFF	water	2	184136	1337516651	1	0.04	0.00307692307692308	6500	1
2	Food 2	Intake 4	17	186739	1337519254	/users/cn/jespinosa/phecomp/data/CRG/20120502_FDF_CRG/20120502_FDF_CRG/20120518_FDF_CRG_c12.mtb	5598	3915	WWFF	food_fat	4	186722	1337519237	1	0.04	0.00235294117647059	6501	1
2	Food 1	Intake 3	55	190709	1337523224	/users/cn/jespinosa/phecomp/data/CRG/20120502_FDF_CRG/20120502_FDF_CRG/20120518_FDF_CRG_c12.mtb	3892	55	WWFF	food_fat	3	190654	1337523169	1	0.0599999999999996	0.00109090909090908	6502	1
2	Food 2	Intake 4	26	190790	1337523305	/users/cn/jespinosa/phecomp/data/CRG/20120502_FDF_CRG/20120502_FDF_CRG/20120518_FDF_CRG_c12.mtb	5599	4820	WWFF	food_fat	4	190764	1337523279	1	0.0599999999999996	0.00230769230769229	6503	1
2	Drink 1	Intake 1	28	191701	1337524216	/users/cn/jespinosa/phecomp/data/CRG/20120502_FDF_CRG/20120502_FDF_CRG/20120518_FDF_CRG_c12.mtb	1141	NA	WWFF	water	1	191673	1337524188	1	0.0599999999999999	0.00214285714285714	6504	1
2	Food 2	Intake 4	34	195644	1337528159	/users/cn/jespinosa/phecomp/data/CRG/20120502_FDF_CRG/20120502_FDF_CRG/20120518_FDF_CRG_c12.mtb	5600	21	WWFF	food_fat	4	195610	1337528125	1	0.1	0.00294117647058824	6505	1
2	Food 2	Intake 4	19	195684	1337528199	/users/cn/jespinosa/phecomp/data/CRG/20120502_FDF_CRG/20120502_FDF_CRG/20120518_FDF_CRG_c12.mtb	5601	15	WWFF	food_fat	4	195665	1337528180	1	0.04	0.00210526315789474	6506	1
2	Food 2	Intake 4	21	195720	1337528235	/users/cn/jespinosa/phecomp/data/CRG/20120502_FDF_CRG/20120502_FDF_CRG/20120518_FDF_CRG_c12.mtb	5602	8543	WWFF	food_fat	4	195699	1337528214	1	0.02	0.000952380952380952	6507	1
2	Drink 1	Intake 1	25	197567	1337530082	/users/cn/jespinosa/phecomp/data/CRG/20120502_FDF_CRG/20120502_FDF_CRG/20120518_FDF_CRG_c12.mtb	1142	NA	WWFF	water	1	197542	1337530057	1	0.0600000000000001	0.0024	6508	1
2	Drink 1	Intake 1	23	200857	1337533372	/users/cn/jespinosa/phecomp/data/CRG/20120502_FDF_CRG/20120502_FDF_CRG/20120518_FDF_CRG_c12.mtb	1143	NA	WWFF	water	1	200834	1337533349	1	0.1	0.00434782608695652	6509	1
2	Food 2	Intake 4	54	204317	1337536832	/users/cn/jespinosa/phecomp/data/CRG/20120502_FDF_CRG/20120502_FDF_CRG/20120518_FDF_CRG_c12.mtb	5603	3113	WWFF	food_fat	4	204263	1337536778	1	0.16	0.00296296296296296	6510	1
2	Drink 2	Intake 2	22	206318	1337538833	/users/cn/jespinosa/phecomp/data/CRG/20120502_FDF_CRG/20120502_FDF_CRG/20120518_FDF_CRG_c12.mtb	1752	NA	WWFF	water	2	206296	1337538811	1	0.0600000000000001	0.00272727272727273	6511	1
2	Drink 1	Intake 1	47	206427	1337538942	/users/cn/jespinosa/phecomp/data/CRG/20120502_FDF_CRG/20120502_FDF_CRG/20120518_FDF_CRG_c12.mtb	1145	NA	WWFF	water	1	206380	1337538895	1	0.02	0.000425531914893617	6512	1
2	Drink 2	Intake 2	14	207374	1337539889	/users/cn/jespinosa/phecomp/data/CRG/20120502_FDF_CRG/20120502_FDF_CRG/20120518_FDF_CRG_c12.mtb	1754	NA	WWFF	water	2	207360	1337539875	1	0.0600000000000001	0.00428571428571429	6513	1
2	Food 2	Intake 4	17	207447	1337539962	/users/cn/jespinosa/phecomp/data/CRG/20120502_FDF_CRG/20120502_FDF_CRG/20120518_FDF_CRG_c12.mtb	5608	852	WWFF	food_fat	4	207430	1337539945	1	0.04	0.00235294117647059	6514	1
2	Drink 2	Intake 2	25	207768	1337540283	/users/cn/jespinosa/phecomp/data/CRG/20120502_FDF_CRG/20120502_FDF_CRG/20120518_FDF_CRG_c12.mtb	1756	NA	WWFF	water	2	207743	1337540258	1	0.0399999999999996	0.00159999999999998	6515	1
2	Drink 1	Intake 1	22	208275	1337540790	/users/cn/jespinosa/phecomp/data/CRG/20120502_FDF_CRG/20120502_FDF_CRG/20120518_FDF_CRG_c12.mtb	1146	NA	WWFF	water	1	208253	1337540768	1	0.0399999999999999	0.00181818181818181	6516	1
2	Food 2	Intake 4	92	208391	1337540906	/users/cn/jespinosa/phecomp/data/CRG/20120502_FDF_CRG/20120502_FDF_CRG/20120518_FDF_CRG_c12.mtb	5610	3457	WWFF	food_fat	4	208299	1337540814	1	0.0800000000000001	0.000869565217391305	6517	1
2	Drink 2	Intake 2	42	209147	1337541662	/users/cn/jespinosa/phecomp/data/CRG/20120502_FDF_CRG/20120502_FDF_CRG/20120518_FDF_CRG_c12.mtb	1758	NA	WWFF	water	2	209105	1337541620	1	0.04	0.000952380952380952	6518	1
2	Food 2	Intake 4	26	211874	1337544389	/users/cn/jespinosa/phecomp/data/CRG/20120502_FDF_CRG/20120502_FDF_CRG/20120518_FDF_CRG_c12.mtb	5612	121	WWFF	food_fat	4	211848	1337544363	1	0.04	0.00153846153846154	6519	1
2	Food 2	Intake 4	55	212050	1337544565	/users/cn/jespinosa/phecomp/data/CRG/20120502_FDF_CRG/20120502_FDF_CRG/20120518_FDF_CRG_c12.mtb	5613	7554	WWFF	food_fat	4	211995	1337544510	1	0.0200000000000005	0.000363636363636373	6520	1
2	Drink 2	Intake 2	17	215332	1337547847	/users/cn/jespinosa/phecomp/data/CRG/20120502_FDF_CRG/20120502_FDF_CRG/20120518_FDF_CRG_c12.mtb	1760	NA	WWFF	water	2	215315	1337547830	1	0.04	0.00235294117647059	6521	1
2	Drink 2	Intake 2	13	215679	1337548194	/users/cn/jespinosa/phecomp/data/CRG/20120502_FDF_CRG/20120502_FDF_CRG/20120518_FDF_CRG_c12.mtb	1761	NA	WWFF	water	2	215666	1337548181	1	0.02	0.00153846153846154	6522	1
2	Drink 2	Intake 2	23	215980	1337548495	/users/cn/jespinosa/phecomp/data/CRG/20120502_FDF_CRG/20120502_FDF_CRG/20120518_FDF_CRG_c12.mtb	1762	NA	WWFF	water	2	215957	1337548472	1	0.04	0.00173913043478261	6523	1
2	Drink 2	Intake 2	15	216006	1337548521	/users/cn/jespinosa/phecomp/data/CRG/20120502_FDF_CRG/20120502_FDF_CRG/20120518_FDF_CRG_c12.mtb	1763	NA	WWFF	water	2	215991	1337548506	1	0.04	0.00266666666666667	6524	1
2	Food 2	Intake 4	16	219620	1337552135	/users/cn/jespinosa/phecomp/data/CRG/20120502_FDF_CRG/20120502_FDF_CRG/20120518_FDF_CRG_c12.mtb	5616	43	WWFF	food_fat	4	219604	1337552119	1	0.04	0.0025	6525	1
2	Food 2	Intake 4	20	219683	1337552198	/users/cn/jespinosa/phecomp/data/CRG/20120502_FDF_CRG/20120502_FDF_CRG/20120518_FDF_CRG_c12.mtb	5617	149	WWFF	food_fat	4	219663	1337552178	1	0.04	0.002	6526	1
2	Food 2	Intake 4	94	219926	1337552441	/users/cn/jespinosa/phecomp/data/CRG/20120502_FDF_CRG/20120502_FDF_CRG/20120518_FDF_CRG_c12.mtb	5619	857	WWFF	food_fat	4	219832	1337552347	1	0.0999999999999996	0.00106382978723404	6527	1
2	Drink 1	Intake 1	23	220684	1337553199	/users/cn/jespinosa/phecomp/data/CRG/20120502_FDF_CRG/20120502_FDF_CRG/20120518_FDF_CRG_c12.mtb	1147	NA	WWFF	water	1	220661	1337553176	1	0.04	0.00173913043478261	6528	1
2	Food 2	Intake 4	62	220845	1337553360	/users/cn/jespinosa/phecomp/data/CRG/20120502_FDF_CRG/20120502_FDF_CRG/20120518_FDF_CRG_c12.mtb	5621	1130	WWFF	food_fat	4	220783	1337553298	1	0.140000000000001	0.00225806451612905	6529	1
2	Drink 2	Intake 2	20	221090	1337553605	/users/cn/jespinosa/phecomp/data/CRG/20120502_FDF_CRG/20120502_FDF_CRG/20120518_FDF_CRG_c12.mtb	1766	NA	WWFF	water	2	221070	1337553585	1	0.0600000000000001	0.00300000000000001	6530	1
2	Drink 1	Intake 1	25	221386	1337553901	/users/cn/jespinosa/phecomp/data/CRG/20120502_FDF_CRG/20120502_FDF_CRG/20120518_FDF_CRG_c12.mtb	1148	NA	WWFF	water	1	221361	1337553876	1	0.0599999999999999	0.0024	6531	1
2	Drink 2	Intake 2	13	221925	1337554440	/users/cn/jespinosa/phecomp/data/CRG/20120502_FDF_CRG/20120502_FDF_CRG/20120518_FDF_CRG_c12.mtb	1767	NA	WWFF	water	2	221912	1337554427	1	0.04	0.00307692307692308	6532	1
2	Food 1	Intake 3	75	222050	1337554565	/users/cn/jespinosa/phecomp/data/CRG/20120502_FDF_CRG/20120502_FDF_CRG/20120518_FDF_CRG_c12.mtb	3901	283	WWFF	food_fat	3	221975	1337554490	1	0.0200000000000005	0.000266666666666673	6533	1
2	Food 2	Intake 4	55	222388	1337554903	/users/cn/jespinosa/phecomp/data/CRG/20120502_FDF_CRG/20120502_FDF_CRG/20120518_FDF_CRG_c12.mtb	5622	5357	WWFF	food_fat	4	222333	1337554848	1	0.04	0.000727272727272727	6534	1
2	Drink 2	Intake 2	19	227697	1337560212	/users/cn/jespinosa/phecomp/data/CRG/20120502_FDF_CRG/20120502_FDF_CRG/20120518_FDF_CRG_c12.mtb	1769	NA	WWFF	water	2	227678	1337560193	1	0.02	0.00105263157894737	6535	1
2	Food 2	Intake 4	44	227789	1337560304	/users/cn/jespinosa/phecomp/data/CRG/20120502_FDF_CRG/20120502_FDF_CRG/20120518_FDF_CRG_c12.mtb	5625	570	WWFF	food_fat	4	227745	1337560260	1	0.0200000000000005	0.000454545454545466	6536	1
2	Drink 2	Intake 2	13	227798	1337560313	/users/cn/jespinosa/phecomp/data/CRG/20120502_FDF_CRG/20120502_FDF_CRG/20120518_FDF_CRG_c12.mtb	1770	NA	WWFF	water	2	227785	1337560300	1	0.02	0.00153846153846154	6537	1
2	Food 2	Intake 4	60	228419	1337560934	/users/cn/jespinosa/phecomp/data/CRG/20120502_FDF_CRG/20120502_FDF_CRG/20120518_FDF_CRG_c12.mtb	5628	12	WWFF	food_fat	4	228359	1337560874	1	0.0200000000000005	0.000333333333333342	6538	1
2	Food 1	Intake 3	79	228510	1337561025	/users/cn/jespinosa/phecomp/data/CRG/20120502_FDF_CRG/20120502_FDF_CRG/20120518_FDF_CRG_c12.mtb	3908	3941	WWFF	food_fat	3	228431	1337560946	1	0.0200000000000005	0.000253164556962032	6539	1
2	Drink 2	Intake 2	36	228626	1337561141	/users/cn/jespinosa/phecomp/data/CRG/20120502_FDF_CRG/20120502_FDF_CRG/20120518_FDF_CRG_c12.mtb	1772	NA	WWFF	water	2	228590	1337561105	1	0.0600000000000001	0.00166666666666667	6540	1
2	Drink 2	Intake 2	18	228809	1337561324	/users/cn/jespinosa/phecomp/data/CRG/20120502_FDF_CRG/20120502_FDF_CRG/20120518_FDF_CRG_c12.mtb	1773	NA	WWFF	water	2	228791	1337561306	1	0.0599999999999996	0.00333333333333331	6541	1
2	Drink 2	Intake 2	15	229438	1337561953	/users/cn/jespinosa/phecomp/data/CRG/20120502_FDF_CRG/20120502_FDF_CRG/20120518_FDF_CRG_c12.mtb	1774	NA	WWFF	water	2	229423	1337561938	1	0.04	0.00266666666666667	6542	1
2	Food 2	Intake 4	34	232485	1337565000	/users/cn/jespinosa/phecomp/data/CRG/20120502_FDF_CRG/20120502_FDF_CRG/20120518_FDF_CRG_c12.mtb	5629	2358	WWFF	food_fat	4	232451	1337564966	1	0.0599999999999996	0.00176470588235293	6543	1
2	Food 2	Intake 4	25	234868	1337567383	/users/cn/jespinosa/phecomp/data/CRG/20120502_FDF_CRG/20120502_FDF_CRG/20120518_FDF_CRG_c12.mtb	5630	2230	WWFF	food_fat	4	234843	1337567358	1	0.0200000000000005	0.00080000000000002	6544	1
2	Drink 2	Intake 2	15	236118	1337568633	/users/cn/jespinosa/phecomp/data/CRG/20120502_FDF_CRG/20120502_FDF_CRG/20120518_FDF_CRG_c12.mtb	1776	NA	WWFF	water	2	236103	1337568618	1	0.0600000000000001	0.00400000000000001	6545	1
2	Food 2	Intake 4	22	237120	1337569635	/users/cn/jespinosa/phecomp/data/CRG/20120502_FDF_CRG/20120502_FDF_CRG/20120518_FDF_CRG_c12.mtb	5632	1500	WWFF	food_fat	4	237098	1337569613	1	0.0200000000000005	0.000909090909090932	6546	1
2	Food 2	Intake 4	102	238722	1337571237	/users/cn/jespinosa/phecomp/data/CRG/20120502_FDF_CRG/20120502_FDF_CRG/20120518_FDF_CRG_c12.mtb	5634	562	WWFF	food_fat	4	238620	1337571135	1	0.0399999999999991	0.000392156862745089	6547	1
2	Drink 2	Intake 2	24	239088	1337571603	/users/cn/jespinosa/phecomp/data/CRG/20120502_FDF_CRG/20120502_FDF_CRG/20120518_FDF_CRG_c12.mtb	1777	NA	WWFF	water	2	239064	1337571579	1	0.0800000000000001	0.00333333333333334	6548	1
2	Food 2	Intake 4	33	239317	1337571832	/users/cn/jespinosa/phecomp/data/CRG/20120502_FDF_CRG/20120502_FDF_CRG/20120518_FDF_CRG_c12.mtb	5637	4856	WWFF	food_fat	4	239284	1337571799	1	0.0200000000000005	0.000606060606060621	6549	1
2	Drink 2	Intake 2	12	239622	1337572137	/users/cn/jespinosa/phecomp/data/CRG/20120502_FDF_CRG/20120502_FDF_CRG/20120518_FDF_CRG_c12.mtb	1778	NA	WWFF	water	2	239610	1337572125	1	0.02	0.00166666666666667	6550	1
2	Drink 2	Intake 2	15	239959	1337572474	/users/cn/jespinosa/phecomp/data/CRG/20120502_FDF_CRG/20120502_FDF_CRG/20120518_FDF_CRG_c12.mtb	1779	NA	WWFF	water	2	239944	1337572459	1	0.04	0.00266666666666667	6551	1
2	Drink 1	Intake 1	24	241932	1337574447	/users/cn/jespinosa/phecomp/data/CRG/20120502_FDF_CRG/20120502_FDF_CRG/20120518_FDF_CRG_c12.mtb	1152	NA	WWFF	water	1	241908	1337574423	1	0.04	0.00166666666666667	6552	1
2	Food 2	Intake 4	45	244218	1337576733	/users/cn/jespinosa/phecomp/data/CRG/20120502_FDF_CRG/20120502_FDF_CRG/20120518_FDF_CRG_c12.mtb	5640	2004	WWFF	food_fat	4	244173	1337576688	1	0.0599999999999996	0.00133333333333332	6553	1
2	Drink 2	Intake 2	13	244722	1337577237	/users/cn/jespinosa/phecomp/data/CRG/20120502_FDF_CRG/20120502_FDF_CRG/20120518_FDF_CRG_c12.mtb	1781	NA	WWFF	water	2	244709	1337577224	1	0.04	0.00307692307692308	6554	1
2	Drink 2	Intake 2	23	245158	1337577673	/users/cn/jespinosa/phecomp/data/CRG/20120502_FDF_CRG/20120502_FDF_CRG/20120518_FDF_CRG_c12.mtb	1782	NA	WWFF	water	2	245135	1337577650	1	0.0599999999999996	0.0026086956521739	6555	1
2	Drink 1	Intake 1	16	245235	1337577750	/users/cn/jespinosa/phecomp/data/CRG/20120502_FDF_CRG/20120502_FDF_CRG/20120518_FDF_CRG_c12.mtb	1154	NA	WWFF	water	1	245219	1337577734	1	0.02	0.00125	6556	1
2	Drink 2	Intake 2	18	245775	1337578290	/users/cn/jespinosa/phecomp/data/CRG/20120502_FDF_CRG/20120502_FDF_CRG/20120518_FDF_CRG_c12.mtb	1783	NA	WWFF	water	2	245757	1337578272	1	0.0800000000000001	0.00444444444444445	6557	1
2	Food 2	Intake 4	29	246251	1337578766	/users/cn/jespinosa/phecomp/data/CRG/20120502_FDF_CRG/20120502_FDF_CRG/20120518_FDF_CRG_c12.mtb	5646	5574	WWFF	food_fat	4	246222	1337578737	1	0.0200000000000005	0.00068965517241381	6558	1
2	Food 2	Intake 4	16	251841	1337584356	/users/cn/jespinosa/phecomp/data/CRG/20120502_FDF_CRG/20120502_FDF_CRG/20120518_FDF_CRG_c12.mtb	5648	29	WWFF	food_fat	4	251825	1337584340	1	0.0600000000000005	0.00375000000000003	6559	1
2	Food 2	Intake 4	13	251883	1337584398	/users/cn/jespinosa/phecomp/data/CRG/20120502_FDF_CRG/20120502_FDF_CRG/20120518_FDF_CRG_c12.mtb	5649	25	WWFF	food_fat	4	251870	1337584385	1	0.04	0.00307692307692308	6560	1
2	Food 2	Intake 4	15	251923	1337584438	/users/cn/jespinosa/phecomp/data/CRG/20120502_FDF_CRG/20120502_FDF_CRG/20120518_FDF_CRG_c12.mtb	5650	8292	WWFF	food_fat	4	251908	1337584423	1	0.0599999999999996	0.00399999999999997	6561	1
2	Drink 2	Intake 2	14	254639	1337587154	/users/cn/jespinosa/phecomp/data/CRG/20120502_FDF_CRG/20120502_FDF_CRG/20120518_FDF_CRG_c12.mtb	1784	NA	WWFF	water	2	254625	1337587140	1	0.0800000000000001	0.00571428571428572	6562	1
2	Food 2	Intake 4	41	260256	1337592771	/users/cn/jespinosa/phecomp/data/CRG/20120502_FDF_CRG/20120502_FDF_CRG/20120518_FDF_CRG_c12.mtb	5651	9335	WWFF	food_fat	4	260215	1337592730	1	0.12	0.00292682926829268	6563	1
2	Drink 2	Intake 2	13	261429	1337593944	/users/cn/jespinosa/phecomp/data/CRG/20120502_FDF_CRG/20120502_FDF_CRG/20120518_FDF_CRG_c12.mtb	1786	NA	WWFF	water	2	261416	1337593931	1	0.0600000000000005	0.00461538461538465	6564	1
2	Drink 2	Intake 2	27	261465	1337593980	/users/cn/jespinosa/phecomp/data/CRG/20120502_FDF_CRG/20120502_FDF_CRG/20120518_FDF_CRG_c12.mtb	1787	NA	WWFF	water	2	261438	1337593953	1	0.04	0.00148148148148148	6565	1
2	Food 1	Intake 3	38	200	1337602144	/users/cn/jespinosa/phecomp/data/CRG/20120502_FDF_CRG/20120502_FDF_CRG/20120521_FDF_CRG_c12.mtb	5639	15	WWFF	food_fat	3	162	1337602106	1	0.42	0.0110526315789474	6566	1
2	Food 1	Intake 3	54	269	1337602213	/users/cn/jespinosa/phecomp/data/CRG/20120502_FDF_CRG/20120502_FDF_CRG/20120521_FDF_CRG_c12.mtb	5640	COLL	WWFF	food_fat	3	215	1337602159	1	0.12	0.00222222222222222	6567	1
2	Food 2	Intake 4	61	319	1337602263	/users/cn/jespinosa/phecomp/data/CRG/20120502_FDF_CRG/20120502_FDF_CRG/20120521_FDF_CRG_c12.mtb	7087	COLL	WWFF	food_fat	4	258	1337602202	1	0.1	0.00163934426229508	6568	1
2	Food 1	Intake 3	62	372	1337602316	/users/cn/jespinosa/phecomp/data/CRG/20120502_FDF_CRG/20120502_FDF_CRG/20120521_FDF_CRG_c12.mtb	5641	COLL	WWFF	food_fat	3	310	1337602254	1	0.4	0.00645161290322581	6569	1
2	Food 2	Intake 4	15	342	1337602286	/users/cn/jespinosa/phecomp/data/CRG/20120502_FDF_CRG/20120502_FDF_CRG/20120521_FDF_CRG_c12.mtb	7088	52	WWFF	food_fat	4	327	1337602271	1	0.04	0.00266666666666667	6570	1
2	Food 2	Intake 4	46	440	1337602384	/users/cn/jespinosa/phecomp/data/CRG/20120502_FDF_CRG/20120502_FDF_CRG/20120521_FDF_CRG_c12.mtb	7089	COLL	WWFF	food_fat	4	394	1337602338	1	0.06	0.00130434782608696	6571	1
2	Food 1	Intake 3	29	457	1337602401	/users/cn/jespinosa/phecomp/data/CRG/20120502_FDF_CRG/20120502_FDF_CRG/20120521_FDF_CRG_c12.mtb	5642	COLL	WWFF	food_fat	3	428	1337602372	1	0.32	0.0110344827586207	6572	1
2	Food 2	Intake 4	82	530	1337602474	/users/cn/jespinosa/phecomp/data/CRG/20120502_FDF_CRG/20120502_FDF_CRG/20120521_FDF_CRG_c12.mtb	7090	COLL	WWFF	food_fat	4	448	1337602392	1	0.6	0.00731707317073171	6573	1
2	Food 1	Intake 3	39	509	1337602453	/users/cn/jespinosa/phecomp/data/CRG/20120502_FDF_CRG/20120502_FDF_CRG/20120521_FDF_CRG_c12.mtb	5643	9	WWFF	food_fat	3	470	1337602414	1	0.16	0.0041025641025641	6574	1
2	Food 1	Intake 3	54	572	1337602516	/users/cn/jespinosa/phecomp/data/CRG/20120502_FDF_CRG/20120502_FDF_CRG/20120521_FDF_CRG_c12.mtb	5644	16	WWFF	food_fat	3	518	1337602462	1	0.78	0.0144444444444444	6575	1
2	Food 2	Intake 4	69	657	1337602601	/users/cn/jespinosa/phecomp/data/CRG/20120502_FDF_CRG/20120502_FDF_CRG/20120521_FDF_CRG_c12.mtb	7092	COLL	WWFF	food_fat	4	588	1337602532	1	0.28	0.00405797101449275	6576	1
2	Food 1	Intake 3	61	651	1337602595	/users/cn/jespinosa/phecomp/data/CRG/20120502_FDF_CRG/20120502_FDF_CRG/20120521_FDF_CRG_c12.mtb	5645	44	WWFF	food_fat	3	590	1337602534	1	0.02	0.000327868852459016	6577	1
2	Food 1	Intake 3	55	750	1337602694	/users/cn/jespinosa/phecomp/data/CRG/20120502_FDF_CRG/20120502_FDF_CRG/20120521_FDF_CRG_c12.mtb	5646	COLL	WWFF	food_fat	3	695	1337602639	1	0.2	0.00363636363636364	6578	1
2	Food 2	Intake 4	63	791	1337602735	/users/cn/jespinosa/phecomp/data/CRG/20120502_FDF_CRG/20120502_FDF_CRG/20120521_FDF_CRG_c12.mtb	7094	COLL	WWFF	food_fat	4	728	1337602672	1	0.2	0.00317460317460317	6579	1
2	Food 1	Intake 3	69	840	1337602784	/users/cn/jespinosa/phecomp/data/CRG/20120502_FDF_CRG/20120502_FDF_CRG/20120521_FDF_CRG_c12.mtb	5647	COLL	WWFF	food_fat	3	771	1337602715	1	0.12	0.00173913043478261	6580	1
2	Food 2	Intake 4	16	818	1337602762	/users/cn/jespinosa/phecomp/data/CRG/20120502_FDF_CRG/20120502_FDF_CRG/20120521_FDF_CRG_c12.mtb	7095	11	WWFF	food_fat	4	802	1337602746	1	0.02	0.00125	6581	1
2	Food 2	Intake 4	49	878	1337602822	/users/cn/jespinosa/phecomp/data/CRG/20120502_FDF_CRG/20120502_FDF_CRG/20120521_FDF_CRG_c12.mtb	7096	COLL	WWFF	food_fat	4	829	1337602773	1	0.72	0.0146938775510204	6582	1
2	Food 1	Intake 3	52	900	1337602844	/users/cn/jespinosa/phecomp/data/CRG/20120502_FDF_CRG/20120502_FDF_CRG/20120521_FDF_CRG_c12.mtb	5648	COLL	WWFF	food_fat	3	848	1337602792	1	0.4	0.00769230769230769	6583	1
2	Food 2	Intake 4	26	916	1337602860	/users/cn/jespinosa/phecomp/data/CRG/20120502_FDF_CRG/20120502_FDF_CRG/20120521_FDF_CRG_c12.mtb	7097	82	WWFF	food_fat	4	890	1337602834	1	0.02	0.000769230769230769	6584	1
2	Food 2	Intake 4	83	1081	1337603025	/users/cn/jespinosa/phecomp/data/CRG/20120502_FDF_CRG/20120502_FDF_CRG/20120521_FDF_CRG_c12.mtb	7098	93	WWFF	food_fat	4	998	1337602942	1	0.32	0.00385542168674699	6585	1
2	Food 1	Intake 3	27	1201	1337603145	/users/cn/jespinosa/phecomp/data/CRG/20120502_FDF_CRG/20120502_FDF_CRG/20120521_FDF_CRG_c12.mtb	5650	14	WWFF	food_fat	3	1174	1337603118	1	0.02	0.000740740740740741	6586	1
2	Food 2	Intake 4	130	1345	1337603289	/users/cn/jespinosa/phecomp/data/CRG/20120502_FDF_CRG/20120502_FDF_CRG/20120521_FDF_CRG_c12.mtb	7099	COLL	WWFF	food_fat	4	1215	1337603159	1	1.44	0.0110769230769231	6587	1
2	Food 1	Intake 3	46	1378	1337603322	/users/cn/jespinosa/phecomp/data/CRG/20120502_FDF_CRG/20120502_FDF_CRG/20120521_FDF_CRG_c12.mtb	5651	COLL	WWFF	food_fat	3	1332	1337603276	1	0.0800000000000001	0.00173913043478261	6588	1
2	Food 2	Intake 4	34	1410	1337603354	/users/cn/jespinosa/phecomp/data/CRG/20120502_FDF_CRG/20120502_FDF_CRG/20120521_FDF_CRG_c12.mtb	7100	157	WWFF	food_fat	4	1376	1337603320	1	0.28	0.00823529411764706	6589	1
2	Food 2	Intake 4	54	1621	1337603565	/users/cn/jespinosa/phecomp/data/CRG/20120502_FDF_CRG/20120502_FDF_CRG/20120521_FDF_CRG_c12.mtb	7101	15	WWFF	food_fat	4	1567	1337603511	1	0.4	0.00740740740740741	6590	1
2	Food 1	Intake 3	25	1661	1337603605	/users/cn/jespinosa/phecomp/data/CRG/20120502_FDF_CRG/20120502_FDF_CRG/20120521_FDF_CRG_c12.mtb	5653	8	WWFF	food_fat	3	1636	1337603580	1	0.0800000000000001	0.0032	6591	1
2	Food 2	Intake 4	29	1698	1337603642	/users/cn/jespinosa/phecomp/data/CRG/20120502_FDF_CRG/20120502_FDF_CRG/20120521_FDF_CRG_c12.mtb	7102	61	WWFF	food_fat	4	1669	1337603613	1	0.04	0.00137931034482759	6592	1
2	Food 2	Intake 4	160	1919	1337603863	/users/cn/jespinosa/phecomp/data/CRG/20120502_FDF_CRG/20120502_FDF_CRG/20120521_FDF_CRG_c12.mtb	7103	118	WWFF	food_fat	4	1759	1337603703	1	0.12	0.00075	6593	1
2	Food 2	Intake 4	76	2113	1337604057	/users/cn/jespinosa/phecomp/data/CRG/20120502_FDF_CRG/20120502_FDF_CRG/20120521_FDF_CRG_c12.mtb	7105	75	WWFF	food_fat	4	2037	1337603981	1	0.58	0.00763157894736842	6594	1
2	Food 2	Intake 4	106	2294	1337604238	/users/cn/jespinosa/phecomp/data/CRG/20120502_FDF_CRG/20120502_FDF_CRG/20120521_FDF_CRG_c12.mtb	7107	895	WWFF	food_fat	4	2188	1337604132	1	0.44	0.00415094339622642	6595	1
2	Food 2	Intake 4	12	3201	1337605145	/users/cn/jespinosa/phecomp/data/CRG/20120502_FDF_CRG/20120502_FDF_CRG/20120521_FDF_CRG_c12.mtb	7108	255	WWFF	food_fat	4	3189	1337605133	1	0.0200000000000005	0.00166666666666671	6596	1
2	Food 2	Intake 4	14	3470	1337605414	/users/cn/jespinosa/phecomp/data/CRG/20120502_FDF_CRG/20120502_FDF_CRG/20120521_FDF_CRG_c12.mtb	7110	17	WWFF	food_fat	4	3456	1337605400	1	0.0200000000000005	0.00142857142857146	6597	1
2	Food 1	Intake 3	65	3552	1337605496	/users/cn/jespinosa/phecomp/data/CRG/20120502_FDF_CRG/20120502_FDF_CRG/20120521_FDF_CRG_c12.mtb	5659	291	WWFF	food_fat	3	3487	1337605431	1	0.1	0.00153846153846154	6598	1
2	Drink 1	Intake 1	20	3622	1337605566	/users/cn/jespinosa/phecomp/data/CRG/20120502_FDF_CRG/20120502_FDF_CRG/20120521_FDF_CRG_c12.mtb	1325	NA	WWFF	water	1	3602	1337605546	1	0.04	0.002	6599	1
2	Food 2	Intake 4	77	3920	1337605864	/users/cn/jespinosa/phecomp/data/CRG/20120502_FDF_CRG/20120502_FDF_CRG/20120521_FDF_CRG_c12.mtb	7113	70	WWFF	food_fat	4	3843	1337605787	1	0.18	0.00233766233766234	6600	1
2	Food 1	Intake 3	68	4058	1337606002	/users/cn/jespinosa/phecomp/data/CRG/20120502_FDF_CRG/20120502_FDF_CRG/20120521_FDF_CRG_c12.mtb	5661	COLL	WWFF	food_fat	3	3990	1337605934	1	0.0399999999999996	0.000588235294117641	6601	1
2	Food 2	Intake 4	124	4171	1337606115	/users/cn/jespinosa/phecomp/data/CRG/20120502_FDF_CRG/20120502_FDF_CRG/20120521_FDF_CRG_c12.mtb	7115	14713	WWFF	food_fat	4	4047	1337605991	1	0.0400000000000009	0.000322580645161298	6602	1
2	Drink 2	Intake 2	20	12249	1337614193	/users/cn/jespinosa/phecomp/data/CRG/20120502_FDF_CRG/20120502_FDF_CRG/20120521_FDF_CRG_c12.mtb	1965	NA	WWFF	water	2	12229	1337614173	1	0.08	0.004	6603	1
2	Drink 2	Intake 2	35	17054	1337618998	/users/cn/jespinosa/phecomp/data/CRG/20120502_FDF_CRG/20120502_FDF_CRG/20120521_FDF_CRG_c12.mtb	1966	NA	WWFF	water	2	17019	1337618963	1	0.12	0.00342857142857143	6604	1
2	Drink 2	Intake 2	12	18842	1337620786	/users/cn/jespinosa/phecomp/data/CRG/20120502_FDF_CRG/20120502_FDF_CRG/20120521_FDF_CRG_c12.mtb	1967	NA	WWFF	water	2	18830	1337620774	1	0.04	0.00333333333333333	6605	1
2	Food 2	Intake 4	22	18906	1337620850	/users/cn/jespinosa/phecomp/data/CRG/20120502_FDF_CRG/20120502_FDF_CRG/20120521_FDF_CRG_c12.mtb	7117	126	WWFF	food_fat	4	18884	1337620828	1	0.0200000000000005	0.000909090909090932	6606	1
2	Drink 2	Intake 2	20	19008	1337620952	/users/cn/jespinosa/phecomp/data/CRG/20120502_FDF_CRG/20120502_FDF_CRG/20120521_FDF_CRG_c12.mtb	1968	NA	WWFF	water	2	18988	1337620932	1	0.02	0.001	6607	1
2	Food 1	Intake 3	42	19074	1337621018	/users/cn/jespinosa/phecomp/data/CRG/20120502_FDF_CRG/20120502_FDF_CRG/20120521_FDF_CRG_c12.mtb	5663	13	WWFF	food_fat	3	19032	1337620976	1	0.1	0.00238095238095238	6608	1
2	Food 2	Intake 4	11	19098	1337621042	/users/cn/jespinosa/phecomp/data/CRG/20120502_FDF_CRG/20120502_FDF_CRG/20120521_FDF_CRG_c12.mtb	7121	4675	WWFF	food_fat	4	19087	1337621031	1	0.0600000000000005	0.0054545454545455	6609	1
2	Drink 2	Intake 2	20	19228	1337621172	/users/cn/jespinosa/phecomp/data/CRG/20120502_FDF_CRG/20120502_FDF_CRG/20120521_FDF_CRG_c12.mtb	1969	NA	WWFF	water	2	19208	1337621152	1	0.08	0.004	6610	1
2	Food 2	Intake 4	52	23825	1337625769	/users/cn/jespinosa/phecomp/data/CRG/20120502_FDF_CRG/20120502_FDF_CRG/20120521_FDF_CRG_c12.mtb	7124	6	WWFF	food_fat	4	23773	1337625717	1	0.04	0.000769230769230769	6611	1
2	Drink 2	Intake 2	14	23841	1337625785	/users/cn/jespinosa/phecomp/data/CRG/20120502_FDF_CRG/20120502_FDF_CRG/20120521_FDF_CRG_c12.mtb	1970	NA	WWFF	water	2	23827	1337625771	1	0.06	0.00428571428571429	6612	1
2	Food 2	Intake 4	36	23867	1337625811	/users/cn/jespinosa/phecomp/data/CRG/20120502_FDF_CRG/20120502_FDF_CRG/20120521_FDF_CRG_c12.mtb	7125	199	WWFF	food_fat	4	23831	1337625775	1	0.0200000000000005	0.000555555555555569	6613	1
2	Drink 2	Intake 2	22	24000	1337625944	/users/cn/jespinosa/phecomp/data/CRG/20120502_FDF_CRG/20120502_FDF_CRG/20120521_FDF_CRG_c12.mtb	1972	NA	WWFF	water	2	23978	1337625922	1	0.04	0.00181818181818182	6614	1
2	Food 2	Intake 4	12	24078	1337626022	/users/cn/jespinosa/phecomp/data/CRG/20120502_FDF_CRG/20120502_FDF_CRG/20120521_FDF_CRG_c12.mtb	7129	33	WWFF	food_fat	4	24066	1337626010	1	0.0399999999999991	0.00333333333333326	6615	1
2	Food 2	Intake 4	46	24157	1337626101	/users/cn/jespinosa/phecomp/data/CRG/20120502_FDF_CRG/20120502_FDF_CRG/20120521_FDF_CRG_c12.mtb	7131	46	WWFF	food_fat	4	24111	1337626055	1	0.0600000000000005	0.00130434782608697	6616	1
2	Food 2	Intake 4	229	24432	1337626376	/users/cn/jespinosa/phecomp/data/CRG/20120502_FDF_CRG/20120502_FDF_CRG/20120521_FDF_CRG_c12.mtb	7132	117	WWFF	food_fat	4	24203	1337626147	1	0.32	0.00139737991266376	6617	1
2	Drink 2	Intake 2	30	24554	1337626498	/users/cn/jespinosa/phecomp/data/CRG/20120502_FDF_CRG/20120502_FDF_CRG/20120521_FDF_CRG_c12.mtb	1973	NA	WWFF	water	2	24524	1337626468	1	0.06	0.002	6618	1
2	Food 2	Intake 4	124	24673	1337626617	/users/cn/jespinosa/phecomp/data/CRG/20120502_FDF_CRG/20120502_FDF_CRG/20120521_FDF_CRG_c12.mtb	7134	100	WWFF	food_fat	4	24549	1337626493	1	0.46	0.00370967741935484	6619	1
2	Food 2	Intake 4	31	24804	1337626748	/users/cn/jespinosa/phecomp/data/CRG/20120502_FDF_CRG/20120502_FDF_CRG/20120521_FDF_CRG_c12.mtb	7136	241	WWFF	food_fat	4	24773	1337626717	1	0.04	0.00129032258064516	6620	1
2	Drink 2	Intake 2	13	24809	1337626753	/users/cn/jespinosa/phecomp/data/CRG/20120502_FDF_CRG/20120502_FDF_CRG/20120521_FDF_CRG_c12.mtb	1974	NA	WWFF	water	2	24796	1337626740	1	0.04	0.00307692307692308	6621	1
2	Food 2	Intake 4	60	25105	1337627049	/users/cn/jespinosa/phecomp/data/CRG/20120502_FDF_CRG/20120502_FDF_CRG/20120521_FDF_CRG_c12.mtb	7138	86	WWFF	food_fat	4	25045	1337626989	1	0.04	0.000666666666666667	6622	1
2	Food 2	Intake 4	20	25211	1337627155	/users/cn/jespinosa/phecomp/data/CRG/20120502_FDF_CRG/20120502_FDF_CRG/20120521_FDF_CRG_c12.mtb	7140	641	WWFF	food_fat	4	25191	1337627135	1	0.0200000000000005	0.00100000000000002	6623	1
2	Food 2	Intake 4	46	25898	1337627842	/users/cn/jespinosa/phecomp/data/CRG/20120502_FDF_CRG/20120502_FDF_CRG/20120521_FDF_CRG_c12.mtb	7148	COLL	WWFF	food_fat	4	25852	1337627796	1	0.0200000000000005	0.000434782608695663	6624	1
2	Food 1	Intake 3	31	25896	1337627840	/users/cn/jespinosa/phecomp/data/CRG/20120502_FDF_CRG/20120502_FDF_CRG/20120521_FDF_CRG_c12.mtb	5671	389	WWFF	food_fat	3	25865	1337627809	1	0.02	0.000645161290322581	6625	1
2	Drink 2	Intake 2	38	25941	1337627885	/users/cn/jespinosa/phecomp/data/CRG/20120502_FDF_CRG/20120502_FDF_CRG/20120521_FDF_CRG_c12.mtb	1976	NA	WWFF	water	2	25903	1337627847	1	0.02	0.000526315789473684	6626	1
2	Food 1	Intake 3	15	26300	1337628244	/users/cn/jespinosa/phecomp/data/CRG/20120502_FDF_CRG/20120502_FDF_CRG/20120521_FDF_CRG_c12.mtb	5672	1194	WWFF	food_fat	3	26285	1337628229	1	0.04	0.00266666666666667	6627	1
2	Drink 2	Intake 2	46	26493	1337628437	/users/cn/jespinosa/phecomp/data/CRG/20120502_FDF_CRG/20120502_FDF_CRG/20120521_FDF_CRG_c12.mtb	1977	NA	WWFF	water	2	26447	1337628391	1	0.0399999999999999	0.000869565217391302	6628	1
2	Food 2	Intake 4	10	27504	1337629448	/users/cn/jespinosa/phecomp/data/CRG/20120502_FDF_CRG/20120502_FDF_CRG/20120521_FDF_CRG_c12.mtb	7156	1103	WWFF	food_fat	4	27494	1337629438	1	0.0200000000000005	0.00200000000000005	6629	1
2	Food 1	Intake 3	27	28634	1337630578	/users/cn/jespinosa/phecomp/data/CRG/20120502_FDF_CRG/20120502_FDF_CRG/20120521_FDF_CRG_c12.mtb	5673	8	WWFF	food_fat	3	28607	1337630551	1	0.0600000000000001	0.00222222222222223	6630	1
2	Food 1	Intake 3	29	28671	1337630615	/users/cn/jespinosa/phecomp/data/CRG/20120502_FDF_CRG/20120502_FDF_CRG/20120521_FDF_CRG_c12.mtb	5674	1700	WWFF	food_fat	3	28642	1337630586	1	0.04	0.00137931034482759	6631	1
2	Food 1	Intake 3	41	30412	1337632356	/users/cn/jespinosa/phecomp/data/CRG/20120502_FDF_CRG/20120502_FDF_CRG/20120521_FDF_CRG_c12.mtb	5675	17	WWFF	food_fat	3	30371	1337632315	1	0.1	0.0024390243902439	6632	1
2	Food 2	Intake 4	13	30442	1337632386	/users/cn/jespinosa/phecomp/data/CRG/20120502_FDF_CRG/20120502_FDF_CRG/20120521_FDF_CRG_c12.mtb	7162	2189	WWFF	food_fat	4	30429	1337632373	1	0.04	0.00307692307692308	6633	1
2	Drink 2	Intake 2	29	30460	1337632404	/users/cn/jespinosa/phecomp/data/CRG/20120502_FDF_CRG/20120502_FDF_CRG/20120521_FDF_CRG_c12.mtb	1979	NA	WWFF	water	2	30431	1337632375	1	0.04	0.00137931034482759	6634	1
2	Drink 2	Intake 2	11	31181	1337633125	/users/cn/jespinosa/phecomp/data/CRG/20120502_FDF_CRG/20120502_FDF_CRG/20120521_FDF_CRG_c12.mtb	1980	NA	WWFF	water	2	31170	1337633114	1	0.04	0.00363636363636364	6635	1
2	Food 2	Intake 4	20	32651	1337634595	/users/cn/jespinosa/phecomp/data/CRG/20120502_FDF_CRG/20120502_FDF_CRG/20120521_FDF_CRG_c12.mtb	7166	1105	WWFF	food_fat	4	32631	1337634575	1	0.0599999999999996	0.00299999999999998	6636	1
2	Drink 2	Intake 2	25	32667	1337634611	/users/cn/jespinosa/phecomp/data/CRG/20120502_FDF_CRG/20120502_FDF_CRG/20120521_FDF_CRG_c12.mtb	1981	NA	WWFF	water	2	32642	1337634586	1	0.08	0.0032	6637	1
2	Food 1	Intake 3	11	33767	1337635711	/users/cn/jespinosa/phecomp/data/CRG/20120502_FDF_CRG/20120502_FDF_CRG/20120521_FDF_CRG_c12.mtb	5676	6	WWFF	food_fat	3	33756	1337635700	1	0.04	0.00363636363636364	6638	1
2	Food 1	Intake 3	17	33790	1337635734	/users/cn/jespinosa/phecomp/data/CRG/20120502_FDF_CRG/20120502_FDF_CRG/20120521_FDF_CRG_c12.mtb	5677	2171	WWFF	food_fat	3	33773	1337635717	1	0.04	0.00235294117647059	6639	1
2	Drink 2	Intake 2	20	34600	1337636544	/users/cn/jespinosa/phecomp/data/CRG/20120502_FDF_CRG/20120502_FDF_CRG/20120521_FDF_CRG_c12.mtb	1982	NA	WWFF	water	2	34580	1337636524	1	0.04	0.002	6640	1
2	Drink 2	Intake 2	16	35393	1337637337	/users/cn/jespinosa/phecomp/data/CRG/20120502_FDF_CRG/20120502_FDF_CRG/20120521_FDF_CRG_c12.mtb	1983	NA	WWFF	water	2	35377	1337637321	1	0.0599999999999999	0.00374999999999999	6641	1
2	Food 1	Intake 3	18	35979	1337637923	/users/cn/jespinosa/phecomp/data/CRG/20120502_FDF_CRG/20120502_FDF_CRG/20120521_FDF_CRG_c12.mtb	5678	20	WWFF	food_fat	3	35961	1337637905	1	0.0800000000000001	0.00444444444444445	6642	1
2	Food 1	Intake 3	15	36014	1337637958	/users/cn/jespinosa/phecomp/data/CRG/20120502_FDF_CRG/20120502_FDF_CRG/20120521_FDF_CRG_c12.mtb	5679	2073	WWFF	food_fat	3	35999	1337637943	1	0.0399999999999996	0.00266666666666664	6643	1
2	Food 1	Intake 3	27	38114	1337640058	/users/cn/jespinosa/phecomp/data/CRG/20120502_FDF_CRG/20120502_FDF_CRG/20120521_FDF_CRG_c12.mtb	5680	259	WWFF	food_fat	3	38087	1337640031	1	0.02	0.000740740740740741	6644	1
2	Drink 2	Intake 2	18	38157	1337640101	/users/cn/jespinosa/phecomp/data/CRG/20120502_FDF_CRG/20120502_FDF_CRG/20120521_FDF_CRG_c12.mtb	1984	NA	WWFF	water	2	38139	1337640083	1	0.02	0.00111111111111111	6645	1
2	Drink 2	Intake 2	55	38278	1337640222	/users/cn/jespinosa/phecomp/data/CRG/20120502_FDF_CRG/20120502_FDF_CRG/20120521_FDF_CRG_c12.mtb	1986	NA	WWFF	water	2	38223	1337640167	1	0.04	0.000727272727272727	6646	1
2	Food 2	Intake 4	44	38417	1337640361	/users/cn/jespinosa/phecomp/data/CRG/20120502_FDF_CRG/20120502_FDF_CRG/20120521_FDF_CRG_c12.mtb	7178	268	WWFF	food_fat	4	38373	1337640317	1	0.0600000000000005	0.00136363636363638	6647	1
2	Food 2	Intake 4	33	38718	1337640662	/users/cn/jespinosa/phecomp/data/CRG/20120502_FDF_CRG/20120502_FDF_CRG/20120521_FDF_CRG_c12.mtb	7181	587	WWFF	food_fat	4	38685	1337640629	1	0.0200000000000005	0.000606060606060621	6648	1
2	Drink 2	Intake 2	32	38794	1337640738	/users/cn/jespinosa/phecomp/data/CRG/20120502_FDF_CRG/20120502_FDF_CRG/20120521_FDF_CRG_c12.mtb	1990	NA	WWFF	water	2	38762	1337640706	1	0.04	0.00125	6649	1
2	Drink 2	Intake 2	16	39050	1337640994	/users/cn/jespinosa/phecomp/data/CRG/20120502_FDF_CRG/20120502_FDF_CRG/20120521_FDF_CRG_c12.mtb	1991	NA	WWFF	water	2	39034	1337640978	1	0.04	0.0025	6650	1
2	Drink 2	Intake 2	21	39306	1337641250	/users/cn/jespinosa/phecomp/data/CRG/20120502_FDF_CRG/20120502_FDF_CRG/20120521_FDF_CRG_c12.mtb	1992	NA	WWFF	water	2	39285	1337641229	1	0.04	0.0019047619047619	6651	1
2	Food 2	Intake 4	62	39367	1337641311	/users/cn/jespinosa/phecomp/data/CRG/20120502_FDF_CRG/20120502_FDF_CRG/20120521_FDF_CRG_c12.mtb	7186	181	WWFF	food_fat	4	39305	1337641249	1	0.0999999999999996	0.00161290322580645	6652	1
2	Food 2	Intake 4	15	39563	1337641507	/users/cn/jespinosa/phecomp/data/CRG/20120502_FDF_CRG/20120502_FDF_CRG/20120521_FDF_CRG_c12.mtb	7187	897	WWFF	food_fat	4	39548	1337641492	1	0.0200000000000005	0.00133333333333337	6653	1
2	Drink 2	Intake 2	15	39880	1337641824	/users/cn/jespinosa/phecomp/data/CRG/20120502_FDF_CRG/20120502_FDF_CRG/20120521_FDF_CRG_c12.mtb	1993	NA	WWFF	water	2	39865	1337641809	1	0.04	0.00266666666666667	6654	1
2	Food 2	Intake 4	12	40472	1337642416	/users/cn/jespinosa/phecomp/data/CRG/20120502_FDF_CRG/20120502_FDF_CRG/20120521_FDF_CRG_c12.mtb	7189	331	WWFF	food_fat	4	40460	1337642404	1	0.0200000000000005	0.00166666666666671	6655	1
2	Drink 2	Intake 2	17	40594	1337642538	/users/cn/jespinosa/phecomp/data/CRG/20120502_FDF_CRG/20120502_FDF_CRG/20120521_FDF_CRG_c12.mtb	1996	NA	WWFF	water	2	40577	1337642521	1	0.02	0.00117647058823529	6656	1
2	Food 2	Intake 4	12	40815	1337642759	/users/cn/jespinosa/phecomp/data/CRG/20120502_FDF_CRG/20120502_FDF_CRG/20120521_FDF_CRG_c12.mtb	7193	2468	WWFF	food_fat	4	40803	1337642747	1	0.0400000000000009	0.00333333333333341	6657	1
2	Drink 2	Intake 2	12	41200	1337643144	/users/cn/jespinosa/phecomp/data/CRG/20120502_FDF_CRG/20120502_FDF_CRG/20120521_FDF_CRG_c12.mtb	1997	NA	WWFF	water	2	41188	1337643132	1	0.02	0.00166666666666667	6658	1
2	Food 1	Intake 3	15	43298	1337645242	/users/cn/jespinosa/phecomp/data/CRG/20120502_FDF_CRG/20120502_FDF_CRG/20120521_FDF_CRG_c12.mtb	5684	14	WWFF	food_fat	3	43283	1337645227	1	0.04	0.00266666666666667	6659	1
2	Food 1	Intake 3	38	43350	1337645294	/users/cn/jespinosa/phecomp/data/CRG/20120502_FDF_CRG/20120502_FDF_CRG/20120521_FDF_CRG_c12.mtb	5685	2755	WWFF	food_fat	3	43312	1337645256	1	0.1	0.00263157894736842	6660	1
2	Food 1	Intake 3	17	46122	1337648066	/users/cn/jespinosa/phecomp/data/CRG/20120502_FDF_CRG/20120502_FDF_CRG/20120521_FDF_CRG_c12.mtb	5686	2236	WWFF	food_fat	3	46105	1337648049	1	0.02	0.00117647058823529	6661	1
2	Drink 2	Intake 2	22	46227	1337648171	/users/cn/jespinosa/phecomp/data/CRG/20120502_FDF_CRG/20120502_FDF_CRG/20120521_FDF_CRG_c12.mtb	1999	NA	WWFF	water	2	46205	1337648149	1	0.0600000000000001	0.00272727272727273	6662	1
2	Drink 2	Intake 2	20	46488	1337648432	/users/cn/jespinosa/phecomp/data/CRG/20120502_FDF_CRG/20120502_FDF_CRG/20120521_FDF_CRG_c12.mtb	2000	NA	WWFF	water	2	46468	1337648412	1	0.04	0.002	6663	1
2	Food 1	Intake 3	37	48395	1337650339	/users/cn/jespinosa/phecomp/data/CRG/20120502_FDF_CRG/20120502_FDF_CRG/20120521_FDF_CRG_c12.mtb	5688	1429	WWFF	food_fat	3	48358	1337650302	1	0.0800000000000001	0.00216216216216216	6664	1
2	Food 2	Intake 4	14	49838	1337651782	/users/cn/jespinosa/phecomp/data/CRG/20120502_FDF_CRG/20120502_FDF_CRG/20120521_FDF_CRG_c12.mtb	7211	1406	WWFF	food_fat	4	49824	1337651768	1	0.0599999999999996	0.00428571428571426	6665	1
2	Drink 2	Intake 2	13	49848	1337651792	/users/cn/jespinosa/phecomp/data/CRG/20120502_FDF_CRG/20120502_FDF_CRG/20120521_FDF_CRG_c12.mtb	2001	NA	WWFF	water	2	49835	1337651779	1	0.0600000000000001	0.00461538461538462	6666	1
2	Food 2	Intake 4	14	51258	1337653202	/users/cn/jespinosa/phecomp/data/CRG/20120502_FDF_CRG/20120502_FDF_CRG/20120521_FDF_CRG_c12.mtb	7214	392	WWFF	food_fat	4	51244	1337653188	1	0.04	0.00285714285714286	6667	1
2	Food 2	Intake 4	61	51711	1337653655	/users/cn/jespinosa/phecomp/data/CRG/20120502_FDF_CRG/20120502_FDF_CRG/20120521_FDF_CRG_c12.mtb	7215	24	WWFF	food_fat	4	51650	1337653594	1	0.0800000000000001	0.00131147540983607	6668	1
2	Drink 2	Intake 2	17	51741	1337653685	/users/cn/jespinosa/phecomp/data/CRG/20120502_FDF_CRG/20120502_FDF_CRG/20120521_FDF_CRG_c12.mtb	2002	NA	WWFF	water	2	51724	1337653668	1	0.0399999999999998	0.00235294117647058	6669	1
2	Food 2	Intake 4	171	51906	1337653850	/users/cn/jespinosa/phecomp/data/CRG/20120502_FDF_CRG/20120502_FDF_CRG/20120521_FDF_CRG_c12.mtb	7216	COLL	WWFF	food_fat	4	51735	1337653679	1	0.04	0.000233918128654971	6670	1
2	Food 1	Intake 3	37	51801	1337653745	/users/cn/jespinosa/phecomp/data/CRG/20120502_FDF_CRG/20120502_FDF_CRG/20120521_FDF_CRG_c12.mtb	5689	813	WWFF	food_fat	3	51764	1337653708	1	0.0200000000000005	0.000540540540540554	6671	1
2	Food 2	Intake 4	14	52628	1337654572	/users/cn/jespinosa/phecomp/data/CRG/20120502_FDF_CRG/20120502_FDF_CRG/20120521_FDF_CRG_c12.mtb	7223	48	WWFF	food_fat	4	52614	1337654558	1	0.04	0.00285714285714286	6672	1
2	Drink 2	Intake 2	21	52638	1337654582	/users/cn/jespinosa/phecomp/data/CRG/20120502_FDF_CRG/20120502_FDF_CRG/20120521_FDF_CRG_c12.mtb	2004	NA	WWFF	water	2	52617	1337654561	1	0.04	0.0019047619047619	6673	1
2	Drink 2	Intake 2	18	52685	1337654629	/users/cn/jespinosa/phecomp/data/CRG/20120502_FDF_CRG/20120502_FDF_CRG/20120521_FDF_CRG_c12.mtb	2005	NA	WWFF	water	2	52667	1337654611	1	0.04	0.00222222222222222	6674	1
2	Food 2	Intake 4	90	52766	1337654710	/users/cn/jespinosa/phecomp/data/CRG/20120502_FDF_CRG/20120502_FDF_CRG/20120521_FDF_CRG_c12.mtb	7224	125	WWFF	food_fat	4	52676	1337654620	1	0.0200000000000005	0.000222222222222228	6675	1
2	Food 2	Intake 4	18	52909	1337654853	/users/cn/jespinosa/phecomp/data/CRG/20120502_FDF_CRG/20120502_FDF_CRG/20120521_FDF_CRG_c12.mtb	7226	5394	WWFF	food_fat	4	52891	1337654835	1	0.04	0.00222222222222222	6676	1
2	Drink 2	Intake 2	17	53530	1337655474	/users/cn/jespinosa/phecomp/data/CRG/20120502_FDF_CRG/20120502_FDF_CRG/20120521_FDF_CRG_c12.mtb	2006	NA	WWFF	water	2	53513	1337655457	1	0.0600000000000001	0.00352941176470589	6677	1
2	Drink 2	Intake 2	15	53554	1337655498	/users/cn/jespinosa/phecomp/data/CRG/20120502_FDF_CRG/20120502_FDF_CRG/20120521_FDF_CRG_c12.mtb	2007	NA	WWFF	water	2	53539	1337655483	1	0.02	0.00133333333333333	6678	1
2	Drink 2	Intake 2	10	54007	1337655951	/users/cn/jespinosa/phecomp/data/CRG/20120502_FDF_CRG/20120502_FDF_CRG/20120521_FDF_CRG_c12.mtb	2008	NA	WWFF	water	2	53997	1337655941	1	0.04	0.004	6679	1
2	Drink 2	Intake 2	18	58169	1337660113	/users/cn/jespinosa/phecomp/data/CRG/20120502_FDF_CRG/20120502_FDF_CRG/20120521_FDF_CRG_c12.mtb	2009	NA	WWFF	water	2	58151	1337660095	1	0.0600000000000001	0.00333333333333334	6680	1
2	Food 2	Intake 4	14	58317	1337660261	/users/cn/jespinosa/phecomp/data/CRG/20120502_FDF_CRG/20120502_FDF_CRG/20120521_FDF_CRG_c12.mtb	7234	313	WWFF	food_fat	4	58303	1337660247	1	0.04	0.00285714285714286	6681	1
2	Food 2	Intake 4	58	58688	1337660632	/users/cn/jespinosa/phecomp/data/CRG/20120502_FDF_CRG/20120502_FDF_CRG/20120521_FDF_CRG_c12.mtb	7238	29	WWFF	food_fat	4	58630	1337660574	1	0.0200000000000005	0.000344827586206905	6682	1
2	Food 2	Intake 4	42	58759	1337660703	/users/cn/jespinosa/phecomp/data/CRG/20120502_FDF_CRG/20120502_FDF_CRG/20120521_FDF_CRG_c12.mtb	7239	1263	WWFF	food_fat	4	58717	1337660661	1	0.0200000000000005	0.000476190476190488	6683	1
2	Drink 2	Intake 2	49	58797	1337660741	/users/cn/jespinosa/phecomp/data/CRG/20120502_FDF_CRG/20120502_FDF_CRG/20120521_FDF_CRG_c12.mtb	2011	NA	WWFF	water	2	58748	1337660692	1	0.04	0.000816326530612245	6684	1
2	Drink 2	Intake 2	44	59022	1337660966	/users/cn/jespinosa/phecomp/data/CRG/20120502_FDF_CRG/20120502_FDF_CRG/20120521_FDF_CRG_c12.mtb	2013	NA	WWFF	water	2	58978	1337660922	1	0.02	0.000454545454545455	6685	1
2	Food 2	Intake 4	24	60046	1337661990	/users/cn/jespinosa/phecomp/data/CRG/20120502_FDF_CRG/20120502_FDF_CRG/20120521_FDF_CRG_c12.mtb	7248	527	WWFF	food_fat	4	60022	1337661966	1	0.0599999999999996	0.00249999999999998	6686	1
2	Food 2	Intake 4	13	60586	1337662530	/users/cn/jespinosa/phecomp/data/CRG/20120502_FDF_CRG/20120502_FDF_CRG/20120521_FDF_CRG_c12.mtb	7250	3016	WWFF	food_fat	4	60573	1337662517	1	0.04	0.00307692307692308	6687	1
2	Drink 2	Intake 2	21	63453	1337665397	/users/cn/jespinosa/phecomp/data/CRG/20120502_FDF_CRG/20120502_FDF_CRG/20120521_FDF_CRG_c12.mtb	2015	NA	WWFF	water	2	63432	1337665376	1	0.02	0.000952380952380952	6688	1
2	Drink 2	Intake 2	15	63497	1337665441	/users/cn/jespinosa/phecomp/data/CRG/20120502_FDF_CRG/20120502_FDF_CRG/20120521_FDF_CRG_c12.mtb	2016	NA	WWFF	water	2	63482	1337665426	1	0.02	0.00133333333333333	6689	1
2	Food 2	Intake 4	13	63615	1337665559	/users/cn/jespinosa/phecomp/data/CRG/20120502_FDF_CRG/20120502_FDF_CRG/20120521_FDF_CRG_c12.mtb	7260	113	WWFF	food_fat	4	63602	1337665546	1	0.04	0.00307692307692308	6690	1
2	Food 1	Intake 3	64	63792	1337665736	/users/cn/jespinosa/phecomp/data/CRG/20120502_FDF_CRG/20120502_FDF_CRG/20120521_FDF_CRG_c12.mtb	5702	1060	WWFF	food_fat	3	63728	1337665672	1	0.0200000000000005	0.000312500000000008	6691	1
2	Drink 2	Intake 2	12	63883	1337665827	/users/cn/jespinosa/phecomp/data/CRG/20120502_FDF_CRG/20120502_FDF_CRG/20120521_FDF_CRG_c12.mtb	2017	NA	WWFF	water	2	63871	1337665815	1	0.04	0.00333333333333333	6692	1
2	Drink 2	Intake 2	20	63978	1337665922	/users/cn/jespinosa/phecomp/data/CRG/20120502_FDF_CRG/20120502_FDF_CRG/20120521_FDF_CRG_c12.mtb	2018	NA	WWFF	water	2	63958	1337665902	1	0.02	0.001	6693	1
2	Drink 2	Intake 2	22	64165	1337666109	/users/cn/jespinosa/phecomp/data/CRG/20120502_FDF_CRG/20120502_FDF_CRG/20120521_FDF_CRG_c12.mtb	2019	NA	WWFF	water	2	64143	1337666087	1	0.0399999999999998	0.00181818181818181	6694	1
2	Drink 2	Intake 2	16	64451	1337666395	/users/cn/jespinosa/phecomp/data/CRG/20120502_FDF_CRG/20120502_FDF_CRG/20120521_FDF_CRG_c12.mtb	2020	NA	WWFF	water	2	64435	1337666379	1	0.04	0.0025	6695	1
2	Food 2	Intake 4	140	64992	1337666936	/users/cn/jespinosa/phecomp/data/CRG/20120502_FDF_CRG/20120502_FDF_CRG/20120521_FDF_CRG_c12.mtb	7272	COLL	WWFF	food_fat	4	64852	1337666796	1	0.0200000000000005	0.000142857142857146	6696	1
2	Food 1	Intake 3	39	65020	1337666964	/users/cn/jespinosa/phecomp/data/CRG/20120502_FDF_CRG/20120502_FDF_CRG/20120521_FDF_CRG_c12.mtb	5707	COLL	WWFF	food_fat	3	64981	1337666925	1	0.0200000000000005	0.000512820512820526	6697	1
2	Food 2	Intake 4	12	65021	1337666965	/users/cn/jespinosa/phecomp/data/CRG/20120502_FDF_CRG/20120502_FDF_CRG/20120521_FDF_CRG_c12.mtb	7273	215	WWFF	food_fat	4	65009	1337666953	1	0.04	0.00333333333333333	6698	1
2	Food 2	Intake 4	19	65255	1337667199	/users/cn/jespinosa/phecomp/data/CRG/20120502_FDF_CRG/20120502_FDF_CRG/20120521_FDF_CRG_c12.mtb	7275	12016	WWFF	food_fat	4	65236	1337667180	1	0.04	0.00210526315789474	6699	1
2	Drink 2	Intake 2	19	76108	1337678052	/users/cn/jespinosa/phecomp/data/CRG/20120502_FDF_CRG/20120502_FDF_CRG/20120521_FDF_CRG_c12.mtb	2021	NA	WWFF	water	2	76089	1337678033	1	0.0800000000000001	0.00421052631578948	6700	1
2	Drink 2	Intake 2	18	76394	1337678338	/users/cn/jespinosa/phecomp/data/CRG/20120502_FDF_CRG/20120502_FDF_CRG/20120521_FDF_CRG_c12.mtb	2022	NA	WWFF	water	2	76376	1337678320	1	0.0800000000000001	0.00444444444444445	6701	1
2	Drink 2	Intake 2	16	77156	1337679100	/users/cn/jespinosa/phecomp/data/CRG/20120502_FDF_CRG/20120502_FDF_CRG/20120521_FDF_CRG_c12.mtb	2023	NA	WWFF	water	2	77140	1337679084	1	0.02	0.00125	6702	1
2	Food 2	Intake 4	13	77284	1337679228	/users/cn/jespinosa/phecomp/data/CRG/20120502_FDF_CRG/20120502_FDF_CRG/20120521_FDF_CRG_c12.mtb	7287	392	WWFF	food_fat	4	77271	1337679215	1	0.0600000000000005	0.00461538461538465	6703	1
2	Drink 2	Intake 2	15	77314	1337679258	/users/cn/jespinosa/phecomp/data/CRG/20120502_FDF_CRG/20120502_FDF_CRG/20120521_FDF_CRG_c12.mtb	2024	NA	WWFF	water	2	77299	1337679243	1	0.04	0.00266666666666667	6704	1
2	Food 2	Intake 4	18	77694	1337679638	/users/cn/jespinosa/phecomp/data/CRG/20120502_FDF_CRG/20120502_FDF_CRG/20120521_FDF_CRG_c12.mtb	7290	2895	WWFF	food_fat	4	77676	1337679620	1	0.0200000000000005	0.00111111111111114	6705	1
2	Food 2	Intake 4	12	80601	1337682545	/users/cn/jespinosa/phecomp/data/CRG/20120502_FDF_CRG/20120502_FDF_CRG/20120521_FDF_CRG_c12.mtb	7293	10789	WWFF	food_fat	4	80589	1337682533	1	0.04	0.00333333333333333	6706	1
2	Drink 2	Intake 2	30	86662	1337688606	/users/cn/jespinosa/phecomp/data/CRG/20120502_FDF_CRG/20120502_FDF_CRG/20120521_FDF_CRG_c12.mtb	2025	NA	WWFF	water	2	86632	1337688576	1	0.0800000000000001	0.00266666666666667	6707	1
2	Food 2	Intake 4	15	91405	1337693349	/users/cn/jespinosa/phecomp/data/CRG/20120502_FDF_CRG/20120502_FDF_CRG/20120521_FDF_CRG_c12.mtb	7299	27	WWFF	food_fat	4	91390	1337693334	1	0.04	0.00266666666666667	6708	1
2	Food 2	Intake 4	11	91443	1337693387	/users/cn/jespinosa/phecomp/data/CRG/20120502_FDF_CRG/20120502_FDF_CRG/20120521_FDF_CRG_c12.mtb	7300	59	WWFF	food_fat	4	91432	1337693376	1	0.0399999999999991	0.00363636363636355	6709	1
2	Food 2	Intake 4	14	91516	1337693460	/users/cn/jespinosa/phecomp/data/CRG/20120502_FDF_CRG/20120502_FDF_CRG/20120521_FDF_CRG_c12.mtb	7302	3189	WWFF	food_fat	4	91502	1337693446	1	0.0599999999999996	0.00428571428571426	6710	1
2	Drink 1	Intake 1	34	91543	1337693487	/users/cn/jespinosa/phecomp/data/CRG/20120502_FDF_CRG/20120502_FDF_CRG/20120521_FDF_CRG_c12.mtb	1330	NA	WWFF	water	1	91509	1337693453	1	0.04	0.00117647058823529	6711	1
2	Food 1	Intake 3	33	94738	1337696682	/users/cn/jespinosa/phecomp/data/CRG/20120502_FDF_CRG/20120502_FDF_CRG/20120521_FDF_CRG_c12.mtb	5714	4638	WWFF	food_fat	3	94705	1337696649	1	0.0200000000000005	0.000606060606060621	6712	1
2	Food 2	Intake 4	12	99388	1337701332	/users/cn/jespinosa/phecomp/data/CRG/20120502_FDF_CRG/20120502_FDF_CRG/20120521_FDF_CRG_c12.mtb	7309	166	WWFF	food_fat	4	99376	1337701320	1	0.0399999999999991	0.00333333333333326	6713	1
2	Drink 2	Intake 2	15	99411	1337701355	/users/cn/jespinosa/phecomp/data/CRG/20120502_FDF_CRG/20120502_FDF_CRG/20120521_FDF_CRG_c12.mtb	2026	NA	WWFF	water	2	99396	1337701340	1	0.04	0.00266666666666667	6714	1
2	Food 2	Intake 4	14	99568	1337701512	/users/cn/jespinosa/phecomp/data/CRG/20120502_FDF_CRG/20120502_FDF_CRG/20120521_FDF_CRG_c12.mtb	7312	261	WWFF	food_fat	4	99554	1337701498	1	0.04	0.00285714285714286	6715	1
2	Drink 1	Intake 1	18	99597	1337701541	/users/cn/jespinosa/phecomp/data/CRG/20120502_FDF_CRG/20120502_FDF_CRG/20120521_FDF_CRG_c12.mtb	1331	NA	WWFF	water	1	99579	1337701523	1	0.04	0.00222222222222222	6716	1
2	Drink 2	Intake 2	17	99752	1337701696	/users/cn/jespinosa/phecomp/data/CRG/20120502_FDF_CRG/20120502_FDF_CRG/20120521_FDF_CRG_c12.mtb	2027	NA	WWFF	water	2	99735	1337701679	1	0.02	0.00117647058823529	6717	1
2	Food 2	Intake 4	12	99841	1337701785	/users/cn/jespinosa/phecomp/data/CRG/20120502_FDF_CRG/20120502_FDF_CRG/20120521_FDF_CRG_c12.mtb	7315	125	WWFF	food_fat	4	99829	1337701773	1	0.04	0.00333333333333333	6718	1
2	Drink 2	Intake 2	17	99879	1337701823	/users/cn/jespinosa/phecomp/data/CRG/20120502_FDF_CRG/20120502_FDF_CRG/20120521_FDF_CRG_c12.mtb	2028	NA	WWFF	water	2	99862	1337701806	1	0.04	0.00235294117647059	6719	1
2	Food 2	Intake 4	14	99980	1337701924	/users/cn/jespinosa/phecomp/data/CRG/20120502_FDF_CRG/20120502_FDF_CRG/20120521_FDF_CRG_c12.mtb	7317	227	WWFF	food_fat	4	99966	1337701910	1	0.0599999999999996	0.00428571428571426	6720	1
2	Food 2	Intake 4	57	100264	1337702208	/users/cn/jespinosa/phecomp/data/CRG/20120502_FDF_CRG/20120502_FDF_CRG/20120521_FDF_CRG_c12.mtb	7321	371	WWFF	food_fat	4	100207	1337702151	1	0.0200000000000005	0.000350877192982465	6721	1
2	Food 2	Intake 4	17	100652	1337702596	/users/cn/jespinosa/phecomp/data/CRG/20120502_FDF_CRG/20120502_FDF_CRG/20120521_FDF_CRG_c12.mtb	7322	4022	WWFF	food_fat	4	100635	1337702579	1	0.0399999999999991	0.00235294117647054	6722	1
2	Food 2	Intake 4	51	104725	1337706669	/users/cn/jespinosa/phecomp/data/CRG/20120502_FDF_CRG/20120502_FDF_CRG/20120521_FDF_CRG_c12.mtb	7323	3288	WWFF	food_fat	4	104674	1337706618	1	0.12	0.00235294117647059	6723	1
2	Food 2	Intake 4	31	108044	1337709988	/users/cn/jespinosa/phecomp/data/CRG/20120502_FDF_CRG/20120502_FDF_CRG/20120521_FDF_CRG_c12.mtb	7324	1224	WWFF	food_fat	4	108013	1337709957	1	0.0200000000000005	0.000645161290322597	6724	1
2	Drink 2	Intake 2	15	108115	1337710059	/users/cn/jespinosa/phecomp/data/CRG/20120502_FDF_CRG/20120502_FDF_CRG/20120521_FDF_CRG_c12.mtb	2030	NA	WWFF	water	2	108100	1337710044	1	0.04	0.00266666666666667	6725	1
2	Food 2	Intake 4	13	109281	1337711225	/users/cn/jespinosa/phecomp/data/CRG/20120502_FDF_CRG/20120502_FDF_CRG/20120521_FDF_CRG_c12.mtb	7325	1211	WWFF	food_fat	4	109268	1337711212	1	0.04	0.00307692307692308	6726	1
2	Food 2	Intake 4	17	110509	1337712453	/users/cn/jespinosa/phecomp/data/CRG/20120502_FDF_CRG/20120502_FDF_CRG/20120521_FDF_CRG_c12.mtb	7328	416	WWFF	food_fat	4	110492	1337712436	1	0.0200000000000005	0.00117647058823532	6727	1
2	Food 2	Intake 4	15	110940	1337712884	/users/cn/jespinosa/phecomp/data/CRG/20120502_FDF_CRG/20120502_FDF_CRG/20120521_FDF_CRG_c12.mtb	7330	2163	WWFF	food_fat	4	110925	1337712869	1	0.0200000000000005	0.00133333333333337	6728	1
2	Drink 2	Intake 2	51	111453	1337713397	/users/cn/jespinosa/phecomp/data/CRG/20120502_FDF_CRG/20120502_FDF_CRG/20120521_FDF_CRG_c12.mtb	2035	NA	WWFF	water	2	111402	1337713346	1	0.04	0.000784313725490196	6729	1
2	Drink 2	Intake 2	16	112005	1337713949	/users/cn/jespinosa/phecomp/data/CRG/20120502_FDF_CRG/20120502_FDF_CRG/20120521_FDF_CRG_c12.mtb	2036	NA	WWFF	water	2	111989	1337713933	1	0.04	0.0025	6730	1
2	Food 2	Intake 4	15	113118	1337715062	/users/cn/jespinosa/phecomp/data/CRG/20120502_FDF_CRG/20120502_FDF_CRG/20120521_FDF_CRG_c12.mtb	7333	440	WWFF	food_fat	4	113103	1337715047	1	0.04	0.00266666666666667	6731	1
2	Food 1	Intake 3	11	113569	1337715513	/users/cn/jespinosa/phecomp/data/CRG/20120502_FDF_CRG/20120502_FDF_CRG/20120521_FDF_CRG_c12.mtb	5724	436	WWFF	food_fat	3	113558	1337715502	1	0.0200000000000005	0.00181818181818186	6732	1
2	Drink 2	Intake 2	17	113881	1337715825	/users/cn/jespinosa/phecomp/data/CRG/20120502_FDF_CRG/20120502_FDF_CRG/20120521_FDF_CRG_c12.mtb	2037	NA	WWFF	water	2	113864	1337715808	1	0.02	0.00117647058823529	6733	1
2	Food 2	Intake 4	15	114020	1337715964	/users/cn/jespinosa/phecomp/data/CRG/20120502_FDF_CRG/20120502_FDF_CRG/20120521_FDF_CRG_c12.mtb	7335	1936	WWFF	food_fat	4	114005	1337715949	1	0.04	0.00266666666666667	6734	1
2	Food 2	Intake 4	15	115971	1337717915	/users/cn/jespinosa/phecomp/data/CRG/20120502_FDF_CRG/20120502_FDF_CRG/20120521_FDF_CRG_c12.mtb	7336	3206	WWFF	food_fat	4	115956	1337717900	1	0.04	0.00266666666666667	6735	1
2	Food 2	Intake 4	15	119192	1337721136	/users/cn/jespinosa/phecomp/data/CRG/20120502_FDF_CRG/20120502_FDF_CRG/20120521_FDF_CRG_c12.mtb	7337	9	WWFF	food_fat	4	119177	1337721121	1	0.0200000000000005	0.00133333333333337	6736	1
2	Food 2	Intake 4	14	119215	1337721159	/users/cn/jespinosa/phecomp/data/CRG/20120502_FDF_CRG/20120502_FDF_CRG/20120521_FDF_CRG_c12.mtb	7338	3313	WWFF	food_fat	4	119201	1337721145	1	0.04	0.00285714285714286	6737	1
2	Drink 2	Intake 2	13	120554	1337722498	/users/cn/jespinosa/phecomp/data/CRG/20120502_FDF_CRG/20120502_FDF_CRG/20120521_FDF_CRG_c12.mtb	2038	NA	WWFF	water	2	120541	1337722485	1	0.02	0.00153846153846154	6738	1
2	Food 2	Intake 4	15	122543	1337724487	/users/cn/jespinosa/phecomp/data/CRG/20120502_FDF_CRG/20120502_FDF_CRG/20120521_FDF_CRG_c12.mtb	7340	91	WWFF	food_fat	4	122528	1337724472	1	0.04	0.00266666666666667	6739	1
2	Food 2	Intake 4	15	122649	1337724593	/users/cn/jespinosa/phecomp/data/CRG/20120502_FDF_CRG/20120502_FDF_CRG/20120521_FDF_CRG_c12.mtb	7341	1832	WWFF	food_fat	4	122634	1337724578	1	0.0599999999999996	0.00399999999999997	6740	1
2	Drink 1	Intake 1	17	123269	1337725213	/users/cn/jespinosa/phecomp/data/CRG/20120502_FDF_CRG/20120502_FDF_CRG/20120521_FDF_CRG_c12.mtb	1334	NA	WWFF	water	1	123252	1337725196	1	0.02	0.00117647058823529	6741	1
2	Drink 2	Intake 2	16	123390	1337725334	/users/cn/jespinosa/phecomp/data/CRG/20120502_FDF_CRG/20120502_FDF_CRG/20120521_FDF_CRG_c12.mtb	2041	NA	WWFF	water	2	123374	1337725318	1	0.02	0.00125	6742	1
2	Drink 2	Intake 2	55	123461	1337725405	/users/cn/jespinosa/phecomp/data/CRG/20120502_FDF_CRG/20120502_FDF_CRG/20120521_FDF_CRG_c12.mtb	2042	NA	WWFF	water	2	123406	1337725350	1	0.02	0.000363636363636364	6743	1
2	Drink 2	Intake 2	16	123681	1337725625	/users/cn/jespinosa/phecomp/data/CRG/20120502_FDF_CRG/20120502_FDF_CRG/20120521_FDF_CRG_c12.mtb	2043	NA	WWFF	water	2	123665	1337725609	1	0.04	0.0025	6744	1
2	Drink 2	Intake 2	12	124010	1337725954	/users/cn/jespinosa/phecomp/data/CRG/20120502_FDF_CRG/20120502_FDF_CRG/20120521_FDF_CRG_c12.mtb	2044	NA	WWFF	water	2	123998	1337725942	1	0.04	0.00333333333333333	6745	1
2	Drink 1	Intake 1	21	124331	1337726275	/users/cn/jespinosa/phecomp/data/CRG/20120502_FDF_CRG/20120502_FDF_CRG/20120521_FDF_CRG_c12.mtb	1335	NA	WWFF	water	1	124310	1337726254	1	0.04	0.0019047619047619	6746	1
2	Drink 2	Intake 2	13	124346	1337726290	/users/cn/jespinosa/phecomp/data/CRG/20120502_FDF_CRG/20120502_FDF_CRG/20120521_FDF_CRG_c12.mtb	2045	NA	WWFF	water	2	124333	1337726277	1	0.04	0.00307692307692308	6747	1
2	Food 2	Intake 4	35	124516	1337726460	/users/cn/jespinosa/phecomp/data/CRG/20120502_FDF_CRG/20120502_FDF_CRG/20120521_FDF_CRG_c12.mtb	7347	1718	WWFF	food_fat	4	124481	1337726425	1	0.04	0.00114285714285714	6748	1
2	Drink 2	Intake 2	28	126044	1337727988	/users/cn/jespinosa/phecomp/data/CRG/20120502_FDF_CRG/20120502_FDF_CRG/20120521_FDF_CRG_c12.mtb	2046	NA	WWFF	water	2	126016	1337727960	1	0.04	0.00142857142857143	6749	1
2	Food 2	Intake 4	15	126249	1337728193	/users/cn/jespinosa/phecomp/data/CRG/20120502_FDF_CRG/20120502_FDF_CRG/20120521_FDF_CRG_c12.mtb	7349	1734	WWFF	food_fat	4	126234	1337728178	1	0.0800000000000001	0.00533333333333334	6750	1
2	Food 2	Intake 4	15	127998	1337729942	/users/cn/jespinosa/phecomp/data/CRG/20120502_FDF_CRG/20120502_FDF_CRG/20120521_FDF_CRG_c12.mtb	7350	3479	WWFF	food_fat	4	127983	1337729927	1	0.0800000000000001	0.00533333333333334	6751	1
2	Drink 2	Intake 2	13	128496	1337730440	/users/cn/jespinosa/phecomp/data/CRG/20120502_FDF_CRG/20120502_FDF_CRG/20120521_FDF_CRG_c12.mtb	2047	NA	WWFF	water	2	128483	1337730427	1	0.04	0.00307692307692308	6752	1
2	Drink 2	Intake 2	15	131386	1337733330	/users/cn/jespinosa/phecomp/data/CRG/20120502_FDF_CRG/20120502_FDF_CRG/20120521_FDF_CRG_c12.mtb	2048	NA	WWFF	water	2	131371	1337733315	1	0.04	0.00266666666666667	6753	1
2	Food 2	Intake 4	30	131507	1337733451	/users/cn/jespinosa/phecomp/data/CRG/20120502_FDF_CRG/20120502_FDF_CRG/20120521_FDF_CRG_c12.mtb	7352	3484	WWFF	food_fat	4	131477	1337733421	1	0.0599999999999996	0.00199999999999999	6754	1
2	Drink 2	Intake 2	41	132243	1337734187	/users/cn/jespinosa/phecomp/data/CRG/20120502_FDF_CRG/20120502_FDF_CRG/20120521_FDF_CRG_c12.mtb	2049	NA	WWFF	water	2	132202	1337734146	1	0.0599999999999996	0.00146341463414633	6755	1
2	Drink 2	Intake 2	14	133231	1337735175	/users/cn/jespinosa/phecomp/data/CRG/20120502_FDF_CRG/20120502_FDF_CRG/20120521_FDF_CRG_c12.mtb	2050	NA	WWFF	water	2	133217	1337735161	1	0.04	0.00285714285714286	6756	1
2	Drink 2	Intake 2	13	133673	1337735617	/users/cn/jespinosa/phecomp/data/CRG/20120502_FDF_CRG/20120502_FDF_CRG/20120521_FDF_CRG_c12.mtb	2051	NA	WWFF	water	2	133660	1337735604	1	0.04	0.00307692307692308	6757	1
2	Food 2	Intake 4	15	135006	1337736950	/users/cn/jespinosa/phecomp/data/CRG/20120502_FDF_CRG/20120502_FDF_CRG/20120521_FDF_CRG_c12.mtb	7359	4246	WWFF	food_fat	4	134991	1337736935	1	0.04	0.00266666666666667	6758	1
2	Food 2	Intake 4	16	139268	1337741212	/users/cn/jespinosa/phecomp/data/CRG/20120502_FDF_CRG/20120502_FDF_CRG/20120521_FDF_CRG_c12.mtb	7360	469	WWFF	food_fat	4	139252	1337741196	1	0.04	0.0025	6759	1
2	Drink 2	Intake 2	28	139393	1337741337	/users/cn/jespinosa/phecomp/data/CRG/20120502_FDF_CRG/20120502_FDF_CRG/20120521_FDF_CRG_c12.mtb	2052	NA	WWFF	water	2	139365	1337741309	1	0.04	0.00142857142857143	6760	1
2	Drink 1	Intake 1	24	139501	1337741445	/users/cn/jespinosa/phecomp/data/CRG/20120502_FDF_CRG/20120502_FDF_CRG/20120521_FDF_CRG_c12.mtb	1337	NA	WWFF	water	1	139477	1337741421	1	0.02	0.000833333333333333	6761	1
2	Drink 2	Intake 2	15	139552	1337741496	/users/cn/jespinosa/phecomp/data/CRG/20120502_FDF_CRG/20120502_FDF_CRG/20120521_FDF_CRG_c12.mtb	2053	NA	WWFF	water	2	139537	1337741481	1	0.02	0.00133333333333333	6762	1
2	Food 2	Intake 4	31	139768	1337741712	/users/cn/jespinosa/phecomp/data/CRG/20120502_FDF_CRG/20120502_FDF_CRG/20120521_FDF_CRG_c12.mtb	7362	2556	WWFF	food_fat	4	139737	1337741681	1	0.0200000000000005	0.000645161290322597	6763	1
2	Drink 2	Intake 2	13	139806	1337741750	/users/cn/jespinosa/phecomp/data/CRG/20120502_FDF_CRG/20120502_FDF_CRG/20120521_FDF_CRG_c12.mtb	2054	NA	WWFF	water	2	139793	1337741737	1	0.04	0.00307692307692308	6764	1
2	Food 2	Intake 4	21	142345	1337744289	/users/cn/jespinosa/phecomp/data/CRG/20120502_FDF_CRG/20120502_FDF_CRG/20120521_FDF_CRG_c12.mtb	7363	206	WWFF	food_fat	4	142324	1337744268	1	0.04	0.0019047619047619	6765	1
2	Food 2	Intake 4	15	142566	1337744510	/users/cn/jespinosa/phecomp/data/CRG/20120502_FDF_CRG/20120502_FDF_CRG/20120521_FDF_CRG_c12.mtb	7364	14	WWFF	food_fat	4	142551	1337744495	1	0.0399999999999991	0.00266666666666661	6766	1
2	Food 2	Intake 4	36	142616	1337744560	/users/cn/jespinosa/phecomp/data/CRG/20120502_FDF_CRG/20120502_FDF_CRG/20120521_FDF_CRG_c12.mtb	7365	4354	WWFF	food_fat	4	142580	1337744524	1	0.0200000000000005	0.000555555555555569	6767	1
2	Drink 2	Intake 2	21	142801	1337744745	/users/cn/jespinosa/phecomp/data/CRG/20120502_FDF_CRG/20120502_FDF_CRG/20120521_FDF_CRG_c12.mtb	2055	NA	WWFF	water	2	142780	1337744724	1	0.04	0.0019047619047619	6768	1
2	Food 2	Intake 4	8	146978	1337748922	/users/cn/jespinosa/phecomp/data/CRG/20120502_FDF_CRG/20120502_FDF_CRG/20120521_FDF_CRG_c12.mtb	7370	467	WWFF	food_fat	4	146970	1337748914	1	0.0200000000000005	0.00250000000000006	6769	1
2	Food 1	Intake 3	12	147457	1337749401	/users/cn/jespinosa/phecomp/data/CRG/20120502_FDF_CRG/20120502_FDF_CRG/20120521_FDF_CRG_c12.mtb	5740	938	WWFF	food_fat	3	147445	1337749389	1	0.0200000000000005	0.00166666666666671	6770	1
2	Drink 2	Intake 2	20	148110	1337750054	/users/cn/jespinosa/phecomp/data/CRG/20120502_FDF_CRG/20120502_FDF_CRG/20120521_FDF_CRG_c12.mtb	2056	NA	WWFF	water	2	148090	1337750034	1	0.0600000000000001	0.00300000000000001	6771	1
2	Drink 2	Intake 2	40	148235	1337750179	/users/cn/jespinosa/phecomp/data/CRG/20120502_FDF_CRG/20120502_FDF_CRG/20120521_FDF_CRG_c12.mtb	2057	NA	WWFF	water	2	148195	1337750139	1	0.04	0.001	6772	1
2	Food 2	Intake 4	15	148410	1337750354	/users/cn/jespinosa/phecomp/data/CRG/20120502_FDF_CRG/20120502_FDF_CRG/20120521_FDF_CRG_c12.mtb	7375	3191	WWFF	food_fat	4	148395	1337750339	1	0.0800000000000001	0.00533333333333334	6773	1
2	Drink 1	Intake 1	15	149392	1337751336	/users/cn/jespinosa/phecomp/data/CRG/20120502_FDF_CRG/20120502_FDF_CRG/20120521_FDF_CRG_c12.mtb	1339	NA	WWFF	water	1	149377	1337751321	1	0.04	0.00266666666666667	6774	1
2	Drink 2	Intake 2	10	151601	1337753545	/users/cn/jespinosa/phecomp/data/CRG/20120502_FDF_CRG/20120502_FDF_CRG/20120521_FDF_CRG_c12.mtb	2059	NA	WWFF	water	2	151591	1337753535	1	0.02	0.002	6775	1
2	Food 2	Intake 4	37	151638	1337753582	/users/cn/jespinosa/phecomp/data/CRG/20120502_FDF_CRG/20120502_FDF_CRG/20120521_FDF_CRG_c12.mtb	7379	138	WWFF	food_fat	4	151601	1337753545	1	0.0200000000000014	0.000540540540540578	6776	1
2	Food 1	Intake 3	52	151828	1337753772	/users/cn/jespinosa/phecomp/data/CRG/20120502_FDF_CRG/20120502_FDF_CRG/20120521_FDF_CRG_c12.mtb	5744	1012	WWFF	food_fat	3	151776	1337753720	1	0.0200000000000005	0.000384615384615394	6777	1
2	Drink 2	Intake 2	14	152029	1337753973	/users/cn/jespinosa/phecomp/data/CRG/20120502_FDF_CRG/20120502_FDF_CRG/20120521_FDF_CRG_c12.mtb	2060	NA	WWFF	water	2	152015	1337753959	1	0.0600000000000001	0.00428571428571429	6778	1
2	Drink 2	Intake 2	12	152579	1337754523	/users/cn/jespinosa/phecomp/data/CRG/20120502_FDF_CRG/20120502_FDF_CRG/20120521_FDF_CRG_c12.mtb	2061	NA	WWFF	water	2	152567	1337754511	1	0.02	0.00166666666666667	6779	1
2	Food 2	Intake 4	18	152858	1337754802	/users/cn/jespinosa/phecomp/data/CRG/20120502_FDF_CRG/20120502_FDF_CRG/20120521_FDF_CRG_c12.mtb	7380	4456	WWFF	food_fat	4	152840	1337754784	1	0.0399999999999991	0.00222222222222217	6780	1
2	Food 2	Intake 4	29	157343	1337759287	/users/cn/jespinosa/phecomp/data/CRG/20120502_FDF_CRG/20120502_FDF_CRG/20120521_FDF_CRG_c12.mtb	7382	LAST	WWFF	food_fat	4	157314	1337759258	1	0.0400000000000009	0.00137931034482762	6781	1
2	Drink 2	Intake 2	36	161299	1337763243	/users/cn/jespinosa/phecomp/data/CRG/20120502_FDF_CRG/20120502_FDF_CRG/20120521_FDF_CRG_c12.mtb	2062	LAST	WWFF	water	2	161263	1337763207	1	0.0799999999999996	0.00222222222222221	6782	1
