CAGE	Caption	Channel	Duration	EndL	EndT	File	Index	InterTime	Name	Nature	SlotI	StartL	StartT	Type	Value	Velocity	linen	period
1	Drink 1	Intake 1	16	969	1335958977	/users/cn/jespinosa/phecomp/data/CRG/20120502_FDF_CRG/20120502_FDF_CRG/20120502_FDF_CRG_c12.mtb	245	NA	WWSS	water	1	953	1335958961	1	0.02	0.00125	2017	1
1	Food 1	Intake 3	94	1569	1335959577	/users/cn/jespinosa/phecomp/data/CRG/20120502_FDF_CRG/20120502_FDF_CRG/20120502_FDF_CRG_c12.mtb	207	700	WWSS	food_sc	3	1475	1335959483	1	0.04	0.000425531914893617	2018	1
1	Food 1	Intake 3	86	2355	1335960363	/users/cn/jespinosa/phecomp/data/CRG/20120502_FDF_CRG/20120502_FDF_CRG/20120502_FDF_CRG_c12.mtb	209	415	WWSS	food_sc	3	2269	1335960277	1	0.02	0.000232558139534884	2019	1
1	Food 1	Intake 3	28	2798	1335960806	/users/cn/jespinosa/phecomp/data/CRG/20120502_FDF_CRG/20120502_FDF_CRG/20120502_FDF_CRG_c12.mtb	211	6695	WWSS	food_sc	3	2770	1335960778	1	0.02	0.000714285714285714	2020	1
1	Drink 1	Intake 1	17	2944	1335960952	/users/cn/jespinosa/phecomp/data/CRG/20120502_FDF_CRG/20120502_FDF_CRG/20120502_FDF_CRG_c12.mtb	270	NA	WWSS	water	1	2927	1335960935	1	0.02	0.00117647058823529	2021	1
1	Drink 1	Intake 1	20	3045	1335961053	/users/cn/jespinosa/phecomp/data/CRG/20120502_FDF_CRG/20120502_FDF_CRG/20120502_FDF_CRG_c12.mtb	271	NA	WWSS	water	1	3025	1335961033	1	0.02	0.001	2022	1
1	Food 1	Intake 3	311	9804	1335967812	/users/cn/jespinosa/phecomp/data/CRG/20120502_FDF_CRG/20120502_FDF_CRG/20120502_FDF_CRG_c12.mtb	214	11	WWSS	food_sc	3	9493	1335967501	1	0.1	0.000321543408360129	2023	1
1	Food 1	Intake 3	52	9867	1335967875	/users/cn/jespinosa/phecomp/data/CRG/20120502_FDF_CRG/20120502_FDF_CRG/20120502_FDF_CRG_c12.mtb	215	4846	WWSS	food_sc	3	9815	1335967823	1	0.02	0.000384615384615385	2024	1
1	Drink 2	Intake 2	82	11794	1335969802	/users/cn/jespinosa/phecomp/data/CRG/20120502_FDF_CRG/20120502_FDF_CRG/20120502_FDF_CRG_c12.mtb	94	NA	WWSS	water	2	11712	1335969720	1	0.06	0.000731707317073171	2025	1
1	Drink 1	Intake 1	18	14660	1335972668	/users/cn/jespinosa/phecomp/data/CRG/20120502_FDF_CRG/20120502_FDF_CRG/20120502_FDF_CRG_c12.mtb	289	NA	WWSS	water	1	14642	1335972650	1	0.02	0.00111111111111111	2026	1
1	Food 1	Intake 3	294	15007	1335973015	/users/cn/jespinosa/phecomp/data/CRG/20120502_FDF_CRG/20120502_FDF_CRG/20120502_FDF_CRG_c12.mtb	224	4067	WWSS	food_sc	3	14713	1335972721	1	0.1	0.000340136054421769	2027	1
1	Food 1	Intake 3	390	19464	1335977472	/users/cn/jespinosa/phecomp/data/CRG/20120502_FDF_CRG/20120502_FDF_CRG/20120502_FDF_CRG_c12.mtb	226	15	WWSS	food_sc	3	19074	1335977082	1	0.1	0.000256410256410256	2028	1
1	Food 1	Intake 3	279	19758	1335977766	/users/cn/jespinosa/phecomp/data/CRG/20120502_FDF_CRG/20120502_FDF_CRG/20120502_FDF_CRG_c12.mtb	227	54	WWSS	food_sc	3	19479	1335977487	1	0.08	0.00028673835125448	2029	1
1	Food 1	Intake 3	83	19895	1335977903	/users/cn/jespinosa/phecomp/data/CRG/20120502_FDF_CRG/20120502_FDF_CRG/20120502_FDF_CRG_c12.mtb	229	2351	WWSS	food_sc	3	19812	1335977820	1	0.02	0.000240963855421687	2030	1
1	Drink 2	Intake 2	75	19967	1335977975	/users/cn/jespinosa/phecomp/data/CRG/20120502_FDF_CRG/20120502_FDF_CRG/20120502_FDF_CRG_c12.mtb	95	NA	WWSS	water	2	19892	1335977900	1	0.18	0.0024	2031	1
1	Drink 1	Intake 1	34	20552	1335978560	/users/cn/jespinosa/phecomp/data/CRG/20120502_FDF_CRG/20120502_FDF_CRG/20120502_FDF_CRG_c12.mtb	296	NA	WWSS	water	1	20518	1335978526	1	0.06	0.00176470588235294	2032	1
1	Food 1	Intake 3	118	22364	1335980372	/users/cn/jespinosa/phecomp/data/CRG/20120502_FDF_CRG/20120502_FDF_CRG/20120502_FDF_CRG_c12.mtb	230	697	WWSS	food_sc	3	22246	1335980254	1	0.02	0.000169491525423729	2033	1
1	Drink 1	Intake 1	163	22754	1335980762	/users/cn/jespinosa/phecomp/data/CRG/20120502_FDF_CRG/20120502_FDF_CRG/20120502_FDF_CRG_c12.mtb	298	NA	WWSS	water	1	22591	1335980599	1	0.02	0.000122699386503067	2034	1
1	Food 1	Intake 3	371	23432	1335981440	/users/cn/jespinosa/phecomp/data/CRG/20120502_FDF_CRG/20120502_FDF_CRG/20120502_FDF_CRG_c12.mtb	232	743	WWSS	food_sc	3	23061	1335981069	1	0.0599999999999999	0.000161725067385444	2035	1
1	Food 1	Intake 3	166	24341	1335982349	/users/cn/jespinosa/phecomp/data/CRG/20120502_FDF_CRG/20120502_FDF_CRG/20120502_FDF_CRG_c12.mtb	235	1687	WWSS	food_sc	3	24175	1335982183	1	0.04	0.000240963855421687	2036	1
1	Food 1	Intake 3	355	26383	1335984391	/users/cn/jespinosa/phecomp/data/CRG/20120502_FDF_CRG/20120502_FDF_CRG/20120502_FDF_CRG_c12.mtb	237	310	WWSS	food_sc	3	26028	1335984036	1	0.08	0.000225352112676056	2037	1
1	Food 2	Intake 4	160	26853	1335984861	/users/cn/jespinosa/phecomp/data/CRG/20120502_FDF_CRG/20120502_FDF_CRG/20120502_FDF_CRG_c12.mtb	164	85	WWSS	food_sc	4	26693	1335984701	1	0.08	0.0005	2038	1
1	Food 2	Intake 4	36	26974	1335984982	/users/cn/jespinosa/phecomp/data/CRG/20120502_FDF_CRG/20120502_FDF_CRG/20120502_FDF_CRG_c12.mtb	165	17	WWSS	food_sc	4	26938	1335984946	1	0.02	0.000555555555555556	2039	1
1	Food 1	Intake 3	20	27011	1335985019	/users/cn/jespinosa/phecomp/data/CRG/20120502_FDF_CRG/20120502_FDF_CRG/20120502_FDF_CRG_c12.mtb	238	1132	WWSS	food_sc	3	26991	1335984999	1	0.02	0.001	2040	1
1	Drink 1	Intake 1	45	27140	1335985148	/users/cn/jespinosa/phecomp/data/CRG/20120502_FDF_CRG/20120502_FDF_CRG/20120502_FDF_CRG_c12.mtb	311	NA	WWSS	water	1	27095	1335985103	1	0.06	0.00133333333333333	2041	1
1	Food 2	Intake 4	110	28253	1335986261	/users/cn/jespinosa/phecomp/data/CRG/20120502_FDF_CRG/20120502_FDF_CRG/20120502_FDF_CRG_c12.mtb	175	14	WWSS	food_sc	4	28143	1335986151	1	0.06	0.000545454545454545	2042	1
1	Food 2	Intake 4	55	28322	1335986330	/users/cn/jespinosa/phecomp/data/CRG/20120502_FDF_CRG/20120502_FDF_CRG/20120502_FDF_CRG_c12.mtb	176	11	WWSS	food_sc	4	28267	1335986275	1	0.02	0.000363636363636364	2043	1
1	Food 2	Intake 4	86	28419	1335986427	/users/cn/jespinosa/phecomp/data/CRG/20120502_FDF_CRG/20120502_FDF_CRG/20120502_FDF_CRG_c12.mtb	177	418	WWSS	food_sc	4	28333	1335986341	1	0.02	0.000232558139534884	2044	1
1	Drink 2	Intake 2	31	28443	1335986451	/users/cn/jespinosa/phecomp/data/CRG/20120502_FDF_CRG/20120502_FDF_CRG/20120502_FDF_CRG_c12.mtb	103	NA	WWSS	water	2	28412	1335986420	1	0.08	0.00258064516129032	2045	1
1	Drink 1	Intake 1	12	28545	1335986553	/users/cn/jespinosa/phecomp/data/CRG/20120502_FDF_CRG/20120502_FDF_CRG/20120502_FDF_CRG_c12.mtb	317	NA	WWSS	water	1	28533	1335986541	1	0.02	0.00166666666666667	2046	1
1	Drink 1	Intake 1	12	28836	1335986844	/users/cn/jespinosa/phecomp/data/CRG/20120502_FDF_CRG/20120502_FDF_CRG/20120502_FDF_CRG_c12.mtb	319	NA	WWSS	water	1	28824	1335986832	1	0.02	0.00166666666666667	2047	1
1	Food 2	Intake 4	102	28939	1335986947	/users/cn/jespinosa/phecomp/data/CRG/20120502_FDF_CRG/20120502_FDF_CRG/20120502_FDF_CRG_c12.mtb	179	142	WWSS	food_sc	4	28837	1335986845	1	0.02	0.000196078431372549	2048	1
1	Drink 2	Intake 2	15	29051	1335987059	/users/cn/jespinosa/phecomp/data/CRG/20120502_FDF_CRG/20120502_FDF_CRG/20120502_FDF_CRG_c12.mtb	105	NA	WWSS	water	2	29036	1335987044	1	0.02	0.00133333333333333	2049	1
1	Food 2	Intake 4	134	29215	1335987223	/users/cn/jespinosa/phecomp/data/CRG/20120502_FDF_CRG/20120502_FDF_CRG/20120502_FDF_CRG_c12.mtb	181	201	WWSS	food_sc	4	29081	1335987089	1	0.02	0.000149253731343284	2050	1
1	Food 1	Intake 3	71	29487	1335987495	/users/cn/jespinosa/phecomp/data/CRG/20120502_FDF_CRG/20120502_FDF_CRG/20120502_FDF_CRG_c12.mtb	245	307	WWSS	food_sc	3	29416	1335987424	1	0.02	0.00028169014084507	2051	1
1	Drink 2	Intake 2	28	29566	1335987574	/users/cn/jespinosa/phecomp/data/CRG/20120502_FDF_CRG/20120502_FDF_CRG/20120502_FDF_CRG_c12.mtb	106	NA	WWSS	water	2	29538	1335987546	1	0.04	0.00142857142857143	2052	1
1	Food 2	Intake 4	91	29885	1335987893	/users/cn/jespinosa/phecomp/data/CRG/20120502_FDF_CRG/20120502_FDF_CRG/20120502_FDF_CRG_c12.mtb	186	196	WWSS	food_sc	4	29794	1335987802	1	0.02	0.00021978021978022	2053	1
1	Drink 1	Intake 1	15	29903	1335987911	/users/cn/jespinosa/phecomp/data/CRG/20120502_FDF_CRG/20120502_FDF_CRG/20120502_FDF_CRG_c12.mtb	327	NA	WWSS	water	1	29888	1335987896	1	0.02	0.00133333333333333	2054	1
1	Food 2	Intake 4	46	30127	1335988135	/users/cn/jespinosa/phecomp/data/CRG/20120502_FDF_CRG/20120502_FDF_CRG/20120502_FDF_CRG_c12.mtb	188	119	WWSS	food_sc	4	30081	1335988089	1	0.02	0.000434782608695652	2055	1
1	Food 1	Intake 3	66	30312	1335988320	/users/cn/jespinosa/phecomp/data/CRG/20120502_FDF_CRG/20120502_FDF_CRG/20120502_FDF_CRG_c12.mtb	250	378	WWSS	food_sc	3	30246	1335988254	1	0.02	0.000303030303030303	2056	1
1	Drink 2	Intake 2	23	30329	1335988337	/users/cn/jespinosa/phecomp/data/CRG/20120502_FDF_CRG/20120502_FDF_CRG/20120502_FDF_CRG_c12.mtb	108	NA	WWSS	water	2	30306	1335988314	1	0.06	0.00260869565217391	2057	1
1	Drink 2	Intake 2	29	30372	1335988380	/users/cn/jespinosa/phecomp/data/CRG/20120502_FDF_CRG/20120502_FDF_CRG/20120502_FDF_CRG_c12.mtb	109	NA	WWSS	water	2	30343	1335988351	1	0.02	0.000689655172413793	2058	1
1	Food 1	Intake 3	79	30769	1335988777	/users/cn/jespinosa/phecomp/data/CRG/20120502_FDF_CRG/20120502_FDF_CRG/20120502_FDF_CRG_c12.mtb	253	1053	WWSS	food_sc	3	30690	1335988698	1	0.02	0.000253164556962025	2059	1
1	Drink 2	Intake 2	17	30795	1335988803	/users/cn/jespinosa/phecomp/data/CRG/20120502_FDF_CRG/20120502_FDF_CRG/20120502_FDF_CRG_c12.mtb	110	NA	WWSS	water	2	30778	1335988786	1	0.02	0.00117647058823529	2060	1
1	Drink 2	Intake 2	10	31028	1335989036	/users/cn/jespinosa/phecomp/data/CRG/20120502_FDF_CRG/20120502_FDF_CRG/20120502_FDF_CRG_c12.mtb	111	NA	WWSS	water	2	31018	1335989026	1	0.02	0.002	2061	1
1	Drink 2	Intake 2	33	31075	1335989083	/users/cn/jespinosa/phecomp/data/CRG/20120502_FDF_CRG/20120502_FDF_CRG/20120502_FDF_CRG_c12.mtb	112	NA	WWSS	water	2	31042	1335989050	1	0.02	0.000606060606060606	2062	1
1	Drink 1	Intake 1	88	31355	1335989363	/users/cn/jespinosa/phecomp/data/CRG/20120502_FDF_CRG/20120502_FDF_CRG/20120502_FDF_CRG_c12.mtb	333	NA	WWSS	water	1	31267	1335989275	1	0.02	0.000227272727272727	2063	1
1	Food 2	Intake 4	411	32233	1335990241	/users/cn/jespinosa/phecomp/data/CRG/20120502_FDF_CRG/20120502_FDF_CRG/20120502_FDF_CRG_c12.mtb	194	1228	WWSS	food_sc	4	31822	1335989830	1	0.14	0.000340632603406326	2064	1
1	Drink 1	Intake 1	74	32304	1335990312	/users/cn/jespinosa/phecomp/data/CRG/20120502_FDF_CRG/20120502_FDF_CRG/20120502_FDF_CRG_c12.mtb	339	NA	WWSS	water	1	32230	1335990238	1	0.02	0.00027027027027027	2065	1
1	Drink 2	Intake 2	15	32329	1335990337	/users/cn/jespinosa/phecomp/data/CRG/20120502_FDF_CRG/20120502_FDF_CRG/20120502_FDF_CRG_c12.mtb	114	NA	WWSS	water	2	32314	1335990322	1	0.04	0.00266666666666667	2066	1
1	Drink 1	Intake 1	18	33145	1335991153	/users/cn/jespinosa/phecomp/data/CRG/20120502_FDF_CRG/20120502_FDF_CRG/20120502_FDF_CRG_c12.mtb	351	NA	WWSS	water	1	33127	1335991135	1	0.02	0.00111111111111111	2067	1
1	Drink 1	Intake 1	52	33356	1335991364	/users/cn/jespinosa/phecomp/data/CRG/20120502_FDF_CRG/20120502_FDF_CRG/20120502_FDF_CRG_c12.mtb	354	NA	WWSS	water	1	33304	1335991312	1	0.02	0.000384615384615385	2068	1
1	Food 2	Intake 4	62	33523	1335991531	/users/cn/jespinosa/phecomp/data/CRG/20120502_FDF_CRG/20120502_FDF_CRG/20120502_FDF_CRG_c12.mtb	198	14	WWSS	food_sc	4	33461	1335991469	1	0.02	0.00032258064516129	2069	1
1	Food 2	Intake 4	44	33581	1335991589	/users/cn/jespinosa/phecomp/data/CRG/20120502_FDF_CRG/20120502_FDF_CRG/20120502_FDF_CRG_c12.mtb	199	572	WWSS	food_sc	4	33537	1335991545	1	0.02	0.000454545454545455	2070	1
1	Drink 1	Intake 1	36	34066	1335992074	/users/cn/jespinosa/phecomp/data/CRG/20120502_FDF_CRG/20120502_FDF_CRG/20120502_FDF_CRG_c12.mtb	359	NA	WWSS	water	1	34030	1335992038	1	0.04	0.00111111111111111	2071	1
1	Drink 2	Intake 2	28	34145	1335992153	/users/cn/jespinosa/phecomp/data/CRG/20120502_FDF_CRG/20120502_FDF_CRG/20120502_FDF_CRG_c12.mtb	121	NA	WWSS	water	2	34117	1335992125	1	0.02	0.000714285714285714	2072	1
1	Food 2	Intake 4	186	34339	1335992347	/users/cn/jespinosa/phecomp/data/CRG/20120502_FDF_CRG/20120502_FDF_CRG/20120502_FDF_CRG_c12.mtb	202	33	WWSS	food_sc	4	34153	1335992161	1	0.02	0.00010752688172043	2073	1
1	Food 2	Intake 4	282	34654	1335992662	/users/cn/jespinosa/phecomp/data/CRG/20120502_FDF_CRG/20120502_FDF_CRG/20120502_FDF_CRG_c12.mtb	203	526	WWSS	food_sc	4	34372	1335992380	1	0.1	0.000354609929078014	2074	1
1	Drink 1	Intake 1	42	34690	1335992698	/users/cn/jespinosa/phecomp/data/CRG/20120502_FDF_CRG/20120502_FDF_CRG/20120502_FDF_CRG_c12.mtb	361	NA	WWSS	water	1	34648	1335992656	1	0.08	0.0019047619047619	2075	1
1	Drink 1	Intake 1	22	34840	1335992848	/users/cn/jespinosa/phecomp/data/CRG/20120502_FDF_CRG/20120502_FDF_CRG/20120502_FDF_CRG_c12.mtb	363	NA	WWSS	water	1	34818	1335992826	1	0.02	0.000909090909090909	2076	1
1	Drink 1	Intake 1	17	35072	1335993080	/users/cn/jespinosa/phecomp/data/CRG/20120502_FDF_CRG/20120502_FDF_CRG/20120502_FDF_CRG_c12.mtb	366	NA	WWSS	water	1	35055	1335993063	1	0.04	0.00235294117647059	2077	1
1	Food 2	Intake 4	31	35211	1335993219	/users/cn/jespinosa/phecomp/data/CRG/20120502_FDF_CRG/20120502_FDF_CRG/20120502_FDF_CRG_c12.mtb	204	8	WWSS	food_sc	4	35180	1335993188	1	0.02	0.000645161290322581	2078	1
1	Food 2	Intake 4	135	35354	1335993362	/users/cn/jespinosa/phecomp/data/CRG/20120502_FDF_CRG/20120502_FDF_CRG/20120502_FDF_CRG_c12.mtb	205	877	WWSS	food_sc	4	35219	1335993227	1	0.0600000000000001	0.000444444444444445	2079	1
1	Drink 2	Intake 2	22	35374	1335993382	/users/cn/jespinosa/phecomp/data/CRG/20120502_FDF_CRG/20120502_FDF_CRG/20120502_FDF_CRG_c12.mtb	124	NA	WWSS	water	2	35352	1335993360	1	0.02	0.000909090909090909	2080	1
1	Drink 2	Intake 2	18	35434	1335993442	/users/cn/jespinosa/phecomp/data/CRG/20120502_FDF_CRG/20120502_FDF_CRG/20120502_FDF_CRG_c12.mtb	125	NA	WWSS	water	2	35416	1335993424	1	0.02	0.00111111111111111	2081	1
1	Drink 1	Intake 1	18	35749	1335993757	/users/cn/jespinosa/phecomp/data/CRG/20120502_FDF_CRG/20120502_FDF_CRG/20120502_FDF_CRG_c12.mtb	374	NA	WWSS	water	1	35731	1335993739	1	0.02	0.00111111111111111	2082	1
1	Drink 1	Intake 1	27	35906	1335993914	/users/cn/jespinosa/phecomp/data/CRG/20120502_FDF_CRG/20120502_FDF_CRG/20120502_FDF_CRG_c12.mtb	375	NA	WWSS	water	1	35879	1335993887	1	0.0599999999999999	0.00222222222222222	2083	1
1	Food 2	Intake 4	83	36314	1335994322	/users/cn/jespinosa/phecomp/data/CRG/20120502_FDF_CRG/20120502_FDF_CRG/20120502_FDF_CRG_c12.mtb	206	11	WWSS	food_sc	4	36231	1335994239	1	0.02	0.000240963855421687	2084	1
1	Food 2	Intake 4	124	36449	1335994457	/users/cn/jespinosa/phecomp/data/CRG/20120502_FDF_CRG/20120502_FDF_CRG/20120502_FDF_CRG_c12.mtb	207	1876	WWSS	food_sc	4	36325	1335994333	1	0.0399999999999999	0.00032258064516129	2085	1
1	Food 2	Intake 4	342	38667	1335996675	/users/cn/jespinosa/phecomp/data/CRG/20120502_FDF_CRG/20120502_FDF_CRG/20120502_FDF_CRG_c12.mtb	209	611	WWSS	food_sc	4	38325	1335996333	1	0.0600000000000001	0.000175438596491228	2086	1
1	Drink 2	Intake 2	44	39275	1335997283	/users/cn/jespinosa/phecomp/data/CRG/20120502_FDF_CRG/20120502_FDF_CRG/20120502_FDF_CRG_c12.mtb	130	NA	WWSS	water	2	39231	1335997239	1	0.04	0.000909090909090909	2087	1
1	Food 2	Intake 4	183	39461	1335997469	/users/cn/jespinosa/phecomp/data/CRG/20120502_FDF_CRG/20120502_FDF_CRG/20120502_FDF_CRG_c12.mtb	213	6	WWSS	food_sc	4	39278	1335997286	1	0.0399999999999999	0.000218579234972677	2088	1
1	Food 2	Intake 4	113	39580	1335997588	/users/cn/jespinosa/phecomp/data/CRG/20120502_FDF_CRG/20120502_FDF_CRG/20120502_FDF_CRG_c12.mtb	214	754	WWSS	food_sc	4	39467	1335997475	1	0.02	0.000176991150442478	2089	1
1	Drink 1	Intake 1	21	39795	1335997803	/users/cn/jespinosa/phecomp/data/CRG/20120502_FDF_CRG/20120502_FDF_CRG/20120502_FDF_CRG_c12.mtb	395	NA	WWSS	water	1	39774	1335997782	1	0.02	0.000952380952380952	2090	1
1	Drink 1	Intake 1	52	40117	1335998125	/users/cn/jespinosa/phecomp/data/CRG/20120502_FDF_CRG/20120502_FDF_CRG/20120502_FDF_CRG_c12.mtb	398	NA	WWSS	water	1	40065	1335998073	1	0.0599999999999999	0.00115384615384615	2091	1
1	Food 1	Intake 3	309	40643	1335998651	/users/cn/jespinosa/phecomp/data/CRG/20120502_FDF_CRG/20120502_FDF_CRG/20120502_FDF_CRG_c12.mtb	262	113	WWSS	food_sc	3	40334	1335998342	1	0.12	0.000388349514563107	2092	1
1	Drink 1	Intake 1	33	40668	1335998676	/users/cn/jespinosa/phecomp/data/CRG/20120502_FDF_CRG/20120502_FDF_CRG/20120502_FDF_CRG_c12.mtb	401	NA	WWSS	water	1	40635	1335998643	1	0.0600000000000001	0.00181818181818182	2093	1
1	Drink 2	Intake 2	15	40676	1335998684	/users/cn/jespinosa/phecomp/data/CRG/20120502_FDF_CRG/20120502_FDF_CRG/20120502_FDF_CRG_c12.mtb	132	NA	WWSS	water	2	40661	1335998669	1	0.02	0.00133333333333333	2094	1
1	Food 1	Intake 3	220	40976	1335998984	/users/cn/jespinosa/phecomp/data/CRG/20120502_FDF_CRG/20120502_FDF_CRG/20120502_FDF_CRG_c12.mtb	263	748	WWSS	food_sc	3	40756	1335998764	1	0.08	0.000363636363636364	2095	1
1	Drink 2	Intake 2	55	41022	1335999030	/users/cn/jespinosa/phecomp/data/CRG/20120502_FDF_CRG/20120502_FDF_CRG/20120502_FDF_CRG_c12.mtb	133	NA	WWSS	water	2	40967	1335998975	1	0.0800000000000001	0.00145454545454546	2096	1
1	Drink 1	Intake 1	34	41337	1335999345	/users/cn/jespinosa/phecomp/data/CRG/20120502_FDF_CRG/20120502_FDF_CRG/20120502_FDF_CRG_c12.mtb	406	NA	WWSS	water	1	41303	1335999311	1	0.02	0.000588235294117647	2097	1
1	Food 1	Intake 3	204	41928	1335999936	/users/cn/jespinosa/phecomp/data/CRG/20120502_FDF_CRG/20120502_FDF_CRG/20120502_FDF_CRG_c12.mtb	266	143	WWSS	food_sc	3	41724	1335999732	1	0.02	9.80392156862745e-05	2098	1
1	Drink 1	Intake 1	18	41964	1335999972	/users/cn/jespinosa/phecomp/data/CRG/20120502_FDF_CRG/20120502_FDF_CRG/20120502_FDF_CRG_c12.mtb	412	NA	WWSS	water	1	41946	1335999954	1	0.02	0.00111111111111111	2099	1
1	Food 2	Intake 4	313	42384	1336000392	/users/cn/jespinosa/phecomp/data/CRG/20120502_FDF_CRG/20120502_FDF_CRG/20120502_FDF_CRG_c12.mtb	225	265	WWSS	food_sc	4	42071	1336000079	1	0.1	0.000319488817891374	2100	1
1	Drink 1	Intake 1	73	42448	1336000456	/users/cn/jespinosa/phecomp/data/CRG/20120502_FDF_CRG/20120502_FDF_CRG/20120502_FDF_CRG_c12.mtb	415	NA	WWSS	water	1	42375	1336000383	1	0.0800000000000001	0.00109589041095891	2101	1
1	Drink 1	Intake 1	33	42492	1336000500	/users/cn/jespinosa/phecomp/data/CRG/20120502_FDF_CRG/20120502_FDF_CRG/20120502_FDF_CRG_c12.mtb	416	NA	WWSS	water	1	42459	1336000467	1	0.02	0.000606060606060606	2102	1
1	Food 2	Intake 4	107	42756	1336000764	/users/cn/jespinosa/phecomp/data/CRG/20120502_FDF_CRG/20120502_FDF_CRG/20120502_FDF_CRG_c12.mtb	226	7745	WWSS	food_sc	4	42649	1336000657	1	0.04	0.000373831775700935	2103	1
1	Drink 1	Intake 1	94	42843	1336000851	/users/cn/jespinosa/phecomp/data/CRG/20120502_FDF_CRG/20120502_FDF_CRG/20120502_FDF_CRG_c12.mtb	420	NA	WWSS	water	1	42749	1336000757	1	0.08	0.000851063829787234	2104	1
1	Drink 1	Intake 1	52	43051	1336001059	/users/cn/jespinosa/phecomp/data/CRG/20120502_FDF_CRG/20120502_FDF_CRG/20120502_FDF_CRG_c12.mtb	424	NA	WWSS	water	1	42999	1336001007	1	0.02	0.000384615384615385	2105	1
1	Drink 2	Intake 2	17	43492	1336001500	/users/cn/jespinosa/phecomp/data/CRG/20120502_FDF_CRG/20120502_FDF_CRG/20120502_FDF_CRG_c12.mtb	136	NA	WWSS	water	2	43475	1336001483	1	0.02	0.00117647058823529	2106	1
1	Drink 1	Intake 1	17	44478	1336002486	/users/cn/jespinosa/phecomp/data/CRG/20120502_FDF_CRG/20120502_FDF_CRG/20120502_FDF_CRG_c12.mtb	435	NA	WWSS	water	1	44461	1336002469	1	0.02	0.00117647058823529	2107	1
1	Food 1	Intake 3	340	50841	1336008849	/users/cn/jespinosa/phecomp/data/CRG/20120502_FDF_CRG/20120502_FDF_CRG/20120502_FDF_CRG_c12.mtb	269	COLL	WWSS	food_sc	3	50501	1336008509	1	0.1	0.000294117647058824	2108	1
1	Food 2	Intake 4	17	50557	1336008565	/users/cn/jespinosa/phecomp/data/CRG/20120502_FDF_CRG/20120502_FDF_CRG/20120502_FDF_CRG_c12.mtb	233	353	WWSS	food_sc	4	50540	1336008548	1	0.02	0.00117647058823529	2109	1
1	Food 1	Intake 3	274	51184	1336009192	/users/cn/jespinosa/phecomp/data/CRG/20120502_FDF_CRG/20120502_FDF_CRG/20120502_FDF_CRG_c12.mtb	271	370	WWSS	food_sc	3	50910	1336008918	1	0.0599999999999998	0.00021897810218978	2110	1
1	Drink 1	Intake 1	26	51207	1336009215	/users/cn/jespinosa/phecomp/data/CRG/20120502_FDF_CRG/20120502_FDF_CRG/20120502_FDF_CRG_c12.mtb	446	NA	WWSS	water	1	51181	1336009189	1	0.0600000000000001	0.00230769230769231	2111	1
1	Drink 2	Intake 2	24	51440	1336009448	/users/cn/jespinosa/phecomp/data/CRG/20120502_FDF_CRG/20120502_FDF_CRG/20120502_FDF_CRG_c12.mtb	138	NA	WWSS	water	2	51416	1336009424	1	0.04	0.00166666666666667	2112	1
1	Drink 2	Intake 2	15	51525	1336009533	/users/cn/jespinosa/phecomp/data/CRG/20120502_FDF_CRG/20120502_FDF_CRG/20120502_FDF_CRG_c12.mtb	139	NA	WWSS	water	2	51510	1336009518	1	0.02	0.00133333333333333	2113	1
1	Food 2	Intake 4	232	51786	1336009794	/users/cn/jespinosa/phecomp/data/CRG/20120502_FDF_CRG/20120502_FDF_CRG/20120502_FDF_CRG_c12.mtb	237	237	WWSS	food_sc	4	51554	1336009562	1	0.02	8.62068965517241e-05	2114	1
1	Drink 2	Intake 2	42	51820	1336009828	/users/cn/jespinosa/phecomp/data/CRG/20120502_FDF_CRG/20120502_FDF_CRG/20120502_FDF_CRG_c12.mtb	140	NA	WWSS	water	2	51778	1336009786	1	0.12	0.00285714285714286	2115	1
1	Food 1	Intake 3	119	52142	1336010150	/users/cn/jespinosa/phecomp/data/CRG/20120502_FDF_CRG/20120502_FDF_CRG/20120502_FDF_CRG_c12.mtb	275	144	WWSS	food_sc	3	52023	1336010031	1	0.04	0.000336134453781513	2116	1
1	Drink 1	Intake 1	29	52176	1336010184	/users/cn/jespinosa/phecomp/data/CRG/20120502_FDF_CRG/20120502_FDF_CRG/20120502_FDF_CRG_c12.mtb	453	NA	WWSS	water	1	52147	1336010155	1	0.04	0.00137931034482759	2117	1
1	Food 1	Intake 3	195	52481	1336010489	/users/cn/jespinosa/phecomp/data/CRG/20120502_FDF_CRG/20120502_FDF_CRG/20120502_FDF_CRG_c12.mtb	278	450	WWSS	food_sc	3	52286	1336010294	1	0.0800000000000001	0.000410256410256411	2118	1
1	Drink 1	Intake 1	36	52513	1336010521	/users/cn/jespinosa/phecomp/data/CRG/20120502_FDF_CRG/20120502_FDF_CRG/20120502_FDF_CRG_c12.mtb	455	NA	WWSS	water	1	52477	1336010485	1	0.0599999999999998	0.00166666666666666	2119	1
1	Drink 2	Intake 2	16	52627	1336010635	/users/cn/jespinosa/phecomp/data/CRG/20120502_FDF_CRG/20120502_FDF_CRG/20120502_FDF_CRG_c12.mtb	141	NA	WWSS	water	2	52611	1336010619	1	0.04	0.0025	2120	1
1	Drink 2	Intake 2	27	52861	1336010869	/users/cn/jespinosa/phecomp/data/CRG/20120502_FDF_CRG/20120502_FDF_CRG/20120502_FDF_CRG_c12.mtb	142	NA	WWSS	water	2	52834	1336010842	1	0.04	0.00148148148148148	2121	1
1	Food 1	Intake 3	81	53012	1336011020	/users/cn/jespinosa/phecomp/data/CRG/20120502_FDF_CRG/20120502_FDF_CRG/20120502_FDF_CRG_c12.mtb	279	9	WWSS	food_sc	3	52931	1336010939	1	0.04	0.000493827160493827	2122	1
1	Food 1	Intake 3	56	53077	1336011085	/users/cn/jespinosa/phecomp/data/CRG/20120502_FDF_CRG/20120502_FDF_CRG/20120502_FDF_CRG_c12.mtb	280	75	WWSS	food_sc	3	53021	1336011029	1	0.0399999999999998	0.000714285714285711	2123	1
1	Drink 1	Intake 1	30	53097	1336011105	/users/cn/jespinosa/phecomp/data/CRG/20120502_FDF_CRG/20120502_FDF_CRG/20120502_FDF_CRG_c12.mtb	459	NA	WWSS	water	1	53067	1336011075	1	0.04	0.00133333333333333	2124	1
1	Food 2	Intake 4	245	53397	1336011405	/users/cn/jespinosa/phecomp/data/CRG/20120502_FDF_CRG/20120502_FDF_CRG/20120502_FDF_CRG_c12.mtb	244	260	WWSS	food_sc	4	53152	1336011160	1	0.0600000000000001	0.000244897959183674	2125	1
1	Drink 1	Intake 1	59	53451	1336011459	/users/cn/jespinosa/phecomp/data/CRG/20120502_FDF_CRG/20120502_FDF_CRG/20120502_FDF_CRG_c12.mtb	460	NA	WWSS	water	1	53392	1336011400	1	0.12	0.00203389830508475	2126	1
1	Food 2	Intake 4	112	53769	1336011777	/users/cn/jespinosa/phecomp/data/CRG/20120502_FDF_CRG/20120502_FDF_CRG/20120502_FDF_CRG_c12.mtb	246	12	WWSS	food_sc	4	53657	1336011665	1	0.02	0.000178571428571429	2127	1
1	Food 1	Intake 3	47	53828	1336011836	/users/cn/jespinosa/phecomp/data/CRG/20120502_FDF_CRG/20120502_FDF_CRG/20120502_FDF_CRG_c12.mtb	281	6	WWSS	food_sc	3	53781	1336011789	1	0.02	0.000425531914893617	2128	1
1	Food 1	Intake 3	199	54033	1336012041	/users/cn/jespinosa/phecomp/data/CRG/20120502_FDF_CRG/20120502_FDF_CRG/20120502_FDF_CRG_c12.mtb	282	895	WWSS	food_sc	3	53834	1336011842	1	0.02	0.000100502512562814	2129	1
1	Drink 1	Intake 1	47	54123	1336012131	/users/cn/jespinosa/phecomp/data/CRG/20120502_FDF_CRG/20120502_FDF_CRG/20120502_FDF_CRG_c12.mtb	465	NA	WWSS	water	1	54076	1336012084	1	0.02	0.000425531914893617	2130	1
1	Drink 2	Intake 2	18	54135	1336012143	/users/cn/jespinosa/phecomp/data/CRG/20120502_FDF_CRG/20120502_FDF_CRG/20120502_FDF_CRG_c12.mtb	143	NA	WWSS	water	2	54117	1336012125	1	0.02	0.00111111111111111	2131	1
1	Drink 2	Intake 2	17	54462	1336012470	/users/cn/jespinosa/phecomp/data/CRG/20120502_FDF_CRG/20120502_FDF_CRG/20120502_FDF_CRG_c12.mtb	145	NA	WWSS	water	2	54445	1336012453	1	0.02	0.00117647058823529	2132	1
1	Food 1	Intake 3	36	54964	1336012972	/users/cn/jespinosa/phecomp/data/CRG/20120502_FDF_CRG/20120502_FDF_CRG/20120502_FDF_CRG_c12.mtb	284	685	WWSS	food_sc	3	54928	1336012936	1	0.02	0.000555555555555556	2133	1
1	Drink 2	Intake 2	22	55038	1336013046	/users/cn/jespinosa/phecomp/data/CRG/20120502_FDF_CRG/20120502_FDF_CRG/20120502_FDF_CRG_c12.mtb	146	NA	WWSS	water	2	55016	1336013024	1	0.0399999999999998	0.00181818181818181	2134	1
1	Food 1	Intake 3	39	55688	1336013696	/users/cn/jespinosa/phecomp/data/CRG/20120502_FDF_CRG/20120502_FDF_CRG/20120502_FDF_CRG_c12.mtb	285	4808	WWSS	food_sc	3	55649	1336013657	1	0.02	0.000512820512820513	2135	1
1	Drink 2	Intake 2	18	56181	1336014189	/users/cn/jespinosa/phecomp/data/CRG/20120502_FDF_CRG/20120502_FDF_CRG/20120502_FDF_CRG_c12.mtb	149	NA	WWSS	water	2	56163	1336014171	1	0.02	0.00111111111111111	2136	1
1	Food 1	Intake 3	172	60668	1336018676	/users/cn/jespinosa/phecomp/data/CRG/20120502_FDF_CRG/20120502_FDF_CRG/20120502_FDF_CRG_c12.mtb	292	21	WWSS	food_sc	3	60496	1336018504	1	0.04	0.000232558139534884	2137	1
1	Food 1	Intake 3	299	60988	1336018996	/users/cn/jespinosa/phecomp/data/CRG/20120502_FDF_CRG/20120502_FDF_CRG/20120502_FDF_CRG_c12.mtb	293	323	WWSS	food_sc	3	60689	1336018697	1	0.1	0.000334448160535117	2138	1
1	Drink 1	Intake 1	37	61019	1336019027	/users/cn/jespinosa/phecomp/data/CRG/20120502_FDF_CRG/20120502_FDF_CRG/20120502_FDF_CRG_c12.mtb	485	NA	WWSS	water	1	60982	1336018990	1	0.0600000000000001	0.00162162162162162	2139	1
1	Drink 2	Intake 2	16	61065	1336019073	/users/cn/jespinosa/phecomp/data/CRG/20120502_FDF_CRG/20120502_FDF_CRG/20120502_FDF_CRG_c12.mtb	150	NA	WWSS	water	2	61049	1336019057	1	0.02	0.00125	2140	1
1	Drink 2	Intake 2	21	61182	1336019190	/users/cn/jespinosa/phecomp/data/CRG/20120502_FDF_CRG/20120502_FDF_CRG/20120502_FDF_CRG_c12.mtb	151	NA	WWSS	water	2	61161	1336019169	1	0.0600000000000001	0.00285714285714286	2141	1
1	Food 1	Intake 3	145	61456	1336019464	/users/cn/jespinosa/phecomp/data/CRG/20120502_FDF_CRG/20120502_FDF_CRG/20120502_FDF_CRG_c12.mtb	296	467	WWSS	food_sc	3	61311	1336019319	1	0.02	0.000137931034482759	2142	1
1	Drink 1	Intake 1	23	61473	1336019481	/users/cn/jespinosa/phecomp/data/CRG/20120502_FDF_CRG/20120502_FDF_CRG/20120502_FDF_CRG_c12.mtb	488	NA	WWSS	water	1	61450	1336019458	1	0.0800000000000001	0.00347826086956522	2143	1
1	Drink 1	Intake 1	18	61798	1336019806	/users/cn/jespinosa/phecomp/data/CRG/20120502_FDF_CRG/20120502_FDF_CRG/20120502_FDF_CRG_c12.mtb	489	NA	WWSS	water	1	61780	1336019788	1	0.02	0.00111111111111111	2144	1
1	Food 1	Intake 3	316	62239	1336020247	/users/cn/jespinosa/phecomp/data/CRG/20120502_FDF_CRG/20120502_FDF_CRG/20120502_FDF_CRG_c12.mtb	300	917	WWSS	food_sc	3	61923	1336019931	1	0.0999999999999999	0.000316455696202531	2145	1
1	Drink 1	Intake 1	78	62309	1336020317	/users/cn/jespinosa/phecomp/data/CRG/20120502_FDF_CRG/20120502_FDF_CRG/20120502_FDF_CRG_c12.mtb	491	NA	WWSS	water	1	62231	1336020239	1	0.2	0.00256410256410256	2146	1
1	Food 1	Intake 3	118	63274	1336021282	/users/cn/jespinosa/phecomp/data/CRG/20120502_FDF_CRG/20120502_FDF_CRG/20120502_FDF_CRG_c12.mtb	304	117	WWSS	food_sc	3	63156	1336021164	1	0.02	0.000169491525423729	2147	1
1	Food 1	Intake 3	147	63538	1336021546	/users/cn/jespinosa/phecomp/data/CRG/20120502_FDF_CRG/20120502_FDF_CRG/20120502_FDF_CRG_c12.mtb	306	12018	WWSS	food_sc	3	63391	1336021399	1	0.04	0.000272108843537415	2148	1
1	Drink 2	Intake 2	25	63559	1336021567	/users/cn/jespinosa/phecomp/data/CRG/20120502_FDF_CRG/20120502_FDF_CRG/20120502_FDF_CRG_c12.mtb	152	NA	WWSS	water	2	63534	1336021542	1	0.0600000000000001	0.0024	2149	1
1	Drink 1	Intake 1	57	64441	1336022449	/users/cn/jespinosa/phecomp/data/CRG/20120502_FDF_CRG/20120502_FDF_CRG/20120502_FDF_CRG_c12.mtb	501	NA	WWSS	water	1	64384	1336022392	1	0.02	0.000350877192982456	2150	1
1	Drink 1	Intake 1	87	64975	1336022983	/users/cn/jespinosa/phecomp/data/CRG/20120502_FDF_CRG/20120502_FDF_CRG/20120502_FDF_CRG_c12.mtb	508	NA	WWSS	water	1	64888	1336022896	1	0.04	0.000459770114942529	2151	1
1	Drink 2	Intake 2	17	65423	1336023431	/users/cn/jespinosa/phecomp/data/CRG/20120502_FDF_CRG/20120502_FDF_CRG/20120502_FDF_CRG_c12.mtb	161	NA	WWSS	water	2	65406	1336023414	1	0.02	0.00117647058823529	2152	1
1	Drink 2	Intake 2	17	66569	1336024577	/users/cn/jespinosa/phecomp/data/CRG/20120502_FDF_CRG/20120502_FDF_CRG/20120502_FDF_CRG_c12.mtb	166	NA	WWSS	water	2	66552	1336024560	1	0.02	0.00117647058823529	2153	1
1	Drink 2	Intake 2	33	75363	1336033371	/users/cn/jespinosa/phecomp/data/CRG/20120502_FDF_CRG/20120502_FDF_CRG/20120502_FDF_CRG_c12.mtb	168	NA	WWSS	water	2	75330	1336033338	1	0.04	0.00121212121212121	2154	1
1	Drink 2	Intake 2	17	75434	1336033442	/users/cn/jespinosa/phecomp/data/CRG/20120502_FDF_CRG/20120502_FDF_CRG/20120502_FDF_CRG_c12.mtb	169	NA	WWSS	water	2	75417	1336033425	1	0.02	0.00117647058823529	2155	1
1	Food 2	Intake 4	107	75663	1336033671	/users/cn/jespinosa/phecomp/data/CRG/20120502_FDF_CRG/20120502_FDF_CRG/20120502_FDF_CRG_c12.mtb	279	7351	WWSS	food_sc	4	75556	1336033564	1	0.02	0.000186915887850467	2156	1
1	Drink 1	Intake 1	27	76167	1336034175	/users/cn/jespinosa/phecomp/data/CRG/20120502_FDF_CRG/20120502_FDF_CRG/20120502_FDF_CRG_c12.mtb	547	NA	WWSS	water	1	76140	1336034148	1	0.0800000000000001	0.00296296296296297	2157	1
1	Drink 1	Intake 1	22	82521	1336040529	/users/cn/jespinosa/phecomp/data/CRG/20120502_FDF_CRG/20120502_FDF_CRG/20120502_FDF_CRG_c12.mtb	550	NA	WWSS	water	1	82499	1336040507	1	0.02	0.000909090909090909	2158	1
1	Drink 2	Intake 2	19	82543	1336040551	/users/cn/jespinosa/phecomp/data/CRG/20120502_FDF_CRG/20120502_FDF_CRG/20120502_FDF_CRG_c12.mtb	170	NA	WWSS	water	2	82524	1336040532	1	0.0600000000000001	0.00315789473684211	2159	1
1	Food 1	Intake 3	447	83461	1336041469	/users/cn/jespinosa/phecomp/data/CRG/20120502_FDF_CRG/20120502_FDF_CRG/20120502_FDF_CRG_c12.mtb	313	10564	WWSS	food_sc	3	83014	1336041022	1	0.0999999999999999	0.000223713646532438	2160	1
1	Drink 2	Intake 2	24	83521	1336041529	/users/cn/jespinosa/phecomp/data/CRG/20120502_FDF_CRG/20120502_FDF_CRG/20120502_FDF_CRG_c12.mtb	173	NA	WWSS	water	2	83497	1336041505	1	0.0800000000000001	0.00333333333333334	2161	1
1	Drink 2	Intake 2	23	84094	1336042102	/users/cn/jespinosa/phecomp/data/CRG/20120502_FDF_CRG/20120502_FDF_CRG/20120502_FDF_CRG_c12.mtb	174	NA	WWSS	water	2	84071	1336042079	1	0.02	0.000869565217391304	2162	1
1	Drink 1	Intake 1	70	84155	1336042163	/users/cn/jespinosa/phecomp/data/CRG/20120502_FDF_CRG/20120502_FDF_CRG/20120502_FDF_CRG_c12.mtb	557	NA	WWSS	water	1	84085	1336042093	1	0.02	0.000285714285714286	2163	1
1	Drink 1	Intake 1	89	84401	1336042409	/users/cn/jespinosa/phecomp/data/CRG/20120502_FDF_CRG/20120502_FDF_CRG/20120502_FDF_CRG_c12.mtb	560	NA	WWSS	water	1	84312	1336042320	1	0.02	0.000224719101123596	2164	1
1	Drink 2	Intake 2	13	85500	1336043508	/users/cn/jespinosa/phecomp/data/CRG/20120502_FDF_CRG/20120502_FDF_CRG/20120502_FDF_CRG_c12.mtb	176	NA	WWSS	water	2	85487	1336043495	1	0.02	0.00153846153846154	2165	1
1	Food 1	Intake 3	265	94290	1336052298	/users/cn/jespinosa/phecomp/data/CRG/20120502_FDF_CRG/20120502_FDF_CRG/20120502_FDF_CRG_c12.mtb	317	104	WWSS	food_sc	3	94025	1336052033	1	0.02	7.54716981132076e-05	2166	1
1	Drink 2	Intake 2	14	94346	1336052354	/users/cn/jespinosa/phecomp/data/CRG/20120502_FDF_CRG/20120502_FDF_CRG/20120502_FDF_CRG_c12.mtb	177	NA	WWSS	water	2	94332	1336052340	1	0.0599999999999998	0.00428571428571427	2167	1
1	Food 1	Intake 3	47	94441	1336052449	/users/cn/jespinosa/phecomp/data/CRG/20120502_FDF_CRG/20120502_FDF_CRG/20120502_FDF_CRG_c12.mtb	318	7397	WWSS	food_sc	3	94394	1336052402	1	0.02	0.000425531914893617	2168	1
1	Drink 1	Intake 1	18	101414	1336059422	/users/cn/jespinosa/phecomp/data/CRG/20120502_FDF_CRG/20120502_FDF_CRG/20120502_FDF_CRG_c12.mtb	572	NA	WWSS	water	1	101396	1336059404	1	0.02	0.00111111111111111	2169	1
1	Drink 2	Intake 2	14	101423	1336059431	/users/cn/jespinosa/phecomp/data/CRG/20120502_FDF_CRG/20120502_FDF_CRG/20120502_FDF_CRG_c12.mtb	178	NA	WWSS	water	2	101409	1336059417	1	0.12	0.00857142857142857	2170	1
1	Food 1	Intake 3	636	102474	1336060482	/users/cn/jespinosa/phecomp/data/CRG/20120502_FDF_CRG/20120502_FDF_CRG/20120502_FDF_CRG_c12.mtb	320	6898	WWSS	food_sc	3	101838	1336059846	1	0.14	0.000220125786163522	2171	1
1	Drink 2	Intake 2	22	103038	1336061046	/users/cn/jespinosa/phecomp/data/CRG/20120502_FDF_CRG/20120502_FDF_CRG/20120502_FDF_CRG_c12.mtb	179	NA	WWSS	water	2	103016	1336061024	1	0.04	0.00181818181818182	2172	1
1	Food 1	Intake 3	612	109984	1336067992	/users/cn/jespinosa/phecomp/data/CRG/20120502_FDF_CRG/20120502_FDF_CRG/20120502_FDF_CRG_c12.mtb	325	1856	WWSS	food_sc	3	109372	1336067380	1	0.1	0.000163398692810458	2173	1
1	Drink 1	Intake 1	25	110546	1336068554	/users/cn/jespinosa/phecomp/data/CRG/20120502_FDF_CRG/20120502_FDF_CRG/20120502_FDF_CRG_c12.mtb	576	NA	WWSS	water	1	110521	1336068529	1	0.04	0.0016	2174	1
1	Food 1	Intake 3	582	112422	1336070430	/users/cn/jespinosa/phecomp/data/CRG/20120502_FDF_CRG/20120502_FDF_CRG/20120502_FDF_CRG_c12.mtb	326	896	WWSS	food_sc	3	111840	1336069848	1	0.22	0.000378006872852234	2175	1
1	Drink 2	Intake 2	28	112447	1336070455	/users/cn/jespinosa/phecomp/data/CRG/20120502_FDF_CRG/20120502_FDF_CRG/20120502_FDF_CRG_c12.mtb	180	NA	WWSS	water	2	112419	1336070427	1	0.0600000000000001	0.00214285714285715	2176	1
1	Drink 1	Intake 1	16	112849	1336070857	/users/cn/jespinosa/phecomp/data/CRG/20120502_FDF_CRG/20120502_FDF_CRG/20120502_FDF_CRG_c12.mtb	581	NA	WWSS	water	1	112833	1336070841	1	0.0800000000000001	0.00500000000000001	2177	1
1	Drink 1	Intake 1	17	113286	1336071294	/users/cn/jespinosa/phecomp/data/CRG/20120502_FDF_CRG/20120502_FDF_CRG/20120502_FDF_CRG_c12.mtb	582	NA	WWSS	water	1	113269	1336071277	1	0.02	0.00117647058823529	2178	1
1	Food 1	Intake 3	116	113434	1336071442	/users/cn/jespinosa/phecomp/data/CRG/20120502_FDF_CRG/20120502_FDF_CRG/20120502_FDF_CRG_c12.mtb	328	5	WWSS	food_sc	3	113318	1336071326	1	0.0600000000000001	0.000517241379310346	2179	1
1	Food 1	Intake 3	113	113552	1336071560	/users/cn/jespinosa/phecomp/data/CRG/20120502_FDF_CRG/20120502_FDF_CRG/20120502_FDF_CRG_c12.mtb	329	444	WWSS	food_sc	3	113439	1336071447	1	0.0600000000000001	0.000530973451327435	2180	1
1	Drink 1	Intake 1	26	113743	1336071751	/users/cn/jespinosa/phecomp/data/CRG/20120502_FDF_CRG/20120502_FDF_CRG/20120502_FDF_CRG_c12.mtb	585	NA	WWSS	water	1	113717	1336071725	1	0.02	0.000769230769230769	2181	1
1	Food 1	Intake 3	87	114083	1336072091	/users/cn/jespinosa/phecomp/data/CRG/20120502_FDF_CRG/20120502_FDF_CRG/20120502_FDF_CRG_c12.mtb	330	91	WWSS	food_sc	3	113996	1336072004	1	0.04	0.000459770114942529	2182	1
1	Drink 1	Intake 1	41	114113	1336072121	/users/cn/jespinosa/phecomp/data/CRG/20120502_FDF_CRG/20120502_FDF_CRG/20120502_FDF_CRG_c12.mtb	587	NA	WWSS	water	1	114072	1336072080	1	0.0600000000000001	0.00146341463414634	2183	1
1	Food 1	Intake 3	56	114230	1336072238	/users/cn/jespinosa/phecomp/data/CRG/20120502_FDF_CRG/20120502_FDF_CRG/20120502_FDF_CRG_c12.mtb	331	59	WWSS	food_sc	3	114174	1336072182	1	0.02	0.000357142857142857	2184	1
1	Food 1	Intake 3	77	114366	1336072374	/users/cn/jespinosa/phecomp/data/CRG/20120502_FDF_CRG/20120502_FDF_CRG/20120502_FDF_CRG_c12.mtb	332	109	WWSS	food_sc	3	114289	1336072297	1	0.02	0.00025974025974026	2185	1
1	Drink 1	Intake 1	24	114396	1336072404	/users/cn/jespinosa/phecomp/data/CRG/20120502_FDF_CRG/20120502_FDF_CRG/20120502_FDF_CRG_c12.mtb	589	NA	WWSS	water	1	114372	1336072380	1	0.04	0.00166666666666667	2186	1
1	Food 1	Intake 3	275	114750	1336072758	/users/cn/jespinosa/phecomp/data/CRG/20120502_FDF_CRG/20120502_FDF_CRG/20120502_FDF_CRG_c12.mtb	333	667	WWSS	food_sc	3	114475	1336072483	1	0.02	7.27272727272727e-05	2187	1
1	Drink 2	Intake 2	18	115393	1336073401	/users/cn/jespinosa/phecomp/data/CRG/20120502_FDF_CRG/20120502_FDF_CRG/20120502_FDF_CRG_c12.mtb	184	NA	WWSS	water	2	115375	1336073383	1	0.02	0.00111111111111111	2188	1
1	Food 1	Intake 3	192	115609	1336073617	/users/cn/jespinosa/phecomp/data/CRG/20120502_FDF_CRG/20120502_FDF_CRG/20120502_FDF_CRG_c12.mtb	335	1006	WWSS	food_sc	3	115417	1336073425	1	0.5	0.00260416666666667	2189	1
1	Drink 1	Intake 1	44	115768	1336073776	/users/cn/jespinosa/phecomp/data/CRG/20120502_FDF_CRG/20120502_FDF_CRG/20120502_FDF_CRG_c12.mtb	596	NA	WWSS	water	1	115724	1336073732	1	0.0999999999999996	0.00227272727272726	2190	1
1	Drink 2	Intake 2	26	116233	1336074241	/users/cn/jespinosa/phecomp/data/CRG/20120502_FDF_CRG/20120502_FDF_CRG/20120502_FDF_CRG_c12.mtb	185	NA	WWSS	water	2	116207	1336074215	1	0.0600000000000001	0.00230769230769231	2191	1
1	Drink 1	Intake 1	18	116471	1336074479	/users/cn/jespinosa/phecomp/data/CRG/20120502_FDF_CRG/20120502_FDF_CRG/20120502_FDF_CRG_c12.mtb	604	NA	WWSS	water	1	116453	1336074461	1	0.02	0.00111111111111111	2192	1
1	Food 1	Intake 3	195	116810	1336074818	/users/cn/jespinosa/phecomp/data/CRG/20120502_FDF_CRG/20120502_FDF_CRG/20120502_FDF_CRG_c12.mtb	340	17	WWSS	food_sc	3	116615	1336074623	1	0.0800000000000001	0.000410256410256411	2193	1
1	Food 1	Intake 3	78	116905	1336074913	/users/cn/jespinosa/phecomp/data/CRG/20120502_FDF_CRG/20120502_FDF_CRG/20120502_FDF_CRG_c12.mtb	341	46	WWSS	food_sc	3	116827	1336074835	1	0.02	0.000256410256410256	2194	1
1	Drink 1	Intake 1	36	116938	1336074946	/users/cn/jespinosa/phecomp/data/CRG/20120502_FDF_CRG/20120502_FDF_CRG/20120502_FDF_CRG_c12.mtb	605	NA	WWSS	water	1	116902	1336074910	1	0.0800000000000001	0.00222222222222222	2195	1
1	Food 1	Intake 3	34	116985	1336074993	/users/cn/jespinosa/phecomp/data/CRG/20120502_FDF_CRG/20120502_FDF_CRG/20120502_FDF_CRG_c12.mtb	342	397	WWSS	food_sc	3	116951	1336074959	1	0.02	0.000588235294117647	2196	1
1	Drink 1	Intake 1	23	117086	1336075094	/users/cn/jespinosa/phecomp/data/CRG/20120502_FDF_CRG/20120502_FDF_CRG/20120502_FDF_CRG_c12.mtb	606	NA	WWSS	water	1	117063	1336075071	1	0.04	0.00173913043478261	2197	1
1	Food 2	Intake 4	66	117448	1336075456	/users/cn/jespinosa/phecomp/data/CRG/20120502_FDF_CRG/20120502_FDF_CRG/20120502_FDF_CRG_c12.mtb	308	328	WWSS	food_sc	4	117382	1336075390	1	0.02	0.000303030303030303	2198	1
1	Drink 1	Intake 1	48	117565	1336075573	/users/cn/jespinosa/phecomp/data/CRG/20120502_FDF_CRG/20120502_FDF_CRG/20120502_FDF_CRG_c12.mtb	607	NA	WWSS	water	1	117517	1336075525	1	0.0800000000000001	0.00166666666666667	2199	1
1	Drink 1	Intake 1	16	117642	1336075650	/users/cn/jespinosa/phecomp/data/CRG/20120502_FDF_CRG/20120502_FDF_CRG/20120502_FDF_CRG_c12.mtb	608	NA	WWSS	water	1	117626	1336075634	1	0.02	0.00125	2200	1
1	Food 2	Intake 4	39	117815	1336075823	/users/cn/jespinosa/phecomp/data/CRG/20120502_FDF_CRG/20120502_FDF_CRG/20120502_FDF_CRG_c12.mtb	310	31	WWSS	food_sc	4	117776	1336075784	1	0.04	0.00102564102564103	2201	1
1	Food 2	Intake 4	56	117902	1336075910	/users/cn/jespinosa/phecomp/data/CRG/20120502_FDF_CRG/20120502_FDF_CRG/20120502_FDF_CRG_c12.mtb	311	347	WWSS	food_sc	4	117846	1336075854	1	0.02	0.000357142857142857	2202	1
1	Food 2	Intake 4	73	118322	1336076330	/users/cn/jespinosa/phecomp/data/CRG/20120502_FDF_CRG/20120502_FDF_CRG/20120502_FDF_CRG_c12.mtb	314	1866	WWSS	food_sc	4	118249	1336076257	1	0.02	0.000273972602739726	2203	1
1	Drink 1	Intake 1	18	118725	1336076733	/users/cn/jespinosa/phecomp/data/CRG/20120502_FDF_CRG/20120502_FDF_CRG/20120502_FDF_CRG_c12.mtb	616	NA	WWSS	water	1	118707	1336076715	1	0.02	0.00111111111111111	2204	1
1	Drink 2	Intake 2	19	118785	1336076793	/users/cn/jespinosa/phecomp/data/CRG/20120502_FDF_CRG/20120502_FDF_CRG/20120502_FDF_CRG_c12.mtb	188	NA	WWSS	water	2	118766	1336076774	1	0.02	0.00105263157894737	2205	1
1	Drink 2	Intake 2	20	119346	1336077354	/users/cn/jespinosa/phecomp/data/CRG/20120502_FDF_CRG/20120502_FDF_CRG/20120502_FDF_CRG_c12.mtb	189	NA	WWSS	water	2	119326	1336077334	1	0.04	0.002	2206	1
1	Drink 1	Intake 1	23	119371	1336077379	/users/cn/jespinosa/phecomp/data/CRG/20120502_FDF_CRG/20120502_FDF_CRG/20120502_FDF_CRG_c12.mtb	619	NA	WWSS	water	1	119348	1336077356	1	0.02	0.000869565217391304	2207	1
1	Drink 2	Intake 2	16	119500	1336077508	/users/cn/jespinosa/phecomp/data/CRG/20120502_FDF_CRG/20120502_FDF_CRG/20120502_FDF_CRG_c12.mtb	191	NA	WWSS	water	2	119484	1336077492	1	0.02	0.00125	2208	1
1	Drink 2	Intake 2	19	119932	1336077940	/users/cn/jespinosa/phecomp/data/CRG/20120502_FDF_CRG/20120502_FDF_CRG/20120502_FDF_CRG_c12.mtb	192	NA	WWSS	water	2	119913	1336077921	1	0.04	0.00210526315789474	2209	1
1	Food 2	Intake 4	42	120230	1336078238	/users/cn/jespinosa/phecomp/data/CRG/20120502_FDF_CRG/20120502_FDF_CRG/20120502_FDF_CRG_c12.mtb	321	4969	WWSS	food_sc	4	120188	1336078196	1	0.02	0.000476190476190476	2210	1
1	Drink 1	Intake 1	64	120313	1336078321	/users/cn/jespinosa/phecomp/data/CRG/20120502_FDF_CRG/20120502_FDF_CRG/20120502_FDF_CRG_c12.mtb	622	NA	WWSS	water	1	120249	1336078257	1	0.0800000000000001	0.00125	2211	1
1	Drink 1	Intake 1	54	120601	1336078609	/users/cn/jespinosa/phecomp/data/CRG/20120502_FDF_CRG/20120502_FDF_CRG/20120502_FDF_CRG_c12.mtb	625	NA	WWSS	water	1	120547	1336078555	1	0.04	0.000740740740740741	2212	1
1	Food 2	Intake 4	365	125564	1336083572	/users/cn/jespinosa/phecomp/data/CRG/20120502_FDF_CRG/20120502_FDF_CRG/20120502_FDF_CRG_c12.mtb	326	56	WWSS	food_sc	4	125199	1336083207	1	0.04	0.00010958904109589	2213	1
1	Food 1	Intake 3	178	125798	1336083806	/users/cn/jespinosa/phecomp/data/CRG/20120502_FDF_CRG/20120502_FDF_CRG/20120502_FDF_CRG_c12.mtb	356	217	WWSS	food_sc	3	125620	1336083628	1	0.0599999999999996	0.000337078651685391	2214	1
1	Food 2	Intake 4	27	126042	1336084050	/users/cn/jespinosa/phecomp/data/CRG/20120502_FDF_CRG/20120502_FDF_CRG/20120502_FDF_CRG_c12.mtb	330	94	WWSS	food_sc	4	126015	1336084023	1	0.04	0.00148148148148148	2215	1
1	Drink 1	Intake 1	56	126110	1336084118	/users/cn/jespinosa/phecomp/data/CRG/20120502_FDF_CRG/20120502_FDF_CRG/20120502_FDF_CRG_c12.mtb	644	NA	WWSS	water	1	126054	1336084062	1	0.12	0.00214285714285714	2216	1
1	Food 2	Intake 4	124	126260	1336084268	/users/cn/jespinosa/phecomp/data/CRG/20120502_FDF_CRG/20120502_FDF_CRG/20120502_FDF_CRG_c12.mtb	332	1981	WWSS	food_sc	4	126136	1336084144	1	0.0599999999999998	0.000483870967741934	2217	1
1	Drink 1	Intake 1	34	126420	1336084428	/users/cn/jespinosa/phecomp/data/CRG/20120502_FDF_CRG/20120502_FDF_CRG/20120502_FDF_CRG_c12.mtb	646	NA	WWSS	water	1	126386	1336084394	1	0.0600000000000001	0.00176470588235294	2218	1
1	Drink 1	Intake 1	76	126530	1336084538	/users/cn/jespinosa/phecomp/data/CRG/20120502_FDF_CRG/20120502_FDF_CRG/20120502_FDF_CRG_c12.mtb	647	NA	WWSS	water	1	126454	1336084462	1	0.02	0.000263157894736842	2219	1
1	Drink 2	Intake 2	20	127975	1336085983	/users/cn/jespinosa/phecomp/data/CRG/20120502_FDF_CRG/20120502_FDF_CRG/20120502_FDF_CRG_c12.mtb	198	NA	WWSS	water	2	127955	1336085963	1	0.0800000000000001	0.00400000000000001	2220	1
1	Food 1	Intake 3	323	128564	1336086572	/users/cn/jespinosa/phecomp/data/CRG/20120502_FDF_CRG/20120502_FDF_CRG/20120502_FDF_CRG_c12.mtb	364	27	WWSS	food_sc	3	128241	1336086249	1	0.0600000000000001	0.000185758513931889	2221	1
1	Food 1	Intake 3	89	128680	1336086688	/users/cn/jespinosa/phecomp/data/CRG/20120502_FDF_CRG/20120502_FDF_CRG/20120502_FDF_CRG_c12.mtb	365	107	WWSS	food_sc	3	128591	1336086599	1	0.04	0.000449438202247191	2222	1
1	Drink 2	Intake 2	47	128723	1336086731	/users/cn/jespinosa/phecomp/data/CRG/20120502_FDF_CRG/20120502_FDF_CRG/20120502_FDF_CRG_c12.mtb	199	NA	WWSS	water	2	128676	1336086684	1	0.0800000000000001	0.00170212765957447	2223	1
1	Food 1	Intake 3	80	128867	1336086875	/users/cn/jespinosa/phecomp/data/CRG/20120502_FDF_CRG/20120502_FDF_CRG/20120502_FDF_CRG_c12.mtb	366	21	WWSS	food_sc	3	128787	1336086795	1	0.02	0.00025	2224	1
1	Food 2	Intake 4	118	129006	1336087014	/users/cn/jespinosa/phecomp/data/CRG/20120502_FDF_CRG/20120502_FDF_CRG/20120502_FDF_CRG_c12.mtb	342	4334	WWSS	food_sc	4	128888	1336086896	1	0.04	0.000338983050847458	2225	1
1	Drink 1	Intake 1	17	129027	1336087035	/users/cn/jespinosa/phecomp/data/CRG/20120502_FDF_CRG/20120502_FDF_CRG/20120502_FDF_CRG_c12.mtb	655	NA	WWSS	water	1	129010	1336087018	1	0.02	0.00117647058823529	2226	1
1	Drink 2	Intake 2	23	129145	1336087153	/users/cn/jespinosa/phecomp/data/CRG/20120502_FDF_CRG/20120502_FDF_CRG/20120502_FDF_CRG_c12.mtb	202	NA	WWSS	water	2	129122	1336087130	1	0.0399999999999996	0.00173913043478259	2227	1
1	Drink 2	Intake 2	213	129744	1336087752	/users/cn/jespinosa/phecomp/data/CRG/20120502_FDF_CRG/20120502_FDF_CRG/20120502_FDF_CRG_c12.mtb	205	NA	WWSS	water	2	129531	1336087539	1	0.02	9.38967136150235e-05	2228	1
1	Drink 2	Intake 2	158	129927	1336087935	/users/cn/jespinosa/phecomp/data/CRG/20120502_FDF_CRG/20120502_FDF_CRG/20120502_FDF_CRG_c12.mtb	206	NA	WWSS	water	2	129769	1336087777	1	0.02	0.000126582278481013	2229	1
1	Drink 2	Intake 2	191	130419	1336088427	/users/cn/jespinosa/phecomp/data/CRG/20120502_FDF_CRG/20120502_FDF_CRG/20120502_FDF_CRG_c12.mtb	209	NA	WWSS	water	2	130228	1336088236	1	0.02	0.000104712041884817	2230	1
1	Drink 2	Intake 2	146	130879	1336088887	/users/cn/jespinosa/phecomp/data/CRG/20120502_FDF_CRG/20120502_FDF_CRG/20120502_FDF_CRG_c12.mtb	211	NA	WWSS	water	2	130733	1336088741	1	0.02	0.000136986301369863	2231	1
1	Drink 2	Intake 2	27	131882	1336089890	/users/cn/jespinosa/phecomp/data/CRG/20120502_FDF_CRG/20120502_FDF_CRG/20120502_FDF_CRG_c12.mtb	216	NA	WWSS	water	2	131855	1336089863	1	0.02	0.000740740740740741	2232	1
1	Food 1	Intake 3	361	133701	1336091709	/users/cn/jespinosa/phecomp/data/CRG/20120502_FDF_CRG/20120502_FDF_CRG/20120502_FDF_CRG_c12.mtb	370	17	WWSS	food_sc	3	133340	1336091348	1	0.0600000000000001	0.000166204986149585	2233	1
1	Food 2	Intake 4	196	133914	1336091922	/users/cn/jespinosa/phecomp/data/CRG/20120502_FDF_CRG/20120502_FDF_CRG/20120502_FDF_CRG_c12.mtb	345	281	WWSS	food_sc	4	133718	1336091726	1	0.0600000000000001	0.000306122448979592	2234	1
1	Drink 1	Intake 1	20	134132	1336092140	/users/cn/jespinosa/phecomp/data/CRG/20120502_FDF_CRG/20120502_FDF_CRG/20120502_FDF_CRG_c12.mtb	664	NA	WWSS	water	1	134112	1336092120	1	0.02	0.001	2235	1
1	Food 2	Intake 4	86	134281	1336092289	/users/cn/jespinosa/phecomp/data/CRG/20120502_FDF_CRG/20120502_FDF_CRG/20120502_FDF_CRG_c12.mtb	348	178	WWSS	food_sc	4	134195	1336092203	1	0.04	0.000465116279069767	2236	1
1	Food 2	Intake 4	44	134503	1336092511	/users/cn/jespinosa/phecomp/data/CRG/20120502_FDF_CRG/20120502_FDF_CRG/20120502_FDF_CRG_c12.mtb	350	327	WWSS	food_sc	4	134459	1336092467	1	0.02	0.000454545454545455	2237	1
1	Drink 2	Intake 2	56	134665	1336092673	/users/cn/jespinosa/phecomp/data/CRG/20120502_FDF_CRG/20120502_FDF_CRG/20120502_FDF_CRG_c12.mtb	232	NA	WWSS	water	2	134609	1336092617	1	0.02	0.000357142857142857	2238	1
1	Drink 2	Intake 2	37	134761	1336092769	/users/cn/jespinosa/phecomp/data/CRG/20120502_FDF_CRG/20120502_FDF_CRG/20120502_FDF_CRG_c12.mtb	233	NA	WWSS	water	2	134724	1336092732	1	0.02	0.000540540540540541	2239	1
1	Drink 2	Intake 2	25	134813	1336092821	/users/cn/jespinosa/phecomp/data/CRG/20120502_FDF_CRG/20120502_FDF_CRG/20120502_FDF_CRG_c12.mtb	234	NA	WWSS	water	2	134788	1336092796	1	0.04	0.0016	2240	1
1	Food 1	Intake 3	136	134966	1336092974	/users/cn/jespinosa/phecomp/data/CRG/20120502_FDF_CRG/20120502_FDF_CRG/20120502_FDF_CRG_c12.mtb	376	62	WWSS	food_sc	3	134830	1336092838	1	0.04	0.000294117647058824	2241	1
1	Food 1	Intake 3	76	135104	1336093112	/users/cn/jespinosa/phecomp/data/CRG/20120502_FDF_CRG/20120502_FDF_CRG/20120502_FDF_CRG_c12.mtb	377	893	WWSS	food_sc	3	135028	1336093036	1	0.02	0.000263157894736842	2242	1
1	Drink 1	Intake 1	40	135178	1336093186	/users/cn/jespinosa/phecomp/data/CRG/20120502_FDF_CRG/20120502_FDF_CRG/20120502_FDF_CRG_c12.mtb	667	NA	WWSS	water	1	135138	1336093146	1	0.0800000000000001	0.002	2243	1
1	Drink 2	Intake 2	484	135751	1336093759	/users/cn/jespinosa/phecomp/data/CRG/20120502_FDF_CRG/20120502_FDF_CRG/20120502_FDF_CRG_c12.mtb	238	NA	WWSS	water	2	135267	1336093275	1	0.04	8.26446280991736e-05	2244	1
1	Drink 2	Intake 2	83	135939	1336093947	/users/cn/jespinosa/phecomp/data/CRG/20120502_FDF_CRG/20120502_FDF_CRG/20120502_FDF_CRG_c12.mtb	239	NA	WWSS	water	2	135856	1336093864	1	0.02	0.000240963855421687	2245	1
1	Food 1	Intake 3	76	136073	1336094081	/users/cn/jespinosa/phecomp/data/CRG/20120502_FDF_CRG/20120502_FDF_CRG/20120502_FDF_CRG_c12.mtb	379	809	WWSS	food_sc	3	135997	1336094005	1	0.02	0.000263157894736842	2246	1
1	Drink 2	Intake 2	472	136900	1336094908	/users/cn/jespinosa/phecomp/data/CRG/20120502_FDF_CRG/20120502_FDF_CRG/20120502_FDF_CRG_c12.mtb	243	NA	WWSS	water	2	136428	1336094436	1	0.02	4.23728813559322e-05	2247	1
1	Food 2	Intake 4	68	136950	1336094958	/users/cn/jespinosa/phecomp/data/CRG/20120502_FDF_CRG/20120502_FDF_CRG/20120502_FDF_CRG_c12.mtb	358	59	WWSS	food_sc	4	136882	1336094890	1	0.02	0.000294117647058824	2248	1
1	Drink 2	Intake 2	92	137028	1336095036	/users/cn/jespinosa/phecomp/data/CRG/20120502_FDF_CRG/20120502_FDF_CRG/20120502_FDF_CRG_c12.mtb	244	NA	WWSS	water	2	136936	1336094944	1	0.02	0.000217391304347826	2249	1
1	Food 2	Intake 4	151	137160	1336095168	/users/cn/jespinosa/phecomp/data/CRG/20120502_FDF_CRG/20120502_FDF_CRG/20120502_FDF_CRG_c12.mtb	360	241	WWSS	food_sc	4	137009	1336095017	1	0.02	0.000132450331125828	2250	1
1	Drink 2	Intake 2	363	137429	1336095437	/users/cn/jespinosa/phecomp/data/CRG/20120502_FDF_CRG/20120502_FDF_CRG/20120502_FDF_CRG_c12.mtb	245	NA	WWSS	water	2	137066	1336095074	1	0.02	5.50964187327824e-05	2251	1
1	Food 2	Intake 4	85	137486	1336095494	/users/cn/jespinosa/phecomp/data/CRG/20120502_FDF_CRG/20120502_FDF_CRG/20120502_FDF_CRG_c12.mtb	364	1022	WWSS	food_sc	4	137401	1336095409	1	0.02	0.000235294117647059	2252	1
1	Drink 2	Intake 2	93	138066	1336096074	/users/cn/jespinosa/phecomp/data/CRG/20120502_FDF_CRG/20120502_FDF_CRG/20120502_FDF_CRG_c12.mtb	248	NA	WWSS	water	2	137973	1336095981	1	0.02	0.00021505376344086	2253	1
1	Drink 1	Intake 1	15	138496	1336096504	/users/cn/jespinosa/phecomp/data/CRG/20120502_FDF_CRG/20120502_FDF_CRG/20120502_FDF_CRG_c12.mtb	683	NA	WWSS	water	1	138481	1336096489	1	0.02	0.00133333333333333	2254	1
1	Food 2	Intake 4	76	138584	1336096592	/users/cn/jespinosa/phecomp/data/CRG/20120502_FDF_CRG/20120502_FDF_CRG/20120502_FDF_CRG_c12.mtb	365	4819	WWSS	food_sc	4	138508	1336096516	1	0.02	0.000263157894736842	2255	1
1	Drink 2	Intake 2	133	138770	1336096778	/users/cn/jespinosa/phecomp/data/CRG/20120502_FDF_CRG/20120502_FDF_CRG/20120502_FDF_CRG_c12.mtb	252	NA	WWSS	water	2	138637	1336096645	1	0.04	0.000300751879699248	2256	1
1	Drink 2	Intake 2	49	138865	1336096873	/users/cn/jespinosa/phecomp/data/CRG/20120502_FDF_CRG/20120502_FDF_CRG/20120502_FDF_CRG_c12.mtb	253	NA	WWSS	water	2	138816	1336096824	1	0.02	0.000408163265306122	2257	1
1	Drink 2	Intake 2	33	140700	1336098708	/users/cn/jespinosa/phecomp/data/CRG/20120502_FDF_CRG/20120502_FDF_CRG/20120502_FDF_CRG_c12.mtb	258	NA	WWSS	water	2	140667	1336098675	1	0.02	0.000606060606060606	2258	1
1	Drink 2	Intake 2	47	140758	1336098766	/users/cn/jespinosa/phecomp/data/CRG/20120502_FDF_CRG/20120502_FDF_CRG/20120502_FDF_CRG_c12.mtb	259	NA	WWSS	water	2	140711	1336098719	1	0.02	0.000425531914893617	2259	1
1	Drink 2	Intake 2	10	141474	1336099482	/users/cn/jespinosa/phecomp/data/CRG/20120502_FDF_CRG/20120502_FDF_CRG/20120502_FDF_CRG_c12.mtb	263	NA	WWSS	water	2	141464	1336099472	1	0.0200000000000005	0.00200000000000005	2260	1
1	Drink 2	Intake 2	33	142420	1336100428	/users/cn/jespinosa/phecomp/data/CRG/20120502_FDF_CRG/20120502_FDF_CRG/20120502_FDF_CRG_c12.mtb	269	NA	WWSS	water	2	142387	1336100395	1	0.0200000000000005	0.000606060606060621	2261	1
1	Drink 2	Intake 2	76	142846	1336100854	/users/cn/jespinosa/phecomp/data/CRG/20120502_FDF_CRG/20120502_FDF_CRG/20120502_FDF_CRG_c12.mtb	272	NA	WWSS	water	2	142770	1336100778	1	0.02	0.000263157894736842	2262	1
1	Drink 2	Intake 2	13	142883	1336100891	/users/cn/jespinosa/phecomp/data/CRG/20120502_FDF_CRG/20120502_FDF_CRG/20120502_FDF_CRG_c12.mtb	273	NA	WWSS	water	2	142870	1336100878	1	0.02	0.00153846153846154	2263	1
1	Drink 2	Intake 2	15	143146	1336101154	/users/cn/jespinosa/phecomp/data/CRG/20120502_FDF_CRG/20120502_FDF_CRG/20120502_FDF_CRG_c12.mtb	275	NA	WWSS	water	2	143131	1336101139	1	0.02	0.00133333333333333	2264	1
1	Food 2	Intake 4	52	143455	1336101463	/users/cn/jespinosa/phecomp/data/CRG/20120502_FDF_CRG/20120502_FDF_CRG/20120502_FDF_CRG_c12.mtb	369	15	WWSS	food_sc	4	143403	1336101411	1	0.02	0.000384615384615385	2265	1
1	Food 2	Intake 4	85	143555	1336101563	/users/cn/jespinosa/phecomp/data/CRG/20120502_FDF_CRG/20120502_FDF_CRG/20120502_FDF_CRG_c12.mtb	370	17	WWSS	food_sc	4	143470	1336101478	1	0.02	0.000235294117647059	2266	1
1	Food 1	Intake 3	67	143639	1336101647	/users/cn/jespinosa/phecomp/data/CRG/20120502_FDF_CRG/20120502_FDF_CRG/20120502_FDF_CRG_c12.mtb	385	33	WWSS	food_sc	3	143572	1336101580	1	0.04	0.000597014925373134	2267	1
1	Food 2	Intake 4	34	143706	1336101714	/users/cn/jespinosa/phecomp/data/CRG/20120502_FDF_CRG/20120502_FDF_CRG/20120502_FDF_CRG_c12.mtb	372	277	WWSS	food_sc	4	143672	1336101680	1	0.04	0.00117647058823529	2268	1
1	Food 2	Intake 4	151	144134	1336102142	/users/cn/jespinosa/phecomp/data/CRG/20120502_FDF_CRG/20120502_FDF_CRG/20120502_FDF_CRG_c12.mtb	376	128	WWSS	food_sc	4	143983	1336101991	1	0.04	0.000264900662251656	2269	1
1	Drink 2	Intake 2	27	144055	1336102063	/users/cn/jespinosa/phecomp/data/CRG/20120502_FDF_CRG/20120502_FDF_CRG/20120502_FDF_CRG_c12.mtb	279	NA	WWSS	water	2	144028	1336102036	1	0.02	0.000740740740740741	2270	1
1	Drink 1	Intake 1	31	144164	1336102172	/users/cn/jespinosa/phecomp/data/CRG/20120502_FDF_CRG/20120502_FDF_CRG/20120502_FDF_CRG_c12.mtb	690	NA	WWSS	water	1	144133	1336102141	1	0.0800000000000001	0.00258064516129033	2271	1
1	Food 2	Intake 4	265	144527	1336102535	/users/cn/jespinosa/phecomp/data/CRG/20120502_FDF_CRG/20120502_FDF_CRG/20120502_FDF_CRG_c12.mtb	378	289	WWSS	food_sc	4	144262	1336102270	1	0.0599999999999998	0.000226415094339622	2272	1
1	Drink 1	Intake 1	40	144560	1336102568	/users/cn/jespinosa/phecomp/data/CRG/20120502_FDF_CRG/20120502_FDF_CRG/20120502_FDF_CRG_c12.mtb	692	NA	WWSS	water	1	144520	1336102528	1	0.16	0.004	2273	1
1	Food 2	Intake 4	255	145071	1336103079	/users/cn/jespinosa/phecomp/data/CRG/20120502_FDF_CRG/20120502_FDF_CRG/20120502_FDF_CRG_c12.mtb	381	155	WWSS	food_sc	4	144816	1336102824	1	0.0600000000000001	0.000235294117647059	2274	1
1	Drink 1	Intake 1	23	145087	1336103095	/users/cn/jespinosa/phecomp/data/CRG/20120502_FDF_CRG/20120502_FDF_CRG/20120502_FDF_CRG_c12.mtb	693	NA	WWSS	water	1	145064	1336103072	1	0.0600000000000001	0.00260869565217392	2275	1
1	Food 2	Intake 4	36	145262	1336103270	/users/cn/jespinosa/phecomp/data/CRG/20120502_FDF_CRG/20120502_FDF_CRG/20120502_FDF_CRG_c12.mtb	383	11	WWSS	food_sc	4	145226	1336103234	1	0.04	0.00111111111111111	2276	1
1	Food 2	Intake 4	39	145312	1336103320	/users/cn/jespinosa/phecomp/data/CRG/20120502_FDF_CRG/20120502_FDF_CRG/20120502_FDF_CRG_c12.mtb	384	1260	WWSS	food_sc	4	145273	1336103281	1	0.04	0.00102564102564103	2277	1
1	Drink 1	Intake 1	36	145385	1336103393	/users/cn/jespinosa/phecomp/data/CRG/20120502_FDF_CRG/20120502_FDF_CRG/20120502_FDF_CRG_c12.mtb	694	NA	WWSS	water	1	145349	1336103357	1	0.1	0.00277777777777778	2278	1
1	Drink 2	Intake 2	23	146260	1336104268	/users/cn/jespinosa/phecomp/data/CRG/20120502_FDF_CRG/20120502_FDF_CRG/20120502_FDF_CRG_c12.mtb	292	NA	WWSS	water	2	146237	1336104245	1	0.0800000000000001	0.00347826086956522	2279	1
1	Food 1	Intake 3	98	146670	1336104678	/users/cn/jespinosa/phecomp/data/CRG/20120502_FDF_CRG/20120502_FDF_CRG/20120502_FDF_CRG_c12.mtb	402	20	WWSS	food_sc	3	146572	1336104580	1	0.02	0.000204081632653061	2280	1
1	Food 1	Intake 3	313	147003	1336105011	/users/cn/jespinosa/phecomp/data/CRG/20120502_FDF_CRG/20120502_FDF_CRG/20120502_FDF_CRG_c12.mtb	403	3160	WWSS	food_sc	3	146690	1336104698	1	0.02	6.38977635782748e-05	2281	1
1	Drink 1	Intake 1	26	147021	1336105029	/users/cn/jespinosa/phecomp/data/CRG/20120502_FDF_CRG/20120502_FDF_CRG/20120502_FDF_CRG_c12.mtb	696	NA	WWSS	water	1	146995	1336105003	1	0.0800000000000001	0.00307692307692308	2282	1
1	Drink 1	Intake 1	31	150171	1336108179	/users/cn/jespinosa/phecomp/data/CRG/20120502_FDF_CRG/20120502_FDF_CRG/20120502_FDF_CRG_c12.mtb	706	NA	WWSS	water	1	150140	1336108148	1	0.0600000000000001	0.00193548387096775	2283	1
1	Food 1	Intake 3	136	150299	1336108307	/users/cn/jespinosa/phecomp/data/CRG/20120502_FDF_CRG/20120502_FDF_CRG/20120502_FDF_CRG_c12.mtb	408	143	WWSS	food_sc	3	150163	1336108171	1	0.02	0.000147058823529412	2284	1
1	Food 1	Intake 3	161	150603	1336108611	/users/cn/jespinosa/phecomp/data/CRG/20120502_FDF_CRG/20120502_FDF_CRG/20120502_FDF_CRG_c12.mtb	410	85	WWSS	food_sc	3	150442	1336108450	1	0.04	0.000248447204968944	2285	1
1	Drink 1	Intake 1	22	150617	1336108625	/users/cn/jespinosa/phecomp/data/CRG/20120502_FDF_CRG/20120502_FDF_CRG/20120502_FDF_CRG_c12.mtb	708	NA	WWSS	water	1	150595	1336108603	1	0.04	0.00181818181818182	2286	1
1	Food 1	Intake 3	86	150774	1336108782	/users/cn/jespinosa/phecomp/data/CRG/20120502_FDF_CRG/20120502_FDF_CRG/20120502_FDF_CRG_c12.mtb	411	17	WWSS	food_sc	3	150688	1336108696	1	0.02	0.000232558139534884	2287	1
1	Food 1	Intake 3	246	151037	1336109045	/users/cn/jespinosa/phecomp/data/CRG/20120502_FDF_CRG/20120502_FDF_CRG/20120502_FDF_CRG_c12.mtb	412	57	WWSS	food_sc	3	150791	1336108799	1	0.02	8.13008130081301e-05	2288	1
1	Drink 2	Intake 2	25	151059	1336109067	/users/cn/jespinosa/phecomp/data/CRG/20120502_FDF_CRG/20120502_FDF_CRG/20120502_FDF_CRG_c12.mtb	295	NA	WWSS	water	2	151034	1336109042	1	0.0800000000000001	0.0032	2289	1
1	Food 1	Intake 3	189	151283	1336109291	/users/cn/jespinosa/phecomp/data/CRG/20120502_FDF_CRG/20120502_FDF_CRG/20120502_FDF_CRG_c12.mtb	413	6260	WWSS	food_sc	3	151094	1336109102	1	0.0599999999999996	0.000317460317460315	2290	1
1	Drink 1	Intake 1	36	151425	1336109433	/users/cn/jespinosa/phecomp/data/CRG/20120502_FDF_CRG/20120502_FDF_CRG/20120502_FDF_CRG_c12.mtb	710	NA	WWSS	water	1	151389	1336109397	1	0.12	0.00333333333333333	2291	1
1	Food 1	Intake 3	36	157579	1336115587	/users/cn/jespinosa/phecomp/data/CRG/20120502_FDF_CRG/20120502_FDF_CRG/20120502_FDF_CRG_c12.mtb	419	105	WWSS	food_sc	3	157543	1336115551	1	0.0200000000000005	0.000555555555555569	2292	1
1	Food 2	Intake 4	62	157746	1336115754	/users/cn/jespinosa/phecomp/data/CRG/20120502_FDF_CRG/20120502_FDF_CRG/20120502_FDF_CRG_c12.mtb	420	8	WWSS	food_sc	4	157684	1336115692	1	0.02	0.00032258064516129	2293	1
1	Food 2	Intake 4	36	157790	1336115798	/users/cn/jespinosa/phecomp/data/CRG/20120502_FDF_CRG/20120502_FDF_CRG/20120502_FDF_CRG_c12.mtb	421	18916	WWSS	food_sc	4	157754	1336115762	1	0.04	0.00111111111111111	2294	1
1	Drink 1	Intake 1	104	159007	1336117015	/users/cn/jespinosa/phecomp/data/CRG/20120502_FDF_CRG/20120502_FDF_CRG/20120502_FDF_CRG_c12.mtb	727	NA	WWSS	water	1	158903	1336116911	1	0.02	0.000192307692307692	2295	1
1	Drink 2	Intake 2	174	1099	1336123285	/users/cn/jespinosa/phecomp/data/CRG/20120502_FDF_CRG/20120502_FDF_CRG/20120504_FDF_CRG_c12.mtb	371	NA	WWSS	water	2	925	1336123111	1	0.02	0.000114942528735632	2296	1
1	Drink 2	Intake 2	84	1229	1336123415	/users/cn/jespinosa/phecomp/data/CRG/20120502_FDF_CRG/20120502_FDF_CRG/20120504_FDF_CRG_c12.mtb	372	NA	WWSS	water	2	1145	1336123331	1	0.02	0.000238095238095238	2297	1
1	Drink 2	Intake 2	38	2172	1336124358	/users/cn/jespinosa/phecomp/data/CRG/20120502_FDF_CRG/20120502_FDF_CRG/20120504_FDF_CRG_c12.mtb	376	NA	WWSS	water	2	2134	1336124320	1	0.02	0.000526315789473684	2298	1
1	Drink 2	Intake 2	62	3174	1336125360	/users/cn/jespinosa/phecomp/data/CRG/20120502_FDF_CRG/20120502_FDF_CRG/20120504_FDF_CRG_c12.mtb	384	NA	WWSS	water	2	3112	1336125298	1	0.02	0.00032258064516129	2299	1
1	Drink 2	Intake 2	246	3997	1336126183	/users/cn/jespinosa/phecomp/data/CRG/20120502_FDF_CRG/20120502_FDF_CRG/20120504_FDF_CRG_c12.mtb	389	NA	WWSS	water	2	3751	1336125937	1	0.04	0.00016260162601626	2300	1
1	Drink 2	Intake 2	54	5513	1336127699	/users/cn/jespinosa/phecomp/data/CRG/20120502_FDF_CRG/20120502_FDF_CRG/20120504_FDF_CRG_c12.mtb	398	NA	WWSS	water	2	5459	1336127645	1	0.02	0.00037037037037037	2301	1
1	Drink 1	Intake 1	17	6431	1336128617	/users/cn/jespinosa/phecomp/data/CRG/20120502_FDF_CRG/20120502_FDF_CRG/20120504_FDF_CRG_c12.mtb	923	NA	WWSS	water	1	6414	1336128600	1	0.02	0.00117647058823529	2302	1
1	Drink 2	Intake 2	149	7591	1336129777	/users/cn/jespinosa/phecomp/data/CRG/20120502_FDF_CRG/20120502_FDF_CRG/20120504_FDF_CRG_c12.mtb	406	NA	WWSS	water	2	7442	1336129628	1	0.02	0.000134228187919463	2303	1
1	Food 2	Intake 4	59	12587	1336134773	/users/cn/jespinosa/phecomp/data/CRG/20120502_FDF_CRG/20120502_FDF_CRG/20120504_FDF_CRG_c12.mtb	742	428	WWSS	food_sc	4	12528	1336134714	1	0.02	0.000338983050847458	2304	1
1	Food 1	Intake 3	286	13301	1336135487	/users/cn/jespinosa/phecomp/data/CRG/20120502_FDF_CRG/20120502_FDF_CRG/20120504_FDF_CRG_c12.mtb	556	8445	WWSS	food_sc	3	13015	1336135201	1	0.08	0.00027972027972028	2305	1
1	Drink 1	Intake 1	30	13329	1336135515	/users/cn/jespinosa/phecomp/data/CRG/20120502_FDF_CRG/20120502_FDF_CRG/20120504_FDF_CRG_c12.mtb	930	NA	WWSS	water	1	13299	1336135485	1	0.04	0.00133333333333333	2306	1
1	Drink 2	Intake 2	18	13519	1336135705	/users/cn/jespinosa/phecomp/data/CRG/20120502_FDF_CRG/20120502_FDF_CRG/20120504_FDF_CRG_c12.mtb	411	NA	WWSS	water	2	13501	1336135687	1	0.02	0.00111111111111111	2307	1
1	Food 1	Intake 3	426	22172	1336144358	/users/cn/jespinosa/phecomp/data/CRG/20120502_FDF_CRG/20120502_FDF_CRG/20120504_FDF_CRG_c12.mtb	559	5032	WWSS	food_sc	3	21746	1336143932	1	0.12	0.00028169014084507	2308	1
1	Drink 1	Intake 1	16	22185	1336144371	/users/cn/jespinosa/phecomp/data/CRG/20120502_FDF_CRG/20120502_FDF_CRG/20120504_FDF_CRG_c12.mtb	932	NA	WWSS	water	1	22169	1336144355	1	0.04	0.0025	2309	1
1	Drink 1	Intake 1	17	22956	1336145142	/users/cn/jespinosa/phecomp/data/CRG/20120502_FDF_CRG/20120502_FDF_CRG/20120504_FDF_CRG_c12.mtb	936	NA	WWSS	water	1	22939	1336145125	1	0.08	0.00470588235294118	2310	1
1	Drink 2	Intake 2	17	25303	1336147489	/users/cn/jespinosa/phecomp/data/CRG/20120502_FDF_CRG/20120502_FDF_CRG/20120504_FDF_CRG_c12.mtb	413	NA	WWSS	water	2	25286	1336147472	1	0.04	0.00235294117647059	2311	1
1	Drink 2	Intake 2	557	26353	1336148539	/users/cn/jespinosa/phecomp/data/CRG/20120502_FDF_CRG/20120502_FDF_CRG/20120504_FDF_CRG_c12.mtb	416	NA	WWSS	water	2	25796	1336147982	1	0.02	3.59066427289048e-05	2312	1
1	Drink 2	Intake 2	64	26587	1336148773	/users/cn/jespinosa/phecomp/data/CRG/20120502_FDF_CRG/20120502_FDF_CRG/20120504_FDF_CRG_c12.mtb	418	NA	WWSS	water	2	26523	1336148709	1	0.04	0.000625	2313	1
1	Food 1	Intake 3	150	27354	1336149540	/users/cn/jespinosa/phecomp/data/CRG/20120502_FDF_CRG/20120502_FDF_CRG/20120504_FDF_CRG_c12.mtb	561	5	WWSS	food_sc	3	27204	1336149390	1	0.02	0.000133333333333333	2314	1
1	Food 1	Intake 3	383	27742	1336149928	/users/cn/jespinosa/phecomp/data/CRG/20120502_FDF_CRG/20120502_FDF_CRG/20120504_FDF_CRG_c12.mtb	562	3419	WWSS	food_sc	3	27359	1336149545	1	0.1	0.000261096605744125	2315	1
1	Drink 1	Intake 1	20	28381	1336150567	/users/cn/jespinosa/phecomp/data/CRG/20120502_FDF_CRG/20120502_FDF_CRG/20120504_FDF_CRG_c12.mtb	942	NA	WWSS	water	1	28361	1336150547	1	0.14	0.007	2316	1
1	Food 1	Intake 3	335	31496	1336153682	/users/cn/jespinosa/phecomp/data/CRG/20120502_FDF_CRG/20120502_FDF_CRG/20120504_FDF_CRG_c12.mtb	563	24	WWSS	food_sc	3	31161	1336153347	1	0.1	0.000298507462686567	2317	1
1	Food 1	Intake 3	110	31630	1336153816	/users/cn/jespinosa/phecomp/data/CRG/20120502_FDF_CRG/20120502_FDF_CRG/20120504_FDF_CRG_c12.mtb	564	530	WWSS	food_sc	3	31520	1336153706	1	0.1	0.000909090909090909	2318	1
1	Drink 1	Intake 1	23	31677	1336153863	/users/cn/jespinosa/phecomp/data/CRG/20120502_FDF_CRG/20120502_FDF_CRG/20120504_FDF_CRG_c12.mtb	944	NA	WWSS	water	1	31654	1336153840	1	0.02	0.000869565217391304	2319	1
1	Drink 1	Intake 1	13	32124	1336154310	/users/cn/jespinosa/phecomp/data/CRG/20120502_FDF_CRG/20120502_FDF_CRG/20120504_FDF_CRG_c12.mtb	945	NA	WWSS	water	1	32111	1336154297	1	0.06	0.00461538461538461	2320	1
1	Food 1	Intake 3	218	32378	1336154564	/users/cn/jespinosa/phecomp/data/CRG/20120502_FDF_CRG/20120502_FDF_CRG/20120504_FDF_CRG_c12.mtb	565	1610	WWSS	food_sc	3	32160	1336154346	1	0.0599999999999999	0.000275229357798165	2321	1
1	Drink 1	Intake 1	17	33523	1336155709	/users/cn/jespinosa/phecomp/data/CRG/20120502_FDF_CRG/20120502_FDF_CRG/20120504_FDF_CRG_c12.mtb	947	NA	WWSS	water	1	33506	1336155692	1	0.08	0.00470588235294118	2322	1
1	Food 1	Intake 3	340	34328	1336156514	/users/cn/jespinosa/phecomp/data/CRG/20120502_FDF_CRG/20120502_FDF_CRG/20120504_FDF_CRG_c12.mtb	567	19	WWSS	food_sc	3	33988	1336156174	1	0.0600000000000001	0.000176470588235294	2323	1
1	Food 1	Intake 3	23	34370	1336156556	/users/cn/jespinosa/phecomp/data/CRG/20120502_FDF_CRG/20120502_FDF_CRG/20120504_FDF_CRG_c12.mtb	568	494	WWSS	food_sc	3	34347	1336156533	1	0.02	0.000869565217391304	2324	1
1	Food 2	Intake 4	282	35146	1336157332	/users/cn/jespinosa/phecomp/data/CRG/20120502_FDF_CRG/20120502_FDF_CRG/20120504_FDF_CRG_c12.mtb	748	441	WWSS	food_sc	4	34864	1336157050	1	0.1	0.000354609929078014	2325	1
1	Drink 1	Intake 1	26	35171	1336157357	/users/cn/jespinosa/phecomp/data/CRG/20120502_FDF_CRG/20120502_FDF_CRG/20120504_FDF_CRG_c12.mtb	949	NA	WWSS	water	1	35145	1336157331	1	0.0800000000000001	0.00307692307692308	2326	1
1	Food 2	Intake 4	177	35764	1336157950	/users/cn/jespinosa/phecomp/data/CRG/20120502_FDF_CRG/20120502_FDF_CRG/20120504_FDF_CRG_c12.mtb	750	746	WWSS	food_sc	4	35587	1336157773	1	0.06	0.000338983050847458	2327	1
1	Food 2	Intake 4	391	36901	1336159087	/users/cn/jespinosa/phecomp/data/CRG/20120502_FDF_CRG/20120502_FDF_CRG/20120504_FDF_CRG_c12.mtb	758	538	WWSS	food_sc	4	36510	1336158696	1	0.16	0.00040920716112532	2328	1
1	Drink 1	Intake 1	34	36928	1336159114	/users/cn/jespinosa/phecomp/data/CRG/20120502_FDF_CRG/20120502_FDF_CRG/20120504_FDF_CRG_c12.mtb	960	NA	WWSS	water	1	36894	1336159080	1	0.0800000000000001	0.00235294117647059	2329	1
1	Drink 1	Intake 1	12	37349	1336159535	/users/cn/jespinosa/phecomp/data/CRG/20120502_FDF_CRG/20120502_FDF_CRG/20120504_FDF_CRG_c12.mtb	962	NA	WWSS	water	1	37337	1336159523	1	0.0399999999999999	0.00333333333333332	2330	1
1	Food 2	Intake 4	241	37680	1336159866	/users/cn/jespinosa/phecomp/data/CRG/20120502_FDF_CRG/20120502_FDF_CRG/20120504_FDF_CRG_c12.mtb	761	2019	WWSS	food_sc	4	37439	1336159625	1	0.08	0.00033195020746888	2331	1
1	Drink 2	Intake 2	11	37688	1336159874	/users/cn/jespinosa/phecomp/data/CRG/20120502_FDF_CRG/20120502_FDF_CRG/20120504_FDF_CRG_c12.mtb	423	NA	WWSS	water	2	37677	1336159863	1	0.06	0.00545454545454545	2332	1
1	Food 2	Intake 4	371	40070	1336162256	/users/cn/jespinosa/phecomp/data/CRG/20120502_FDF_CRG/20120502_FDF_CRG/20120504_FDF_CRG_c12.mtb	763	19	WWSS	food_sc	4	39699	1336161885	1	0.12	0.000323450134770889	2333	1
1	Food 2	Intake 4	168	40257	1336162443	/users/cn/jespinosa/phecomp/data/CRG/20120502_FDF_CRG/20120502_FDF_CRG/20120504_FDF_CRG_c12.mtb	764	961	WWSS	food_sc	4	40089	1336162275	1	0.08	0.000476190476190476	2334	1
1	Drink 1	Intake 1	27	40280	1336162466	/users/cn/jespinosa/phecomp/data/CRG/20120502_FDF_CRG/20120502_FDF_CRG/20120504_FDF_CRG_c12.mtb	970	NA	WWSS	water	1	40253	1336162439	1	0.0600000000000001	0.00222222222222223	2335	1
1	Drink 1	Intake 1	16	40793	1336162979	/users/cn/jespinosa/phecomp/data/CRG/20120502_FDF_CRG/20120502_FDF_CRG/20120504_FDF_CRG_c12.mtb	972	NA	WWSS	water	1	40777	1336162963	1	0.02	0.00125	2336	1
1	Food 2	Intake 4	150	41368	1336163554	/users/cn/jespinosa/phecomp/data/CRG/20120502_FDF_CRG/20120502_FDF_CRG/20120504_FDF_CRG_c12.mtb	772	50	WWSS	food_sc	4	41218	1336163404	1	0.02	0.000133333333333333	2337	1
1	Food 2	Intake 4	41	41459	1336163645	/users/cn/jespinosa/phecomp/data/CRG/20120502_FDF_CRG/20120502_FDF_CRG/20120504_FDF_CRG_c12.mtb	773	319	WWSS	food_sc	4	41418	1336163604	1	0.02	0.00048780487804878	2338	1
1	Drink 1	Intake 1	16	41534	1336163720	/users/cn/jespinosa/phecomp/data/CRG/20120502_FDF_CRG/20120502_FDF_CRG/20120504_FDF_CRG_c12.mtb	975	NA	WWSS	water	1	41518	1336163704	1	0.0399999999999999	0.00249999999999999	2339	1
1	Drink 1	Intake 1	16	41580	1336163766	/users/cn/jespinosa/phecomp/data/CRG/20120502_FDF_CRG/20120502_FDF_CRG/20120504_FDF_CRG_c12.mtb	976	NA	WWSS	water	1	41564	1336163750	1	0.02	0.00125	2340	1
1	Food 2	Intake 4	159	41937	1336164123	/users/cn/jespinosa/phecomp/data/CRG/20120502_FDF_CRG/20120502_FDF_CRG/20120504_FDF_CRG_c12.mtb	774	1216	WWSS	food_sc	4	41778	1336163964	1	0.02	0.000125786163522013	2341	1
1	Drink 1	Intake 1	23	42887	1336165073	/users/cn/jespinosa/phecomp/data/CRG/20120502_FDF_CRG/20120502_FDF_CRG/20120504_FDF_CRG_c12.mtb	982	NA	WWSS	water	1	42864	1336165050	1	0.02	0.000869565217391304	2342	1
1	Food 1	Intake 3	451	43604	1336165790	/users/cn/jespinosa/phecomp/data/CRG/20120502_FDF_CRG/20120502_FDF_CRG/20120504_FDF_CRG_c12.mtb	591	521	WWSS	food_sc	3	43153	1336165339	1	0.16	0.000354767184035477	2343	1
1	Drink 1	Intake 1	31	43629	1336165815	/users/cn/jespinosa/phecomp/data/CRG/20120502_FDF_CRG/20120502_FDF_CRG/20120504_FDF_CRG_c12.mtb	983	NA	WWSS	water	1	43598	1336165784	1	0.12	0.00387096774193548	2344	1
1	Food 1	Intake 3	146	44271	1336166457	/users/cn/jespinosa/phecomp/data/CRG/20120502_FDF_CRG/20120502_FDF_CRG/20120504_FDF_CRG_c12.mtb	594	951	WWSS	food_sc	3	44125	1336166311	1	0.04	0.000273972602739726	2345	1
1	Drink 2	Intake 2	12	44472	1336166658	/users/cn/jespinosa/phecomp/data/CRG/20120502_FDF_CRG/20120502_FDF_CRG/20120504_FDF_CRG_c12.mtb	424	NA	WWSS	water	2	44460	1336166646	1	0.04	0.00333333333333333	2346	1
1	Drink 1	Intake 1	10	44518	1336166704	/users/cn/jespinosa/phecomp/data/CRG/20120502_FDF_CRG/20120502_FDF_CRG/20120504_FDF_CRG_c12.mtb	987	NA	WWSS	water	1	44508	1336166694	1	0.02	0.002	2347	1
1	Drink 1	Intake 1	23	45163	1336167349	/users/cn/jespinosa/phecomp/data/CRG/20120502_FDF_CRG/20120502_FDF_CRG/20120504_FDF_CRG_c12.mtb	989	NA	WWSS	water	1	45140	1336167326	1	0.02	0.000869565217391304	2348	1
1	Food 1	Intake 3	69	45291	1336167477	/users/cn/jespinosa/phecomp/data/CRG/20120502_FDF_CRG/20120502_FDF_CRG/20120504_FDF_CRG_c12.mtb	597	17	WWSS	food_sc	3	45222	1336167408	1	0.04	0.000579710144927536	2349	1
1	Food 1	Intake 3	260	45568	1336167754	/users/cn/jespinosa/phecomp/data/CRG/20120502_FDF_CRG/20120502_FDF_CRG/20120504_FDF_CRG_c12.mtb	598	3805	WWSS	food_sc	3	45308	1336167494	1	0.08	0.000307692307692308	2350	1
1	Drink 2	Intake 2	12	45573	1336167759	/users/cn/jespinosa/phecomp/data/CRG/20120502_FDF_CRG/20120502_FDF_CRG/20120504_FDF_CRG_c12.mtb	425	NA	WWSS	water	2	45561	1336167747	1	0.04	0.00333333333333333	2351	1
1	Food 1	Intake 3	369	49742	1336171928	/users/cn/jespinosa/phecomp/data/CRG/20120502_FDF_CRG/20120502_FDF_CRG/20120504_FDF_CRG_c12.mtb	600	117	WWSS	food_sc	3	49373	1336171559	1	0.0600000000000001	0.00016260162601626	2352	1
1	Food 1	Intake 3	361	50220	1336172406	/users/cn/jespinosa/phecomp/data/CRG/20120502_FDF_CRG/20120502_FDF_CRG/20120504_FDF_CRG_c12.mtb	601	664	WWSS	food_sc	3	49859	1336172045	1	0.14	0.000387811634349031	2353	1
1	Drink 2	Intake 2	28	50247	1336172433	/users/cn/jespinosa/phecomp/data/CRG/20120502_FDF_CRG/20120502_FDF_CRG/20120504_FDF_CRG_c12.mtb	426	NA	WWSS	water	2	50219	1336172405	1	0.08	0.00285714285714286	2354	1
1	Drink 2	Intake 2	15	50730	1336172916	/users/cn/jespinosa/phecomp/data/CRG/20120502_FDF_CRG/20120502_FDF_CRG/20120504_FDF_CRG_c12.mtb	428	NA	WWSS	water	2	50715	1336172901	1	0.02	0.00133333333333333	2355	1
1	Drink 2	Intake 2	20	50754	1336172940	/users/cn/jespinosa/phecomp/data/CRG/20120502_FDF_CRG/20120502_FDF_CRG/20120504_FDF_CRG_c12.mtb	429	NA	WWSS	water	2	50734	1336172920	1	0.08	0.004	2356	1
1	Food 1	Intake 3	260	51144	1336173330	/users/cn/jespinosa/phecomp/data/CRG/20120502_FDF_CRG/20120502_FDF_CRG/20120504_FDF_CRG_c12.mtb	607	513	WWSS	food_sc	3	50884	1336173070	1	0.04	0.000153846153846154	2357	1
1	Drink 2	Intake 2	24	51165	1336173351	/users/cn/jespinosa/phecomp/data/CRG/20120502_FDF_CRG/20120502_FDF_CRG/20120504_FDF_CRG_c12.mtb	430	NA	WWSS	water	2	51141	1336173327	1	0.0599999999999999	0.0025	2358	1
1	Drink 2	Intake 2	35	51363	1336173549	/users/cn/jespinosa/phecomp/data/CRG/20120502_FDF_CRG/20120502_FDF_CRG/20120504_FDF_CRG_c12.mtb	432	NA	WWSS	water	2	51328	1336173514	1	0.02	0.000571428571428571	2359	1
1	Drink 2	Intake 2	13	51528	1336173714	/users/cn/jespinosa/phecomp/data/CRG/20120502_FDF_CRG/20120502_FDF_CRG/20120504_FDF_CRG_c12.mtb	433	NA	WWSS	water	2	51515	1336173701	1	0.0600000000000001	0.00461538461538462	2360	1
1	Food 1	Intake 3	186	51843	1336174029	/users/cn/jespinosa/phecomp/data/CRG/20120502_FDF_CRG/20120502_FDF_CRG/20120504_FDF_CRG_c12.mtb	609	73	WWSS	food_sc	3	51657	1336173843	1	0.0600000000000001	0.000322580645161291	2361	1
1	Drink 1	Intake 1	26	51922	1336174108	/users/cn/jespinosa/phecomp/data/CRG/20120502_FDF_CRG/20120502_FDF_CRG/20120504_FDF_CRG_c12.mtb	1000	NA	WWSS	water	1	51896	1336174082	1	0.02	0.000769230769230769	2362	1
1	Food 1	Intake 3	86	52002	1336174188	/users/cn/jespinosa/phecomp/data/CRG/20120502_FDF_CRG/20120502_FDF_CRG/20120504_FDF_CRG_c12.mtb	610	6	WWSS	food_sc	3	51916	1336174102	1	0.02	0.000232558139534884	2363	1
1	Food 1	Intake 3	303	52311	1336174497	/users/cn/jespinosa/phecomp/data/CRG/20120502_FDF_CRG/20120502_FDF_CRG/20120504_FDF_CRG_c12.mtb	611	4	WWSS	food_sc	3	52008	1336174194	1	0.14	0.000462046204620462	2364	1
1	Food 1	Intake 3	62	52377	1336174563	/users/cn/jespinosa/phecomp/data/CRG/20120502_FDF_CRG/20120502_FDF_CRG/20120504_FDF_CRG_c12.mtb	612	714	WWSS	food_sc	3	52315	1336174501	1	0.04	0.000645161290322581	2365	1
1	Drink 1	Intake 1	17	52486	1336174672	/users/cn/jespinosa/phecomp/data/CRG/20120502_FDF_CRG/20120502_FDF_CRG/20120504_FDF_CRG_c12.mtb	1001	NA	WWSS	water	1	52469	1336174655	1	0.02	0.00117647058823529	2366	1
1	Drink 1	Intake 1	16	52611	1336174797	/users/cn/jespinosa/phecomp/data/CRG/20120502_FDF_CRG/20120502_FDF_CRG/20120504_FDF_CRG_c12.mtb	1002	NA	WWSS	water	1	52595	1336174781	1	0.02	0.00125	2367	1
1	Drink 2	Intake 2	51	52744	1336174930	/users/cn/jespinosa/phecomp/data/CRG/20120502_FDF_CRG/20120502_FDF_CRG/20120504_FDF_CRG_c12.mtb	435	NA	WWSS	water	2	52693	1336174879	1	0.1	0.00196078431372549	2368	1
1	Drink 2	Intake 2	12	52779	1336174965	/users/cn/jespinosa/phecomp/data/CRG/20120502_FDF_CRG/20120502_FDF_CRG/20120504_FDF_CRG_c12.mtb	436	NA	WWSS	water	2	52767	1336174953	1	0.02	0.00166666666666667	2369	1
1	Drink 1	Intake 1	21	53094	1336175280	/users/cn/jespinosa/phecomp/data/CRG/20120502_FDF_CRG/20120502_FDF_CRG/20120504_FDF_CRG_c12.mtb	1005	NA	WWSS	water	1	53073	1336175259	1	0.02	0.000952380952380952	2370	1
1	Food 1	Intake 3	78	53169	1336175355	/users/cn/jespinosa/phecomp/data/CRG/20120502_FDF_CRG/20120502_FDF_CRG/20120504_FDF_CRG_c12.mtb	615	2757	WWSS	food_sc	3	53091	1336175277	1	0.04	0.000512820512820513	2371	1
1	Drink 1	Intake 1	9	53234	1336175420	/users/cn/jespinosa/phecomp/data/CRG/20120502_FDF_CRG/20120502_FDF_CRG/20120504_FDF_CRG_c12.mtb	1006	NA	WWSS	water	1	53225	1336175411	1	0.02	0.00222222222222222	2372	1
1	Drink 1	Intake 1	17	53276	1336175462	/users/cn/jespinosa/phecomp/data/CRG/20120502_FDF_CRG/20120502_FDF_CRG/20120504_FDF_CRG_c12.mtb	1007	NA	WWSS	water	1	53259	1336175445	1	0.02	0.00117647058823529	2373	1
1	Drink 2	Intake 2	21	53466	1336175652	/users/cn/jespinosa/phecomp/data/CRG/20120502_FDF_CRG/20120502_FDF_CRG/20120504_FDF_CRG_c12.mtb	437	NA	WWSS	water	2	53445	1336175631	1	0.0399999999999999	0.0019047619047619	2374	1
1	Drink 1	Intake 1	17	54380	1336176566	/users/cn/jespinosa/phecomp/data/CRG/20120502_FDF_CRG/20120502_FDF_CRG/20120504_FDF_CRG_c12.mtb	1009	NA	WWSS	water	1	54363	1336176549	1	0.0399999999999998	0.00235294117647058	2375	1
1	Food 1	Intake 3	18	55944	1336178130	/users/cn/jespinosa/phecomp/data/CRG/20120502_FDF_CRG/20120502_FDF_CRG/20120504_FDF_CRG_c12.mtb	617	12505	WWSS	food_sc	3	55926	1336178112	1	0.32	0.0177777777777778	2376	1
1	Drink 1	Intake 1	36	56386	1336178572	/users/cn/jespinosa/phecomp/data/CRG/20120502_FDF_CRG/20120502_FDF_CRG/20120504_FDF_CRG_c12.mtb	1010	NA	WWSS	water	1	56350	1336178536	1	0.0600000000000001	0.00166666666666667	2377	1
1	Drink 1	Intake 1	23	56891	1336179077	/users/cn/jespinosa/phecomp/data/CRG/20120502_FDF_CRG/20120502_FDF_CRG/20120504_FDF_CRG_c12.mtb	1013	NA	WWSS	water	1	56868	1336179054	1	0.04	0.00173913043478261	2378	1
1	Drink 2	Intake 2	23	57165	1336179351	/users/cn/jespinosa/phecomp/data/CRG/20120502_FDF_CRG/20120502_FDF_CRG/20120504_FDF_CRG_c12.mtb	439	NA	WWSS	water	2	57142	1336179328	1	0.04	0.00173913043478261	2379	1
1	Drink 1	Intake 1	24	57285	1336179471	/users/cn/jespinosa/phecomp/data/CRG/20120502_FDF_CRG/20120502_FDF_CRG/20120504_FDF_CRG_c12.mtb	1014	NA	WWSS	water	1	57261	1336179447	1	0.04	0.00166666666666667	2380	1
1	Drink 2	Intake 2	15	57611	1336179797	/users/cn/jespinosa/phecomp/data/CRG/20120502_FDF_CRG/20120502_FDF_CRG/20120504_FDF_CRG_c12.mtb	440	NA	WWSS	water	2	57596	1336179782	1	0.02	0.00133333333333333	2381	1
1	Drink 2	Intake 2	39	58874	1336181060	/users/cn/jespinosa/phecomp/data/CRG/20120502_FDF_CRG/20120502_FDF_CRG/20120504_FDF_CRG_c12.mtb	441	NA	WWSS	water	2	58835	1336181021	1	0.08	0.00205128205128205	2382	1
1	Drink 2	Intake 2	17	58908	1336181094	/users/cn/jespinosa/phecomp/data/CRG/20120502_FDF_CRG/20120502_FDF_CRG/20120504_FDF_CRG_c12.mtb	442	NA	WWSS	water	2	58891	1336181077	1	0.02	0.00117647058823529	2383	1
1	Drink 2	Intake 2	19	58950	1336181136	/users/cn/jespinosa/phecomp/data/CRG/20120502_FDF_CRG/20120502_FDF_CRG/20120504_FDF_CRG_c12.mtb	443	NA	WWSS	water	2	58931	1336181117	1	0.0600000000000001	0.00315789473684211	2384	1
1	Drink 2	Intake 2	25	59059	1336181245	/users/cn/jespinosa/phecomp/data/CRG/20120502_FDF_CRG/20120502_FDF_CRG/20120504_FDF_CRG_c12.mtb	444	NA	WWSS	water	2	59034	1336181220	1	0.04	0.0016	2385	1
1	Drink 1	Intake 1	16	63614	1336185800	/users/cn/jespinosa/phecomp/data/CRG/20120502_FDF_CRG/20120502_FDF_CRG/20120504_FDF_CRG_c12.mtb	1019	NA	WWSS	water	1	63598	1336185784	1	0.02	0.00125	2386	1
1	Food 1	Intake 3	72	68521	1336190707	/users/cn/jespinosa/phecomp/data/CRG/20120502_FDF_CRG/20120502_FDF_CRG/20120504_FDF_CRG_c12.mtb	623	15	WWSS	food_sc	3	68449	1336190635	1	0.02	0.000277777777777778	2387	1
1	Food 1	Intake 3	551	69087	1336191273	/users/cn/jespinosa/phecomp/data/CRG/20120502_FDF_CRG/20120502_FDF_CRG/20120504_FDF_CRG_c12.mtb	624	54	WWSS	food_sc	3	68536	1336190722	1	0.1	0.000181488203266788	2388	1
1	Drink 2	Intake 2	22	69111	1336191297	/users/cn/jespinosa/phecomp/data/CRG/20120502_FDF_CRG/20120502_FDF_CRG/20120504_FDF_CRG_c12.mtb	446	NA	WWSS	water	2	69089	1336191275	1	0.0799999999999998	0.00363636363636363	2389	1
1	Food 1	Intake 3	35	69176	1336191362	/users/cn/jespinosa/phecomp/data/CRG/20120502_FDF_CRG/20120502_FDF_CRG/20120504_FDF_CRG_c12.mtb	625	35	WWSS	food_sc	3	69141	1336191327	1	0.02	0.000571428571428571	2390	1
1	Food 1	Intake 3	311	69522	1336191708	/users/cn/jespinosa/phecomp/data/CRG/20120502_FDF_CRG/20120502_FDF_CRG/20120504_FDF_CRG_c12.mtb	626	73	WWSS	food_sc	3	69211	1336191397	1	0.0800000000000001	0.000257234726688103	2391	1
1	Drink 1	Intake 1	36	69555	1336191741	/users/cn/jespinosa/phecomp/data/CRG/20120502_FDF_CRG/20120502_FDF_CRG/20120504_FDF_CRG_c12.mtb	1021	NA	WWSS	water	1	69519	1336191705	1	0.16	0.00444444444444444	2392	1
1	Food 1	Intake 3	137	69732	1336191918	/users/cn/jespinosa/phecomp/data/CRG/20120502_FDF_CRG/20120502_FDF_CRG/20120504_FDF_CRG_c12.mtb	627	452	WWSS	food_sc	3	69595	1336191781	1	0.0600000000000001	0.000437956204379563	2393	1
1	Drink 2	Intake 2	21	69933	1336192119	/users/cn/jespinosa/phecomp/data/CRG/20120502_FDF_CRG/20120502_FDF_CRG/20120504_FDF_CRG_c12.mtb	447	NA	WWSS	water	2	69912	1336192098	1	0.0600000000000001	0.00285714285714286	2394	1
1	Drink 1	Intake 1	30	70184	1336192370	/users/cn/jespinosa/phecomp/data/CRG/20120502_FDF_CRG/20120502_FDF_CRG/20120504_FDF_CRG_c12.mtb	1024	NA	WWSS	water	1	70154	1336192340	1	0.02	0.000666666666666667	2395	1
1	Food 1	Intake 3	230	70414	1336192600	/users/cn/jespinosa/phecomp/data/CRG/20120502_FDF_CRG/20120502_FDF_CRG/20120504_FDF_CRG_c12.mtb	629	6363	WWSS	food_sc	3	70184	1336192370	1	0.0600000000000001	0.000260869565217392	2396	1
1	Drink 1	Intake 1	30	70438	1336192624	/users/cn/jespinosa/phecomp/data/CRG/20120502_FDF_CRG/20120502_FDF_CRG/20120504_FDF_CRG_c12.mtb	1025	NA	WWSS	water	1	70408	1336192594	1	0.0800000000000001	0.00266666666666667	2397	1
1	Drink 2	Intake 2	17	71208	1336193394	/users/cn/jespinosa/phecomp/data/CRG/20120502_FDF_CRG/20120502_FDF_CRG/20120504_FDF_CRG_c12.mtb	449	NA	WWSS	water	2	71191	1336193377	1	0.02	0.00117647058823529	2398	1
1	Drink 1	Intake 1	53	71830	1336194016	/users/cn/jespinosa/phecomp/data/CRG/20120502_FDF_CRG/20120502_FDF_CRG/20120504_FDF_CRG_c12.mtb	1028	NA	WWSS	water	1	71777	1336193963	1	0.02	0.000377358490566038	2399	1
1	Drink 1	Intake 1	96	72982	1336195168	/users/cn/jespinosa/phecomp/data/CRG/20120502_FDF_CRG/20120502_FDF_CRG/20120504_FDF_CRG_c12.mtb	1044	NA	WWSS	water	1	72886	1336195072	1	0.02	0.000208333333333333	2400	1
1	Drink 2	Intake 2	15	74801	1336196987	/users/cn/jespinosa/phecomp/data/CRG/20120502_FDF_CRG/20120502_FDF_CRG/20120504_FDF_CRG_c12.mtb	463	NA	WWSS	water	2	74786	1336196972	1	0.02	0.00133333333333333	2401	1
1	Food 1	Intake 3	109	76886	1336199072	/users/cn/jespinosa/phecomp/data/CRG/20120502_FDF_CRG/20120502_FDF_CRG/20120504_FDF_CRG_c12.mtb	639	390	WWSS	food_sc	3	76777	1336198963	1	0.02	0.00018348623853211	2402	1
1	Drink 1	Intake 1	24	77191	1336199377	/users/cn/jespinosa/phecomp/data/CRG/20120502_FDF_CRG/20120502_FDF_CRG/20120504_FDF_CRG_c12.mtb	1056	NA	WWSS	water	1	77167	1336199353	1	0.04	0.00166666666666667	2403	1
1	Drink 1	Intake 1	31	77263	1336199449	/users/cn/jespinosa/phecomp/data/CRG/20120502_FDF_CRG/20120502_FDF_CRG/20120504_FDF_CRG_c12.mtb	1057	NA	WWSS	water	1	77232	1336199418	1	0.0799999999999998	0.00258064516129032	2404	1
1	Food 1	Intake 3	105	77381	1336199567	/users/cn/jespinosa/phecomp/data/CRG/20120502_FDF_CRG/20120502_FDF_CRG/20120504_FDF_CRG_c12.mtb	642	1631	WWSS	food_sc	3	77276	1336199462	1	0.02	0.00019047619047619	2405	1
1	Drink 1	Intake 1	28	77944	1336200130	/users/cn/jespinosa/phecomp/data/CRG/20120502_FDF_CRG/20120502_FDF_CRG/20120504_FDF_CRG_c12.mtb	1059	NA	WWSS	water	1	77916	1336200102	1	0.02	0.000714285714285714	2406	1
1	Drink 1	Intake 1	26	78014	1336200200	/users/cn/jespinosa/phecomp/data/CRG/20120502_FDF_CRG/20120502_FDF_CRG/20120504_FDF_CRG_c12.mtb	1060	NA	WWSS	water	1	77988	1336200174	1	0.0399999999999998	0.00153846153846153	2407	1
1	Drink 1	Intake 1	109	78129	1336200315	/users/cn/jespinosa/phecomp/data/CRG/20120502_FDF_CRG/20120502_FDF_CRG/20120504_FDF_CRG_c12.mtb	1061	NA	WWSS	water	1	78020	1336200206	1	0.1	0.000917431192660551	2408	1
1	Drink 1	Intake 1	50	78334	1336200520	/users/cn/jespinosa/phecomp/data/CRG/20120502_FDF_CRG/20120502_FDF_CRG/20120504_FDF_CRG_c12.mtb	1063	NA	WWSS	water	1	78284	1336200470	1	0.02	0.0004	2409	1
1	Drink 1	Intake 1	23	78994	1336201180	/users/cn/jespinosa/phecomp/data/CRG/20120502_FDF_CRG/20120502_FDF_CRG/20120504_FDF_CRG_c12.mtb	1066	NA	WWSS	water	1	78971	1336201157	1	0.02	0.000869565217391304	2410	1
1	Food 2	Intake 4	54	79066	1336201252	/users/cn/jespinosa/phecomp/data/CRG/20120502_FDF_CRG/20120502_FDF_CRG/20120504_FDF_CRG_c12.mtb	824	2076	WWSS	food_sc	4	79012	1336201198	1	0.02	0.00037037037037037	2411	1
1	Drink 2	Intake 2	45	79245	1336201431	/users/cn/jespinosa/phecomp/data/CRG/20120502_FDF_CRG/20120502_FDF_CRG/20120504_FDF_CRG_c12.mtb	465	NA	WWSS	water	2	79200	1336201386	1	0.02	0.000444444444444444	2412	1
1	Drink 1	Intake 1	16	79494	1336201680	/users/cn/jespinosa/phecomp/data/CRG/20120502_FDF_CRG/20120502_FDF_CRG/20120504_FDF_CRG_c12.mtb	1072	NA	WWSS	water	1	79478	1336201664	1	0.02	0.00125	2413	1
1	Food 2	Intake 4	38	81180	1336203366	/users/cn/jespinosa/phecomp/data/CRG/20120502_FDF_CRG/20120502_FDF_CRG/20120504_FDF_CRG_c12.mtb	826	4	WWSS	food_sc	4	81142	1336203328	1	0.02	0.000526315789473684	2414	1
1	Food 2	Intake 4	51	81235	1336203421	/users/cn/jespinosa/phecomp/data/CRG/20120502_FDF_CRG/20120502_FDF_CRG/20120504_FDF_CRG_c12.mtb	827	327	WWSS	food_sc	4	81184	1336203370	1	0.02	0.000392156862745098	2415	1
1	Food 1	Intake 3	206	81768	1336203954	/users/cn/jespinosa/phecomp/data/CRG/20120502_FDF_CRG/20120502_FDF_CRG/20120504_FDF_CRG_c12.mtb	648	9842	WWSS	food_sc	3	81562	1336203748	1	0.0399999999999996	0.000194174757281551	2416	1
1	Drink 2	Intake 2	25	82051	1336204237	/users/cn/jespinosa/phecomp/data/CRG/20120502_FDF_CRG/20120502_FDF_CRG/20120504_FDF_CRG_c12.mtb	467	NA	WWSS	water	2	82026	1336204212	1	0.04	0.0016	2417	1
1	Drink 1	Intake 1	16	82171	1336204357	/users/cn/jespinosa/phecomp/data/CRG/20120502_FDF_CRG/20120502_FDF_CRG/20120504_FDF_CRG_c12.mtb	1085	NA	WWSS	water	1	82155	1336204341	1	0.02	0.00125	2418	1
1	Drink 1	Intake 1	153	82967	1336205153	/users/cn/jespinosa/phecomp/data/CRG/20120502_FDF_CRG/20120502_FDF_CRG/20120504_FDF_CRG_c12.mtb	1089	NA	WWSS	water	1	82814	1336205000	1	0.02	0.000130718954248366	2419	1
1	Drink 1	Intake 1	44	83311	1336205497	/users/cn/jespinosa/phecomp/data/CRG/20120502_FDF_CRG/20120502_FDF_CRG/20120504_FDF_CRG_c12.mtb	1092	NA	WWSS	water	1	83267	1336205453	1	0.02	0.000454545454545455	2420	1
1	Drink 1	Intake 1	619	84408	1336206594	/users/cn/jespinosa/phecomp/data/CRG/20120502_FDF_CRG/20120502_FDF_CRG/20120504_FDF_CRG_c12.mtb	1096	NA	WWSS	water	1	83789	1336205975	1	0.02	3.23101777059774e-05	2421	1
1	Drink 1	Intake 1	137	86361	1336208547	/users/cn/jespinosa/phecomp/data/CRG/20120502_FDF_CRG/20120502_FDF_CRG/20120504_FDF_CRG_c12.mtb	1106	NA	WWSS	water	1	86224	1336208410	1	0.02	0.000145985401459854	2422	1
1	Drink 1	Intake 1	63	89277	1336211463	/users/cn/jespinosa/phecomp/data/CRG/20120502_FDF_CRG/20120502_FDF_CRG/20120504_FDF_CRG_c12.mtb	1122	NA	WWSS	water	1	89214	1336211400	1	0.02	0.000317460317460317	2423	1
1	Drink 1	Intake 1	26	90718	1336212904	/users/cn/jespinosa/phecomp/data/CRG/20120502_FDF_CRG/20120502_FDF_CRG/20120504_FDF_CRG_c12.mtb	1124	NA	WWSS	water	1	90692	1336212878	1	0.02	0.000769230769230769	2424	1
1	Food 2	Intake 4	182	91792	1336213978	/users/cn/jespinosa/phecomp/data/CRG/20120502_FDF_CRG/20120502_FDF_CRG/20120504_FDF_CRG_c12.mtb	833	17112	WWSS	food_sc	4	91610	1336213796	1	0.0599999999999999	0.000329670329670329	2425	1
1	Drink 1	Intake 1	21	93157	1336215343	/users/cn/jespinosa/phecomp/data/CRG/20120502_FDF_CRG/20120502_FDF_CRG/20120504_FDF_CRG_c12.mtb	1126	NA	WWSS	water	1	93136	1336215322	1	0.02	0.000952380952380952	2426	1
1	Food 1	Intake 3	122	109026	1336231212	/users/cn/jespinosa/phecomp/data/CRG/20120502_FDF_CRG/20120502_FDF_CRG/20120504_FDF_CRG_c12.mtb	656	50	WWSS	food_sc	3	108904	1336231090	1	0.0600000000000001	0.000491803278688525	2427	1
1	Food 1	Intake 3	81	109157	1336231343	/users/cn/jespinosa/phecomp/data/CRG/20120502_FDF_CRG/20120502_FDF_CRG/20120504_FDF_CRG_c12.mtb	658	15	WWSS	food_sc	3	109076	1336231262	1	0.04	0.000493827160493827	2428	1
1	Food 1	Intake 3	120	109292	1336231478	/users/cn/jespinosa/phecomp/data/CRG/20120502_FDF_CRG/20120502_FDF_CRG/20120504_FDF_CRG_c12.mtb	659	68	WWSS	food_sc	3	109172	1336231358	1	0.02	0.000166666666666667	2429	1
1	Food 1	Intake 3	86	109446	1336231632	/users/cn/jespinosa/phecomp/data/CRG/20120502_FDF_CRG/20120502_FDF_CRG/20120504_FDF_CRG_c12.mtb	660	3905	WWSS	food_sc	3	109360	1336231546	1	0.04	0.000465116279069767	2430	1
1	Drink 1	Intake 1	21	109572	1336231758	/users/cn/jespinosa/phecomp/data/CRG/20120502_FDF_CRG/20120502_FDF_CRG/20120504_FDF_CRG_c12.mtb	1130	NA	WWSS	water	1	109551	1336231737	1	0.02	0.000952380952380952	2431	1
1	Food 1	Intake 3	569	113920	1336236106	/users/cn/jespinosa/phecomp/data/CRG/20120502_FDF_CRG/20120502_FDF_CRG/20120504_FDF_CRG_c12.mtb	661	3135	WWSS	food_sc	3	113351	1336235537	1	0.2	0.000351493848857645	2432	1
1	Drink 1	Intake 1	20	113933	1336236119	/users/cn/jespinosa/phecomp/data/CRG/20120502_FDF_CRG/20120502_FDF_CRG/20120504_FDF_CRG_c12.mtb	1131	NA	WWSS	water	1	113913	1336236099	1	0.04	0.002	2433	1
1	Drink 1	Intake 1	23	114184	1336236370	/users/cn/jespinosa/phecomp/data/CRG/20120502_FDF_CRG/20120502_FDF_CRG/20120504_FDF_CRG_c12.mtb	1132	NA	WWSS	water	1	114161	1336236347	1	0.12	0.00521739130434783	2434	1
1	Food 1	Intake 3	202	117257	1336239443	/users/cn/jespinosa/phecomp/data/CRG/20120502_FDF_CRG/20120502_FDF_CRG/20120504_FDF_CRG_c12.mtb	664	18	WWSS	food_sc	3	117055	1336239241	1	0.0600000000000001	0.000297029702970298	2435	1
1	Food 1	Intake 3	117	117392	1336239578	/users/cn/jespinosa/phecomp/data/CRG/20120502_FDF_CRG/20120502_FDF_CRG/20120504_FDF_CRG_c12.mtb	665	153	WWSS	food_sc	3	117275	1336239461	1	0.0600000000000001	0.000512820512820514	2436	1
1	Food 1	Intake 3	124	117669	1336239855	/users/cn/jespinosa/phecomp/data/CRG/20120502_FDF_CRG/20120502_FDF_CRG/20120504_FDF_CRG_c12.mtb	666	1709	WWSS	food_sc	3	117545	1336239731	1	0.04	0.00032258064516129	2437	1
1	Drink 1	Intake 1	18	117740	1336239926	/users/cn/jespinosa/phecomp/data/CRG/20120502_FDF_CRG/20120502_FDF_CRG/20120504_FDF_CRG_c12.mtb	1135	NA	WWSS	water	1	117722	1336239908	1	0.0200000000000005	0.00111111111111114	2438	1
1	Drink 1	Intake 1	23	118995	1336241181	/users/cn/jespinosa/phecomp/data/CRG/20120502_FDF_CRG/20120502_FDF_CRG/20120504_FDF_CRG_c12.mtb	1136	NA	WWSS	water	1	118972	1336241158	1	0.0799999999999996	0.0034782608695652	2439	1
1	Food 1	Intake 3	347	119725	1336241911	/users/cn/jespinosa/phecomp/data/CRG/20120502_FDF_CRG/20120502_FDF_CRG/20120504_FDF_CRG_c12.mtb	671	429	WWSS	food_sc	3	119378	1336241564	1	0.0800000000000001	0.000230547550432277	2440	1
1	Drink 1	Intake 1	15	119751	1336241937	/users/cn/jespinosa/phecomp/data/CRG/20120502_FDF_CRG/20120502_FDF_CRG/20120504_FDF_CRG_c12.mtb	1137	NA	WWSS	water	1	119736	1336241922	1	0.04	0.00266666666666667	2441	1
1	Food 1	Intake 3	131	120285	1336242471	/users/cn/jespinosa/phecomp/data/CRG/20120502_FDF_CRG/20120502_FDF_CRG/20120504_FDF_CRG_c12.mtb	673	669	WWSS	food_sc	3	120154	1336242340	1	0.02	0.000152671755725191	2442	1
1	Drink 1	Intake 1	23	120303	1336242489	/users/cn/jespinosa/phecomp/data/CRG/20120502_FDF_CRG/20120502_FDF_CRG/20120504_FDF_CRG_c12.mtb	1139	NA	WWSS	water	1	120280	1336242466	1	0.0800000000000001	0.00347826086956522	2443	1
1	Food 1	Intake 3	372	121326	1336243512	/users/cn/jespinosa/phecomp/data/CRG/20120502_FDF_CRG/20120502_FDF_CRG/20120504_FDF_CRG_c12.mtb	674	330	WWSS	food_sc	3	120954	1336243140	1	0.1	0.000268817204301075	2444	1
1	Food 1	Intake 3	132	121788	1336243974	/users/cn/jespinosa/phecomp/data/CRG/20120502_FDF_CRG/20120502_FDF_CRG/20120504_FDF_CRG_c12.mtb	676	1057	WWSS	food_sc	3	121656	1336243842	1	0.02	0.000151515151515152	2445	1
1	Food 1	Intake 3	308	123153	1336245339	/users/cn/jespinosa/phecomp/data/CRG/20120502_FDF_CRG/20120502_FDF_CRG/20120504_FDF_CRG_c12.mtb	682	321	WWSS	food_sc	3	122845	1336245031	1	0.02	6.49350649350649e-05	2446	1
1	Drink 2	Intake 2	25	123172	1336245358	/users/cn/jespinosa/phecomp/data/CRG/20120502_FDF_CRG/20120502_FDF_CRG/20120504_FDF_CRG_c12.mtb	470	NA	WWSS	water	2	123147	1336245333	1	0.12	0.0048	2447	1
1	Food 1	Intake 3	418	123892	1336246078	/users/cn/jespinosa/phecomp/data/CRG/20120502_FDF_CRG/20120502_FDF_CRG/20120504_FDF_CRG_c12.mtb	684	638	WWSS	food_sc	3	123474	1336245660	1	0.18	0.000430622009569378	2448	1
1	Drink 1	Intake 1	35	123944	1336246130	/users/cn/jespinosa/phecomp/data/CRG/20120502_FDF_CRG/20120502_FDF_CRG/20120504_FDF_CRG_c12.mtb	1145	NA	WWSS	water	1	123909	1336246095	1	0.14	0.004	2449	1
1	Food 1	Intake 3	91	124621	1336246807	/users/cn/jespinosa/phecomp/data/CRG/20120502_FDF_CRG/20120502_FDF_CRG/20120504_FDF_CRG_c12.mtb	686	157	WWSS	food_sc	3	124530	1336246716	1	0.02	0.00021978021978022	2450	1
1	Food 1	Intake 3	191	124969	1336247155	/users/cn/jespinosa/phecomp/data/CRG/20120502_FDF_CRG/20120502_FDF_CRG/20120504_FDF_CRG_c12.mtb	688	847	WWSS	food_sc	3	124778	1336246964	1	0.0999999999999996	0.000523560209424082	2451	1
1	Drink 1	Intake 1	41	125003	1336247189	/users/cn/jespinosa/phecomp/data/CRG/20120502_FDF_CRG/20120502_FDF_CRG/20120504_FDF_CRG_c12.mtb	1148	NA	WWSS	water	1	124962	1336247148	1	0.0800000000000001	0.00195121951219512	2452	1
1	Drink 1	Intake 1	30	125533	1336247719	/users/cn/jespinosa/phecomp/data/CRG/20120502_FDF_CRG/20120502_FDF_CRG/20120504_FDF_CRG_c12.mtb	1150	NA	WWSS	water	1	125503	1336247689	1	0.0800000000000001	0.00266666666666667	2453	1
1	Food 1	Intake 3	40	125856	1336248042	/users/cn/jespinosa/phecomp/data/CRG/20120502_FDF_CRG/20120502_FDF_CRG/20120504_FDF_CRG_c12.mtb	693	1305	WWSS	food_sc	3	125816	1336248002	1	0.02	0.0005	2454	1
1	Food 1	Intake 3	247	127408	1336249594	/users/cn/jespinosa/phecomp/data/CRG/20120502_FDF_CRG/20120502_FDF_CRG/20120504_FDF_CRG_c12.mtb	695	23	WWSS	food_sc	3	127161	1336249347	1	0.04	0.000161943319838057	2455	1
1	Food 1	Intake 3	178	127609	1336249795	/users/cn/jespinosa/phecomp/data/CRG/20120502_FDF_CRG/20120502_FDF_CRG/20120504_FDF_CRG_c12.mtb	696	1611	WWSS	food_sc	3	127431	1336249617	1	0.0600000000000001	0.000337078651685394	2456	1
1	Food 1	Intake 3	115	129335	1336251521	/users/cn/jespinosa/phecomp/data/CRG/20120502_FDF_CRG/20120502_FDF_CRG/20120504_FDF_CRG_c12.mtb	697	72	WWSS	food_sc	3	129220	1336251406	1	0.02	0.000173913043478261	2457	1
1	Food 2	Intake 4	186	129593	1336251779	/users/cn/jespinosa/phecomp/data/CRG/20120502_FDF_CRG/20120502_FDF_CRG/20120504_FDF_CRG_c12.mtb	852	160	WWSS	food_sc	4	129407	1336251593	1	0.04	0.00021505376344086	2458	1
1	Food 2	Intake 4	110	129863	1336252049	/users/cn/jespinosa/phecomp/data/CRG/20120502_FDF_CRG/20120502_FDF_CRG/20120504_FDF_CRG_c12.mtb	855	228	WWSS	food_sc	4	129753	1336251939	1	0.02	0.000181818181818182	2459	1
1	Food 2	Intake 4	33	130124	1336252310	/users/cn/jespinosa/phecomp/data/CRG/20120502_FDF_CRG/20120502_FDF_CRG/20120504_FDF_CRG_c12.mtb	858	33	WWSS	food_sc	4	130091	1336252277	1	0.02	0.000606060606060606	2460	1
1	Food 2	Intake 4	277	130434	1336252620	/users/cn/jespinosa/phecomp/data/CRG/20120502_FDF_CRG/20120502_FDF_CRG/20120504_FDF_CRG_c12.mtb	859	8	WWSS	food_sc	4	130157	1336252343	1	0.0599999999999999	0.000216606498194945	2461	1
1	Food 2	Intake 4	29	130471	1336252657	/users/cn/jespinosa/phecomp/data/CRG/20120502_FDF_CRG/20120502_FDF_CRG/20120504_FDF_CRG_c12.mtb	860	37	WWSS	food_sc	4	130442	1336252628	1	0.0600000000000001	0.00206896551724138	2462	1
1	Food 2	Intake 4	112	130620	1336252806	/users/cn/jespinosa/phecomp/data/CRG/20120502_FDF_CRG/20120502_FDF_CRG/20120504_FDF_CRG_c12.mtb	861	9	WWSS	food_sc	4	130508	1336252694	1	0.0600000000000001	0.000535714285714287	2463	1
1	Food 2	Intake 4	132	130761	1336252947	/users/cn/jespinosa/phecomp/data/CRG/20120502_FDF_CRG/20120502_FDF_CRG/20120504_FDF_CRG_c12.mtb	862	790	WWSS	food_sc	4	130629	1336252815	1	0.0600000000000001	0.000454545454545455	2464	1
1	Drink 1	Intake 1	39	130794	1336252980	/users/cn/jespinosa/phecomp/data/CRG/20120502_FDF_CRG/20120502_FDF_CRG/20120504_FDF_CRG_c12.mtb	1154	NA	WWSS	water	1	130755	1336252941	1	0.12	0.00307692307692308	2465	1
1	Drink 2	Intake 2	17	130801	1336252987	/users/cn/jespinosa/phecomp/data/CRG/20120502_FDF_CRG/20120502_FDF_CRG/20120504_FDF_CRG_c12.mtb	471	NA	WWSS	water	2	130784	1336252970	1	0.02	0.00117647058823529	2466	1
1	Drink 1	Intake 1	31	131446	1336253632	/users/cn/jespinosa/phecomp/data/CRG/20120502_FDF_CRG/20120502_FDF_CRG/20120504_FDF_CRG_c12.mtb	1158	NA	WWSS	water	1	131415	1336253601	1	0.1	0.0032258064516129	2467	1
1	Food 2	Intake 4	271	131822	1336254008	/users/cn/jespinosa/phecomp/data/CRG/20120502_FDF_CRG/20120502_FDF_CRG/20120504_FDF_CRG_c12.mtb	865	932	WWSS	food_sc	4	131551	1336253737	1	0.0999999999999999	0.0003690036900369	2468	1
1	Drink 1	Intake 1	20	131839	1336254025	/users/cn/jespinosa/phecomp/data/CRG/20120502_FDF_CRG/20120502_FDF_CRG/20120504_FDF_CRG_c12.mtb	1159	NA	WWSS	water	1	131819	1336254005	1	0.02	0.001	2469	1
1	Drink 1	Intake 1	29	132046	1336254232	/users/cn/jespinosa/phecomp/data/CRG/20120502_FDF_CRG/20120502_FDF_CRG/20120504_FDF_CRG_c12.mtb	1160	NA	WWSS	water	1	132017	1336254203	1	0.02	0.000689655172413793	2470	1
1	Food 2	Intake 4	89	132843	1336255029	/users/cn/jespinosa/phecomp/data/CRG/20120502_FDF_CRG/20120502_FDF_CRG/20120504_FDF_CRG_c12.mtb	871	2993	WWSS	food_sc	4	132754	1336254940	1	0.04	0.000449438202247191	2471	1
1	Drink 1	Intake 1	26	132993	1336255179	/users/cn/jespinosa/phecomp/data/CRG/20120502_FDF_CRG/20120502_FDF_CRG/20120504_FDF_CRG_c12.mtb	1163	NA	WWSS	water	1	132967	1336255153	1	0.0800000000000001	0.00307692307692308	2472	1
1	Food 2	Intake 4	24	135860	1336258046	/users/cn/jespinosa/phecomp/data/CRG/20120502_FDF_CRG/20120502_FDF_CRG/20120504_FDF_CRG_c12.mtb	875	17	WWSS	food_sc	4	135836	1336258022	1	0.02	0.000833333333333333	2473	1
1	Food 2	Intake 4	543	136420	1336258606	/users/cn/jespinosa/phecomp/data/CRG/20120502_FDF_CRG/20120502_FDF_CRG/20120504_FDF_CRG_c12.mtb	876	471	WWSS	food_sc	4	135877	1336258063	1	0.18	0.000331491712707182	2474	1
1	Drink 1	Intake 1	45	136457	1336258643	/users/cn/jespinosa/phecomp/data/CRG/20120502_FDF_CRG/20120502_FDF_CRG/20120504_FDF_CRG_c12.mtb	1168	NA	WWSS	water	1	136412	1336258598	1	0.04	0.000888888888888889	2475	1
1	Drink 1	Intake 1	22	136868	1336259054	/users/cn/jespinosa/phecomp/data/CRG/20120502_FDF_CRG/20120502_FDF_CRG/20120504_FDF_CRG_c12.mtb	1172	NA	WWSS	water	1	136846	1336259032	1	0.02	0.000909090909090909	2476	1
1	Food 2	Intake 4	129	137020	1336259206	/users/cn/jespinosa/phecomp/data/CRG/20120502_FDF_CRG/20120502_FDF_CRG/20120504_FDF_CRG_c12.mtb	881	188	WWSS	food_sc	4	136891	1336259077	1	0.04	0.000310077519379845	2477	1
1	Drink 1	Intake 1	39	137055	1336259241	/users/cn/jespinosa/phecomp/data/CRG/20120502_FDF_CRG/20120502_FDF_CRG/20120504_FDF_CRG_c12.mtb	1173	NA	WWSS	water	1	137016	1336259202	1	0.16	0.0041025641025641	2478	1
1	Food 2	Intake 4	134	137342	1336259528	/users/cn/jespinosa/phecomp/data/CRG/20120502_FDF_CRG/20120502_FDF_CRG/20120504_FDF_CRG_c12.mtb	882	59	WWSS	food_sc	4	137208	1336259394	1	0.0600000000000001	0.000447761194029852	2479	1
1	Food 2	Intake 4	49	137450	1336259636	/users/cn/jespinosa/phecomp/data/CRG/20120502_FDF_CRG/20120502_FDF_CRG/20120504_FDF_CRG_c12.mtb	883	1073	WWSS	food_sc	4	137401	1336259587	1	0.04	0.000816326530612245	2480	1
1	Drink 2	Intake 2	26	137655	1336259841	/users/cn/jespinosa/phecomp/data/CRG/20120502_FDF_CRG/20120502_FDF_CRG/20120504_FDF_CRG_c12.mtb	474	NA	WWSS	water	2	137629	1336259815	1	0.04	0.00153846153846154	2481	1
1	Drink 1	Intake 1	36	138222	1336260408	/users/cn/jespinosa/phecomp/data/CRG/20120502_FDF_CRG/20120502_FDF_CRG/20120504_FDF_CRG_c12.mtb	1178	NA	WWSS	water	1	138186	1336260372	1	0.02	0.000555555555555556	2482	1
1	Drink 2	Intake 2	22	138327	1336260513	/users/cn/jespinosa/phecomp/data/CRG/20120502_FDF_CRG/20120502_FDF_CRG/20120504_FDF_CRG_c12.mtb	476	NA	WWSS	water	2	138305	1336260491	1	0.0600000000000001	0.00272727272727273	2483	1
1	Food 2	Intake 4	91	138614	1336260800	/users/cn/jespinosa/phecomp/data/CRG/20120502_FDF_CRG/20120502_FDF_CRG/20120504_FDF_CRG_c12.mtb	887	831	WWSS	food_sc	4	138523	1336260709	1	0.0600000000000001	0.00065934065934066	2484	1
1	Food 2	Intake 4	75	139520	1336261706	/users/cn/jespinosa/phecomp/data/CRG/20120502_FDF_CRG/20120502_FDF_CRG/20120504_FDF_CRG_c12.mtb	891	582	WWSS	food_sc	4	139445	1336261631	1	0.4	0.00533333333333333	2485	1
1	Drink 1	Intake 1	18	139620	1336261806	/users/cn/jespinosa/phecomp/data/CRG/20120502_FDF_CRG/20120502_FDF_CRG/20120504_FDF_CRG_c12.mtb	1181	NA	WWSS	water	1	139602	1336261788	1	0.02	0.00111111111111111	2486	1
1	Drink 2	Intake 2	47	139872	1336262058	/users/cn/jespinosa/phecomp/data/CRG/20120502_FDF_CRG/20120502_FDF_CRG/20120504_FDF_CRG_c12.mtb	477	NA	WWSS	water	2	139825	1336262011	1	0.04	0.000851063829787234	2487	1
1	Food 2	Intake 4	59	140161	1336262347	/users/cn/jespinosa/phecomp/data/CRG/20120502_FDF_CRG/20120502_FDF_CRG/20120504_FDF_CRG_c12.mtb	895	11910	WWSS	food_sc	4	140102	1336262288	1	0.02	0.000338983050847458	2488	1
1	Drink 1	Intake 1	20	140412	1336262598	/users/cn/jespinosa/phecomp/data/CRG/20120502_FDF_CRG/20120502_FDF_CRG/20120504_FDF_CRG_c12.mtb	1184	NA	WWSS	water	1	140392	1336262578	1	0.04	0.002	2489	1
1	Drink 1	Intake 1	36	140502	1336262688	/users/cn/jespinosa/phecomp/data/CRG/20120502_FDF_CRG/20120502_FDF_CRG/20120504_FDF_CRG_c12.mtb	1185	NA	WWSS	water	1	140466	1336262652	1	0.0600000000000001	0.00166666666666667	2490	1
1	Drink 1	Intake 1	17	140715	1336262901	/users/cn/jespinosa/phecomp/data/CRG/20120502_FDF_CRG/20120502_FDF_CRG/20120504_FDF_CRG_c12.mtb	1186	NA	WWSS	water	1	140698	1336262884	1	0.02	0.00117647058823529	2491	1
1	Drink 2	Intake 2	17	144763	1336266949	/users/cn/jespinosa/phecomp/data/CRG/20120502_FDF_CRG/20120502_FDF_CRG/20120504_FDF_CRG_c12.mtb	480	NA	WWSS	water	2	144746	1336266932	1	0.02	0.00117647058823529	2492	1
1	Drink 1	Intake 1	36	148400	1336270586	/users/cn/jespinosa/phecomp/data/CRG/20120502_FDF_CRG/20120502_FDF_CRG/20120504_FDF_CRG_c12.mtb	1196	NA	WWSS	water	1	148364	1336270550	1	0.16	0.00444444444444444	2493	1
1	Food 2	Intake 4	102	152173	1336274359	/users/cn/jespinosa/phecomp/data/CRG/20120502_FDF_CRG/20120502_FDF_CRG/20120504_FDF_CRG_c12.mtb	907	12	WWSS	food_sc	4	152071	1336274257	1	0.02	0.000196078431372549	2494	1
1	Food 2	Intake 4	316	152501	1336274687	/users/cn/jespinosa/phecomp/data/CRG/20120502_FDF_CRG/20120502_FDF_CRG/20120504_FDF_CRG_c12.mtb	908	347	WWSS	food_sc	4	152185	1336274371	1	0.14	0.000443037974683544	2495	1
1	Drink 1	Intake 1	33	152529	1336274715	/users/cn/jespinosa/phecomp/data/CRG/20120502_FDF_CRG/20120502_FDF_CRG/20120504_FDF_CRG_c12.mtb	1198	NA	WWSS	water	1	152496	1336274682	1	0.0800000000000001	0.00242424242424243	2496	1
1	Food 2	Intake 4	78	152926	1336275112	/users/cn/jespinosa/phecomp/data/CRG/20120502_FDF_CRG/20120502_FDF_CRG/20120504_FDF_CRG_c12.mtb	912	54	WWSS	food_sc	4	152848	1336275034	1	0.0600000000000001	0.000769230769230771	2497	1
1	Food 2	Intake 4	51	153031	1336275217	/users/cn/jespinosa/phecomp/data/CRG/20120502_FDF_CRG/20120502_FDF_CRG/20120504_FDF_CRG_c12.mtb	913	131	WWSS	food_sc	4	152980	1336275166	1	0.02	0.000392156862745098	2498	1
1	Drink 1	Intake 1	65	153132	1336275318	/users/cn/jespinosa/phecomp/data/CRG/20120502_FDF_CRG/20120502_FDF_CRG/20120504_FDF_CRG_c12.mtb	1200	NA	WWSS	water	1	153067	1336275253	1	0.0999999999999996	0.00153846153846153	2499	1
1	Food 2	Intake 4	80	153242	1336275428	/users/cn/jespinosa/phecomp/data/CRG/20120502_FDF_CRG/20120502_FDF_CRG/20120504_FDF_CRG_c12.mtb	915	101	WWSS	food_sc	4	153162	1336275348	1	0.02	0.00025	2500	1
1	Drink 1	Intake 1	20	153254	1336275440	/users/cn/jespinosa/phecomp/data/CRG/20120502_FDF_CRG/20120502_FDF_CRG/20120504_FDF_CRG_c12.mtb	1201	NA	WWSS	water	1	153234	1336275420	1	0.02	0.001	2501	1
1	Food 2	Intake 4	88	153431	1336275617	/users/cn/jespinosa/phecomp/data/CRG/20120502_FDF_CRG/20120502_FDF_CRG/20120504_FDF_CRG_c12.mtb	916	2644	WWSS	food_sc	4	153343	1336275529	1	0.02	0.000227272727272727	2502	1
1	Drink 2	Intake 2	23	153459	1336275645	/users/cn/jespinosa/phecomp/data/CRG/20120502_FDF_CRG/20120502_FDF_CRG/20120504_FDF_CRG_c12.mtb	481	NA	WWSS	water	2	153436	1336275622	1	0.04	0.00173913043478261	2503	1
1	Drink 1	Intake 1	33	153552	1336275738	/users/cn/jespinosa/phecomp/data/CRG/20120502_FDF_CRG/20120502_FDF_CRG/20120504_FDF_CRG_c12.mtb	1203	NA	WWSS	water	1	153519	1336275705	1	0.02	0.000606060606060606	2504	1
1	Drink 1	Intake 1	28	153703	1336275889	/users/cn/jespinosa/phecomp/data/CRG/20120502_FDF_CRG/20120502_FDF_CRG/20120504_FDF_CRG_c12.mtb	1204	NA	WWSS	water	1	153675	1336275861	1	0.0800000000000001	0.00285714285714286	2505	1
1	Food 2	Intake 4	40	156115	1336278301	/users/cn/jespinosa/phecomp/data/CRG/20120502_FDF_CRG/20120502_FDF_CRG/20120504_FDF_CRG_c12.mtb	918	62	WWSS	food_sc	4	156075	1336278261	1	0.02	0.0005	2506	1
1	Food 2	Intake 4	87	156264	1336278450	/users/cn/jespinosa/phecomp/data/CRG/20120502_FDF_CRG/20120502_FDF_CRG/20120504_FDF_CRG_c12.mtb	919	4	WWSS	food_sc	4	156177	1336278363	1	0.04	0.000459770114942529	2507	1
1	Food 2	Intake 4	75	156343	1336278529	/users/cn/jespinosa/phecomp/data/CRG/20120502_FDF_CRG/20120502_FDF_CRG/20120504_FDF_CRG_c12.mtb	920	248	WWSS	food_sc	4	156268	1336278454	1	0.02	0.000266666666666667	2508	1
1	Food 1	Intake 3	58	156649	1336278835	/users/cn/jespinosa/phecomp/data/CRG/20120502_FDF_CRG/20120502_FDF_CRG/20120504_FDF_CRG_c12.mtb	760	120	WWSS	food_sc	3	156591	1336278777	1	0.02	0.000344827586206897	2509	1
1	Drink 2	Intake 2	25	156666	1336278852	/users/cn/jespinosa/phecomp/data/CRG/20120502_FDF_CRG/20120502_FDF_CRG/20120504_FDF_CRG_c12.mtb	484	NA	WWSS	water	2	156641	1336278827	1	0.02	0.0008	2510	1
1	Drink 1	Intake 1	17	156764	1336278950	/users/cn/jespinosa/phecomp/data/CRG/20120502_FDF_CRG/20120502_FDF_CRG/20120504_FDF_CRG_c12.mtb	1207	NA	WWSS	water	1	156747	1336278933	1	0.02	0.00117647058823529	2511	1
1	Food 2	Intake 4	118	156887	1336279073	/users/cn/jespinosa/phecomp/data/CRG/20120502_FDF_CRG/20120502_FDF_CRG/20120504_FDF_CRG_c12.mtb	925	248	WWSS	food_sc	4	156769	1336278955	1	0.02	0.000169491525423729	2512	1
1	Food 2	Intake 4	89	157224	1336279410	/users/cn/jespinosa/phecomp/data/CRG/20120502_FDF_CRG/20120502_FDF_CRG/20120504_FDF_CRG_c12.mtb	928	89	WWSS	food_sc	4	157135	1336279321	1	0.02	0.000224719101123596	2513	1
1	Drink 2	Intake 2	41	157307	1336279493	/users/cn/jespinosa/phecomp/data/CRG/20120502_FDF_CRG/20120502_FDF_CRG/20120504_FDF_CRG_c12.mtb	485	NA	WWSS	water	2	157266	1336279452	1	0.0999999999999999	0.0024390243902439	2514	1
1	Food 2	Intake 4	197	157510	1336279696	/users/cn/jespinosa/phecomp/data/CRG/20120502_FDF_CRG/20120502_FDF_CRG/20120504_FDF_CRG_c12.mtb	929	116	WWSS	food_sc	4	157313	1336279499	1	0.0600000000000001	0.000304568527918782	2515	1
1	Food 2	Intake 4	141	157767	1336279953	/users/cn/jespinosa/phecomp/data/CRG/20120502_FDF_CRG/20120502_FDF_CRG/20120504_FDF_CRG_c12.mtb	931	672	WWSS	food_sc	4	157626	1336279812	1	0.04	0.000283687943262411	2516	1
1	Drink 1	Intake 1	25	157967	1336280153	/users/cn/jespinosa/phecomp/data/CRG/20120502_FDF_CRG/20120502_FDF_CRG/20120504_FDF_CRG_c12.mtb	1208	NA	WWSS	water	1	157942	1336280128	1	0.1	0.004	2517	1
1	Food 2	Intake 4	55	158494	1336280680	/users/cn/jespinosa/phecomp/data/CRG/20120502_FDF_CRG/20120502_FDF_CRG/20120504_FDF_CRG_c12.mtb	936	446	WWSS	food_sc	4	158439	1336280625	1	0.04	0.000727272727272727	2518	1
1	Food 2	Intake 4	108	159048	1336281234	/users/cn/jespinosa/phecomp/data/CRG/20120502_FDF_CRG/20120502_FDF_CRG/20120504_FDF_CRG_c12.mtb	938	434	WWSS	food_sc	4	158940	1336281126	1	0.02	0.000185185185185185	2519	1
1	Food 2	Intake 4	112	159594	1336281780	/users/cn/jespinosa/phecomp/data/CRG/20120502_FDF_CRG/20120502_FDF_CRG/20120504_FDF_CRG_c12.mtb	939	6	WWSS	food_sc	4	159482	1336281668	1	0.02	0.000178571428571429	2520	1
1	Food 2	Intake 4	144	159744	1336281930	/users/cn/jespinosa/phecomp/data/CRG/20120502_FDF_CRG/20120502_FDF_CRG/20120504_FDF_CRG_c12.mtb	940	489	WWSS	food_sc	4	159600	1336281786	1	0.02	0.000138888888888889	2521	1
1	Drink 1	Intake 1	9	159754	1336281940	/users/cn/jespinosa/phecomp/data/CRG/20120502_FDF_CRG/20120502_FDF_CRG/20120504_FDF_CRG_c12.mtb	1211	NA	WWSS	water	1	159745	1336281931	1	0.0200000000000005	0.00222222222222228	2522	1
1	Food 2	Intake 4	98	160331	1336282517	/users/cn/jespinosa/phecomp/data/CRG/20120502_FDF_CRG/20120502_FDF_CRG/20120504_FDF_CRG_c12.mtb	944	244	WWSS	food_sc	4	160233	1336282419	1	0.04	0.000408163265306122	2523	1
1	Food 1	Intake 3	100	160675	1336282861	/users/cn/jespinosa/phecomp/data/CRG/20120502_FDF_CRG/20120502_FDF_CRG/20120504_FDF_CRG_c12.mtb	782	69	WWSS	food_sc	3	160575	1336282761	1	0.34	0.0034	2524	1
1	Food 1	Intake 3	51	160795	1336282981	/users/cn/jespinosa/phecomp/data/CRG/20120502_FDF_CRG/20120502_FDF_CRG/20120504_FDF_CRG_c12.mtb	783	856	WWSS	food_sc	3	160744	1336282930	1	0.02	0.000392156862745098	2525	1
1	Drink 1	Intake 1	35	161265	1336283451	/users/cn/jespinosa/phecomp/data/CRG/20120502_FDF_CRG/20120502_FDF_CRG/20120504_FDF_CRG_c12.mtb	1214	NA	WWSS	water	1	161230	1336283416	1	0.12	0.00342857142857143	2526	1
1	Food 2	Intake 4	15	161666	1336283852	/users/cn/jespinosa/phecomp/data/CRG/20120502_FDF_CRG/20120502_FDF_CRG/20120504_FDF_CRG_c12.mtb	953	28702	WWSS	food_sc	4	161651	1336283837	1	0.0200000000000005	0.00133333333333337	2527	1
1	Drink 2	Intake 2	20	165200	1336287386	/users/cn/jespinosa/phecomp/data/CRG/20120502_FDF_CRG/20120502_FDF_CRG/20120504_FDF_CRG_c12.mtb	487	NA	WWSS	water	2	165180	1336287366	1	0.02	0.001	2528	1
1	Drink 1	Intake 1	33	173284	1336295470	/users/cn/jespinosa/phecomp/data/CRG/20120502_FDF_CRG/20120502_FDF_CRG/20120504_FDF_CRG_c12.mtb	1217	NA	WWSS	water	1	173251	1336295437	1	0.2	0.00606060606060606	2529	1
1	Drink 2	Intake 2	15	175071	1336297257	/users/cn/jespinosa/phecomp/data/CRG/20120502_FDF_CRG/20120502_FDF_CRG/20120504_FDF_CRG_c12.mtb	490	NA	WWSS	water	2	175056	1336297242	1	0.04	0.00266666666666667	2530	1
1	Food 2	Intake 4	16	190384	1336312570	/users/cn/jespinosa/phecomp/data/CRG/20120502_FDF_CRG/20120502_FDF_CRG/20120504_FDF_CRG_c12.mtb	961	1327	WWSS	food_sc	4	190368	1336312554	1	0.02	0.00125	2531	1
1	Food 2	Intake 4	172	191883	1336314069	/users/cn/jespinosa/phecomp/data/CRG/20120502_FDF_CRG/20120502_FDF_CRG/20120504_FDF_CRG_c12.mtb	964	891	WWSS	food_sc	4	191711	1336313897	1	0.04	0.000232558139534884	2532	1
1	Food 2	Intake 4	20	192794	1336314980	/users/cn/jespinosa/phecomp/data/CRG/20120502_FDF_CRG/20120502_FDF_CRG/20120504_FDF_CRG_c12.mtb	968	8082	WWSS	food_sc	4	192774	1336314960	1	0.02	0.001	2533	1
1	Food 2	Intake 4	874	201750	1336323936	/users/cn/jespinosa/phecomp/data/CRG/20120502_FDF_CRG/20120502_FDF_CRG/20120504_FDF_CRG_c12.mtb	972	2084	WWSS	food_sc	4	200876	1336323062	1	0.1	0.00011441647597254	2534	1
1	Food 2	Intake 4	973	204807	1336326993	/users/cn/jespinosa/phecomp/data/CRG/20120502_FDF_CRG/20120502_FDF_CRG/20120504_FDF_CRG_c12.mtb	974	1088	WWSS	food_sc	4	203834	1336326020	1	0.2	0.000205549845837616	2535	1
1	Drink 1	Intake 1	44	204844	1336327030	/users/cn/jespinosa/phecomp/data/CRG/20120502_FDF_CRG/20120502_FDF_CRG/20120504_FDF_CRG_c12.mtb	1220	NA	WWSS	water	1	204800	1336326986	1	0.0200000000000005	0.000454545454545466	2536	1
1	Drink 2	Intake 2	16	205890	1336328076	/users/cn/jespinosa/phecomp/data/CRG/20120502_FDF_CRG/20120502_FDF_CRG/20120504_FDF_CRG_c12.mtb	493	NA	WWSS	water	2	205874	1336328060	1	0.04	0.0025	2537	1
1	Food 2	Intake 4	24	205919	1336328105	/users/cn/jespinosa/phecomp/data/CRG/20120502_FDF_CRG/20120502_FDF_CRG/20120504_FDF_CRG_c12.mtb	975	11	WWSS	food_sc	4	205895	1336328081	1	0.02	0.000833333333333333	2538	1
1	Food 2	Intake 4	249	206179	1336328365	/users/cn/jespinosa/phecomp/data/CRG/20120502_FDF_CRG/20120502_FDF_CRG/20120504_FDF_CRG_c12.mtb	976	1052	WWSS	food_sc	4	205930	1336328116	1	0.0599999999999996	0.000240963855421685	2539	1
1	Food 2	Intake 4	238	207469	1336329655	/users/cn/jespinosa/phecomp/data/CRG/20120502_FDF_CRG/20120502_FDF_CRG/20120504_FDF_CRG_c12.mtb	977	1148	WWSS	food_sc	4	207231	1336329417	1	0.0600000000000001	0.000252100840336135	2540	1
1	Drink 1	Intake 1	12	208332	1336330518	/users/cn/jespinosa/phecomp/data/CRG/20120502_FDF_CRG/20120502_FDF_CRG/20120504_FDF_CRG_c12.mtb	1225	NA	WWSS	water	1	208320	1336330506	1	0.0600000000000005	0.00500000000000004	2541	1
1	Food 2	Intake 4	463	209080	1336331266	/users/cn/jespinosa/phecomp/data/CRG/20120502_FDF_CRG/20120502_FDF_CRG/20120504_FDF_CRG_c12.mtb	980	31	WWSS	food_sc	4	208617	1336330803	1	0.14	0.000302375809935205	2542	1
1	Food 2	Intake 4	180	209291	1336331477	/users/cn/jespinosa/phecomp/data/CRG/20120502_FDF_CRG/20120502_FDF_CRG/20120504_FDF_CRG_c12.mtb	981	823	WWSS	food_sc	4	209111	1336331297	1	0.0600000000000001	0.000333333333333334	2543	1
1	Drink 1	Intake 1	36	209318	1336331504	/users/cn/jespinosa/phecomp/data/CRG/20120502_FDF_CRG/20120502_FDF_CRG/20120504_FDF_CRG_c12.mtb	1226	NA	WWSS	water	1	209282	1336331468	1	0.0399999999999991	0.00111111111111109	2544	1
1	Food 2	Intake 4	126	210240	1336332426	/users/cn/jespinosa/phecomp/data/CRG/20120502_FDF_CRG/20120502_FDF_CRG/20120504_FDF_CRG_c12.mtb	984	1226	WWSS	food_sc	4	210114	1336332300	1	0.04	0.000317460317460317	2545	1
1	Drink 1	Intake 1	26	210275	1336332461	/users/cn/jespinosa/phecomp/data/CRG/20120502_FDF_CRG/20120502_FDF_CRG/20120504_FDF_CRG_c12.mtb	1229	NA	WWSS	water	1	210249	1336332435	1	0.12	0.00461538461538461	2546	1
1	Food 2	Intake 4	389	211855	1336334041	/users/cn/jespinosa/phecomp/data/CRG/20120502_FDF_CRG/20120502_FDF_CRG/20120504_FDF_CRG_c12.mtb	985	569	WWSS	food_sc	4	211466	1336333652	1	0.1	0.00025706940874036	2547	1
1	Drink 1	Intake 1	15	211958	1336334144	/users/cn/jespinosa/phecomp/data/CRG/20120502_FDF_CRG/20120502_FDF_CRG/20120504_FDF_CRG_c12.mtb	1230	NA	WWSS	water	1	211943	1336334129	1	0.0200000000000005	0.00133333333333337	2548	1
1	Food 2	Intake 4	135	212559	1336334745	/users/cn/jespinosa/phecomp/data/CRG/20120502_FDF_CRG/20120502_FDF_CRG/20120504_FDF_CRG_c12.mtb	986	842	WWSS	food_sc	4	212424	1336334610	1	0.04	0.000296296296296296	2549	1
1	Food 2	Intake 4	416	213817	1336336003	/users/cn/jespinosa/phecomp/data/CRG/20120502_FDF_CRG/20120502_FDF_CRG/20120504_FDF_CRG_c12.mtb	995	746	WWSS	food_sc	4	213401	1336335587	1	0.16	0.000384615384615385	2550	1
1	Drink 2	Intake 2	15	213825	1336336011	/users/cn/jespinosa/phecomp/data/CRG/20120502_FDF_CRG/20120502_FDF_CRG/20120504_FDF_CRG_c12.mtb	501	NA	WWSS	water	2	213810	1336335996	1	0.02	0.00133333333333333	2551	1
1	Drink 1	Intake 1	50	214018	1336336204	/users/cn/jespinosa/phecomp/data/CRG/20120502_FDF_CRG/20120502_FDF_CRG/20120504_FDF_CRG_c12.mtb	1244	NA	WWSS	water	1	213968	1336336154	1	0.0800000000000001	0.0016	2552	1
1	Food 2	Intake 4	65	214628	1336336814	/users/cn/jespinosa/phecomp/data/CRG/20120502_FDF_CRG/20120502_FDF_CRG/20120504_FDF_CRG_c12.mtb	999	11	WWSS	food_sc	4	214563	1336336749	1	0.02	0.000307692307692308	2553	1
1	Food 2	Intake 4	120	214759	1336336945	/users/cn/jespinosa/phecomp/data/CRG/20120502_FDF_CRG/20120502_FDF_CRG/20120504_FDF_CRG_c12.mtb	1000	42	WWSS	food_sc	4	214639	1336336825	1	0.02	0.000166666666666667	2554	1
1	Food 2	Intake 4	99	214900	1336337086	/users/cn/jespinosa/phecomp/data/CRG/20120502_FDF_CRG/20120502_FDF_CRG/20120504_FDF_CRG_c12.mtb	1001	282	WWSS	food_sc	4	214801	1336336987	1	0.04	0.000404040404040404	2555	1
1	Drink 1	Intake 1	28	214939	1336337125	/users/cn/jespinosa/phecomp/data/CRG/20120502_FDF_CRG/20120502_FDF_CRG/20120504_FDF_CRG_c12.mtb	1250	NA	WWSS	water	1	214911	1336337097	1	0.0999999999999996	0.00357142857142856	2556	1
1	Food 2	Intake 4	47	215229	1336337415	/users/cn/jespinosa/phecomp/data/CRG/20120502_FDF_CRG/20120502_FDF_CRG/20120504_FDF_CRG_c12.mtb	1002	25	WWSS	food_sc	4	215182	1336337368	1	0.02	0.000425531914893617	2557	1
1	Food 2	Intake 4	196	215450	1336337636	/users/cn/jespinosa/phecomp/data/CRG/20120502_FDF_CRG/20120502_FDF_CRG/20120504_FDF_CRG_c12.mtb	1003	313	WWSS	food_sc	4	215254	1336337440	1	0.12	0.000612244897959184	2558	1
1	Food 2	Intake 4	60	215823	1336338009	/users/cn/jespinosa/phecomp/data/CRG/20120502_FDF_CRG/20120502_FDF_CRG/20120504_FDF_CRG_c12.mtb	1005	442	WWSS	food_sc	4	215763	1336337949	1	0.0200000000000005	0.000333333333333342	2559	1
1	Drink 1	Intake 1	33	216109	1336338295	/users/cn/jespinosa/phecomp/data/CRG/20120502_FDF_CRG/20120502_FDF_CRG/20120504_FDF_CRG_c12.mtb	1257	NA	WWSS	water	1	216076	1336338262	1	0.0800000000000001	0.00242424242424243	2560	1
1	Food 2	Intake 4	181	216446	1336338632	/users/cn/jespinosa/phecomp/data/CRG/20120502_FDF_CRG/20120502_FDF_CRG/20120504_FDF_CRG_c12.mtb	1007	383	WWSS	food_sc	4	216265	1336338451	1	0.04	0.000220994475138122	2561	1
1	Drink 1	Intake 1	21	216662	1336338848	/users/cn/jespinosa/phecomp/data/CRG/20120502_FDF_CRG/20120502_FDF_CRG/20120504_FDF_CRG_c12.mtb	1261	NA	WWSS	water	1	216641	1336338827	1	0.0200000000000005	0.000952380952380976	2562	1
1	Food 2	Intake 4	81	216910	1336339096	/users/cn/jespinosa/phecomp/data/CRG/20120502_FDF_CRG/20120502_FDF_CRG/20120504_FDF_CRG_c12.mtb	1010	49	WWSS	food_sc	4	216829	1336339015	1	0.0200000000000005	0.00024691358024692	2563	1
1	Food 2	Intake 4	159	217118	1336339304	/users/cn/jespinosa/phecomp/data/CRG/20120502_FDF_CRG/20120502_FDF_CRG/20120504_FDF_CRG_c12.mtb	1011	942	WWSS	food_sc	4	216959	1336339145	1	0.04	0.000251572327044025	2564	1
1	Drink 1	Intake 1	25	217133	1336339319	/users/cn/jespinosa/phecomp/data/CRG/20120502_FDF_CRG/20120502_FDF_CRG/20120504_FDF_CRG_c12.mtb	1262	NA	WWSS	water	1	217108	1336339294	1	0.0599999999999996	0.00239999999999998	2565	1
1	Drink 1	Intake 1	38	217907	1336340093	/users/cn/jespinosa/phecomp/data/CRG/20120502_FDF_CRG/20120502_FDF_CRG/20120504_FDF_CRG_c12.mtb	1267	NA	WWSS	water	1	217869	1336340055	1	0.0800000000000001	0.00210526315789474	2566	1
1	Food 2	Intake 4	102	218162	1336340348	/users/cn/jespinosa/phecomp/data/CRG/20120502_FDF_CRG/20120502_FDF_CRG/20120504_FDF_CRG_c12.mtb	1016	61	WWSS	food_sc	4	218060	1336340246	1	0.04	0.000392156862745098	2567	1
1	Food 2	Intake 4	81	218304	1336340490	/users/cn/jespinosa/phecomp/data/CRG/20120502_FDF_CRG/20120502_FDF_CRG/20120504_FDF_CRG_c12.mtb	1018	5355	WWSS	food_sc	4	218223	1336340409	1	0.04	0.000493827160493827	2568	1
1	Food 2	Intake 4	52	223711	1336345897	/users/cn/jespinosa/phecomp/data/CRG/20120502_FDF_CRG/20120502_FDF_CRG/20120504_FDF_CRG_c12.mtb	1023	77	WWSS	food_sc	4	223659	1336345845	1	0.0200000000000005	0.000384615384615394	2569	1
1	Food 2	Intake 4	119	223907	1336346093	/users/cn/jespinosa/phecomp/data/CRG/20120502_FDF_CRG/20120502_FDF_CRG/20120504_FDF_CRG_c12.mtb	1025	14	WWSS	food_sc	4	223788	1336345974	1	0.04	0.000336134453781513	2570	1
1	Food 2	Intake 4	440	224361	1336346547	/users/cn/jespinosa/phecomp/data/CRG/20120502_FDF_CRG/20120502_FDF_CRG/20120504_FDF_CRG_c12.mtb	1026	1138	WWSS	food_sc	4	223921	1336346107	1	0.18	0.000409090909090909	2571	1
1	Drink 1	Intake 1	25	224381	1336346567	/users/cn/jespinosa/phecomp/data/CRG/20120502_FDF_CRG/20120502_FDF_CRG/20120504_FDF_CRG_c12.mtb	1271	NA	WWSS	water	1	224356	1336346542	1	0.0800000000000001	0.0032	2572	1
1	Drink 1	Intake 1	16	224672	1336346858	/users/cn/jespinosa/phecomp/data/CRG/20120502_FDF_CRG/20120502_FDF_CRG/20120504_FDF_CRG_c12.mtb	1272	NA	WWSS	water	1	224656	1336346842	1	0.0200000000000005	0.00125000000000003	2573	1
1	Drink 1	Intake 1	30	224916	1336347102	/users/cn/jespinosa/phecomp/data/CRG/20120502_FDF_CRG/20120502_FDF_CRG/20120504_FDF_CRG_c12.mtb	1273	NA	WWSS	water	1	224886	1336347072	1	0.0999999999999996	0.00333333333333332	2574	1
1	Drink 1	Intake 1	18	225076	1336347262	/users/cn/jespinosa/phecomp/data/CRG/20120502_FDF_CRG/20120502_FDF_CRG/20120504_FDF_CRG_c12.mtb	1274	NA	WWSS	water	1	225058	1336347244	1	0.0200000000000005	0.00111111111111114	2575	1
1	Drink 2	Intake 2	28	225259	1336347445	/users/cn/jespinosa/phecomp/data/CRG/20120502_FDF_CRG/20120502_FDF_CRG/20120504_FDF_CRG_c12.mtb	502	NA	WWSS	water	2	225231	1336347417	1	0.1	0.00357142857142857	2576	1
1	Food 2	Intake 4	104	225603	1336347789	/users/cn/jespinosa/phecomp/data/CRG/20120502_FDF_CRG/20120502_FDF_CRG/20120504_FDF_CRG_c12.mtb	1033	319	WWSS	food_sc	4	225499	1336347685	1	0.0200000000000005	0.000192307692307697	2577	1
1	Drink 2	Intake 2	13	225608	1336347794	/users/cn/jespinosa/phecomp/data/CRG/20120502_FDF_CRG/20120502_FDF_CRG/20120504_FDF_CRG_c12.mtb	504	NA	WWSS	water	2	225595	1336347781	1	0.02	0.00153846153846154	2578	1
1	Drink 2	Intake 2	23	225777	1336347963	/users/cn/jespinosa/phecomp/data/CRG/20120502_FDF_CRG/20120502_FDF_CRG/20120504_FDF_CRG_c12.mtb	505	NA	WWSS	water	2	225754	1336347940	1	0.04	0.00173913043478261	2579	1
1	Food 2	Intake 4	107	226029	1336348215	/users/cn/jespinosa/phecomp/data/CRG/20120502_FDF_CRG/20120502_FDF_CRG/20120504_FDF_CRG_c12.mtb	1035	30	WWSS	food_sc	4	225922	1336348108	1	0.0599999999999996	0.000560747663551398	2580	1
1	Food 2	Intake 4	89	226148	1336348334	/users/cn/jespinosa/phecomp/data/CRG/20120502_FDF_CRG/20120502_FDF_CRG/20120504_FDF_CRG_c12.mtb	1036	862	WWSS	food_sc	4	226059	1336348245	1	0.04	0.000449438202247191	2581	1
1	Food 2	Intake 4	81	227091	1336349277	/users/cn/jespinosa/phecomp/data/CRG/20120502_FDF_CRG/20120502_FDF_CRG/20120504_FDF_CRG_c12.mtb	1040	578	WWSS	food_sc	4	227010	1336349196	1	0.0200000000000005	0.00024691358024692	2582	1
1	Food 2	Intake 4	82	227751	1336349937	/users/cn/jespinosa/phecomp/data/CRG/20120502_FDF_CRG/20120502_FDF_CRG/20120504_FDF_CRG_c12.mtb	1042	1569	WWSS	food_sc	4	227669	1336349855	1	0.0200000000000005	0.000243902439024396	2583	1
1	Drink 2	Intake 2	24	227771	1336349957	/users/cn/jespinosa/phecomp/data/CRG/20120502_FDF_CRG/20120502_FDF_CRG/20120504_FDF_CRG_c12.mtb	506	NA	WWSS	water	2	227747	1336349933	1	0.0800000000000001	0.00333333333333334	2584	1
1	Food 2	Intake 4	123	229443	1336351629	/users/cn/jespinosa/phecomp/data/CRG/20120502_FDF_CRG/20120502_FDF_CRG/20120504_FDF_CRG_c12.mtb	1045	6440	WWSS	food_sc	4	229320	1336351506	1	0.04	0.00032520325203252	2585	1
1	Food 2	Intake 4	24	235907	1336358093	/users/cn/jespinosa/phecomp/data/CRG/20120502_FDF_CRG/20120502_FDF_CRG/20120504_FDF_CRG_c12.mtb	1046	76	WWSS	food_sc	4	235883	1336358069	1	0.04	0.00166666666666667	2586	1
1	Food 2	Intake 4	470	236453	1336358639	/users/cn/jespinosa/phecomp/data/CRG/20120502_FDF_CRG/20120502_FDF_CRG/20120504_FDF_CRG_c12.mtb	1048	370	WWSS	food_sc	4	235983	1336358169	1	0.22	0.000468085106382979	2587	1
1	Drink 1	Intake 1	27	236724	1336358910	/users/cn/jespinosa/phecomp/data/CRG/20120502_FDF_CRG/20120502_FDF_CRG/20120504_FDF_CRG_c12.mtb	1288	NA	WWSS	water	1	236697	1336358883	1	0.12	0.00444444444444444	2588	1
1	Food 2	Intake 4	84	236907	1336359093	/users/cn/jespinosa/phecomp/data/CRG/20120502_FDF_CRG/20120502_FDF_CRG/20120504_FDF_CRG_c12.mtb	1050	4	WWSS	food_sc	4	236823	1336359009	1	0.0200000000000005	0.000238095238095244	2589	1
1	Food 2	Intake 4	68	236979	1336359165	/users/cn/jespinosa/phecomp/data/CRG/20120502_FDF_CRG/20120502_FDF_CRG/20120504_FDF_CRG_c12.mtb	1051	4976	WWSS	food_sc	4	236911	1336359097	1	0.04	0.000588235294117647	2590	1
1	Drink 1	Intake 1	31	237150	1336359336	/users/cn/jespinosa/phecomp/data/CRG/20120502_FDF_CRG/20120502_FDF_CRG/20120504_FDF_CRG_c12.mtb	1289	NA	WWSS	water	1	237119	1336359305	1	0.0200000000000005	0.000645161290322597	2591	1
1	Drink 2	Intake 2	35	237376	1336359562	/users/cn/jespinosa/phecomp/data/CRG/20120502_FDF_CRG/20120502_FDF_CRG/20120504_FDF_CRG_c12.mtb	507	NA	WWSS	water	2	237341	1336359527	1	0.14	0.004	2592	1
1	Food 2	Intake 4	23	241978	1336364164	/users/cn/jespinosa/phecomp/data/CRG/20120502_FDF_CRG/20120502_FDF_CRG/20120504_FDF_CRG_c12.mtb	1054	332	WWSS	food_sc	4	241955	1336364141	1	0.0200000000000005	0.000869565217391326	2593	1
1	Food 2	Intake 4	231	242541	1336364727	/users/cn/jespinosa/phecomp/data/CRG/20120502_FDF_CRG/20120502_FDF_CRG/20120504_FDF_CRG_c12.mtb	1055	146	WWSS	food_sc	4	242310	1336364496	1	0.04	0.000173160173160173	2594	1
1	Drink 2	Intake 2	20	242584	1336364770	/users/cn/jespinosa/phecomp/data/CRG/20120502_FDF_CRG/20120502_FDF_CRG/20120504_FDF_CRG_c12.mtb	508	NA	WWSS	water	2	242564	1336364750	1	0.0800000000000001	0.00400000000000001	2595	1
1	Food 2	Intake 4	211	242898	1336365084	/users/cn/jespinosa/phecomp/data/CRG/20120502_FDF_CRG/20120502_FDF_CRG/20120504_FDF_CRG_c12.mtb	1058	115	WWSS	food_sc	4	242687	1336364873	1	0.0800000000000001	0.00037914691943128	2596	1
1	Drink 1	Intake 1	26	242921	1336365107	/users/cn/jespinosa/phecomp/data/CRG/20120502_FDF_CRG/20120502_FDF_CRG/20120504_FDF_CRG_c12.mtb	1292	NA	WWSS	water	1	242895	1336365081	1	0.0599999999999996	0.00230769230769229	2597	1
1	Food 2	Intake 4	52	243065	1336365251	/users/cn/jespinosa/phecomp/data/CRG/20120502_FDF_CRG/20120502_FDF_CRG/20120504_FDF_CRG_c12.mtb	1060	93	WWSS	food_sc	4	243013	1336365199	1	0.0200000000000005	0.000384615384615394	2598	1
1	Food 2	Intake 4	49	243207	1336365393	/users/cn/jespinosa/phecomp/data/CRG/20120502_FDF_CRG/20120502_FDF_CRG/20120504_FDF_CRG_c12.mtb	1062	799	WWSS	food_sc	4	243158	1336365344	1	0.04	0.000816326530612245	2599	1
1	Drink 2	Intake 2	44	243341	1336365527	/users/cn/jespinosa/phecomp/data/CRG/20120502_FDF_CRG/20120502_FDF_CRG/20120504_FDF_CRG_c12.mtb	509	NA	WWSS	water	2	243297	1336365483	1	0.14	0.00318181818181818	2600	1
1	Food 2	Intake 4	151	244157	1336366343	/users/cn/jespinosa/phecomp/data/CRG/20120502_FDF_CRG/20120502_FDF_CRG/20120504_FDF_CRG_c12.mtb	1066	694	WWSS	food_sc	4	244006	1336366192	1	0.04	0.000264900662251656	2601	1
1	Drink 2	Intake 2	17	244164	1336366350	/users/cn/jespinosa/phecomp/data/CRG/20120502_FDF_CRG/20120502_FDF_CRG/20120504_FDF_CRG_c12.mtb	511	NA	WWSS	water	2	244147	1336366333	1	0.04	0.00235294117647059	2602	1
1	Drink 2	Intake 2	17	244195	1336366381	/users/cn/jespinosa/phecomp/data/CRG/20120502_FDF_CRG/20120502_FDF_CRG/20120504_FDF_CRG_c12.mtb	512	NA	WWSS	water	2	244178	1336366364	1	0.02	0.00117647058823529	2603	1
1	Drink 2	Intake 2	24	244795	1336366981	/users/cn/jespinosa/phecomp/data/CRG/20120502_FDF_CRG/20120502_FDF_CRG/20120504_FDF_CRG_c12.mtb	513	NA	WWSS	water	2	244771	1336366957	1	0.0600000000000001	0.0025	2604	1
1	Food 2	Intake 4	146	244997	1336367183	/users/cn/jespinosa/phecomp/data/CRG/20120502_FDF_CRG/20120502_FDF_CRG/20120504_FDF_CRG_c12.mtb	1069	52	WWSS	food_sc	4	244851	1336367037	1	0.04	0.000273972602739726	2605	1
1	Food 2	Intake 4	111	245160	1336367346	/users/cn/jespinosa/phecomp/data/CRG/20120502_FDF_CRG/20120502_FDF_CRG/20120504_FDF_CRG_c12.mtb	1070	1161	WWSS	food_sc	4	245049	1336367235	1	0.04	0.00036036036036036	2606	1
1	Drink 1	Intake 1	34	245393	1336367579	/users/cn/jespinosa/phecomp/data/CRG/20120502_FDF_CRG/20120502_FDF_CRG/20120504_FDF_CRG_c12.mtb	1300	NA	WWSS	water	1	245359	1336367545	1	0.0200000000000005	0.000588235294117662	2607	1
1	Food 2	Intake 4	110	246431	1336368617	/users/cn/jespinosa/phecomp/data/CRG/20120502_FDF_CRG/20120502_FDF_CRG/20120504_FDF_CRG_c12.mtb	1079	20703	WWSS	food_sc	4	246321	1336368507	1	0.04	0.000363636363636364	2608	1
1	Drink 1	Intake 1	20	247018	1336369204	/users/cn/jespinosa/phecomp/data/CRG/20120502_FDF_CRG/20120502_FDF_CRG/20120504_FDF_CRG_c12.mtb	1310	NA	WWSS	water	1	246998	1336369184	1	0.04	0.002	2609	1
1	Drink 1	Intake 1	37	249877	1336372063	/users/cn/jespinosa/phecomp/data/CRG/20120502_FDF_CRG/20120502_FDF_CRG/20120504_FDF_CRG_c12.mtb	1313	NA	WWSS	water	1	249840	1336372026	1	0.0200000000000005	0.000540540540540554	2610	1
1	Drink 2	Intake 2	15	251988	1336374174	/users/cn/jespinosa/phecomp/data/CRG/20120502_FDF_CRG/20120502_FDF_CRG/20120504_FDF_CRG_c12.mtb	514	NA	WWSS	water	2	251973	1336374159	1	0.02	0.00133333333333333	2611	1
1	Drink 2	Intake 2	33	309	1336382820	/users/cn/jespinosa/phecomp/data/CRG/20120502_FDF_CRG/20120502_FDF_CRG/20120507_FDF_CRG_c12.mtb	587	NA	WWSS	water	2	276	1336382787	1	0.02	0.000606060606060606	2612	1
1	Food 2	Intake 4	281	7090	1336389601	/users/cn/jespinosa/phecomp/data/CRG/20120502_FDF_CRG/20120502_FDF_CRG/20120507_FDF_CRG_c12.mtb	1277	12036	WWSS	food_sc	4	6809	1336389320	1	0.1	0.000355871886120996	2613	1
1	Food 2	Intake 4	506	19632	1336402143	/users/cn/jespinosa/phecomp/data/CRG/20120502_FDF_CRG/20120502_FDF_CRG/20120507_FDF_CRG_c12.mtb	1280	70	WWSS	food_sc	4	19126	1336401637	1	0.1	0.000197628458498024	2614	1
1	Food 2	Intake 4	66	19768	1336402279	/users/cn/jespinosa/phecomp/data/CRG/20120502_FDF_CRG/20120502_FDF_CRG/20120507_FDF_CRG_c12.mtb	1281	5994	WWSS	food_sc	4	19702	1336402213	1	0.02	0.000303030303030303	2615	1
1	Drink 1	Intake 1	23	19790	1336402301	/users/cn/jespinosa/phecomp/data/CRG/20120502_FDF_CRG/20120502_FDF_CRG/20120507_FDF_CRG_c12.mtb	1449	NA	WWSS	water	1	19767	1336402278	1	0.06	0.00260869565217391	2616	1
1	Food 2	Intake 4	591	26353	1336408864	/users/cn/jespinosa/phecomp/data/CRG/20120502_FDF_CRG/20120502_FDF_CRG/20120507_FDF_CRG_c12.mtb	1283	3670	WWSS	food_sc	4	25762	1336408273	1	0.12	0.000203045685279188	2617	1
1	Food 2	Intake 4	359	30382	1336412893	/users/cn/jespinosa/phecomp/data/CRG/20120502_FDF_CRG/20120502_FDF_CRG/20120507_FDF_CRG_c12.mtb	1284	4	WWSS	food_sc	4	30023	1336412534	1	0.12	0.000334261838440111	2618	1
1	Food 2	Intake 4	252	30638	1336413149	/users/cn/jespinosa/phecomp/data/CRG/20120502_FDF_CRG/20120502_FDF_CRG/20120507_FDF_CRG_c12.mtb	1285	1874	WWSS	food_sc	4	30386	1336412897	1	0.1	0.000396825396825397	2619	1
1	Drink 1	Intake 1	23	30659	1336413170	/users/cn/jespinosa/phecomp/data/CRG/20120502_FDF_CRG/20120502_FDF_CRG/20120507_FDF_CRG_c12.mtb	1451	NA	WWSS	water	1	30636	1336413147	1	0.04	0.00173913043478261	2620	1
1	Drink 1	Intake 1	19	31415	1336413926	/users/cn/jespinosa/phecomp/data/CRG/20120502_FDF_CRG/20120502_FDF_CRG/20120507_FDF_CRG_c12.mtb	1452	NA	WWSS	water	1	31396	1336413907	1	0.04	0.00210526315789474	2621	1
1	Food 2	Intake 4	292	32804	1336415315	/users/cn/jespinosa/phecomp/data/CRG/20120502_FDF_CRG/20120502_FDF_CRG/20120507_FDF_CRG_c12.mtb	1289	416	WWSS	food_sc	4	32512	1336415023	1	0.12	0.000410958904109589	2622	1
1	Drink 1	Intake 1	31	32841	1336415352	/users/cn/jespinosa/phecomp/data/CRG/20120502_FDF_CRG/20120502_FDF_CRG/20120507_FDF_CRG_c12.mtb	1453	NA	WWSS	water	1	32810	1336415321	1	0.08	0.00258064516129032	2623	1
1	Food 2	Intake 4	191	33411	1336415922	/users/cn/jespinosa/phecomp/data/CRG/20120502_FDF_CRG/20120502_FDF_CRG/20120507_FDF_CRG_c12.mtb	1291	1082	WWSS	food_sc	4	33220	1336415731	1	0.0399999999999999	0.000209424083769633	2624	1
1	Drink 1	Intake 1	22	33429	1336415940	/users/cn/jespinosa/phecomp/data/CRG/20120502_FDF_CRG/20120502_FDF_CRG/20120507_FDF_CRG_c12.mtb	1455	NA	WWSS	water	1	33407	1336415918	1	0.12	0.00545454545454545	2625	1
1	Food 1	Intake 3	203	34696	1336417207	/users/cn/jespinosa/phecomp/data/CRG/20120502_FDF_CRG/20120502_FDF_CRG/20120507_FDF_CRG_c12.mtb	942	1257	WWSS	food_sc	3	34493	1336417004	1	0.08	0.000394088669950739	2626	1
1	Drink 1	Intake 1	16	35151	1336417662	/users/cn/jespinosa/phecomp/data/CRG/20120502_FDF_CRG/20120502_FDF_CRG/20120507_FDF_CRG_c12.mtb	1459	NA	WWSS	water	1	35135	1336417646	1	0.04	0.0025	2627	1
1	Food 2	Intake 4	620	36573	1336419084	/users/cn/jespinosa/phecomp/data/CRG/20120502_FDF_CRG/20120502_FDF_CRG/20120507_FDF_CRG_c12.mtb	1292	658	WWSS	food_sc	4	35953	1336418464	1	0.22	0.000354838709677419	2628	1
1	Drink 2	Intake 2	20	36645	1336419156	/users/cn/jespinosa/phecomp/data/CRG/20120502_FDF_CRG/20120502_FDF_CRG/20120507_FDF_CRG_c12.mtb	591	NA	WWSS	water	2	36625	1336419136	1	0.02	0.001	2629	1
1	Drink 2	Intake 2	25	37086	1336419597	/users/cn/jespinosa/phecomp/data/CRG/20120502_FDF_CRG/20120502_FDF_CRG/20120507_FDF_CRG_c12.mtb	592	NA	WWSS	water	2	37061	1336419572	1	0.06	0.0024	2630	1
1	Food 2	Intake 4	87	37318	1336419829	/users/cn/jespinosa/phecomp/data/CRG/20120502_FDF_CRG/20120502_FDF_CRG/20120507_FDF_CRG_c12.mtb	1296	31	WWSS	food_sc	4	37231	1336419742	1	0.02	0.000229885057471264	2631	1
1	Food 1	Intake 3	43	37392	1336419903	/users/cn/jespinosa/phecomp/data/CRG/20120502_FDF_CRG/20120502_FDF_CRG/20120507_FDF_CRG_c12.mtb	946	612	WWSS	food_sc	3	37349	1336419860	1	0.02	0.000465116279069767	2632	1
1	Drink 2	Intake 2	20	37406	1336419917	/users/cn/jespinosa/phecomp/data/CRG/20120502_FDF_CRG/20120502_FDF_CRG/20120507_FDF_CRG_c12.mtb	593	NA	WWSS	water	2	37386	1336419897	1	0.04	0.002	2633	1
1	Food 2	Intake 4	68	38072	1336420583	/users/cn/jespinosa/phecomp/data/CRG/20120502_FDF_CRG/20120502_FDF_CRG/20120507_FDF_CRG_c12.mtb	1300	166	WWSS	food_sc	4	38004	1336420515	1	0.02	0.000294117647058824	2634	1
1	Food 2	Intake 4	148	38386	1336420897	/users/cn/jespinosa/phecomp/data/CRG/20120502_FDF_CRG/20120502_FDF_CRG/20120507_FDF_CRG_c12.mtb	1301	155	WWSS	food_sc	4	38238	1336420749	1	0.04	0.00027027027027027	2635	1
1	Drink 1	Intake 1	22	38407	1336420918	/users/cn/jespinosa/phecomp/data/CRG/20120502_FDF_CRG/20120502_FDF_CRG/20120507_FDF_CRG_c12.mtb	1463	NA	WWSS	water	1	38385	1336420896	1	0.06	0.00272727272727273	2636	1
1	Food 2	Intake 4	114	38655	1336421166	/users/cn/jespinosa/phecomp/data/CRG/20120502_FDF_CRG/20120502_FDF_CRG/20120507_FDF_CRG_c12.mtb	1302	2496	WWSS	food_sc	4	38541	1336421052	1	0.0600000000000001	0.000526315789473685	2637	1
1	Drink 1	Intake 1	28	38726	1336421237	/users/cn/jespinosa/phecomp/data/CRG/20120502_FDF_CRG/20120502_FDF_CRG/20120507_FDF_CRG_c12.mtb	1465	NA	WWSS	water	1	38698	1336421209	1	0.12	0.00428571428571429	2638	1
1	Food 2	Intake 4	32	41183	1336423694	/users/cn/jespinosa/phecomp/data/CRG/20120502_FDF_CRG/20120502_FDF_CRG/20120507_FDF_CRG_c12.mtb	1306	204	WWSS	food_sc	4	41151	1336423662	1	0.02	0.000625	2639	1
1	Food 2	Intake 4	220	41607	1336424118	/users/cn/jespinosa/phecomp/data/CRG/20120502_FDF_CRG/20120502_FDF_CRG/20120507_FDF_CRG_c12.mtb	1308	36	WWSS	food_sc	4	41387	1336423898	1	0.0599999999999998	0.000272727272727272	2640	1
1	Food 2	Intake 4	125	41768	1336424279	/users/cn/jespinosa/phecomp/data/CRG/20120502_FDF_CRG/20120502_FDF_CRG/20120507_FDF_CRG_c12.mtb	1309	15	WWSS	food_sc	4	41643	1336424154	1	0.0600000000000001	0.000480000000000001	2641	1
1	Food 2	Intake 4	73	41856	1336424367	/users/cn/jespinosa/phecomp/data/CRG/20120502_FDF_CRG/20120502_FDF_CRG/20120507_FDF_CRG_c12.mtb	1310	124	WWSS	food_sc	4	41783	1336424294	1	0.04	0.000547945205479452	2642	1
1	Drink 1	Intake 1	19	41872	1336424383	/users/cn/jespinosa/phecomp/data/CRG/20120502_FDF_CRG/20120502_FDF_CRG/20120507_FDF_CRG_c12.mtb	1469	NA	WWSS	water	1	41853	1336424364	1	0.0399999999999999	0.00210526315789473	2643	1
1	Food 2	Intake 4	74	42054	1336424565	/users/cn/jespinosa/phecomp/data/CRG/20120502_FDF_CRG/20120502_FDF_CRG/20120507_FDF_CRG_c12.mtb	1312	529	WWSS	food_sc	4	41980	1336424491	1	0.04	0.000540540540540541	2644	1
1	Drink 1	Intake 1	16	42077	1336424588	/users/cn/jespinosa/phecomp/data/CRG/20120502_FDF_CRG/20120502_FDF_CRG/20120507_FDF_CRG_c12.mtb	1470	NA	WWSS	water	1	42061	1336424572	1	0.04	0.0025	2645	1
1	Drink 1	Intake 1	25	42583	1336425094	/users/cn/jespinosa/phecomp/data/CRG/20120502_FDF_CRG/20120502_FDF_CRG/20120507_FDF_CRG_c12.mtb	1472	NA	WWSS	water	1	42558	1336425069	1	0.0599999999999999	0.0024	2646	1
1	Food 2	Intake 4	114	42697	1336425208	/users/cn/jespinosa/phecomp/data/CRG/20120502_FDF_CRG/20120502_FDF_CRG/20120507_FDF_CRG_c12.mtb	1316	282	WWSS	food_sc	4	42583	1336425094	1	0.04	0.000350877192982456	2647	1
1	Food 2	Intake 4	123	43102	1336425613	/users/cn/jespinosa/phecomp/data/CRG/20120502_FDF_CRG/20120502_FDF_CRG/20120507_FDF_CRG_c12.mtb	1317	198	WWSS	food_sc	4	42979	1336425490	1	0.0399999999999998	0.000325203252032519	2648	1
1	Drink 2	Intake 2	14	43152	1336425663	/users/cn/jespinosa/phecomp/data/CRG/20120502_FDF_CRG/20120502_FDF_CRG/20120507_FDF_CRG_c12.mtb	595	NA	WWSS	water	2	43138	1336425649	1	0.02	0.00142857142857143	2649	1
1	Food 2	Intake 4	87	43387	1336425898	/users/cn/jespinosa/phecomp/data/CRG/20120502_FDF_CRG/20120502_FDF_CRG/20120507_FDF_CRG_c12.mtb	1319	289	WWSS	food_sc	4	43300	1336425811	1	0.02	0.000229885057471264	2650	1
1	Drink 1	Intake 1	34	43413	1336425924	/users/cn/jespinosa/phecomp/data/CRG/20120502_FDF_CRG/20120502_FDF_CRG/20120507_FDF_CRG_c12.mtb	1474	NA	WWSS	water	1	43379	1336425890	1	0.0800000000000001	0.00235294117647059	2651	1
1	Food 2	Intake 4	34	43710	1336426221	/users/cn/jespinosa/phecomp/data/CRG/20120502_FDF_CRG/20120502_FDF_CRG/20120507_FDF_CRG_c12.mtb	1320	35	WWSS	food_sc	4	43676	1336426187	1	0.02	0.000588235294117647	2652	1
1	Food 2	Intake 4	73	43818	1336426329	/users/cn/jespinosa/phecomp/data/CRG/20120502_FDF_CRG/20120502_FDF_CRG/20120507_FDF_CRG_c12.mtb	1322	1036	WWSS	food_sc	4	43745	1336426256	1	0.04	0.000547945205479452	2653	1
1	Drink 1	Intake 1	31	44560	1336427071	/users/cn/jespinosa/phecomp/data/CRG/20120502_FDF_CRG/20120502_FDF_CRG/20120507_FDF_CRG_c12.mtb	1477	NA	WWSS	water	1	44529	1336427040	1	0.1	0.0032258064516129	2654	1
1	Food 2	Intake 4	68	44922	1336427433	/users/cn/jespinosa/phecomp/data/CRG/20120502_FDF_CRG/20120502_FDF_CRG/20120507_FDF_CRG_c12.mtb	1325	114	WWSS	food_sc	4	44854	1336427365	1	0.02	0.000294117647058824	2655	1
1	Food 2	Intake 4	17	45053	1336427564	/users/cn/jespinosa/phecomp/data/CRG/20120502_FDF_CRG/20120502_FDF_CRG/20120507_FDF_CRG_c12.mtb	1326	697	WWSS	food_sc	4	45036	1336427547	1	0.02	0.00117647058823529	2656	1
1	Drink 1	Intake 1	16	45724	1336428235	/users/cn/jespinosa/phecomp/data/CRG/20120502_FDF_CRG/20120502_FDF_CRG/20120507_FDF_CRG_c12.mtb	1478	NA	WWSS	water	1	45708	1336428219	1	0.02	0.00125	2657	1
1	Food 1	Intake 3	191	45941	1336428452	/users/cn/jespinosa/phecomp/data/CRG/20120502_FDF_CRG/20120502_FDF_CRG/20120507_FDF_CRG_c12.mtb	961	2	WWSS	food_sc	3	45750	1336428261	1	0.04	0.000209424083769634	2658	1
1	Food 2	Intake 4	79	46022	1336428533	/users/cn/jespinosa/phecomp/data/CRG/20120502_FDF_CRG/20120502_FDF_CRG/20120507_FDF_CRG_c12.mtb	1329	1201	WWSS	food_sc	4	45943	1336428454	1	0.02	0.000253164556962025	2659	1
1	Food 2	Intake 4	42	47265	1336429776	/users/cn/jespinosa/phecomp/data/CRG/20120502_FDF_CRG/20120502_FDF_CRG/20120507_FDF_CRG_c12.mtb	1330	3810	WWSS	food_sc	4	47223	1336429734	1	0.02	0.000476190476190476	2660	1
1	Food 2	Intake 4	461	51536	1336434047	/users/cn/jespinosa/phecomp/data/CRG/20120502_FDF_CRG/20120502_FDF_CRG/20120507_FDF_CRG_c12.mtb	1333	53	WWSS	food_sc	4	51075	1336433586	1	0.12	0.000260303687635575	2661	1
1	Food 2	Intake 4	306	51895	1336434406	/users/cn/jespinosa/phecomp/data/CRG/20120502_FDF_CRG/20120502_FDF_CRG/20120507_FDF_CRG_c12.mtb	1334	217	WWSS	food_sc	4	51589	1336434100	1	0.12	0.000392156862745098	2662	1
1	Drink 1	Intake 1	21	51913	1336434424	/users/cn/jespinosa/phecomp/data/CRG/20120502_FDF_CRG/20120502_FDF_CRG/20120507_FDF_CRG_c12.mtb	1481	NA	WWSS	water	1	51892	1336434403	1	0.0399999999999999	0.0019047619047619	2663	1
1	Food 2	Intake 4	84	52196	1336434707	/users/cn/jespinosa/phecomp/data/CRG/20120502_FDF_CRG/20120502_FDF_CRG/20120507_FDF_CRG_c12.mtb	1337	453	WWSS	food_sc	4	52112	1336434623	1	0.0399999999999998	0.000476190476190474	2664	1
1	Drink 1	Intake 1	23	52211	1336434722	/users/cn/jespinosa/phecomp/data/CRG/20120502_FDF_CRG/20120502_FDF_CRG/20120507_FDF_CRG_c12.mtb	1482	NA	WWSS	water	1	52188	1336434699	1	0.0600000000000001	0.00260869565217392	2665	1
1	Drink 2	Intake 2	22	52593	1336435104	/users/cn/jespinosa/phecomp/data/CRG/20120502_FDF_CRG/20120502_FDF_CRG/20120507_FDF_CRG_c12.mtb	597	NA	WWSS	water	2	52571	1336435082	1	0.06	0.00272727272727273	2666	1
1	Food 2	Intake 4	114	52763	1336435274	/users/cn/jespinosa/phecomp/data/CRG/20120502_FDF_CRG/20120502_FDF_CRG/20120507_FDF_CRG_c12.mtb	1341	131	WWSS	food_sc	4	52649	1336435160	1	0.02	0.000175438596491228	2667	1
1	Drink 1	Intake 1	23	52790	1336435301	/users/cn/jespinosa/phecomp/data/CRG/20120502_FDF_CRG/20120502_FDF_CRG/20120507_FDF_CRG_c12.mtb	1483	NA	WWSS	water	1	52767	1336435278	1	0.02	0.000869565217391304	2668	1
1	Drink 2	Intake 2	23	52791	1336435302	/users/cn/jespinosa/phecomp/data/CRG/20120502_FDF_CRG/20120502_FDF_CRG/20120507_FDF_CRG_c12.mtb	598	NA	WWSS	water	2	52768	1336435279	1	0.04	0.00173913043478261	2669	1
1	Food 1	Intake 3	112	53006	1336435517	/users/cn/jespinosa/phecomp/data/CRG/20120502_FDF_CRG/20120502_FDF_CRG/20120507_FDF_CRG_c12.mtb	968	75	WWSS	food_sc	3	52894	1336435405	1	0.08	0.000714285714285714	2670	1
1	Drink 1	Intake 1	36	53042	1336435553	/users/cn/jespinosa/phecomp/data/CRG/20120502_FDF_CRG/20120502_FDF_CRG/20120507_FDF_CRG_c12.mtb	1484	NA	WWSS	water	1	53006	1336435517	1	0.1	0.00277777777777778	2671	1
1	Food 1	Intake 3	79	53160	1336435671	/users/cn/jespinosa/phecomp/data/CRG/20120502_FDF_CRG/20120502_FDF_CRG/20120507_FDF_CRG_c12.mtb	969	COLL	WWSS	food_sc	3	53081	1336435592	1	0.02	0.000253164556962025	2672	1
1	Food 2	Intake 4	34	53181	1336435692	/users/cn/jespinosa/phecomp/data/CRG/20120502_FDF_CRG/20120502_FDF_CRG/20120507_FDF_CRG_c12.mtb	1345	100	WWSS	food_sc	4	53147	1336435658	1	0.02	0.000588235294117647	2673	1
1	Food 2	Intake 4	64	53345	1336435856	/users/cn/jespinosa/phecomp/data/CRG/20120502_FDF_CRG/20120502_FDF_CRG/20120507_FDF_CRG_c12.mtb	1348	9303	WWSS	food_sc	4	53281	1336435792	1	0.02	0.0003125	2674	1
1	Drink 1	Intake 1	13	53354	1336435865	/users/cn/jespinosa/phecomp/data/CRG/20120502_FDF_CRG/20120502_FDF_CRG/20120507_FDF_CRG_c12.mtb	1485	NA	WWSS	water	1	53341	1336435852	1	0.02	0.00153846153846154	2675	1
1	Food 2	Intake 4	27	62675	1336445186	/users/cn/jespinosa/phecomp/data/CRG/20120502_FDF_CRG/20120502_FDF_CRG/20120507_FDF_CRG_c12.mtb	1352	43	WWSS	food_sc	4	62648	1336445159	1	0.02	0.000740740740740741	2676	1
1	Food 2	Intake 4	566	63284	1336445795	/users/cn/jespinosa/phecomp/data/CRG/20120502_FDF_CRG/20120502_FDF_CRG/20120507_FDF_CRG_c12.mtb	1353	230	WWSS	food_sc	4	62718	1336445229	1	0.16	0.000282685512367491	2677	1
1	Food 2	Intake 4	102	63616	1336446127	/users/cn/jespinosa/phecomp/data/CRG/20120502_FDF_CRG/20120502_FDF_CRG/20120507_FDF_CRG_c12.mtb	1356	157	WWSS	food_sc	4	63514	1336446025	1	0.02	0.000196078431372549	2678	1
1	Drink 1	Intake 1	25	63707	1336446218	/users/cn/jespinosa/phecomp/data/CRG/20120502_FDF_CRG/20120502_FDF_CRG/20120507_FDF_CRG_c12.mtb	1490	NA	WWSS	water	1	63682	1336446193	1	0.0799999999999998	0.00319999999999999	2679	1
1	Food 1	Intake 3	174	63947	1336446458	/users/cn/jespinosa/phecomp/data/CRG/20120502_FDF_CRG/20120502_FDF_CRG/20120507_FDF_CRG_c12.mtb	977	73	WWSS	food_sc	3	63773	1336446284	1	0.04	0.000229885057471264	2680	1
1	Food 1	Intake 3	75	64095	1336446606	/users/cn/jespinosa/phecomp/data/CRG/20120502_FDF_CRG/20120502_FDF_CRG/20120507_FDF_CRG_c12.mtb	979	130	WWSS	food_sc	3	64020	1336446531	1	0.02	0.000266666666666667	2681	1
1	Drink 1	Intake 1	33	64122	1336446633	/users/cn/jespinosa/phecomp/data/CRG/20120502_FDF_CRG/20120502_FDF_CRG/20120507_FDF_CRG_c12.mtb	1492	NA	WWSS	water	1	64089	1336446600	1	0.1	0.00303030303030303	2682	1
1	Food 1	Intake 3	72	64297	1336446808	/users/cn/jespinosa/phecomp/data/CRG/20120502_FDF_CRG/20120502_FDF_CRG/20120507_FDF_CRG_c12.mtb	980	730	WWSS	food_sc	3	64225	1336446736	1	0.02	0.000277777777777778	2683	1
1	Drink 1	Intake 1	18	64747	1336447258	/users/cn/jespinosa/phecomp/data/CRG/20120502_FDF_CRG/20120502_FDF_CRG/20120507_FDF_CRG_c12.mtb	1493	NA	WWSS	water	1	64729	1336447240	1	0.02	0.00111111111111111	2684	1
1	Drink 1	Intake 1	37	64877	1336447388	/users/cn/jespinosa/phecomp/data/CRG/20120502_FDF_CRG/20120502_FDF_CRG/20120507_FDF_CRG_c12.mtb	1495	NA	WWSS	water	1	64840	1336447351	1	0.12	0.00324324324324324	2685	1
1	Food 2	Intake 4	142	65169	1336447680	/users/cn/jespinosa/phecomp/data/CRG/20120502_FDF_CRG/20120502_FDF_CRG/20120507_FDF_CRG_c12.mtb	1362	42	WWSS	food_sc	4	65027	1336447538	1	0.04	0.00028169014084507	2686	1
1	Food 1	Intake 3	175	65386	1336447897	/users/cn/jespinosa/phecomp/data/CRG/20120502_FDF_CRG/20120502_FDF_CRG/20120507_FDF_CRG_c12.mtb	984	3795	WWSS	food_sc	3	65211	1336447722	1	0.08	0.000457142857142857	2687	1
1	Drink 1	Intake 1	26	65478	1336447989	/users/cn/jespinosa/phecomp/data/CRG/20120502_FDF_CRG/20120502_FDF_CRG/20120507_FDF_CRG_c12.mtb	1496	NA	WWSS	water	1	65452	1336447963	1	0.02	0.000769230769230769	2688	1
1	Drink 1	Intake 1	20	65573	1336448084	/users/cn/jespinosa/phecomp/data/CRG/20120502_FDF_CRG/20120502_FDF_CRG/20120507_FDF_CRG_c12.mtb	1497	NA	WWSS	water	1	65553	1336448064	1	0.04	0.002	2689	1
1	Drink 1	Intake 1	46	66024	1336448535	/users/cn/jespinosa/phecomp/data/CRG/20120502_FDF_CRG/20120502_FDF_CRG/20120507_FDF_CRG_c12.mtb	1498	NA	WWSS	water	1	65978	1336448489	1	0.0800000000000001	0.00173913043478261	2690	1
1	Drink 1	Intake 1	17	68908	1336451419	/users/cn/jespinosa/phecomp/data/CRG/20120502_FDF_CRG/20120502_FDF_CRG/20120507_FDF_CRG_c12.mtb	1500	NA	WWSS	water	1	68891	1336451402	1	0.02	0.00117647058823529	2691	1
1	Food 1	Intake 3	339	69520	1336452031	/users/cn/jespinosa/phecomp/data/CRG/20120502_FDF_CRG/20120502_FDF_CRG/20120507_FDF_CRG_c12.mtb	987	22	WWSS	food_sc	3	69181	1336451692	1	0.12	0.000353982300884956	2692	1
1	Food 1	Intake 3	74	69616	1336452127	/users/cn/jespinosa/phecomp/data/CRG/20120502_FDF_CRG/20120502_FDF_CRG/20120507_FDF_CRG_c12.mtb	988	52	WWSS	food_sc	3	69542	1336452053	1	0.02	0.00027027027027027	2693	1
1	Drink 1	Intake 1	25	69643	1336452154	/users/cn/jespinosa/phecomp/data/CRG/20120502_FDF_CRG/20120502_FDF_CRG/20120507_FDF_CRG_c12.mtb	1502	NA	WWSS	water	1	69618	1336452129	1	0.04	0.0016	2694	1
1	Food 1	Intake 3	66	69734	1336452245	/users/cn/jespinosa/phecomp/data/CRG/20120502_FDF_CRG/20120502_FDF_CRG/20120507_FDF_CRG_c12.mtb	989	69	WWSS	food_sc	3	69668	1336452179	1	0.02	0.000303030303030303	2695	1
1	Drink 1	Intake 1	21	69796	1336452307	/users/cn/jespinosa/phecomp/data/CRG/20120502_FDF_CRG/20120502_FDF_CRG/20120507_FDF_CRG_c12.mtb	1503	NA	WWSS	water	1	69775	1336452286	1	0.0399999999999998	0.0019047619047619	2696	1
1	Food 1	Intake 3	134	69937	1336452448	/users/cn/jespinosa/phecomp/data/CRG/20120502_FDF_CRG/20120502_FDF_CRG/20120507_FDF_CRG_c12.mtb	990	347	WWSS	food_sc	3	69803	1336452314	1	0.0399999999999999	0.000298507462686566	2697	1
1	Drink 2	Intake 2	17	70212	1336452723	/users/cn/jespinosa/phecomp/data/CRG/20120502_FDF_CRG/20120502_FDF_CRG/20120507_FDF_CRG_c12.mtb	601	NA	WWSS	water	2	70195	1336452706	1	0.02	0.00117647058823529	2698	1
1	Food 1	Intake 3	116	70400	1336452911	/users/cn/jespinosa/phecomp/data/CRG/20120502_FDF_CRG/20120502_FDF_CRG/20120507_FDF_CRG_c12.mtb	992	297	WWSS	food_sc	3	70284	1336452795	1	0.02	0.000172413793103448	2699	1
1	Drink 2	Intake 2	37	70664	1336453175	/users/cn/jespinosa/phecomp/data/CRG/20120502_FDF_CRG/20120502_FDF_CRG/20120507_FDF_CRG_c12.mtb	602	NA	WWSS	water	2	70627	1336453138	1	0.06	0.00162162162162162	2700	1
1	Food 1	Intake 3	99	70796	1336453307	/users/cn/jespinosa/phecomp/data/CRG/20120502_FDF_CRG/20120502_FDF_CRG/20120507_FDF_CRG_c12.mtb	994	46	WWSS	food_sc	3	70697	1336453208	1	0.04	0.000404040404040404	2701	1
1	Drink 1	Intake 1	18	70821	1336453332	/users/cn/jespinosa/phecomp/data/CRG/20120502_FDF_CRG/20120502_FDF_CRG/20120507_FDF_CRG_c12.mtb	1504	NA	WWSS	water	1	70803	1336453314	1	0.02	0.00111111111111111	2702	1
1	Food 1	Intake 3	162	71004	1336453515	/users/cn/jespinosa/phecomp/data/CRG/20120502_FDF_CRG/20120502_FDF_CRG/20120507_FDF_CRG_c12.mtb	995	85	WWSS	food_sc	3	70842	1336453353	1	0.0399999999999999	0.000246913580246913	2703	1
1	Drink 1	Intake 1	27	71047	1336453558	/users/cn/jespinosa/phecomp/data/CRG/20120502_FDF_CRG/20120502_FDF_CRG/20120507_FDF_CRG_c12.mtb	1505	NA	WWSS	water	1	71020	1336453531	1	0.12	0.00444444444444444	2704	1
1	Food 1	Intake 3	187	71276	1336453787	/users/cn/jespinosa/phecomp/data/CRG/20120502_FDF_CRG/20120502_FDF_CRG/20120507_FDF_CRG_c12.mtb	996	186	WWSS	food_sc	3	71089	1336453600	1	0.04	0.000213903743315508	2705	1
1	Food 1	Intake 3	139	71601	1336454112	/users/cn/jespinosa/phecomp/data/CRG/20120502_FDF_CRG/20120502_FDF_CRG/20120507_FDF_CRG_c12.mtb	997	6	WWSS	food_sc	3	71462	1336453973	1	0.04	0.000287769784172662	2706	1
1	Food 1	Intake 3	18	71625	1336454136	/users/cn/jespinosa/phecomp/data/CRG/20120502_FDF_CRG/20120502_FDF_CRG/20120507_FDF_CRG_c12.mtb	998	291	WWSS	food_sc	3	71607	1336454118	1	0.02	0.00111111111111111	2707	1
1	Drink 1	Intake 1	27	71855	1336454366	/users/cn/jespinosa/phecomp/data/CRG/20120502_FDF_CRG/20120502_FDF_CRG/20120507_FDF_CRG_c12.mtb	1508	NA	WWSS	water	1	71828	1336454339	1	0.0800000000000001	0.00296296296296297	2708	1
1	Food 1	Intake 3	147	72063	1336454574	/users/cn/jespinosa/phecomp/data/CRG/20120502_FDF_CRG/20120502_FDF_CRG/20120507_FDF_CRG_c12.mtb	1003	278	WWSS	food_sc	3	71916	1336454427	1	0.04	0.000272108843537415	2709	1
1	Food 1	Intake 3	110	72451	1336454962	/users/cn/jespinosa/phecomp/data/CRG/20120502_FDF_CRG/20120502_FDF_CRG/20120507_FDF_CRG_c12.mtb	1005	362	WWSS	food_sc	3	72341	1336454852	1	0.04	0.000363636363636364	2710	1
1	Drink 1	Intake 1	38	72782	1336455293	/users/cn/jespinosa/phecomp/data/CRG/20120502_FDF_CRG/20120502_FDF_CRG/20120507_FDF_CRG_c12.mtb	1510	NA	WWSS	water	1	72744	1336455255	1	0.0800000000000001	0.00210526315789474	2711	1
1	Food 1	Intake 3	71	72884	1336455395	/users/cn/jespinosa/phecomp/data/CRG/20120502_FDF_CRG/20120502_FDF_CRG/20120507_FDF_CRG_c12.mtb	1007	529	WWSS	food_sc	3	72813	1336455324	1	0.02	0.00028169014084507	2712	1
1	Food 1	Intake 3	70	73483	1336455994	/users/cn/jespinosa/phecomp/data/CRG/20120502_FDF_CRG/20120502_FDF_CRG/20120507_FDF_CRG_c12.mtb	1010	8381	WWSS	food_sc	3	73413	1336455924	1	0.04	0.000571428571428571	2713	1
1	Drink 1	Intake 1	20	73717	1336456228	/users/cn/jespinosa/phecomp/data/CRG/20120502_FDF_CRG/20120502_FDF_CRG/20120507_FDF_CRG_c12.mtb	1513	NA	WWSS	water	1	73697	1336456208	1	0.02	0.001	2714	1
1	Drink 1	Intake 1	45	74523	1336457034	/users/cn/jespinosa/phecomp/data/CRG/20120502_FDF_CRG/20120502_FDF_CRG/20120507_FDF_CRG_c12.mtb	1515	NA	WWSS	water	1	74478	1336456989	1	0.04	0.000888888888888889	2715	1
1	Food 1	Intake 3	33	81897	1336464408	/users/cn/jespinosa/phecomp/data/CRG/20120502_FDF_CRG/20120502_FDF_CRG/20120507_FDF_CRG_c12.mtb	1019	7	WWSS	food_sc	3	81864	1336464375	1	0.04	0.00121212121212121	2716	1
1	Food 1	Intake 3	122	82026	1336464537	/users/cn/jespinosa/phecomp/data/CRG/20120502_FDF_CRG/20120502_FDF_CRG/20120507_FDF_CRG_c12.mtb	1020	408	WWSS	food_sc	3	81904	1336464415	1	0.04	0.000327868852459016	2717	1
1	Food 1	Intake 3	142	82576	1336465087	/users/cn/jespinosa/phecomp/data/CRG/20120502_FDF_CRG/20120502_FDF_CRG/20120507_FDF_CRG_c12.mtb	1022	19646	WWSS	food_sc	3	82434	1336464945	1	0.04	0.00028169014084507	2718	1
1	Drink 2	Intake 2	31	84188	1336466699	/users/cn/jespinosa/phecomp/data/CRG/20120502_FDF_CRG/20120502_FDF_CRG/20120507_FDF_CRG_c12.mtb	605	NA	WWSS	water	2	84157	1336466668	1	0.06	0.00193548387096774	2719	1
1	Drink 2	Intake 2	46	84325	1336466836	/users/cn/jespinosa/phecomp/data/CRG/20120502_FDF_CRG/20120502_FDF_CRG/20120507_FDF_CRG_c12.mtb	606	NA	WWSS	water	2	84279	1336466790	1	0.06	0.00130434782608696	2720	1
1	Drink 2	Intake 2	17	92726	1336475237	/users/cn/jespinosa/phecomp/data/CRG/20120502_FDF_CRG/20120502_FDF_CRG/20120507_FDF_CRG_c12.mtb	608	NA	WWSS	water	2	92709	1336475220	1	0.02	0.00117647058823529	2721	1
1	Food 1	Intake 3	318	102540	1336485051	/users/cn/jespinosa/phecomp/data/CRG/20120502_FDF_CRG/20120502_FDF_CRG/20120507_FDF_CRG_c12.mtb	1025	6780	WWSS	food_sc	3	102222	1336484733	1	0.0799999999999998	0.000251572327044024	2722	1
1	Food 1	Intake 3	20	109340	1336491851	/users/cn/jespinosa/phecomp/data/CRG/20120502_FDF_CRG/20120502_FDF_CRG/20120507_FDF_CRG_c12.mtb	1029	2452	WWSS	food_sc	3	109320	1336491831	1	0.02	0.001	2723	1
1	Food 1	Intake 3	424	112216	1336494727	/users/cn/jespinosa/phecomp/data/CRG/20120502_FDF_CRG/20120502_FDF_CRG/20120507_FDF_CRG_c12.mtb	1031	3387	WWSS	food_sc	3	111792	1336494303	1	0.12	0.000283018867924528	2724	1
1	Food 1	Intake 3	558	116161	1336498672	/users/cn/jespinosa/phecomp/data/CRG/20120502_FDF_CRG/20120502_FDF_CRG/20120507_FDF_CRG_c12.mtb	1033	2140	WWSS	food_sc	3	115603	1336498114	1	0.2	0.0003584229390681	2725	1
1	Drink 1	Intake 1	13	116184	1336498695	/users/cn/jespinosa/phecomp/data/CRG/20120502_FDF_CRG/20120502_FDF_CRG/20120507_FDF_CRG_c12.mtb	1527	NA	WWSS	water	1	116171	1336498682	1	0.04	0.00307692307692308	2726	1
1	Drink 1	Intake 1	22	117830	1336500341	/users/cn/jespinosa/phecomp/data/CRG/20120502_FDF_CRG/20120502_FDF_CRG/20120507_FDF_CRG_c12.mtb	1528	NA	WWSS	water	1	117808	1336500319	1	0.1	0.00454545454545455	2727	1
1	Food 1	Intake 3	302	118603	1336501114	/users/cn/jespinosa/phecomp/data/CRG/20120502_FDF_CRG/20120502_FDF_CRG/20120507_FDF_CRG_c12.mtb	1034	8	WWSS	food_sc	3	118301	1336500812	1	0.0800000000000001	0.000264900662251656	2728	1
1	Food 1	Intake 3	119	118730	1336501241	/users/cn/jespinosa/phecomp/data/CRG/20120502_FDF_CRG/20120502_FDF_CRG/20120507_FDF_CRG_c12.mtb	1035	705	WWSS	food_sc	3	118611	1336501122	1	0.0800000000000001	0.000672268907563026	2729	1
1	Food 1	Intake 3	23	119458	1336501969	/users/cn/jespinosa/phecomp/data/CRG/20120502_FDF_CRG/20120502_FDF_CRG/20120507_FDF_CRG_c12.mtb	1039	751	WWSS	food_sc	3	119435	1336501946	1	0.3	0.0130434782608696	2730	1
1	Drink 1	Intake 1	38	119557	1336502068	/users/cn/jespinosa/phecomp/data/CRG/20120502_FDF_CRG/20120502_FDF_CRG/20120507_FDF_CRG_c12.mtb	1531	NA	WWSS	water	1	119519	1336502030	1	0.0799999999999996	0.00210526315789473	2731	1
1	Food 1	Intake 3	51	120260	1336502771	/users/cn/jespinosa/phecomp/data/CRG/20120502_FDF_CRG/20120502_FDF_CRG/20120507_FDF_CRG_c12.mtb	1047	115	WWSS	food_sc	3	120209	1336502720	1	0.02	0.000392156862745098	2732	1
1	Food 1	Intake 3	94	120469	1336502980	/users/cn/jespinosa/phecomp/data/CRG/20120502_FDF_CRG/20120502_FDF_CRG/20120507_FDF_CRG_c12.mtb	1049	27	WWSS	food_sc	3	120375	1336502886	1	0.02	0.000212765957446809	2733	1
1	Food 1	Intake 3	81	120577	1336503088	/users/cn/jespinosa/phecomp/data/CRG/20120502_FDF_CRG/20120502_FDF_CRG/20120507_FDF_CRG_c12.mtb	1050	70	WWSS	food_sc	3	120496	1336503007	1	0.02	0.000246913580246914	2734	1
1	Drink 2	Intake 2	13	120586	1336503097	/users/cn/jespinosa/phecomp/data/CRG/20120502_FDF_CRG/20120502_FDF_CRG/20120507_FDF_CRG_c12.mtb	612	NA	WWSS	water	2	120573	1336503084	1	0.04	0.00307692307692308	2735	1
1	Food 1	Intake 3	99	120746	1336503257	/users/cn/jespinosa/phecomp/data/CRG/20120502_FDF_CRG/20120502_FDF_CRG/20120507_FDF_CRG_c12.mtb	1051	22	WWSS	food_sc	3	120647	1336503158	1	0.02	0.000202020202020202	2736	1
1	Food 1	Intake 3	107	120875	1336503386	/users/cn/jespinosa/phecomp/data/CRG/20120502_FDF_CRG/20120502_FDF_CRG/20120507_FDF_CRG_c12.mtb	1052	225	WWSS	food_sc	3	120768	1336503279	1	0.04	0.000373831775700935	2737	1
1	Drink 2	Intake 2	25	120891	1336503402	/users/cn/jespinosa/phecomp/data/CRG/20120502_FDF_CRG/20120502_FDF_CRG/20120507_FDF_CRG_c12.mtb	614	NA	WWSS	water	2	120866	1336503377	1	0.04	0.0016	2738	1
1	Food 1	Intake 3	104	121204	1336503715	/users/cn/jespinosa/phecomp/data/CRG/20120502_FDF_CRG/20120502_FDF_CRG/20120507_FDF_CRG_c12.mtb	1054	134	WWSS	food_sc	3	121100	1336503611	1	0.02	0.000192307692307692	2739	1
1	Food 1	Intake 3	57	121395	1336503906	/users/cn/jespinosa/phecomp/data/CRG/20120502_FDF_CRG/20120502_FDF_CRG/20120507_FDF_CRG_c12.mtb	1055	1052	WWSS	food_sc	3	121338	1336503849	1	0.02	0.000350877192982456	2740	1
1	Drink 2	Intake 2	41	121644	1336504155	/users/cn/jespinosa/phecomp/data/CRG/20120502_FDF_CRG/20120502_FDF_CRG/20120507_FDF_CRG_c12.mtb	616	NA	WWSS	water	2	121603	1336504114	1	0.1	0.0024390243902439	2741	1
1	Food 1	Intake 3	34	122481	1336504992	/users/cn/jespinosa/phecomp/data/CRG/20120502_FDF_CRG/20120502_FDF_CRG/20120507_FDF_CRG_c12.mtb	1062	320	WWSS	food_sc	3	122447	1336504958	1	0.02	0.000588235294117647	2742	1
1	Drink 2	Intake 2	19	122491	1336505002	/users/cn/jespinosa/phecomp/data/CRG/20120502_FDF_CRG/20120502_FDF_CRG/20120507_FDF_CRG_c12.mtb	618	NA	WWSS	water	2	122472	1336504983	1	0.0399999999999999	0.00210526315789473	2743	1
1	Food 2	Intake 4	120	122921	1336505432	/users/cn/jespinosa/phecomp/data/CRG/20120502_FDF_CRG/20120502_FDF_CRG/20120507_FDF_CRG_c12.mtb	1430	4619	WWSS	food_sc	4	122801	1336505312	1	0.04	0.000333333333333333	2744	1
1	Drink 2	Intake 2	19	123756	1336506267	/users/cn/jespinosa/phecomp/data/CRG/20120502_FDF_CRG/20120502_FDF_CRG/20120507_FDF_CRG_c12.mtb	619	NA	WWSS	water	2	123737	1336506248	1	0.04	0.00210526315789474	2745	1
1	Drink 1	Intake 1	23	123913	1336506424	/users/cn/jespinosa/phecomp/data/CRG/20120502_FDF_CRG/20120502_FDF_CRG/20120507_FDF_CRG_c12.mtb	1541	NA	WWSS	water	1	123890	1336506401	1	0.02	0.000869565217391304	2746	1
1	Drink 1	Intake 1	17	124902	1336507413	/users/cn/jespinosa/phecomp/data/CRG/20120502_FDF_CRG/20120502_FDF_CRG/20120507_FDF_CRG_c12.mtb	1543	NA	WWSS	water	1	124885	1336507396	1	0.02	0.00117647058823529	2747	1
1	Food 1	Intake 3	76	127616	1336510127	/users/cn/jespinosa/phecomp/data/CRG/20120502_FDF_CRG/20120502_FDF_CRG/20120507_FDF_CRG_c12.mtb	1071	4	WWSS	food_sc	3	127540	1336510051	1	0.02	0.000263157894736842	2748	1
1	Food 1	Intake 3	73	127693	1336510204	/users/cn/jespinosa/phecomp/data/CRG/20120502_FDF_CRG/20120502_FDF_CRG/20120507_FDF_CRG_c12.mtb	1072	14	WWSS	food_sc	3	127620	1336510131	1	0.02	0.000273972602739726	2749	1
1	Food 2	Intake 4	279	127986	1336510497	/users/cn/jespinosa/phecomp/data/CRG/20120502_FDF_CRG/20120502_FDF_CRG/20120507_FDF_CRG_c12.mtb	1434	257	WWSS	food_sc	4	127707	1336510218	1	0.0999999999999996	0.000358422939068099	2750	1
1	Food 2	Intake 4	51	128294	1336510805	/users/cn/jespinosa/phecomp/data/CRG/20120502_FDF_CRG/20120502_FDF_CRG/20120507_FDF_CRG_c12.mtb	1438	26	WWSS	food_sc	4	128243	1336510754	1	0.0200000000000005	0.000392156862745108	2751	1
1	Food 1	Intake 3	109	128429	1336510940	/users/cn/jespinosa/phecomp/data/CRG/20120502_FDF_CRG/20120502_FDF_CRG/20120507_FDF_CRG_c12.mtb	1076	257	WWSS	food_sc	3	128320	1336510831	1	0.02	0.00018348623853211	2752	1
1	Drink 1	Intake 1	32	128450	1336510961	/users/cn/jespinosa/phecomp/data/CRG/20120502_FDF_CRG/20120502_FDF_CRG/20120507_FDF_CRG_c12.mtb	1546	NA	WWSS	water	1	128418	1336510929	1	0.02	0.000625	2753	1
1	Food 2	Intake 4	65	128751	1336511262	/users/cn/jespinosa/phecomp/data/CRG/20120502_FDF_CRG/20120502_FDF_CRG/20120507_FDF_CRG_c12.mtb	1442	346	WWSS	food_sc	4	128686	1336511197	1	0.02	0.000307692307692308	2754	1
1	Drink 1	Intake 1	28	128785	1336511296	/users/cn/jespinosa/phecomp/data/CRG/20120502_FDF_CRG/20120502_FDF_CRG/20120507_FDF_CRG_c12.mtb	1547	NA	WWSS	water	1	128757	1336511268	1	0.0800000000000001	0.00285714285714286	2755	1
1	Food 2	Intake 4	71	129168	1336511679	/users/cn/jespinosa/phecomp/data/CRG/20120502_FDF_CRG/20120502_FDF_CRG/20120507_FDF_CRG_c12.mtb	1445	337	WWSS	food_sc	4	129097	1336511608	1	0.02	0.00028169014084507	2756	1
1	Drink 1	Intake 1	48	129412	1336511923	/users/cn/jespinosa/phecomp/data/CRG/20120502_FDF_CRG/20120502_FDF_CRG/20120507_FDF_CRG_c12.mtb	1550	NA	WWSS	water	1	129364	1336511875	1	0.04	0.000833333333333333	2757	1
1	Food 2	Intake 4	106	129611	1336512122	/users/cn/jespinosa/phecomp/data/CRG/20120502_FDF_CRG/20120502_FDF_CRG/20120507_FDF_CRG_c12.mtb	1447	96	WWSS	food_sc	4	129505	1336512016	1	0.02	0.000188679245283019	2758	1
1	Food 2	Intake 4	237	129944	1336512455	/users/cn/jespinosa/phecomp/data/CRG/20120502_FDF_CRG/20120502_FDF_CRG/20120507_FDF_CRG_c12.mtb	1448	485	WWSS	food_sc	4	129707	1336512218	1	0.42	0.00177215189873418	2759	1
1	Drink 1	Intake 1	25	129980	1336512491	/users/cn/jespinosa/phecomp/data/CRG/20120502_FDF_CRG/20120502_FDF_CRG/20120507_FDF_CRG_c12.mtb	1552	NA	WWSS	water	1	129955	1336512466	1	0.0600000000000001	0.0024	2760	1
1	Food 1	Intake 3	49	130478	1336512989	/users/cn/jespinosa/phecomp/data/CRG/20120502_FDF_CRG/20120502_FDF_CRG/20120507_FDF_CRG_c12.mtb	1094	180	WWSS	food_sc	3	130429	1336512940	1	0.36	0.0073469387755102	2761	1
1	Food 1	Intake 3	65	130723	1336513234	/users/cn/jespinosa/phecomp/data/CRG/20120502_FDF_CRG/20120502_FDF_CRG/20120507_FDF_CRG_c12.mtb	1097	1966	WWSS	food_sc	3	130658	1336513169	1	0.02	0.000307692307692308	2762	1
1	Drink 2	Intake 2	22	130739	1336513250	/users/cn/jespinosa/phecomp/data/CRG/20120502_FDF_CRG/20120502_FDF_CRG/20120507_FDF_CRG_c12.mtb	622	NA	WWSS	water	2	130717	1336513228	1	0.0600000000000001	0.00272727272727273	2763	1
1	Drink 1	Intake 1	17	132555	1336515066	/users/cn/jespinosa/phecomp/data/CRG/20120502_FDF_CRG/20120502_FDF_CRG/20120507_FDF_CRG_c12.mtb	1557	NA	WWSS	water	1	132538	1336515049	1	0.02	0.00117647058823529	2764	1
1	Food 1	Intake 3	8	132697	1336515208	/users/cn/jespinosa/phecomp/data/CRG/20120502_FDF_CRG/20120502_FDF_CRG/20120507_FDF_CRG_c12.mtb	1108	COLL	WWSS	food_sc	3	132689	1336515200	1	0.02	0.0025	2765	1
1	Food 2	Intake 4	255	132949	1336515460	/users/cn/jespinosa/phecomp/data/CRG/20120502_FDF_CRG/20120502_FDF_CRG/20120507_FDF_CRG_c12.mtb	1467	260	WWSS	food_sc	4	132694	1336515205	1	0.0800000000000001	0.000313725490196079	2766	1
1	Food 2	Intake 4	189	133398	1336515909	/users/cn/jespinosa/phecomp/data/CRG/20120502_FDF_CRG/20120502_FDF_CRG/20120507_FDF_CRG_c12.mtb	1470	721	WWSS	food_sc	4	133209	1336515720	1	0.0600000000000001	0.000317460317460318	2767	1
1	Drink 1	Intake 1	23	133811	1336516322	/users/cn/jespinosa/phecomp/data/CRG/20120502_FDF_CRG/20120502_FDF_CRG/20120507_FDF_CRG_c12.mtb	1560	NA	WWSS	water	1	133788	1336516299	1	0.0600000000000001	0.00260869565217392	2768	1
1	Food 2	Intake 4	205	134324	1336516835	/users/cn/jespinosa/phecomp/data/CRG/20120502_FDF_CRG/20120502_FDF_CRG/20120507_FDF_CRG_c12.mtb	1474	3853	WWSS	food_sc	4	134119	1336516630	1	0.04	0.000195121951219512	2769	1
1	Food 2	Intake 4	16	138193	1336520704	/users/cn/jespinosa/phecomp/data/CRG/20120502_FDF_CRG/20120502_FDF_CRG/20120507_FDF_CRG_c12.mtb	1475	753	WWSS	food_sc	4	138177	1336520688	1	0.02	0.00125	2770	1
1	Drink 1	Intake 1	31	138218	1336520729	/users/cn/jespinosa/phecomp/data/CRG/20120502_FDF_CRG/20120502_FDF_CRG/20120507_FDF_CRG_c12.mtb	1561	NA	WWSS	water	1	138187	1336520698	1	0.02	0.000645161290322581	2771	1
1	Drink 1	Intake 1	22	138510	1336521021	/users/cn/jespinosa/phecomp/data/CRG/20120502_FDF_CRG/20120502_FDF_CRG/20120507_FDF_CRG_c12.mtb	1563	NA	WWSS	water	1	138488	1336520999	1	0.02	0.000909090909090909	2772	1
1	Drink 1	Intake 1	28	138810	1336521321	/users/cn/jespinosa/phecomp/data/CRG/20120502_FDF_CRG/20120502_FDF_CRG/20120507_FDF_CRG_c12.mtb	1564	NA	WWSS	water	1	138782	1336521293	1	0.0999999999999996	0.00357142857142856	2773	1
1	Food 1	Intake 3	216	139162	1336521673	/users/cn/jespinosa/phecomp/data/CRG/20120502_FDF_CRG/20120502_FDF_CRG/20120507_FDF_CRG_c12.mtb	1117	4	WWSS	food_sc	3	138946	1336521457	1	0.04	0.000185185185185185	2774	1
1	Food 1	Intake 3	186	139352	1336521863	/users/cn/jespinosa/phecomp/data/CRG/20120502_FDF_CRG/20120502_FDF_CRG/20120507_FDF_CRG_c12.mtb	1118	1094	WWSS	food_sc	3	139166	1336521677	1	0.0600000000000001	0.000322580645161291	2775	1
1	Drink 1	Intake 1	34	139378	1336521889	/users/cn/jespinosa/phecomp/data/CRG/20120502_FDF_CRG/20120502_FDF_CRG/20120507_FDF_CRG_c12.mtb	1565	NA	WWSS	water	1	139344	1336521855	1	0.12	0.00352941176470588	2776	1
1	Food 2	Intake 4	239	140685	1336523196	/users/cn/jespinosa/phecomp/data/CRG/20120502_FDF_CRG/20120502_FDF_CRG/20120507_FDF_CRG_c12.mtb	1482	436	WWSS	food_sc	4	140446	1336522957	1	0.12	0.000502092050209205	2777	1
1	Drink 1	Intake 1	22	140703	1336523214	/users/cn/jespinosa/phecomp/data/CRG/20120502_FDF_CRG/20120502_FDF_CRG/20120507_FDF_CRG_c12.mtb	1567	NA	WWSS	water	1	140681	1336523192	1	0.0600000000000001	0.00272727272727273	2778	1
1	Food 2	Intake 4	99	141220	1336523731	/users/cn/jespinosa/phecomp/data/CRG/20120502_FDF_CRG/20120502_FDF_CRG/20120507_FDF_CRG_c12.mtb	1486	820	WWSS	food_sc	4	141121	1336523632	1	0.04	0.000404040404040404	2779	1
1	Drink 2	Intake 2	22	141866	1336524377	/users/cn/jespinosa/phecomp/data/CRG/20120502_FDF_CRG/20120502_FDF_CRG/20120507_FDF_CRG_c12.mtb	627	NA	WWSS	water	2	141844	1336524355	1	0.04	0.00181818181818182	2780	1
1	Food 2	Intake 4	125	142165	1336524676	/users/cn/jespinosa/phecomp/data/CRG/20120502_FDF_CRG/20120502_FDF_CRG/20120507_FDF_CRG_c12.mtb	1490	1157	WWSS	food_sc	4	142040	1336524551	1	0.02	0.00016	2781	1
1	Drink 1	Intake 1	14	142919	1336525430	/users/cn/jespinosa/phecomp/data/CRG/20120502_FDF_CRG/20120502_FDF_CRG/20120507_FDF_CRG_c12.mtb	1569	NA	WWSS	water	1	142905	1336525416	1	0.04	0.00285714285714286	2782	1
1	Food 2	Intake 4	50	143372	1336525883	/users/cn/jespinosa/phecomp/data/CRG/20120502_FDF_CRG/20120502_FDF_CRG/20120507_FDF_CRG_c12.mtb	1494	7534	WWSS	food_sc	4	143322	1336525833	1	0.02	0.0004	2783	1
1	Food 2	Intake 4	70	150976	1336533487	/users/cn/jespinosa/phecomp/data/CRG/20120502_FDF_CRG/20120502_FDF_CRG/20120507_FDF_CRG_c12.mtb	1497	4196	WWSS	food_sc	4	150906	1336533417	1	0.04	0.000571428571428571	2784	1
1	Drink 1	Intake 1	35	151089	1336533600	/users/cn/jespinosa/phecomp/data/CRG/20120502_FDF_CRG/20120502_FDF_CRG/20120507_FDF_CRG_c12.mtb	1571	NA	WWSS	water	1	151054	1336533565	1	0.04	0.00114285714285714	2785	1
1	Drink 1	Intake 1	14	151324	1336533835	/users/cn/jespinosa/phecomp/data/CRG/20120502_FDF_CRG/20120502_FDF_CRG/20120507_FDF_CRG_c12.mtb	1572	NA	WWSS	water	1	151310	1336533821	1	0.0600000000000001	0.00428571428571429	2786	1
1	Food 2	Intake 4	120	155292	1336537803	/users/cn/jespinosa/phecomp/data/CRG/20120502_FDF_CRG/20120502_FDF_CRG/20120507_FDF_CRG_c12.mtb	1500	COLL	WWSS	food_sc	4	155172	1336537683	1	0.0200000000000005	0.000166666666666671	2787	1
1	Food 1	Intake 3	59	155348	1336537859	/users/cn/jespinosa/phecomp/data/CRG/20120502_FDF_CRG/20120502_FDF_CRG/20120507_FDF_CRG_c12.mtb	1130	94	WWSS	food_sc	3	155289	1336537800	1	0.04	0.000677966101694915	2788	1
1	Food 1	Intake 3	86	155528	1336538039	/users/cn/jespinosa/phecomp/data/CRG/20120502_FDF_CRG/20120502_FDF_CRG/20120507_FDF_CRG_c12.mtb	1131	12	WWSS	food_sc	3	155442	1336537953	1	0.02	0.000232558139534884	2789	1
1	Drink 2	Intake 2	17	155542	1336538053	/users/cn/jespinosa/phecomp/data/CRG/20120502_FDF_CRG/20120502_FDF_CRG/20120507_FDF_CRG_c12.mtb	628	NA	WWSS	water	2	155525	1336538036	1	0.02	0.00117647058823529	2790	1
1	Food 1	Intake 3	146	155686	1336538197	/users/cn/jespinosa/phecomp/data/CRG/20120502_FDF_CRG/20120502_FDF_CRG/20120507_FDF_CRG_c12.mtb	1132	75	WWSS	food_sc	3	155540	1336538051	1	0.0600000000000001	0.00041095890410959	2791	1
1	Drink 1	Intake 1	33	155712	1336538223	/users/cn/jespinosa/phecomp/data/CRG/20120502_FDF_CRG/20120502_FDF_CRG/20120507_FDF_CRG_c12.mtb	1574	NA	WWSS	water	1	155679	1336538190	1	0.1	0.00303030303030303	2792	1
1	Food 1	Intake 3	245	156006	1336538517	/users/cn/jespinosa/phecomp/data/CRG/20120502_FDF_CRG/20120502_FDF_CRG/20120507_FDF_CRG_c12.mtb	1133	535	WWSS	food_sc	3	155761	1336538272	1	0.1	0.000408163265306122	2793	1
1	Drink 2	Intake 2	21	156038	1336538549	/users/cn/jespinosa/phecomp/data/CRG/20120502_FDF_CRG/20120502_FDF_CRG/20120507_FDF_CRG_c12.mtb	629	NA	WWSS	water	2	156017	1336538528	1	0.08	0.00380952380952381	2794	1
1	Drink 2	Intake 2	30	156386	1336538897	/users/cn/jespinosa/phecomp/data/CRG/20120502_FDF_CRG/20120502_FDF_CRG/20120507_FDF_CRG_c12.mtb	630	NA	WWSS	water	2	156356	1336538867	1	0.0800000000000001	0.00266666666666667	2795	1
1	Food 1	Intake 3	125	156666	1336539177	/users/cn/jespinosa/phecomp/data/CRG/20120502_FDF_CRG/20120502_FDF_CRG/20120507_FDF_CRG_c12.mtb	1138	185	WWSS	food_sc	3	156541	1336539052	1	0.02	0.00016	2796	1
1	Drink 1	Intake 1	29	156789	1336539300	/users/cn/jespinosa/phecomp/data/CRG/20120502_FDF_CRG/20120502_FDF_CRG/20120507_FDF_CRG_c12.mtb	1575	NA	WWSS	water	1	156760	1336539271	1	0.04	0.00137931034482759	2797	1
1	Food 2	Intake 4	41	156892	1336539403	/users/cn/jespinosa/phecomp/data/CRG/20120502_FDF_CRG/20120502_FDF_CRG/20120507_FDF_CRG_c12.mtb	1509	33	WWSS	food_sc	4	156851	1336539362	1	0.02	0.00048780487804878	2798	1
1	Food 2	Intake 4	84	157009	1336539520	/users/cn/jespinosa/phecomp/data/CRG/20120502_FDF_CRG/20120502_FDF_CRG/20120507_FDF_CRG_c12.mtb	1510	838	WWSS	food_sc	4	156925	1336539436	1	0.02	0.000238095238095238	2799	1
1	Drink 1	Intake 1	22	157335	1336539846	/users/cn/jespinosa/phecomp/data/CRG/20120502_FDF_CRG/20120502_FDF_CRG/20120507_FDF_CRG_c12.mtb	1576	NA	WWSS	water	1	157313	1336539824	1	0.0399999999999996	0.0018181818181818	2800	1
1	Food 2	Intake 4	101	157948	1336540459	/users/cn/jespinosa/phecomp/data/CRG/20120502_FDF_CRG/20120502_FDF_CRG/20120507_FDF_CRG_c12.mtb	1516	470	WWSS	food_sc	4	157847	1336540358	1	0.04	0.000396039603960396	2801	1
1	Drink 1	Intake 1	43	157982	1336540493	/users/cn/jespinosa/phecomp/data/CRG/20120502_FDF_CRG/20120502_FDF_CRG/20120507_FDF_CRG_c12.mtb	1577	NA	WWSS	water	1	157939	1336540450	1	0.12	0.0027906976744186	2802	1
1	Food 2	Intake 4	120	158538	1336541049	/users/cn/jespinosa/phecomp/data/CRG/20120502_FDF_CRG/20120502_FDF_CRG/20120507_FDF_CRG_c12.mtb	1520	112	WWSS	food_sc	4	158418	1336540929	1	0.04	0.000333333333333333	2803	1
1	Food 2	Intake 4	33	158683	1336541194	/users/cn/jespinosa/phecomp/data/CRG/20120502_FDF_CRG/20120502_FDF_CRG/20120507_FDF_CRG_c12.mtb	1522	449	WWSS	food_sc	4	158650	1336541161	1	0.02	0.000606060606060606	2804	1
1	Food 1	Intake 3	61	159193	1336541704	/users/cn/jespinosa/phecomp/data/CRG/20120502_FDF_CRG/20120502_FDF_CRG/20120507_FDF_CRG_c12.mtb	1155	6	WWSS	food_sc	3	159132	1336541643	1	0.02	0.000327868852459016	2805	1
1	Food 2	Intake 4	107	159306	1336541817	/users/cn/jespinosa/phecomp/data/CRG/20120502_FDF_CRG/20120502_FDF_CRG/20120507_FDF_CRG_c12.mtb	1526	403	WWSS	food_sc	4	159199	1336541710	1	0.02	0.000186915887850467	2806	1
1	Drink 2	Intake 2	14	159570	1336542081	/users/cn/jespinosa/phecomp/data/CRG/20120502_FDF_CRG/20120502_FDF_CRG/20120507_FDF_CRG_c12.mtb	634	NA	WWSS	water	2	159556	1336542067	1	0.02	0.00142857142857143	2807	1
1	Food 1	Intake 3	152	159861	1336542372	/users/cn/jespinosa/phecomp/data/CRG/20120502_FDF_CRG/20120502_FDF_CRG/20120507_FDF_CRG_c12.mtb	1161	41	WWSS	food_sc	3	159709	1336542220	1	0.0600000000000001	0.000394736842105264	2808	1
1	Drink 2	Intake 2	30	159896	1336542407	/users/cn/jespinosa/phecomp/data/CRG/20120502_FDF_CRG/20120502_FDF_CRG/20120507_FDF_CRG_c12.mtb	635	NA	WWSS	water	2	159866	1336542377	1	0.0600000000000001	0.002	2809	1
1	Food 1	Intake 3	150	160052	1336542563	/users/cn/jespinosa/phecomp/data/CRG/20120502_FDF_CRG/20120502_FDF_CRG/20120507_FDF_CRG_c12.mtb	1162	136	WWSS	food_sc	3	159902	1336542413	1	0.04	0.000266666666666667	2810	1
1	Food 1	Intake 3	97	160285	1336542796	/users/cn/jespinosa/phecomp/data/CRG/20120502_FDF_CRG/20120502_FDF_CRG/20120507_FDF_CRG_c12.mtb	1164	795	WWSS	food_sc	3	160188	1336542699	1	0.02	0.000206185567010309	2811	1
1	Drink 1	Intake 1	14	160364	1336542875	/users/cn/jespinosa/phecomp/data/CRG/20120502_FDF_CRG/20120502_FDF_CRG/20120507_FDF_CRG_c12.mtb	1581	NA	WWSS	water	1	160350	1336542861	1	0.04	0.00285714285714286	2812	1
1	Food 1	Intake 3	57	161137	1336543648	/users/cn/jespinosa/phecomp/data/CRG/20120502_FDF_CRG/20120502_FDF_CRG/20120507_FDF_CRG_c12.mtb	1167	244	WWSS	food_sc	3	161080	1336543591	1	0.02	0.000350877192982456	2813	1
1	Food 1	Intake 3	126	161507	1336544018	/users/cn/jespinosa/phecomp/data/CRG/20120502_FDF_CRG/20120502_FDF_CRG/20120507_FDF_CRG_c12.mtb	1168	847	WWSS	food_sc	3	161381	1336543892	1	0.02	0.000158730158730159	2814	1
1	Drink 2	Intake 2	23	161643	1336544154	/users/cn/jespinosa/phecomp/data/CRG/20120502_FDF_CRG/20120502_FDF_CRG/20120507_FDF_CRG_c12.mtb	637	NA	WWSS	water	2	161620	1336544131	1	0.0799999999999998	0.00347826086956521	2815	1
1	Food 1	Intake 3	47	162401	1336544912	/users/cn/jespinosa/phecomp/data/CRG/20120502_FDF_CRG/20120502_FDF_CRG/20120507_FDF_CRG_c12.mtb	1170	14225	WWSS	food_sc	3	162354	1336544865	1	0.02	0.000425531914893617	2816	1
1	Food 1	Intake 3	149	5598	1336559286	/users/cn/jespinosa/phecomp/data/CRG/20120502_FDF_CRG/20120502_FDF_CRG/20120509_FDF_CRG_c12.mtb	1280	COLL	WWSS	food_sc	3	5449	1336559137	1	0.02	0.000134228187919463	2817	1
1	Food 2	Intake 4	87	5674	1336559362	/users/cn/jespinosa/phecomp/data/CRG/20120502_FDF_CRG/20120502_FDF_CRG/20120509_FDF_CRG_c12.mtb	1691	630	WWSS	food_sc	4	5587	1336559275	1	0.02	0.000229885057471264	2818	1
1	Drink 2	Intake 2	25	5696	1336559384	/users/cn/jespinosa/phecomp/data/CRG/20120502_FDF_CRG/20120502_FDF_CRG/20120509_FDF_CRG_c12.mtb	712	NA	WWSS	water	2	5671	1336559359	1	0.06	0.0024	2819	1
1	Food 1	Intake 3	97	6401	1336560089	/users/cn/jespinosa/phecomp/data/CRG/20120502_FDF_CRG/20120502_FDF_CRG/20120509_FDF_CRG_c12.mtb	1282	8335	WWSS	food_sc	3	6304	1336559992	1	0.04	0.000412371134020619	2820	1
1	Drink 1	Intake 1	28	7100	1336560788	/users/cn/jespinosa/phecomp/data/CRG/20120502_FDF_CRG/20120502_FDF_CRG/20120509_FDF_CRG_c12.mtb	1727	NA	WWSS	water	1	7072	1336560760	1	0.02	0.000714285714285714	2821	1
1	Food 2	Intake 4	21	14757	1336568445	/users/cn/jespinosa/phecomp/data/CRG/20120502_FDF_CRG/20120502_FDF_CRG/20120509_FDF_CRG_c12.mtb	1694	24	WWSS	food_sc	4	14736	1336568424	1	0.02	0.000952380952380952	2822	1
1	Food 2	Intake 4	44	14825	1336568513	/users/cn/jespinosa/phecomp/data/CRG/20120502_FDF_CRG/20120502_FDF_CRG/20120509_FDF_CRG_c12.mtb	1695	36	WWSS	food_sc	4	14781	1336568469	1	0.04	0.000909090909090909	2823	1
1	Food 2	Intake 4	67	14928	1336568616	/users/cn/jespinosa/phecomp/data/CRG/20120502_FDF_CRG/20120502_FDF_CRG/20120509_FDF_CRG_c12.mtb	1696	14714	WWSS	food_sc	4	14861	1336568549	1	0.04	0.000597014925373134	2824	1
1	Food 1	Intake 3	18	29660	1336583348	/users/cn/jespinosa/phecomp/data/CRG/20120502_FDF_CRG/20120502_FDF_CRG/20120509_FDF_CRG_c12.mtb	1286	2163	WWSS	food_sc	3	29642	1336583330	1	0.02	0.00111111111111111	2825	1
1	Food 2	Intake 4	17	31840	1336585528	/users/cn/jespinosa/phecomp/data/CRG/20120502_FDF_CRG/20120502_FDF_CRG/20120509_FDF_CRG_c12.mtb	1700	46	WWSS	food_sc	4	31823	1336585511	1	0.02	0.00117647058823529	2826	1
1	Food 1	Intake 3	16	31902	1336585590	/users/cn/jespinosa/phecomp/data/CRG/20120502_FDF_CRG/20120502_FDF_CRG/20120509_FDF_CRG_c12.mtb	1288	19	WWSS	food_sc	3	31886	1336585574	1	0.02	0.00125	2827	1
1	Food 1	Intake 3	257	32178	1336585866	/users/cn/jespinosa/phecomp/data/CRG/20120502_FDF_CRG/20120502_FDF_CRG/20120509_FDF_CRG_c12.mtb	1289	1954	WWSS	food_sc	3	31921	1336585609	1	0.12	0.00046692607003891	2828	1
1	Drink 1	Intake 1	17	33556	1336587244	/users/cn/jespinosa/phecomp/data/CRG/20120502_FDF_CRG/20120502_FDF_CRG/20120509_FDF_CRG_c12.mtb	1729	NA	WWSS	water	1	33539	1336587227	1	0.02	0.00117647058823529	2829	1
1	Food 1	Intake 3	150	34282	1336587970	/users/cn/jespinosa/phecomp/data/CRG/20120502_FDF_CRG/20120502_FDF_CRG/20120509_FDF_CRG_c12.mtb	1290	COLL	WWSS	food_sc	3	34132	1336587820	1	0.06	0.0004	2830	1
1	Food 2	Intake 4	139	34410	1336588098	/users/cn/jespinosa/phecomp/data/CRG/20120502_FDF_CRG/20120502_FDF_CRG/20120509_FDF_CRG_c12.mtb	1701	20	WWSS	food_sc	4	34271	1336587959	1	0.06	0.000431654676258993	2831	1
1	Food 1	Intake 3	67	34497	1336588185	/users/cn/jespinosa/phecomp/data/CRG/20120502_FDF_CRG/20120502_FDF_CRG/20120509_FDF_CRG_c12.mtb	1291	18	WWSS	food_sc	3	34430	1336588118	1	0.02	0.000298507462686567	2832	1
1	Drink 1	Intake 1	12	34507	1336588195	/users/cn/jespinosa/phecomp/data/CRG/20120502_FDF_CRG/20120502_FDF_CRG/20120509_FDF_CRG_c12.mtb	1730	NA	WWSS	water	1	34495	1336588183	1	0.02	0.00166666666666667	2833	1
1	Food 1	Intake 3	70	34585	1336588273	/users/cn/jespinosa/phecomp/data/CRG/20120502_FDF_CRG/20120502_FDF_CRG/20120509_FDF_CRG_c12.mtb	1292	57	WWSS	food_sc	3	34515	1336588203	1	0.02	0.000285714285714286	2834	1
1	Drink 2	Intake 2	37	34618	1336588306	/users/cn/jespinosa/phecomp/data/CRG/20120502_FDF_CRG/20120502_FDF_CRG/20120509_FDF_CRG_c12.mtb	713	NA	WWSS	water	2	34581	1336588269	1	0.06	0.00162162162162162	2835	1
1	Food 1	Intake 3	51	34693	1336588381	/users/cn/jespinosa/phecomp/data/CRG/20120502_FDF_CRG/20120502_FDF_CRG/20120509_FDF_CRG_c12.mtb	1293	59	WWSS	food_sc	3	34642	1336588330	1	0.02	0.000392156862745098	2836	1
1	Food 2	Intake 4	65	34817	1336588505	/users/cn/jespinosa/phecomp/data/CRG/20120502_FDF_CRG/20120502_FDF_CRG/20120509_FDF_CRG_c12.mtb	1703	1253	WWSS	food_sc	4	34752	1336588440	1	0.02	0.000307692307692308	2837	1
1	Food 2	Intake 4	309	36379	1336590067	/users/cn/jespinosa/phecomp/data/CRG/20120502_FDF_CRG/20120502_FDF_CRG/20120509_FDF_CRG_c12.mtb	1705	1200	WWSS	food_sc	4	36070	1336589758	1	0.1	0.000323624595469256	2838	1
1	Drink 2	Intake 2	27	36403	1336590091	/users/cn/jespinosa/phecomp/data/CRG/20120502_FDF_CRG/20120502_FDF_CRG/20120509_FDF_CRG_c12.mtb	714	NA	WWSS	water	2	36376	1336590064	1	0.08	0.00296296296296296	2839	1
1	Food 2	Intake 4	223	37802	1336591490	/users/cn/jespinosa/phecomp/data/CRG/20120502_FDF_CRG/20120502_FDF_CRG/20120509_FDF_CRG_c12.mtb	1707	508	WWSS	food_sc	4	37579	1336591267	1	0.08	0.000358744394618834	2840	1
1	Drink 2	Intake 2	16	37816	1336591504	/users/cn/jespinosa/phecomp/data/CRG/20120502_FDF_CRG/20120502_FDF_CRG/20120509_FDF_CRG_c12.mtb	715	NA	WWSS	water	2	37800	1336591488	1	0.04	0.0025	2841	1
1	Drink 1	Intake 1	22	38287	1336591975	/users/cn/jespinosa/phecomp/data/CRG/20120502_FDF_CRG/20120502_FDF_CRG/20120509_FDF_CRG_c12.mtb	1732	NA	WWSS	water	1	38265	1336591953	1	0.02	0.000909090909090909	2842	1
1	Food 2	Intake 4	310	38620	1336592308	/users/cn/jespinosa/phecomp/data/CRG/20120502_FDF_CRG/20120502_FDF_CRG/20120509_FDF_CRG_c12.mtb	1708	1209	WWSS	food_sc	4	38310	1336591998	1	0.12	0.000387096774193548	2843	1
1	Drink 1	Intake 1	13	38636	1336592324	/users/cn/jespinosa/phecomp/data/CRG/20120502_FDF_CRG/20120502_FDF_CRG/20120509_FDF_CRG_c12.mtb	1733	NA	WWSS	water	1	38623	1336592311	1	0.06	0.00461538461538461	2844	1
1	Drink 1	Intake 1	15	38787	1336592475	/users/cn/jespinosa/phecomp/data/CRG/20120502_FDF_CRG/20120502_FDF_CRG/20120509_FDF_CRG_c12.mtb	1734	NA	WWSS	water	1	38772	1336592460	1	0.02	0.00133333333333333	2845	1
1	Food 2	Intake 4	187	40016	1336593704	/users/cn/jespinosa/phecomp/data/CRG/20120502_FDF_CRG/20120502_FDF_CRG/20120509_FDF_CRG_c12.mtb	1711	89	WWSS	food_sc	4	39829	1336593517	1	0.12	0.000641711229946524	2846	1
1	Food 2	Intake 4	49	40154	1336593842	/users/cn/jespinosa/phecomp/data/CRG/20120502_FDF_CRG/20120502_FDF_CRG/20120509_FDF_CRG_c12.mtb	1713	58	WWSS	food_sc	4	40105	1336593793	1	0.02	0.000408163265306122	2847	1
1	Food 1	Intake 3	48	40260	1336593948	/users/cn/jespinosa/phecomp/data/CRG/20120502_FDF_CRG/20120502_FDF_CRG/20120509_FDF_CRG_c12.mtb	1297	365	WWSS	food_sc	3	40212	1336593900	1	0.02	0.000416666666666667	2848	1
1	Food 2	Intake 4	162	40787	1336594475	/users/cn/jespinosa/phecomp/data/CRG/20120502_FDF_CRG/20120502_FDF_CRG/20120509_FDF_CRG_c12.mtb	1717	208	WWSS	food_sc	4	40625	1336594313	1	0.02	0.000123456790123457	2849	1
1	Drink 2	Intake 2	23	40805	1336594493	/users/cn/jespinosa/phecomp/data/CRG/20120502_FDF_CRG/20120502_FDF_CRG/20120509_FDF_CRG_c12.mtb	716	NA	WWSS	water	2	40782	1336594470	1	0.04	0.00173913043478261	2850	1
1	Food 2	Intake 4	80	41075	1336594763	/users/cn/jespinosa/phecomp/data/CRG/20120502_FDF_CRG/20120502_FDF_CRG/20120509_FDF_CRG_c12.mtb	1720	141	WWSS	food_sc	4	40995	1336594683	1	0.02	0.00025	2851	1
1	Drink 2	Intake 2	26	41096	1336594784	/users/cn/jespinosa/phecomp/data/CRG/20120502_FDF_CRG/20120502_FDF_CRG/20120509_FDF_CRG_c12.mtb	717	NA	WWSS	water	2	41070	1336594758	1	0.1	0.00384615384615385	2852	1
1	Food 2	Intake 4	97	41313	1336595001	/users/cn/jespinosa/phecomp/data/CRG/20120502_FDF_CRG/20120502_FDF_CRG/20120509_FDF_CRG_c12.mtb	1722	93	WWSS	food_sc	4	41216	1336594904	1	0.04	0.000412371134020619	2853	1
1	Drink 1	Intake 1	26	41342	1336595030	/users/cn/jespinosa/phecomp/data/CRG/20120502_FDF_CRG/20120502_FDF_CRG/20120509_FDF_CRG_c12.mtb	1737	NA	WWSS	water	1	41316	1336595004	1	0.02	0.000769230769230769	2854	1
1	Food 1	Intake 3	44	41450	1336595138	/users/cn/jespinosa/phecomp/data/CRG/20120502_FDF_CRG/20120502_FDF_CRG/20120509_FDF_CRG_c12.mtb	1303	46	WWSS	food_sc	3	41406	1336595094	1	0.02	0.000454545454545455	2855	1
1	Food 2	Intake 4	113	41609	1336595297	/users/cn/jespinosa/phecomp/data/CRG/20120502_FDF_CRG/20120502_FDF_CRG/20120509_FDF_CRG_c12.mtb	1723	COLL	WWSS	food_sc	4	41496	1336595184	1	0.02	0.000176991150442478	2856	1
1	Food 1	Intake 3	130	41726	1336595414	/users/cn/jespinosa/phecomp/data/CRG/20120502_FDF_CRG/20120502_FDF_CRG/20120509_FDF_CRG_c12.mtb	1306	484	WWSS	food_sc	3	41596	1336595284	1	0.04	0.000307692307692308	2857	1
1	Drink 2	Intake 2	28	41766	1336595454	/users/cn/jespinosa/phecomp/data/CRG/20120502_FDF_CRG/20120502_FDF_CRG/20120509_FDF_CRG_c12.mtb	718	NA	WWSS	water	2	41738	1336595426	1	0.06	0.00214285714285714	2858	1
1	Food 1	Intake 3	45	42255	1336595943	/users/cn/jespinosa/phecomp/data/CRG/20120502_FDF_CRG/20120502_FDF_CRG/20120509_FDF_CRG_c12.mtb	1307	101	WWSS	food_sc	3	42210	1336595898	1	0.02	0.000444444444444444	2859	1
1	Food 1	Intake 3	127	42483	1336596171	/users/cn/jespinosa/phecomp/data/CRG/20120502_FDF_CRG/20120502_FDF_CRG/20120509_FDF_CRG_c12.mtb	1308	279	WWSS	food_sc	3	42356	1336596044	1	0.02	0.00015748031496063	2860	1
1	Drink 2	Intake 2	28	42602	1336596290	/users/cn/jespinosa/phecomp/data/CRG/20120502_FDF_CRG/20120502_FDF_CRG/20120509_FDF_CRG_c12.mtb	719	NA	WWSS	water	2	42574	1336596262	1	0.1	0.00357142857142857	2861	1
1	Drink 1	Intake 1	17	42647	1336596335	/users/cn/jespinosa/phecomp/data/CRG/20120502_FDF_CRG/20120502_FDF_CRG/20120509_FDF_CRG_c12.mtb	1739	NA	WWSS	water	1	42630	1336596318	1	0.02	0.00117647058823529	2862	1
1	Food 2	Intake 4	21	42783	1336596471	/users/cn/jespinosa/phecomp/data/CRG/20120502_FDF_CRG/20120502_FDF_CRG/20120509_FDF_CRG_c12.mtb	1725	101	WWSS	food_sc	4	42762	1336596450	1	0.02	0.000952380952380952	2863	1
1	Food 2	Intake 4	111	42995	1336596683	/users/cn/jespinosa/phecomp/data/CRG/20120502_FDF_CRG/20120502_FDF_CRG/20120509_FDF_CRG_c12.mtb	1727	1077	WWSS	food_sc	4	42884	1336596572	1	0.0399999999999999	0.000360360360360359	2864	1
1	Drink 2	Intake 2	29	43030	1336596718	/users/cn/jespinosa/phecomp/data/CRG/20120502_FDF_CRG/20120502_FDF_CRG/20120509_FDF_CRG_c12.mtb	720	NA	WWSS	water	2	43001	1336596689	1	0.08	0.00275862068965517	2865	1
1	Food 2	Intake 4	17	44089	1336597777	/users/cn/jespinosa/phecomp/data/CRG/20120502_FDF_CRG/20120502_FDF_CRG/20120509_FDF_CRG_c12.mtb	1728	45	WWSS	food_sc	4	44072	1336597760	1	0.02	0.00117647058823529	2866	1
1	Food 2	Intake 4	39	44173	1336597861	/users/cn/jespinosa/phecomp/data/CRG/20120502_FDF_CRG/20120502_FDF_CRG/20120509_FDF_CRG_c12.mtb	1729	9	WWSS	food_sc	4	44134	1336597822	1	0.02	0.000512820512820513	2867	1
1	Food 2	Intake 4	74	44256	1336597944	/users/cn/jespinosa/phecomp/data/CRG/20120502_FDF_CRG/20120502_FDF_CRG/20120509_FDF_CRG_c12.mtb	1730	45	WWSS	food_sc	4	44182	1336597870	1	0.02	0.00027027027027027	2868	1
1	Food 2	Intake 4	220	44521	1336598209	/users/cn/jespinosa/phecomp/data/CRG/20120502_FDF_CRG/20120502_FDF_CRG/20120509_FDF_CRG_c12.mtb	1731	918	WWSS	food_sc	4	44301	1336597989	1	0.1	0.000454545454545455	2869	1
1	Drink 2	Intake 2	36	44552	1336598240	/users/cn/jespinosa/phecomp/data/CRG/20120502_FDF_CRG/20120502_FDF_CRG/20120509_FDF_CRG_c12.mtb	721	NA	WWSS	water	2	44516	1336598204	1	0.08	0.00222222222222222	2870	1
1	Food 2	Intake 4	128	45567	1336599255	/users/cn/jespinosa/phecomp/data/CRG/20120502_FDF_CRG/20120502_FDF_CRG/20120509_FDF_CRG_c12.mtb	1732	43	WWSS	food_sc	4	45439	1336599127	1	0.02	0.00015625	2871	1
1	Food 2	Intake 4	157	45767	1336599455	/users/cn/jespinosa/phecomp/data/CRG/20120502_FDF_CRG/20120502_FDF_CRG/20120509_FDF_CRG_c12.mtb	1733	COLL	WWSS	food_sc	4	45610	1336599298	1	0.02	0.000127388535031847	2872	1
1	Food 1	Intake 3	173	45926	1336599614	/users/cn/jespinosa/phecomp/data/CRG/20120502_FDF_CRG/20120502_FDF_CRG/20120509_FDF_CRG_c12.mtb	1316	73	WWSS	food_sc	3	45753	1336599441	1	0.04	0.00023121387283237	2873	1
1	Drink 1	Intake 1	31	45952	1336599640	/users/cn/jespinosa/phecomp/data/CRG/20120502_FDF_CRG/20120502_FDF_CRG/20120509_FDF_CRG_c12.mtb	1741	NA	WWSS	water	1	45921	1336599609	1	0.06	0.00193548387096774	2874	1
1	Food 1	Intake 3	160	46159	1336599847	/users/cn/jespinosa/phecomp/data/CRG/20120502_FDF_CRG/20120502_FDF_CRG/20120509_FDF_CRG_c12.mtb	1317	20	WWSS	food_sc	3	45999	1336599687	1	0.08	0.0005	2875	1
1	Food 1	Intake 3	82	46261	1336599949	/users/cn/jespinosa/phecomp/data/CRG/20120502_FDF_CRG/20120502_FDF_CRG/20120509_FDF_CRG_c12.mtb	1318	1945	WWSS	food_sc	3	46179	1336599867	1	0.0600000000000001	0.000731707317073172	2876	1
1	Drink 2	Intake 2	37	46300	1336599988	/users/cn/jespinosa/phecomp/data/CRG/20120502_FDF_CRG/20120502_FDF_CRG/20120509_FDF_CRG_c12.mtb	722	NA	WWSS	water	2	46263	1336599951	1	0.1	0.0027027027027027	2877	1
1	Food 1	Intake 3	58	48264	1336601952	/users/cn/jespinosa/phecomp/data/CRG/20120502_FDF_CRG/20120502_FDF_CRG/20120509_FDF_CRG_c12.mtb	1320	308	WWSS	food_sc	3	48206	1336601894	1	0.04	0.000689655172413793	2878	1
1	Food 1	Intake 3	203	48775	1336602463	/users/cn/jespinosa/phecomp/data/CRG/20120502_FDF_CRG/20120502_FDF_CRG/20120509_FDF_CRG_c12.mtb	1321	615	WWSS	food_sc	3	48572	1336602260	1	0.1	0.000492610837438424	2879	1
1	Drink 2	Intake 2	32	48867	1336602555	/users/cn/jespinosa/phecomp/data/CRG/20120502_FDF_CRG/20120502_FDF_CRG/20120509_FDF_CRG_c12.mtb	723	NA	WWSS	water	2	48835	1336602523	1	0.0599999999999999	0.001875	2880	1
1	Food 1	Intake 3	166	49556	1336603244	/users/cn/jespinosa/phecomp/data/CRG/20120502_FDF_CRG/20120502_FDF_CRG/20120509_FDF_CRG_c12.mtb	1322	418	WWSS	food_sc	3	49390	1336603078	1	0.0399999999999999	0.000240963855421686	2881	1
1	Drink 2	Intake 2	16	49565	1336603253	/users/cn/jespinosa/phecomp/data/CRG/20120502_FDF_CRG/20120502_FDF_CRG/20120509_FDF_CRG_c12.mtb	724	NA	WWSS	water	2	49549	1336603237	1	0.02	0.00125	2882	1
1	Food 1	Intake 3	160	50134	1336603822	/users/cn/jespinosa/phecomp/data/CRG/20120502_FDF_CRG/20120502_FDF_CRG/20120509_FDF_CRG_c12.mtb	1323	4	WWSS	food_sc	3	49974	1336603662	1	0.04	0.00025	2883	1
1	Food 1	Intake 3	80	50218	1336603906	/users/cn/jespinosa/phecomp/data/CRG/20120502_FDF_CRG/20120502_FDF_CRG/20120509_FDF_CRG_c12.mtb	1324	1781	WWSS	food_sc	3	50138	1336603826	1	0.04	0.0005	2884	1
1	Drink 1	Intake 1	46	50254	1336603942	/users/cn/jespinosa/phecomp/data/CRG/20120502_FDF_CRG/20120502_FDF_CRG/20120509_FDF_CRG_c12.mtb	1742	NA	WWSS	water	1	50208	1336603896	1	0.06	0.00130434782608696	2885	1
1	Food 1	Intake 3	74	52073	1336605761	/users/cn/jespinosa/phecomp/data/CRG/20120502_FDF_CRG/20120502_FDF_CRG/20120509_FDF_CRG_c12.mtb	1325	66	WWSS	food_sc	3	51999	1336605687	1	0.02	0.00027027027027027	2886	1
1	Food 1	Intake 3	244	52383	1336606071	/users/cn/jespinosa/phecomp/data/CRG/20120502_FDF_CRG/20120502_FDF_CRG/20120509_FDF_CRG_c12.mtb	1326	934	WWSS	food_sc	3	52139	1336605827	1	0.08	0.000327868852459016	2887	1
1	Drink 2	Intake 2	17	52412	1336606100	/users/cn/jespinosa/phecomp/data/CRG/20120502_FDF_CRG/20120502_FDF_CRG/20120509_FDF_CRG_c12.mtb	725	NA	WWSS	water	2	52395	1336606083	1	0.02	0.00117647058823529	2888	1
1	Drink 1	Intake 1	21	52498	1336606186	/users/cn/jespinosa/phecomp/data/CRG/20120502_FDF_CRG/20120502_FDF_CRG/20120509_FDF_CRG_c12.mtb	1743	NA	WWSS	water	1	52477	1336606165	1	0.02	0.000952380952380952	2889	1
1	Drink 1	Intake 1	23	52709	1336606397	/users/cn/jespinosa/phecomp/data/CRG/20120502_FDF_CRG/20120502_FDF_CRG/20120509_FDF_CRG_c12.mtb	1744	NA	WWSS	water	1	52686	1336606374	1	0.02	0.000869565217391304	2890	1
1	Drink 2	Intake 2	8	53186	1336606874	/users/cn/jespinosa/phecomp/data/CRG/20120502_FDF_CRG/20120502_FDF_CRG/20120509_FDF_CRG_c12.mtb	726	NA	WWSS	water	2	53178	1336606866	1	0.02	0.0025	2891	1
1	Food 1	Intake 3	57	53374	1336607062	/users/cn/jespinosa/phecomp/data/CRG/20120502_FDF_CRG/20120502_FDF_CRG/20120509_FDF_CRG_c12.mtb	1331	17	WWSS	food_sc	3	53317	1336607005	1	0.04	0.000701754385964912	2892	1
1	Food 1	Intake 3	55	53446	1336607134	/users/cn/jespinosa/phecomp/data/CRG/20120502_FDF_CRG/20120502_FDF_CRG/20120509_FDF_CRG_c12.mtb	1332	1189	WWSS	food_sc	3	53391	1336607079	1	0.04	0.000727272727272727	2893	1
1	Drink 2	Intake 2	25	53484	1336607172	/users/cn/jespinosa/phecomp/data/CRG/20120502_FDF_CRG/20120502_FDF_CRG/20120509_FDF_CRG_c12.mtb	727	NA	WWSS	water	2	53459	1336607147	1	0.08	0.0032	2894	1
1	Food 1	Intake 3	44	54679	1336608367	/users/cn/jespinosa/phecomp/data/CRG/20120502_FDF_CRG/20120502_FDF_CRG/20120509_FDF_CRG_c12.mtb	1334	182	WWSS	food_sc	3	54635	1336608323	1	0.02	0.000454545454545455	2895	1
1	Drink 2	Intake 2	19	54737	1336608425	/users/cn/jespinosa/phecomp/data/CRG/20120502_FDF_CRG/20120502_FDF_CRG/20120509_FDF_CRG_c12.mtb	728	NA	WWSS	water	2	54718	1336608406	1	0.02	0.00105263157894737	2896	1
1	Food 2	Intake 4	103	54964	1336608652	/users/cn/jespinosa/phecomp/data/CRG/20120502_FDF_CRG/20120502_FDF_CRG/20120509_FDF_CRG_c12.mtb	1751	48	WWSS	food_sc	4	54861	1336608549	1	0.04	0.000388349514563107	2897	1
1	Drink 2	Intake 2	46	55022	1336608710	/users/cn/jespinosa/phecomp/data/CRG/20120502_FDF_CRG/20120502_FDF_CRG/20120509_FDF_CRG_c12.mtb	729	NA	WWSS	water	2	54976	1336608664	1	0.02	0.000434782608695652	2898	1
1	Food 2	Intake 4	86	55098	1336608786	/users/cn/jespinosa/phecomp/data/CRG/20120502_FDF_CRG/20120502_FDF_CRG/20120509_FDF_CRG_c12.mtb	1752	4650	WWSS	food_sc	4	55012	1336608700	1	0.04	0.000465116279069767	2899	1
1	Drink 2	Intake 2	23	55269	1336608957	/users/cn/jespinosa/phecomp/data/CRG/20120502_FDF_CRG/20120502_FDF_CRG/20120509_FDF_CRG_c12.mtb	730	NA	WWSS	water	2	55246	1336608934	1	0.0600000000000001	0.00260869565217392	2900	1
1	Food 2	Intake 4	67	59815	1336613503	/users/cn/jespinosa/phecomp/data/CRG/20120502_FDF_CRG/20120502_FDF_CRG/20120509_FDF_CRG_c12.mtb	1755	13	WWSS	food_sc	4	59748	1336613436	1	0.0399999999999998	0.000597014925373131	2901	1
1	Food 2	Intake 4	164	59992	1336613680	/users/cn/jespinosa/phecomp/data/CRG/20120502_FDF_CRG/20120502_FDF_CRG/20120509_FDF_CRG_c12.mtb	1756	2366	WWSS	food_sc	4	59828	1336613516	1	0.0600000000000001	0.000365853658536586	2902	1
1	Food 1	Intake 3	21	62379	1336616067	/users/cn/jespinosa/phecomp/data/CRG/20120502_FDF_CRG/20120502_FDF_CRG/20120509_FDF_CRG_c12.mtb	1339	14	WWSS	food_sc	3	62358	1336616046	1	0.02	0.000952380952380952	2903	1
1	Food 2	Intake 4	30	62423	1336616111	/users/cn/jespinosa/phecomp/data/CRG/20120502_FDF_CRG/20120502_FDF_CRG/20120509_FDF_CRG_c12.mtb	1757	26	WWSS	food_sc	4	62393	1336616081	1	0.02	0.000666666666666667	2904	1
1	Food 1	Intake 3	132	62581	1336616269	/users/cn/jespinosa/phecomp/data/CRG/20120502_FDF_CRG/20120502_FDF_CRG/20120509_FDF_CRG_c12.mtb	1340	15	WWSS	food_sc	3	62449	1336616137	1	0.0599999999999998	0.000454545454545453	2905	1
1	Food 1	Intake 3	20	62616	1336616304	/users/cn/jespinosa/phecomp/data/CRG/20120502_FDF_CRG/20120502_FDF_CRG/20120509_FDF_CRG_c12.mtb	1341	22	WWSS	food_sc	3	62596	1336616284	1	0.04	0.002	2906	1
1	Food 1	Intake 3	23	62661	1336616349	/users/cn/jespinosa/phecomp/data/CRG/20120502_FDF_CRG/20120502_FDF_CRG/20120509_FDF_CRG_c12.mtb	1342	73	WWSS	food_sc	3	62638	1336616326	1	0.04	0.00173913043478261	2907	1
1	Food 1	Intake 3	34	62768	1336616456	/users/cn/jespinosa/phecomp/data/CRG/20120502_FDF_CRG/20120502_FDF_CRG/20120509_FDF_CRG_c12.mtb	1343	16	WWSS	food_sc	3	62734	1336616422	1	0.02	0.000588235294117647	2908	1
1	Food 2	Intake 4	159	62943	1336616631	/users/cn/jespinosa/phecomp/data/CRG/20120502_FDF_CRG/20120502_FDF_CRG/20120509_FDF_CRG_c12.mtb	1759	4066	WWSS	food_sc	4	62784	1336616472	1	0.04	0.000251572327044025	2909	1
1	Drink 1	Intake 1	16	62954	1336616642	/users/cn/jespinosa/phecomp/data/CRG/20120502_FDF_CRG/20120502_FDF_CRG/20120509_FDF_CRG_c12.mtb	1751	NA	WWSS	water	1	62938	1336616626	1	0.02	0.00125	2910	1
1	Drink 2	Intake 2	17	62961	1336616649	/users/cn/jespinosa/phecomp/data/CRG/20120502_FDF_CRG/20120502_FDF_CRG/20120509_FDF_CRG_c12.mtb	732	NA	WWSS	water	2	62944	1336616632	1	0.02	0.00117647058823529	2911	1
1	Drink 2	Intake 2	32	63380	1336617068	/users/cn/jespinosa/phecomp/data/CRG/20120502_FDF_CRG/20120502_FDF_CRG/20120509_FDF_CRG_c12.mtb	733	NA	WWSS	water	2	63348	1336617036	1	0.0599999999999998	0.00187499999999999	2912	1
1	Drink 2	Intake 2	20	63830	1336617518	/users/cn/jespinosa/phecomp/data/CRG/20120502_FDF_CRG/20120502_FDF_CRG/20120509_FDF_CRG_c12.mtb	734	NA	WWSS	water	2	63810	1336617498	1	0.0800000000000001	0.00400000000000001	2913	1
1	Food 2	Intake 4	189	67198	1336620886	/users/cn/jespinosa/phecomp/data/CRG/20120502_FDF_CRG/20120502_FDF_CRG/20120509_FDF_CRG_c12.mtb	1761	48	WWSS	food_sc	4	67009	1336620697	1	0.0799999999999998	0.000423280423280422	2914	1
1	Food 2	Intake 4	121	67367	1336621055	/users/cn/jespinosa/phecomp/data/CRG/20120502_FDF_CRG/20120502_FDF_CRG/20120509_FDF_CRG_c12.mtb	1762	1603	WWSS	food_sc	4	67246	1336620934	1	0.02	0.000165289256198347	2915	1
1	Food 2	Intake 4	370	69340	1336623028	/users/cn/jespinosa/phecomp/data/CRG/20120502_FDF_CRG/20120502_FDF_CRG/20120509_FDF_CRG_c12.mtb	1763	190	WWSS	food_sc	4	68970	1336622658	1	0.1	0.00027027027027027	2916	1
1	Drink 2	Intake 2	32	69365	1336623053	/users/cn/jespinosa/phecomp/data/CRG/20120502_FDF_CRG/20120502_FDF_CRG/20120509_FDF_CRG_c12.mtb	735	NA	WWSS	water	2	69333	1336623021	1	0.12	0.00375	2917	1
1	Food 1	Intake 3	172	69702	1336623390	/users/cn/jespinosa/phecomp/data/CRG/20120502_FDF_CRG/20120502_FDF_CRG/20120509_FDF_CRG_c12.mtb	1349	135	WWSS	food_sc	3	69530	1336623218	1	0.0600000000000001	0.000348837209302326	2918	1
1	Drink 2	Intake 2	20	69716	1336623404	/users/cn/jespinosa/phecomp/data/CRG/20120502_FDF_CRG/20120502_FDF_CRG/20120509_FDF_CRG_c12.mtb	736	NA	WWSS	water	2	69696	1336623384	1	0.0600000000000001	0.00300000000000001	2919	1
1	Food 2	Intake 4	112	69949	1336623637	/users/cn/jespinosa/phecomp/data/CRG/20120502_FDF_CRG/20120502_FDF_CRG/20120509_FDF_CRG_c12.mtb	1768	663	WWSS	food_sc	4	69837	1336623525	1	0.04	0.000357142857142857	2920	1
1	Drink 2	Intake 2	27	69967	1336623655	/users/cn/jespinosa/phecomp/data/CRG/20120502_FDF_CRG/20120502_FDF_CRG/20120509_FDF_CRG_c12.mtb	737	NA	WWSS	water	2	69940	1336623628	1	0.0600000000000001	0.00222222222222223	2921	1
1	Drink 1	Intake 1	16	70544	1336624232	/users/cn/jespinosa/phecomp/data/CRG/20120502_FDF_CRG/20120502_FDF_CRG/20120509_FDF_CRG_c12.mtb	1754	NA	WWSS	water	1	70528	1336624216	1	0.02	0.00125	2922	1
1	Food 2	Intake 4	82	70694	1336624382	/users/cn/jespinosa/phecomp/data/CRG/20120502_FDF_CRG/20120502_FDF_CRG/20120509_FDF_CRG_c12.mtb	1770	134	WWSS	food_sc	4	70612	1336624300	1	0.02	0.00024390243902439	2923	1
1	Drink 2	Intake 2	24	70714	1336624402	/users/cn/jespinosa/phecomp/data/CRG/20120502_FDF_CRG/20120502_FDF_CRG/20120509_FDF_CRG_c12.mtb	738	NA	WWSS	water	2	70690	1336624378	1	0.0800000000000001	0.00333333333333334	2924	1
1	Food 2	Intake 4	167	70995	1336624683	/users/cn/jespinosa/phecomp/data/CRG/20120502_FDF_CRG/20120502_FDF_CRG/20120509_FDF_CRG_c12.mtb	1773	169	WWSS	food_sc	4	70828	1336624516	1	0.0600000000000001	0.000359281437125749	2925	1
1	Drink 2	Intake 2	20	71010	1336624698	/users/cn/jespinosa/phecomp/data/CRG/20120502_FDF_CRG/20120502_FDF_CRG/20120509_FDF_CRG_c12.mtb	739	NA	WWSS	water	2	70990	1336624678	1	0.02	0.001	2926	1
1	Food 2	Intake 4	62	71226	1336624914	/users/cn/jespinosa/phecomp/data/CRG/20120502_FDF_CRG/20120502_FDF_CRG/20120509_FDF_CRG_c12.mtb	1775	24	WWSS	food_sc	4	71164	1336624852	1	0.02	0.00032258064516129	2927	1
1	Food 2	Intake 4	102	71352	1336625040	/users/cn/jespinosa/phecomp/data/CRG/20120502_FDF_CRG/20120502_FDF_CRG/20120509_FDF_CRG_c12.mtb	1776	146	WWSS	food_sc	4	71250	1336624938	1	0.04	0.000392156862745098	2928	1
1	Drink 2	Intake 2	25	71379	1336625067	/users/cn/jespinosa/phecomp/data/CRG/20120502_FDF_CRG/20120502_FDF_CRG/20120509_FDF_CRG_c12.mtb	740	NA	WWSS	water	2	71354	1336625042	1	0.04	0.0016	2929	1
1	Food 2	Intake 4	73	71571	1336625259	/users/cn/jespinosa/phecomp/data/CRG/20120502_FDF_CRG/20120502_FDF_CRG/20120509_FDF_CRG_c12.mtb	1778	324	WWSS	food_sc	4	71498	1336625186	1	0.02	0.000273972602739726	2930	1
1	Food 2	Intake 4	80	71975	1336625663	/users/cn/jespinosa/phecomp/data/CRG/20120502_FDF_CRG/20120502_FDF_CRG/20120509_FDF_CRG_c12.mtb	1780	2726	WWSS	food_sc	4	71895	1336625583	1	0.04	0.0005	2931	1
1	Drink 2	Intake 2	27	72401	1336626089	/users/cn/jespinosa/phecomp/data/CRG/20120502_FDF_CRG/20120502_FDF_CRG/20120509_FDF_CRG_c12.mtb	741	NA	WWSS	water	2	72374	1336626062	1	0.0799999999999998	0.00296296296296296	2932	1
1	Food 1	Intake 3	31	74732	1336628420	/users/cn/jespinosa/phecomp/data/CRG/20120502_FDF_CRG/20120502_FDF_CRG/20120509_FDF_CRG_c12.mtb	1362	40	WWSS	food_sc	3	74701	1336628389	1	0.02	0.000645161290322581	2933	1
1	Food 2	Intake 4	45	74817	1336628505	/users/cn/jespinosa/phecomp/data/CRG/20120502_FDF_CRG/20120502_FDF_CRG/20120509_FDF_CRG_c12.mtb	1786	100	WWSS	food_sc	4	74772	1336628460	1	0.04	0.000888888888888889	2934	1
1	Food 2	Intake 4	77	74994	1336628682	/users/cn/jespinosa/phecomp/data/CRG/20120502_FDF_CRG/20120502_FDF_CRG/20120509_FDF_CRG_c12.mtb	1787	168	WWSS	food_sc	4	74917	1336628605	1	0.02	0.00025974025974026	2935	1
1	Drink 1	Intake 1	15	75129	1336628817	/users/cn/jespinosa/phecomp/data/CRG/20120502_FDF_CRG/20120502_FDF_CRG/20120509_FDF_CRG_c12.mtb	1756	NA	WWSS	water	1	75114	1336628802	1	0.04	0.00266666666666667	2936	1
1	Food 2	Intake 4	83	75245	1336628933	/users/cn/jespinosa/phecomp/data/CRG/20120502_FDF_CRG/20120502_FDF_CRG/20120509_FDF_CRG_c12.mtb	1790	532	WWSS	food_sc	4	75162	1336628850	1	0.0600000000000001	0.000722891566265061	2937	1
1	Drink 2	Intake 2	20	75320	1336629008	/users/cn/jespinosa/phecomp/data/CRG/20120502_FDF_CRG/20120502_FDF_CRG/20120509_FDF_CRG_c12.mtb	742	NA	WWSS	water	2	75300	1336628988	1	0.02	0.001	2938	1
1	Food 2	Intake 4	47	75824	1336629512	/users/cn/jespinosa/phecomp/data/CRG/20120502_FDF_CRG/20120502_FDF_CRG/20120509_FDF_CRG_c12.mtb	1792	40	WWSS	food_sc	4	75777	1336629465	1	0.02	0.000425531914893617	2939	1
1	Food 2	Intake 4	99	75963	1336629651	/users/cn/jespinosa/phecomp/data/CRG/20120502_FDF_CRG/20120502_FDF_CRG/20120509_FDF_CRG_c12.mtb	1793	2618	WWSS	food_sc	4	75864	1336629552	1	0.02	0.000202020202020202	2940	1
1	Drink 2	Intake 2	38	76086	1336629774	/users/cn/jespinosa/phecomp/data/CRG/20120502_FDF_CRG/20120502_FDF_CRG/20120509_FDF_CRG_c12.mtb	743	NA	WWSS	water	2	76048	1336629736	1	0.16	0.00421052631578947	2941	1
1	Food 2	Intake 4	17	78598	1336632286	/users/cn/jespinosa/phecomp/data/CRG/20120502_FDF_CRG/20120502_FDF_CRG/20120509_FDF_CRG_c12.mtb	1795	8311	WWSS	food_sc	4	78581	1336632269	1	0.02	0.00117647058823529	2942	1
1	Food 2	Intake 4	37	86946	1336640634	/users/cn/jespinosa/phecomp/data/CRG/20120502_FDF_CRG/20120502_FDF_CRG/20120509_FDF_CRG_c12.mtb	1798	210	WWSS	food_sc	4	86909	1336640597	1	0.02	0.000540540540540541	2943	1
1	Food 2	Intake 4	120	87276	1336640964	/users/cn/jespinosa/phecomp/data/CRG/20120502_FDF_CRG/20120502_FDF_CRG/20120509_FDF_CRG_c12.mtb	1800	445	WWSS	food_sc	4	87156	1336640844	1	0.0600000000000001	0.000500000000000001	2944	1
1	Food 2	Intake 4	57	87778	1336641466	/users/cn/jespinosa/phecomp/data/CRG/20120502_FDF_CRG/20120502_FDF_CRG/20120509_FDF_CRG_c12.mtb	1802	14490	WWSS	food_sc	4	87721	1336641409	1	0.02	0.000350877192982456	2945	1
1	Drink 2	Intake 2	8	87866	1336641554	/users/cn/jespinosa/phecomp/data/CRG/20120502_FDF_CRG/20120502_FDF_CRG/20120509_FDF_CRG_c12.mtb	747	NA	WWSS	water	2	87858	1336641546	1	0.02	0.0025	2946	1
1	Drink 2	Intake 2	18	89236	1336642924	/users/cn/jespinosa/phecomp/data/CRG/20120502_FDF_CRG/20120502_FDF_CRG/20120509_FDF_CRG_c12.mtb	748	NA	WWSS	water	2	89218	1336642906	1	0.0600000000000001	0.00333333333333334	2947	1
1	Food 2	Intake 4	364	102632	1336656320	/users/cn/jespinosa/phecomp/data/CRG/20120502_FDF_CRG/20120502_FDF_CRG/20120509_FDF_CRG_c12.mtb	1807	14	WWSS	food_sc	4	102268	1336655956	1	0.14	0.000384615384615385	2948	1
1	Food 2	Intake 4	123	102769	1336656457	/users/cn/jespinosa/phecomp/data/CRG/20120502_FDF_CRG/20120502_FDF_CRG/20120509_FDF_CRG_c12.mtb	1808	8755	WWSS	food_sc	4	102646	1336656334	1	0.0600000000000001	0.000487804878048781	2949	1
1	Food 2	Intake 4	495	112019	1336665707	/users/cn/jespinosa/phecomp/data/CRG/20120502_FDF_CRG/20120502_FDF_CRG/20120509_FDF_CRG_c12.mtb	1810	7978	WWSS	food_sc	4	111524	1336665212	1	0.16	0.000323232323232323	2950	1
1	Food 2	Intake 4	247	120244	1336673932	/users/cn/jespinosa/phecomp/data/CRG/20120502_FDF_CRG/20120502_FDF_CRG/20120509_FDF_CRG_c12.mtb	1813	88	WWSS	food_sc	4	119997	1336673685	1	0.0800000000000001	0.000323886639676114	2951	1
1	Food 2	Intake 4	56	120388	1336674076	/users/cn/jespinosa/phecomp/data/CRG/20120502_FDF_CRG/20120502_FDF_CRG/20120509_FDF_CRG_c12.mtb	1815	2173	WWSS	food_sc	4	120332	1336674020	1	0.02	0.000357142857142857	2952	1
1	Food 2	Intake 4	644	123205	1336676893	/users/cn/jespinosa/phecomp/data/CRG/20120502_FDF_CRG/20120502_FDF_CRG/20120509_FDF_CRG_c12.mtb	1816	2798	WWSS	food_sc	4	122561	1336676249	1	0.22	0.000341614906832298	2953	1
1	Drink 2	Intake 2	11	123220	1336676908	/users/cn/jespinosa/phecomp/data/CRG/20120502_FDF_CRG/20120502_FDF_CRG/20120509_FDF_CRG_c12.mtb	751	NA	WWSS	water	2	123209	1336676897	1	0.04	0.00363636363636364	2954	1
1	Drink 2	Intake 2	25	124447	1336678135	/users/cn/jespinosa/phecomp/data/CRG/20120502_FDF_CRG/20120502_FDF_CRG/20120509_FDF_CRG_c12.mtb	752	NA	WWSS	water	2	124422	1336678110	1	0.1	0.004	2955	1
1	Food 2	Intake 4	43	126046	1336679734	/users/cn/jespinosa/phecomp/data/CRG/20120502_FDF_CRG/20120502_FDF_CRG/20120509_FDF_CRG_c12.mtb	1818	43	WWSS	food_sc	4	126003	1336679691	1	0.0200000000000005	0.000465116279069779	2956	1
1	Food 1	Intake 3	133	126222	1336679910	/users/cn/jespinosa/phecomp/data/CRG/20120502_FDF_CRG/20120502_FDF_CRG/20120509_FDF_CRG_c12.mtb	1383	7	WWSS	food_sc	3	126089	1336679777	1	0.04	0.000300751879699248	2957	1
1	Food 1	Intake 3	110	126339	1336680027	/users/cn/jespinosa/phecomp/data/CRG/20120502_FDF_CRG/20120502_FDF_CRG/20120509_FDF_CRG_c12.mtb	1384	1423	WWSS	food_sc	3	126229	1336679917	1	0.04	0.000363636363636364	2958	1
1	Food 2	Intake 4	131	127893	1336681581	/users/cn/jespinosa/phecomp/data/CRG/20120502_FDF_CRG/20120502_FDF_CRG/20120509_FDF_CRG_c12.mtb	1825	COLL	WWSS	food_sc	4	127762	1336681450	1	0.04	0.000305343511450382	2959	1
1	Food 1	Intake 3	17	127782	1336681470	/users/cn/jespinosa/phecomp/data/CRG/20120502_FDF_CRG/20120502_FDF_CRG/20120509_FDF_CRG_c12.mtb	1385	115	WWSS	food_sc	3	127765	1336681453	1	0.02	0.00117647058823529	2960	1
1	Food 2	Intake 4	139	128036	1336681724	/users/cn/jespinosa/phecomp/data/CRG/20120502_FDF_CRG/20120502_FDF_CRG/20120509_FDF_CRG_c12.mtb	1826	27	WWSS	food_sc	4	127897	1336681585	1	0.04	0.000287769784172662	2961	1
1	Food 2	Intake 4	96	128159	1336681847	/users/cn/jespinosa/phecomp/data/CRG/20120502_FDF_CRG/20120502_FDF_CRG/20120509_FDF_CRG_c12.mtb	1827	1511	WWSS	food_sc	4	128063	1336681751	1	0.02	0.000208333333333333	2962	1
1	Drink 1	Intake 1	20	128307	1336681995	/users/cn/jespinosa/phecomp/data/CRG/20120502_FDF_CRG/20120502_FDF_CRG/20120509_FDF_CRG_c12.mtb	1764	NA	WWSS	water	1	128287	1336681975	1	0.1	0.005	2963	1
1	Food 2	Intake 4	322	129992	1336683680	/users/cn/jespinosa/phecomp/data/CRG/20120502_FDF_CRG/20120502_FDF_CRG/20120509_FDF_CRG_c12.mtb	1829	78	WWSS	food_sc	4	129670	1336683358	1	0.0600000000000001	0.000186335403726708	2964	1
1	Food 1	Intake 3	266	130336	1336684024	/users/cn/jespinosa/phecomp/data/CRG/20120502_FDF_CRG/20120502_FDF_CRG/20120509_FDF_CRG_c12.mtb	1387	5	WWSS	food_sc	3	130070	1336683758	1	0.1	0.00037593984962406	2965	1
1	Food 1	Intake 3	158	130499	1336684187	/users/cn/jespinosa/phecomp/data/CRG/20120502_FDF_CRG/20120502_FDF_CRG/20120509_FDF_CRG_c12.mtb	1388	125	WWSS	food_sc	3	130341	1336684029	1	0.1	0.000632911392405063	2966	1
1	Drink 2	Intake 2	33	130547	1336684235	/users/cn/jespinosa/phecomp/data/CRG/20120502_FDF_CRG/20120502_FDF_CRG/20120509_FDF_CRG_c12.mtb	753	NA	WWSS	water	2	130514	1336684202	1	0.12	0.00363636363636364	2967	1
1	Food 1	Intake 3	104	130728	1336684416	/users/cn/jespinosa/phecomp/data/CRG/20120502_FDF_CRG/20120502_FDF_CRG/20120509_FDF_CRG_c12.mtb	1390	2578	WWSS	food_sc	3	130624	1336684312	1	0.0399999999999998	0.000384615384615383	2968	1
1	Drink 2	Intake 2	20	130742	1336684430	/users/cn/jespinosa/phecomp/data/CRG/20120502_FDF_CRG/20120502_FDF_CRG/20120509_FDF_CRG_c12.mtb	754	NA	WWSS	water	2	130722	1336684410	1	0.04	0.002	2969	1
1	Drink 2	Intake 2	18	131038	1336684726	/users/cn/jespinosa/phecomp/data/CRG/20120502_FDF_CRG/20120502_FDF_CRG/20120509_FDF_CRG_c12.mtb	755	NA	WWSS	water	2	131020	1336684708	1	0.0399999999999996	0.0022222222222222	2970	1
1	Food 1	Intake 3	387	133693	1336687381	/users/cn/jespinosa/phecomp/data/CRG/20120502_FDF_CRG/20120502_FDF_CRG/20120509_FDF_CRG_c12.mtb	1392	491	WWSS	food_sc	3	133306	1336686994	1	0.2	0.000516795865633075	2971	1
1	Drink 2	Intake 2	19	133709	1336687397	/users/cn/jespinosa/phecomp/data/CRG/20120502_FDF_CRG/20120502_FDF_CRG/20120509_FDF_CRG_c12.mtb	756	NA	WWSS	water	2	133690	1336687378	1	0.04	0.00210526315789474	2972	1
1	Food 1	Intake 3	65	134249	1336687937	/users/cn/jespinosa/phecomp/data/CRG/20120502_FDF_CRG/20120502_FDF_CRG/20120509_FDF_CRG_c12.mtb	1397	COLL	WWSS	food_sc	3	134184	1336687872	1	0.02	0.000307692307692308	2973	1
1	Food 2	Intake 4	172	134408	1336688096	/users/cn/jespinosa/phecomp/data/CRG/20120502_FDF_CRG/20120502_FDF_CRG/20120509_FDF_CRG_c12.mtb	1837	34	WWSS	food_sc	4	134236	1336687924	1	0.02	0.000116279069767442	2974	1
1	Drink 1	Intake 1	44	134446	1336688134	/users/cn/jespinosa/phecomp/data/CRG/20120502_FDF_CRG/20120502_FDF_CRG/20120509_FDF_CRG_c12.mtb	1765	NA	WWSS	water	1	134402	1336688090	1	0.14	0.00318181818181818	2975	1
1	Food 2	Intake 4	110	134552	1336688240	/users/cn/jespinosa/phecomp/data/CRG/20120502_FDF_CRG/20120502_FDF_CRG/20120509_FDF_CRG_c12.mtb	1838	307	WWSS	food_sc	4	134442	1336688130	1	0.02	0.000181818181818182	2976	1
1	Food 2	Intake 4	57	134916	1336688604	/users/cn/jespinosa/phecomp/data/CRG/20120502_FDF_CRG/20120502_FDF_CRG/20120509_FDF_CRG_c12.mtb	1840	5	WWSS	food_sc	4	134859	1336688547	1	0.0600000000000001	0.00105263157894737	2977	1
1	Food 2	Intake 4	93	135014	1336688702	/users/cn/jespinosa/phecomp/data/CRG/20120502_FDF_CRG/20120502_FDF_CRG/20120509_FDF_CRG_c12.mtb	1841	218	WWSS	food_sc	4	134921	1336688609	1	0.04	0.00043010752688172	2978	1
1	Drink 1	Intake 1	32	135044	1336688732	/users/cn/jespinosa/phecomp/data/CRG/20120502_FDF_CRG/20120502_FDF_CRG/20120509_FDF_CRG_c12.mtb	1767	NA	WWSS	water	1	135012	1336688700	1	0.0800000000000001	0.0025	2979	1
1	Food 2	Intake 4	149	135381	1336689069	/users/cn/jespinosa/phecomp/data/CRG/20120502_FDF_CRG/20120502_FDF_CRG/20120509_FDF_CRG_c12.mtb	1845	904	WWSS	food_sc	4	135232	1336688920	1	0.04	0.000268456375838926	2980	1
1	Drink 2	Intake 2	18	135629	1336689317	/users/cn/jespinosa/phecomp/data/CRG/20120502_FDF_CRG/20120502_FDF_CRG/20120509_FDF_CRG_c12.mtb	758	NA	WWSS	water	2	135611	1336689299	1	0.02	0.00111111111111111	2981	1
1	Food 2	Intake 4	145	136430	1336690118	/users/cn/jespinosa/phecomp/data/CRG/20120502_FDF_CRG/20120502_FDF_CRG/20120509_FDF_CRG_c12.mtb	1850	173	WWSS	food_sc	4	136285	1336689973	1	0.04	0.000275862068965517	2982	1
1	Drink 2	Intake 2	21	136442	1336690130	/users/cn/jespinosa/phecomp/data/CRG/20120502_FDF_CRG/20120502_FDF_CRG/20120509_FDF_CRG_c12.mtb	760	NA	WWSS	water	2	136421	1336690109	1	0.0800000000000001	0.00380952380952381	2983	1
1	Food 1	Intake 3	52	136655	1336690343	/users/cn/jespinosa/phecomp/data/CRG/20120502_FDF_CRG/20120502_FDF_CRG/20120509_FDF_CRG_c12.mtb	1409	67	WWSS	food_sc	3	136603	1336690291	1	0.04	0.000769230769230769	2984	1
1	Food 1	Intake 3	120	136842	1336690530	/users/cn/jespinosa/phecomp/data/CRG/20120502_FDF_CRG/20120502_FDF_CRG/20120509_FDF_CRG_c12.mtb	1410	COLL	WWSS	food_sc	3	136722	1336690410	1	0.02	0.000166666666666667	2985	1
1	Food 2	Intake 4	18	136770	1336690458	/users/cn/jespinosa/phecomp/data/CRG/20120502_FDF_CRG/20120502_FDF_CRG/20120509_FDF_CRG_c12.mtb	1851	5210	WWSS	food_sc	4	136752	1336690440	1	0.02	0.00111111111111111	2986	1
1	Drink 2	Intake 2	24	137114	1336690802	/users/cn/jespinosa/phecomp/data/CRG/20120502_FDF_CRG/20120502_FDF_CRG/20120509_FDF_CRG_c12.mtb	761	NA	WWSS	water	2	137090	1336690778	1	0.04	0.00166666666666667	2987	1
1	Food 1	Intake 3	118	142098	1336695786	/users/cn/jespinosa/phecomp/data/CRG/20120502_FDF_CRG/20120502_FDF_CRG/20120509_FDF_CRG_c12.mtb	1412	28	WWSS	food_sc	3	141980	1336695668	1	0.04	0.000338983050847458	2988	1
1	Food 1	Intake 3	332	142458	1336696146	/users/cn/jespinosa/phecomp/data/CRG/20120502_FDF_CRG/20120502_FDF_CRG/20120509_FDF_CRG_c12.mtb	1413	101	WWSS	food_sc	3	142126	1336695814	1	0.12	0.00036144578313253	2989	1
1	Drink 2	Intake 2	27	142479	1336696167	/users/cn/jespinosa/phecomp/data/CRG/20120502_FDF_CRG/20120502_FDF_CRG/20120509_FDF_CRG_c12.mtb	762	NA	WWSS	water	2	142452	1336696140	1	0.0800000000000001	0.00296296296296297	2990	1
1	Food 1	Intake 3	105	142664	1336696352	/users/cn/jespinosa/phecomp/data/CRG/20120502_FDF_CRG/20120502_FDF_CRG/20120509_FDF_CRG_c12.mtb	1414	20	WWSS	food_sc	3	142559	1336696247	1	0.02	0.00019047619047619	2991	1
1	Food 1	Intake 3	136	142820	1336696508	/users/cn/jespinosa/phecomp/data/CRG/20120502_FDF_CRG/20120502_FDF_CRG/20120509_FDF_CRG_c12.mtb	1415	2879	WWSS	food_sc	3	142684	1336696372	1	0.0600000000000001	0.000441176470588236	2992	1
1	Drink 2	Intake 2	18	142847	1336696535	/users/cn/jespinosa/phecomp/data/CRG/20120502_FDF_CRG/20120502_FDF_CRG/20120509_FDF_CRG_c12.mtb	763	NA	WWSS	water	2	142829	1336696517	1	0.02	0.00111111111111111	2993	1
1	Food 1	Intake 3	85	145784	1336699472	/users/cn/jespinosa/phecomp/data/CRG/20120502_FDF_CRG/20120502_FDF_CRG/20120509_FDF_CRG_c12.mtb	1417	112	WWSS	food_sc	3	145699	1336699387	1	0.04	0.000470588235294118	2994	1
1	Food 1	Intake 3	73	145969	1336699657	/users/cn/jespinosa/phecomp/data/CRG/20120502_FDF_CRG/20120502_FDF_CRG/20120509_FDF_CRG_c12.mtb	1418	7	WWSS	food_sc	3	145896	1336699584	1	0.04	0.000547945205479452	2995	1
1	Food 1	Intake 3	77	146053	1336699741	/users/cn/jespinosa/phecomp/data/CRG/20120502_FDF_CRG/20120502_FDF_CRG/20120509_FDF_CRG_c12.mtb	1419	185	WWSS	food_sc	3	145976	1336699664	1	0.04	0.000519480519480519	2996	1
1	Drink 2	Intake 2	33	146081	1336699769	/users/cn/jespinosa/phecomp/data/CRG/20120502_FDF_CRG/20120502_FDF_CRG/20120509_FDF_CRG_c12.mtb	765	NA	WWSS	water	2	146048	1336699736	1	0.0800000000000001	0.00242424242424243	2997	1
1	Food 2	Intake 4	36	146274	1336699962	/users/cn/jespinosa/phecomp/data/CRG/20120502_FDF_CRG/20120502_FDF_CRG/20120509_FDF_CRG_c12.mtb	1870	52	WWSS	food_sc	4	146238	1336699926	1	0.02	0.000555555555555556	2998	1
1	Food 1	Intake 3	95	146421	1336700109	/users/cn/jespinosa/phecomp/data/CRG/20120502_FDF_CRG/20120502_FDF_CRG/20120509_FDF_CRG_c12.mtb	1423	COLL	WWSS	food_sc	3	146326	1336700014	1	0.02	0.000210526315789474	2999	1
1	Food 2	Intake 4	21	146436	1336700124	/users/cn/jespinosa/phecomp/data/CRG/20120502_FDF_CRG/20120502_FDF_CRG/20120509_FDF_CRG_c12.mtb	1872	735	WWSS	food_sc	4	146415	1336700103	1	0.02	0.000952380952380952	3000	1
1	Drink 2	Intake 2	21	146453	1336700141	/users/cn/jespinosa/phecomp/data/CRG/20120502_FDF_CRG/20120502_FDF_CRG/20120509_FDF_CRG_c12.mtb	767	NA	WWSS	water	2	146432	1336700120	1	0.0399999999999996	0.00190476190476189	3001	1
1	Drink 2	Intake 2	34	147034	1336700722	/users/cn/jespinosa/phecomp/data/CRG/20120502_FDF_CRG/20120502_FDF_CRG/20120509_FDF_CRG_c12.mtb	768	NA	WWSS	water	2	147000	1336700688	1	0.12	0.00352941176470588	3002	1
1	Food 1	Intake 3	144	147315	1336701003	/users/cn/jespinosa/phecomp/data/CRG/20120502_FDF_CRG/20120502_FDF_CRG/20120509_FDF_CRG_c12.mtb	1427	70	WWSS	food_sc	3	147171	1336700859	1	0.0600000000000001	0.000416666666666667	3003	1
1	Food 1	Intake 3	197	147582	1336701270	/users/cn/jespinosa/phecomp/data/CRG/20120502_FDF_CRG/20120502_FDF_CRG/20120509_FDF_CRG_c12.mtb	1428	525	WWSS	food_sc	3	147385	1336701073	1	0.0600000000000001	0.000304568527918782	3004	1
1	Drink 2	Intake 2	20	147596	1336701284	/users/cn/jespinosa/phecomp/data/CRG/20120502_FDF_CRG/20120502_FDF_CRG/20120509_FDF_CRG_c12.mtb	769	NA	WWSS	water	2	147576	1336701264	1	0.0600000000000001	0.00300000000000001	3005	1
1	Drink 2	Intake 2	21	147985	1336701673	/users/cn/jespinosa/phecomp/data/CRG/20120502_FDF_CRG/20120502_FDF_CRG/20120509_FDF_CRG_c12.mtb	770	NA	WWSS	water	2	147964	1336701652	1	0.02	0.000952380952380952	3006	1
1	Food 1	Intake 3	134	148241	1336701929	/users/cn/jespinosa/phecomp/data/CRG/20120502_FDF_CRG/20120502_FDF_CRG/20120509_FDF_CRG_c12.mtb	1430	3796	WWSS	food_sc	3	148107	1336701795	1	0.04	0.000298507462686567	3007	1
1	Drink 2	Intake 2	27	148264	1336701952	/users/cn/jespinosa/phecomp/data/CRG/20120502_FDF_CRG/20120502_FDF_CRG/20120509_FDF_CRG_c12.mtb	772	NA	WWSS	water	2	148237	1336701925	1	0.0600000000000001	0.00222222222222223	3008	1
1	Food 1	Intake 3	77	152114	1336705802	/users/cn/jespinosa/phecomp/data/CRG/20120502_FDF_CRG/20120502_FDF_CRG/20120509_FDF_CRG_c12.mtb	1431	128	WWSS	food_sc	3	152037	1336705725	1	0.04	0.000519480519480519	3009	1
1	Food 1	Intake 3	91	152333	1336706021	/users/cn/jespinosa/phecomp/data/CRG/20120502_FDF_CRG/20120502_FDF_CRG/20120509_FDF_CRG_c12.mtb	1433	76	WWSS	food_sc	3	152242	1336705930	1	0.0600000000000001	0.00065934065934066	3010	1
1	Food 1	Intake 3	49	152458	1336706146	/users/cn/jespinosa/phecomp/data/CRG/20120502_FDF_CRG/20120502_FDF_CRG/20120509_FDF_CRG_c12.mtb	1435	122	WWSS	food_sc	3	152409	1336706097	1	0.02	0.000408163265306122	3011	1
1	Drink 2	Intake 2	29	152540	1336706228	/users/cn/jespinosa/phecomp/data/CRG/20120502_FDF_CRG/20120502_FDF_CRG/20120509_FDF_CRG_c12.mtb	775	NA	WWSS	water	2	152511	1336706199	1	0.1	0.00344827586206897	3012	1
1	Food 1	Intake 3	70	152650	1336706338	/users/cn/jespinosa/phecomp/data/CRG/20120502_FDF_CRG/20120502_FDF_CRG/20120509_FDF_CRG_c12.mtb	1436	17	WWSS	food_sc	3	152580	1336706268	1	0.02	0.000285714285714286	3013	1
1	Food 1	Intake 3	115	152782	1336706470	/users/cn/jespinosa/phecomp/data/CRG/20120502_FDF_CRG/20120502_FDF_CRG/20120509_FDF_CRG_c12.mtb	1437	32	WWSS	food_sc	3	152667	1336706355	1	0.04	0.000347826086956522	3014	1
1	Food 2	Intake 4	107	152921	1336706609	/users/cn/jespinosa/phecomp/data/CRG/20120502_FDF_CRG/20120502_FDF_CRG/20120509_FDF_CRG_c12.mtb	1889	342	WWSS	food_sc	4	152814	1336706502	1	0.04	0.000373831775700935	3015	1
1	Drink 2	Intake 2	24	152937	1336706625	/users/cn/jespinosa/phecomp/data/CRG/20120502_FDF_CRG/20120502_FDF_CRG/20120509_FDF_CRG_c12.mtb	777	NA	WWSS	water	2	152913	1336706601	1	0.0600000000000001	0.0025	3016	1
1	Food 2	Intake 4	113	153376	1336707064	/users/cn/jespinosa/phecomp/data/CRG/20120502_FDF_CRG/20120502_FDF_CRG/20120509_FDF_CRG_c12.mtb	1891	38	WWSS	food_sc	4	153263	1336706951	1	0.0599999999999996	0.00053097345132743	3017	1
1	Food 2	Intake 4	70	153484	1336707172	/users/cn/jespinosa/phecomp/data/CRG/20120502_FDF_CRG/20120502_FDF_CRG/20120509_FDF_CRG_c12.mtb	1892	107	WWSS	food_sc	4	153414	1336707102	1	0.02	0.000285714285714286	3018	1
1	Drink 2	Intake 2	31	153520	1336707208	/users/cn/jespinosa/phecomp/data/CRG/20120502_FDF_CRG/20120502_FDF_CRG/20120509_FDF_CRG_c12.mtb	778	NA	WWSS	water	2	153489	1336707177	1	0.1	0.0032258064516129	3019	1
1	Food 1	Intake 3	102	153693	1336707381	/users/cn/jespinosa/phecomp/data/CRG/20120502_FDF_CRG/20120502_FDF_CRG/20120509_FDF_CRG_c12.mtb	1444	214	WWSS	food_sc	3	153591	1336707279	1	0.04	0.000392156862745098	3020	1
1	Food 2	Intake 4	31	153938	1336707626	/users/cn/jespinosa/phecomp/data/CRG/20120502_FDF_CRG/20120502_FDF_CRG/20120509_FDF_CRG_c12.mtb	1897	2822	WWSS	food_sc	4	153907	1336707595	1	0.02	0.000645161290322581	3021	1
1	Drink 2	Intake 2	23	154061	1336707749	/users/cn/jespinosa/phecomp/data/CRG/20120502_FDF_CRG/20120502_FDF_CRG/20120509_FDF_CRG_c12.mtb	779	NA	WWSS	water	2	154038	1336707726	1	0.04	0.00173913043478261	3022	1
1	Food 1	Intake 3	109	156869	1336710557	/users/cn/jespinosa/phecomp/data/CRG/20120502_FDF_CRG/20120502_FDF_CRG/20120509_FDF_CRG_c12.mtb	1451	98	WWSS	food_sc	3	156760	1336710448	1	0.02	0.00018348623853211	3023	1
1	Food 1	Intake 3	165	157132	1336710820	/users/cn/jespinosa/phecomp/data/CRG/20120502_FDF_CRG/20120502_FDF_CRG/20120509_FDF_CRG_c12.mtb	1452	104	WWSS	food_sc	3	156967	1336710655	1	0.0600000000000001	0.000363636363636364	3024	1
1	Drink 1	Intake 1	18	157188	1336710876	/users/cn/jespinosa/phecomp/data/CRG/20120502_FDF_CRG/20120502_FDF_CRG/20120509_FDF_CRG_c12.mtb	1773	NA	WWSS	water	1	157170	1336710858	1	0.0599999999999999	0.00333333333333333	3025	1
1	Food 1	Intake 3	225	157461	1336711149	/users/cn/jespinosa/phecomp/data/CRG/20120502_FDF_CRG/20120502_FDF_CRG/20120509_FDF_CRG_c12.mtb	1453	674	WWSS	food_sc	3	157236	1336710924	1	0.0600000000000001	0.000266666666666667	3026	1
1	Drink 2	Intake 2	15	157486	1336711174	/users/cn/jespinosa/phecomp/data/CRG/20120502_FDF_CRG/20120502_FDF_CRG/20120509_FDF_CRG_c12.mtb	781	NA	WWSS	water	2	157471	1336711159	1	0.04	0.00266666666666667	3027	1
1	Food 2	Intake 4	60	158195	1336711883	/users/cn/jespinosa/phecomp/data/CRG/20120502_FDF_CRG/20120502_FDF_CRG/20120509_FDF_CRG_c12.mtb	1910	15	WWSS	food_sc	4	158135	1336711823	1	0.02	0.000333333333333333	3028	1
1	Food 2	Intake 4	183	158393	1336712081	/users/cn/jespinosa/phecomp/data/CRG/20120502_FDF_CRG/20120502_FDF_CRG/20120509_FDF_CRG_c12.mtb	1911	143	WWSS	food_sc	4	158210	1336711898	1	0.0800000000000001	0.000437158469945356	3029	1
1	Drink 2	Intake 2	22	158412	1336712100	/users/cn/jespinosa/phecomp/data/CRG/20120502_FDF_CRG/20120502_FDF_CRG/20120509_FDF_CRG_c12.mtb	782	NA	WWSS	water	2	158390	1336712078	1	0.0600000000000001	0.00272727272727273	3030	1
1	Food 2	Intake 4	231	158767	1336712455	/users/cn/jespinosa/phecomp/data/CRG/20120502_FDF_CRG/20120502_FDF_CRG/20120509_FDF_CRG_c12.mtb	1912	341	WWSS	food_sc	4	158536	1336712224	1	0.04	0.000173160173160173	3031	1
1	Drink 2	Intake 2	23	158784	1336712472	/users/cn/jespinosa/phecomp/data/CRG/20120502_FDF_CRG/20120502_FDF_CRG/20120509_FDF_CRG_c12.mtb	783	NA	WWSS	water	2	158761	1336712449	1	0.0600000000000001	0.00260869565217392	3032	1
1	Drink 2	Intake 2	20	159014	1336712702	/users/cn/jespinosa/phecomp/data/CRG/20120502_FDF_CRG/20120502_FDF_CRG/20120509_FDF_CRG_c12.mtb	784	NA	WWSS	water	2	158994	1336712682	1	0.02	0.001	3033	1
1	Food 2	Intake 4	181	159289	1336712977	/users/cn/jespinosa/phecomp/data/CRG/20120502_FDF_CRG/20120502_FDF_CRG/20120509_FDF_CRG_c12.mtb	1914	56	WWSS	food_sc	4	159108	1336712796	1	0.02	0.000110497237569061	3034	1
1	Food 2	Intake 4	163	159508	1336713196	/users/cn/jespinosa/phecomp/data/CRG/20120502_FDF_CRG/20120502_FDF_CRG/20120509_FDF_CRG_c12.mtb	1915	363	WWSS	food_sc	4	159345	1336713033	1	0.02	0.000122699386503067	3035	1
1	Drink 2	Intake 2	23	159526	1336713214	/users/cn/jespinosa/phecomp/data/CRG/20120502_FDF_CRG/20120502_FDF_CRG/20120509_FDF_CRG_c12.mtb	786	NA	WWSS	water	2	159503	1336713191	1	0.0600000000000001	0.00260869565217392	3036	1
1	Food 1	Intake 3	52	159923	1336713611	/users/cn/jespinosa/phecomp/data/CRG/20120502_FDF_CRG/20120502_FDF_CRG/20120509_FDF_CRG_c12.mtb	1465	248	WWSS	food_sc	3	159871	1336713559	1	0.02	0.000384615384615385	3037	1
1	Food 2	Intake 4	131	160302	1336713990	/users/cn/jespinosa/phecomp/data/CRG/20120502_FDF_CRG/20120502_FDF_CRG/20120509_FDF_CRG_c12.mtb	1920	407	WWSS	food_sc	4	160171	1336713859	1	0.04	0.000305343511450382	3038	1
1	Drink 2	Intake 2	38	160330	1336714018	/users/cn/jespinosa/phecomp/data/CRG/20120502_FDF_CRG/20120502_FDF_CRG/20120509_FDF_CRG_c12.mtb	788	NA	WWSS	water	2	160292	1336713980	1	0.0600000000000001	0.00157894736842106	3039	1
1	Food 2	Intake 4	205	160914	1336714602	/users/cn/jespinosa/phecomp/data/CRG/20120502_FDF_CRG/20120502_FDF_CRG/20120509_FDF_CRG_c12.mtb	1921	149	WWSS	food_sc	4	160709	1336714397	1	0.0600000000000001	0.000292682926829269	3040	1
1	Food 2	Intake 4	115	161178	1336714866	/users/cn/jespinosa/phecomp/data/CRG/20120502_FDF_CRG/20120502_FDF_CRG/20120509_FDF_CRG_c12.mtb	1923	267	WWSS	food_sc	4	161063	1336714751	1	0.04	0.000347826086956522	3041	1
1	Drink 2	Intake 2	36	161206	1336714894	/users/cn/jespinosa/phecomp/data/CRG/20120502_FDF_CRG/20120502_FDF_CRG/20120509_FDF_CRG_c12.mtb	789	NA	WWSS	water	2	161170	1336714858	1	0.1	0.00277777777777778	3042	1
1	Food 2	Intake 4	326	161771	1336715459	/users/cn/jespinosa/phecomp/data/CRG/20120502_FDF_CRG/20120502_FDF_CRG/20120509_FDF_CRG_c12.mtb	1924	28	WWSS	food_sc	4	161445	1336715133	1	0.04	0.000122699386503067	3043	1
1	Food 2	Intake 4	147	161946	1336715634	/users/cn/jespinosa/phecomp/data/CRG/20120502_FDF_CRG/20120502_FDF_CRG/20120509_FDF_CRG_c12.mtb	1925	119	WWSS	food_sc	4	161799	1336715487	1	0.04	0.000272108843537415	3044	1
1	Food 2	Intake 4	285	162350	1336716038	/users/cn/jespinosa/phecomp/data/CRG/20120502_FDF_CRG/20120502_FDF_CRG/20120509_FDF_CRG_c12.mtb	1927	189	WWSS	food_sc	4	162065	1336715753	1	0.0200000000000005	7.0175438596493e-05	3045	1
1	Drink 2	Intake 2	16	162539	1336716227	/users/cn/jespinosa/phecomp/data/CRG/20120502_FDF_CRG/20120502_FDF_CRG/20120509_FDF_CRG_c12.mtb	791	NA	WWSS	water	2	162523	1336716211	1	0.0200000000000005	0.00125000000000003	3046	1
1	Food 2	Intake 4	347	162886	1336716574	/users/cn/jespinosa/phecomp/data/CRG/20120502_FDF_CRG/20120502_FDF_CRG/20120509_FDF_CRG_c12.mtb	1929	251	WWSS	food_sc	4	162539	1336716227	1	0.0599999999999996	0.000172910662824206	3047	1
1	Drink 2	Intake 2	24	162906	1336716594	/users/cn/jespinosa/phecomp/data/CRG/20120502_FDF_CRG/20120502_FDF_CRG/20120509_FDF_CRG_c12.mtb	792	NA	WWSS	water	2	162882	1336716570	1	0.04	0.00166666666666667	3048	1
1	Drink 2	Intake 2	33	162985	1336716673	/users/cn/jespinosa/phecomp/data/CRG/20120502_FDF_CRG/20120502_FDF_CRG/20120509_FDF_CRG_c12.mtb	793	NA	WWSS	water	2	162952	1336716640	1	0.0799999999999996	0.00242424242424241	3049	1
1	Food 2	Intake 4	295	163432	1336717120	/users/cn/jespinosa/phecomp/data/CRG/20120502_FDF_CRG/20120502_FDF_CRG/20120509_FDF_CRG_c12.mtb	1930	4675	WWSS	food_sc	4	163137	1336716825	1	0.04	0.000135593220338983	3050	1
1	Food 2	Intake 4	25	168132	1336721820	/users/cn/jespinosa/phecomp/data/CRG/20120502_FDF_CRG/20120502_FDF_CRG/20120509_FDF_CRG_c12.mtb	1931	9	WWSS	food_sc	4	168107	1336721795	1	0.02	0.0008	3051	1
1	Food 2	Intake 4	29	168170	1336721858	/users/cn/jespinosa/phecomp/data/CRG/20120502_FDF_CRG/20120502_FDF_CRG/20120509_FDF_CRG_c12.mtb	1932	30	WWSS	food_sc	4	168141	1336721829	1	0.02	0.000689655172413793	3052	1
1	Food 2	Intake 4	23	168223	1336721911	/users/cn/jespinosa/phecomp/data/CRG/20120502_FDF_CRG/20120502_FDF_CRG/20120509_FDF_CRG_c12.mtb	1933	32	WWSS	food_sc	4	168200	1336721888	1	0.02	0.000869565217391304	3053	1
1	Food 2	Intake 4	28	168283	1336721971	/users/cn/jespinosa/phecomp/data/CRG/20120502_FDF_CRG/20120502_FDF_CRG/20120509_FDF_CRG_c12.mtb	1934	15635	WWSS	food_sc	4	168255	1336721943	1	0.02	0.000714285714285714	3054	1
1	Drink 1	Intake 1	28	168980	1336722668	/users/cn/jespinosa/phecomp/data/CRG/20120502_FDF_CRG/20120502_FDF_CRG/20120509_FDF_CRG_c12.mtb	1782	NA	WWSS	water	1	168952	1336722640	1	0.02	0.000714285714285714	3055	1
1	Drink 1	Intake 1	33	542	1336731407	/users/cn/jespinosa/phecomp/data/CRG/20120502_FDF_CRG/20120502_FDF_CRG/20120511_FDF_CRG_c12.mtb	1936	NA	WWSS	water	1	509	1336731374	1	0.02	0.000606060606060606	3056	1
1	Food 1	Intake 3	71	6812	1336737677	/users/cn/jespinosa/phecomp/data/CRG/20120502_FDF_CRG/20120502_FDF_CRG/20120511_FDF_CRG_c12.mtb	1581	26	WWSS	food_sc	3	6741	1336737606	1	0.06	0.000845070422535211	3057	1
1	Food 1	Intake 3	38	6876	1336737741	/users/cn/jespinosa/phecomp/data/CRG/20120502_FDF_CRG/20120502_FDF_CRG/20120511_FDF_CRG_c12.mtb	1582	192	WWSS	food_sc	3	6838	1336737703	1	0.04	0.00105263157894737	3058	1
1	Food 2	Intake 4	30	7098	1336737963	/users/cn/jespinosa/phecomp/data/CRG/20120502_FDF_CRG/20120502_FDF_CRG/20120511_FDF_CRG_c12.mtb	2207	1192	WWSS	food_sc	4	7068	1336737933	1	0.02	0.000666666666666667	3059	1
1	Food 2	Intake 4	24	8314	1336739179	/users/cn/jespinosa/phecomp/data/CRG/20120502_FDF_CRG/20120502_FDF_CRG/20120511_FDF_CRG_c12.mtb	2208	COLL	WWSS	food_sc	4	8290	1336739155	1	0.02	0.000833333333333333	3060	1
1	Food 1	Intake 3	154	8457	1336739322	/users/cn/jespinosa/phecomp/data/CRG/20120502_FDF_CRG/20120502_FDF_CRG/20120511_FDF_CRG_c12.mtb	1583	1408	WWSS	food_sc	3	8303	1336739168	1	0.08	0.000519480519480519	3061	1
1	Drink 2	Intake 2	21	8478	1336739343	/users/cn/jespinosa/phecomp/data/CRG/20120502_FDF_CRG/20120502_FDF_CRG/20120511_FDF_CRG_c12.mtb	860	NA	WWSS	water	2	8457	1336739322	1	0.04	0.0019047619047619	3062	1
1	Food 1	Intake 3	73	9938	1336740803	/users/cn/jespinosa/phecomp/data/CRG/20120502_FDF_CRG/20120502_FDF_CRG/20120511_FDF_CRG_c12.mtb	1584	7824	WWSS	food_sc	3	9865	1336740730	1	0.02	0.000273972602739726	3063	1
1	Drink 2	Intake 2	30	10147	1336741012	/users/cn/jespinosa/phecomp/data/CRG/20120502_FDF_CRG/20120502_FDF_CRG/20120511_FDF_CRG_c12.mtb	861	NA	WWSS	water	2	10117	1336740982	1	0.02	0.000666666666666667	3064	1
1	Drink 2	Intake 2	17	10436	1336741301	/users/cn/jespinosa/phecomp/data/CRG/20120502_FDF_CRG/20120502_FDF_CRG/20120511_FDF_CRG_c12.mtb	862	NA	WWSS	water	2	10419	1336741284	1	0.04	0.00235294117647059	3065	1
1	Drink 2	Intake 2	22	10496	1336741361	/users/cn/jespinosa/phecomp/data/CRG/20120502_FDF_CRG/20120502_FDF_CRG/20120511_FDF_CRG_c12.mtb	863	NA	WWSS	water	2	10474	1336741339	1	0.02	0.000909090909090909	3066	1
1	Drink 2	Intake 2	16	10545	1336741410	/users/cn/jespinosa/phecomp/data/CRG/20120502_FDF_CRG/20120502_FDF_CRG/20120511_FDF_CRG_c12.mtb	864	NA	WWSS	water	2	10529	1336741394	1	0.02	0.00125	3067	1
1	Food 2	Intake 4	16	17778	1336748643	/users/cn/jespinosa/phecomp/data/CRG/20120502_FDF_CRG/20120502_FDF_CRG/20120511_FDF_CRG_c12.mtb	2210	22	WWSS	food_sc	4	17762	1336748627	1	0.02	0.00125	3068	1
1	Food 2	Intake 4	9	17809	1336748674	/users/cn/jespinosa/phecomp/data/CRG/20120502_FDF_CRG/20120502_FDF_CRG/20120511_FDF_CRG_c12.mtb	2211	17	WWSS	food_sc	4	17800	1336748665	1	0.02	0.00222222222222222	3069	1
1	Food 2	Intake 4	72	17898	1336748763	/users/cn/jespinosa/phecomp/data/CRG/20120502_FDF_CRG/20120502_FDF_CRG/20120511_FDF_CRG_c12.mtb	2212	25	WWSS	food_sc	4	17826	1336748691	1	0.08	0.00111111111111111	3070	1
1	Food 2	Intake 4	36	17959	1336748824	/users/cn/jespinosa/phecomp/data/CRG/20120502_FDF_CRG/20120502_FDF_CRG/20120511_FDF_CRG_c12.mtb	2213	6824	WWSS	food_sc	4	17923	1336748788	1	0.02	0.000555555555555556	3071	1
1	Food 2	Intake 4	22	24805	1336755670	/users/cn/jespinosa/phecomp/data/CRG/20120502_FDF_CRG/20120502_FDF_CRG/20120511_FDF_CRG_c12.mtb	2214	2288	WWSS	food_sc	4	24783	1336755648	1	0.02	0.000909090909090909	3072	1
1	Food 2	Intake 4	9	27102	1336757967	/users/cn/jespinosa/phecomp/data/CRG/20120502_FDF_CRG/20120502_FDF_CRG/20120511_FDF_CRG_c12.mtb	2215	11	WWSS	food_sc	4	27093	1336757958	1	0.02	0.00222222222222222	3073	1
1	Food 2	Intake 4	122	27235	1336758100	/users/cn/jespinosa/phecomp/data/CRG/20120502_FDF_CRG/20120502_FDF_CRG/20120511_FDF_CRG_c12.mtb	2216	13	WWSS	food_sc	4	27113	1336757978	1	0.14	0.00114754098360656	3074	1
1	Food 2	Intake 4	18	27266	1336758131	/users/cn/jespinosa/phecomp/data/CRG/20120502_FDF_CRG/20120502_FDF_CRG/20120511_FDF_CRG_c12.mtb	2217	3059	WWSS	food_sc	4	27248	1336758113	1	0.02	0.00111111111111111	3075	1
1	Food 1	Intake 3	116	30441	1336761306	/users/cn/jespinosa/phecomp/data/CRG/20120502_FDF_CRG/20120502_FDF_CRG/20120511_FDF_CRG_c12.mtb	1586	37	WWSS	food_sc	3	30325	1336761190	1	0.12	0.00103448275862069	3076	1
1	Food 1	Intake 3	90	30568	1336761433	/users/cn/jespinosa/phecomp/data/CRG/20120502_FDF_CRG/20120502_FDF_CRG/20120511_FDF_CRG_c12.mtb	1587	1631	WWSS	food_sc	3	30478	1336761343	1	0.06	0.000666666666666667	3077	1
1	Drink 2	Intake 2	18	31734	1336762599	/users/cn/jespinosa/phecomp/data/CRG/20120502_FDF_CRG/20120502_FDF_CRG/20120511_FDF_CRG_c12.mtb	865	NA	WWSS	water	2	31716	1336762581	1	0.04	0.00222222222222222	3078	1
1	Food 1	Intake 3	25	32224	1336763089	/users/cn/jespinosa/phecomp/data/CRG/20120502_FDF_CRG/20120502_FDF_CRG/20120511_FDF_CRG_c12.mtb	1588	20	WWSS	food_sc	3	32199	1336763064	1	0.02	0.0008	3079	1
1	Food 1	Intake 3	63	32307	1336763172	/users/cn/jespinosa/phecomp/data/CRG/20120502_FDF_CRG/20120502_FDF_CRG/20120511_FDF_CRG_c12.mtb	1589	106	WWSS	food_sc	3	32244	1336763109	1	0.02	0.000317460317460317	3080	1
1	Food 1	Intake 3	27	32440	1336763305	/users/cn/jespinosa/phecomp/data/CRG/20120502_FDF_CRG/20120502_FDF_CRG/20120511_FDF_CRG_c12.mtb	1590	39	WWSS	food_sc	3	32413	1336763278	1	0.02	0.000740740740740741	3081	1
1	Food 2	Intake 4	119	32598	1336763463	/users/cn/jespinosa/phecomp/data/CRG/20120502_FDF_CRG/20120502_FDF_CRG/20120511_FDF_CRG_c12.mtb	2221	COLL	WWSS	food_sc	4	32479	1336763344	1	0.02	0.000168067226890756	3082	1
1	Food 1	Intake 3	51	32636	1336763501	/users/cn/jespinosa/phecomp/data/CRG/20120502_FDF_CRG/20120502_FDF_CRG/20120511_FDF_CRG_c12.mtb	1591	COLL	WWSS	food_sc	3	32585	1336763450	1	0.02	0.000392156862745098	3083	1
1	Food 2	Intake 4	78	32681	1336763546	/users/cn/jespinosa/phecomp/data/CRG/20120502_FDF_CRG/20120502_FDF_CRG/20120511_FDF_CRG_c12.mtb	2222	2523	WWSS	food_sc	4	32603	1336763468	1	0.02	0.000256410256410256	3084	1
1	Drink 2	Intake 2	20	32693	1336763558	/users/cn/jespinosa/phecomp/data/CRG/20120502_FDF_CRG/20120502_FDF_CRG/20120511_FDF_CRG_c12.mtb	866	NA	WWSS	water	2	32673	1336763538	1	0.04	0.002	3085	1
1	Drink 2	Intake 2	14	33448	1336764313	/users/cn/jespinosa/phecomp/data/CRG/20120502_FDF_CRG/20120502_FDF_CRG/20120511_FDF_CRG_c12.mtb	867	NA	WWSS	water	2	33434	1336764299	1	0.06	0.00428571428571429	3086	1
1	Food 2	Intake 4	101	35305	1336766170	/users/cn/jespinosa/phecomp/data/CRG/20120502_FDF_CRG/20120502_FDF_CRG/20120511_FDF_CRG_c12.mtb	2225	COLL	WWSS	food_sc	4	35204	1336766069	1	0.02	0.000198019801980198	3087	1
1	Food 1	Intake 3	38	35330	1336766195	/users/cn/jespinosa/phecomp/data/CRG/20120502_FDF_CRG/20120502_FDF_CRG/20120511_FDF_CRG_c12.mtb	1592	27	WWSS	food_sc	3	35292	1336766157	1	0.02	0.000526315789473684	3088	1
1	Food 1	Intake 3	17	35374	1336766239	/users/cn/jespinosa/phecomp/data/CRG/20120502_FDF_CRG/20120502_FDF_CRG/20120511_FDF_CRG_c12.mtb	1593	COLL	WWSS	food_sc	3	35357	1336766222	1	0.02	0.00117647058823529	3089	1
1	Food 2	Intake 4	213	35582	1336766447	/users/cn/jespinosa/phecomp/data/CRG/20120502_FDF_CRG/20120502_FDF_CRG/20120511_FDF_CRG_c12.mtb	2226	65	WWSS	food_sc	4	35369	1336766234	1	0.1	0.000469483568075117	3090	1
1	Drink 1	Intake 1	28	35601	1336766466	/users/cn/jespinosa/phecomp/data/CRG/20120502_FDF_CRG/20120502_FDF_CRG/20120511_FDF_CRG_c12.mtb	1943	NA	WWSS	water	1	35573	1336766438	1	0.04	0.00142857142857143	3091	1
1	Food 2	Intake 4	144	35791	1336766656	/users/cn/jespinosa/phecomp/data/CRG/20120502_FDF_CRG/20120502_FDF_CRG/20120511_FDF_CRG_c12.mtb	2227	534	WWSS	food_sc	4	35647	1336766512	1	0.02	0.000138888888888889	3092	1
1	Drink 2	Intake 2	18	35830	1336766695	/users/cn/jespinosa/phecomp/data/CRG/20120502_FDF_CRG/20120502_FDF_CRG/20120511_FDF_CRG_c12.mtb	869	NA	WWSS	water	2	35812	1336766677	1	0.02	0.00111111111111111	3093	1
1	Drink 2	Intake 2	28	35979	1336766844	/users/cn/jespinosa/phecomp/data/CRG/20120502_FDF_CRG/20120502_FDF_CRG/20120511_FDF_CRG_c12.mtb	870	NA	WWSS	water	2	35951	1336766816	1	0.1	0.00357142857142857	3094	1
1	Food 2	Intake 4	73	36398	1336767263	/users/cn/jespinosa/phecomp/data/CRG/20120502_FDF_CRG/20120502_FDF_CRG/20120511_FDF_CRG_c12.mtb	2229	312	WWSS	food_sc	4	36325	1336767190	1	0.04	0.000547945205479452	3095	1
1	Drink 2	Intake 2	27	36419	1336767284	/users/cn/jespinosa/phecomp/data/CRG/20120502_FDF_CRG/20120502_FDF_CRG/20120511_FDF_CRG_c12.mtb	871	NA	WWSS	water	2	36392	1336767257	1	0.08	0.00296296296296296	3096	1
1	Food 2	Intake 4	97	36807	1336767672	/users/cn/jespinosa/phecomp/data/CRG/20120502_FDF_CRG/20120502_FDF_CRG/20120511_FDF_CRG_c12.mtb	2231	2833	WWSS	food_sc	4	36710	1336767575	1	0.02	0.000206185567010309	3097	1
1	Food 2	Intake 4	51	39691	1336770556	/users/cn/jespinosa/phecomp/data/CRG/20120502_FDF_CRG/20120502_FDF_CRG/20120511_FDF_CRG_c12.mtb	2232	15	WWSS	food_sc	4	39640	1336770505	1	0.02	0.000392156862745098	3098	1
1	Food 2	Intake 4	28	39734	1336770599	/users/cn/jespinosa/phecomp/data/CRG/20120502_FDF_CRG/20120502_FDF_CRG/20120511_FDF_CRG_c12.mtb	2233	25	WWSS	food_sc	4	39706	1336770571	1	0.02	0.000714285714285714	3099	1
1	Food 2	Intake 4	41	39800	1336770665	/users/cn/jespinosa/phecomp/data/CRG/20120502_FDF_CRG/20120502_FDF_CRG/20120511_FDF_CRG_c12.mtb	2234	49	WWSS	food_sc	4	39759	1336770624	1	0.0399999999999999	0.000975609756097558	3100	1
1	Food 2	Intake 4	88	39937	1336770802	/users/cn/jespinosa/phecomp/data/CRG/20120502_FDF_CRG/20120502_FDF_CRG/20120511_FDF_CRG_c12.mtb	2235	2180	WWSS	food_sc	4	39849	1336770714	1	0.04	0.000454545454545455	3101	1
1	Drink 2	Intake 2	16	39956	1336770821	/users/cn/jespinosa/phecomp/data/CRG/20120502_FDF_CRG/20120502_FDF_CRG/20120511_FDF_CRG_c12.mtb	872	NA	WWSS	water	2	39940	1336770805	1	0.02	0.00125	3102	1
1	Food 2	Intake 4	88	42205	1336773070	/users/cn/jespinosa/phecomp/data/CRG/20120502_FDF_CRG/20120502_FDF_CRG/20120511_FDF_CRG_c12.mtb	2236	627	WWSS	food_sc	4	42117	1336772982	1	0.0599999999999999	0.000681818181818181	3103	1
1	Food 2	Intake 4	100	42932	1336773797	/users/cn/jespinosa/phecomp/data/CRG/20120502_FDF_CRG/20120502_FDF_CRG/20120511_FDF_CRG_c12.mtb	2238	22	WWSS	food_sc	4	42832	1336773697	1	0.04	0.0004	3104	1
1	Food 2	Intake 4	36	42990	1336773855	/users/cn/jespinosa/phecomp/data/CRG/20120502_FDF_CRG/20120502_FDF_CRG/20120511_FDF_CRG_c12.mtb	2239	20	WWSS	food_sc	4	42954	1336773819	1	0.04	0.00111111111111111	3105	1
1	Food 2	Intake 4	65	43075	1336773940	/users/cn/jespinosa/phecomp/data/CRG/20120502_FDF_CRG/20120502_FDF_CRG/20120511_FDF_CRG_c12.mtb	2240	15	WWSS	food_sc	4	43010	1336773875	1	0.0399999999999999	0.000615384615384614	3106	1
1	Food 2	Intake 4	77	43167	1336774032	/users/cn/jespinosa/phecomp/data/CRG/20120502_FDF_CRG/20120502_FDF_CRG/20120511_FDF_CRG_c12.mtb	2241	99	WWSS	food_sc	4	43090	1336773955	1	0.04	0.000519480519480519	3107	1
1	Drink 2	Intake 2	9	43179	1336774044	/users/cn/jespinosa/phecomp/data/CRG/20120502_FDF_CRG/20120502_FDF_CRG/20120511_FDF_CRG_c12.mtb	873	NA	WWSS	water	2	43170	1336774035	1	0.02	0.00222222222222222	3108	1
1	Food 1	Intake 3	52	43318	1336774183	/users/cn/jespinosa/phecomp/data/CRG/20120502_FDF_CRG/20120502_FDF_CRG/20120511_FDF_CRG_c12.mtb	1599	COLL	WWSS	food_sc	3	43266	1336774131	1	0.02	0.000384615384615385	3109	1
1	Food 2	Intake 4	93	43399	1336774264	/users/cn/jespinosa/phecomp/data/CRG/20120502_FDF_CRG/20120502_FDF_CRG/20120511_FDF_CRG_c12.mtb	2244	80	WWSS	food_sc	4	43306	1336774171	1	0.02	0.00021505376344086	3110	1
1	Drink 2	Intake 2	21	43420	1336774285	/users/cn/jespinosa/phecomp/data/CRG/20120502_FDF_CRG/20120502_FDF_CRG/20120511_FDF_CRG_c12.mtb	874	NA	WWSS	water	2	43399	1336774264	1	0.0599999999999999	0.00285714285714285	3111	1
1	Food 2	Intake 4	196	43675	1336774540	/users/cn/jespinosa/phecomp/data/CRG/20120502_FDF_CRG/20120502_FDF_CRG/20120511_FDF_CRG_c12.mtb	2245	169	WWSS	food_sc	4	43479	1336774344	1	0.04	0.000204081632653061	3112	1
1	Drink 1	Intake 1	15	43750	1336774615	/users/cn/jespinosa/phecomp/data/CRG/20120502_FDF_CRG/20120502_FDF_CRG/20120511_FDF_CRG_c12.mtb	1946	NA	WWSS	water	1	43735	1336774600	1	0.04	0.00266666666666667	3113	1
1	Drink 2	Intake 2	16	43758	1336774623	/users/cn/jespinosa/phecomp/data/CRG/20120502_FDF_CRG/20120502_FDF_CRG/20120511_FDF_CRG_c12.mtb	875	NA	WWSS	water	2	43742	1336774607	1	0.02	0.00125	3114	1
1	Food 2	Intake 4	102	43946	1336774811	/users/cn/jespinosa/phecomp/data/CRG/20120502_FDF_CRG/20120502_FDF_CRG/20120511_FDF_CRG_c12.mtb	2247	640	WWSS	food_sc	4	43844	1336774709	1	0.04	0.000392156862745098	3115	1
1	Drink 2	Intake 2	33	43972	1336774837	/users/cn/jespinosa/phecomp/data/CRG/20120502_FDF_CRG/20120502_FDF_CRG/20120511_FDF_CRG_c12.mtb	876	NA	WWSS	water	2	43939	1336774804	1	0.0600000000000001	0.00181818181818182	3116	1
1	Food 2	Intake 4	184	44770	1336775635	/users/cn/jespinosa/phecomp/data/CRG/20120502_FDF_CRG/20120502_FDF_CRG/20120511_FDF_CRG_c12.mtb	2249	73	WWSS	food_sc	4	44586	1336775451	1	0.04	0.000217391304347826	3117	1
1	Drink 1	Intake 1	19	44785	1336775650	/users/cn/jespinosa/phecomp/data/CRG/20120502_FDF_CRG/20120502_FDF_CRG/20120511_FDF_CRG_c12.mtb	1948	NA	WWSS	water	1	44766	1336775631	1	0.04	0.00210526315789474	3118	1
1	Food 2	Intake 4	104	44947	1336775812	/users/cn/jespinosa/phecomp/data/CRG/20120502_FDF_CRG/20120502_FDF_CRG/20120511_FDF_CRG_c12.mtb	2250	42	WWSS	food_sc	4	44843	1336775708	1	0.0399999999999998	0.000384615384615383	3119	1
1	Food 2	Intake 4	127	45116	1336775981	/users/cn/jespinosa/phecomp/data/CRG/20120502_FDF_CRG/20120502_FDF_CRG/20120511_FDF_CRG_c12.mtb	2251	482	WWSS	food_sc	4	44989	1336775854	1	0.04	0.00031496062992126	3120	1
1	Drink 1	Intake 1	26	45156	1336776021	/users/cn/jespinosa/phecomp/data/CRG/20120502_FDF_CRG/20120502_FDF_CRG/20120511_FDF_CRG_c12.mtb	1950	NA	WWSS	water	1	45130	1336775995	1	0.06	0.00230769230769231	3121	1
1	Food 2	Intake 4	131	45729	1336776594	/users/cn/jespinosa/phecomp/data/CRG/20120502_FDF_CRG/20120502_FDF_CRG/20120511_FDF_CRG_c12.mtb	2253	79	WWSS	food_sc	4	45598	1336776463	1	0.02	0.000152671755725191	3122	1
1	Drink 2	Intake 2	26	45752	1336776617	/users/cn/jespinosa/phecomp/data/CRG/20120502_FDF_CRG/20120502_FDF_CRG/20120511_FDF_CRG_c12.mtb	879	NA	WWSS	water	2	45726	1336776591	1	0.0599999999999999	0.0023076923076923	3123	1
1	Food 2	Intake 4	183	45991	1336776856	/users/cn/jespinosa/phecomp/data/CRG/20120502_FDF_CRG/20120502_FDF_CRG/20120511_FDF_CRG_c12.mtb	2254	502	WWSS	food_sc	4	45808	1336776673	1	0.04	0.000218579234972678	3124	1
1	Drink 2	Intake 2	20	46238	1336777103	/users/cn/jespinosa/phecomp/data/CRG/20120502_FDF_CRG/20120502_FDF_CRG/20120511_FDF_CRG_c12.mtb	880	NA	WWSS	water	2	46218	1336777083	1	0.0600000000000001	0.00300000000000001	3125	1
1	Food 2	Intake 4	16	46509	1336777374	/users/cn/jespinosa/phecomp/data/CRG/20120502_FDF_CRG/20120502_FDF_CRG/20120511_FDF_CRG_c12.mtb	2255	438	WWSS	food_sc	4	46493	1336777358	1	0.02	0.00125	3126	1
1	Food 2	Intake 4	260	47207	1336778072	/users/cn/jespinosa/phecomp/data/CRG/20120502_FDF_CRG/20120502_FDF_CRG/20120511_FDF_CRG_c12.mtb	2257	972	WWSS	food_sc	4	46947	1336777812	1	0.0799999999999998	0.000307692307692307	3127	1
1	Food 2	Intake 4	186	48365	1336779230	/users/cn/jespinosa/phecomp/data/CRG/20120502_FDF_CRG/20120502_FDF_CRG/20120511_FDF_CRG_c12.mtb	2258	1929	WWSS	food_sc	4	48179	1336779044	1	0.04	0.00021505376344086	3128	1
1	Food 2	Intake 4	50	50344	1336781209	/users/cn/jespinosa/phecomp/data/CRG/20120502_FDF_CRG/20120502_FDF_CRG/20120511_FDF_CRG_c12.mtb	2259	2702	WWSS	food_sc	4	50294	1336781159	1	0.04	0.0008	3129	1
1	Food 2	Intake 4	35	53081	1336783946	/users/cn/jespinosa/phecomp/data/CRG/20120502_FDF_CRG/20120502_FDF_CRG/20120511_FDF_CRG_c12.mtb	2260	35	WWSS	food_sc	4	53046	1336783911	1	0.02	0.000571428571428571	3130	1
1	Food 2	Intake 4	42	53158	1336784023	/users/cn/jespinosa/phecomp/data/CRG/20120502_FDF_CRG/20120502_FDF_CRG/20120511_FDF_CRG_c12.mtb	2261	2952	WWSS	food_sc	4	53116	1336783981	1	0.02	0.000476190476190476	3131	1
1	Food 2	Intake 4	73	56183	1336787048	/users/cn/jespinosa/phecomp/data/CRG/20120502_FDF_CRG/20120502_FDF_CRG/20120511_FDF_CRG_c12.mtb	2262	8	WWSS	food_sc	4	56110	1336786975	1	0.04	0.000547945205479452	3132	1
1	Food 2	Intake 4	44	56235	1336787100	/users/cn/jespinosa/phecomp/data/CRG/20120502_FDF_CRG/20120502_FDF_CRG/20120511_FDF_CRG_c12.mtb	2263	33	WWSS	food_sc	4	56191	1336787056	1	0.04	0.000909090909090909	3133	1
1	Food 2	Intake 4	170	56438	1336787303	/users/cn/jespinosa/phecomp/data/CRG/20120502_FDF_CRG/20120502_FDF_CRG/20120511_FDF_CRG_c12.mtb	2264	120	WWSS	food_sc	4	56268	1336787133	1	0.0800000000000001	0.000470588235294118	3134	1
1	Drink 2	Intake 2	17	56456	1336787321	/users/cn/jespinosa/phecomp/data/CRG/20120502_FDF_CRG/20120502_FDF_CRG/20120511_FDF_CRG_c12.mtb	881	NA	WWSS	water	2	56439	1336787304	1	0.02	0.00117647058823529	3135	1
1	Food 2	Intake 4	115	56673	1336787538	/users/cn/jespinosa/phecomp/data/CRG/20120502_FDF_CRG/20120502_FDF_CRG/20120511_FDF_CRG_c12.mtb	2265	38	WWSS	food_sc	4	56558	1336787423	1	0.04	0.000347826086956522	3136	1
1	Drink 2	Intake 2	29	56702	1336787567	/users/cn/jespinosa/phecomp/data/CRG/20120502_FDF_CRG/20120502_FDF_CRG/20120511_FDF_CRG_c12.mtb	882	NA	WWSS	water	2	56673	1336787538	1	0.0399999999999999	0.00137931034482758	3137	1
1	Food 2	Intake 4	69	56780	1336787645	/users/cn/jespinosa/phecomp/data/CRG/20120502_FDF_CRG/20120502_FDF_CRG/20120511_FDF_CRG_c12.mtb	2266	481	WWSS	food_sc	4	56711	1336787576	1	0.0399999999999998	0.000579710144927533	3138	1
1	Drink 1	Intake 1	21	56797	1336787662	/users/cn/jespinosa/phecomp/data/CRG/20120502_FDF_CRG/20120502_FDF_CRG/20120511_FDF_CRG_c12.mtb	1953	NA	WWSS	water	1	56776	1336787641	1	0.04	0.0019047619047619	3139	1
1	Drink 1	Intake 1	17	56875	1336787740	/users/cn/jespinosa/phecomp/data/CRG/20120502_FDF_CRG/20120502_FDF_CRG/20120511_FDF_CRG_c12.mtb	1954	NA	WWSS	water	1	56858	1336787723	1	0.02	0.00117647058823529	3140	1
1	Drink 2	Intake 2	36	56905	1336787770	/users/cn/jespinosa/phecomp/data/CRG/20120502_FDF_CRG/20120502_FDF_CRG/20120511_FDF_CRG_c12.mtb	883	NA	WWSS	water	2	56869	1336787734	1	0.04	0.00111111111111111	3141	1
1	Drink 2	Intake 2	33	57066	1336787931	/users/cn/jespinosa/phecomp/data/CRG/20120502_FDF_CRG/20120502_FDF_CRG/20120511_FDF_CRG_c12.mtb	884	NA	WWSS	water	2	57033	1336787898	1	0.02	0.000606060606060606	3142	1
1	Drink 2	Intake 2	22	57218	1336788083	/users/cn/jespinosa/phecomp/data/CRG/20120502_FDF_CRG/20120502_FDF_CRG/20120511_FDF_CRG_c12.mtb	885	NA	WWSS	water	2	57196	1336788061	1	0.0599999999999999	0.00272727272727272	3143	1
1	Food 1	Intake 3	36	57297	1336788162	/users/cn/jespinosa/phecomp/data/CRG/20120502_FDF_CRG/20120502_FDF_CRG/20120511_FDF_CRG_c12.mtb	1606	COLL	WWSS	food_sc	3	57261	1336788126	1	0.02	0.000555555555555556	3144	1
1	Food 2	Intake 4	80	57362	1336788227	/users/cn/jespinosa/phecomp/data/CRG/20120502_FDF_CRG/20120502_FDF_CRG/20120511_FDF_CRG_c12.mtb	2268	COLL	WWSS	food_sc	4	57282	1336788147	1	0.02	0.00025	3145	1
1	Food 1	Intake 3	69	57418	1336788283	/users/cn/jespinosa/phecomp/data/CRG/20120502_FDF_CRG/20120502_FDF_CRG/20120511_FDF_CRG_c12.mtb	1608	4571	WWSS	food_sc	3	57349	1336788214	1	0.02	0.000289855072463768	3146	1
1	Drink 2	Intake 2	25	57496	1336788361	/users/cn/jespinosa/phecomp/data/CRG/20120502_FDF_CRG/20120502_FDF_CRG/20120511_FDF_CRG_c12.mtb	886	NA	WWSS	water	2	57471	1336788336	1	0.04	0.0016	3147	1
1	Food 1	Intake 3	121	62110	1336792975	/users/cn/jespinosa/phecomp/data/CRG/20120502_FDF_CRG/20120502_FDF_CRG/20120511_FDF_CRG_c12.mtb	1610	2400	WWSS	food_sc	3	61989	1336792854	1	0.0600000000000001	0.000495867768595042	3148	1
1	Food 1	Intake 3	194	64704	1336795569	/users/cn/jespinosa/phecomp/data/CRG/20120502_FDF_CRG/20120502_FDF_CRG/20120511_FDF_CRG_c12.mtb	1613	7	WWSS	food_sc	3	64510	1336795375	1	0.1	0.000515463917525773	3149	1
1	Food 1	Intake 3	107	64818	1336795683	/users/cn/jespinosa/phecomp/data/CRG/20120502_FDF_CRG/20120502_FDF_CRG/20120511_FDF_CRG_c12.mtb	1614	11	WWSS	food_sc	3	64711	1336795576	1	0.04	0.000373831775700935	3150	1
1	Food 2	Intake 4	65	64894	1336795759	/users/cn/jespinosa/phecomp/data/CRG/20120502_FDF_CRG/20120502_FDF_CRG/20120511_FDF_CRG_c12.mtb	2274	64	WWSS	food_sc	4	64829	1336795694	1	0.02	0.000307692307692308	3151	1
1	Food 2	Intake 4	72	65030	1336795895	/users/cn/jespinosa/phecomp/data/CRG/20120502_FDF_CRG/20120502_FDF_CRG/20120511_FDF_CRG_c12.mtb	2275	100	WWSS	food_sc	4	64958	1336795823	1	0.02	0.000277777777777778	3152	1
1	Drink 2	Intake 2	34	65056	1336795921	/users/cn/jespinosa/phecomp/data/CRG/20120502_FDF_CRG/20120502_FDF_CRG/20120511_FDF_CRG_c12.mtb	887	NA	WWSS	water	2	65022	1336795887	1	0.12	0.00352941176470588	3153	1
1	Drink 2	Intake 2	24	65098	1336795963	/users/cn/jespinosa/phecomp/data/CRG/20120502_FDF_CRG/20120502_FDF_CRG/20120511_FDF_CRG_c12.mtb	888	NA	WWSS	water	2	65074	1336795939	1	0.0599999999999998	0.00249999999999999	3154	1
1	Food 2	Intake 4	156	65286	1336796151	/users/cn/jespinosa/phecomp/data/CRG/20120502_FDF_CRG/20120502_FDF_CRG/20120511_FDF_CRG_c12.mtb	2277	95	WWSS	food_sc	4	65130	1336795995	1	0.02	0.000128205128205128	3155	1
1	Food 1	Intake 3	29	65410	1336796275	/users/cn/jespinosa/phecomp/data/CRG/20120502_FDF_CRG/20120502_FDF_CRG/20120511_FDF_CRG_c12.mtb	1621	29	WWSS	food_sc	3	65381	1336796246	1	0.02	0.000689655172413793	3156	1
1	Drink 1	Intake 1	19	65433	1336796298	/users/cn/jespinosa/phecomp/data/CRG/20120502_FDF_CRG/20120502_FDF_CRG/20120511_FDF_CRG_c12.mtb	1955	NA	WWSS	water	1	65414	1336796279	1	0.06	0.00315789473684211	3157	1
1	Food 1	Intake 3	116	65555	1336796420	/users/cn/jespinosa/phecomp/data/CRG/20120502_FDF_CRG/20120502_FDF_CRG/20120511_FDF_CRG_c12.mtb	1622	42	WWSS	food_sc	3	65439	1336796304	1	0.0399999999999999	0.000344827586206896	3158	1
1	Food 1	Intake 3	56	65653	1336796518	/users/cn/jespinosa/phecomp/data/CRG/20120502_FDF_CRG/20120502_FDF_CRG/20120511_FDF_CRG_c12.mtb	1623	COLL	WWSS	food_sc	3	65597	1336796462	1	0.02	0.000357142857142857	3159	1
1	Food 2	Intake 4	76	65715	1336796580	/users/cn/jespinosa/phecomp/data/CRG/20120502_FDF_CRG/20120502_FDF_CRG/20120511_FDF_CRG_c12.mtb	2281	579	WWSS	food_sc	4	65639	1336796504	1	0.04	0.000526315789473684	3160	1
1	Drink 1	Intake 1	23	65735	1336796600	/users/cn/jespinosa/phecomp/data/CRG/20120502_FDF_CRG/20120502_FDF_CRG/20120511_FDF_CRG_c12.mtb	1956	NA	WWSS	water	1	65712	1336796577	1	0.06	0.00260869565217391	3161	1
1	Drink 2	Intake 2	32	66199	1336797064	/users/cn/jespinosa/phecomp/data/CRG/20120502_FDF_CRG/20120502_FDF_CRG/20120511_FDF_CRG_c12.mtb	889	NA	WWSS	water	2	66167	1336797032	1	0.1	0.003125	3162	1
1	Food 2	Intake 4	113	66407	1336797272	/users/cn/jespinosa/phecomp/data/CRG/20120502_FDF_CRG/20120502_FDF_CRG/20120511_FDF_CRG_c12.mtb	2285	70	WWSS	food_sc	4	66294	1336797159	1	0.0600000000000001	0.000530973451327435	3163	1
1	Food 1	Intake 3	142	66619	1336797484	/users/cn/jespinosa/phecomp/data/CRG/20120502_FDF_CRG/20120502_FDF_CRG/20120511_FDF_CRG_c12.mtb	1630	423	WWSS	food_sc	3	66477	1336797342	1	0.04	0.00028169014084507	3164	1
1	Drink 2	Intake 2	29	66681	1336797546	/users/cn/jespinosa/phecomp/data/CRG/20120502_FDF_CRG/20120502_FDF_CRG/20120511_FDF_CRG_c12.mtb	890	NA	WWSS	water	2	66652	1336797517	1	0.0799999999999998	0.00275862068965517	3165	1
1	Food 2	Intake 4	58	67100	1336797965	/users/cn/jespinosa/phecomp/data/CRG/20120502_FDF_CRG/20120502_FDF_CRG/20120511_FDF_CRG_c12.mtb	2292	286	WWSS	food_sc	4	67042	1336797907	1	0.04	0.000689655172413793	3166	1
1	Drink 2	Intake 2	29	67122	1336797987	/users/cn/jespinosa/phecomp/data/CRG/20120502_FDF_CRG/20120502_FDF_CRG/20120511_FDF_CRG_c12.mtb	891	NA	WWSS	water	2	67093	1336797958	1	0.0600000000000001	0.00206896551724138	3167	1
1	Food 1	Intake 3	29	67415	1336798280	/users/cn/jespinosa/phecomp/data/CRG/20120502_FDF_CRG/20120502_FDF_CRG/20120511_FDF_CRG_c12.mtb	1634	102	WWSS	food_sc	3	67386	1336798251	1	0.02	0.000689655172413793	3168	1
1	Food 2	Intake 4	247	67764	1336798629	/users/cn/jespinosa/phecomp/data/CRG/20120502_FDF_CRG/20120502_FDF_CRG/20120511_FDF_CRG_c12.mtb	2295	23	WWSS	food_sc	4	67517	1336798382	1	0.0600000000000001	0.000242914979757085	3169	1
1	Drink 1	Intake 1	28	67790	1336798655	/users/cn/jespinosa/phecomp/data/CRG/20120502_FDF_CRG/20120502_FDF_CRG/20120511_FDF_CRG_c12.mtb	1958	NA	WWSS	water	1	67762	1336798627	1	0.1	0.00357142857142857	3170	1
1	Food 2	Intake 4	83	67870	1336798735	/users/cn/jespinosa/phecomp/data/CRG/20120502_FDF_CRG/20120502_FDF_CRG/20120511_FDF_CRG_c12.mtb	2296	89	WWSS	food_sc	4	67787	1336798652	1	0.02	0.000240963855421687	3171	1
1	Food 1	Intake 3	81	68040	1336798905	/users/cn/jespinosa/phecomp/data/CRG/20120502_FDF_CRG/20120502_FDF_CRG/20120511_FDF_CRG_c12.mtb	1641	146	WWSS	food_sc	3	67959	1336798824	1	0.0399999999999999	0.000493827160493826	3172	1
1	Drink 2	Intake 2	28	68067	1336798932	/users/cn/jespinosa/phecomp/data/CRG/20120502_FDF_CRG/20120502_FDF_CRG/20120511_FDF_CRG_c12.mtb	892	NA	WWSS	water	2	68039	1336798904	1	0.04	0.00142857142857143	3173	1
1	Food 1	Intake 3	67	68253	1336799118	/users/cn/jespinosa/phecomp/data/CRG/20120502_FDF_CRG/20120502_FDF_CRG/20120511_FDF_CRG_c12.mtb	1643	COLL	WWSS	food_sc	3	68186	1336799051	1	0.02	0.000298507462686567	3174	1
1	Food 2	Intake 4	96	68337	1336799202	/users/cn/jespinosa/phecomp/data/CRG/20120502_FDF_CRG/20120502_FDF_CRG/20120511_FDF_CRG_c12.mtb	2300	147	WWSS	food_sc	4	68241	1336799106	1	0.04	0.000416666666666667	3175	1
1	Food 1	Intake 3	26	68510	1336799375	/users/cn/jespinosa/phecomp/data/CRG/20120502_FDF_CRG/20120502_FDF_CRG/20120511_FDF_CRG_c12.mtb	1645	165	WWSS	food_sc	3	68484	1336799349	1	0.02	0.000769230769230769	3176	1
1	Food 1	Intake 3	19	68694	1336799559	/users/cn/jespinosa/phecomp/data/CRG/20120502_FDF_CRG/20120502_FDF_CRG/20120511_FDF_CRG_c12.mtb	1649	112	WWSS	food_sc	3	68675	1336799540	1	0.02	0.00105263157894737	3177	1
1	Drink 2	Intake 2	28	68718	1336799583	/users/cn/jespinosa/phecomp/data/CRG/20120502_FDF_CRG/20120502_FDF_CRG/20120511_FDF_CRG_c12.mtb	893	NA	WWSS	water	2	68690	1336799555	1	0.0800000000000001	0.00285714285714286	3178	1
1	Food 2	Intake 4	166	68972	1336799837	/users/cn/jespinosa/phecomp/data/CRG/20120502_FDF_CRG/20120502_FDF_CRG/20120511_FDF_CRG_c12.mtb	2304	335	WWSS	food_sc	4	68806	1336799671	1	0.0600000000000001	0.000361445783132531	3179	1
1	Drink 2	Intake 2	18	69252	1336800117	/users/cn/jespinosa/phecomp/data/CRG/20120502_FDF_CRG/20120502_FDF_CRG/20120511_FDF_CRG_c12.mtb	894	NA	WWSS	water	2	69234	1336800099	1	0.04	0.00222222222222222	3180	1
1	Food 1	Intake 3	92	69399	1336800264	/users/cn/jespinosa/phecomp/data/CRG/20120502_FDF_CRG/20120502_FDF_CRG/20120511_FDF_CRG_c12.mtb	1656	54	WWSS	food_sc	3	69307	1336800172	1	0.02	0.000217391304347826	3181	1
1	Food 1	Intake 3	54	69507	1336800372	/users/cn/jespinosa/phecomp/data/CRG/20120502_FDF_CRG/20120502_FDF_CRG/20120511_FDF_CRG_c12.mtb	1658	58	WWSS	food_sc	3	69453	1336800318	1	0.02	0.00037037037037037	3182	1
1	Food 1	Intake 3	58	69623	1336800488	/users/cn/jespinosa/phecomp/data/CRG/20120502_FDF_CRG/20120502_FDF_CRG/20120511_FDF_CRG_c12.mtb	1659	COLL	WWSS	food_sc	3	69565	1336800430	1	0.02	0.000344827586206897	3183	1
1	Food 2	Intake 4	49	69659	1336800524	/users/cn/jespinosa/phecomp/data/CRG/20120502_FDF_CRG/20120502_FDF_CRG/20120511_FDF_CRG_c12.mtb	2316	96	WWSS	food_sc	4	69610	1336800475	1	0.02	0.000408163265306122	3184	1
1	Food 2	Intake 4	152	69907	1336800772	/users/cn/jespinosa/phecomp/data/CRG/20120502_FDF_CRG/20120502_FDF_CRG/20120511_FDF_CRG_c12.mtb	2317	146	WWSS	food_sc	4	69755	1336800620	1	0.0800000000000001	0.000526315789473685	3185	1
1	Drink 1	Intake 1	20	69978	1336800843	/users/cn/jespinosa/phecomp/data/CRG/20120502_FDF_CRG/20120502_FDF_CRG/20120511_FDF_CRG_c12.mtb	1959	NA	WWSS	water	1	69958	1336800823	1	0.04	0.002	3186	1
1	Food 2	Intake 4	139	70192	1336801057	/users/cn/jespinosa/phecomp/data/CRG/20120502_FDF_CRG/20120502_FDF_CRG/20120511_FDF_CRG_c12.mtb	2319	4	WWSS	food_sc	4	70053	1336800918	1	0.0599999999999996	0.00043165467625899	3187	1
1	Food 2	Intake 4	54	70250	1336801115	/users/cn/jespinosa/phecomp/data/CRG/20120502_FDF_CRG/20120502_FDF_CRG/20120511_FDF_CRG_c12.mtb	2320	363	WWSS	food_sc	4	70196	1336801061	1	0.02	0.00037037037037037	3188	1
1	Drink 2	Intake 2	25	70533	1336801398	/users/cn/jespinosa/phecomp/data/CRG/20120502_FDF_CRG/20120502_FDF_CRG/20120511_FDF_CRG_c12.mtb	896	NA	WWSS	water	2	70508	1336801373	1	0.04	0.0016	3189	1
1	Food 2	Intake 4	86	70699	1336801564	/users/cn/jespinosa/phecomp/data/CRG/20120502_FDF_CRG/20120502_FDF_CRG/20120511_FDF_CRG_c12.mtb	2326	COLL	WWSS	food_sc	4	70613	1336801478	1	0.02	0.000232558139534884	3190	1
1	Food 1	Intake 3	109	70796	1336801661	/users/cn/jespinosa/phecomp/data/CRG/20120502_FDF_CRG/20120502_FDF_CRG/20120511_FDF_CRG_c12.mtb	1672	65	WWSS	food_sc	3	70687	1336801552	1	0.04	0.00036697247706422	3191	1
1	Drink 2	Intake 2	28	70819	1336801684	/users/cn/jespinosa/phecomp/data/CRG/20120502_FDF_CRG/20120502_FDF_CRG/20120511_FDF_CRG_c12.mtb	897	NA	WWSS	water	2	70791	1336801656	1	0.04	0.00142857142857143	3192	1
1	Food 1	Intake 3	63	70924	1336801789	/users/cn/jespinosa/phecomp/data/CRG/20120502_FDF_CRG/20120502_FDF_CRG/20120511_FDF_CRG_c12.mtb	1673	55	WWSS	food_sc	3	70861	1336801726	1	0.02	0.000317460317460317	3193	1
1	Food 2	Intake 4	155	71134	1336801999	/users/cn/jespinosa/phecomp/data/CRG/20120502_FDF_CRG/20120502_FDF_CRG/20120511_FDF_CRG_c12.mtb	2330	9	WWSS	food_sc	4	70979	1336801844	1	0.0800000000000001	0.000516129032258065	3194	1
1	Food 1	Intake 3	60	71203	1336802068	/users/cn/jespinosa/phecomp/data/CRG/20120502_FDF_CRG/20120502_FDF_CRG/20120511_FDF_CRG_c12.mtb	1677	59	WWSS	food_sc	3	71143	1336802008	1	0.02	0.000333333333333333	3195	1
1	Food 1	Intake 3	91	71353	1336802218	/users/cn/jespinosa/phecomp/data/CRG/20120502_FDF_CRG/20120502_FDF_CRG/20120511_FDF_CRG_c12.mtb	1678	93	WWSS	food_sc	3	71262	1336802127	1	0.02	0.00021978021978022	3196	1
1	Food 2	Intake 4	30	71476	1336802341	/users/cn/jespinosa/phecomp/data/CRG/20120502_FDF_CRG/20120502_FDF_CRG/20120511_FDF_CRG_c12.mtb	2334	6	WWSS	food_sc	4	71446	1336802311	1	0.02	0.000666666666666667	3197	1
1	Food 2	Intake 4	23	71505	1336802370	/users/cn/jespinosa/phecomp/data/CRG/20120502_FDF_CRG/20120502_FDF_CRG/20120511_FDF_CRG_c12.mtb	2335	23	WWSS	food_sc	4	71482	1336802347	1	0.02	0.000869565217391304	3198	1
1	Food 1	Intake 3	118	71646	1336802511	/users/cn/jespinosa/phecomp/data/CRG/20120502_FDF_CRG/20120502_FDF_CRG/20120511_FDF_CRG_c12.mtb	1681	9	WWSS	food_sc	3	71528	1336802393	1	0.02	0.000169491525423729	3199	1
1	Food 1	Intake 3	80	71735	1336802600	/users/cn/jespinosa/phecomp/data/CRG/20120502_FDF_CRG/20120502_FDF_CRG/20120511_FDF_CRG_c12.mtb	1682	113	WWSS	food_sc	3	71655	1336802520	1	0.02	0.00025	3200	1
1	Food 1	Intake 3	110	71958	1336802823	/users/cn/jespinosa/phecomp/data/CRG/20120502_FDF_CRG/20120502_FDF_CRG/20120511_FDF_CRG_c12.mtb	1684	COLL	WWSS	food_sc	3	71848	1336802713	1	0.04	0.000363636363636364	3201	1
1	Food 2	Intake 4	51	71971	1336802836	/users/cn/jespinosa/phecomp/data/CRG/20120502_FDF_CRG/20120502_FDF_CRG/20120511_FDF_CRG_c12.mtb	2341	50	WWSS	food_sc	4	71920	1336802785	1	0.02	0.000392156862745098	3202	1
1	Drink 1	Intake 1	46	72022	1336802887	/users/cn/jespinosa/phecomp/data/CRG/20120502_FDF_CRG/20120502_FDF_CRG/20120511_FDF_CRG_c12.mtb	1960	NA	WWSS	water	1	71976	1336802841	1	0.08	0.00173913043478261	3203	1
1	Food 1	Intake 3	66	72087	1336802952	/users/cn/jespinosa/phecomp/data/CRG/20120502_FDF_CRG/20120502_FDF_CRG/20120511_FDF_CRG_c12.mtb	1685	COLL	WWSS	food_sc	3	72021	1336802886	1	0.02	0.000303030303030303	3204	1
1	Food 2	Intake 4	28	72068	1336802933	/users/cn/jespinosa/phecomp/data/CRG/20120502_FDF_CRG/20120502_FDF_CRG/20120511_FDF_CRG_c12.mtb	2342	25	WWSS	food_sc	4	72040	1336802905	1	0.02	0.000714285714285714	3205	1
1	Food 1	Intake 3	76	72169	1336803034	/users/cn/jespinosa/phecomp/data/CRG/20120502_FDF_CRG/20120502_FDF_CRG/20120511_FDF_CRG_c12.mtb	1686	45	WWSS	food_sc	3	72093	1336802958	1	0.04	0.000526315789473684	3206	1
1	Food 2	Intake 4	35	72249	1336803114	/users/cn/jespinosa/phecomp/data/CRG/20120502_FDF_CRG/20120502_FDF_CRG/20120511_FDF_CRG_c12.mtb	2346	41	WWSS	food_sc	4	72214	1336803079	1	0.02	0.000571428571428571	3207	1
1	Food 1	Intake 3	28	72318	1336803183	/users/cn/jespinosa/phecomp/data/CRG/20120502_FDF_CRG/20120502_FDF_CRG/20120511_FDF_CRG_c12.mtb	1688	60	WWSS	food_sc	3	72290	1336803155	1	0.02	0.000714285714285714	3208	1
1	Drink 2	Intake 2	21	72362	1336803227	/users/cn/jespinosa/phecomp/data/CRG/20120502_FDF_CRG/20120502_FDF_CRG/20120511_FDF_CRG_c12.mtb	898	NA	WWSS	water	2	72341	1336803206	1	0.0399999999999998	0.0019047619047619	3209	1
1	Food 1	Intake 3	31	72409	1336803274	/users/cn/jespinosa/phecomp/data/CRG/20120502_FDF_CRG/20120502_FDF_CRG/20120511_FDF_CRG_c12.mtb	1689	COLL	WWSS	food_sc	3	72378	1336803243	1	0.02	0.000645161290322581	3210	1
1	Food 2	Intake 4	86	72482	1336803347	/users/cn/jespinosa/phecomp/data/CRG/20120502_FDF_CRG/20120502_FDF_CRG/20120511_FDF_CRG_c12.mtb	2348	COLL	WWSS	food_sc	4	72396	1336803261	1	0.02	0.000232558139534884	3211	1
1	Food 1	Intake 3	99	72567	1336803432	/users/cn/jespinosa/phecomp/data/CRG/20120502_FDF_CRG/20120502_FDF_CRG/20120511_FDF_CRG_c12.mtb	1691	COLL	WWSS	food_sc	3	72468	1336803333	1	0.04	0.000404040404040404	3212	1
1	Food 2	Intake 4	57	72611	1336803476	/users/cn/jespinosa/phecomp/data/CRG/20120502_FDF_CRG/20120502_FDF_CRG/20120511_FDF_CRG_c12.mtb	2351	4	WWSS	food_sc	4	72554	1336803419	1	0.02	0.000350877192982456	3213	1
1	Food 2	Intake 4	52	72667	1336803532	/users/cn/jespinosa/phecomp/data/CRG/20120502_FDF_CRG/20120502_FDF_CRG/20120511_FDF_CRG_c12.mtb	2352	27	WWSS	food_sc	4	72615	1336803480	1	0.02	0.000384615384615385	3214	1
1	Food 2	Intake 4	102	72796	1336803661	/users/cn/jespinosa/phecomp/data/CRG/20120502_FDF_CRG/20120502_FDF_CRG/20120511_FDF_CRG_c12.mtb	2353	2	WWSS	food_sc	4	72694	1336803559	1	0.02	0.000196078431372549	3215	1
1	Food 1	Intake 3	128	72926	1336803791	/users/cn/jespinosa/phecomp/data/CRG/20120502_FDF_CRG/20120502_FDF_CRG/20120511_FDF_CRG_c12.mtb	1697	COLL	WWSS	food_sc	3	72798	1336803663	1	0.04	0.0003125	3216	1
1	Food 2	Intake 4	35	72848	1336803713	/users/cn/jespinosa/phecomp/data/CRG/20120502_FDF_CRG/20120502_FDF_CRG/20120511_FDF_CRG_c12.mtb	2354	4015	WWSS	food_sc	4	72813	1336803678	1	0.02	0.000571428571428571	3217	1
1	Drink 2	Intake 2	43	72963	1336803828	/users/cn/jespinosa/phecomp/data/CRG/20120502_FDF_CRG/20120502_FDF_CRG/20120511_FDF_CRG_c12.mtb	899	NA	WWSS	water	2	72920	1336803785	1	0.0800000000000001	0.00186046511627907	3218	1
1	Food 1	Intake 3	65	76928	1336807793	/users/cn/jespinosa/phecomp/data/CRG/20120502_FDF_CRG/20120502_FDF_CRG/20120511_FDF_CRG_c12.mtb	1698	COLL	WWSS	food_sc	3	76863	1336807728	1	0.04	0.000615384615384615	3219	1
1	Food 2	Intake 4	49	76917	1336807782	/users/cn/jespinosa/phecomp/data/CRG/20120502_FDF_CRG/20120502_FDF_CRG/20120511_FDF_CRG_c12.mtb	2356	110	WWSS	food_sc	4	76868	1336807733	1	0.02	0.000408163265306122	3220	1
1	Food 2	Intake 4	17	77044	1336807909	/users/cn/jespinosa/phecomp/data/CRG/20120502_FDF_CRG/20120502_FDF_CRG/20120511_FDF_CRG_c12.mtb	2357	320	WWSS	food_sc	4	77027	1336807892	1	0.02	0.00117647058823529	3221	1
1	Drink 2	Intake 2	25	77138	1336808003	/users/cn/jespinosa/phecomp/data/CRG/20120502_FDF_CRG/20120502_FDF_CRG/20120511_FDF_CRG_c12.mtb	901	NA	WWSS	water	2	77113	1336807978	1	0.0399999999999998	0.00159999999999999	3222	1
1	Food 1	Intake 3	135	77499	1336808364	/users/cn/jespinosa/phecomp/data/CRG/20120502_FDF_CRG/20120502_FDF_CRG/20120511_FDF_CRG_c12.mtb	1700	892	WWSS	food_sc	3	77364	1336808229	1	0.0600000000000001	0.000444444444444445	3223	1
1	Drink 2	Intake 2	13	77540	1336808405	/users/cn/jespinosa/phecomp/data/CRG/20120502_FDF_CRG/20120502_FDF_CRG/20120511_FDF_CRG_c12.mtb	902	NA	WWSS	water	2	77527	1336808392	1	0.04	0.00307692307692308	3224	1
1	Food 1	Intake 3	140	78531	1336809396	/users/cn/jespinosa/phecomp/data/CRG/20120502_FDF_CRG/20120502_FDF_CRG/20120511_FDF_CRG_c12.mtb	1702	COLL	WWSS	food_sc	3	78391	1336809256	1	0.02	0.000142857142857143	3225	1
1	Food 2	Intake 4	17	78538	1336809403	/users/cn/jespinosa/phecomp/data/CRG/20120502_FDF_CRG/20120502_FDF_CRG/20120511_FDF_CRG_c12.mtb	2361	8315	WWSS	food_sc	4	78521	1336809386	1	0.04	0.00235294117647059	3226	1
1	Drink 2	Intake 2	24	78595	1336809460	/users/cn/jespinosa/phecomp/data/CRG/20120502_FDF_CRG/20120502_FDF_CRG/20120511_FDF_CRG_c12.mtb	903	NA	WWSS	water	2	78571	1336809436	1	0.04	0.00166666666666667	3227	1
1	Food 2	Intake 4	30	86883	1336817748	/users/cn/jespinosa/phecomp/data/CRG/20120502_FDF_CRG/20120502_FDF_CRG/20120511_FDF_CRG_c12.mtb	2365	166	WWSS	food_sc	4	86853	1336817718	1	0.0200000000000005	0.000666666666666683	3228	1
1	Food 1	Intake 3	40	87089	1336817954	/users/cn/jespinosa/phecomp/data/CRG/20120502_FDF_CRG/20120502_FDF_CRG/20120511_FDF_CRG_c12.mtb	1704	33	WWSS	food_sc	3	87049	1336817914	1	0.02	0.0005	3229	1
1	Food 1	Intake 3	21	87143	1336818008	/users/cn/jespinosa/phecomp/data/CRG/20120502_FDF_CRG/20120502_FDF_CRG/20120511_FDF_CRG_c12.mtb	1706	9272	WWSS	food_sc	3	87122	1336817987	1	0.02	0.000952380952380952	3230	1
1	Drink 2	Intake 2	14	87328	1336818193	/users/cn/jespinosa/phecomp/data/CRG/20120502_FDF_CRG/20120502_FDF_CRG/20120511_FDF_CRG_c12.mtb	904	NA	WWSS	water	2	87314	1336818179	1	0.02	0.00142857142857143	3231	1
1	Food 2	Intake 4	23	96438	1336827303	/users/cn/jespinosa/phecomp/data/CRG/20120502_FDF_CRG/20120502_FDF_CRG/20120511_FDF_CRG_c12.mtb	2369	129	WWSS	food_sc	4	96415	1336827280	1	0.04	0.00173913043478261	3232	1
1	Food 2	Intake 4	16	96583	1336827448	/users/cn/jespinosa/phecomp/data/CRG/20120502_FDF_CRG/20120502_FDF_CRG/20120511_FDF_CRG_c12.mtb	2370	252	WWSS	food_sc	4	96567	1336827432	1	0.02	0.00125	3233	1
1	Food 2	Intake 4	25	96860	1336827725	/users/cn/jespinosa/phecomp/data/CRG/20120502_FDF_CRG/20120502_FDF_CRG/20120511_FDF_CRG_c12.mtb	2371	95	WWSS	food_sc	4	96835	1336827700	1	0.02	0.0008	3234	1
1	Food 1	Intake 3	36	96991	1336827856	/users/cn/jespinosa/phecomp/data/CRG/20120502_FDF_CRG/20120502_FDF_CRG/20120511_FDF_CRG_c12.mtb	1709	6136	WWSS	food_sc	3	96955	1336827820	1	0.02	0.000555555555555556	3235	1
1	Food 1	Intake 3	12	103139	1336834004	/users/cn/jespinosa/phecomp/data/CRG/20120502_FDF_CRG/20120502_FDF_CRG/20120511_FDF_CRG_c12.mtb	1711	808	WWSS	food_sc	3	103127	1336833992	1	0.02	0.00166666666666667	3236	1
1	Food 1	Intake 3	41	103988	1336834853	/users/cn/jespinosa/phecomp/data/CRG/20120502_FDF_CRG/20120502_FDF_CRG/20120511_FDF_CRG_c12.mtb	1713	1869	WWSS	food_sc	3	103947	1336834812	1	0.02	0.00048780487804878	3237	1
1	Food 1	Intake 3	57	105914	1336836779	/users/cn/jespinosa/phecomp/data/CRG/20120502_FDF_CRG/20120502_FDF_CRG/20120511_FDF_CRG_c12.mtb	1715	8025	WWSS	food_sc	3	105857	1336836722	1	0.04	0.000701754385964912	3238	1
1	Food 2	Intake 4	16	113955	1336844820	/users/cn/jespinosa/phecomp/data/CRG/20120502_FDF_CRG/20120502_FDF_CRG/20120511_FDF_CRG_c12.mtb	2375	62	WWSS	food_sc	4	113939	1336844804	1	0.04	0.0025	3239	1
1	Food 2	Intake 4	32	114049	1336844914	/users/cn/jespinosa/phecomp/data/CRG/20120502_FDF_CRG/20120502_FDF_CRG/20120511_FDF_CRG_c12.mtb	2376	12	WWSS	food_sc	4	114017	1336844882	1	0.02	0.000625	3240	1
1	Food 2	Intake 4	17	114078	1336844943	/users/cn/jespinosa/phecomp/data/CRG/20120502_FDF_CRG/20120502_FDF_CRG/20120511_FDF_CRG_c12.mtb	2377	28	WWSS	food_sc	4	114061	1336844926	1	0.04	0.00235294117647059	3241	1
1	Food 2	Intake 4	16	114122	1336844987	/users/cn/jespinosa/phecomp/data/CRG/20120502_FDF_CRG/20120502_FDF_CRG/20120511_FDF_CRG_c12.mtb	2378	2088	WWSS	food_sc	4	114106	1336844971	1	0.02	0.00125	3242	1
1	Drink 2	Intake 2	17	114146	1336845011	/users/cn/jespinosa/phecomp/data/CRG/20120502_FDF_CRG/20120502_FDF_CRG/20120511_FDF_CRG_c12.mtb	909	NA	WWSS	water	2	114129	1336844994	1	0.02	0.00117647058823529	3243	1
1	Food 2	Intake 4	73	116283	1336847148	/users/cn/jespinosa/phecomp/data/CRG/20120502_FDF_CRG/20120502_FDF_CRG/20120511_FDF_CRG_c12.mtb	2379	32	WWSS	food_sc	4	116210	1336847075	1	0.04	0.000547945205479452	3244	1
1	Food 1	Intake 3	47	116362	1336847227	/users/cn/jespinosa/phecomp/data/CRG/20120502_FDF_CRG/20120502_FDF_CRG/20120511_FDF_CRG_c12.mtb	1717	50	WWSS	food_sc	3	116315	1336847180	1	0.04	0.000851063829787234	3245	1
1	Drink 2	Intake 2	15	116382	1336847247	/users/cn/jespinosa/phecomp/data/CRG/20120502_FDF_CRG/20120502_FDF_CRG/20120511_FDF_CRG_c12.mtb	911	NA	WWSS	water	2	116367	1336847232	1	0.02	0.00133333333333333	3246	1
1	Food 2	Intake 4	50	116462	1336847327	/users/cn/jespinosa/phecomp/data/CRG/20120502_FDF_CRG/20120502_FDF_CRG/20120511_FDF_CRG_c12.mtb	2381	1506	WWSS	food_sc	4	116412	1336847277	1	0.02	0.0004	3247	1
1	Drink 2	Intake 2	9	116616	1336847481	/users/cn/jespinosa/phecomp/data/CRG/20120502_FDF_CRG/20120502_FDF_CRG/20120511_FDF_CRG_c12.mtb	912	NA	WWSS	water	2	116607	1336847472	1	0.02	0.00222222222222222	3248	1
1	Drink 1	Intake 1	17	116912	1336847777	/users/cn/jespinosa/phecomp/data/CRG/20120502_FDF_CRG/20120502_FDF_CRG/20120511_FDF_CRG_c12.mtb	1966	NA	WWSS	water	1	116895	1336847760	1	0.02	0.00117647058823529	3249	1
1	Drink 2	Intake 2	13	117708	1336848573	/users/cn/jespinosa/phecomp/data/CRG/20120502_FDF_CRG/20120502_FDF_CRG/20120511_FDF_CRG_c12.mtb	914	NA	WWSS	water	2	117695	1336848560	1	0.0600000000000001	0.00461538461538462	3250	1
1	Food 2	Intake 4	9	117977	1336848842	/users/cn/jespinosa/phecomp/data/CRG/20120502_FDF_CRG/20120502_FDF_CRG/20120511_FDF_CRG_c12.mtb	2388	26	WWSS	food_sc	4	117968	1336848833	1	0.02	0.00222222222222222	3251	1
1	Food 2	Intake 4	33	118036	1336848901	/users/cn/jespinosa/phecomp/data/CRG/20120502_FDF_CRG/20120502_FDF_CRG/20120511_FDF_CRG_c12.mtb	2389	27	WWSS	food_sc	4	118003	1336848868	1	0.04	0.00121212121212121	3252	1
1	Food 2	Intake 4	17	118080	1336848945	/users/cn/jespinosa/phecomp/data/CRG/20120502_FDF_CRG/20120502_FDF_CRG/20120511_FDF_CRG_c12.mtb	2390	17	WWSS	food_sc	4	118063	1336848928	1	0.02	0.00117647058823529	3253	1
1	Food 2	Intake 4	36	118133	1336848998	/users/cn/jespinosa/phecomp/data/CRG/20120502_FDF_CRG/20120502_FDF_CRG/20120511_FDF_CRG_c12.mtb	2391	1301	WWSS	food_sc	4	118097	1336848962	1	0.02	0.000555555555555556	3254	1
1	Food 2	Intake 4	9	119443	1336850308	/users/cn/jespinosa/phecomp/data/CRG/20120502_FDF_CRG/20120502_FDF_CRG/20120511_FDF_CRG_c12.mtb	2393	6	WWSS	food_sc	4	119434	1336850299	1	0.02	0.00222222222222222	3255	1
1	Food 2	Intake 4	70	119519	1336850384	/users/cn/jespinosa/phecomp/data/CRG/20120502_FDF_CRG/20120502_FDF_CRG/20120511_FDF_CRG_c12.mtb	2394	1005	WWSS	food_sc	4	119449	1336850314	1	0.0600000000000001	0.000857142857142859	3256	1
1	Drink 2	Intake 2	26	119540	1336850405	/users/cn/jespinosa/phecomp/data/CRG/20120502_FDF_CRG/20120502_FDF_CRG/20120511_FDF_CRG_c12.mtb	915	NA	WWSS	water	2	119514	1336850379	1	0.0600000000000001	0.00230769230769231	3257	1
1	Food 2	Intake 4	20	120544	1336851409	/users/cn/jespinosa/phecomp/data/CRG/20120502_FDF_CRG/20120502_FDF_CRG/20120511_FDF_CRG_c12.mtb	2395	8	WWSS	food_sc	4	120524	1336851389	1	0.02	0.001	3258	1
1	Food 2	Intake 4	63	120615	1336851480	/users/cn/jespinosa/phecomp/data/CRG/20120502_FDF_CRG/20120502_FDF_CRG/20120511_FDF_CRG_c12.mtb	2396	1121	WWSS	food_sc	4	120552	1336851417	1	0.0600000000000001	0.000952380952380954	3259	1
1	Drink 2	Intake 2	18	120862	1336851727	/users/cn/jespinosa/phecomp/data/CRG/20120502_FDF_CRG/20120502_FDF_CRG/20120511_FDF_CRG_c12.mtb	916	NA	WWSS	water	2	120844	1336851709	1	0.0800000000000001	0.00444444444444445	3260	1
1	Food 1	Intake 3	16	121752	1336852617	/users/cn/jespinosa/phecomp/data/CRG/20120502_FDF_CRG/20120502_FDF_CRG/20120511_FDF_CRG_c12.mtb	1726	32	WWSS	food_sc	3	121736	1336852601	1	0.02	0.00125	3261	1
1	Food 1	Intake 3	51	121835	1336852700	/users/cn/jespinosa/phecomp/data/CRG/20120502_FDF_CRG/20120502_FDF_CRG/20120511_FDF_CRG_c12.mtb	1727	122	WWSS	food_sc	3	121784	1336852649	1	0.0600000000000001	0.0011764705882353	3262	1
1	Food 2	Intake 4	293	122250	1336853115	/users/cn/jespinosa/phecomp/data/CRG/20120502_FDF_CRG/20120502_FDF_CRG/20120511_FDF_CRG_c12.mtb	2397	COLL	WWSS	food_sc	4	121957	1336852822	1	0.0399999999999996	0.000136518771331057	3263	1
1	Food 1	Intake 3	98	122289	1336853154	/users/cn/jespinosa/phecomp/data/CRG/20120502_FDF_CRG/20120502_FDF_CRG/20120511_FDF_CRG_c12.mtb	1730	9	WWSS	food_sc	3	122191	1336853056	1	0.02	0.000204081632653061	3264	1
1	Drink 2	Intake 2	18	122304	1336853169	/users/cn/jespinosa/phecomp/data/CRG/20120502_FDF_CRG/20120502_FDF_CRG/20120511_FDF_CRG_c12.mtb	917	NA	WWSS	water	2	122286	1336853151	1	0.02	0.00111111111111111	3265	1
1	Food 2	Intake 4	208	122506	1336853371	/users/cn/jespinosa/phecomp/data/CRG/20120502_FDF_CRG/20120502_FDF_CRG/20120511_FDF_CRG_c12.mtb	2398	420	WWSS	food_sc	4	122298	1336853163	1	0.02	9.61538461538462e-05	3266	1
1	Drink 2	Intake 2	22	122517	1336853382	/users/cn/jespinosa/phecomp/data/CRG/20120502_FDF_CRG/20120502_FDF_CRG/20120511_FDF_CRG_c12.mtb	918	NA	WWSS	water	2	122495	1336853360	1	0.04	0.00181818181818182	3267	1
1	Drink 2	Intake 2	25	122897	1336853762	/users/cn/jespinosa/phecomp/data/CRG/20120502_FDF_CRG/20120502_FDF_CRG/20120511_FDF_CRG_c12.mtb	919	NA	WWSS	water	2	122872	1336853737	1	0.0599999999999996	0.00239999999999998	3268	1
1	Food 2	Intake 4	118	123044	1336853909	/users/cn/jespinosa/phecomp/data/CRG/20120502_FDF_CRG/20120502_FDF_CRG/20120511_FDF_CRG_c12.mtb	2401	122	WWSS	food_sc	4	122926	1336853791	1	0.02	0.000169491525423729	3269	1
1	Food 2	Intake 4	60	123226	1336854091	/users/cn/jespinosa/phecomp/data/CRG/20120502_FDF_CRG/20120502_FDF_CRG/20120511_FDF_CRG_c12.mtb	2403	306	WWSS	food_sc	4	123166	1336854031	1	0.02	0.000333333333333333	3270	1
1	Food 2	Intake 4	65	123597	1336854462	/users/cn/jespinosa/phecomp/data/CRG/20120502_FDF_CRG/20120502_FDF_CRG/20120511_FDF_CRG_c12.mtb	2409	63	WWSS	food_sc	4	123532	1336854397	1	0.02	0.000307692307692308	3271	1
1	Drink 1	Intake 1	21	123653	1336854518	/users/cn/jespinosa/phecomp/data/CRG/20120502_FDF_CRG/20120502_FDF_CRG/20120511_FDF_CRG_c12.mtb	1969	NA	WWSS	water	1	123632	1336854497	1	0.04	0.0019047619047619	3272	1
1	Food 2	Intake 4	85	123745	1336854610	/users/cn/jespinosa/phecomp/data/CRG/20120502_FDF_CRG/20120502_FDF_CRG/20120511_FDF_CRG_c12.mtb	2411	259	WWSS	food_sc	4	123660	1336854525	1	0.02	0.000235294117647059	3273	1
1	Drink 2	Intake 2	23	123939	1336854804	/users/cn/jespinosa/phecomp/data/CRG/20120502_FDF_CRG/20120502_FDF_CRG/20120511_FDF_CRG_c12.mtb	921	NA	WWSS	water	2	123916	1336854781	1	0.0800000000000001	0.00347826086956522	3274	1
1	Food 2	Intake 4	31	124035	1336854900	/users/cn/jespinosa/phecomp/data/CRG/20120502_FDF_CRG/20120502_FDF_CRG/20120511_FDF_CRG_c12.mtb	2414	45	WWSS	food_sc	4	124004	1336854869	1	0.02	0.000645161290322581	3275	1
1	Food 1	Intake 3	120	124200	1336855065	/users/cn/jespinosa/phecomp/data/CRG/20120502_FDF_CRG/20120502_FDF_CRG/20120511_FDF_CRG_c12.mtb	1746	27	WWSS	food_sc	3	124080	1336854945	1	0.02	0.000166666666666667	3276	1
1	Food 1	Intake 3	146	124373	1336855238	/users/cn/jespinosa/phecomp/data/CRG/20120502_FDF_CRG/20120502_FDF_CRG/20120511_FDF_CRG_c12.mtb	1748	227	WWSS	food_sc	3	124227	1336855092	1	0.0600000000000001	0.00041095890410959	3277	1
1	Food 2	Intake 4	156	124756	1336855621	/users/cn/jespinosa/phecomp/data/CRG/20120502_FDF_CRG/20120502_FDF_CRG/20120511_FDF_CRG_c12.mtb	2416	409	WWSS	food_sc	4	124600	1336855465	1	0.04	0.000256410256410256	3278	1
1	Drink 2	Intake 2	36	124812	1336855677	/users/cn/jespinosa/phecomp/data/CRG/20120502_FDF_CRG/20120502_FDF_CRG/20120511_FDF_CRG_c12.mtb	922	NA	WWSS	water	2	124776	1336855641	1	0.1	0.00277777777777778	3279	1
1	Food 2	Intake 4	60	125225	1336856090	/users/cn/jespinosa/phecomp/data/CRG/20120502_FDF_CRG/20120502_FDF_CRG/20120511_FDF_CRG_c12.mtb	2419	48	WWSS	food_sc	4	125165	1336856030	1	0.02	0.000333333333333333	3280	1
1	Food 2	Intake 4	187	125460	1336856325	/users/cn/jespinosa/phecomp/data/CRG/20120502_FDF_CRG/20120502_FDF_CRG/20120511_FDF_CRG_c12.mtb	2420	670	WWSS	food_sc	4	125273	1336856138	1	0.04	0.000213903743315508	3281	1
1	Drink 2	Intake 2	34	125489	1336856354	/users/cn/jespinosa/phecomp/data/CRG/20120502_FDF_CRG/20120502_FDF_CRG/20120511_FDF_CRG_c12.mtb	923	NA	WWSS	water	2	125455	1336856320	1	0.0800000000000001	0.00235294117647059	3282	1
1	Drink 1	Intake 1	20	125840	1336856705	/users/cn/jespinosa/phecomp/data/CRG/20120502_FDF_CRG/20120502_FDF_CRG/20120511_FDF_CRG_c12.mtb	1972	NA	WWSS	water	1	125820	1336856685	1	0.0599999999999999	0.00299999999999999	3283	1
1	Drink 1	Intake 1	34	125919	1336856784	/users/cn/jespinosa/phecomp/data/CRG/20120502_FDF_CRG/20120502_FDF_CRG/20120511_FDF_CRG_c12.mtb	1973	NA	WWSS	water	1	125885	1336856750	1	0.04	0.00117647058823529	3284	1
1	Drink 1	Intake 1	54	125984	1336856849	/users/cn/jespinosa/phecomp/data/CRG/20120502_FDF_CRG/20120502_FDF_CRG/20120511_FDF_CRG_c12.mtb	1974	NA	WWSS	water	1	125930	1336856795	1	0.12	0.00222222222222222	3285	1
1	Food 2	Intake 4	92	126222	1336857087	/users/cn/jespinosa/phecomp/data/CRG/20120502_FDF_CRG/20120502_FDF_CRG/20120511_FDF_CRG_c12.mtb	2423	221	WWSS	food_sc	4	126130	1336856995	1	0.02	0.000217391304347826	3286	1
1	Food 1	Intake 3	140	126583	1336857448	/users/cn/jespinosa/phecomp/data/CRG/20120502_FDF_CRG/20120502_FDF_CRG/20120511_FDF_CRG_c12.mtb	1762	71	WWSS	food_sc	3	126443	1336857308	1	0.0600000000000001	0.000428571428571429	3287	1
1	Drink 2	Intake 2	19	126599	1336857464	/users/cn/jespinosa/phecomp/data/CRG/20120502_FDF_CRG/20120502_FDF_CRG/20120511_FDF_CRG_c12.mtb	924	NA	WWSS	water	2	126580	1336857445	1	0.02	0.00105263157894737	3288	1
1	Food 1	Intake 3	58	126712	1336857577	/users/cn/jespinosa/phecomp/data/CRG/20120502_FDF_CRG/20120502_FDF_CRG/20120511_FDF_CRG_c12.mtb	1763	46	WWSS	food_sc	3	126654	1336857519	1	0.0800000000000001	0.00137931034482759	3289	1
1	Food 1	Intake 3	168	126926	1336857791	/users/cn/jespinosa/phecomp/data/CRG/20120502_FDF_CRG/20120502_FDF_CRG/20120511_FDF_CRG_c12.mtb	1764	51	WWSS	food_sc	3	126758	1336857623	1	0.04	0.000238095238095238	3290	1
1	Food 1	Intake 3	150	127127	1336857992	/users/cn/jespinosa/phecomp/data/CRG/20120502_FDF_CRG/20120502_FDF_CRG/20120511_FDF_CRG_c12.mtb	1765	713	WWSS	food_sc	3	126977	1336857842	1	0.02	0.000133333333333333	3291	1
1	Food 1	Intake 3	239	128079	1336858944	/users/cn/jespinosa/phecomp/data/CRG/20120502_FDF_CRG/20120502_FDF_CRG/20120511_FDF_CRG_c12.mtb	1769	4	WWSS	food_sc	3	127840	1336858705	1	0.04	0.000167364016736402	3292	1
1	Food 2	Intake 4	27	128110	1336858975	/users/cn/jespinosa/phecomp/data/CRG/20120502_FDF_CRG/20120502_FDF_CRG/20120511_FDF_CRG_c12.mtb	2436	132	WWSS	food_sc	4	128083	1336858948	1	0.02	0.000740740740740741	3293	1
1	Food 1	Intake 3	114	128356	1336859221	/users/cn/jespinosa/phecomp/data/CRG/20120502_FDF_CRG/20120502_FDF_CRG/20120511_FDF_CRG_c12.mtb	1771	487	WWSS	food_sc	3	128242	1336859107	1	0.0200000000000005	0.000175438596491232	3294	1
1	Drink 2	Intake 2	19	128452	1336859317	/users/cn/jespinosa/phecomp/data/CRG/20120502_FDF_CRG/20120502_FDF_CRG/20120511_FDF_CRG_c12.mtb	925	NA	WWSS	water	2	128433	1336859298	1	0.02	0.00105263157894737	3295	1
1	Food 2	Intake 4	87	128930	1336859795	/users/cn/jespinosa/phecomp/data/CRG/20120502_FDF_CRG/20120502_FDF_CRG/20120511_FDF_CRG_c12.mtb	2441	20	WWSS	food_sc	4	128843	1336859708	1	0.02	0.000229885057471264	3296	1
1	Food 1	Intake 3	43	128993	1336859858	/users/cn/jespinosa/phecomp/data/CRG/20120502_FDF_CRG/20120502_FDF_CRG/20120511_FDF_CRG_c12.mtb	1775	9	WWSS	food_sc	3	128950	1336859815	1	0.02	0.000465116279069767	3297	1
1	Food 1	Intake 3	92	129094	1336859959	/users/cn/jespinosa/phecomp/data/CRG/20120502_FDF_CRG/20120502_FDF_CRG/20120511_FDF_CRG_c12.mtb	1776	632	WWSS	food_sc	3	129002	1336859867	1	0.02	0.000217391304347826	3298	1
1	Drink 1	Intake 1	16	129109	1336859974	/users/cn/jespinosa/phecomp/data/CRG/20120502_FDF_CRG/20120502_FDF_CRG/20120511_FDF_CRG_c12.mtb	1976	NA	WWSS	water	1	129093	1336859958	1	0.02	0.00125	3299	1
1	Drink 2	Intake 2	24	129120	1336859985	/users/cn/jespinosa/phecomp/data/CRG/20120502_FDF_CRG/20120502_FDF_CRG/20120511_FDF_CRG_c12.mtb	926	NA	WWSS	water	2	129096	1336859961	1	0.0600000000000001	0.0025	3300	1
1	Food 2	Intake 4	52	129778	1336860643	/users/cn/jespinosa/phecomp/data/CRG/20120502_FDF_CRG/20120502_FDF_CRG/20120511_FDF_CRG_c12.mtb	2446	3764	WWSS	food_sc	4	129726	1336860591	1	0.02	0.000384615384615385	3301	1
1	Drink 1	Intake 1	62	129903	1336860768	/users/cn/jespinosa/phecomp/data/CRG/20120502_FDF_CRG/20120502_FDF_CRG/20120511_FDF_CRG_c12.mtb	1978	NA	WWSS	water	1	129841	1336860706	1	0.1	0.00161290322580645	3302	1
1	Drink 1	Intake 1	9	130011	1336860876	/users/cn/jespinosa/phecomp/data/CRG/20120502_FDF_CRG/20120502_FDF_CRG/20120511_FDF_CRG_c12.mtb	1979	NA	WWSS	water	1	130002	1336860867	1	0.02	0.00222222222222222	3303	1
1	Drink 1	Intake 1	15	130035	1336860900	/users/cn/jespinosa/phecomp/data/CRG/20120502_FDF_CRG/20120502_FDF_CRG/20120511_FDF_CRG_c12.mtb	1980	NA	WWSS	water	1	130020	1336860885	1	0.02	0.00133333333333333	3304	1
1	Food 2	Intake 4	14	133556	1336864421	/users/cn/jespinosa/phecomp/data/CRG/20120502_FDF_CRG/20120502_FDF_CRG/20120511_FDF_CRG_c12.mtb	2448	20	WWSS	food_sc	4	133542	1336864407	1	0.02	0.00142857142857143	3305	1
1	Food 2	Intake 4	9	133585	1336864450	/users/cn/jespinosa/phecomp/data/CRG/20120502_FDF_CRG/20120502_FDF_CRG/20120511_FDF_CRG_c12.mtb	2449	212	WWSS	food_sc	4	133576	1336864441	1	0.02	0.00222222222222222	3306	1
1	Food 2	Intake 4	18	133815	1336864680	/users/cn/jespinosa/phecomp/data/CRG/20120502_FDF_CRG/20120502_FDF_CRG/20120511_FDF_CRG_c12.mtb	2451	38	WWSS	food_sc	4	133797	1336864662	1	0.02	0.00111111111111111	3307	1
1	Drink 1	Intake 1	14	133852	1336864717	/users/cn/jespinosa/phecomp/data/CRG/20120502_FDF_CRG/20120502_FDF_CRG/20120511_FDF_CRG_c12.mtb	1981	NA	WWSS	water	1	133838	1336864703	1	0.02	0.00142857142857143	3308	1
1	Food 2	Intake 4	228	134081	1336864946	/users/cn/jespinosa/phecomp/data/CRG/20120502_FDF_CRG/20120502_FDF_CRG/20120511_FDF_CRG_c12.mtb	2453	COLL	WWSS	food_sc	4	133853	1336864718	1	0.02	8.7719298245614e-05	3309	1
1	Food 1	Intake 3	55	133914	1336864779	/users/cn/jespinosa/phecomp/data/CRG/20120502_FDF_CRG/20120502_FDF_CRG/20120511_FDF_CRG_c12.mtb	1779	188	WWSS	food_sc	3	133859	1336864724	1	0.02	0.000363636363636364	3310	1
1	Drink 1	Intake 1	18	134089	1336864954	/users/cn/jespinosa/phecomp/data/CRG/20120502_FDF_CRG/20120502_FDF_CRG/20120511_FDF_CRG_c12.mtb	1982	NA	WWSS	water	1	134071	1336864936	1	0.02	0.00111111111111111	3311	1
1	Food 2	Intake 4	78	134180	1336865045	/users/cn/jespinosa/phecomp/data/CRG/20120502_FDF_CRG/20120502_FDF_CRG/20120511_FDF_CRG_c12.mtb	2454	104	WWSS	food_sc	4	134102	1336864967	1	0.0599999999999996	0.000769230769230764	3312	1
1	Drink 1	Intake 1	36	134232	1336865097	/users/cn/jespinosa/phecomp/data/CRG/20120502_FDF_CRG/20120502_FDF_CRG/20120511_FDF_CRG_c12.mtb	1983	NA	WWSS	water	1	134196	1336865061	1	0.04	0.00111111111111111	3313	1
1	Food 2	Intake 4	38	134322	1336865187	/users/cn/jespinosa/phecomp/data/CRG/20120502_FDF_CRG/20120502_FDF_CRG/20120511_FDF_CRG_c12.mtb	2456	1187	WWSS	food_sc	4	134284	1336865149	1	0.0200000000000005	0.000526315789473697	3314	1
1	Drink 1	Intake 1	17	134350	1336865215	/users/cn/jespinosa/phecomp/data/CRG/20120502_FDF_CRG/20120502_FDF_CRG/20120511_FDF_CRG_c12.mtb	1984	NA	WWSS	water	1	134333	1336865198	1	0.02	0.00117647058823529	3315	1
1	Drink 2	Intake 2	17	134912	1336865777	/users/cn/jespinosa/phecomp/data/CRG/20120502_FDF_CRG/20120502_FDF_CRG/20120511_FDF_CRG_c12.mtb	928	NA	WWSS	water	2	134895	1336865760	1	0.02	0.00117647058823529	3316	1
1	Drink 2	Intake 2	41	135087	1336865952	/users/cn/jespinosa/phecomp/data/CRG/20120502_FDF_CRG/20120502_FDF_CRG/20120511_FDF_CRG_c12.mtb	929	NA	WWSS	water	2	135046	1336865911	1	0.14	0.00341463414634146	3317	1
1	Food 2	Intake 4	81	135590	1336866455	/users/cn/jespinosa/phecomp/data/CRG/20120502_FDF_CRG/20120502_FDF_CRG/20120511_FDF_CRG_c12.mtb	2463	5	WWSS	food_sc	4	135509	1336866374	1	0.02	0.000246913580246914	3318	1
1	Food 2	Intake 4	105	135700	1336866565	/users/cn/jespinosa/phecomp/data/CRG/20120502_FDF_CRG/20120502_FDF_CRG/20120511_FDF_CRG_c12.mtb	2464	1408	WWSS	food_sc	4	135595	1336866460	1	0.0600000000000001	0.000571428571428572	3319	1
1	Food 2	Intake 4	62	137170	1336868035	/users/cn/jespinosa/phecomp/data/CRG/20120502_FDF_CRG/20120502_FDF_CRG/20120511_FDF_CRG_c12.mtb	2467	761	WWSS	food_sc	4	137108	1336867973	1	0.04	0.000645161290322581	3320	1
1	Drink 1	Intake 1	16	137283	1336868148	/users/cn/jespinosa/phecomp/data/CRG/20120502_FDF_CRG/20120502_FDF_CRG/20120511_FDF_CRG_c12.mtb	1987	NA	WWSS	water	1	137267	1336868132	1	0.0799999999999998	0.00499999999999999	3321	1
1	Food 2	Intake 4	109	138040	1336868905	/users/cn/jespinosa/phecomp/data/CRG/20120502_FDF_CRG/20120502_FDF_CRG/20120511_FDF_CRG_c12.mtb	2468	125	WWSS	food_sc	4	137931	1336868796	1	0.02	0.00018348623853211	3322	1
1	Food 2	Intake 4	61	138226	1336869091	/users/cn/jespinosa/phecomp/data/CRG/20120502_FDF_CRG/20120502_FDF_CRG/20120511_FDF_CRG_c12.mtb	2470	727	WWSS	food_sc	4	138165	1336869030	1	0.02	0.000327868852459016	3323	1
1	Drink 2	Intake 2	23	138348	1336869213	/users/cn/jespinosa/phecomp/data/CRG/20120502_FDF_CRG/20120502_FDF_CRG/20120511_FDF_CRG_c12.mtb	931	NA	WWSS	water	2	138325	1336869190	1	0.04	0.00173913043478261	3324	1
1	Food 2	Intake 4	20	138973	1336869838	/users/cn/jespinosa/phecomp/data/CRG/20120502_FDF_CRG/20120502_FDF_CRG/20120511_FDF_CRG_c12.mtb	2471	5214	WWSS	food_sc	4	138953	1336869818	1	0.02	0.001	3325	1
1	Food 2	Intake 4	15	144202	1336875067	/users/cn/jespinosa/phecomp/data/CRG/20120502_FDF_CRG/20120502_FDF_CRG/20120511_FDF_CRG_c12.mtb	2474	1545	WWSS	food_sc	4	144187	1336875052	1	0.02	0.00133333333333333	3326	1
1	Food 1	Intake 3	15	145762	1336876627	/users/cn/jespinosa/phecomp/data/CRG/20120502_FDF_CRG/20120502_FDF_CRG/20120511_FDF_CRG_c12.mtb	1797	2384	WWSS	food_sc	3	145747	1336876612	1	0.04	0.00266666666666667	3327	1
1	Food 2	Intake 4	49	148195	1336879060	/users/cn/jespinosa/phecomp/data/CRG/20120502_FDF_CRG/20120502_FDF_CRG/20120511_FDF_CRG_c12.mtb	2475	3282	WWSS	food_sc	4	148146	1336879011	1	0.0800000000000001	0.00163265306122449	3328	1
1	Food 2	Intake 4	36	151513	1336882378	/users/cn/jespinosa/phecomp/data/CRG/20120502_FDF_CRG/20120502_FDF_CRG/20120511_FDF_CRG_c12.mtb	2478	12	WWSS	food_sc	4	151477	1336882342	1	0.04	0.00111111111111111	3329	1
1	Food 2	Intake 4	17	151542	1336882407	/users/cn/jespinosa/phecomp/data/CRG/20120502_FDF_CRG/20120502_FDF_CRG/20120511_FDF_CRG_c12.mtb	2479	17	WWSS	food_sc	4	151525	1336882390	1	0.04	0.00235294117647059	3330	1
1	Food 2	Intake 4	8	151567	1336882432	/users/cn/jespinosa/phecomp/data/CRG/20120502_FDF_CRG/20120502_FDF_CRG/20120511_FDF_CRG_c12.mtb	2480	7	WWSS	food_sc	4	151559	1336882424	1	0.0200000000000005	0.00250000000000006	3331	1
1	Food 2	Intake 4	119	151693	1336882558	/users/cn/jespinosa/phecomp/data/CRG/20120502_FDF_CRG/20120502_FDF_CRG/20120511_FDF_CRG_c12.mtb	2481	508	WWSS	food_sc	4	151574	1336882439	1	0.0599999999999996	0.000504201680672266	3332	1
1	Food 2	Intake 4	43	152244	1336883109	/users/cn/jespinosa/phecomp/data/CRG/20120502_FDF_CRG/20120502_FDF_CRG/20120511_FDF_CRG_c12.mtb	2482	65	WWSS	food_sc	4	152201	1336883066	1	0.0200000000000005	0.000465116279069779	3333	1
1	Drink 2	Intake 2	23	152310	1336883175	/users/cn/jespinosa/phecomp/data/CRG/20120502_FDF_CRG/20120502_FDF_CRG/20120511_FDF_CRG_c12.mtb	934	NA	WWSS	water	2	152287	1336883152	1	0.0800000000000001	0.00347826086956522	3334	1
1	Food 1	Intake 3	121	152430	1336883295	/users/cn/jespinosa/phecomp/data/CRG/20120502_FDF_CRG/20120502_FDF_CRG/20120511_FDF_CRG_c12.mtb	1800	9	WWSS	food_sc	3	152309	1336883174	1	0.04	0.000330578512396694	3335	1
1	Drink 2	Intake 2	17	152444	1336883309	/users/cn/jespinosa/phecomp/data/CRG/20120502_FDF_CRG/20120502_FDF_CRG/20120511_FDF_CRG_c12.mtb	935	NA	WWSS	water	2	152427	1336883292	1	0.02	0.00117647058823529	3336	1
1	Food 1	Intake 3	89	152528	1336883393	/users/cn/jespinosa/phecomp/data/CRG/20120502_FDF_CRG/20120502_FDF_CRG/20120511_FDF_CRG_c12.mtb	1801	29	WWSS	food_sc	3	152439	1336883304	1	0.02	0.000224719101123596	3337	1
1	Food 2	Intake 4	116	152673	1336883538	/users/cn/jespinosa/phecomp/data/CRG/20120502_FDF_CRG/20120502_FDF_CRG/20120511_FDF_CRG_c12.mtb	2485	59	WWSS	food_sc	4	152557	1336883422	1	0.04	0.000344827586206897	3338	1
1	Drink 1	Intake 1	28	152696	1336883561	/users/cn/jespinosa/phecomp/data/CRG/20120502_FDF_CRG/20120502_FDF_CRG/20120511_FDF_CRG_c12.mtb	1990	NA	WWSS	water	1	152668	1336883533	1	0.0800000000000001	0.00285714285714286	3339	1
1	Food 2	Intake 4	36	152768	1336883633	/users/cn/jespinosa/phecomp/data/CRG/20120502_FDF_CRG/20120502_FDF_CRG/20120511_FDF_CRG_c12.mtb	2486	386	WWSS	food_sc	4	152732	1336883597	1	0.0200000000000005	0.000555555555555569	3340	1
1	Drink 2	Intake 2	28	153083	1336883948	/users/cn/jespinosa/phecomp/data/CRG/20120502_FDF_CRG/20120502_FDF_CRG/20120511_FDF_CRG_c12.mtb	936	NA	WWSS	water	2	153055	1336883920	1	0.0600000000000001	0.00214285714285715	3341	1
1	Food 2	Intake 4	112	153266	1336884131	/users/cn/jespinosa/phecomp/data/CRG/20120502_FDF_CRG/20120502_FDF_CRG/20120511_FDF_CRG_c12.mtb	2488	210	WWSS	food_sc	4	153154	1336884019	1	0.04	0.000357142857142857	3342	1
1	Drink 1	Intake 1	37	153308	1336884173	/users/cn/jespinosa/phecomp/data/CRG/20120502_FDF_CRG/20120502_FDF_CRG/20120511_FDF_CRG_c12.mtb	1991	NA	WWSS	water	1	153271	1336884136	1	0.04	0.00108108108108108	3343	1
1	Drink 2	Intake 2	25	153339	1336884204	/users/cn/jespinosa/phecomp/data/CRG/20120502_FDF_CRG/20120502_FDF_CRG/20120511_FDF_CRG_c12.mtb	937	NA	WWSS	water	2	153314	1336884179	1	0.02	0.0008	3344	1
1	Food 1	Intake 3	132	153608	1336884473	/users/cn/jespinosa/phecomp/data/CRG/20120502_FDF_CRG/20120502_FDF_CRG/20120511_FDF_CRG_c12.mtb	1806	135	WWSS	food_sc	3	153476	1336884341	1	0.02	0.000151515151515152	3345	1
1	Drink 2	Intake 2	27	153631	1336884496	/users/cn/jespinosa/phecomp/data/CRG/20120502_FDF_CRG/20120502_FDF_CRG/20120511_FDF_CRG_c12.mtb	938	NA	WWSS	water	2	153604	1336884469	1	0.0800000000000001	0.00296296296296297	3346	1
1	Drink 1	Intake 1	9	153740	1336884605	/users/cn/jespinosa/phecomp/data/CRG/20120502_FDF_CRG/20120502_FDF_CRG/20120511_FDF_CRG_c12.mtb	1995	NA	WWSS	water	1	153731	1336884596	1	0.02	0.00222222222222222	3347	1
1	Food 1	Intake 3	163	153906	1336884771	/users/cn/jespinosa/phecomp/data/CRG/20120502_FDF_CRG/20120502_FDF_CRG/20120511_FDF_CRG_c12.mtb	1807	COLL	WWSS	food_sc	3	153743	1336884608	1	0.0600000000000001	0.000368098159509203	3348	1
1	Food 2	Intake 4	49	153950	1336884815	/users/cn/jespinosa/phecomp/data/CRG/20120502_FDF_CRG/20120502_FDF_CRG/20120511_FDF_CRG_c12.mtb	2493	COLL	WWSS	food_sc	4	153901	1336884766	1	0.0200000000000005	0.000408163265306133	3349	1
1	Food 1	Intake 3	178	154114	1336884979	/users/cn/jespinosa/phecomp/data/CRG/20120502_FDF_CRG/20120502_FDF_CRG/20120511_FDF_CRG_c12.mtb	1808	146	WWSS	food_sc	3	153936	1336884801	1	0.02	0.000112359550561798	3350	1
1	Food 1	Intake 3	136	154396	1336885261	/users/cn/jespinosa/phecomp/data/CRG/20120502_FDF_CRG/20120502_FDF_CRG/20120511_FDF_CRG_c12.mtb	1810	COLL	WWSS	food_sc	3	154260	1336885125	1	0.04	0.000294117647058824	3351	1
1	Food 2	Intake 4	74	154457	1336885322	/users/cn/jespinosa/phecomp/data/CRG/20120502_FDF_CRG/20120502_FDF_CRG/20120511_FDF_CRG_c12.mtb	2499	589	WWSS	food_sc	4	154383	1336885248	1	0.04	0.000540540540540541	3352	1
1	Drink 2	Intake 2	27	154478	1336885343	/users/cn/jespinosa/phecomp/data/CRG/20120502_FDF_CRG/20120502_FDF_CRG/20120511_FDF_CRG_c12.mtb	939	NA	WWSS	water	2	154451	1336885316	1	0.04	0.00148148148148148	3353	1
1	Food 2	Intake 4	183	155229	1336886094	/users/cn/jespinosa/phecomp/data/CRG/20120502_FDF_CRG/20120502_FDF_CRG/20120511_FDF_CRG_c12.mtb	2503	39	WWSS	food_sc	4	155046	1336885911	1	0.0200000000000005	0.000109289617486342	3354	1
1	Drink 2	Intake 2	17	155172	1336886037	/users/cn/jespinosa/phecomp/data/CRG/20120502_FDF_CRG/20120502_FDF_CRG/20120511_FDF_CRG_c12.mtb	940	NA	WWSS	water	2	155155	1336886020	1	0.02	0.00117647058823529	3355	1
1	Food 2	Intake 4	80	155348	1336886213	/users/cn/jespinosa/phecomp/data/CRG/20120502_FDF_CRG/20120502_FDF_CRG/20120511_FDF_CRG_c12.mtb	2504	227	WWSS	food_sc	4	155268	1336886133	1	0.0200000000000005	0.000250000000000006	3356	1
1	Drink 1	Intake 1	40	155381	1336886246	/users/cn/jespinosa/phecomp/data/CRG/20120502_FDF_CRG/20120502_FDF_CRG/20120511_FDF_CRG_c12.mtb	1996	NA	WWSS	water	1	155341	1336886206	1	0.0600000000000001	0.0015	3357	1
1	Food 2	Intake 4	140	155715	1336886580	/users/cn/jespinosa/phecomp/data/CRG/20120502_FDF_CRG/20120502_FDF_CRG/20120511_FDF_CRG_c12.mtb	2507	8	WWSS	food_sc	4	155575	1336886440	1	0.0200000000000005	0.000142857142857146	3358	1
1	Food 2	Intake 4	157	155880	1336886745	/users/cn/jespinosa/phecomp/data/CRG/20120502_FDF_CRG/20120502_FDF_CRG/20120511_FDF_CRG_c12.mtb	2508	294	WWSS	food_sc	4	155723	1336886588	1	0.0599999999999996	0.000382165605095539	3359	1
1	Drink 2	Intake 2	38	155932	1336886797	/users/cn/jespinosa/phecomp/data/CRG/20120502_FDF_CRG/20120502_FDF_CRG/20120511_FDF_CRG_c12.mtb	942	NA	WWSS	water	2	155894	1336886759	1	0.1	0.00263157894736842	3360	1
1	Food 2	Intake 4	20	156194	1336887059	/users/cn/jespinosa/phecomp/data/CRG/20120502_FDF_CRG/20120502_FDF_CRG/20120511_FDF_CRG_c12.mtb	2512	28	WWSS	food_sc	4	156174	1336887039	1	0.36	0.018	3361	1
1	Food 1	Intake 3	136	156358	1336887223	/users/cn/jespinosa/phecomp/data/CRG/20120502_FDF_CRG/20120502_FDF_CRG/20120511_FDF_CRG_c12.mtb	1826	152	WWSS	food_sc	3	156222	1336887087	1	0.04	0.000294117647058824	3362	1
1	Food 1	Intake 3	120	156630	1336887495	/users/cn/jespinosa/phecomp/data/CRG/20120502_FDF_CRG/20120502_FDF_CRG/20120511_FDF_CRG_c12.mtb	1828	175	WWSS	food_sc	3	156510	1336887375	1	0.02	0.000166666666666667	3363	1
1	Food 1	Intake 3	160	156965	1336887830	/users/cn/jespinosa/phecomp/data/CRG/20120502_FDF_CRG/20120502_FDF_CRG/20120511_FDF_CRG_c12.mtb	1830	403	WWSS	food_sc	3	156805	1336887670	1	0.04	0.00025	3364	1
1	Drink 2	Intake 2	24	157348	1336888213	/users/cn/jespinosa/phecomp/data/CRG/20120502_FDF_CRG/20120502_FDF_CRG/20120511_FDF_CRG_c12.mtb	944	NA	WWSS	water	2	157324	1336888189	1	0.04	0.00166666666666667	3365	1
1	Food 1	Intake 3	61	157429	1336888294	/users/cn/jespinosa/phecomp/data/CRG/20120502_FDF_CRG/20120502_FDF_CRG/20120511_FDF_CRG_c12.mtb	1834	26	WWSS	food_sc	3	157368	1336888233	1	0.0200000000000005	0.000327868852459025	3366	1
1	Food 1	Intake 3	253	157708	1336888573	/users/cn/jespinosa/phecomp/data/CRG/20120502_FDF_CRG/20120502_FDF_CRG/20120511_FDF_CRG_c12.mtb	1835	30	WWSS	food_sc	3	157455	1336888320	1	0.0599999999999996	0.000237154150197627	3367	1
1	Food 1	Intake 3	168	157906	1336888771	/users/cn/jespinosa/phecomp/data/CRG/20120502_FDF_CRG/20120502_FDF_CRG/20120511_FDF_CRG_c12.mtb	1836	COLL	WWSS	food_sc	3	157738	1336888603	1	0.02	0.000119047619047619	3368	1
1	Food 2	Intake 4	44	157889	1336888754	/users/cn/jespinosa/phecomp/data/CRG/20120502_FDF_CRG/20120502_FDF_CRG/20120511_FDF_CRG_c12.mtb	2524	316	WWSS	food_sc	4	157845	1336888710	1	0.0200000000000005	0.000454545454545466	3369	1
1	Drink 2	Intake 2	23	158086	1336888951	/users/cn/jespinosa/phecomp/data/CRG/20120502_FDF_CRG/20120502_FDF_CRG/20120511_FDF_CRG_c12.mtb	945	NA	WWSS	water	2	158063	1336888928	1	0.0800000000000001	0.00347826086956522	3370	1
1	Food 1	Intake 3	128	158333	1336889198	/users/cn/jespinosa/phecomp/data/CRG/20120502_FDF_CRG/20120502_FDF_CRG/20120511_FDF_CRG_c12.mtb	1839	46	WWSS	food_sc	3	158205	1336889070	1	0.0800000000000001	0.000625000000000001	3371	1
1	Drink 1	Intake 1	15	158353	1336889218	/users/cn/jespinosa/phecomp/data/CRG/20120502_FDF_CRG/20120502_FDF_CRG/20120511_FDF_CRG_c12.mtb	1998	NA	WWSS	water	1	158338	1336889203	1	0.04	0.00266666666666667	3372	1
1	Food 1	Intake 3	178	158557	1336889422	/users/cn/jespinosa/phecomp/data/CRG/20120502_FDF_CRG/20120502_FDF_CRG/20120511_FDF_CRG_c12.mtb	1840	204	WWSS	food_sc	3	158379	1336889244	1	0.04	0.000224719101123596	3373	1
1	Drink 1	Intake 1	39	158601	1336889466	/users/cn/jespinosa/phecomp/data/CRG/20120502_FDF_CRG/20120502_FDF_CRG/20120511_FDF_CRG_c12.mtb	1999	NA	WWSS	water	1	158562	1336889427	1	0.04	0.00102564102564103	3374	1
1	Drink 1	Intake 1	31	158669	1336889534	/users/cn/jespinosa/phecomp/data/CRG/20120502_FDF_CRG/20120502_FDF_CRG/20120511_FDF_CRG_c12.mtb	2000	NA	WWSS	water	1	158638	1336889503	1	0.02	0.000645161290322581	3375	1
1	Food 1	Intake 3	197	158958	1336889823	/users/cn/jespinosa/phecomp/data/CRG/20120502_FDF_CRG/20120502_FDF_CRG/20120511_FDF_CRG_c12.mtb	1842	27	WWSS	food_sc	3	158761	1336889626	1	0.0600000000000001	0.000304568527918782	3376	1
1	Drink 1	Intake 1	20	158972	1336889837	/users/cn/jespinosa/phecomp/data/CRG/20120502_FDF_CRG/20120502_FDF_CRG/20120511_FDF_CRG_c12.mtb	2001	NA	WWSS	water	1	158952	1336889817	1	0.02	0.001	3377	1
1	Food 1	Intake 3	351	159336	1336890201	/users/cn/jespinosa/phecomp/data/CRG/20120502_FDF_CRG/20120502_FDF_CRG/20120511_FDF_CRG_c12.mtb	1843	634	WWSS	food_sc	3	158985	1336889850	1	0.0600000000000001	0.000170940170940171	3378	1
1	Drink 1	Intake 1	18	159550	1336890415	/users/cn/jespinosa/phecomp/data/CRG/20120502_FDF_CRG/20120502_FDF_CRG/20120511_FDF_CRG_c12.mtb	2002	NA	WWSS	water	1	159532	1336890397	1	0.02	0.00111111111111111	3379	1
1	Food 1	Intake 3	121	160091	1336890956	/users/cn/jespinosa/phecomp/data/CRG/20120502_FDF_CRG/20120502_FDF_CRG/20120511_FDF_CRG_c12.mtb	1845	17497	WWSS	food_sc	3	159970	1336890835	1	0.02	0.000165289256198347	3380	1
1	Drink 2	Intake 2	15	160519	1336891384	/users/cn/jespinosa/phecomp/data/CRG/20120502_FDF_CRG/20120502_FDF_CRG/20120511_FDF_CRG_c12.mtb	947	NA	WWSS	water	2	160504	1336891369	1	0.02	0.00133333333333333	3381	1
1	Drink 1	Intake 1	20	168802	1336899667	/users/cn/jespinosa/phecomp/data/CRG/20120502_FDF_CRG/20120502_FDF_CRG/20120511_FDF_CRG_c12.mtb	2004	NA	WWSS	water	1	168782	1336899647	1	0.0600000000000001	0.00300000000000001	3382	1
1	Food 1	Intake 3	16	177604	1336908469	/users/cn/jespinosa/phecomp/data/CRG/20120502_FDF_CRG/20120502_FDF_CRG/20120511_FDF_CRG_c12.mtb	1851	3408	WWSS	food_sc	3	177588	1336908453	1	0.02	0.00125	3383	1
1	Food 2	Intake 4	15	181027	1336911892	/users/cn/jespinosa/phecomp/data/CRG/20120502_FDF_CRG/20120502_FDF_CRG/20120511_FDF_CRG_c12.mtb	2537	9673	WWSS	food_sc	4	181012	1336911877	1	0.0200000000000005	0.00133333333333337	3384	1
1	Food 2	Intake 4	9	190709	1336921574	/users/cn/jespinosa/phecomp/data/CRG/20120502_FDF_CRG/20120502_FDF_CRG/20120511_FDF_CRG_c12.mtb	2540	110	WWSS	food_sc	4	190700	1336921565	1	0.0200000000000005	0.00222222222222228	3385	1
1	Food 2	Intake 4	46	190865	1336921730	/users/cn/jespinosa/phecomp/data/CRG/20120502_FDF_CRG/20120502_FDF_CRG/20120511_FDF_CRG_c12.mtb	2542	3533	WWSS	food_sc	4	190819	1336921684	1	0.04	0.000869565217391304	3386	1
1	Drink 2	Intake 2	17	191300	1336922165	/users/cn/jespinosa/phecomp/data/CRG/20120502_FDF_CRG/20120502_FDF_CRG/20120511_FDF_CRG_c12.mtb	948	NA	WWSS	water	2	191283	1336922148	1	0.0600000000000001	0.00352941176470589	3387	1
1	Food 2	Intake 4	65	194463	1336925328	/users/cn/jespinosa/phecomp/data/CRG/20120502_FDF_CRG/20120502_FDF_CRG/20120511_FDF_CRG_c12.mtb	2544	106	WWSS	food_sc	4	194398	1336925263	1	0.0600000000000005	0.000923076923076931	3388	1
1	Food 2	Intake 4	47	194616	1336925481	/users/cn/jespinosa/phecomp/data/CRG/20120502_FDF_CRG/20120502_FDF_CRG/20120511_FDF_CRG_c12.mtb	2546	3079	WWSS	food_sc	4	194569	1336925434	1	0.04	0.000851063829787234	3389	1
1	Drink 2	Intake 2	20	196151	1336927016	/users/cn/jespinosa/phecomp/data/CRG/20120502_FDF_CRG/20120502_FDF_CRG/20120511_FDF_CRG_c12.mtb	949	NA	WWSS	water	2	196131	1336926996	1	0.1	0.005	3390	1
1	Food 2	Intake 4	41	197736	1336928601	/users/cn/jespinosa/phecomp/data/CRG/20120502_FDF_CRG/20120502_FDF_CRG/20120511_FDF_CRG_c12.mtb	2547	41	WWSS	food_sc	4	197695	1336928560	1	0.0200000000000005	0.000487804878048793	3391	1
1	Food 2	Intake 4	69	197846	1336928711	/users/cn/jespinosa/phecomp/data/CRG/20120502_FDF_CRG/20120502_FDF_CRG/20120511_FDF_CRG_c12.mtb	2548	60	WWSS	food_sc	4	197777	1336928642	1	0.0599999999999996	0.000869565217391299	3392	1
1	Food 2	Intake 4	25	197931	1336928796	/users/cn/jespinosa/phecomp/data/CRG/20120502_FDF_CRG/20120502_FDF_CRG/20120511_FDF_CRG_c12.mtb	2549	65	WWSS	food_sc	4	197906	1336928771	1	0.0200000000000005	0.00080000000000002	3393	1
1	Food 2	Intake 4	38	198034	1336928899	/users/cn/jespinosa/phecomp/data/CRG/20120502_FDF_CRG/20120502_FDF_CRG/20120511_FDF_CRG_c12.mtb	2551	1772	WWSS	food_sc	4	197996	1336928861	1	0.0200000000000005	0.000526315789473697	3394	1
1	Food 2	Intake 4	68	199874	1336930739	/users/cn/jespinosa/phecomp/data/CRG/20120502_FDF_CRG/20120502_FDF_CRG/20120511_FDF_CRG_c12.mtb	2552	19	WWSS	food_sc	4	199806	1336930671	1	0.0399999999999991	0.000588235294117634	3395	1
1	Food 2	Intake 4	95	199988	1336930853	/users/cn/jespinosa/phecomp/data/CRG/20120502_FDF_CRG/20120502_FDF_CRG/20120511_FDF_CRG_c12.mtb	2553	2341	WWSS	food_sc	4	199893	1336930758	1	0.100000000000001	0.00105263157894738	3396	1
1	Drink 1	Intake 1	16	200075	1336930940	/users/cn/jespinosa/phecomp/data/CRG/20120502_FDF_CRG/20120502_FDF_CRG/20120511_FDF_CRG_c12.mtb	2007	NA	WWSS	water	1	200059	1336930924	1	0.02	0.00125	3397	1
1	Food 2	Intake 4	18	202347	1336933212	/users/cn/jespinosa/phecomp/data/CRG/20120502_FDF_CRG/20120502_FDF_CRG/20120511_FDF_CRG_c12.mtb	2555	212	WWSS	food_sc	4	202329	1336933194	1	0.42	0.0233333333333333	3398	1
1	Food 2	Intake 4	55	202614	1336933479	/users/cn/jespinosa/phecomp/data/CRG/20120502_FDF_CRG/20120502_FDF_CRG/20120511_FDF_CRG_c12.mtb	2557	479	WWSS	food_sc	4	202559	1336933424	1	0.0200000000000005	0.000363636363636373	3399	1
1	Food 1	Intake 3	129	203222	1336934087	/users/cn/jespinosa/phecomp/data/CRG/20120502_FDF_CRG/20120502_FDF_CRG/20120511_FDF_CRG_c12.mtb	1855	90	WWSS	food_sc	3	203093	1336933958	1	0.0600000000000001	0.000465116279069768	3400	1
1	Food 1	Intake 3	87	203399	1336934264	/users/cn/jespinosa/phecomp/data/CRG/20120502_FDF_CRG/20120502_FDF_CRG/20120511_FDF_CRG_c12.mtb	1856	512	WWSS	food_sc	3	203312	1336934177	1	0.02	0.000229885057471264	3401	1
1	Drink 2	Intake 2	24	203532	1336934397	/users/cn/jespinosa/phecomp/data/CRG/20120502_FDF_CRG/20120502_FDF_CRG/20120511_FDF_CRG_c12.mtb	952	NA	WWSS	water	2	203508	1336934373	1	0.0800000000000001	0.00333333333333334	3402	1
1	Food 1	Intake 3	44	203955	1336934820	/users/cn/jespinosa/phecomp/data/CRG/20120502_FDF_CRG/20120502_FDF_CRG/20120511_FDF_CRG_c12.mtb	1859	47	WWSS	food_sc	3	203911	1336934776	1	0.02	0.000454545454545455	3403	1
1	Food 1	Intake 3	67	204069	1336934934	/users/cn/jespinosa/phecomp/data/CRG/20120502_FDF_CRG/20120502_FDF_CRG/20120511_FDF_CRG_c12.mtb	1860	60	WWSS	food_sc	3	204002	1336934867	1	0.02	0.000298507462686567	3404	1
1	Food 1	Intake 3	102	204231	1336935096	/users/cn/jespinosa/phecomp/data/CRG/20120502_FDF_CRG/20120502_FDF_CRG/20120511_FDF_CRG_c12.mtb	1862	829	WWSS	food_sc	3	204129	1336934994	1	0.02	0.000196078431372549	3405	1
1	Drink 1	Intake 1	19	204339	1336935204	/users/cn/jespinosa/phecomp/data/CRG/20120502_FDF_CRG/20120502_FDF_CRG/20120511_FDF_CRG_c12.mtb	2009	NA	WWSS	water	1	204320	1336935185	1	0.02	0.00105263157894737	3406	1
1	Drink 2	Intake 2	32	204605	1336935470	/users/cn/jespinosa/phecomp/data/CRG/20120502_FDF_CRG/20120502_FDF_CRG/20120511_FDF_CRG_c12.mtb	954	NA	WWSS	water	2	204573	1336935438	1	0.1	0.003125	3407	1
1	Food 1	Intake 3	68	205128	1336935993	/users/cn/jespinosa/phecomp/data/CRG/20120502_FDF_CRG/20120502_FDF_CRG/20120511_FDF_CRG_c12.mtb	1866	20	WWSS	food_sc	3	205060	1336935925	1	0.0600000000000001	0.000882352941176472	3408	1
1	Food 1	Intake 3	9	205157	1336936022	/users/cn/jespinosa/phecomp/data/CRG/20120502_FDF_CRG/20120502_FDF_CRG/20120511_FDF_CRG_c12.mtb	1867	32	WWSS	food_sc	3	205148	1336936013	1	0.02	0.00222222222222222	3409	1
1	Food 1	Intake 3	13	205202	1336936067	/users/cn/jespinosa/phecomp/data/CRG/20120502_FDF_CRG/20120502_FDF_CRG/20120511_FDF_CRG_c12.mtb	1868	157	WWSS	food_sc	3	205189	1336936054	1	0.02	0.00153846153846154	3410	1
1	Food 1	Intake 3	194	205553	1336936418	/users/cn/jespinosa/phecomp/data/CRG/20120502_FDF_CRG/20120502_FDF_CRG/20120511_FDF_CRG_c12.mtb	1871	32	WWSS	food_sc	3	205359	1336936224	1	0.0600000000000001	0.000309278350515464	3411	1
1	Food 1	Intake 3	76	205661	1336936526	/users/cn/jespinosa/phecomp/data/CRG/20120502_FDF_CRG/20120502_FDF_CRG/20120511_FDF_CRG_c12.mtb	1872	14	WWSS	food_sc	3	205585	1336936450	1	0.02	0.000263157894736842	3412	1
1	Food 1	Intake 3	17	205692	1336936557	/users/cn/jespinosa/phecomp/data/CRG/20120502_FDF_CRG/20120502_FDF_CRG/20120511_FDF_CRG_c12.mtb	1873	2116	WWSS	food_sc	3	205675	1336936540	1	0.02	0.00117647058823529	3413	1
1	Drink 2	Intake 2	33	205899	1336936764	/users/cn/jespinosa/phecomp/data/CRG/20120502_FDF_CRG/20120502_FDF_CRG/20120511_FDF_CRG_c12.mtb	955	NA	WWSS	water	2	205866	1336936731	1	0.0799999999999996	0.00242424242424241	3414	1
1	Drink 2	Intake 2	17	207515	1336938380	/users/cn/jespinosa/phecomp/data/CRG/20120502_FDF_CRG/20120502_FDF_CRG/20120511_FDF_CRG_c12.mtb	956	NA	WWSS	water	2	207498	1336938363	1	0.02	0.00117647058823529	3415	1
1	Drink 2	Intake 2	18	207716	1336938581	/users/cn/jespinosa/phecomp/data/CRG/20120502_FDF_CRG/20120502_FDF_CRG/20120511_FDF_CRG_c12.mtb	957	NA	WWSS	water	2	207698	1336938563	1	0.04	0.00222222222222222	3416	1
1	Food 1	Intake 3	73	207881	1336938746	/users/cn/jespinosa/phecomp/data/CRG/20120502_FDF_CRG/20120502_FDF_CRG/20120511_FDF_CRG_c12.mtb	1875	73	WWSS	food_sc	3	207808	1336938673	1	0.04	0.000547945205479452	3417	1
1	Food 1	Intake 3	120	208074	1336938939	/users/cn/jespinosa/phecomp/data/CRG/20120502_FDF_CRG/20120502_FDF_CRG/20120511_FDF_CRG_c12.mtb	1877	3446	WWSS	food_sc	3	207954	1336938819	1	0.04	0.000333333333333333	3418	1
1	Drink 1	Intake 1	20	210247	1336941112	/users/cn/jespinosa/phecomp/data/CRG/20120502_FDF_CRG/20120502_FDF_CRG/20120511_FDF_CRG_c12.mtb	2013	NA	WWSS	water	1	210227	1336941092	1	0.0399999999999998	0.00199999999999999	3419	1
1	Food 1	Intake 3	39	211559	1336942424	/users/cn/jespinosa/phecomp/data/CRG/20120502_FDF_CRG/20120502_FDF_CRG/20120511_FDF_CRG_c12.mtb	1880	68	WWSS	food_sc	3	211520	1336942385	1	0.04	0.00102564102564103	3420	1
1	Food 1	Intake 3	49	211676	1336942541	/users/cn/jespinosa/phecomp/data/CRG/20120502_FDF_CRG/20120502_FDF_CRG/20120511_FDF_CRG_c12.mtb	1881	317	WWSS	food_sc	3	211627	1336942492	1	0.0600000000000001	0.00122448979591837	3421	1
1	Drink 2	Intake 2	20	211708	1336942573	/users/cn/jespinosa/phecomp/data/CRG/20120502_FDF_CRG/20120502_FDF_CRG/20120511_FDF_CRG_c12.mtb	960	NA	WWSS	water	2	211688	1336942553	1	0.04	0.002	3422	1
1	Food 1	Intake 3	94	212087	1336942952	/users/cn/jespinosa/phecomp/data/CRG/20120502_FDF_CRG/20120502_FDF_CRG/20120511_FDF_CRG_c12.mtb	1885	405	WWSS	food_sc	3	211993	1336942858	1	0.02	0.000212765957446809	3423	1
1	Drink 2	Intake 2	22	212098	1336942963	/users/cn/jespinosa/phecomp/data/CRG/20120502_FDF_CRG/20120502_FDF_CRG/20120511_FDF_CRG_c12.mtb	961	NA	WWSS	water	2	212076	1336942941	1	0.0999999999999996	0.00454545454545453	3424	1
1	Food 1	Intake 3	121	212613	1336943478	/users/cn/jespinosa/phecomp/data/CRG/20120502_FDF_CRG/20120502_FDF_CRG/20120511_FDF_CRG_c12.mtb	1889	19	WWSS	food_sc	3	212492	1336943357	1	0.02	0.000165289256198347	3425	1
1	Food 1	Intake 3	170	212802	1336943667	/users/cn/jespinosa/phecomp/data/CRG/20120502_FDF_CRG/20120502_FDF_CRG/20120511_FDF_CRG_c12.mtb	1890	14	WWSS	food_sc	3	212632	1336943497	1	0.0399999999999996	0.000235294117647056	3426	1
1	Food 1	Intake 3	105	212921	1336943786	/users/cn/jespinosa/phecomp/data/CRG/20120502_FDF_CRG/20120502_FDF_CRG/20120511_FDF_CRG_c12.mtb	1891	425	WWSS	food_sc	3	212816	1336943681	1	0.0600000000000005	0.000571428571428576	3427	1
1	Drink 2	Intake 2	34	212949	1336943814	/users/cn/jespinosa/phecomp/data/CRG/20120502_FDF_CRG/20120502_FDF_CRG/20120511_FDF_CRG_c12.mtb	963	NA	WWSS	water	2	212915	1336943780	1	0.100000000000001	0.00294117647058826	3428	1
1	Food 1	Intake 3	105	213451	1336944316	/users/cn/jespinosa/phecomp/data/CRG/20120502_FDF_CRG/20120502_FDF_CRG/20120511_FDF_CRG_c12.mtb	1894	985	WWSS	food_sc	3	213346	1336944211	1	0.02	0.00019047619047619	3429	1
1	Drink 2	Intake 2	24	213759	1336944624	/users/cn/jespinosa/phecomp/data/CRG/20120502_FDF_CRG/20120502_FDF_CRG/20120511_FDF_CRG_c12.mtb	966	NA	WWSS	water	2	213735	1336944600	1	0.0600000000000005	0.00250000000000002	3430	1
1	Food 1	Intake 3	53	214489	1336945354	/users/cn/jespinosa/phecomp/data/CRG/20120502_FDF_CRG/20120502_FDF_CRG/20120511_FDF_CRG_c12.mtb	1900	21	WWSS	food_sc	3	214436	1336945301	1	0.02	0.000377358490566038	3431	1
1	Food 1	Intake 3	149	214659	1336945524	/users/cn/jespinosa/phecomp/data/CRG/20120502_FDF_CRG/20120502_FDF_CRG/20120511_FDF_CRG_c12.mtb	1901	559	WWSS	food_sc	3	214510	1336945375	1	0.02	0.000134228187919463	3432	1
1	Food 1	Intake 3	150	215368	1336946233	/users/cn/jespinosa/phecomp/data/CRG/20120502_FDF_CRG/20120502_FDF_CRG/20120511_FDF_CRG_c12.mtb	1903	531	WWSS	food_sc	3	215218	1336946083	1	0.0800000000000001	0.000533333333333334	3433	1
1	Drink 2	Intake 2	21	215387	1336946252	/users/cn/jespinosa/phecomp/data/CRG/20120502_FDF_CRG/20120502_FDF_CRG/20120511_FDF_CRG_c12.mtb	968	NA	WWSS	water	2	215366	1336946231	1	0.04	0.0019047619047619	3434	1
1	Drink 2	Intake 2	30	215445	1336946310	/users/cn/jespinosa/phecomp/data/CRG/20120502_FDF_CRG/20120502_FDF_CRG/20120511_FDF_CRG_c12.mtb	969	NA	WWSS	water	2	215415	1336946280	1	0.04	0.00133333333333333	3435	1
1	Food 2	Intake 4	141	216040	1336946905	/users/cn/jespinosa/phecomp/data/CRG/20120502_FDF_CRG/20120502_FDF_CRG/20120511_FDF_CRG_c12.mtb	2613	537	WWSS	food_sc	4	215899	1336946764	1	0.04	0.000283687943262411	3436	1
1	Drink 2	Intake 2	17	216058	1336946923	/users/cn/jespinosa/phecomp/data/CRG/20120502_FDF_CRG/20120502_FDF_CRG/20120511_FDF_CRG_c12.mtb	970	NA	WWSS	water	2	216041	1336946906	1	0.04	0.00235294117647059	3437	1
1	Food 2	Intake 4	23	216600	1336947465	/users/cn/jespinosa/phecomp/data/CRG/20120502_FDF_CRG/20120502_FDF_CRG/20120511_FDF_CRG_c12.mtb	2615	218	WWSS	food_sc	4	216577	1336947442	1	0.0200000000000005	0.000869565217391326	3438	1
1	Food 1	Intake 3	141	216959	1336947824	/users/cn/jespinosa/phecomp/data/CRG/20120502_FDF_CRG/20120502_FDF_CRG/20120511_FDF_CRG_c12.mtb	1907	88	WWSS	food_sc	3	216818	1336947683	1	0.02	0.000141843971631206	3439	1
1	Food 1	Intake 3	18	217065	1336947930	/users/cn/jespinosa/phecomp/data/CRG/20120502_FDF_CRG/20120502_FDF_CRG/20120511_FDF_CRG_c12.mtb	1908	493	WWSS	food_sc	3	217047	1336947912	1	0.02	0.00111111111111111	3440	1
1	Food 2	Intake 4	26	217584	1336948449	/users/cn/jespinosa/phecomp/data/CRG/20120502_FDF_CRG/20120502_FDF_CRG/20120511_FDF_CRG_c12.mtb	2619	859	WWSS	food_sc	4	217558	1336948423	1	0.359999999999999	0.0138461538461538	3441	1
1	Food 2	Intake 4	72	218515	1336949380	/users/cn/jespinosa/phecomp/data/CRG/20120502_FDF_CRG/20120502_FDF_CRG/20120511_FDF_CRG_c12.mtb	2623	46	WWSS	food_sc	4	218443	1336949308	1	0.0200000000000005	0.000277777777777785	3442	1
1	Food 2	Intake 4	68	218629	1336949494	/users/cn/jespinosa/phecomp/data/CRG/20120502_FDF_CRG/20120502_FDF_CRG/20120511_FDF_CRG_c12.mtb	2624	5541	WWSS	food_sc	4	218561	1336949426	1	0.0200000000000005	0.000294117647058831	3443	1
1	Drink 1	Intake 1	20	218992	1336949857	/users/cn/jespinosa/phecomp/data/CRG/20120502_FDF_CRG/20120502_FDF_CRG/20120511_FDF_CRG_c12.mtb	2022	NA	WWSS	water	1	218972	1336949837	1	0.04	0.002	3444	1
1	Drink 2	Intake 2	15	218996	1336949861	/users/cn/jespinosa/phecomp/data/CRG/20120502_FDF_CRG/20120502_FDF_CRG/20120511_FDF_CRG_c12.mtb	974	NA	WWSS	water	2	218981	1336949846	1	0.0200000000000005	0.00133333333333337	3445	1
1	Drink 2	Intake 2	29	219058	1336949923	/users/cn/jespinosa/phecomp/data/CRG/20120502_FDF_CRG/20120502_FDF_CRG/20120511_FDF_CRG_c12.mtb	975	NA	WWSS	water	2	219029	1336949894	1	0.04	0.00137931034482759	3446	1
1	Food 2	Intake 4	34	224204	1336955069	/users/cn/jespinosa/phecomp/data/CRG/20120502_FDF_CRG/20120502_FDF_CRG/20120511_FDF_CRG_c12.mtb	2628	16	WWSS	food_sc	4	224170	1336955035	1	0.04	0.00117647058823529	3447	1
1	Food 2	Intake 4	100	224320	1336955185	/users/cn/jespinosa/phecomp/data/CRG/20120502_FDF_CRG/20120502_FDF_CRG/20120511_FDF_CRG_c12.mtb	2629	15	WWSS	food_sc	4	224220	1336955085	1	0.0999999999999996	0.000999999999999996	3448	1
1	Food 1	Intake 3	101	224436	1336955301	/users/cn/jespinosa/phecomp/data/CRG/20120502_FDF_CRG/20120502_FDF_CRG/20120511_FDF_CRG_c12.mtb	1918	104	WWSS	food_sc	3	224335	1336955200	1	0.04	0.000396039603960396	3449	1
1	Drink 2	Intake 2	12	224442	1336955307	/users/cn/jespinosa/phecomp/data/CRG/20120502_FDF_CRG/20120502_FDF_CRG/20120511_FDF_CRG_c12.mtb	976	NA	WWSS	water	2	224430	1336955295	1	0.04	0.00333333333333333	3450	1
1	Food 1	Intake 3	121	224661	1336955526	/users/cn/jespinosa/phecomp/data/CRG/20120502_FDF_CRG/20120502_FDF_CRG/20120511_FDF_CRG_c12.mtb	1920	164	WWSS	food_sc	3	224540	1336955405	1	0.0600000000000005	0.000495867768595045	3451	1
1	Drink 1	Intake 1	21	224718	1336955583	/users/cn/jespinosa/phecomp/data/CRG/20120502_FDF_CRG/20120502_FDF_CRG/20120511_FDF_CRG_c12.mtb	2023	NA	WWSS	water	1	224697	1336955562	1	0.02	0.000952380952380952	3452	1
1	Food 2	Intake 4	89	224914	1336955779	/users/cn/jespinosa/phecomp/data/CRG/20120502_FDF_CRG/20120502_FDF_CRG/20120511_FDF_CRG_c12.mtb	2635	480	WWSS	food_sc	4	224825	1336955690	1	0.0200000000000005	0.000224719101123601	3453	1
1	Drink 2	Intake 2	26	224934	1336955799	/users/cn/jespinosa/phecomp/data/CRG/20120502_FDF_CRG/20120502_FDF_CRG/20120511_FDF_CRG_c12.mtb	978	NA	WWSS	water	2	224908	1336955773	1	0.0800000000000001	0.00307692307692308	3454	1
1	Drink 1	Intake 1	19	225366	1336956231	/users/cn/jespinosa/phecomp/data/CRG/20120502_FDF_CRG/20120502_FDF_CRG/20120511_FDF_CRG_c12.mtb	2025	NA	WWSS	water	1	225347	1336956212	1	0.02	0.00105263157894737	3455	1
1	Food 2	Intake 4	103	225497	1336956362	/users/cn/jespinosa/phecomp/data/CRG/20120502_FDF_CRG/20120502_FDF_CRG/20120511_FDF_CRG_c12.mtb	2638	61	WWSS	food_sc	4	225394	1336956259	1	0.0200000000000005	0.000194174757281558	3456	1
1	Drink 2	Intake 2	21	225538	1336956403	/users/cn/jespinosa/phecomp/data/CRG/20120502_FDF_CRG/20120502_FDF_CRG/20120511_FDF_CRG_c12.mtb	981	NA	WWSS	water	2	225517	1336956382	1	0.0599999999999996	0.00285714285714284	3457	1
1	Food 2	Intake 4	88	225646	1336956511	/users/cn/jespinosa/phecomp/data/CRG/20120502_FDF_CRG/20120502_FDF_CRG/20120511_FDF_CRG_c12.mtb	2639	245	WWSS	food_sc	4	225558	1336956423	1	0.04	0.000454545454545455	3458	1
1	Food 1	Intake 3	147	226038	1336956903	/users/cn/jespinosa/phecomp/data/CRG/20120502_FDF_CRG/20120502_FDF_CRG/20120511_FDF_CRG_c12.mtb	1928	645	WWSS	food_sc	3	225891	1336956756	1	0.04	0.000272108843537415	3459	1
1	Drink 1	Intake 1	17	226055	1336956920	/users/cn/jespinosa/phecomp/data/CRG/20120502_FDF_CRG/20120502_FDF_CRG/20120511_FDF_CRG_c12.mtb	2026	NA	WWSS	water	1	226038	1336956903	1	0.0399999999999998	0.00235294117647058	3460	1
1	Food 1	Intake 3	80	226763	1336957628	/users/cn/jespinosa/phecomp/data/CRG/20120502_FDF_CRG/20120502_FDF_CRG/20120511_FDF_CRG_c12.mtb	1929	145	WWSS	food_sc	3	226683	1336957548	1	0.0200000000000005	0.000250000000000006	3461	1
1	Drink 2	Intake 2	22	226883	1336957748	/users/cn/jespinosa/phecomp/data/CRG/20120502_FDF_CRG/20120502_FDF_CRG/20120511_FDF_CRG_c12.mtb	984	NA	WWSS	water	2	226861	1336957726	1	0.04	0.00181818181818182	3462	1
1	Drink 1	Intake 1	20	226889	1336957754	/users/cn/jespinosa/phecomp/data/CRG/20120502_FDF_CRG/20120502_FDF_CRG/20120511_FDF_CRG_c12.mtb	2028	NA	WWSS	water	1	226869	1336957734	1	0.02	0.001	3463	1
1	Food 1	Intake 3	68	226976	1336957841	/users/cn/jespinosa/phecomp/data/CRG/20120502_FDF_CRG/20120502_FDF_CRG/20120511_FDF_CRG_c12.mtb	1931	5390	WWSS	food_sc	3	226908	1336957773	1	0.0200000000000005	0.000294117647058831	3464	1
1	Drink 2	Intake 2	24	227002	1336957867	/users/cn/jespinosa/phecomp/data/CRG/20120502_FDF_CRG/20120502_FDF_CRG/20120511_FDF_CRG_c12.mtb	985	NA	WWSS	water	2	226978	1336957843	1	0.04	0.00166666666666667	3465	1
1	Food 1	Intake 3	28	232394	1336963259	/users/cn/jespinosa/phecomp/data/CRG/20120502_FDF_CRG/20120502_FDF_CRG/20120511_FDF_CRG_c12.mtb	1932	15	WWSS	food_sc	3	232366	1336963231	1	0.04	0.00142857142857143	3466	1
1	Food 1	Intake 3	12	232421	1336963286	/users/cn/jespinosa/phecomp/data/CRG/20120502_FDF_CRG/20120502_FDF_CRG/20120511_FDF_CRG_c12.mtb	1933	41	WWSS	food_sc	3	232409	1336963274	1	0.04	0.00333333333333333	3467	1
1	Food 1	Intake 3	9	232471	1336963336	/users/cn/jespinosa/phecomp/data/CRG/20120502_FDF_CRG/20120502_FDF_CRG/20120511_FDF_CRG_c12.mtb	1935	27	WWSS	food_sc	3	232462	1336963327	1	0.04	0.00444444444444444	3468	1
1	Food 1	Intake 3	8	232506	1336963371	/users/cn/jespinosa/phecomp/data/CRG/20120502_FDF_CRG/20120502_FDF_CRG/20120511_FDF_CRG_c12.mtb	1936	17	WWSS	food_sc	3	232498	1336963363	1	0.0200000000000005	0.00250000000000006	3469	1
1	Food 1	Intake 3	25	232548	1336963413	/users/cn/jespinosa/phecomp/data/CRG/20120502_FDF_CRG/20120502_FDF_CRG/20120511_FDF_CRG_c12.mtb	1937	2947	WWSS	food_sc	3	232523	1336963388	1	0.04	0.0016	3470	1
1	Food 1	Intake 3	24	235519	1336966384	/users/cn/jespinosa/phecomp/data/CRG/20120502_FDF_CRG/20120502_FDF_CRG/20120511_FDF_CRG_c12.mtb	1939	1712	WWSS	food_sc	3	235495	1336966360	1	0.04	0.00166666666666667	3471	1
1	Food 1	Intake 3	55	237286	1336968151	/users/cn/jespinosa/phecomp/data/CRG/20120502_FDF_CRG/20120502_FDF_CRG/20120511_FDF_CRG_c12.mtb	1941	239	WWSS	food_sc	3	237231	1336968096	1	0.0600000000000005	0.0010909090909091	3472	1
1	Food 1	Intake 3	118	237643	1336968508	/users/cn/jespinosa/phecomp/data/CRG/20120502_FDF_CRG/20120502_FDF_CRG/20120511_FDF_CRG_c12.mtb	1945	1822	WWSS	food_sc	3	237525	1336968390	1	0.04	0.000338983050847458	3473	1
1	Drink 2	Intake 2	29	237665	1336968530	/users/cn/jespinosa/phecomp/data/CRG/20120502_FDF_CRG/20120502_FDF_CRG/20120511_FDF_CRG_c12.mtb	986	NA	WWSS	water	2	237636	1336968501	1	0.0600000000000005	0.0020689655172414	3474	1
1	Drink 2	Intake 2	17	238554	1336969419	/users/cn/jespinosa/phecomp/data/CRG/20120502_FDF_CRG/20120502_FDF_CRG/20120511_FDF_CRG_c12.mtb	987	NA	WWSS	water	2	238537	1336969402	1	0.0599999999999996	0.00352941176470586	3475	1
1	Food 2	Intake 4	88	239553	1336970418	/users/cn/jespinosa/phecomp/data/CRG/20120502_FDF_CRG/20120502_FDF_CRG/20120511_FDF_CRG_c12.mtb	2651	171	WWSS	food_sc	4	239465	1336970330	1	0.0200000000000005	0.000227272727272733	3476	1
1	Food 1	Intake 3	110	239834	1336970699	/users/cn/jespinosa/phecomp/data/CRG/20120502_FDF_CRG/20120502_FDF_CRG/20120511_FDF_CRG_c12.mtb	1949	157	WWSS	food_sc	3	239724	1336970589	1	0.04	0.000363636363636364	3477	1
1	Drink 2	Intake 2	24	239999	1336970864	/users/cn/jespinosa/phecomp/data/CRG/20120502_FDF_CRG/20120502_FDF_CRG/20120511_FDF_CRG_c12.mtb	988	NA	WWSS	water	2	239975	1336970840	1	0.0800000000000001	0.00333333333333334	3478	1
1	Food 2	Intake 4	104	240095	1336970960	/users/cn/jespinosa/phecomp/data/CRG/20120502_FDF_CRG/20120502_FDF_CRG/20120511_FDF_CRG_c12.mtb	2656	323	WWSS	food_sc	4	239991	1336970856	1	0.34	0.00326923076923077	3479	1
1	Drink 2	Intake 2	30	240384	1336971249	/users/cn/jespinosa/phecomp/data/CRG/20120502_FDF_CRG/20120502_FDF_CRG/20120511_FDF_CRG_c12.mtb	989	NA	WWSS	water	2	240354	1336971219	1	0.0600000000000005	0.00200000000000002	3480	1
1	Food 1	Intake 3	55	240473	1336971338	/users/cn/jespinosa/phecomp/data/CRG/20120502_FDF_CRG/20120502_FDF_CRG/20120511_FDF_CRG_c12.mtb	1953	423	WWSS	food_sc	3	240418	1336971283	1	0.0800000000000001	0.00145454545454546	3481	1
1	Drink 2	Intake 2	23	240534	1336971399	/users/cn/jespinosa/phecomp/data/CRG/20120502_FDF_CRG/20120502_FDF_CRG/20120511_FDF_CRG_c12.mtb	990	NA	WWSS	water	2	240511	1336971376	1	0.0399999999999991	0.00173913043478257	3482	1
1	Food 2	Intake 4	47	240943	1336971808	/users/cn/jespinosa/phecomp/data/CRG/20120502_FDF_CRG/20120502_FDF_CRG/20120511_FDF_CRG_c12.mtb	2664	402	WWSS	food_sc	4	240896	1336971761	1	0.0200000000000005	0.000425531914893628	3483	1
1	Drink 2	Intake 2	25	240970	1336971835	/users/cn/jespinosa/phecomp/data/CRG/20120502_FDF_CRG/20120502_FDF_CRG/20120511_FDF_CRG_c12.mtb	991	NA	WWSS	water	2	240945	1336971810	1	0.100000000000001	0.00400000000000004	3484	1
1	Food 1	Intake 3	78	241423	1336972288	/users/cn/jespinosa/phecomp/data/CRG/20120502_FDF_CRG/20120502_FDF_CRG/20120511_FDF_CRG_c12.mtb	1957	21	WWSS	food_sc	3	241345	1336972210	1	0.04	0.000512820512820513	3485	1
1	Food 1	Intake 3	160	241604	1336972469	/users/cn/jespinosa/phecomp/data/CRG/20120502_FDF_CRG/20120502_FDF_CRG/20120511_FDF_CRG_c12.mtb	1958	513	WWSS	food_sc	3	241444	1336972309	1	0.04	0.00025	3486	1
1	Drink 2	Intake 2	18	242059	1336972924	/users/cn/jespinosa/phecomp/data/CRG/20120502_FDF_CRG/20120502_FDF_CRG/20120511_FDF_CRG_c12.mtb	992	NA	WWSS	water	2	242041	1336972906	1	0.04	0.00222222222222222	3487	1
1	Food 1	Intake 3	136	242253	1336973118	/users/cn/jespinosa/phecomp/data/CRG/20120502_FDF_CRG/20120502_FDF_CRG/20120511_FDF_CRG_c12.mtb	1961	4	WWSS	food_sc	3	242117	1336972982	1	0.04	0.000294117647058824	3488	1
1	Food 1	Intake 3	193	242450	1336973315	/users/cn/jespinosa/phecomp/data/CRG/20120502_FDF_CRG/20120502_FDF_CRG/20120511_FDF_CRG_c12.mtb	1962	27	WWSS	food_sc	3	242257	1336973122	1	0.04	0.000207253886010363	3489	1
1	Food 1	Intake 3	79	242556	1336973421	/users/cn/jespinosa/phecomp/data/CRG/20120502_FDF_CRG/20120502_FDF_CRG/20120511_FDF_CRG_c12.mtb	1963	540	WWSS	food_sc	3	242477	1336973342	1	0.0200000000000005	0.000253164556962032	3490	1
1	Drink 2	Intake 2	29	242785	1336973650	/users/cn/jespinosa/phecomp/data/CRG/20120502_FDF_CRG/20120502_FDF_CRG/20120511_FDF_CRG_c12.mtb	993	NA	WWSS	water	2	242756	1336973621	1	0.0999999999999996	0.00344827586206895	3491	1
1	Food 2	Intake 4	78	243174	1336974039	/users/cn/jespinosa/phecomp/data/CRG/20120502_FDF_CRG/20120502_FDF_CRG/20120511_FDF_CRG_c12.mtb	2681	COLL	WWSS	food_sc	4	243096	1336973961	1	0.0200000000000005	0.000256410256410263	3492	1
1	Food 1	Intake 3	59	243204	1336974069	/users/cn/jespinosa/phecomp/data/CRG/20120502_FDF_CRG/20120502_FDF_CRG/20120511_FDF_CRG_c12.mtb	1972	55	WWSS	food_sc	3	243145	1336974010	1	0.04	0.000677966101694915	3493	1
1	Food 1	Intake 3	114	243373	1336974238	/users/cn/jespinosa/phecomp/data/CRG/20120502_FDF_CRG/20120502_FDF_CRG/20120511_FDF_CRG_c12.mtb	1973	23	WWSS	food_sc	3	243259	1336974124	1	0.04	0.000350877192982456	3494	1
1	Food 1	Intake 3	48	243444	1336974309	/users/cn/jespinosa/phecomp/data/CRG/20120502_FDF_CRG/20120502_FDF_CRG/20120511_FDF_CRG_c12.mtb	1974	117	WWSS	food_sc	3	243396	1336974261	1	0.04	0.000833333333333333	3495	1
1	Food 1	Intake 3	81	243642	1336974507	/users/cn/jespinosa/phecomp/data/CRG/20120502_FDF_CRG/20120502_FDF_CRG/20120511_FDF_CRG_c12.mtb	1975	4	WWSS	food_sc	3	243561	1336974426	1	0.04	0.000493827160493827	3496	1
1	Food 1	Intake 3	167	243813	1336974678	/users/cn/jespinosa/phecomp/data/CRG/20120502_FDF_CRG/20120502_FDF_CRG/20120511_FDF_CRG_c12.mtb	1976	213	WWSS	food_sc	3	243646	1336974511	1	0.04	0.000239520958083832	3497	1
1	Drink 2	Intake 2	14	243869	1336974734	/users/cn/jespinosa/phecomp/data/CRG/20120502_FDF_CRG/20120502_FDF_CRG/20120511_FDF_CRG_c12.mtb	994	NA	WWSS	water	2	243855	1336974720	1	0.0200000000000005	0.00142857142857146	3498	1
1	Food 1	Intake 3	66	244092	1336974957	/users/cn/jespinosa/phecomp/data/CRG/20120502_FDF_CRG/20120502_FDF_CRG/20120511_FDF_CRG_c12.mtb	1979	32	WWSS	food_sc	3	244026	1336974891	1	0.44	0.00666666666666667	3499	1
1	Food 1	Intake 3	68	244192	1336975057	/users/cn/jespinosa/phecomp/data/CRG/20120502_FDF_CRG/20120502_FDF_CRG/20120511_FDF_CRG_c12.mtb	1980	102	WWSS	food_sc	3	244124	1336974989	1	0.0400000000000009	0.00058823529411766	3500	1
1	Food 2	Intake 4	150	244444	1336975309	/users/cn/jespinosa/phecomp/data/CRG/20120502_FDF_CRG/20120502_FDF_CRG/20120511_FDF_CRG_c12.mtb	2693	245	WWSS	food_sc	4	244294	1336975159	1	0.04	0.000266666666666667	3501	1
1	Drink 2	Intake 2	28	244612	1336975477	/users/cn/jespinosa/phecomp/data/CRG/20120502_FDF_CRG/20120502_FDF_CRG/20120511_FDF_CRG_c12.mtb	995	NA	WWSS	water	2	244584	1336975449	1	0.0999999999999996	0.00357142857142856	3502	1
1	Food 1	Intake 3	334	245023	1336975888	/users/cn/jespinosa/phecomp/data/CRG/20120502_FDF_CRG/20120502_FDF_CRG/20120511_FDF_CRG_c12.mtb	1983	281	WWSS	food_sc	3	244689	1336975554	1	0.0999999999999996	0.000299401197604789	3503	1
1	Drink 2	Intake 2	26	245229	1336976094	/users/cn/jespinosa/phecomp/data/CRG/20120502_FDF_CRG/20120502_FDF_CRG/20120511_FDF_CRG_c12.mtb	996	NA	WWSS	water	2	245203	1336976068	1	0.0600000000000005	0.00230769230769233	3504	1
1	Food 1	Intake 3	305	245609	1336976474	/users/cn/jespinosa/phecomp/data/CRG/20120502_FDF_CRG/20120502_FDF_CRG/20120511_FDF_CRG_c12.mtb	1985	1482	WWSS	food_sc	3	245304	1336976169	1	0.04	0.000131147540983607	3505	1
1	Drink 2	Intake 2	25	245638	1336976503	/users/cn/jespinosa/phecomp/data/CRG/20120502_FDF_CRG/20120502_FDF_CRG/20120511_FDF_CRG_c12.mtb	997	NA	WWSS	water	2	245613	1336976478	1	0.0799999999999992	0.00319999999999997	3506	1
1	Food 1	Intake 3	203	247294	1336978159	/users/cn/jespinosa/phecomp/data/CRG/20120502_FDF_CRG/20120502_FDF_CRG/20120511_FDF_CRG_c12.mtb	1989	736	WWSS	food_sc	3	247091	1336977956	1	0.0600000000000005	0.000295566502463057	3507	1
1	Food 1	Intake 3	97	248127	1336978992	/users/cn/jespinosa/phecomp/data/CRG/20120502_FDF_CRG/20120502_FDF_CRG/20120511_FDF_CRG_c12.mtb	1990	14143	WWSS	food_sc	3	248030	1336978895	1	0.04	0.000412371134020619	3508	1
1	Drink 1	Intake 1	53	248905	1336979770	/users/cn/jespinosa/phecomp/data/CRG/20120502_FDF_CRG/20120502_FDF_CRG/20120511_FDF_CRG_c12.mtb	2035	NA	WWSS	water	1	248852	1336979717	1	0.02	0.000377358490566038	3509	1
1	Drink 2	Intake 2	18	249007	1336979872	/users/cn/jespinosa/phecomp/data/CRG/20120502_FDF_CRG/20120502_FDF_CRG/20120511_FDF_CRG_c12.mtb	1000	NA	WWSS	water	2	248989	1336979854	1	0.0200000000000005	0.00111111111111114	3510	1
1	Drink 1	Intake 1	28	312	1336992485	/users/cn/jespinosa/phecomp/data/CRG/20120502_FDF_CRG/20120502_FDF_CRG/20120514_FDF_CRG_c12.mtb	2148	NA	WWSS	water	1	284	1336992457	1	0.02	0.000714285714285714	3511	1
1	Drink 1	Intake 1	35	526	1336992699	/users/cn/jespinosa/phecomp/data/CRG/20120502_FDF_CRG/20120502_FDF_CRG/20120514_FDF_CRG_c12.mtb	2150	NA	WWSS	water	1	491	1336992664	1	0.02	0.000571428571428571	3512	1
1	Drink 1	Intake 1	23	860	1336993033	/users/cn/jespinosa/phecomp/data/CRG/20120502_FDF_CRG/20120502_FDF_CRG/20120514_FDF_CRG_c12.mtb	2154	NA	WWSS	water	1	837	1336993010	1	0.02	0.000869565217391304	3513	1
1	Food 2	Intake 4	76	1038	1336993211	/users/cn/jespinosa/phecomp/data/CRG/20120502_FDF_CRG/20120502_FDF_CRG/20120514_FDF_CRG_c12.mtb	2801	25	WWSS	food_sc	4	962	1336993135	1	0.02	0.000263157894736842	3514	1
1	Food 2	Intake 4	56	1119	1336993292	/users/cn/jespinosa/phecomp/data/CRG/20120502_FDF_CRG/20120502_FDF_CRG/20120514_FDF_CRG_c12.mtb	2802	4	WWSS	food_sc	4	1063	1336993236	1	0.02	0.000357142857142857	3515	1
1	Food 2	Intake 4	75	1198	1336993371	/users/cn/jespinosa/phecomp/data/CRG/20120502_FDF_CRG/20120502_FDF_CRG/20120514_FDF_CRG_c12.mtb	2803	COLL	WWSS	food_sc	4	1123	1336993296	1	0.02	0.000266666666666667	3516	1
1	Food 1	Intake 3	51	1236	1336993409	/users/cn/jespinosa/phecomp/data/CRG/20120502_FDF_CRG/20120502_FDF_CRG/20120514_FDF_CRG_c12.mtb	2103	354	WWSS	food_sc	3	1185	1336993358	1	0.02	0.000392156862745098	3517	1
1	Drink 1	Intake 1	28	1535	1336993708	/users/cn/jespinosa/phecomp/data/CRG/20120502_FDF_CRG/20120502_FDF_CRG/20120514_FDF_CRG_c12.mtb	2159	NA	WWSS	water	1	1507	1336993680	1	0.04	0.00142857142857143	3518	1
1	Food 1	Intake 3	40	1630	1336993803	/users/cn/jespinosa/phecomp/data/CRG/20120502_FDF_CRG/20120502_FDF_CRG/20120514_FDF_CRG_c12.mtb	2105	349	WWSS	food_sc	3	1590	1336993763	1	0.02	0.0005	3519	1
1	Drink 1	Intake 1	17	1683	1336993856	/users/cn/jespinosa/phecomp/data/CRG/20120502_FDF_CRG/20120502_FDF_CRG/20120514_FDF_CRG_c12.mtb	2160	NA	WWSS	water	1	1666	1336993839	1	0.02	0.00117647058823529	3520	1
1	Drink 1	Intake 1	18	1715	1336993888	/users/cn/jespinosa/phecomp/data/CRG/20120502_FDF_CRG/20120502_FDF_CRG/20120514_FDF_CRG_c12.mtb	2161	NA	WWSS	water	1	1697	1336993870	1	0.04	0.00222222222222222	3521	1
1	Food 1	Intake 3	71	2050	1336994223	/users/cn/jespinosa/phecomp/data/CRG/20120502_FDF_CRG/20120502_FDF_CRG/20120514_FDF_CRG_c12.mtb	2108	246	WWSS	food_sc	3	1979	1336994152	1	0.02	0.00028169014084507	3522	1
1	Drink 1	Intake 1	23	2262	1336994435	/users/cn/jespinosa/phecomp/data/CRG/20120502_FDF_CRG/20120502_FDF_CRG/20120514_FDF_CRG_c12.mtb	2162	NA	WWSS	water	1	2239	1336994412	1	0.04	0.00173913043478261	3523	1
1	Food 1	Intake 3	62	2358	1336994531	/users/cn/jespinosa/phecomp/data/CRG/20120502_FDF_CRG/20120502_FDF_CRG/20120514_FDF_CRG_c12.mtb	2111	36	WWSS	food_sc	3	2296	1336994469	1	0.02	0.00032258064516129	3524	1
1	Food 1	Intake 3	36	2430	1336994603	/users/cn/jespinosa/phecomp/data/CRG/20120502_FDF_CRG/20120502_FDF_CRG/20120514_FDF_CRG_c12.mtb	2112	24010	WWSS	food_sc	3	2394	1336994567	1	0.02	0.000555555555555556	3525	1
1	Drink 2	Intake 2	22	14037	1337006210	/users/cn/jespinosa/phecomp/data/CRG/20120502_FDF_CRG/20120502_FDF_CRG/20120514_FDF_CRG_c12.mtb	1041	NA	WWSS	water	2	14015	1337006188	1	0.04	0.00181818181818182	3526	1
1	Food 2	Intake 4	74	26514	1337018687	/users/cn/jespinosa/phecomp/data/CRG/20120502_FDF_CRG/20120502_FDF_CRG/20120514_FDF_CRG_c12.mtb	2814	29	WWSS	food_sc	4	26440	1337018613	1	0.02	0.00027027027027027	3527	1
1	Food 2	Intake 4	12	26555	1337018728	/users/cn/jespinosa/phecomp/data/CRG/20120502_FDF_CRG/20120502_FDF_CRG/20120514_FDF_CRG_c12.mtb	2815	37	WWSS	food_sc	4	26543	1337018716	1	0.02	0.00166666666666667	3528	1
1	Food 2	Intake 4	49	26641	1337018814	/users/cn/jespinosa/phecomp/data/CRG/20120502_FDF_CRG/20120502_FDF_CRG/20120514_FDF_CRG_c12.mtb	2816	8	WWSS	food_sc	4	26592	1337018765	1	0.04	0.000816326530612245	3529	1
1	Food 1	Intake 3	102	26751	1337018924	/users/cn/jespinosa/phecomp/data/CRG/20120502_FDF_CRG/20120502_FDF_CRG/20120514_FDF_CRG_c12.mtb	2117	64	WWSS	food_sc	3	26649	1337018822	1	0.04	0.000392156862745098	3530	1
1	Food 1	Intake 3	137	26952	1337019125	/users/cn/jespinosa/phecomp/data/CRG/20120502_FDF_CRG/20120502_FDF_CRG/20120514_FDF_CRG_c12.mtb	2118	1424	WWSS	food_sc	3	26815	1337018988	1	0.02	0.000145985401459854	3531	1
1	Drink 1	Intake 1	30	26979	1337019152	/users/cn/jespinosa/phecomp/data/CRG/20120502_FDF_CRG/20120502_FDF_CRG/20120514_FDF_CRG_c12.mtb	2164	NA	WWSS	water	1	26949	1337019122	1	0.08	0.00266666666666667	3532	1
1	Drink 1	Intake 1	12	28327	1337020500	/users/cn/jespinosa/phecomp/data/CRG/20120502_FDF_CRG/20120502_FDF_CRG/20120514_FDF_CRG_c12.mtb	2165	NA	WWSS	water	1	28315	1337020488	1	0.04	0.00333333333333333	3533	1
1	Food 2	Intake 4	72	28448	1337020621	/users/cn/jespinosa/phecomp/data/CRG/20120502_FDF_CRG/20120502_FDF_CRG/20120514_FDF_CRG_c12.mtb	2818	4	WWSS	food_sc	4	28376	1337020549	1	0.04	0.000555555555555556	3534	1
1	Food 2	Intake 4	49	28501	1337020674	/users/cn/jespinosa/phecomp/data/CRG/20120502_FDF_CRG/20120502_FDF_CRG/20120514_FDF_CRG_c12.mtb	2819	24	WWSS	food_sc	4	28452	1337020625	1	0.02	0.000408163265306122	3535	1
1	Food 2	Intake 4	230	28755	1337020928	/users/cn/jespinosa/phecomp/data/CRG/20120502_FDF_CRG/20120502_FDF_CRG/20120514_FDF_CRG_c12.mtb	2820	418	WWSS	food_sc	4	28525	1337020698	1	0.08	0.000347826086956522	3536	1
1	Drink 2	Intake 2	13	28775	1337020948	/users/cn/jespinosa/phecomp/data/CRG/20120502_FDF_CRG/20120502_FDF_CRG/20120514_FDF_CRG_c12.mtb	1042	NA	WWSS	water	2	28762	1337020935	1	0.08	0.00615384615384615	3537	1
1	Food 2	Intake 4	186	29359	1337021532	/users/cn/jespinosa/phecomp/data/CRG/20120502_FDF_CRG/20120502_FDF_CRG/20120514_FDF_CRG_c12.mtb	2822	52	WWSS	food_sc	4	29173	1337021346	1	0.06	0.00032258064516129	3538	1
1	Drink 2	Intake 2	27	29379	1337021552	/users/cn/jespinosa/phecomp/data/CRG/20120502_FDF_CRG/20120502_FDF_CRG/20120514_FDF_CRG_c12.mtb	1043	NA	WWSS	water	2	29352	1337021525	1	0.04	0.00148148148148148	3539	1
1	Food 2	Intake 4	249	29660	1337021833	/users/cn/jespinosa/phecomp/data/CRG/20120502_FDF_CRG/20120502_FDF_CRG/20120514_FDF_CRG_c12.mtb	2823	2717	WWSS	food_sc	4	29411	1337021584	1	0.08	0.000321285140562249	3540	1
1	Drink 2	Intake 2	26	29697	1337021870	/users/cn/jespinosa/phecomp/data/CRG/20120502_FDF_CRG/20120502_FDF_CRG/20120514_FDF_CRG_c12.mtb	1044	NA	WWSS	water	2	29671	1337021844	1	0.1	0.00384615384615385	3541	1
1	Drink 1	Intake 1	28	31823	1337023996	/users/cn/jespinosa/phecomp/data/CRG/20120502_FDF_CRG/20120502_FDF_CRG/20120514_FDF_CRG_c12.mtb	2166	NA	WWSS	water	1	31795	1337023968	1	0.02	0.000714285714285714	3542	1
1	Food 2	Intake 4	171	32548	1337024721	/users/cn/jespinosa/phecomp/data/CRG/20120502_FDF_CRG/20120502_FDF_CRG/20120514_FDF_CRG_c12.mtb	2824	9	WWSS	food_sc	4	32377	1337024550	1	0.1	0.000584795321637427	3543	1
1	Food 2	Intake 4	247	32804	1337024977	/users/cn/jespinosa/phecomp/data/CRG/20120502_FDF_CRG/20120502_FDF_CRG/20120514_FDF_CRG_c12.mtb	2825	106	WWSS	food_sc	4	32557	1337024730	1	0.1	0.000404858299595142	3544	1
1	Drink 1	Intake 1	33	32911	1337025084	/users/cn/jespinosa/phecomp/data/CRG/20120502_FDF_CRG/20120502_FDF_CRG/20120514_FDF_CRG_c12.mtb	2167	NA	WWSS	water	1	32878	1337025051	1	0.1	0.00303030303030303	3545	1
1	Food 2	Intake 4	89	32999	1337025172	/users/cn/jespinosa/phecomp/data/CRG/20120502_FDF_CRG/20120502_FDF_CRG/20120514_FDF_CRG_c12.mtb	2827	1906	WWSS	food_sc	4	32910	1337025083	1	0.02	0.000224719101123596	3546	1
1	Food 2	Intake 4	157	35062	1337027235	/users/cn/jespinosa/phecomp/data/CRG/20120502_FDF_CRG/20120502_FDF_CRG/20120514_FDF_CRG_c12.mtb	2828	30	WWSS	food_sc	4	34905	1337027078	1	0.02	0.000127388535031847	3547	1
1	Food 2	Intake 4	156	35248	1337027421	/users/cn/jespinosa/phecomp/data/CRG/20120502_FDF_CRG/20120502_FDF_CRG/20120514_FDF_CRG_c12.mtb	2829	8	WWSS	food_sc	4	35092	1337027265	1	0.0599999999999999	0.000384615384615384	3548	1
1	Food 2	Intake 4	276	35532	1337027705	/users/cn/jespinosa/phecomp/data/CRG/20120502_FDF_CRG/20120502_FDF_CRG/20120514_FDF_CRG_c12.mtb	2830	243	WWSS	food_sc	4	35256	1337027429	1	0.14	0.000507246376811594	3549	1
1	Drink 1	Intake 1	25	35552	1337027725	/users/cn/jespinosa/phecomp/data/CRG/20120502_FDF_CRG/20120502_FDF_CRG/20120514_FDF_CRG_c12.mtb	2168	NA	WWSS	water	1	35527	1337027700	1	0.06	0.0024	3550	1
1	Drink 2	Intake 2	33	35802	1337027975	/users/cn/jespinosa/phecomp/data/CRG/20120502_FDF_CRG/20120502_FDF_CRG/20120514_FDF_CRG_c12.mtb	1045	NA	WWSS	water	2	35769	1337027942	1	0.02	0.000606060606060606	3551	1
1	Food 1	Intake 3	133	35908	1337028081	/users/cn/jespinosa/phecomp/data/CRG/20120502_FDF_CRG/20120502_FDF_CRG/20120514_FDF_CRG_c12.mtb	2121	135	WWSS	food_sc	3	35775	1337027948	1	0.04	0.000300751879699248	3552	1
1	Food 1	Intake 3	82	36125	1337028298	/users/cn/jespinosa/phecomp/data/CRG/20120502_FDF_CRG/20120502_FDF_CRG/20120514_FDF_CRG_c12.mtb	2122	3815	WWSS	food_sc	3	36043	1337028216	1	0.02	0.00024390243902439	3553	1
1	Drink 1	Intake 1	29	36222	1337028395	/users/cn/jespinosa/phecomp/data/CRG/20120502_FDF_CRG/20120502_FDF_CRG/20120514_FDF_CRG_c12.mtb	2169	NA	WWSS	water	1	36193	1337028366	1	0.12	0.00413793103448276	3554	1
1	Food 1	Intake 3	459	40399	1337032572	/users/cn/jespinosa/phecomp/data/CRG/20120502_FDF_CRG/20120502_FDF_CRG/20120514_FDF_CRG_c12.mtb	2123	5	WWSS	food_sc	3	39940	1337032113	1	0.16	0.000348583877995643	3555	1
1	Food 1	Intake 3	147	40551	1337032724	/users/cn/jespinosa/phecomp/data/CRG/20120502_FDF_CRG/20120502_FDF_CRG/20120514_FDF_CRG_c12.mtb	2124	44	WWSS	food_sc	3	40404	1337032577	1	0.02	0.000136054421768707	3556	1
1	Food 1	Intake 3	168	40763	1337032936	/users/cn/jespinosa/phecomp/data/CRG/20120502_FDF_CRG/20120502_FDF_CRG/20120514_FDF_CRG_c12.mtb	2125	133	WWSS	food_sc	3	40595	1337032768	1	0.08	0.000476190476190476	3557	1
1	Drink 2	Intake 2	39	40796	1337032969	/users/cn/jespinosa/phecomp/data/CRG/20120502_FDF_CRG/20120502_FDF_CRG/20120514_FDF_CRG_c12.mtb	1046	NA	WWSS	water	2	40757	1337032930	1	0.14	0.00358974358974359	3558	1
1	Food 1	Intake 3	76	40972	1337033145	/users/cn/jespinosa/phecomp/data/CRG/20120502_FDF_CRG/20120502_FDF_CRG/20120514_FDF_CRG_c12.mtb	2126	442	WWSS	food_sc	3	40896	1337033069	1	0.04	0.000526315789473684	3559	1
1	Drink 1	Intake 1	21	41156	1337033329	/users/cn/jespinosa/phecomp/data/CRG/20120502_FDF_CRG/20120502_FDF_CRG/20120514_FDF_CRG_c12.mtb	2170	NA	WWSS	water	1	41135	1337033308	1	0.02	0.000952380952380952	3560	1
1	Drink 2	Intake 2	17	41295	1337033468	/users/cn/jespinosa/phecomp/data/CRG/20120502_FDF_CRG/20120502_FDF_CRG/20120514_FDF_CRG_c12.mtb	1047	NA	WWSS	water	2	41278	1337033451	1	0.02	0.00117647058823529	3561	1
1	Food 2	Intake 4	80	41494	1337033667	/users/cn/jespinosa/phecomp/data/CRG/20120502_FDF_CRG/20120502_FDF_CRG/20120514_FDF_CRG_c12.mtb	2836	COLL	WWSS	food_sc	4	41414	1337033587	1	0.02	0.00025	3562	1
1	Food 1	Intake 3	180	41666	1337033839	/users/cn/jespinosa/phecomp/data/CRG/20120502_FDF_CRG/20120502_FDF_CRG/20120514_FDF_CRG_c12.mtb	2128	770	WWSS	food_sc	3	41486	1337033659	1	0.04	0.000222222222222222	3563	1
1	Drink 1	Intake 1	38	41773	1337033946	/users/cn/jespinosa/phecomp/data/CRG/20120502_FDF_CRG/20120502_FDF_CRG/20120514_FDF_CRG_c12.mtb	2171	NA	WWSS	water	1	41735	1337033908	1	0.14	0.00368421052631579	3564	1
1	Drink 2	Intake 2	14	42227	1337034400	/users/cn/jespinosa/phecomp/data/CRG/20120502_FDF_CRG/20120502_FDF_CRG/20120514_FDF_CRG_c12.mtb	1048	NA	WWSS	water	2	42213	1337034386	1	0.02	0.00142857142857143	3565	1
1	Food 1	Intake 3	192	42628	1337034801	/users/cn/jespinosa/phecomp/data/CRG/20120502_FDF_CRG/20120502_FDF_CRG/20120514_FDF_CRG_c12.mtb	2129	COLL	WWSS	food_sc	3	42436	1337034609	1	0.0399999999999999	0.000208333333333333	3566	1
1	Food 2	Intake 4	65	42683	1337034856	/users/cn/jespinosa/phecomp/data/CRG/20120502_FDF_CRG/20120502_FDF_CRG/20120514_FDF_CRG_c12.mtb	2839	27	WWSS	food_sc	4	42618	1337034791	1	0.02	0.000307692307692308	3567	1
1	Food 2	Intake 4	163	42873	1337035046	/users/cn/jespinosa/phecomp/data/CRG/20120502_FDF_CRG/20120502_FDF_CRG/20120514_FDF_CRG_c12.mtb	2840	5091	WWSS	food_sc	4	42710	1337034883	1	0.0599999999999999	0.000368098159509202	3568	1
1	Drink 2	Intake 2	14	42879	1337035052	/users/cn/jespinosa/phecomp/data/CRG/20120502_FDF_CRG/20120502_FDF_CRG/20120514_FDF_CRG_c12.mtb	1049	NA	WWSS	water	2	42865	1337035038	1	0.06	0.00428571428571429	3569	1
1	Drink 1	Intake 1	13	43964	1337036137	/users/cn/jespinosa/phecomp/data/CRG/20120502_FDF_CRG/20120502_FDF_CRG/20120514_FDF_CRG_c12.mtb	2172	NA	WWSS	water	1	43951	1337036124	1	0.02	0.00153846153846154	3570	1
1	Food 2	Intake 4	149	48113	1337040286	/users/cn/jespinosa/phecomp/data/CRG/20120502_FDF_CRG/20120502_FDF_CRG/20120514_FDF_CRG_c12.mtb	2841	14	WWSS	food_sc	4	47964	1337040137	1	0.0600000000000001	0.00040268456375839	3571	1
1	Food 2	Intake 4	195	48322	1337040495	/users/cn/jespinosa/phecomp/data/CRG/20120502_FDF_CRG/20120502_FDF_CRG/20120514_FDF_CRG_c12.mtb	2842	49	WWSS	food_sc	4	48127	1337040300	1	0.0800000000000001	0.000410256410256411	3572	1
1	Food 2	Intake 4	81	48452	1337040625	/users/cn/jespinosa/phecomp/data/CRG/20120502_FDF_CRG/20120502_FDF_CRG/20120514_FDF_CRG_c12.mtb	2844	282	WWSS	food_sc	4	48371	1337040544	1	0.04	0.000493827160493827	3573	1
1	Drink 2	Intake 2	8	48469	1337040642	/users/cn/jespinosa/phecomp/data/CRG/20120502_FDF_CRG/20120502_FDF_CRG/20120514_FDF_CRG_c12.mtb	1050	NA	WWSS	water	2	48461	1337040634	1	0.02	0.0025	3574	1
1	Drink 1	Intake 1	17	48722	1337040895	/users/cn/jespinosa/phecomp/data/CRG/20120502_FDF_CRG/20120502_FDF_CRG/20120514_FDF_CRG_c12.mtb	2174	NA	WWSS	water	1	48705	1337040878	1	0.0399999999999999	0.00235294117647058	3575	1
1	Food 2	Intake 4	190	48924	1337041097	/users/cn/jespinosa/phecomp/data/CRG/20120502_FDF_CRG/20120502_FDF_CRG/20120514_FDF_CRG_c12.mtb	2847	26	WWSS	food_sc	4	48734	1337040907	1	0.04	0.000210526315789474	3576	1
1	Drink 2	Intake 2	14	48930	1337041103	/users/cn/jespinosa/phecomp/data/CRG/20120502_FDF_CRG/20120502_FDF_CRG/20120514_FDF_CRG_c12.mtb	1051	NA	WWSS	water	2	48916	1337041089	1	0.02	0.00142857142857143	3577	1
1	Food 2	Intake 4	111	49061	1337041234	/users/cn/jespinosa/phecomp/data/CRG/20120502_FDF_CRG/20120502_FDF_CRG/20120514_FDF_CRG_c12.mtb	2848	23	WWSS	food_sc	4	48950	1337041123	1	0.02	0.00018018018018018	3578	1
1	Food 2	Intake 4	109	49193	1337041366	/users/cn/jespinosa/phecomp/data/CRG/20120502_FDF_CRG/20120502_FDF_CRG/20120514_FDF_CRG_c12.mtb	2849	950	WWSS	food_sc	4	49084	1337041257	1	0.04	0.00036697247706422	3579	1
1	Drink 1	Intake 1	38	49221	1337041394	/users/cn/jespinosa/phecomp/data/CRG/20120502_FDF_CRG/20120502_FDF_CRG/20120514_FDF_CRG_c12.mtb	2176	NA	WWSS	water	1	49183	1337041356	1	0.0600000000000001	0.00157894736842106	3580	1
1	Drink 1	Intake 1	17	49443	1337041616	/users/cn/jespinosa/phecomp/data/CRG/20120502_FDF_CRG/20120502_FDF_CRG/20120514_FDF_CRG_c12.mtb	2177	NA	WWSS	water	1	49426	1337041599	1	0.02	0.00117647058823529	3581	1
1	Food 1	Intake 3	109	50252	1337042425	/users/cn/jespinosa/phecomp/data/CRG/20120502_FDF_CRG/20120502_FDF_CRG/20120514_FDF_CRG_c12.mtb	2140	1218	WWSS	food_sc	3	50143	1337042316	1	0.04	0.00036697247706422	3582	1
1	Drink 2	Intake 2	39	50289	1337042462	/users/cn/jespinosa/phecomp/data/CRG/20120502_FDF_CRG/20120502_FDF_CRG/20120514_FDF_CRG_c12.mtb	1052	NA	WWSS	water	2	50250	1337042423	1	0.12	0.00307692307692308	3583	1
1	Food 2	Intake 4	52	51522	1337043695	/users/cn/jespinosa/phecomp/data/CRG/20120502_FDF_CRG/20120502_FDF_CRG/20120514_FDF_CRG_c12.mtb	2855	5068	WWSS	food_sc	4	51470	1337043643	1	0.02	0.000384615384615385	3584	1
1	Food 2	Intake 4	17	56607	1337048780	/users/cn/jespinosa/phecomp/data/CRG/20120502_FDF_CRG/20120502_FDF_CRG/20120514_FDF_CRG_c12.mtb	2856	24	WWSS	food_sc	4	56590	1337048763	1	0.02	0.00117647058823529	3585	1
1	Food 2	Intake 4	20	56651	1337048824	/users/cn/jespinosa/phecomp/data/CRG/20120502_FDF_CRG/20120502_FDF_CRG/20120514_FDF_CRG_c12.mtb	2857	30	WWSS	food_sc	4	56631	1337048804	1	0.02	0.001	3586	1
1	Food 2	Intake 4	18	56699	1337048872	/users/cn/jespinosa/phecomp/data/CRG/20120502_FDF_CRG/20120502_FDF_CRG/20120514_FDF_CRG_c12.mtb	2858	2407	WWSS	food_sc	4	56681	1337048854	1	0.02	0.00111111111111111	3587	1
1	Food 2	Intake 4	146	59252	1337051425	/users/cn/jespinosa/phecomp/data/CRG/20120502_FDF_CRG/20120502_FDF_CRG/20120514_FDF_CRG_c12.mtb	2860	4	WWSS	food_sc	4	59106	1337051279	1	0.0399999999999998	0.000273972602739725	3588	1
1	Food 2	Intake 4	218	59474	1337051647	/users/cn/jespinosa/phecomp/data/CRG/20120502_FDF_CRG/20120502_FDF_CRG/20120514_FDF_CRG_c12.mtb	2861	4063	WWSS	food_sc	4	59256	1337051429	1	0.1	0.000458715596330275	3589	1
1	Food 2	Intake 4	223	63760	1337055933	/users/cn/jespinosa/phecomp/data/CRG/20120502_FDF_CRG/20120502_FDF_CRG/20120514_FDF_CRG_c12.mtb	2862	94	WWSS	food_sc	4	63537	1337055710	1	0.0600000000000001	0.000269058295964126	3590	1
1	Food 2	Intake 4	131	63985	1337056158	/users/cn/jespinosa/phecomp/data/CRG/20120502_FDF_CRG/20120502_FDF_CRG/20120514_FDF_CRG_c12.mtb	2863	82	WWSS	food_sc	4	63854	1337056027	1	0.04	0.000305343511450382	3591	1
1	Drink 2	Intake 2	28	64004	1337056177	/users/cn/jespinosa/phecomp/data/CRG/20120502_FDF_CRG/20120502_FDF_CRG/20120514_FDF_CRG_c12.mtb	1054	NA	WWSS	water	2	63976	1337056149	1	0.12	0.00428571428571429	3592	1
1	Food 2	Intake 4	415	64482	1337056655	/users/cn/jespinosa/phecomp/data/CRG/20120502_FDF_CRG/20120502_FDF_CRG/20120514_FDF_CRG_c12.mtb	2864	231	WWSS	food_sc	4	64067	1337056240	1	0.1	0.000240963855421687	3593	1
1	Drink 2	Intake 2	38	64522	1337056695	/users/cn/jespinosa/phecomp/data/CRG/20120502_FDF_CRG/20120502_FDF_CRG/20120514_FDF_CRG_c12.mtb	1055	NA	WWSS	water	2	64484	1337056657	1	0.14	0.00368421052631579	3594	1
1	Food 2	Intake 4	88	64801	1337056974	/users/cn/jespinosa/phecomp/data/CRG/20120502_FDF_CRG/20120502_FDF_CRG/20120514_FDF_CRG_c12.mtb	2867	513	WWSS	food_sc	4	64713	1337056886	1	0.02	0.000227272727272727	3595	1
1	Drink 1	Intake 1	17	65053	1337057226	/users/cn/jespinosa/phecomp/data/CRG/20120502_FDF_CRG/20120502_FDF_CRG/20120514_FDF_CRG_c12.mtb	2180	NA	WWSS	water	1	65036	1337057209	1	0.04	0.00235294117647059	3596	1
1	Drink 1	Intake 1	27	65285	1337057458	/users/cn/jespinosa/phecomp/data/CRG/20120502_FDF_CRG/20120502_FDF_CRG/20120514_FDF_CRG_c12.mtb	2181	NA	WWSS	water	1	65258	1337057431	1	0.04	0.00148148148148148	3597	1
1	Food 2	Intake 4	79	65393	1337057566	/users/cn/jespinosa/phecomp/data/CRG/20120502_FDF_CRG/20120502_FDF_CRG/20120514_FDF_CRG_c12.mtb	2870	73	WWSS	food_sc	4	65314	1337057487	1	0.02	0.000253164556962025	3598	1
1	Food 2	Intake 4	66	65532	1337057705	/users/cn/jespinosa/phecomp/data/CRG/20120502_FDF_CRG/20120502_FDF_CRG/20120514_FDF_CRG_c12.mtb	2872	138	WWSS	food_sc	4	65466	1337057639	1	0.04	0.000606060606060606	3599	1
1	Drink 2	Intake 2	15	65660	1337057833	/users/cn/jespinosa/phecomp/data/CRG/20120502_FDF_CRG/20120502_FDF_CRG/20120514_FDF_CRG_c12.mtb	1057	NA	WWSS	water	2	65645	1337057818	1	0.0600000000000001	0.00400000000000001	3600	1
1	Food 2	Intake 4	61	65731	1337057904	/users/cn/jespinosa/phecomp/data/CRG/20120502_FDF_CRG/20120502_FDF_CRG/20120514_FDF_CRG_c12.mtb	2873	5	WWSS	food_sc	4	65670	1337057843	1	0.02	0.000327868852459016	3601	1
1	Food 2	Intake 4	74	65810	1337057983	/users/cn/jespinosa/phecomp/data/CRG/20120502_FDF_CRG/20120502_FDF_CRG/20120514_FDF_CRG_c12.mtb	2874	34	WWSS	food_sc	4	65736	1337057909	1	0.0399999999999998	0.000540540540540538	3602	1
1	Drink 1	Intake 1	21	65828	1337058001	/users/cn/jespinosa/phecomp/data/CRG/20120502_FDF_CRG/20120502_FDF_CRG/20120514_FDF_CRG_c12.mtb	2183	NA	WWSS	water	1	65807	1337057980	1	0.04	0.0019047619047619	3603	1
1	Food 2	Intake 4	79	65923	1337058096	/users/cn/jespinosa/phecomp/data/CRG/20120502_FDF_CRG/20120502_FDF_CRG/20120514_FDF_CRG_c12.mtb	2875	28	WWSS	food_sc	4	65844	1337058017	1	0.04	0.000506329113924051	3604	1
1	Food 2	Intake 4	75	66026	1337058199	/users/cn/jespinosa/phecomp/data/CRG/20120502_FDF_CRG/20120502_FDF_CRG/20120514_FDF_CRG_c12.mtb	2876	115	WWSS	food_sc	4	65951	1337058124	1	0.02	0.000266666666666667	3605	1
1	Drink 2	Intake 2	23	66085	1337058258	/users/cn/jespinosa/phecomp/data/CRG/20120502_FDF_CRG/20120502_FDF_CRG/20120514_FDF_CRG_c12.mtb	1058	NA	WWSS	water	2	66062	1337058235	1	0.04	0.00173913043478261	3606	1
1	Food 2	Intake 4	59	66200	1337058373	/users/cn/jespinosa/phecomp/data/CRG/20120502_FDF_CRG/20120502_FDF_CRG/20120514_FDF_CRG_c12.mtb	2878	358	WWSS	food_sc	4	66141	1337058314	1	0.02	0.000338983050847458	3607	1
1	Food 2	Intake 4	119	66677	1337058850	/users/cn/jespinosa/phecomp/data/CRG/20120502_FDF_CRG/20120502_FDF_CRG/20120514_FDF_CRG_c12.mtb	2880	41	WWSS	food_sc	4	66558	1337058731	1	0.04	0.000336134453781513	3608	1
1	Drink 2	Intake 2	18	66708	1337058881	/users/cn/jespinosa/phecomp/data/CRG/20120502_FDF_CRG/20120502_FDF_CRG/20120514_FDF_CRG_c12.mtb	1059	NA	WWSS	water	2	66690	1337058863	1	0.02	0.00111111111111111	3609	1
1	Food 2	Intake 4	170	66888	1337059061	/users/cn/jespinosa/phecomp/data/CRG/20120502_FDF_CRG/20120502_FDF_CRG/20120514_FDF_CRG_c12.mtb	2881	746	WWSS	food_sc	4	66718	1337058891	1	0.0600000000000001	0.000352941176470589	3610	1
1	Drink 2	Intake 2	30	66982	1337059155	/users/cn/jespinosa/phecomp/data/CRG/20120502_FDF_CRG/20120502_FDF_CRG/20120514_FDF_CRG_c12.mtb	1060	NA	WWSS	water	2	66952	1337059125	1	0.0600000000000001	0.002	3611	1
1	Drink 2	Intake 2	16	67235	1337059408	/users/cn/jespinosa/phecomp/data/CRG/20120502_FDF_CRG/20120502_FDF_CRG/20120514_FDF_CRG_c12.mtb	1061	NA	WWSS	water	2	67219	1337059392	1	0.0399999999999998	0.00249999999999999	3612	1
1	Food 2	Intake 4	81	67715	1337059888	/users/cn/jespinosa/phecomp/data/CRG/20120502_FDF_CRG/20120502_FDF_CRG/20120514_FDF_CRG_c12.mtb	2885	116	WWSS	food_sc	4	67634	1337059807	1	0.04	0.000493827160493827	3613	1
1	Drink 2	Intake 2	15	67816	1337059989	/users/cn/jespinosa/phecomp/data/CRG/20120502_FDF_CRG/20120502_FDF_CRG/20120514_FDF_CRG_c12.mtb	1062	NA	WWSS	water	2	67801	1337059974	1	0.02	0.00133333333333333	3614	1
1	Food 2	Intake 4	121	67952	1337060125	/users/cn/jespinosa/phecomp/data/CRG/20120502_FDF_CRG/20120502_FDF_CRG/20120514_FDF_CRG_c12.mtb	2887	62	WWSS	food_sc	4	67831	1337060004	1	0.02	0.000165289256198347	3615	1
1	Drink 1	Intake 1	31	67973	1337060146	/users/cn/jespinosa/phecomp/data/CRG/20120502_FDF_CRG/20120502_FDF_CRG/20120514_FDF_CRG_c12.mtb	2184	NA	WWSS	water	1	67942	1337060115	1	0.04	0.00129032258064516	3616	1
1	Food 2	Intake 4	147	68161	1337060334	/users/cn/jespinosa/phecomp/data/CRG/20120502_FDF_CRG/20120502_FDF_CRG/20120514_FDF_CRG_c12.mtb	2888	38	WWSS	food_sc	4	68014	1337060187	1	0.04	0.000272108843537415	3617	1
1	Drink 2	Intake 2	34	68189	1337060362	/users/cn/jespinosa/phecomp/data/CRG/20120502_FDF_CRG/20120502_FDF_CRG/20120514_FDF_CRG_c12.mtb	1063	NA	WWSS	water	2	68155	1337060328	1	0.0800000000000001	0.00235294117647059	3618	1
1	Food 2	Intake 4	117	68316	1337060489	/users/cn/jespinosa/phecomp/data/CRG/20120502_FDF_CRG/20120502_FDF_CRG/20120514_FDF_CRG_c12.mtb	2889	17	WWSS	food_sc	4	68199	1337060372	1	0.0600000000000001	0.000512820512820514	3619	1
1	Food 2	Intake 4	110	68443	1337060616	/users/cn/jespinosa/phecomp/data/CRG/20120502_FDF_CRG/20120502_FDF_CRG/20120514_FDF_CRG_c12.mtb	2890	86	WWSS	food_sc	4	68333	1337060506	1	0.02	0.000181818181818182	3620	1
1	Food 2	Intake 4	98	68627	1337060800	/users/cn/jespinosa/phecomp/data/CRG/20120502_FDF_CRG/20120502_FDF_CRG/20120514_FDF_CRG_c12.mtb	2892	7	WWSS	food_sc	4	68529	1337060702	1	0.02	0.000204081632653061	3621	1
1	Food 2	Intake 4	99	68733	1337060906	/users/cn/jespinosa/phecomp/data/CRG/20120502_FDF_CRG/20120502_FDF_CRG/20120514_FDF_CRG_c12.mtb	2893	300	WWSS	food_sc	4	68634	1337060807	1	0.0399999999999996	0.0004040404040404	3622	1
1	Food 2	Intake 4	159	69192	1337061365	/users/cn/jespinosa/phecomp/data/CRG/20120502_FDF_CRG/20120502_FDF_CRG/20120514_FDF_CRG_c12.mtb	2895	25	WWSS	food_sc	4	69033	1337061206	1	0.04	0.000251572327044025	3623	1
1	Drink 1	Intake 1	18	69202	1337061375	/users/cn/jespinosa/phecomp/data/CRG/20120502_FDF_CRG/20120502_FDF_CRG/20120514_FDF_CRG_c12.mtb	2185	NA	WWSS	water	1	69184	1337061357	1	0.02	0.00111111111111111	3624	1
1	Drink 2	Intake 2	15	69215	1337061388	/users/cn/jespinosa/phecomp/data/CRG/20120502_FDF_CRG/20120502_FDF_CRG/20120514_FDF_CRG_c12.mtb	1064	NA	WWSS	water	2	69200	1337061373	1	0.02	0.00133333333333333	3625	1
1	Food 2	Intake 4	92	69309	1337061482	/users/cn/jespinosa/phecomp/data/CRG/20120502_FDF_CRG/20120502_FDF_CRG/20120514_FDF_CRG_c12.mtb	2896	29	WWSS	food_sc	4	69217	1337061390	1	0.04	0.000434782608695652	3626	1
1	Food 2	Intake 4	97	69435	1337061608	/users/cn/jespinosa/phecomp/data/CRG/20120502_FDF_CRG/20120502_FDF_CRG/20120514_FDF_CRG_c12.mtb	2897	14	WWSS	food_sc	4	69338	1337061511	1	0.04	0.000412371134020619	3627	1
1	Food 2	Intake 4	26	69475	1337061648	/users/cn/jespinosa/phecomp/data/CRG/20120502_FDF_CRG/20120502_FDF_CRG/20120514_FDF_CRG_c12.mtb	2898	367	WWSS	food_sc	4	69449	1337061622	1	0.02	0.000769230769230769	3628	1
1	Drink 1	Intake 1	23	69827	1337062000	/users/cn/jespinosa/phecomp/data/CRG/20120502_FDF_CRG/20120502_FDF_CRG/20120514_FDF_CRG_c12.mtb	2186	NA	WWSS	water	1	69804	1337061977	1	0.0599999999999998	0.0026086956521739	3629	1
1	Food 2	Intake 4	216	70058	1337062231	/users/cn/jespinosa/phecomp/data/CRG/20120502_FDF_CRG/20120502_FDF_CRG/20120514_FDF_CRG_c12.mtb	2900	72	WWSS	food_sc	4	69842	1337062015	1	0.02	9.25925925925926e-05	3630	1
1	Food 2	Intake 4	100	70230	1337062403	/users/cn/jespinosa/phecomp/data/CRG/20120502_FDF_CRG/20120502_FDF_CRG/20120514_FDF_CRG_c12.mtb	2901	37	WWSS	food_sc	4	70130	1337062303	1	0.02	0.0002	3631	1
1	Food 2	Intake 4	245	70512	1337062685	/users/cn/jespinosa/phecomp/data/CRG/20120502_FDF_CRG/20120502_FDF_CRG/20120514_FDF_CRG_c12.mtb	2902	849	WWSS	food_sc	4	70267	1337062440	1	0.04	0.000163265306122449	3632	1
1	Drink 1	Intake 1	26	70541	1337062714	/users/cn/jespinosa/phecomp/data/CRG/20120502_FDF_CRG/20120502_FDF_CRG/20120514_FDF_CRG_c12.mtb	2187	NA	WWSS	water	1	70515	1337062688	1	0.1	0.00384615384615385	3633	1
1	Food 2	Intake 4	292	71653	1337063826	/users/cn/jespinosa/phecomp/data/CRG/20120502_FDF_CRG/20120502_FDF_CRG/20120514_FDF_CRG_c12.mtb	2903	4181	WWSS	food_sc	4	71361	1337063534	1	0.1	0.000342465753424658	3634	1
1	Food 2	Intake 4	166	76000	1337068173	/users/cn/jespinosa/phecomp/data/CRG/20120502_FDF_CRG/20120502_FDF_CRG/20120514_FDF_CRG_c12.mtb	2906	20	WWSS	food_sc	4	75834	1337068007	1	0.02	0.000120481927710843	3635	1
1	Food 2	Intake 4	138	76158	1337068331	/users/cn/jespinosa/phecomp/data/CRG/20120502_FDF_CRG/20120502_FDF_CRG/20120514_FDF_CRG_c12.mtb	2907	7634	WWSS	food_sc	4	76020	1337068193	1	0.04	0.000289855072463768	3636	1
1	Drink 2	Intake 2	27	76181	1337068354	/users/cn/jespinosa/phecomp/data/CRG/20120502_FDF_CRG/20120502_FDF_CRG/20120514_FDF_CRG_c12.mtb	1066	NA	WWSS	water	2	76154	1337068327	1	0.14	0.00518518518518519	3637	1
1	Food 2	Intake 4	20	83812	1337075985	/users/cn/jespinosa/phecomp/data/CRG/20120502_FDF_CRG/20120502_FDF_CRG/20120514_FDF_CRG_c12.mtb	2909	4730	WWSS	food_sc	4	83792	1337075965	1	0.02	0.001	3638	1
1	Food 2	Intake 4	18	88560	1337080733	/users/cn/jespinosa/phecomp/data/CRG/20120502_FDF_CRG/20120502_FDF_CRG/20120514_FDF_CRG_c12.mtb	2911	27	WWSS	food_sc	4	88542	1337080715	1	0.02	0.00111111111111111	3639	1
1	Food 2	Intake 4	35	88622	1337080795	/users/cn/jespinosa/phecomp/data/CRG/20120502_FDF_CRG/20120502_FDF_CRG/20120514_FDF_CRG_c12.mtb	2912	409	WWSS	food_sc	4	88587	1337080760	1	0.02	0.000571428571428571	3640	1
1	Food 2	Intake 4	76	89107	1337081280	/users/cn/jespinosa/phecomp/data/CRG/20120502_FDF_CRG/20120502_FDF_CRG/20120514_FDF_CRG_c12.mtb	2913	3628	WWSS	food_sc	4	89031	1337081204	1	0.04	0.000526315789473684	3641	1
1	Drink 1	Intake 1	15	91059	1337083232	/users/cn/jespinosa/phecomp/data/CRG/20120502_FDF_CRG/20120502_FDF_CRG/20120514_FDF_CRG_c12.mtb	2193	NA	WWSS	water	1	91044	1337083217	1	0.04	0.00266666666666667	3642	1
1	Food 2	Intake 4	28	92763	1337084936	/users/cn/jespinosa/phecomp/data/CRG/20120502_FDF_CRG/20120502_FDF_CRG/20120514_FDF_CRG_c12.mtb	2915	7	WWSS	food_sc	4	92735	1337084908	1	0.04	0.00142857142857143	3643	1
1	Food 2	Intake 4	23	92793	1337084966	/users/cn/jespinosa/phecomp/data/CRG/20120502_FDF_CRG/20120502_FDF_CRG/20120514_FDF_CRG_c12.mtb	2916	7315	WWSS	food_sc	4	92770	1337084943	1	0.0399999999999996	0.00173913043478259	3644	1
1	Food 2	Intake 4	39	100147	1337092320	/users/cn/jespinosa/phecomp/data/CRG/20120502_FDF_CRG/20120502_FDF_CRG/20120514_FDF_CRG_c12.mtb	2917	69	WWSS	food_sc	4	100108	1337092281	1	0.04	0.00102564102564103	3645	1
1	Food 2	Intake 4	8	100224	1337092397	/users/cn/jespinosa/phecomp/data/CRG/20120502_FDF_CRG/20120502_FDF_CRG/20120514_FDF_CRG_c12.mtb	2918	19	WWSS	food_sc	4	100216	1337092389	1	0.02	0.0025	3646	1
1	Food 2	Intake 4	23	100266	1337092439	/users/cn/jespinosa/phecomp/data/CRG/20120502_FDF_CRG/20120502_FDF_CRG/20120514_FDF_CRG_c12.mtb	2919	38	WWSS	food_sc	4	100243	1337092416	1	0.02	0.000869565217391304	3647	1
1	Food 2	Intake 4	47	100351	1337092524	/users/cn/jespinosa/phecomp/data/CRG/20120502_FDF_CRG/20120502_FDF_CRG/20120514_FDF_CRG_c12.mtb	2920	91	WWSS	food_sc	4	100304	1337092477	1	0.04	0.000851063829787234	3648	1
1	Food 2	Intake 4	35	100477	1337092650	/users/cn/jespinosa/phecomp/data/CRG/20120502_FDF_CRG/20120502_FDF_CRG/20120514_FDF_CRG_c12.mtb	2921	7648	WWSS	food_sc	4	100442	1337092615	1	0.02	0.000571428571428571	3649	1
1	Drink 2	Intake 2	16	101553	1337093726	/users/cn/jespinosa/phecomp/data/CRG/20120502_FDF_CRG/20120502_FDF_CRG/20120514_FDF_CRG_c12.mtb	1068	NA	WWSS	water	2	101537	1337093710	1	0.02	0.00125	3650	1
1	Food 2	Intake 4	39	108164	1337100337	/users/cn/jespinosa/phecomp/data/CRG/20120502_FDF_CRG/20120502_FDF_CRG/20120514_FDF_CRG_c12.mtb	2924	59	WWSS	food_sc	4	108125	1337100298	1	0.02	0.000512820512820513	3651	1
1	Food 2	Intake 4	161	108384	1337100557	/users/cn/jespinosa/phecomp/data/CRG/20120502_FDF_CRG/20120502_FDF_CRG/20120514_FDF_CRG_c12.mtb	2925	11	WWSS	food_sc	4	108223	1337100396	1	0.0800000000000001	0.000496894409937889	3652	1
1	Food 2	Intake 4	179	108574	1337100747	/users/cn/jespinosa/phecomp/data/CRG/20120502_FDF_CRG/20120502_FDF_CRG/20120514_FDF_CRG_c12.mtb	2926	14	WWSS	food_sc	4	108395	1337100568	1	0.0600000000000001	0.000335195530726258	3653	1
1	Food 2	Intake 4	187	108775	1337100948	/users/cn/jespinosa/phecomp/data/CRG/20120502_FDF_CRG/20120502_FDF_CRG/20120514_FDF_CRG_c12.mtb	2927	4048	WWSS	food_sc	4	108588	1337100761	1	0.0800000000000001	0.000427807486631017	3654	1
1	Drink 2	Intake 2	31	110320	1337102493	/users/cn/jespinosa/phecomp/data/CRG/20120502_FDF_CRG/20120502_FDF_CRG/20120514_FDF_CRG_c12.mtb	1069	NA	WWSS	water	2	110289	1337102462	1	0.12	0.00387096774193548	3655	1
1	Food 2	Intake 4	164	112987	1337105160	/users/cn/jespinosa/phecomp/data/CRG/20120502_FDF_CRG/20120502_FDF_CRG/20120514_FDF_CRG_c12.mtb	2928	9	WWSS	food_sc	4	112823	1337104996	1	0.0800000000000001	0.000487804878048781	3656	1
1	Food 2	Intake 4	291	113287	1337105460	/users/cn/jespinosa/phecomp/data/CRG/20120502_FDF_CRG/20120502_FDF_CRG/20120514_FDF_CRG_c12.mtb	2929	60	WWSS	food_sc	4	112996	1337105169	1	0.12	0.000412371134020619	3657	1
1	Food 2	Intake 4	127	113474	1337105647	/users/cn/jespinosa/phecomp/data/CRG/20120502_FDF_CRG/20120502_FDF_CRG/20120514_FDF_CRG_c12.mtb	2930	264	WWSS	food_sc	4	113347	1337105520	1	0.04	0.00031496062992126	3658	1
1	Drink 2	Intake 2	15	113492	1337105665	/users/cn/jespinosa/phecomp/data/CRG/20120502_FDF_CRG/20120502_FDF_CRG/20120514_FDF_CRG_c12.mtb	1070	NA	WWSS	water	2	113477	1337105650	1	0.04	0.00266666666666667	3659	1
1	Food 2	Intake 4	154	113892	1337106065	/users/cn/jespinosa/phecomp/data/CRG/20120502_FDF_CRG/20120502_FDF_CRG/20120514_FDF_CRG_c12.mtb	2932	81	WWSS	food_sc	4	113738	1337105911	1	0.0600000000000001	0.00038961038961039	3660	1
1	Drink 2	Intake 2	23	113910	1337106083	/users/cn/jespinosa/phecomp/data/CRG/20120502_FDF_CRG/20120502_FDF_CRG/20120514_FDF_CRG_c12.mtb	1072	NA	WWSS	water	2	113887	1337106060	1	0.0999999999999999	0.00434782608695652	3661	1
1	Food 2	Intake 4	178	114151	1337106324	/users/cn/jespinosa/phecomp/data/CRG/20120502_FDF_CRG/20120502_FDF_CRG/20120514_FDF_CRG_c12.mtb	2933	296	WWSS	food_sc	4	113973	1337106146	1	0.04	0.000224719101123596	3662	1
1	Drink 2	Intake 2	19	114170	1337106343	/users/cn/jespinosa/phecomp/data/CRG/20120502_FDF_CRG/20120502_FDF_CRG/20120514_FDF_CRG_c12.mtb	1073	NA	WWSS	water	2	114151	1337106324	1	0.02	0.00105263157894737	3663	1
1	Food 2	Intake 4	45	114492	1337106665	/users/cn/jespinosa/phecomp/data/CRG/20120502_FDF_CRG/20120502_FDF_CRG/20120514_FDF_CRG_c12.mtb	2935	1969	WWSS	food_sc	4	114447	1337106620	1	0.02	0.000444444444444444	3664	1
1	Drink 2	Intake 2	25	114506	1337106679	/users/cn/jespinosa/phecomp/data/CRG/20120502_FDF_CRG/20120502_FDF_CRG/20120514_FDF_CRG_c12.mtb	1074	NA	WWSS	water	2	114481	1337106654	1	0.0600000000000001	0.0024	3665	1
1	Drink 2	Intake 2	17	114914	1337107087	/users/cn/jespinosa/phecomp/data/CRG/20120502_FDF_CRG/20120502_FDF_CRG/20120514_FDF_CRG_c12.mtb	1075	NA	WWSS	water	2	114897	1337107070	1	0.0399999999999998	0.00235294117647058	3666	1
1	Food 2	Intake 4	81	116542	1337108715	/users/cn/jespinosa/phecomp/data/CRG/20120502_FDF_CRG/20120502_FDF_CRG/20120514_FDF_CRG_c12.mtb	2936	38	WWSS	food_sc	4	116461	1337108634	1	0.02	0.000246913580246914	3667	1
1	Food 2	Intake 4	53	116633	1337108806	/users/cn/jespinosa/phecomp/data/CRG/20120502_FDF_CRG/20120502_FDF_CRG/20120514_FDF_CRG_c12.mtb	2938	1555	WWSS	food_sc	4	116580	1337108753	1	0.02	0.000377358490566038	3668	1
1	Food 2	Intake 4	100	118288	1337110461	/users/cn/jespinosa/phecomp/data/CRG/20120502_FDF_CRG/20120502_FDF_CRG/20120514_FDF_CRG_c12.mtb	2939	8	WWSS	food_sc	4	118188	1337110361	1	0.04	0.0004	3669	1
1	Food 2	Intake 4	282	118578	1337110751	/users/cn/jespinosa/phecomp/data/CRG/20120502_FDF_CRG/20120502_FDF_CRG/20120514_FDF_CRG_c12.mtb	2940	160	WWSS	food_sc	4	118296	1337110469	1	0.0600000000000001	0.000212765957446809	3670	1
1	Food 2	Intake 4	96	118834	1337111007	/users/cn/jespinosa/phecomp/data/CRG/20120502_FDF_CRG/20120502_FDF_CRG/20120514_FDF_CRG_c12.mtb	2942	65	WWSS	food_sc	4	118738	1337110911	1	0.04	0.000416666666666667	3671	1
1	Drink 2	Intake 2	24	118853	1337111026	/users/cn/jespinosa/phecomp/data/CRG/20120502_FDF_CRG/20120502_FDF_CRG/20120514_FDF_CRG_c12.mtb	1076	NA	WWSS	water	2	118829	1337111002	1	0.04	0.00166666666666667	3672	1
1	Food 2	Intake 4	165	119064	1337111237	/users/cn/jespinosa/phecomp/data/CRG/20120502_FDF_CRG/20120502_FDF_CRG/20120514_FDF_CRG_c12.mtb	2943	112	WWSS	food_sc	4	118899	1337111072	1	0.0599999999999996	0.000363636363636361	3673	1
1	Drink 1	Intake 1	28	119087	1337111260	/users/cn/jespinosa/phecomp/data/CRG/20120502_FDF_CRG/20120502_FDF_CRG/20120514_FDF_CRG_c12.mtb	2194	NA	WWSS	water	1	119059	1337111232	1	0.0599999999999998	0.00214285714285714	3674	1
1	Drink 1	Intake 1	16	119183	1337111356	/users/cn/jespinosa/phecomp/data/CRG/20120502_FDF_CRG/20120502_FDF_CRG/20120514_FDF_CRG_c12.mtb	2195	NA	WWSS	water	1	119167	1337111340	1	0.02	0.00125	3675	1
1	Food 2	Intake 4	159	119335	1337111508	/users/cn/jespinosa/phecomp/data/CRG/20120502_FDF_CRG/20120502_FDF_CRG/20120514_FDF_CRG_c12.mtb	2944	405	WWSS	food_sc	4	119176	1337111349	1	0.0600000000000001	0.000377358490566038	3676	1
1	Drink 2	Intake 2	28	119366	1337111539	/users/cn/jespinosa/phecomp/data/CRG/20120502_FDF_CRG/20120502_FDF_CRG/20120514_FDF_CRG_c12.mtb	1077	NA	WWSS	water	2	119338	1337111511	1	0.0800000000000001	0.00285714285714286	3677	1
1	Food 2	Intake 4	68	119808	1337111981	/users/cn/jespinosa/phecomp/data/CRG/20120502_FDF_CRG/20120502_FDF_CRG/20120514_FDF_CRG_c12.mtb	2946	384	WWSS	food_sc	4	119740	1337111913	1	0.04	0.000588235294117647	3678	1
1	Drink 2	Intake 2	27	120121	1337112294	/users/cn/jespinosa/phecomp/data/CRG/20120502_FDF_CRG/20120502_FDF_CRG/20120514_FDF_CRG_c12.mtb	1078	NA	WWSS	water	2	120094	1337112267	1	0.1	0.0037037037037037	3679	1
1	Food 2	Intake 4	128	120320	1337112493	/users/cn/jespinosa/phecomp/data/CRG/20120502_FDF_CRG/20120502_FDF_CRG/20120514_FDF_CRG_c12.mtb	2948	12	WWSS	food_sc	4	120192	1337112365	1	0.02	0.00015625	3680	1
1	Food 2	Intake 4	71	120403	1337112576	/users/cn/jespinosa/phecomp/data/CRG/20120502_FDF_CRG/20120502_FDF_CRG/20120514_FDF_CRG_c12.mtb	2949	87	WWSS	food_sc	4	120332	1337112505	1	0.02	0.00028169014084507	3681	1
1	Food 2	Intake 4	71	120561	1337112734	/users/cn/jespinosa/phecomp/data/CRG/20120502_FDF_CRG/20120502_FDF_CRG/20120514_FDF_CRG_c12.mtb	2950	235	WWSS	food_sc	4	120490	1337112663	1	0.02	0.00028169014084507	3682	1
1	Drink 2	Intake 2	21	120573	1337112746	/users/cn/jespinosa/phecomp/data/CRG/20120502_FDF_CRG/20120502_FDF_CRG/20120514_FDF_CRG_c12.mtb	1079	NA	WWSS	water	2	120552	1337112725	1	0.04	0.0019047619047619	3683	1
1	Food 2	Intake 4	116	120912	1337113085	/users/cn/jespinosa/phecomp/data/CRG/20120502_FDF_CRG/20120502_FDF_CRG/20120514_FDF_CRG_c12.mtb	2952	12	WWSS	food_sc	4	120796	1337112969	1	0.02	0.000172413793103448	3684	1
1	Food 2	Intake 4	70	120994	1337113167	/users/cn/jespinosa/phecomp/data/CRG/20120502_FDF_CRG/20120502_FDF_CRG/20120514_FDF_CRG_c12.mtb	2953	19	WWSS	food_sc	4	120924	1337113097	1	0.0799999999999996	0.00114285714285714	3685	1
1	Food 2	Intake 4	31	121044	1337113217	/users/cn/jespinosa/phecomp/data/CRG/20120502_FDF_CRG/20120502_FDF_CRG/20120514_FDF_CRG_c12.mtb	2954	376	WWSS	food_sc	4	121013	1337113186	1	0.0200000000000005	0.000645161290322597	3686	1
1	Drink 2	Intake 2	20	121100	1337113273	/users/cn/jespinosa/phecomp/data/CRG/20120502_FDF_CRG/20120502_FDF_CRG/20120514_FDF_CRG_c12.mtb	1080	NA	WWSS	water	2	121080	1337113253	1	0.04	0.002	3687	1
1	Food 2	Intake 4	122	121542	1337113715	/users/cn/jespinosa/phecomp/data/CRG/20120502_FDF_CRG/20120502_FDF_CRG/20120514_FDF_CRG_c12.mtb	2957	34	WWSS	food_sc	4	121420	1337113593	1	0.0200000000000005	0.000163934426229512	3688	1
1	Drink 2	Intake 2	23	121576	1337113749	/users/cn/jespinosa/phecomp/data/CRG/20120502_FDF_CRG/20120502_FDF_CRG/20120514_FDF_CRG_c12.mtb	1081	NA	WWSS	water	2	121553	1337113726	1	0.1	0.00434782608695652	3689	1
1	Food 2	Intake 4	86	121662	1337113835	/users/cn/jespinosa/phecomp/data/CRG/20120502_FDF_CRG/20120502_FDF_CRG/20120514_FDF_CRG_c12.mtb	2958	2908	WWSS	food_sc	4	121576	1337113749	1	0.04	0.000465116279069767	3690	1
1	Food 2	Intake 4	437	125007	1337117180	/users/cn/jespinosa/phecomp/data/CRG/20120502_FDF_CRG/20120502_FDF_CRG/20120514_FDF_CRG_c12.mtb	2959	118	WWSS	food_sc	4	124570	1337116743	1	0.16	0.000366132723112128	3691	1
1	Drink 2	Intake 2	20	125111	1337117284	/users/cn/jespinosa/phecomp/data/CRG/20120502_FDF_CRG/20120502_FDF_CRG/20120514_FDF_CRG_c12.mtb	1082	NA	WWSS	water	2	125091	1337117264	1	0.02	0.001	3692	1
1	Food 2	Intake 4	218	125343	1337117516	/users/cn/jespinosa/phecomp/data/CRG/20120502_FDF_CRG/20120502_FDF_CRG/20120514_FDF_CRG_c12.mtb	2960	146	WWSS	food_sc	4	125125	1337117298	1	0.0999999999999996	0.000458715596330273	3693	1
1	Drink 2	Intake 2	27	125367	1337117540	/users/cn/jespinosa/phecomp/data/CRG/20120502_FDF_CRG/20120502_FDF_CRG/20120514_FDF_CRG_c12.mtb	1084	NA	WWSS	water	2	125340	1337117513	1	0.0600000000000001	0.00222222222222223	3694	1
1	Food 2	Intake 4	149	125638	1337117811	/users/cn/jespinosa/phecomp/data/CRG/20120502_FDF_CRG/20120502_FDF_CRG/20120514_FDF_CRG_c12.mtb	2961	80	WWSS	food_sc	4	125489	1337117662	1	0.04	0.000268456375838926	3695	1
1	Drink 2	Intake 2	17	125726	1337117899	/users/cn/jespinosa/phecomp/data/CRG/20120502_FDF_CRG/20120502_FDF_CRG/20120514_FDF_CRG_c12.mtb	1085	NA	WWSS	water	2	125709	1337117882	1	0.02	0.00117647058823529	3696	1
1	Food 2	Intake 4	129	125847	1337118020	/users/cn/jespinosa/phecomp/data/CRG/20120502_FDF_CRG/20120502_FDF_CRG/20120514_FDF_CRG_c12.mtb	2962	103	WWSS	food_sc	4	125718	1337117891	1	0.04	0.000310077519379845	3697	1
1	Drink 2	Intake 2	29	125871	1337118044	/users/cn/jespinosa/phecomp/data/CRG/20120502_FDF_CRG/20120502_FDF_CRG/20120514_FDF_CRG_c12.mtb	1086	NA	WWSS	water	2	125842	1337118015	1	0.0800000000000001	0.00275862068965518	3698	1
1	Food 2	Intake 4	171	126121	1337118294	/users/cn/jespinosa/phecomp/data/CRG/20120502_FDF_CRG/20120502_FDF_CRG/20120514_FDF_CRG_c12.mtb	2964	72	WWSS	food_sc	4	125950	1337118123	1	0.0600000000000005	0.000350877192982459	3699	1
1	Drink 1	Intake 1	16	126141	1337118314	/users/cn/jespinosa/phecomp/data/CRG/20120502_FDF_CRG/20120502_FDF_CRG/20120514_FDF_CRG_c12.mtb	2196	NA	WWSS	water	1	126125	1337118298	1	0.04	0.0025	3700	1
1	Food 2	Intake 4	137	126330	1337118503	/users/cn/jespinosa/phecomp/data/CRG/20120502_FDF_CRG/20120502_FDF_CRG/20120514_FDF_CRG_c12.mtb	2965	1235	WWSS	food_sc	4	126193	1337118366	1	0.0399999999999991	0.000291970802919701	3701	1
1	Drink 2	Intake 2	16	126358	1337118531	/users/cn/jespinosa/phecomp/data/CRG/20120502_FDF_CRG/20120502_FDF_CRG/20120514_FDF_CRG_c12.mtb	1088	NA	WWSS	water	2	126342	1337118515	1	0.0600000000000001	0.00375000000000001	3702	1
1	Food 2	Intake 4	118	127683	1337119856	/users/cn/jespinosa/phecomp/data/CRG/20120502_FDF_CRG/20120502_FDF_CRG/20120514_FDF_CRG_c12.mtb	2968	106	WWSS	food_sc	4	127565	1337119738	1	0.0600000000000005	0.000508474576271191	3703	1
1	Drink 2	Intake 2	30	127760	1337119933	/users/cn/jespinosa/phecomp/data/CRG/20120502_FDF_CRG/20120502_FDF_CRG/20120514_FDF_CRG_c12.mtb	1090	NA	WWSS	water	2	127730	1337119903	1	0.02	0.000666666666666667	3704	1
1	Food 2	Intake 4	86	127875	1337120048	/users/cn/jespinosa/phecomp/data/CRG/20120502_FDF_CRG/20120502_FDF_CRG/20120514_FDF_CRG_c12.mtb	2970	3420	WWSS	food_sc	4	127789	1337119962	1	0.04	0.000465116279069767	3705	1
1	Drink 2	Intake 2	26	128231	1337120404	/users/cn/jespinosa/phecomp/data/CRG/20120502_FDF_CRG/20120502_FDF_CRG/20120514_FDF_CRG_c12.mtb	1091	NA	WWSS	water	2	128205	1337120378	1	0.1	0.00384615384615385	3706	1
1	Food 2	Intake 4	77	131372	1337123545	/users/cn/jespinosa/phecomp/data/CRG/20120502_FDF_CRG/20120502_FDF_CRG/20120514_FDF_CRG_c12.mtb	2972	34	WWSS	food_sc	4	131295	1337123468	1	0.04	0.000519480519480519	3707	1
1	Food 2	Intake 4	28	131434	1337123607	/users/cn/jespinosa/phecomp/data/CRG/20120502_FDF_CRG/20120502_FDF_CRG/20120514_FDF_CRG_c12.mtb	2973	3065	WWSS	food_sc	4	131406	1337123579	1	0.0200000000000005	0.000714285714285732	3708	1
1	Food 2	Intake 4	70	134569	1337126742	/users/cn/jespinosa/phecomp/data/CRG/20120502_FDF_CRG/20120502_FDF_CRG/20120514_FDF_CRG_c12.mtb	2978	24	WWSS	food_sc	4	134499	1337126672	1	0.04	0.000571428571428571	3709	1
1	Food 2	Intake 4	139	134732	1337126905	/users/cn/jespinosa/phecomp/data/CRG/20120502_FDF_CRG/20120502_FDF_CRG/20120514_FDF_CRG_c12.mtb	2979	227	WWSS	food_sc	4	134593	1337126766	1	0.0800000000000001	0.000575539568345324	3710	1
1	Food 2	Intake 4	142	135101	1337127274	/users/cn/jespinosa/phecomp/data/CRG/20120502_FDF_CRG/20120502_FDF_CRG/20120514_FDF_CRG_c12.mtb	2983	579	WWSS	food_sc	4	134959	1337127132	1	0.0600000000000005	0.000422535211267609	3711	1
1	Drink 1	Intake 1	15	135111	1337127284	/users/cn/jespinosa/phecomp/data/CRG/20120502_FDF_CRG/20120502_FDF_CRG/20120514_FDF_CRG_c12.mtb	2198	NA	WWSS	water	1	135096	1337127269	1	0.04	0.00266666666666667	3712	1
1	Drink 2	Intake 2	13	135346	1337127519	/users/cn/jespinosa/phecomp/data/CRG/20120502_FDF_CRG/20120502_FDF_CRG/20120514_FDF_CRG_c12.mtb	1092	NA	WWSS	water	2	135333	1337127506	1	0.02	0.00153846153846154	3713	1
1	Drink 2	Intake 2	19	135617	1337127790	/users/cn/jespinosa/phecomp/data/CRG/20120502_FDF_CRG/20120502_FDF_CRG/20120514_FDF_CRG_c12.mtb	1094	NA	WWSS	water	2	135598	1337127771	1	0.04	0.00210526315789474	3714	1
1	Drink 2	Intake 2	21	135647	1337127820	/users/cn/jespinosa/phecomp/data/CRG/20120502_FDF_CRG/20120502_FDF_CRG/20120514_FDF_CRG_c12.mtb	1095	NA	WWSS	water	2	135626	1337127799	1	0.04	0.0019047619047619	3715	1
1	Food 2	Intake 4	147	135827	1337128000	/users/cn/jespinosa/phecomp/data/CRG/20120502_FDF_CRG/20120502_FDF_CRG/20120514_FDF_CRG_c12.mtb	2986	451	WWSS	food_sc	4	135680	1337127853	1	0.0200000000000005	0.000136054421768711	3716	1
1	Drink 1	Intake 1	30	135901	1337128074	/users/cn/jespinosa/phecomp/data/CRG/20120502_FDF_CRG/20120502_FDF_CRG/20120514_FDF_CRG_c12.mtb	2199	NA	WWSS	water	1	135871	1337128044	1	0.02	0.000666666666666667	3717	1
1	Drink 1	Intake 1	36	136171	1337128344	/users/cn/jespinosa/phecomp/data/CRG/20120502_FDF_CRG/20120502_FDF_CRG/20120514_FDF_CRG_c12.mtb	2201	NA	WWSS	water	1	136135	1337128308	1	0.02	0.000555555555555556	3718	1
1	Food 2	Intake 4	111	136389	1337128562	/users/cn/jespinosa/phecomp/data/CRG/20120502_FDF_CRG/20120502_FDF_CRG/20120514_FDF_CRG_c12.mtb	2989	951	WWSS	food_sc	4	136278	1337128451	1	0.0200000000000005	0.000180180180180185	3719	1
1	Food 2	Intake 4	197	137537	1337129710	/users/cn/jespinosa/phecomp/data/CRG/20120502_FDF_CRG/20120502_FDF_CRG/20120514_FDF_CRG_c12.mtb	2993	7693	WWSS	food_sc	4	137340	1337129513	1	0.04	0.000203045685279188	3720	1
1	Drink 2	Intake 2	31	137792	1337129965	/users/cn/jespinosa/phecomp/data/CRG/20120502_FDF_CRG/20120502_FDF_CRG/20120514_FDF_CRG_c12.mtb	1099	NA	WWSS	water	2	137761	1337129934	1	0.04	0.00129032258064516	3721	1
1	Food 2	Intake 4	59	145289	1337137462	/users/cn/jespinosa/phecomp/data/CRG/20120502_FDF_CRG/20120502_FDF_CRG/20120514_FDF_CRG_c12.mtb	2997	2597	WWSS	food_sc	4	145230	1337137403	1	0.0200000000000005	0.000338983050847466	3722	1
1	Food 2	Intake 4	235	148121	1337140294	/users/cn/jespinosa/phecomp/data/CRG/20120502_FDF_CRG/20120502_FDF_CRG/20120514_FDF_CRG_c12.mtb	3000	45	WWSS	food_sc	4	147886	1337140059	1	0.0600000000000005	0.000255319148936172	3723	1
1	Food 2	Intake 4	160	148326	1337140499	/users/cn/jespinosa/phecomp/data/CRG/20120502_FDF_CRG/20120502_FDF_CRG/20120514_FDF_CRG_c12.mtb	3001	2634	WWSS	food_sc	4	148166	1337140339	1	0.0599999999999996	0.000374999999999998	3724	1
1	Drink 1	Intake 1	22	148373	1337140546	/users/cn/jespinosa/phecomp/data/CRG/20120502_FDF_CRG/20120502_FDF_CRG/20120514_FDF_CRG_c12.mtb	2205	NA	WWSS	water	1	148351	1337140524	1	0.0600000000000001	0.00272727272727273	3725	1
1	Food 2	Intake 4	271	151231	1337143404	/users/cn/jespinosa/phecomp/data/CRG/20120502_FDF_CRG/20120502_FDF_CRG/20120514_FDF_CRG_c12.mtb	3004	281	WWSS	food_sc	4	150960	1337143133	1	0.100000000000001	0.000369003690036904	3726	1
1	Drink 1	Intake 1	14	151240	1337143413	/users/cn/jespinosa/phecomp/data/CRG/20120502_FDF_CRG/20120502_FDF_CRG/20120514_FDF_CRG_c12.mtb	2206	NA	WWSS	water	1	151226	1337143399	1	0.0600000000000001	0.00428571428571429	3727	1
1	Drink 1	Intake 1	10	151510	1337143683	/users/cn/jespinosa/phecomp/data/CRG/20120502_FDF_CRG/20120502_FDF_CRG/20120514_FDF_CRG_c12.mtb	2207	NA	WWSS	water	1	151500	1337143673	1	0.02	0.002	3728	1
1	Food 2	Intake 4	104	151616	1337143789	/users/cn/jespinosa/phecomp/data/CRG/20120502_FDF_CRG/20120502_FDF_CRG/20120514_FDF_CRG_c12.mtb	3008	542	WWSS	food_sc	4	151512	1337143685	1	0.04	0.000384615384615385	3729	1
1	Drink 2	Intake 2	28	151649	1337143822	/users/cn/jespinosa/phecomp/data/CRG/20120502_FDF_CRG/20120502_FDF_CRG/20120514_FDF_CRG_c12.mtb	1100	NA	WWSS	water	2	151621	1337143794	1	0.0799999999999996	0.00285714285714284	3730	1
1	Drink 2	Intake 2	27	152119	1337144292	/users/cn/jespinosa/phecomp/data/CRG/20120502_FDF_CRG/20120502_FDF_CRG/20120514_FDF_CRG_c12.mtb	1102	NA	WWSS	water	2	152092	1337144265	1	0.0800000000000001	0.00296296296296297	3731	1
1	Food 2	Intake 4	86	152244	1337144417	/users/cn/jespinosa/phecomp/data/CRG/20120502_FDF_CRG/20120502_FDF_CRG/20120514_FDF_CRG_c12.mtb	3013	337	WWSS	food_sc	4	152158	1337144331	1	0.0200000000000005	0.00023255813953489	3732	1
1	Drink 2	Intake 2	17	152391	1337144564	/users/cn/jespinosa/phecomp/data/CRG/20120502_FDF_CRG/20120502_FDF_CRG/20120514_FDF_CRG_c12.mtb	1104	NA	WWSS	water	2	152374	1337144547	1	0.02	0.00117647058823529	3733	1
1	Food 2	Intake 4	80	152661	1337144834	/users/cn/jespinosa/phecomp/data/CRG/20120502_FDF_CRG/20120502_FDF_CRG/20120514_FDF_CRG_c12.mtb	3016	518	WWSS	food_sc	4	152581	1337144754	1	0.0399999999999991	0.000499999999999989	3734	1
1	Drink 2	Intake 2	20	152797	1337144970	/users/cn/jespinosa/phecomp/data/CRG/20120502_FDF_CRG/20120502_FDF_CRG/20120514_FDF_CRG_c12.mtb	1105	NA	WWSS	water	2	152777	1337144950	1	0.04	0.002	3735	1
1	Drink 2	Intake 2	21	153046	1337145219	/users/cn/jespinosa/phecomp/data/CRG/20120502_FDF_CRG/20120502_FDF_CRG/20120514_FDF_CRG_c12.mtb	1106	NA	WWSS	water	2	153025	1337145198	1	0.1	0.00476190476190476	3736	1
1	Food 2	Intake 4	31	153210	1337145383	/users/cn/jespinosa/phecomp/data/CRG/20120502_FDF_CRG/20120502_FDF_CRG/20120514_FDF_CRG_c12.mtb	3019	392	WWSS	food_sc	4	153179	1337145352	1	0.0200000000000005	0.000645161290322597	3737	1
1	Drink 1	Intake 1	9	153381	1337145554	/users/cn/jespinosa/phecomp/data/CRG/20120502_FDF_CRG/20120502_FDF_CRG/20120514_FDF_CRG_c12.mtb	2216	NA	WWSS	water	1	153372	1337145545	1	0.02	0.00222222222222222	3738	1
1	Food 2	Intake 4	38	153640	1337145813	/users/cn/jespinosa/phecomp/data/CRG/20120502_FDF_CRG/20120502_FDF_CRG/20120514_FDF_CRG_c12.mtb	3023	COLL	WWSS	food_sc	4	153602	1337145775	1	0.0200000000000005	0.000526315789473697	3739	1
1	Food 1	Intake 3	265	153891	1337146064	/users/cn/jespinosa/phecomp/data/CRG/20120502_FDF_CRG/20120502_FDF_CRG/20120514_FDF_CRG_c12.mtb	2248	206	WWSS	food_sc	3	153626	1337145799	1	0.02	7.54716981132076e-05	3740	1
1	Drink 2	Intake 2	37	153923	1337146096	/users/cn/jespinosa/phecomp/data/CRG/20120502_FDF_CRG/20120502_FDF_CRG/20120514_FDF_CRG_c12.mtb	1107	NA	WWSS	water	2	153886	1337146059	1	0.0800000000000001	0.00216216216216216	3741	1
1	Food 1	Intake 3	92	154189	1337146362	/users/cn/jespinosa/phecomp/data/CRG/20120502_FDF_CRG/20120502_FDF_CRG/20120514_FDF_CRG_c12.mtb	2250	57	WWSS	food_sc	3	154097	1337146270	1	0.0399999999999999	0.000434782608695651	3742	1
1	Drink 2	Intake 2	20	154224	1337146397	/users/cn/jespinosa/phecomp/data/CRG/20120502_FDF_CRG/20120502_FDF_CRG/20120514_FDF_CRG_c12.mtb	1108	NA	WWSS	water	2	154204	1337146377	1	0.0800000000000001	0.00400000000000001	3743	1
1	Food 1	Intake 3	194	154440	1337146613	/users/cn/jespinosa/phecomp/data/CRG/20120502_FDF_CRG/20120502_FDF_CRG/20120514_FDF_CRG_c12.mtb	2251	14	WWSS	food_sc	3	154246	1337146419	1	0.04	0.000206185567010309	3744	1
1	Food 1	Intake 3	91	154545	1337146718	/users/cn/jespinosa/phecomp/data/CRG/20120502_FDF_CRG/20120502_FDF_CRG/20120514_FDF_CRG_c12.mtb	2252	396	WWSS	food_sc	3	154454	1337146627	1	0.02	0.00021978021978022	3745	1
1	Drink 2	Intake 2	13	154930	1337147103	/users/cn/jespinosa/phecomp/data/CRG/20120502_FDF_CRG/20120502_FDF_CRG/20120514_FDF_CRG_c12.mtb	1109	NA	WWSS	water	2	154917	1337147090	1	0.02	0.00153846153846154	3746	1
1	Food 1	Intake 3	101	155042	1337147215	/users/cn/jespinosa/phecomp/data/CRG/20120502_FDF_CRG/20120502_FDF_CRG/20120514_FDF_CRG_c12.mtb	2256	717	WWSS	food_sc	3	154941	1337147114	1	0.02	0.000198019801980198	3747	1
1	Drink 1	Intake 1	17	155381	1337147554	/users/cn/jespinosa/phecomp/data/CRG/20120502_FDF_CRG/20120502_FDF_CRG/20120514_FDF_CRG_c12.mtb	2224	NA	WWSS	water	1	155364	1337147537	1	0.02	0.00117647058823529	3748	1
1	Drink 1	Intake 1	1113	156688	1337148861	/users/cn/jespinosa/phecomp/data/CRG/20120502_FDF_CRG/20120502_FDF_CRG/20120514_FDF_CRG_c12.mtb	2225	NA	WWSS	water	1	155575	1337147748	1	0.04	3.59389038634322e-05	3749	1
1	Food 1	Intake 3	80	155839	1337148012	/users/cn/jespinosa/phecomp/data/CRG/20120502_FDF_CRG/20120502_FDF_CRG/20120514_FDF_CRG_c12.mtb	2262	20	WWSS	food_sc	3	155759	1337147932	1	0.02	0.00025	3750	1
1	Food 1	Intake 3	110	155969	1337148142	/users/cn/jespinosa/phecomp/data/CRG/20120502_FDF_CRG/20120502_FDF_CRG/20120514_FDF_CRG_c12.mtb	2263	170	WWSS	food_sc	3	155859	1337148032	1	0.0399999999999999	0.000363636363636363	3751	1
1	Food 1	Intake 3	242	156381	1337148554	/users/cn/jespinosa/phecomp/data/CRG/20120502_FDF_CRG/20120502_FDF_CRG/20120514_FDF_CRG_c12.mtb	2265	19	WWSS	food_sc	3	156139	1337148312	1	0.14	0.000578512396694215	3752	1
1	Food 1	Intake 3	105	156505	1337148678	/users/cn/jespinosa/phecomp/data/CRG/20120502_FDF_CRG/20120502_FDF_CRG/20120514_FDF_CRG_c12.mtb	2266	108	WWSS	food_sc	3	156400	1337148573	1	0.04	0.000380952380952381	3753	1
1	Drink 2	Intake 2	31	156529	1337148702	/users/cn/jespinosa/phecomp/data/CRG/20120502_FDF_CRG/20120502_FDF_CRG/20120514_FDF_CRG_c12.mtb	1110	NA	WWSS	water	2	156498	1337148671	1	0.0999999999999996	0.00322580645161289	3754	1
1	Food 1	Intake 3	248	156861	1337149034	/users/cn/jespinosa/phecomp/data/CRG/20120502_FDF_CRG/20120502_FDF_CRG/20120514_FDF_CRG_c12.mtb	2267	61	WWSS	food_sc	3	156613	1337148786	1	0.1	0.000403225806451613	3755	1
1	Drink 1	Intake 1	171	156891	1337149064	/users/cn/jespinosa/phecomp/data/CRG/20120502_FDF_CRG/20120502_FDF_CRG/20120514_FDF_CRG_c12.mtb	2226	NA	WWSS	water	1	156720	1337148893	1	0.0399999999999998	0.00023391812865497	3756	1
1	Drink 2	Intake 2	18	156878	1337149051	/users/cn/jespinosa/phecomp/data/CRG/20120502_FDF_CRG/20120502_FDF_CRG/20120514_FDF_CRG_c12.mtb	1111	NA	WWSS	water	2	156860	1337149033	1	0.0800000000000001	0.00444444444444445	3757	1
1	Food 1	Intake 3	100	157022	1337149195	/users/cn/jespinosa/phecomp/data/CRG/20120502_FDF_CRG/20120502_FDF_CRG/20120514_FDF_CRG_c12.mtb	2268	3648	WWSS	food_sc	3	156922	1337149095	1	0.0399999999999998	0.000399999999999998	3758	1
1	Drink 1	Intake 1	68	157126	1337149299	/users/cn/jespinosa/phecomp/data/CRG/20120502_FDF_CRG/20120502_FDF_CRG/20120514_FDF_CRG_c12.mtb	2228	NA	WWSS	water	1	157058	1337149231	1	0.02	0.000294117647058824	3759	1
1	Drink 1	Intake 1	167	157658	1337149831	/users/cn/jespinosa/phecomp/data/CRG/20120502_FDF_CRG/20120502_FDF_CRG/20120514_FDF_CRG_c12.mtb	2231	NA	WWSS	water	1	157491	1337149664	1	0.02	0.000119760479041916	3760	1
1	Drink 1	Intake 1	94	158264	1337150437	/users/cn/jespinosa/phecomp/data/CRG/20120502_FDF_CRG/20120502_FDF_CRG/20120514_FDF_CRG_c12.mtb	2234	NA	WWSS	water	1	158170	1337150343	1	0.02	0.000212765957446809	3761	1
1	Drink 1	Intake 1	20	158801	1337150974	/users/cn/jespinosa/phecomp/data/CRG/20120502_FDF_CRG/20120502_FDF_CRG/20120514_FDF_CRG_c12.mtb	2238	NA	WWSS	water	1	158781	1337150954	1	0.02	0.001	3762	1
1	Drink 1	Intake 1	71	159378	1337151551	/users/cn/jespinosa/phecomp/data/CRG/20120502_FDF_CRG/20120502_FDF_CRG/20120514_FDF_CRG_c12.mtb	2239	NA	WWSS	water	1	159307	1337151480	1	0.02	0.00028169014084507	3763	1
1	Drink 1	Intake 1	239	159654	1337151827	/users/cn/jespinosa/phecomp/data/CRG/20120502_FDF_CRG/20120502_FDF_CRG/20120514_FDF_CRG_c12.mtb	2240	NA	WWSS	water	1	159415	1337151588	1	0.02	8.36820083682008e-05	3764	1
1	Drink 1	Intake 1	520	160895	1337153068	/users/cn/jespinosa/phecomp/data/CRG/20120502_FDF_CRG/20120502_FDF_CRG/20120514_FDF_CRG_c12.mtb	2243	NA	WWSS	water	1	160375	1337152548	1	0.02	3.84615384615385e-05	3765	1
1	Food 2	Intake 4	39	160709	1337152882	/users/cn/jespinosa/phecomp/data/CRG/20120502_FDF_CRG/20120502_FDF_CRG/20120514_FDF_CRG_c12.mtb	3048	1780	WWSS	food_sc	4	160670	1337152843	1	0.0200000000000005	0.000512820512820526	3766	1
1	Drink 1	Intake 1	187	161086	1337153259	/users/cn/jespinosa/phecomp/data/CRG/20120502_FDF_CRG/20120502_FDF_CRG/20120514_FDF_CRG_c12.mtb	2244	NA	WWSS	water	1	160899	1337153072	1	0.02	0.000106951871657754	3767	1
1	Drink 1	Intake 1	18	161853	1337154026	/users/cn/jespinosa/phecomp/data/CRG/20120502_FDF_CRG/20120502_FDF_CRG/20120514_FDF_CRG_c12.mtb	2249	NA	WWSS	water	1	161835	1337154008	1	0.02	0.00111111111111111	3768	1
1	Drink 1	Intake 1	791	162698	1337154871	/users/cn/jespinosa/phecomp/data/CRG/20120502_FDF_CRG/20120502_FDF_CRG/20120514_FDF_CRG_c12.mtb	2250	NA	WWSS	water	1	161907	1337154080	1	0.02	2.52844500632111e-05	3769	1
1	Food 1	Intake 3	8	162497	1337154670	/users/cn/jespinosa/phecomp/data/CRG/20120502_FDF_CRG/20120502_FDF_CRG/20120514_FDF_CRG_c12.mtb	2269	207	WWSS	food_sc	3	162489	1337154662	1	0.04	0.005	3770	1
1	Food 1	Intake 3	86	162790	1337154963	/users/cn/jespinosa/phecomp/data/CRG/20120502_FDF_CRG/20120502_FDF_CRG/20120514_FDF_CRG_c12.mtb	2270	12	WWSS	food_sc	3	162704	1337154877	1	0.04	0.000465116279069767	3771	1
1	Drink 1	Intake 1	15	162788	1337154961	/users/cn/jespinosa/phecomp/data/CRG/20120502_FDF_CRG/20120502_FDF_CRG/20120514_FDF_CRG_c12.mtb	2251	NA	WWSS	water	1	162773	1337154946	1	0.02	0.00133333333333333	3772	1
1	Food 1	Intake 3	25	162827	1337155000	/users/cn/jespinosa/phecomp/data/CRG/20120502_FDF_CRG/20120502_FDF_CRG/20120514_FDF_CRG_c12.mtb	2271	22	WWSS	food_sc	3	162802	1337154975	1	0.04	0.0016	3773	1
1	Food 1	Intake 3	49	162898	1337155071	/users/cn/jespinosa/phecomp/data/CRG/20120502_FDF_CRG/20120502_FDF_CRG/20120514_FDF_CRG_c12.mtb	2272	1310	WWSS	food_sc	3	162849	1337155022	1	0.04	0.000816326530612245	3774	1
1	Drink 2	Intake 2	40	162963	1337155136	/users/cn/jespinosa/phecomp/data/CRG/20120502_FDF_CRG/20120502_FDF_CRG/20120514_FDF_CRG_c12.mtb	1113	NA	WWSS	water	2	162923	1337155096	1	0.16	0.004	3775	1
1	Drink 1	Intake 1	233	164147	1337156320	/users/cn/jespinosa/phecomp/data/CRG/20120502_FDF_CRG/20120502_FDF_CRG/20120514_FDF_CRG_c12.mtb	2254	NA	WWSS	water	1	163914	1337156087	1	0.02	8.58369098712446e-05	3776	1
1	Food 1	Intake 3	36	164244	1337156417	/users/cn/jespinosa/phecomp/data/CRG/20120502_FDF_CRG/20120502_FDF_CRG/20120514_FDF_CRG_c12.mtb	2273	10478	WWSS	food_sc	3	164208	1337156381	1	0.02	0.000555555555555556	3777	1
1	Drink 1	Intake 1	107	164560	1337156733	/users/cn/jespinosa/phecomp/data/CRG/20120502_FDF_CRG/20120502_FDF_CRG/20120514_FDF_CRG_c12.mtb	2256	NA	WWSS	water	1	164453	1337156626	1	0.02	0.000186915887850467	3778	1
1	Food 1	Intake 3	41	3657	1337166936	/users/cn/jespinosa/phecomp/data/CRG/20120502_FDF_CRG/20120502_FDF_CRG/20120516_FDF_CRG_c12.mtb	2310	3631	WWSS	food_sc	3	3616	1337166895	1	0.02	0.00048780487804878	3779	1
1	Food 1	Intake 3	15	7303	1337170582	/users/cn/jespinosa/phecomp/data/CRG/20120502_FDF_CRG/20120502_FDF_CRG/20120516_FDF_CRG_c12.mtb	2311	91	WWSS	food_sc	3	7288	1337170567	1	0.02	0.00133333333333333	3780	1
1	Food 1	Intake 3	21	7415	1337170694	/users/cn/jespinosa/phecomp/data/CRG/20120502_FDF_CRG/20120502_FDF_CRG/20120516_FDF_CRG_c12.mtb	2312	30	WWSS	food_sc	3	7394	1337170673	1	0.04	0.0019047619047619	3781	1
1	Food 1	Intake 3	88	7533	1337170812	/users/cn/jespinosa/phecomp/data/CRG/20120502_FDF_CRG/20120502_FDF_CRG/20120516_FDF_CRG_c12.mtb	2313	6386	WWSS	food_sc	3	7445	1337170724	1	0.06	0.000681818181818182	3782	1
1	Drink 2	Intake 2	19	8406	1337171685	/users/cn/jespinosa/phecomp/data/CRG/20120502_FDF_CRG/20120502_FDF_CRG/20120516_FDF_CRG_c12.mtb	1135	NA	WWSS	water	2	8387	1337171666	1	0.08	0.00421052631578947	3783	1
1	Food 1	Intake 3	17	13936	1337177215	/users/cn/jespinosa/phecomp/data/CRG/20120502_FDF_CRG/20120502_FDF_CRG/20120516_FDF_CRG_c12.mtb	2315	2563	WWSS	food_sc	3	13919	1337177198	1	0.02	0.00117647058823529	3784	1
1	Food 2	Intake 4	18	16517	1337179796	/users/cn/jespinosa/phecomp/data/CRG/20120502_FDF_CRG/20120502_FDF_CRG/20120516_FDF_CRG_c12.mtb	3109	27	WWSS	food_sc	4	16499	1337179778	1	0.02	0.00111111111111111	3785	1
1	Food 2	Intake 4	37	16581	1337179860	/users/cn/jespinosa/phecomp/data/CRG/20120502_FDF_CRG/20120502_FDF_CRG/20120516_FDF_CRG_c12.mtb	3110	55	WWSS	food_sc	4	16544	1337179823	1	0.02	0.000540540540540541	3786	1
1	Food 2	Intake 4	332	16968	1337180247	/users/cn/jespinosa/phecomp/data/CRG/20120502_FDF_CRG/20120502_FDF_CRG/20120516_FDF_CRG_c12.mtb	3111	229	WWSS	food_sc	4	16636	1337179915	1	0.14	0.000421686746987952	3787	1
1	Food 1	Intake 3	36	17233	1337180512	/users/cn/jespinosa/phecomp/data/CRG/20120502_FDF_CRG/20120502_FDF_CRG/20120516_FDF_CRG_c12.mtb	2319	475	WWSS	food_sc	3	17197	1337180476	1	0.02	0.000555555555555556	3788	1
1	Drink 2	Intake 2	25	17691	1337180970	/users/cn/jespinosa/phecomp/data/CRG/20120502_FDF_CRG/20120502_FDF_CRG/20120516_FDF_CRG_c12.mtb	1136	NA	WWSS	water	2	17666	1337180945	1	0.06	0.0024	3789	1
1	Food 1	Intake 3	17	17725	1337181004	/users/cn/jespinosa/phecomp/data/CRG/20120502_FDF_CRG/20120502_FDF_CRG/20120516_FDF_CRG_c12.mtb	2320	9	WWSS	food_sc	3	17708	1337180987	1	0.02	0.00117647058823529	3790	1
1	Food 1	Intake 3	55	17789	1337181068	/users/cn/jespinosa/phecomp/data/CRG/20120502_FDF_CRG/20120502_FDF_CRG/20120516_FDF_CRG_c12.mtb	2321	7016	WWSS	food_sc	3	17734	1337181013	1	0.02	0.000363636363636364	3791	1
1	Drink 2	Intake 2	23	18148	1337181427	/users/cn/jespinosa/phecomp/data/CRG/20120502_FDF_CRG/20120502_FDF_CRG/20120516_FDF_CRG_c12.mtb	1137	NA	WWSS	water	2	18125	1337181404	1	0.06	0.00260869565217391	3792	1
1	Drink 2	Intake 2	26	18701	1337181980	/users/cn/jespinosa/phecomp/data/CRG/20120502_FDF_CRG/20120502_FDF_CRG/20120516_FDF_CRG_c12.mtb	1138	NA	WWSS	water	2	18675	1337181954	1	0.08	0.00307692307692308	3793	1
1	Food 2	Intake 4	23	24828	1337188107	/users/cn/jespinosa/phecomp/data/CRG/20120502_FDF_CRG/20120502_FDF_CRG/20120516_FDF_CRG_c12.mtb	3115	14	WWSS	food_sc	4	24805	1337188084	1	0.02	0.000869565217391304	3794	1
1	Food 2	Intake 4	219	25061	1337188340	/users/cn/jespinosa/phecomp/data/CRG/20120502_FDF_CRG/20120502_FDF_CRG/20120516_FDF_CRG_c12.mtb	3116	5202	WWSS	food_sc	4	24842	1337188121	1	0.44	0.00200913242009132	3795	1
1	Food 2	Intake 4	36	30299	1337193578	/users/cn/jespinosa/phecomp/data/CRG/20120502_FDF_CRG/20120502_FDF_CRG/20120516_FDF_CRG_c12.mtb	3119	17	WWSS	food_sc	4	30263	1337193542	1	0.02	0.000555555555555556	3796	1
1	Food 2	Intake 4	30	30346	1337193625	/users/cn/jespinosa/phecomp/data/CRG/20120502_FDF_CRG/20120502_FDF_CRG/20120516_FDF_CRG_c12.mtb	3120	39	WWSS	food_sc	4	30316	1337193595	1	0.02	0.000666666666666667	3797	1
1	Food 1	Intake 3	44	30429	1337193708	/users/cn/jespinosa/phecomp/data/CRG/20120502_FDF_CRG/20120502_FDF_CRG/20120516_FDF_CRG_c12.mtb	2324	1083	WWSS	food_sc	3	30385	1337193664	1	0.02	0.000454545454545455	3798	1
1	Drink 2	Intake 2	16	30488	1337193767	/users/cn/jespinosa/phecomp/data/CRG/20120502_FDF_CRG/20120502_FDF_CRG/20120516_FDF_CRG_c12.mtb	1139	NA	WWSS	water	2	30472	1337193751	1	0.04	0.0025	3799	1
1	Drink 2	Intake 2	21	30968	1337194247	/users/cn/jespinosa/phecomp/data/CRG/20120502_FDF_CRG/20120502_FDF_CRG/20120516_FDF_CRG_c12.mtb	1141	NA	WWSS	water	2	30947	1337194226	1	0.04	0.0019047619047619	3800	1
1	Drink 2	Intake 2	8	30992	1337194271	/users/cn/jespinosa/phecomp/data/CRG/20120502_FDF_CRG/20120502_FDF_CRG/20120516_FDF_CRG_c12.mtb	1142	NA	WWSS	water	2	30984	1337194263	1	0.02	0.0025	3801	1
1	Drink 2	Intake 2	13	31068	1337194347	/users/cn/jespinosa/phecomp/data/CRG/20120502_FDF_CRG/20120502_FDF_CRG/20120516_FDF_CRG_c12.mtb	1143	NA	WWSS	water	2	31055	1337194334	1	0.04	0.00307692307692308	3802	1
1	Food 2	Intake 4	135	31647	1337194926	/users/cn/jespinosa/phecomp/data/CRG/20120502_FDF_CRG/20120502_FDF_CRG/20120516_FDF_CRG_c12.mtb	3127	28	WWSS	food_sc	4	31512	1337194791	1	0.04	0.000296296296296296	3803	1
1	Food 2	Intake 4	20	31695	1337194974	/users/cn/jespinosa/phecomp/data/CRG/20120502_FDF_CRG/20120502_FDF_CRG/20120516_FDF_CRG_c12.mtb	3128	56	WWSS	food_sc	4	31675	1337194954	1	0.02	0.001	3804	1
1	Food 2	Intake 4	153	31904	1337195183	/users/cn/jespinosa/phecomp/data/CRG/20120502_FDF_CRG/20120502_FDF_CRG/20120516_FDF_CRG_c12.mtb	3129	460	WWSS	food_sc	4	31751	1337195030	1	0.04	0.000261437908496732	3805	1
1	Drink 2	Intake 2	18	32217	1337195496	/users/cn/jespinosa/phecomp/data/CRG/20120502_FDF_CRG/20120502_FDF_CRG/20120516_FDF_CRG_c12.mtb	1144	NA	WWSS	water	2	32199	1337195478	1	0.08	0.00444444444444444	3806	1
1	Food 2	Intake 4	84	32448	1337195727	/users/cn/jespinosa/phecomp/data/CRG/20120502_FDF_CRG/20120502_FDF_CRG/20120516_FDF_CRG_c12.mtb	3132	259	WWSS	food_sc	4	32364	1337195643	1	0.0399999999999999	0.000476190476190475	3807	1
1	Drink 1	Intake 1	126	32524	1337195803	/users/cn/jespinosa/phecomp/data/CRG/20120502_FDF_CRG/20120502_FDF_CRG/20120516_FDF_CRG_c12.mtb	2329	NA	WWSS	water	1	32398	1337195677	1	0.02	0.000158730158730159	3808	1
1	Food 1	Intake 3	64	32771	1337196050	/users/cn/jespinosa/phecomp/data/CRG/20120502_FDF_CRG/20120502_FDF_CRG/20120516_FDF_CRG_c12.mtb	2334	72	WWSS	food_sc	3	32707	1337195986	1	0.02	0.0003125	3809	1
1	Food 1	Intake 3	38	32881	1337196160	/users/cn/jespinosa/phecomp/data/CRG/20120502_FDF_CRG/20120502_FDF_CRG/20120516_FDF_CRG_c12.mtb	2336	COLL	WWSS	food_sc	3	32843	1337196122	1	0.02	0.000526315789473684	3810	1
1	Food 2	Intake 4	97	32965	1337196244	/users/cn/jespinosa/phecomp/data/CRG/20120502_FDF_CRG/20120502_FDF_CRG/20120516_FDF_CRG_c12.mtb	3136	2400	WWSS	food_sc	4	32868	1337196147	1	0.04	0.000412371134020619	3811	1
1	Drink 2	Intake 2	20	32992	1337196271	/users/cn/jespinosa/phecomp/data/CRG/20120502_FDF_CRG/20120502_FDF_CRG/20120516_FDF_CRG_c12.mtb	1145	NA	WWSS	water	2	32972	1337196251	1	0.04	0.002	3812	1
1	Drink 1	Intake 1	428	34032	1337197311	/users/cn/jespinosa/phecomp/data/CRG/20120502_FDF_CRG/20120502_FDF_CRG/20120516_FDF_CRG_c12.mtb	2333	NA	WWSS	water	1	33604	1337196883	1	0.02	4.67289719626168e-05	3813	1
1	Food 2	Intake 4	52	35417	1337198696	/users/cn/jespinosa/phecomp/data/CRG/20120502_FDF_CRG/20120502_FDF_CRG/20120516_FDF_CRG_c12.mtb	3137	11	WWSS	food_sc	4	35365	1337198644	1	0.02	0.000384615384615385	3814	1
1	Food 2	Intake 4	43	35471	1337198750	/users/cn/jespinosa/phecomp/data/CRG/20120502_FDF_CRG/20120502_FDF_CRG/20120516_FDF_CRG_c12.mtb	3138	71	WWSS	food_sc	4	35428	1337198707	1	0.02	0.000465116279069767	3815	1
1	Food 2	Intake 4	44	35586	1337198865	/users/cn/jespinosa/phecomp/data/CRG/20120502_FDF_CRG/20120502_FDF_CRG/20120516_FDF_CRG_c12.mtb	3140	2071	WWSS	food_sc	4	35542	1337198821	1	0.02	0.000454545454545455	3816	1
1	Drink 2	Intake 2	15	35623	1337198902	/users/cn/jespinosa/phecomp/data/CRG/20120502_FDF_CRG/20120502_FDF_CRG/20120516_FDF_CRG_c12.mtb	1146	NA	WWSS	water	2	35608	1337198887	1	0.02	0.00133333333333333	3817	1
1	Food 2	Intake 4	289	37946	1337201225	/users/cn/jespinosa/phecomp/data/CRG/20120502_FDF_CRG/20120502_FDF_CRG/20120516_FDF_CRG_c12.mtb	3141	63	WWSS	food_sc	4	37657	1337200936	1	0.12	0.00041522491349481	3818	1
1	Drink 1	Intake 1	304	38043	1337201322	/users/cn/jespinosa/phecomp/data/CRG/20120502_FDF_CRG/20120502_FDF_CRG/20120516_FDF_CRG_c12.mtb	2346	NA	WWSS	water	1	37739	1337201018	1	0.02	6.57894736842105e-05	3819	1
1	Food 1	Intake 3	18	38027	1337201306	/users/cn/jespinosa/phecomp/data/CRG/20120502_FDF_CRG/20120502_FDF_CRG/20120516_FDF_CRG_c12.mtb	2339	11	WWSS	food_sc	3	38009	1337201288	1	0.02	0.00111111111111111	3820	1
1	Food 1	Intake 3	144	38182	1337201461	/users/cn/jespinosa/phecomp/data/CRG/20120502_FDF_CRG/20120502_FDF_CRG/20120516_FDF_CRG_c12.mtb	2340	COLL	WWSS	food_sc	3	38038	1337201317	1	0.04	0.000277777777777778	3821	1
1	Food 2	Intake 4	28	38103	1337201382	/users/cn/jespinosa/phecomp/data/CRG/20120502_FDF_CRG/20120502_FDF_CRG/20120516_FDF_CRG_c12.mtb	3143	106	WWSS	food_sc	4	38075	1337201354	1	0.02	0.000714285714285714	3822	1
1	Drink 2	Intake 2	17	38188	1337201467	/users/cn/jespinosa/phecomp/data/CRG/20120502_FDF_CRG/20120502_FDF_CRG/20120516_FDF_CRG_c12.mtb	1147	NA	WWSS	water	2	38171	1337201450	1	0.0399999999999999	0.00235294117647058	3823	1
1	Food 1	Intake 3	79	38288	1337201567	/users/cn/jespinosa/phecomp/data/CRG/20120502_FDF_CRG/20120502_FDF_CRG/20120516_FDF_CRG_c12.mtb	2341	COLL	WWSS	food_sc	3	38209	1337201488	1	0.02	0.000253164556962025	3824	1
1	Food 2	Intake 4	85	38346	1337201625	/users/cn/jespinosa/phecomp/data/CRG/20120502_FDF_CRG/20120502_FDF_CRG/20120516_FDF_CRG_c12.mtb	3144	10	WWSS	food_sc	4	38261	1337201540	1	0.02	0.000235294117647059	3825	1
1	Food 2	Intake 4	56	38412	1337201691	/users/cn/jespinosa/phecomp/data/CRG/20120502_FDF_CRG/20120502_FDF_CRG/20120516_FDF_CRG_c12.mtb	3145	82	WWSS	food_sc	4	38356	1337201635	1	0.02	0.000357142857142857	3826	1
1	Drink 2	Intake 2	18	38506	1337201785	/users/cn/jespinosa/phecomp/data/CRG/20120502_FDF_CRG/20120502_FDF_CRG/20120516_FDF_CRG_c12.mtb	1148	NA	WWSS	water	2	38488	1337201767	1	0.02	0.00111111111111111	3827	1
1	Food 1	Intake 3	97	38591	1337201870	/users/cn/jespinosa/phecomp/data/CRG/20120502_FDF_CRG/20120502_FDF_CRG/20120516_FDF_CRG_c12.mtb	2344	971	WWSS	food_sc	3	38494	1337201773	1	0.02	0.000206185567010309	3828	1
1	Drink 2	Intake 2	25	38744	1337202023	/users/cn/jespinosa/phecomp/data/CRG/20120502_FDF_CRG/20120502_FDF_CRG/20120516_FDF_CRG_c12.mtb	1149	NA	WWSS	water	2	38719	1337201998	1	0.04	0.0016	3829	1
1	Drink 2	Intake 2	13	38803	1337202082	/users/cn/jespinosa/phecomp/data/CRG/20120502_FDF_CRG/20120502_FDF_CRG/20120516_FDF_CRG_c12.mtb	1150	NA	WWSS	water	2	38790	1337202069	1	0.02	0.00153846153846154	3830	1
1	Drink 1	Intake 1	19	38960	1337202239	/users/cn/jespinosa/phecomp/data/CRG/20120502_FDF_CRG/20120502_FDF_CRG/20120516_FDF_CRG_c12.mtb	2351	NA	WWSS	water	1	38941	1337202220	1	0.04	0.00210526315789474	3831	1
1	Drink 1	Intake 1	14	39496	1337202775	/users/cn/jespinosa/phecomp/data/CRG/20120502_FDF_CRG/20120502_FDF_CRG/20120516_FDF_CRG_c12.mtb	2352	NA	WWSS	water	1	39482	1337202761	1	0.02	0.00142857142857143	3832	1
1	Drink 2	Intake 2	15	39499	1337202778	/users/cn/jespinosa/phecomp/data/CRG/20120502_FDF_CRG/20120502_FDF_CRG/20120516_FDF_CRG_c12.mtb	1151	NA	WWSS	water	2	39484	1337202763	1	0.0399999999999999	0.00266666666666666	3833	1
1	Food 2	Intake 4	104	39666	1337202945	/users/cn/jespinosa/phecomp/data/CRG/20120502_FDF_CRG/20120502_FDF_CRG/20120516_FDF_CRG_c12.mtb	3153	29	WWSS	food_sc	4	39562	1337202841	1	0.02	0.000192307692307692	3834	1
1	Food 2	Intake 4	32	39727	1337203006	/users/cn/jespinosa/phecomp/data/CRG/20120502_FDF_CRG/20120502_FDF_CRG/20120516_FDF_CRG_c12.mtb	3154	83	WWSS	food_sc	4	39695	1337202974	1	0.02	0.000625	3835	1
1	Food 2	Intake 4	119	39929	1337203208	/users/cn/jespinosa/phecomp/data/CRG/20120502_FDF_CRG/20120502_FDF_CRG/20120516_FDF_CRG_c12.mtb	3156	285	WWSS	food_sc	4	39810	1337203089	1	0.02	0.000168067226890756	3836	1
1	Drink 1	Intake 1	15	39978	1337203257	/users/cn/jespinosa/phecomp/data/CRG/20120502_FDF_CRG/20120502_FDF_CRG/20120516_FDF_CRG_c12.mtb	2353	NA	WWSS	water	1	39963	1337203242	1	0.02	0.00133333333333333	3837	1
1	Drink 2	Intake 2	13	40149	1337203428	/users/cn/jespinosa/phecomp/data/CRG/20120502_FDF_CRG/20120502_FDF_CRG/20120516_FDF_CRG_c12.mtb	1152	NA	WWSS	water	2	40136	1337203415	1	0.02	0.00153846153846154	3838	1
1	Drink 1	Intake 1	8	40158	1337203437	/users/cn/jespinosa/phecomp/data/CRG/20120502_FDF_CRG/20120502_FDF_CRG/20120516_FDF_CRG_c12.mtb	2355	NA	WWSS	water	1	40150	1337203429	1	0.02	0.0025	3839	1
1	Food 2	Intake 4	45	40259	1337203538	/users/cn/jespinosa/phecomp/data/CRG/20120502_FDF_CRG/20120502_FDF_CRG/20120516_FDF_CRG_c12.mtb	3157	91	WWSS	food_sc	4	40214	1337203493	1	0.02	0.000444444444444444	3840	1
1	Food 2	Intake 4	49	40399	1337203678	/users/cn/jespinosa/phecomp/data/CRG/20120502_FDF_CRG/20120502_FDF_CRG/20120516_FDF_CRG_c12.mtb	3159	79	WWSS	food_sc	4	40350	1337203629	1	0.02	0.000408163265306122	3841	1
1	Food 2	Intake 4	100	40578	1337203857	/users/cn/jespinosa/phecomp/data/CRG/20120502_FDF_CRG/20120502_FDF_CRG/20120516_FDF_CRG_c12.mtb	3161	125	WWSS	food_sc	4	40478	1337203757	1	0.02	0.0002	3842	1
1	Drink 2	Intake 2	17	40611	1337203890	/users/cn/jespinosa/phecomp/data/CRG/20120502_FDF_CRG/20120502_FDF_CRG/20120516_FDF_CRG_c12.mtb	1154	NA	WWSS	water	2	40594	1337203873	1	0.0600000000000001	0.00352941176470589	3843	1
1	Food 2	Intake 4	103	40806	1337204085	/users/cn/jespinosa/phecomp/data/CRG/20120502_FDF_CRG/20120502_FDF_CRG/20120516_FDF_CRG_c12.mtb	3162	588	WWSS	food_sc	4	40703	1337203982	1	0.04	0.000388349514563107	3844	1
1	Food 1	Intake 3	115	41509	1337204788	/users/cn/jespinosa/phecomp/data/CRG/20120502_FDF_CRG/20120502_FDF_CRG/20120516_FDF_CRG_c12.mtb	2359	31	WWSS	food_sc	3	41394	1337204673	1	0.06	0.000521739130434783	3845	1
1	Food 2	Intake 4	65	41605	1337204884	/users/cn/jespinosa/phecomp/data/CRG/20120502_FDF_CRG/20120502_FDF_CRG/20120516_FDF_CRG_c12.mtb	3168	752	WWSS	food_sc	4	41540	1337204819	1	0.0399999999999998	0.000615384615384612	3846	1
1	Drink 2	Intake 2	28	41626	1337204905	/users/cn/jespinosa/phecomp/data/CRG/20120502_FDF_CRG/20120502_FDF_CRG/20120516_FDF_CRG_c12.mtb	1155	NA	WWSS	water	2	41598	1337204877	1	0.08	0.00285714285714286	3847	1
1	Food 2	Intake 4	83	42440	1337205719	/users/cn/jespinosa/phecomp/data/CRG/20120502_FDF_CRG/20120502_FDF_CRG/20120516_FDF_CRG_c12.mtb	3171	COLL	WWSS	food_sc	4	42357	1337205636	1	0.02	0.000240963855421687	3848	1
1	Food 1	Intake 3	192	42620	1337205899	/users/cn/jespinosa/phecomp/data/CRG/20120502_FDF_CRG/20120502_FDF_CRG/20120516_FDF_CRG_c12.mtb	2366	1198	WWSS	food_sc	3	42428	1337205707	1	0.02	0.000104166666666667	3849	1
1	Drink 2	Intake 2	26	42812	1337206091	/users/cn/jespinosa/phecomp/data/CRG/20120502_FDF_CRG/20120502_FDF_CRG/20120516_FDF_CRG_c12.mtb	1156	NA	WWSS	water	2	42786	1337206065	1	0.04	0.00153846153846154	3850	1
1	Drink 2	Intake 2	18	43197	1337206476	/users/cn/jespinosa/phecomp/data/CRG/20120502_FDF_CRG/20120502_FDF_CRG/20120516_FDF_CRG_c12.mtb	1157	NA	WWSS	water	2	43179	1337206458	1	0.0399999999999999	0.00222222222222222	3851	1
1	Food 2	Intake 4	128	43946	1337207225	/users/cn/jespinosa/phecomp/data/CRG/20120502_FDF_CRG/20120502_FDF_CRG/20120516_FDF_CRG_c12.mtb	3176	12	WWSS	food_sc	4	43818	1337207097	1	0.02	0.00015625	3852	1
1	Food 2	Intake 4	17	43975	1337207254	/users/cn/jespinosa/phecomp/data/CRG/20120502_FDF_CRG/20120502_FDF_CRG/20120516_FDF_CRG_c12.mtb	3177	41	WWSS	food_sc	4	43958	1337207237	1	0.02	0.00117647058823529	3853	1
1	Food 1	Intake 3	132	44148	1337207427	/users/cn/jespinosa/phecomp/data/CRG/20120502_FDF_CRG/20120502_FDF_CRG/20120516_FDF_CRG_c12.mtb	2371	199	WWSS	food_sc	3	44016	1337207295	1	0.02	0.000151515151515152	3854	1
1	Food 1	Intake 3	48	44395	1337207674	/users/cn/jespinosa/phecomp/data/CRG/20120502_FDF_CRG/20120502_FDF_CRG/20120516_FDF_CRG_c12.mtb	2374	3657	WWSS	food_sc	3	44347	1337207626	1	0.02	0.000416666666666667	3855	1
1	Drink 2	Intake 2	23	44415	1337207694	/users/cn/jespinosa/phecomp/data/CRG/20120502_FDF_CRG/20120502_FDF_CRG/20120516_FDF_CRG_c12.mtb	1158	NA	WWSS	water	2	44392	1337207671	1	0.0600000000000001	0.00260869565217392	3856	1
1	Food 2	Intake 4	115	48167	1337211446	/users/cn/jespinosa/phecomp/data/CRG/20120502_FDF_CRG/20120502_FDF_CRG/20120516_FDF_CRG_c12.mtb	3180	12	WWSS	food_sc	4	48052	1337211331	1	0.0600000000000001	0.000521739130434784	3857	1
1	Food 2	Intake 4	30	48209	1337211488	/users/cn/jespinosa/phecomp/data/CRG/20120502_FDF_CRG/20120502_FDF_CRG/20120516_FDF_CRG_c12.mtb	3181	63	WWSS	food_sc	4	48179	1337211458	1	0.02	0.000666666666666667	3858	1
1	Food 1	Intake 3	56	48328	1337211607	/users/cn/jespinosa/phecomp/data/CRG/20120502_FDF_CRG/20120502_FDF_CRG/20120516_FDF_CRG_c12.mtb	2375	22	WWSS	food_sc	3	48272	1337211551	1	0.02	0.000357142857142857	3859	1
1	Food 1	Intake 3	21	48371	1337211650	/users/cn/jespinosa/phecomp/data/CRG/20120502_FDF_CRG/20120502_FDF_CRG/20120516_FDF_CRG_c12.mtb	2376	248	WWSS	food_sc	3	48350	1337211629	1	0.02	0.000952380952380952	3860	1
1	Food 2	Intake 4	158	48777	1337212056	/users/cn/jespinosa/phecomp/data/CRG/20120502_FDF_CRG/20120502_FDF_CRG/20120516_FDF_CRG_c12.mtb	3184	48	WWSS	food_sc	4	48619	1337211898	1	0.04	0.000253164556962025	3861	1
1	Drink 2	Intake 2	17	48807	1337212086	/users/cn/jespinosa/phecomp/data/CRG/20120502_FDF_CRG/20120502_FDF_CRG/20120516_FDF_CRG_c12.mtb	1159	NA	WWSS	water	2	48790	1337212069	1	0.02	0.00117647058823529	3862	1
1	Food 2	Intake 4	94	48919	1337212198	/users/cn/jespinosa/phecomp/data/CRG/20120502_FDF_CRG/20120502_FDF_CRG/20120516_FDF_CRG_c12.mtb	3185	16	WWSS	food_sc	4	48825	1337212104	1	0.02	0.000212765957446809	3863	1
1	Food 2	Intake 4	100	49035	1337212314	/users/cn/jespinosa/phecomp/data/CRG/20120502_FDF_CRG/20120502_FDF_CRG/20120516_FDF_CRG_c12.mtb	3186	604	WWSS	food_sc	4	48935	1337212214	1	0.04	0.0004	3864	1
1	Drink 2	Intake 2	22	49052	1337212331	/users/cn/jespinosa/phecomp/data/CRG/20120502_FDF_CRG/20120502_FDF_CRG/20120516_FDF_CRG_c12.mtb	1160	NA	WWSS	water	2	49030	1337212309	1	0.0600000000000001	0.00272727272727273	3865	1
1	Drink 2	Intake 2	25	49221	1337212500	/users/cn/jespinosa/phecomp/data/CRG/20120502_FDF_CRG/20120502_FDF_CRG/20120516_FDF_CRG_c12.mtb	1161	NA	WWSS	water	2	49196	1337212475	1	0.0599999999999998	0.00239999999999999	3866	1
1	Drink 2	Intake 2	21	49417	1337212696	/users/cn/jespinosa/phecomp/data/CRG/20120502_FDF_CRG/20120502_FDF_CRG/20120516_FDF_CRG_c12.mtb	1162	NA	WWSS	water	2	49396	1337212675	1	0.02	0.000952380952380952	3867	1
1	Food 1	Intake 3	192	49831	1337213110	/users/cn/jespinosa/phecomp/data/CRG/20120502_FDF_CRG/20120502_FDF_CRG/20120516_FDF_CRG_c12.mtb	2388	1094	WWSS	food_sc	3	49639	1337212918	1	0.02	0.000104166666666667	3868	1
1	Drink 2	Intake 2	26	49870	1337213149	/users/cn/jespinosa/phecomp/data/CRG/20120502_FDF_CRG/20120502_FDF_CRG/20120516_FDF_CRG_c12.mtb	1163	NA	WWSS	water	2	49844	1337213123	1	0.0600000000000001	0.00230769230769231	3869	1
1	Food 1	Intake 3	101	51026	1337214305	/users/cn/jespinosa/phecomp/data/CRG/20120502_FDF_CRG/20120502_FDF_CRG/20120516_FDF_CRG_c12.mtb	2393	370	WWSS	food_sc	3	50925	1337214204	1	0.0399999999999999	0.000396039603960395	3870	1
1	Drink 2	Intake 2	17	51093	1337214372	/users/cn/jespinosa/phecomp/data/CRG/20120502_FDF_CRG/20120502_FDF_CRG/20120516_FDF_CRG_c12.mtb	1165	NA	WWSS	water	2	51076	1337214355	1	0.02	0.00117647058823529	3871	1
1	Food 1	Intake 3	117	51513	1337214792	/users/cn/jespinosa/phecomp/data/CRG/20120502_FDF_CRG/20120502_FDF_CRG/20120516_FDF_CRG_c12.mtb	2394	29	WWSS	food_sc	3	51396	1337214675	1	0.44	0.00376068376068376	3872	1
1	Drink 2	Intake 2	31	51546	1337214825	/users/cn/jespinosa/phecomp/data/CRG/20120502_FDF_CRG/20120502_FDF_CRG/20120516_FDF_CRG_c12.mtb	1167	NA	WWSS	water	2	51515	1337214794	1	0.04	0.00129032258064516	3873	1
1	Food 1	Intake 3	78	51620	1337214899	/users/cn/jespinosa/phecomp/data/CRG/20120502_FDF_CRG/20120502_FDF_CRG/20120516_FDF_CRG_c12.mtb	2395	59	WWSS	food_sc	3	51542	1337214821	1	0.02	0.000256410256410256	3874	1
1	Food 1	Intake 3	64	51743	1337215022	/users/cn/jespinosa/phecomp/data/CRG/20120502_FDF_CRG/20120502_FDF_CRG/20120516_FDF_CRG_c12.mtb	2397	3224	WWSS	food_sc	3	51679	1337214958	1	0.02	0.0003125	3875	1
1	Drink 2	Intake 2	29	52178	1337215457	/users/cn/jespinosa/phecomp/data/CRG/20120502_FDF_CRG/20120502_FDF_CRG/20120516_FDF_CRG_c12.mtb	1169	NA	WWSS	water	2	52149	1337215428	1	0.02	0.000689655172413793	3876	1
1	Food 2	Intake 4	49	55016	1337218295	/users/cn/jespinosa/phecomp/data/CRG/20120502_FDF_CRG/20120502_FDF_CRG/20120516_FDF_CRG_c12.mtb	3198	3328	WWSS	food_sc	4	54967	1337218246	1	0.04	0.000816326530612245	3877	1
1	Food 2	Intake 4	99	58443	1337221722	/users/cn/jespinosa/phecomp/data/CRG/20120502_FDF_CRG/20120502_FDF_CRG/20120516_FDF_CRG_c12.mtb	3200	3080	WWSS	food_sc	4	58344	1337221623	1	0.0599999999999998	0.000606060606060604	3878	1
1	Food 1	Intake 3	16	61539	1337224818	/users/cn/jespinosa/phecomp/data/CRG/20120502_FDF_CRG/20120502_FDF_CRG/20120516_FDF_CRG_c12.mtb	2399	10	WWSS	food_sc	3	61523	1337224802	1	0.02	0.00125	3879	1
1	Food 1	Intake 3	40	61589	1337224868	/users/cn/jespinosa/phecomp/data/CRG/20120502_FDF_CRG/20120502_FDF_CRG/20120516_FDF_CRG_c12.mtb	2400	30	WWSS	food_sc	3	61549	1337224828	1	0.0599999999999998	0.00149999999999999	3880	1
1	Food 1	Intake 3	12	61631	1337224910	/users/cn/jespinosa/phecomp/data/CRG/20120502_FDF_CRG/20120502_FDF_CRG/20120516_FDF_CRG_c12.mtb	2401	2934	WWSS	food_sc	3	61619	1337224898	1	0.02	0.00166666666666667	3881	1
1	Food 1	Intake 3	101	64666	1337227945	/users/cn/jespinosa/phecomp/data/CRG/20120502_FDF_CRG/20120502_FDF_CRG/20120516_FDF_CRG_c12.mtb	2402	1988	WWSS	food_sc	3	64565	1337227844	1	0.04	0.000396039603960396	3882	1
1	Drink 2	Intake 2	31	66032	1337229311	/users/cn/jespinosa/phecomp/data/CRG/20120502_FDF_CRG/20120502_FDF_CRG/20120516_FDF_CRG_c12.mtb	1172	NA	WWSS	water	2	66001	1337229280	1	0.16	0.00516129032258065	3883	1
1	Food 2	Intake 4	31	66685	1337229964	/users/cn/jespinosa/phecomp/data/CRG/20120502_FDF_CRG/20120502_FDF_CRG/20120516_FDF_CRG_c12.mtb	3206	117	WWSS	food_sc	4	66654	1337229933	1	0.02	0.000645161290322581	3884	1
1	Food 1	Intake 3	19	66821	1337230100	/users/cn/jespinosa/phecomp/data/CRG/20120502_FDF_CRG/20120502_FDF_CRG/20120516_FDF_CRG_c12.mtb	2406	16	WWSS	food_sc	3	66802	1337230081	1	0.02	0.00105263157894737	3885	1
1	Food 1	Intake 3	41	66878	1337230157	/users/cn/jespinosa/phecomp/data/CRG/20120502_FDF_CRG/20120502_FDF_CRG/20120516_FDF_CRG_c12.mtb	2407	85	WWSS	food_sc	3	66837	1337230116	1	0.02	0.00048780487804878	3886	1
1	Food 2	Intake 4	115	67078	1337230357	/users/cn/jespinosa/phecomp/data/CRG/20120502_FDF_CRG/20120502_FDF_CRG/20120516_FDF_CRG_c12.mtb	3210	12	WWSS	food_sc	4	66963	1337230242	1	0.04	0.000347826086956522	3887	1
1	Food 2	Intake 4	83	67173	1337230452	/users/cn/jespinosa/phecomp/data/CRG/20120502_FDF_CRG/20120502_FDF_CRG/20120516_FDF_CRG_c12.mtb	3211	17	WWSS	food_sc	4	67090	1337230369	1	0.02	0.000240963855421687	3888	1
1	Food 2	Intake 4	97	67287	1337230566	/users/cn/jespinosa/phecomp/data/CRG/20120502_FDF_CRG/20120502_FDF_CRG/20120516_FDF_CRG_c12.mtb	3212	75	WWSS	food_sc	4	67190	1337230469	1	0.0399999999999998	0.000412371134020617	3889	1
1	Drink 2	Intake 2	31	67311	1337230590	/users/cn/jespinosa/phecomp/data/CRG/20120502_FDF_CRG/20120502_FDF_CRG/20120516_FDF_CRG_c12.mtb	1173	NA	WWSS	water	2	67280	1337230559	1	0.0800000000000001	0.00258064516129033	3890	1
1	Food 2	Intake 4	154	67516	1337230795	/users/cn/jespinosa/phecomp/data/CRG/20120502_FDF_CRG/20120502_FDF_CRG/20120516_FDF_CRG_c12.mtb	3213	22	WWSS	food_sc	4	67362	1337230641	1	0.02	0.00012987012987013	3891	1
1	Drink 2	Intake 2	16	67529	1337230808	/users/cn/jespinosa/phecomp/data/CRG/20120502_FDF_CRG/20120502_FDF_CRG/20120516_FDF_CRG_c12.mtb	1175	NA	WWSS	water	2	67513	1337230792	1	0.04	0.0025	3892	1
1	Food 2	Intake 4	68	67606	1337230885	/users/cn/jespinosa/phecomp/data/CRG/20120502_FDF_CRG/20120502_FDF_CRG/20120516_FDF_CRG_c12.mtb	3214	127	WWSS	food_sc	4	67538	1337230817	1	0.04	0.000588235294117647	3893	1
1	Food 2	Intake 4	31	67764	1337231043	/users/cn/jespinosa/phecomp/data/CRG/20120502_FDF_CRG/20120502_FDF_CRG/20120516_FDF_CRG_c12.mtb	3216	1363	WWSS	food_sc	4	67733	1337231012	1	0.04	0.00129032258064516	3894	1
1	Drink 2	Intake 2	23	67784	1337231063	/users/cn/jespinosa/phecomp/data/CRG/20120502_FDF_CRG/20120502_FDF_CRG/20120516_FDF_CRG_c12.mtb	1177	NA	WWSS	water	2	67761	1337231040	1	0.0800000000000001	0.00347826086956522	3895	1
1	Drink 2	Intake 2	23	68537	1337231816	/users/cn/jespinosa/phecomp/data/CRG/20120502_FDF_CRG/20120502_FDF_CRG/20120516_FDF_CRG_c12.mtb	1179	NA	WWSS	water	2	68514	1337231793	1	0.04	0.00173913043478261	3896	1
1	Drink 1	Intake 1	26	68608	1337231887	/users/cn/jespinosa/phecomp/data/CRG/20120502_FDF_CRG/20120502_FDF_CRG/20120516_FDF_CRG_c12.mtb	2364	NA	WWSS	water	1	68582	1337231861	1	0.02	0.000769230769230769	3897	1
1	Food 2	Intake 4	75	69202	1337232481	/users/cn/jespinosa/phecomp/data/CRG/20120502_FDF_CRG/20120502_FDF_CRG/20120516_FDF_CRG_c12.mtb	3220	498	WWSS	food_sc	4	69127	1337232406	1	0.02	0.000266666666666667	3898	1
1	Drink 2	Intake 2	22	69594	1337232873	/users/cn/jespinosa/phecomp/data/CRG/20120502_FDF_CRG/20120502_FDF_CRG/20120516_FDF_CRG_c12.mtb	1180	NA	WWSS	water	2	69572	1337232851	1	0.04	0.00181818181818182	3899	1
1	Food 2	Intake 4	46	69746	1337233025	/users/cn/jespinosa/phecomp/data/CRG/20120502_FDF_CRG/20120502_FDF_CRG/20120516_FDF_CRG_c12.mtb	3225	206	WWSS	food_sc	4	69700	1337232979	1	0.02	0.000434782608695652	3900	1
1	Food 2	Intake 4	32	69984	1337233263	/users/cn/jespinosa/phecomp/data/CRG/20120502_FDF_CRG/20120502_FDF_CRG/20120516_FDF_CRG_c12.mtb	3229	282	WWSS	food_sc	4	69952	1337233231	1	0.02	0.000625	3901	1
1	Drink 2	Intake 2	21	70001	1337233280	/users/cn/jespinosa/phecomp/data/CRG/20120502_FDF_CRG/20120502_FDF_CRG/20120516_FDF_CRG_c12.mtb	1182	NA	WWSS	water	2	69980	1337233259	1	0.02	0.000952380952380952	3902	1
1	Drink 2	Intake 2	25	70262	1337233541	/users/cn/jespinosa/phecomp/data/CRG/20120502_FDF_CRG/20120502_FDF_CRG/20120516_FDF_CRG_c12.mtb	1183	NA	WWSS	water	2	70237	1337233516	1	0.0399999999999998	0.00159999999999999	3903	1
1	Food 2	Intake 4	79	70345	1337233624	/users/cn/jespinosa/phecomp/data/CRG/20120502_FDF_CRG/20120502_FDF_CRG/20120516_FDF_CRG_c12.mtb	3231	252	WWSS	food_sc	4	70266	1337233545	1	0.02	0.000253164556962025	3904	1
1	Food 1	Intake 3	105	70702	1337233981	/users/cn/jespinosa/phecomp/data/CRG/20120502_FDF_CRG/20120502_FDF_CRG/20120516_FDF_CRG_c12.mtb	2427	129	WWSS	food_sc	3	70597	1337233876	1	0.04	0.000380952380952381	3905	1
1	Drink 2	Intake 2	28	70739	1337234018	/users/cn/jespinosa/phecomp/data/CRG/20120502_FDF_CRG/20120502_FDF_CRG/20120516_FDF_CRG_c12.mtb	1184	NA	WWSS	water	2	70711	1337233990	1	0.0600000000000001	0.00214285714285715	3906	1
1	Food 2	Intake 4	144	70975	1337234254	/users/cn/jespinosa/phecomp/data/CRG/20120502_FDF_CRG/20120502_FDF_CRG/20120516_FDF_CRG_c12.mtb	3236	133	WWSS	food_sc	4	70831	1337234110	1	0.02	0.000138888888888889	3907	1
1	Food 2	Intake 4	113	71221	1337234500	/users/cn/jespinosa/phecomp/data/CRG/20120502_FDF_CRG/20120502_FDF_CRG/20120516_FDF_CRG_c12.mtb	3238	287	WWSS	food_sc	4	71108	1337234387	1	0.04	0.000353982300884956	3908	1
1	Drink 2	Intake 2	17	71230	1337234509	/users/cn/jespinosa/phecomp/data/CRG/20120502_FDF_CRG/20120502_FDF_CRG/20120516_FDF_CRG_c12.mtb	1185	NA	WWSS	water	2	71213	1337234492	1	0.02	0.00117647058823529	3909	1
1	Food 1	Intake 3	59	71567	1337234846	/users/cn/jespinosa/phecomp/data/CRG/20120502_FDF_CRG/20120502_FDF_CRG/20120516_FDF_CRG_c12.mtb	2434	4	WWSS	food_sc	3	71508	1337234787	1	0.02	0.000338983050847458	3910	1
1	Food 1	Intake 3	215	71786	1337235065	/users/cn/jespinosa/phecomp/data/CRG/20120502_FDF_CRG/20120502_FDF_CRG/20120516_FDF_CRG_c12.mtb	2435	96	WWSS	food_sc	3	71571	1337234850	1	0.0399999999999998	0.000186046511627906	3911	1
1	Drink 2	Intake 2	41	71837	1337235116	/users/cn/jespinosa/phecomp/data/CRG/20120502_FDF_CRG/20120502_FDF_CRG/20120516_FDF_CRG_c12.mtb	1186	NA	WWSS	water	2	71796	1337235075	1	0.12	0.00292682926829268	3912	1
1	Food 1	Intake 3	52	71934	1337235213	/users/cn/jespinosa/phecomp/data/CRG/20120502_FDF_CRG/20120502_FDF_CRG/20120516_FDF_CRG_c12.mtb	2436	778	WWSS	food_sc	3	71882	1337235161	1	0.02	0.000384615384615385	3913	1
1	Drink 2	Intake 2	15	72138	1337235417	/users/cn/jespinosa/phecomp/data/CRG/20120502_FDF_CRG/20120502_FDF_CRG/20120516_FDF_CRG_c12.mtb	1187	NA	WWSS	water	2	72123	1337235402	1	0.04	0.00266666666666667	3914	1
1	Food 1	Intake 3	80	72792	1337236071	/users/cn/jespinosa/phecomp/data/CRG/20120502_FDF_CRG/20120502_FDF_CRG/20120516_FDF_CRG_c12.mtb	2438	4788	WWSS	food_sc	3	72712	1337235991	1	0.02	0.00025	3915	1
1	Food 1	Intake 3	42	77622	1337240901	/users/cn/jespinosa/phecomp/data/CRG/20120502_FDF_CRG/20120502_FDF_CRG/20120516_FDF_CRG_c12.mtb	2439	72	WWSS	food_sc	3	77580	1337240859	1	0.04	0.000952380952380952	3916	1
1	Food 1	Intake 3	41	77735	1337241014	/users/cn/jespinosa/phecomp/data/CRG/20120502_FDF_CRG/20120502_FDF_CRG/20120516_FDF_CRG_c12.mtb	2440	18	WWSS	food_sc	3	77694	1337240973	1	0.02	0.00048780487804878	3917	1
1	Food 1	Intake 3	35	77788	1337241067	/users/cn/jespinosa/phecomp/data/CRG/20120502_FDF_CRG/20120502_FDF_CRG/20120516_FDF_CRG_c12.mtb	2441	28	WWSS	food_sc	3	77753	1337241032	1	0.04	0.00114285714285714	3918	1
1	Food 1	Intake 3	41	77857	1337241136	/users/cn/jespinosa/phecomp/data/CRG/20120502_FDF_CRG/20120502_FDF_CRG/20120516_FDF_CRG_c12.mtb	2442	5994	WWSS	food_sc	3	77816	1337241095	1	0.04	0.000975609756097561	3919	1
1	Drink 1	Intake 1	26	77893	1337241172	/users/cn/jespinosa/phecomp/data/CRG/20120502_FDF_CRG/20120502_FDF_CRG/20120516_FDF_CRG_c12.mtb	2366	NA	WWSS	water	1	77867	1337241146	1	0.06	0.00230769230769231	3920	1
1	Drink 2	Intake 2	39	78368	1337241647	/users/cn/jespinosa/phecomp/data/CRG/20120502_FDF_CRG/20120502_FDF_CRG/20120516_FDF_CRG_c12.mtb	1188	NA	WWSS	water	2	78329	1337241608	1	0.14	0.00358974358974359	3921	1
1	Food 1	Intake 3	24	83875	1337247154	/users/cn/jespinosa/phecomp/data/CRG/20120502_FDF_CRG/20120502_FDF_CRG/20120516_FDF_CRG_c12.mtb	2444	30	WWSS	food_sc	3	83851	1337247130	1	0.02	0.000833333333333333	3922	1
1	Food 1	Intake 3	40	83945	1337247224	/users/cn/jespinosa/phecomp/data/CRG/20120502_FDF_CRG/20120502_FDF_CRG/20120516_FDF_CRG_c12.mtb	2445	12	WWSS	food_sc	3	83905	1337247184	1	0.02	0.0005	3923	1
1	Food 1	Intake 3	36	83993	1337247272	/users/cn/jespinosa/phecomp/data/CRG/20120502_FDF_CRG/20120502_FDF_CRG/20120516_FDF_CRG_c12.mtb	2446	COLL	WWSS	food_sc	3	83957	1337247236	1	0.02	0.000555555555555556	3924	1
1	Food 2	Intake 4	16	84001	1337247280	/users/cn/jespinosa/phecomp/data/CRG/20120502_FDF_CRG/20120502_FDF_CRG/20120516_FDF_CRG_c12.mtb	3245	3386	WWSS	food_sc	4	83985	1337247264	1	0.02	0.00125	3925	1
1	Drink 1	Intake 1	17	87026	1337250305	/users/cn/jespinosa/phecomp/data/CRG/20120502_FDF_CRG/20120502_FDF_CRG/20120516_FDF_CRG_c12.mtb	2369	NA	WWSS	water	1	87009	1337250288	1	0.02	0.00117647058823529	3926	1
1	Food 2	Intake 4	73	87460	1337250739	/users/cn/jespinosa/phecomp/data/CRG/20120502_FDF_CRG/20120502_FDF_CRG/20120516_FDF_CRG_c12.mtb	3249	10616	WWSS	food_sc	4	87387	1337250666	1	0.02	0.000273972602739726	3927	1
1	Drink 1	Intake 1	17	89278	1337252557	/users/cn/jespinosa/phecomp/data/CRG/20120502_FDF_CRG/20120502_FDF_CRG/20120516_FDF_CRG_c12.mtb	2378	NA	WWSS	water	1	89261	1337252540	1	0.02	0.00117647058823529	3928	1
1	Drink 1	Intake 1	545	90026	1337253305	/users/cn/jespinosa/phecomp/data/CRG/20120502_FDF_CRG/20120502_FDF_CRG/20120516_FDF_CRG_c12.mtb	2379	NA	WWSS	water	1	89481	1337252760	1	0.02	3.6697247706422e-05	3929	1
1	Drink 1	Intake 1	44	90961	1337254240	/users/cn/jespinosa/phecomp/data/CRG/20120502_FDF_CRG/20120502_FDF_CRG/20120516_FDF_CRG_c12.mtb	2383	NA	WWSS	water	1	90917	1337254196	1	0.02	0.000454545454545455	3930	1
1	Drink 1	Intake 1	80	91085	1337254364	/users/cn/jespinosa/phecomp/data/CRG/20120502_FDF_CRG/20120502_FDF_CRG/20120516_FDF_CRG_c12.mtb	2384	NA	WWSS	water	1	91005	1337254284	1	0.02	0.00025	3931	1
1	Drink 1	Intake 1	248	91592	1337254871	/users/cn/jespinosa/phecomp/data/CRG/20120502_FDF_CRG/20120502_FDF_CRG/20120516_FDF_CRG_c12.mtb	2387	NA	WWSS	water	1	91344	1337254623	1	0.04	0.000161290322580645	3932	1
1	Drink 1	Intake 1	221	91984	1337255263	/users/cn/jespinosa/phecomp/data/CRG/20120502_FDF_CRG/20120502_FDF_CRG/20120516_FDF_CRG_c12.mtb	2388	NA	WWSS	water	1	91763	1337255042	1	0.02	9.04977375565611e-05	3933	1
1	Drink 1	Intake 1	9	92996	1337256275	/users/cn/jespinosa/phecomp/data/CRG/20120502_FDF_CRG/20120502_FDF_CRG/20120516_FDF_CRG_c12.mtb	2391	NA	WWSS	water	1	92987	1337256266	1	0.02	0.00222222222222222	3934	1
1	Food 2	Intake 4	19	98095	1337261374	/users/cn/jespinosa/phecomp/data/CRG/20120502_FDF_CRG/20120502_FDF_CRG/20120516_FDF_CRG_c12.mtb	3251	13330	WWSS	food_sc	4	98076	1337261355	1	0.02	0.00105263157894737	3935	1
1	Drink 2	Intake 2	28	99879	1337263158	/users/cn/jespinosa/phecomp/data/CRG/20120502_FDF_CRG/20120502_FDF_CRG/20120516_FDF_CRG_c12.mtb	1193	NA	WWSS	water	2	99851	1337263130	1	0.0799999999999996	0.00285714285714284	3936	1
1	Food 2	Intake 4	33	111458	1337274737	/users/cn/jespinosa/phecomp/data/CRG/20120502_FDF_CRG/20120502_FDF_CRG/20120516_FDF_CRG_c12.mtb	3255	2060	WWSS	food_sc	4	111425	1337274704	1	0.02	0.000606060606060606	3937	1
1	Drink 2	Intake 2	18	111970	1337275249	/users/cn/jespinosa/phecomp/data/CRG/20120502_FDF_CRG/20120502_FDF_CRG/20120516_FDF_CRG_c12.mtb	1194	NA	WWSS	water	2	111952	1337275231	1	0.0800000000000001	0.00444444444444445	3938	1
1	Food 2	Intake 4	375	113893	1337277172	/users/cn/jespinosa/phecomp/data/CRG/20120502_FDF_CRG/20120502_FDF_CRG/20120516_FDF_CRG_c12.mtb	3256	12	WWSS	food_sc	4	113518	1337276797	1	0.16	0.000426666666666667	3939	1
1	Food 2	Intake 4	248	114153	1337277432	/users/cn/jespinosa/phecomp/data/CRG/20120502_FDF_CRG/20120502_FDF_CRG/20120516_FDF_CRG_c12.mtb	3257	2213	WWSS	food_sc	4	113905	1337277184	1	0.0800000000000001	0.000322580645161291	3940	1
1	Drink 1	Intake 1	16	114168	1337277447	/users/cn/jespinosa/phecomp/data/CRG/20120502_FDF_CRG/20120502_FDF_CRG/20120516_FDF_CRG_c12.mtb	2392	NA	WWSS	water	1	114152	1337277431	1	0.04	0.0025	3941	1
1	Drink 2	Intake 2	12	114859	1337278138	/users/cn/jespinosa/phecomp/data/CRG/20120502_FDF_CRG/20120502_FDF_CRG/20120516_FDF_CRG_c12.mtb	1195	NA	WWSS	water	2	114847	1337278126	1	0.02	0.00166666666666667	3942	1
1	Drink 1	Intake 1	15	115015	1337278294	/users/cn/jespinosa/phecomp/data/CRG/20120502_FDF_CRG/20120502_FDF_CRG/20120516_FDF_CRG_c12.mtb	2393	NA	WWSS	water	1	115000	1337278279	1	0.04	0.00266666666666667	3943	1
1	Food 2	Intake 4	120	116486	1337279765	/users/cn/jespinosa/phecomp/data/CRG/20120502_FDF_CRG/20120502_FDF_CRG/20120516_FDF_CRG_c12.mtb	3259	8	WWSS	food_sc	4	116366	1337279645	1	0.0600000000000001	0.000500000000000001	3944	1
1	Food 2	Intake 4	100	116594	1337279873	/users/cn/jespinosa/phecomp/data/CRG/20120502_FDF_CRG/20120502_FDF_CRG/20120516_FDF_CRG_c12.mtb	3260	15	WWSS	food_sc	4	116494	1337279773	1	0.04	0.0004	3945	1
1	Food 2	Intake 4	74	116683	1337279962	/users/cn/jespinosa/phecomp/data/CRG/20120502_FDF_CRG/20120502_FDF_CRG/20120516_FDF_CRG_c12.mtb	3261	7	WWSS	food_sc	4	116609	1337279888	1	0.04	0.000540540540540541	3946	1
1	Food 2	Intake 4	121	116811	1337280090	/users/cn/jespinosa/phecomp/data/CRG/20120502_FDF_CRG/20120502_FDF_CRG/20120516_FDF_CRG_c12.mtb	3262	5	WWSS	food_sc	4	116690	1337279969	1	0.0800000000000001	0.000661157024793389	3947	1
1	Food 2	Intake 4	79	116895	1337280174	/users/cn/jespinosa/phecomp/data/CRG/20120502_FDF_CRG/20120502_FDF_CRG/20120516_FDF_CRG_c12.mtb	3263	877	WWSS	food_sc	4	116816	1337280095	1	0.04	0.000506329113924051	3948	1
1	Drink 2	Intake 2	31	116923	1337280202	/users/cn/jespinosa/phecomp/data/CRG/20120502_FDF_CRG/20120502_FDF_CRG/20120516_FDF_CRG_c12.mtb	1196	NA	WWSS	water	2	116892	1337280171	1	0.0800000000000001	0.00258064516129033	3949	1
1	Drink 2	Intake 2	20	117104	1337280383	/users/cn/jespinosa/phecomp/data/CRG/20120502_FDF_CRG/20120502_FDF_CRG/20120516_FDF_CRG_c12.mtb	1197	NA	WWSS	water	2	117084	1337280363	1	0.04	0.002	3950	1
1	Food 1	Intake 3	113	117885	1337281164	/users/cn/jespinosa/phecomp/data/CRG/20120502_FDF_CRG/20120502_FDF_CRG/20120516_FDF_CRG_c12.mtb	2456	11	WWSS	food_sc	3	117772	1337281051	1	0.02	0.000176991150442478	3951	1
1	Food 1	Intake 3	165	118061	1337281340	/users/cn/jespinosa/phecomp/data/CRG/20120502_FDF_CRG/20120502_FDF_CRG/20120516_FDF_CRG_c12.mtb	2457	83	WWSS	food_sc	3	117896	1337281175	1	0.0600000000000001	0.000363636363636364	3952	1
1	Drink 2	Intake 2	63	118124	1337281403	/users/cn/jespinosa/phecomp/data/CRG/20120502_FDF_CRG/20120502_FDF_CRG/20120516_FDF_CRG_c12.mtb	1199	NA	WWSS	water	2	118061	1337281340	1	0.0600000000000001	0.000952380952380954	3953	1
1	Food 2	Intake 4	91	118235	1337281514	/users/cn/jespinosa/phecomp/data/CRG/20120502_FDF_CRG/20120502_FDF_CRG/20120516_FDF_CRG_c12.mtb	3270	25	WWSS	food_sc	4	118144	1337281423	1	0.02	0.00021978021978022	3954	1
1	Food 2	Intake 4	48	118308	1337281587	/users/cn/jespinosa/phecomp/data/CRG/20120502_FDF_CRG/20120502_FDF_CRG/20120516_FDF_CRG_c12.mtb	3271	124	WWSS	food_sc	4	118260	1337281539	1	0.02	0.000416666666666667	3955	1
1	Drink 2	Intake 2	26	118424	1337281703	/users/cn/jespinosa/phecomp/data/CRG/20120502_FDF_CRG/20120502_FDF_CRG/20120516_FDF_CRG_c12.mtb	1200	NA	WWSS	water	2	118398	1337281677	1	0.12	0.00461538461538461	3956	1
1	Food 1	Intake 3	113	118545	1337281824	/users/cn/jespinosa/phecomp/data/CRG/20120502_FDF_CRG/20120502_FDF_CRG/20120516_FDF_CRG_c12.mtb	2461	19	WWSS	food_sc	3	118432	1337281711	1	0.02	0.000176991150442478	3957	1
1	Food 1	Intake 3	190	118754	1337282033	/users/cn/jespinosa/phecomp/data/CRG/20120502_FDF_CRG/20120502_FDF_CRG/20120516_FDF_CRG_c12.mtb	2462	521	WWSS	food_sc	3	118564	1337281843	1	0.0600000000000001	0.000315789473684211	3958	1
1	Drink 2	Intake 2	13	119140	1337282419	/users/cn/jespinosa/phecomp/data/CRG/20120502_FDF_CRG/20120502_FDF_CRG/20120516_FDF_CRG_c12.mtb	1201	NA	WWSS	water	2	119127	1337282406	1	0.0599999999999996	0.00461538461538458	3959	1
1	Food 1	Intake 3	25	119300	1337282579	/users/cn/jespinosa/phecomp/data/CRG/20120502_FDF_CRG/20120502_FDF_CRG/20120516_FDF_CRG_c12.mtb	2465	209	WWSS	food_sc	3	119275	1337282554	1	0.02	0.0008	3960	1
1	Food 2	Intake 4	17	119526	1337282805	/users/cn/jespinosa/phecomp/data/CRG/20120502_FDF_CRG/20120502_FDF_CRG/20120516_FDF_CRG_c12.mtb	3278	174	WWSS	food_sc	4	119509	1337282788	1	0.02	0.00117647058823529	3961	1
1	Food 1	Intake 3	91	119791	1337283070	/users/cn/jespinosa/phecomp/data/CRG/20120502_FDF_CRG/20120502_FDF_CRG/20120516_FDF_CRG_c12.mtb	2468	251	WWSS	food_sc	3	119700	1337282979	1	0.02	0.00021978021978022	3962	1
1	Drink 2	Intake 2	18	119892	1337283171	/users/cn/jespinosa/phecomp/data/CRG/20120502_FDF_CRG/20120502_FDF_CRG/20120516_FDF_CRG_c12.mtb	1202	NA	WWSS	water	2	119874	1337283153	1	0.0200000000000005	0.00111111111111114	3963	1
1	Drink 1	Intake 1	20	119914	1337283193	/users/cn/jespinosa/phecomp/data/CRG/20120502_FDF_CRG/20120502_FDF_CRG/20120516_FDF_CRG_c12.mtb	2395	NA	WWSS	water	1	119894	1337283173	1	0.02	0.001	3964	1
1	Food 2	Intake 4	91	120133	1337283412	/users/cn/jespinosa/phecomp/data/CRG/20120502_FDF_CRG/20120502_FDF_CRG/20120516_FDF_CRG_c12.mtb	3282	36	WWSS	food_sc	4	120042	1337283321	1	0.04	0.00043956043956044	3965	1
1	Food 2	Intake 4	149	120318	1337283597	/users/cn/jespinosa/phecomp/data/CRG/20120502_FDF_CRG/20120502_FDF_CRG/20120516_FDF_CRG_c12.mtb	3283	3644	WWSS	food_sc	4	120169	1337283448	1	0.0599999999999996	0.000402684563758387	3966	1
1	Drink 1	Intake 1	20	120341	1337283620	/users/cn/jespinosa/phecomp/data/CRG/20120502_FDF_CRG/20120502_FDF_CRG/20120516_FDF_CRG_c12.mtb	2396	NA	WWSS	water	1	120321	1337283600	1	0.04	0.002	3967	1
1	Food 2	Intake 4	214	124176	1337287455	/users/cn/jespinosa/phecomp/data/CRG/20120502_FDF_CRG/20120502_FDF_CRG/20120516_FDF_CRG_c12.mtb	3285	532	WWSS	food_sc	4	123962	1337287241	1	0.1	0.000467289719626168	3968	1
1	Food 2	Intake 4	142	124850	1337288129	/users/cn/jespinosa/phecomp/data/CRG/20120502_FDF_CRG/20120502_FDF_CRG/20120516_FDF_CRG_c12.mtb	3286	6	WWSS	food_sc	4	124708	1337287987	1	0.0600000000000001	0.000422535211267606	3969	1
1	Food 2	Intake 4	160	125016	1337288295	/users/cn/jespinosa/phecomp/data/CRG/20120502_FDF_CRG/20120502_FDF_CRG/20120516_FDF_CRG_c12.mtb	3287	1557	WWSS	food_sc	4	124856	1337288135	1	0.0800000000000001	0.000500000000000001	3970	1
1	Drink 1	Intake 1	34	125054	1337288333	/users/cn/jespinosa/phecomp/data/CRG/20120502_FDF_CRG/20120502_FDF_CRG/20120516_FDF_CRG_c12.mtb	2397	NA	WWSS	water	1	125020	1337288299	1	0.0399999999999999	0.00117647058823529	3971	1
1	Drink 2	Intake 2	20	125098	1337288377	/users/cn/jespinosa/phecomp/data/CRG/20120502_FDF_CRG/20120502_FDF_CRG/20120516_FDF_CRG_c12.mtb	1204	NA	WWSS	water	2	125078	1337288357	1	0.0600000000000001	0.00300000000000001	3972	1
1	Food 2	Intake 4	34	126607	1337289886	/users/cn/jespinosa/phecomp/data/CRG/20120502_FDF_CRG/20120502_FDF_CRG/20120516_FDF_CRG_c12.mtb	3289	10	WWSS	food_sc	4	126573	1337289852	1	0.02	0.000588235294117647	3973	1
1	Food 2	Intake 4	249	126866	1337290145	/users/cn/jespinosa/phecomp/data/CRG/20120502_FDF_CRG/20120502_FDF_CRG/20120516_FDF_CRG_c12.mtb	3290	37	WWSS	food_sc	4	126617	1337289896	1	0.0800000000000001	0.000321285140562249	3974	1
1	Drink 2	Intake 2	18	126881	1337290160	/users/cn/jespinosa/phecomp/data/CRG/20120502_FDF_CRG/20120502_FDF_CRG/20120516_FDF_CRG_c12.mtb	1205	NA	WWSS	water	2	126863	1337290142	1	0.04	0.00222222222222222	3975	1
1	Food 2	Intake 4	39	126942	1337290221	/users/cn/jespinosa/phecomp/data/CRG/20120502_FDF_CRG/20120502_FDF_CRG/20120516_FDF_CRG_c12.mtb	3291	COLL	WWSS	food_sc	4	126903	1337290182	1	0.02	0.000512820512820513	3976	1
1	Food 1	Intake 3	85	127027	1337290306	/users/cn/jespinosa/phecomp/data/CRG/20120502_FDF_CRG/20120502_FDF_CRG/20120516_FDF_CRG_c12.mtb	2474	68	WWSS	food_sc	3	126942	1337290221	1	0.02	0.000235294117647059	3977	1
1	Food 1	Intake 3	62	127157	1337290436	/users/cn/jespinosa/phecomp/data/CRG/20120502_FDF_CRG/20120502_FDF_CRG/20120516_FDF_CRG_c12.mtb	2476	436	WWSS	food_sc	3	127095	1337290374	1	0.02	0.00032258064516129	3978	1
1	Drink 2	Intake 2	19	127173	1337290452	/users/cn/jespinosa/phecomp/data/CRG/20120502_FDF_CRG/20120502_FDF_CRG/20120516_FDF_CRG_c12.mtb	1206	NA	WWSS	water	2	127154	1337290433	1	0.04	0.00210526315789474	3979	1
1	Food 1	Intake 3	113	127706	1337290985	/users/cn/jespinosa/phecomp/data/CRG/20120502_FDF_CRG/20120502_FDF_CRG/20120516_FDF_CRG_c12.mtb	2482	217	WWSS	food_sc	3	127593	1337290872	1	0.04	0.000353982300884956	3980	1
1	Drink 2	Intake 2	28	127723	1337291002	/users/cn/jespinosa/phecomp/data/CRG/20120502_FDF_CRG/20120502_FDF_CRG/20120516_FDF_CRG_c12.mtb	1207	NA	WWSS	water	2	127695	1337290974	1	0.04	0.00142857142857143	3981	1
1	Food 1	Intake 3	77	128000	1337291279	/users/cn/jespinosa/phecomp/data/CRG/20120502_FDF_CRG/20120502_FDF_CRG/20120516_FDF_CRG_c12.mtb	2484	18	WWSS	food_sc	3	127923	1337291202	1	0.02	0.00025974025974026	3982	1
1	Food 1	Intake 3	90	128108	1337291387	/users/cn/jespinosa/phecomp/data/CRG/20120502_FDF_CRG/20120502_FDF_CRG/20120516_FDF_CRG_c12.mtb	2485	167	WWSS	food_sc	3	128018	1337291297	1	0.04	0.000444444444444444	3983	1
1	Food 1	Intake 3	97	128372	1337291651	/users/cn/jespinosa/phecomp/data/CRG/20120502_FDF_CRG/20120502_FDF_CRG/20120516_FDF_CRG_c12.mtb	2486	217	WWSS	food_sc	3	128275	1337291554	1	0.02	0.000206185567010309	3984	1
1	Drink 1	Intake 1	36	128416	1337291695	/users/cn/jespinosa/phecomp/data/CRG/20120502_FDF_CRG/20120502_FDF_CRG/20120516_FDF_CRG_c12.mtb	2398	NA	WWSS	water	1	128380	1337291659	1	0.1	0.00277777777777778	3985	1
1	Food 1	Intake 3	68	128657	1337291936	/users/cn/jespinosa/phecomp/data/CRG/20120502_FDF_CRG/20120502_FDF_CRG/20120516_FDF_CRG_c12.mtb	2488	COLL	WWSS	food_sc	3	128589	1337291868	1	0.02	0.000294117647058824	3986	1
1	Food 2	Intake 4	52	128680	1337291959	/users/cn/jespinosa/phecomp/data/CRG/20120502_FDF_CRG/20120502_FDF_CRG/20120516_FDF_CRG_c12.mtb	3306	94	WWSS	food_sc	4	128628	1337291907	1	0.02	0.000384615384615385	3987	1
1	Food 1	Intake 3	115	128889	1337292168	/users/cn/jespinosa/phecomp/data/CRG/20120502_FDF_CRG/20120502_FDF_CRG/20120516_FDF_CRG_c12.mtb	2490	94	WWSS	food_sc	3	128774	1337292053	1	0.02	0.000173913043478261	3988	1
1	Drink 2	Intake 2	22	128929	1337292208	/users/cn/jespinosa/phecomp/data/CRG/20120502_FDF_CRG/20120502_FDF_CRG/20120516_FDF_CRG_c12.mtb	1208	NA	WWSS	water	2	128907	1337292186	1	0.02	0.000909090909090909	3989	1
1	Food 1	Intake 3	77	129060	1337292339	/users/cn/jespinosa/phecomp/data/CRG/20120502_FDF_CRG/20120502_FDF_CRG/20120516_FDF_CRG_c12.mtb	2491	1282	WWSS	food_sc	3	128983	1337292262	1	0.02	0.00025974025974026	3990	1
1	Drink 2	Intake 2	18	129078	1337292357	/users/cn/jespinosa/phecomp/data/CRG/20120502_FDF_CRG/20120502_FDF_CRG/20120516_FDF_CRG_c12.mtb	1209	NA	WWSS	water	2	129060	1337292339	1	0.04	0.00222222222222222	3991	1
1	Food 2	Intake 4	53	130395	1337293674	/users/cn/jespinosa/phecomp/data/CRG/20120502_FDF_CRG/20120502_FDF_CRG/20120516_FDF_CRG_c12.mtb	3311	76	WWSS	food_sc	4	130342	1337293621	1	0.02	0.000377358490566038	3992	1
1	Food 1	Intake 3	105	130576	1337293855	/users/cn/jespinosa/phecomp/data/CRG/20120502_FDF_CRG/20120502_FDF_CRG/20120516_FDF_CRG_c12.mtb	2494	66	WWSS	food_sc	3	130471	1337293750	1	0.04	0.000380952380952381	3993	1
1	Drink 2	Intake 2	14	130605	1337293884	/users/cn/jespinosa/phecomp/data/CRG/20120502_FDF_CRG/20120502_FDF_CRG/20120516_FDF_CRG_c12.mtb	1210	NA	WWSS	water	2	130591	1337293870	1	0.02	0.00142857142857143	3994	1
1	Food 1	Intake 3	108	130750	1337294029	/users/cn/jespinosa/phecomp/data/CRG/20120502_FDF_CRG/20120502_FDF_CRG/20120516_FDF_CRG_c12.mtb	2495	26	WWSS	food_sc	3	130642	1337293921	1	0.02	0.000185185185185185	3995	1
1	Food 2	Intake 4	53	130829	1337294108	/users/cn/jespinosa/phecomp/data/CRG/20120502_FDF_CRG/20120502_FDF_CRG/20120516_FDF_CRG_c12.mtb	3315	77	WWSS	food_sc	4	130776	1337294055	1	0.02	0.000377358490566038	3996	1
1	Food 1	Intake 3	69	130975	1337294254	/users/cn/jespinosa/phecomp/data/CRG/20120502_FDF_CRG/20120502_FDF_CRG/20120516_FDF_CRG_c12.mtb	2498	6	WWSS	food_sc	3	130906	1337294185	1	0.02	0.000289855072463768	3997	1
1	Food 1	Intake 3	38	131019	1337294298	/users/cn/jespinosa/phecomp/data/CRG/20120502_FDF_CRG/20120502_FDF_CRG/20120516_FDF_CRG_c12.mtb	2499	20	WWSS	food_sc	3	130981	1337294260	1	0.02	0.000526315789473684	3998	1
1	Drink 2	Intake 2	16	131036	1337294315	/users/cn/jespinosa/phecomp/data/CRG/20120502_FDF_CRG/20120502_FDF_CRG/20120516_FDF_CRG_c12.mtb	1211	NA	WWSS	water	2	131020	1337294299	1	0.02	0.00125	3999	1
1	Food 1	Intake 3	180	131219	1337294498	/users/cn/jespinosa/phecomp/data/CRG/20120502_FDF_CRG/20120502_FDF_CRG/20120516_FDF_CRG_c12.mtb	2500	COLL	WWSS	food_sc	3	131039	1337294318	1	0.02	0.000111111111111111	4000	1
1	Food 2	Intake 4	20	131098	1337294377	/users/cn/jespinosa/phecomp/data/CRG/20120502_FDF_CRG/20120502_FDF_CRG/20120516_FDF_CRG_c12.mtb	3319	1799	WWSS	food_sc	4	131078	1337294357	1	0.02	0.001	4001	1
1	Drink 1	Intake 1	28	131250	1337294529	/users/cn/jespinosa/phecomp/data/CRG/20120502_FDF_CRG/20120502_FDF_CRG/20120516_FDF_CRG_c12.mtb	2401	NA	WWSS	water	1	131222	1337294501	1	0.0600000000000001	0.00214285714285715	4002	1
1	Drink 2	Intake 2	17	131487	1337294766	/users/cn/jespinosa/phecomp/data/CRG/20120502_FDF_CRG/20120502_FDF_CRG/20120516_FDF_CRG_c12.mtb	1212	NA	WWSS	water	2	131470	1337294749	1	0.02	0.00117647058823529	4003	1
1	Drink 1	Intake 1	15	132805	1337296084	/users/cn/jespinosa/phecomp/data/CRG/20120502_FDF_CRG/20120502_FDF_CRG/20120516_FDF_CRG_c12.mtb	2409	NA	WWSS	water	1	132790	1337296069	1	0.02	0.00133333333333333	4004	1
1	Food 2	Intake 4	65	132962	1337296241	/users/cn/jespinosa/phecomp/data/CRG/20120502_FDF_CRG/20120502_FDF_CRG/20120516_FDF_CRG_c12.mtb	3329	5441	WWSS	food_sc	4	132897	1337296176	1	0.04	0.000615384615384615	4005	1
1	Drink 1	Intake 1	36	133203	1337296482	/users/cn/jespinosa/phecomp/data/CRG/20120502_FDF_CRG/20120502_FDF_CRG/20120516_FDF_CRG_c12.mtb	2410	NA	WWSS	water	1	133167	1337296446	1	0.0399999999999999	0.00111111111111111	4006	1
1	Drink 2	Intake 2	20	134476	1337297755	/users/cn/jespinosa/phecomp/data/CRG/20120502_FDF_CRG/20120502_FDF_CRG/20120516_FDF_CRG_c12.mtb	1217	NA	WWSS	water	2	134456	1337297735	1	0.04	0.002	4007	1
1	Food 2	Intake 4	110	138513	1337301792	/users/cn/jespinosa/phecomp/data/CRG/20120502_FDF_CRG/20120502_FDF_CRG/20120516_FDF_CRG_c12.mtb	3335	40	WWSS	food_sc	4	138403	1337301682	1	0.04	0.000363636363636364	4008	1
1	Food 2	Intake 4	93	138646	1337301925	/users/cn/jespinosa/phecomp/data/CRG/20120502_FDF_CRG/20120502_FDF_CRG/20120516_FDF_CRG_c12.mtb	3336	COLL	WWSS	food_sc	4	138553	1337301832	1	0.02	0.00021505376344086	4009	1
1	Food 1	Intake 3	27	138587	1337301866	/users/cn/jespinosa/phecomp/data/CRG/20120502_FDF_CRG/20120502_FDF_CRG/20120516_FDF_CRG_c12.mtb	2508	67	WWSS	food_sc	3	138560	1337301839	1	0.02	0.000740740740740741	4010	1
1	Food 1	Intake 3	34	138688	1337301967	/users/cn/jespinosa/phecomp/data/CRG/20120502_FDF_CRG/20120502_FDF_CRG/20120516_FDF_CRG_c12.mtb	2509	17	WWSS	food_sc	3	138654	1337301933	1	0.02	0.000588235294117647	4011	1
1	Food 1	Intake 3	88	138793	1337302072	/users/cn/jespinosa/phecomp/data/CRG/20120502_FDF_CRG/20120502_FDF_CRG/20120516_FDF_CRG_c12.mtb	2510	1390	WWSS	food_sc	3	138705	1337301984	1	0.0600000000000001	0.000681818181818183	4012	1
1	Drink 1	Intake 1	13	139353	1337302632	/users/cn/jespinosa/phecomp/data/CRG/20120502_FDF_CRG/20120502_FDF_CRG/20120516_FDF_CRG_c12.mtb	2411	NA	WWSS	water	1	139340	1337302619	1	0.02	0.00153846153846154	4013	1
1	Food 1	Intake 3	140	140323	1337303602	/users/cn/jespinosa/phecomp/data/CRG/20120502_FDF_CRG/20120502_FDF_CRG/20120516_FDF_CRG_c12.mtb	2512	4027	WWSS	food_sc	3	140183	1337303462	1	0.02	0.000142857142857143	4014	1
1	Food 1	Intake 3	20	144370	1337307649	/users/cn/jespinosa/phecomp/data/CRG/20120502_FDF_CRG/20120502_FDF_CRG/20120516_FDF_CRG_c12.mtb	2513	2832	WWSS	food_sc	3	144350	1337307629	1	0.02	0.001	4015	1
1	Food 1	Intake 3	46	147248	1337310527	/users/cn/jespinosa/phecomp/data/CRG/20120502_FDF_CRG/20120502_FDF_CRG/20120516_FDF_CRG_c12.mtb	2515	8	WWSS	food_sc	3	147202	1337310481	1	0.04	0.000869565217391304	4016	1
1	Food 1	Intake 3	50	147306	1337310585	/users/cn/jespinosa/phecomp/data/CRG/20120502_FDF_CRG/20120502_FDF_CRG/20120516_FDF_CRG_c12.mtb	2516	91	WWSS	food_sc	3	147256	1337310535	1	0.04	0.0008	4017	1
1	Food 1	Intake 3	114	147511	1337310790	/users/cn/jespinosa/phecomp/data/CRG/20120502_FDF_CRG/20120502_FDF_CRG/20120516_FDF_CRG_c12.mtb	2518	4128	WWSS	food_sc	3	147397	1337310676	1	0.04	0.000350877192982456	4018	1
1	Food 2	Intake 4	23	151662	1337314941	/users/cn/jespinosa/phecomp/data/CRG/20120502_FDF_CRG/20120502_FDF_CRG/20120516_FDF_CRG_c12.mtb	3342	1013	WWSS	food_sc	4	151639	1337314918	1	0.02	0.000869565217391304	4019	1
1	Food 1	Intake 3	210	152885	1337316164	/users/cn/jespinosa/phecomp/data/CRG/20120502_FDF_CRG/20120502_FDF_CRG/20120516_FDF_CRG_c12.mtb	2519	43	WWSS	food_sc	3	152675	1337315954	1	0.0800000000000001	0.000380952380952381	4020	1
1	Drink 1	Intake 1	20	152905	1337316184	/users/cn/jespinosa/phecomp/data/CRG/20120502_FDF_CRG/20120502_FDF_CRG/20120516_FDF_CRG_c12.mtb	2413	NA	WWSS	water	1	152885	1337316164	1	0.0600000000000001	0.00300000000000001	4021	1
1	Food 1	Intake 3	289	153217	1337316496	/users/cn/jespinosa/phecomp/data/CRG/20120502_FDF_CRG/20120502_FDF_CRG/20120516_FDF_CRG_c12.mtb	2520	81	WWSS	food_sc	3	152928	1337316207	1	0.1	0.000346020761245675	4022	1
1	Food 1	Intake 3	38	153336	1337316615	/users/cn/jespinosa/phecomp/data/CRG/20120502_FDF_CRG/20120502_FDF_CRG/20120516_FDF_CRG_c12.mtb	2521	147	WWSS	food_sc	3	153298	1337316577	1	0.02	0.000526315789473684	4023	1
1	Drink 2	Intake 2	23	153417	1337316696	/users/cn/jespinosa/phecomp/data/CRG/20120502_FDF_CRG/20120502_FDF_CRG/20120516_FDF_CRG_c12.mtb	1219	NA	WWSS	water	2	153394	1337316673	1	0.0800000000000001	0.00347826086956522	4024	1
1	Food 1	Intake 3	141	153624	1337316903	/users/cn/jespinosa/phecomp/data/CRG/20120502_FDF_CRG/20120502_FDF_CRG/20120516_FDF_CRG_c12.mtb	2523	93	WWSS	food_sc	3	153483	1337316762	1	0.02	0.000141843971631206	4025	1
1	Drink 1	Intake 1	17	153630	1337316909	/users/cn/jespinosa/phecomp/data/CRG/20120502_FDF_CRG/20120502_FDF_CRG/20120516_FDF_CRG_c12.mtb	2414	NA	WWSS	water	1	153613	1337316892	1	0.02	0.00117647058823529	4026	1
1	Food 1	Intake 3	103	153820	1337317099	/users/cn/jespinosa/phecomp/data/CRG/20120502_FDF_CRG/20120502_FDF_CRG/20120516_FDF_CRG_c12.mtb	2524	286	WWSS	food_sc	3	153717	1337316996	1	0.02	0.000194174757281553	4027	1
1	Drink 2	Intake 2	25	153839	1337317118	/users/cn/jespinosa/phecomp/data/CRG/20120502_FDF_CRG/20120502_FDF_CRG/20120516_FDF_CRG_c12.mtb	1220	NA	WWSS	water	2	153814	1337317093	1	0.0799999999999996	0.00319999999999998	4028	1
1	Drink 2	Intake 2	21	154045	1337317324	/users/cn/jespinosa/phecomp/data/CRG/20120502_FDF_CRG/20120502_FDF_CRG/20120516_FDF_CRG_c12.mtb	1221	NA	WWSS	water	2	154024	1337317303	1	0.04	0.0019047619047619	4029	1
1	Food 1	Intake 3	85	154191	1337317470	/users/cn/jespinosa/phecomp/data/CRG/20120502_FDF_CRG/20120502_FDF_CRG/20120516_FDF_CRG_c12.mtb	2526	26	WWSS	food_sc	3	154106	1337317385	1	0.0200000000000005	0.000235294117647065	4030	1
1	Food 1	Intake 3	54	154271	1337317550	/users/cn/jespinosa/phecomp/data/CRG/20120502_FDF_CRG/20120502_FDF_CRG/20120516_FDF_CRG_c12.mtb	2527	68	WWSS	food_sc	3	154217	1337317496	1	0.04	0.000740740740740741	4031	1
1	Drink 1	Intake 1	26	154286	1337317565	/users/cn/jespinosa/phecomp/data/CRG/20120502_FDF_CRG/20120502_FDF_CRG/20120516_FDF_CRG_c12.mtb	2416	NA	WWSS	water	1	154260	1337317539	1	0.0599999999999999	0.0023076923076923	4032	1
1	Food 2	Intake 4	166	154505	1337317784	/users/cn/jespinosa/phecomp/data/CRG/20120502_FDF_CRG/20120502_FDF_CRG/20120516_FDF_CRG_c12.mtb	3350	1313	WWSS	food_sc	4	154339	1337317618	1	0.02	0.000120481927710843	4033	1
1	Drink 1	Intake 1	19	154521	1337317800	/users/cn/jespinosa/phecomp/data/CRG/20120502_FDF_CRG/20120502_FDF_CRG/20120516_FDF_CRG_c12.mtb	2417	NA	WWSS	water	1	154502	1337317781	1	0.0600000000000001	0.00315789473684211	4034	1
1	Drink 2	Intake 2	15	154944	1337318223	/users/cn/jespinosa/phecomp/data/CRG/20120502_FDF_CRG/20120502_FDF_CRG/20120516_FDF_CRG_c12.mtb	1222	NA	WWSS	water	2	154929	1337318208	1	0.02	0.00133333333333333	4035	1
1	Drink 2	Intake 2	21	155494	1337318773	/users/cn/jespinosa/phecomp/data/CRG/20120502_FDF_CRG/20120502_FDF_CRG/20120516_FDF_CRG_c12.mtb	1223	NA	WWSS	water	2	155473	1337318752	1	0.0600000000000001	0.00285714285714286	4036	1
1	Food 1	Intake 3	181	155999	1337319278	/users/cn/jespinosa/phecomp/data/CRG/20120502_FDF_CRG/20120502_FDF_CRG/20120516_FDF_CRG_c12.mtb	2532	41	WWSS	food_sc	3	155818	1337319097	1	0.02	0.000110497237569061	4037	1
1	Food 1	Intake 3	75	156115	1337319394	/users/cn/jespinosa/phecomp/data/CRG/20120502_FDF_CRG/20120502_FDF_CRG/20120516_FDF_CRG_c12.mtb	2533	20	WWSS	food_sc	3	156040	1337319319	1	0.02	0.000266666666666667	4038	1
1	Drink 1	Intake 1	24	156139	1337319418	/users/cn/jespinosa/phecomp/data/CRG/20120502_FDF_CRG/20120502_FDF_CRG/20120516_FDF_CRG_c12.mtb	2418	NA	WWSS	water	1	156115	1337319394	1	0.04	0.00166666666666667	4039	1
1	Food 1	Intake 3	147	156282	1337319561	/users/cn/jespinosa/phecomp/data/CRG/20120502_FDF_CRG/20120502_FDF_CRG/20120516_FDF_CRG_c12.mtb	2534	69	WWSS	food_sc	3	156135	1337319414	1	0.02	0.000136054421768707	4040	1
1	Food 1	Intake 3	84	156435	1337319714	/users/cn/jespinosa/phecomp/data/CRG/20120502_FDF_CRG/20120502_FDF_CRG/20120516_FDF_CRG_c12.mtb	2535	41	WWSS	food_sc	3	156351	1337319630	1	0.02	0.000238095238095238	4041	1
1	Food 1	Intake 3	177	156653	1337319932	/users/cn/jespinosa/phecomp/data/CRG/20120502_FDF_CRG/20120502_FDF_CRG/20120516_FDF_CRG_c12.mtb	2536	44	WWSS	food_sc	3	156476	1337319755	1	0.02	0.000112994350282486	4042	1
1	Drink 2	Intake 2	20	156675	1337319954	/users/cn/jespinosa/phecomp/data/CRG/20120502_FDF_CRG/20120502_FDF_CRG/20120516_FDF_CRG_c12.mtb	1224	NA	WWSS	water	2	156655	1337319934	1	0.04	0.002	4043	1
1	Food 1	Intake 3	182	156879	1337320158	/users/cn/jespinosa/phecomp/data/CRG/20120502_FDF_CRG/20120502_FDF_CRG/20120516_FDF_CRG_c12.mtb	2537	227	WWSS	food_sc	3	156697	1337319976	1	0.04	0.00021978021978022	4044	1
1	Drink 1	Intake 1	22	156889	1337320168	/users/cn/jespinosa/phecomp/data/CRG/20120502_FDF_CRG/20120502_FDF_CRG/20120516_FDF_CRG_c12.mtb	2419	NA	WWSS	water	1	156867	1337320146	1	0.04	0.00181818181818182	4045	1
1	Drink 2	Intake 2	20	156902	1337320181	/users/cn/jespinosa/phecomp/data/CRG/20120502_FDF_CRG/20120502_FDF_CRG/20120516_FDF_CRG_c12.mtb	1225	NA	WWSS	water	2	156882	1337320161	1	0.04	0.002	4046	1
1	Food 1	Intake 3	104	157210	1337320489	/users/cn/jespinosa/phecomp/data/CRG/20120502_FDF_CRG/20120502_FDF_CRG/20120516_FDF_CRG_c12.mtb	2540	31	WWSS	food_sc	3	157106	1337320385	1	0.02	0.000192307692307692	4047	1
1	Food 1	Intake 3	74	157315	1337320594	/users/cn/jespinosa/phecomp/data/CRG/20120502_FDF_CRG/20120502_FDF_CRG/20120516_FDF_CRG_c12.mtb	2541	286	WWSS	food_sc	3	157241	1337320520	1	0.02	0.00027027027027027	4048	1
1	Drink 2	Intake 2	26	157359	1337320638	/users/cn/jespinosa/phecomp/data/CRG/20120502_FDF_CRG/20120502_FDF_CRG/20120516_FDF_CRG_c12.mtb	1226	NA	WWSS	water	2	157333	1337320612	1	0.04	0.00153846153846154	4049	1
1	Food 1	Intake 3	248	157849	1337321128	/users/cn/jespinosa/phecomp/data/CRG/20120502_FDF_CRG/20120502_FDF_CRG/20120516_FDF_CRG_c12.mtb	2542	8	WWSS	food_sc	3	157601	1337320880	1	0.04	0.000161290322580645	4050	1
1	Drink 2	Intake 2	16	157855	1337321134	/users/cn/jespinosa/phecomp/data/CRG/20120502_FDF_CRG/20120502_FDF_CRG/20120516_FDF_CRG_c12.mtb	1227	NA	WWSS	water	2	157839	1337321118	1	0.02	0.00125	4051	1
1	Food 1	Intake 3	319	158176	1337321455	/users/cn/jespinosa/phecomp/data/CRG/20120502_FDF_CRG/20120502_FDF_CRG/20120516_FDF_CRG_c12.mtb	2543	231	WWSS	food_sc	3	157857	1337321136	1	0.1	0.000313479623824451	4052	1
1	Drink 2	Intake 2	15	158194	1337321473	/users/cn/jespinosa/phecomp/data/CRG/20120502_FDF_CRG/20120502_FDF_CRG/20120516_FDF_CRG_c12.mtb	1228	NA	WWSS	water	2	158179	1337321458	1	0.04	0.00266666666666667	4053	1
1	Food 1	Intake 3	86	158493	1337321772	/users/cn/jespinosa/phecomp/data/CRG/20120502_FDF_CRG/20120502_FDF_CRG/20120516_FDF_CRG_c12.mtb	2545	88	WWSS	food_sc	3	158407	1337321686	1	0.04	0.000465116279069767	4054	1
1	Drink 2	Intake 2	48	158553	1337321832	/users/cn/jespinosa/phecomp/data/CRG/20120502_FDF_CRG/20120502_FDF_CRG/20120516_FDF_CRG_c12.mtb	1229	NA	WWSS	water	2	158505	1337321784	1	0.0600000000000001	0.00125	4055	1
1	Food 1	Intake 3	194	158775	1337322054	/users/cn/jespinosa/phecomp/data/CRG/20120502_FDF_CRG/20120502_FDF_CRG/20120516_FDF_CRG_c12.mtb	2546	14133	WWSS	food_sc	3	158581	1337321860	1	0.0600000000000001	0.000309278350515464	4056	1
1	Drink 2	Intake 2	18	158792	1337322071	/users/cn/jespinosa/phecomp/data/CRG/20120502_FDF_CRG/20120502_FDF_CRG/20120516_FDF_CRG_c12.mtb	1230	NA	WWSS	water	2	158774	1337322053	1	0.02	0.00111111111111111	4057	1
1	Drink 2	Intake 2	14	2600	1337335115	/users/cn/jespinosa/phecomp/data/CRG/20120502_FDF_CRG/20120502_FDF_CRG/20120518_FDF_CRG_c12.mtb	1232	NA	WWSS	water	2	2586	1337335101	1	0.06	0.00428571428571429	4058	1
1	Drink 2	Intake 2	16	2740	1337335255	/users/cn/jespinosa/phecomp/data/CRG/20120502_FDF_CRG/20120502_FDF_CRG/20120518_FDF_CRG_c12.mtb	1234	NA	WWSS	water	2	2724	1337335239	1	0.08	0.005	4059	1
1	Food 1	Intake 3	91	3763	1337336278	/users/cn/jespinosa/phecomp/data/CRG/20120502_FDF_CRG/20120502_FDF_CRG/20120518_FDF_CRG_c12.mtb	2547	100	WWSS	food_sc	3	3672	1337336187	1	0.06	0.000659340659340659	4060	1
1	Food 1	Intake 3	68	3931	1337336446	/users/cn/jespinosa/phecomp/data/CRG/20120502_FDF_CRG/20120502_FDF_CRG/20120518_FDF_CRG_c12.mtb	2548	32	WWSS	food_sc	3	3863	1337336378	1	0.08	0.00117647058823529	4061	1
1	Food 1	Intake 3	57	4020	1337336535	/users/cn/jespinosa/phecomp/data/CRG/20120502_FDF_CRG/20120502_FDF_CRG/20120518_FDF_CRG_c12.mtb	2549	9027	WWSS	food_sc	3	3963	1337336478	1	0.04	0.000701754385964912	4062	1
1	Drink 1	Intake 1	21	4292	1337336807	/users/cn/jespinosa/phecomp/data/CRG/20120502_FDF_CRG/20120502_FDF_CRG/20120518_FDF_CRG_c12.mtb	2423	NA	WWSS	water	1	4271	1337336786	1	0.02	0.000952380952380952	4063	1
1	Food 1	Intake 3	61	13108	1337345623	/users/cn/jespinosa/phecomp/data/CRG/20120502_FDF_CRG/20120502_FDF_CRG/20120518_FDF_CRG_c12.mtb	2552	169	WWSS	food_sc	3	13047	1337345562	1	0.04	0.000655737704918033	4064	1
1	Food 1	Intake 3	83	13360	1337345875	/users/cn/jespinosa/phecomp/data/CRG/20120502_FDF_CRG/20120502_FDF_CRG/20120518_FDF_CRG_c12.mtb	2553	12	WWSS	food_sc	3	13277	1337345792	1	0.04	0.000481927710843374	4065	1
1	Food 1	Intake 3	42	13414	1337345929	/users/cn/jespinosa/phecomp/data/CRG/20120502_FDF_CRG/20120502_FDF_CRG/20120518_FDF_CRG_c12.mtb	2554	16	WWSS	food_sc	3	13372	1337345887	1	0.02	0.000476190476190476	4066	1
1	Food 1	Intake 3	25	13455	1337345970	/users/cn/jespinosa/phecomp/data/CRG/20120502_FDF_CRG/20120502_FDF_CRG/20120518_FDF_CRG_c12.mtb	2555	5	WWSS	food_sc	3	13430	1337345945	1	0.02	0.0008	4067	1
1	Food 1	Intake 3	106	13566	1337346081	/users/cn/jespinosa/phecomp/data/CRG/20120502_FDF_CRG/20120502_FDF_CRG/20120518_FDF_CRG_c12.mtb	2556	11332	WWSS	food_sc	3	13460	1337345975	1	0.06	0.000566037735849057	4068	1
1	Drink 1	Intake 1	27	14725	1337347240	/users/cn/jespinosa/phecomp/data/CRG/20120502_FDF_CRG/20120502_FDF_CRG/20120518_FDF_CRG_c12.mtb	2424	NA	WWSS	water	1	14698	1337347213	1	0.12	0.00444444444444444	4069	1
1	Food 2	Intake 4	257	25155	1337357670	/users/cn/jespinosa/phecomp/data/CRG/20120502_FDF_CRG/20120502_FDF_CRG/20120518_FDF_CRG_c12.mtb	3367	3	WWSS	food_sc	4	24898	1337357413	1	0.12	0.00046692607003891	4070	1
1	Food 2	Intake 4	257	25415	1337357930	/users/cn/jespinosa/phecomp/data/CRG/20120502_FDF_CRG/20120502_FDF_CRG/20120518_FDF_CRG_c12.mtb	3368	5070	WWSS	food_sc	4	25158	1337357673	1	0.1	0.000389105058365759	4071	1
1	Drink 2	Intake 2	20	25435	1337357950	/users/cn/jespinosa/phecomp/data/CRG/20120502_FDF_CRG/20120502_FDF_CRG/20120518_FDF_CRG_c12.mtb	1235	NA	WWSS	water	2	25415	1337357930	1	0.02	0.001	4072	1
1	Food 2	Intake 4	145	30630	1337363145	/users/cn/jespinosa/phecomp/data/CRG/20120502_FDF_CRG/20120502_FDF_CRG/20120518_FDF_CRG_c12.mtb	3369	1277	WWSS	food_sc	4	30485	1337363000	1	0.06	0.000413793103448276	4073	1
1	Food 2	Intake 4	277	32184	1337364699	/users/cn/jespinosa/phecomp/data/CRG/20120502_FDF_CRG/20120502_FDF_CRG/20120518_FDF_CRG_c12.mtb	3370	6	WWSS	food_sc	4	31907	1337364422	1	0.1	0.00036101083032491	4074	1
1	Food 2	Intake 4	87	32277	1337364792	/users/cn/jespinosa/phecomp/data/CRG/20120502_FDF_CRG/20120502_FDF_CRG/20120518_FDF_CRG_c12.mtb	3371	660	WWSS	food_sc	4	32190	1337364705	1	0.04	0.000459770114942529	4075	1
1	Drink 2	Intake 2	12	32288	1337364803	/users/cn/jespinosa/phecomp/data/CRG/20120502_FDF_CRG/20120502_FDF_CRG/20120518_FDF_CRG_c12.mtb	1236	NA	WWSS	water	2	32276	1337364791	1	0.04	0.00333333333333333	4076	1
1	Food 2	Intake 4	179	33116	1337365631	/users/cn/jespinosa/phecomp/data/CRG/20120502_FDF_CRG/20120502_FDF_CRG/20120518_FDF_CRG_c12.mtb	3372	51	WWSS	food_sc	4	32937	1337365452	1	0.08	0.000446927374301676	4077	1
1	Drink 2	Intake 2	32	33144	1337365659	/users/cn/jespinosa/phecomp/data/CRG/20120502_FDF_CRG/20120502_FDF_CRG/20120518_FDF_CRG_c12.mtb	1237	NA	WWSS	water	2	33112	1337365627	1	0.1	0.003125	4078	1
1	Food 1	Intake 3	47	33214	1337365729	/users/cn/jespinosa/phecomp/data/CRG/20120502_FDF_CRG/20120502_FDF_CRG/20120518_FDF_CRG_c12.mtb	2561	24	WWSS	food_sc	3	33167	1337365682	1	0.02	0.000425531914893617	4079	1
1	Food 1	Intake 3	143	33381	1337365896	/users/cn/jespinosa/phecomp/data/CRG/20120502_FDF_CRG/20120502_FDF_CRG/20120518_FDF_CRG_c12.mtb	2562	2393	WWSS	food_sc	3	33238	1337365753	1	0.06	0.00041958041958042	4080	1
1	Drink 2	Intake 2	19	33393	1337365908	/users/cn/jespinosa/phecomp/data/CRG/20120502_FDF_CRG/20120502_FDF_CRG/20120518_FDF_CRG_c12.mtb	1238	NA	WWSS	water	2	33374	1337365889	1	0.08	0.00421052631578947	4081	1
1	Drink 2	Intake 2	12	33801	1337366316	/users/cn/jespinosa/phecomp/data/CRG/20120502_FDF_CRG/20120502_FDF_CRG/20120518_FDF_CRG_c12.mtb	1239	NA	WWSS	water	2	33789	1337366304	1	0.04	0.00333333333333333	4082	1
1	Food 1	Intake 3	51	35825	1337368340	/users/cn/jespinosa/phecomp/data/CRG/20120502_FDF_CRG/20120502_FDF_CRG/20120518_FDF_CRG_c12.mtb	2563	20	WWSS	food_sc	3	35774	1337368289	1	0.04	0.000784313725490196	4083	1
1	Food 1	Intake 3	265	36110	1337368625	/users/cn/jespinosa/phecomp/data/CRG/20120502_FDF_CRG/20120502_FDF_CRG/20120518_FDF_CRG_c12.mtb	2564	1711	WWSS	food_sc	3	35845	1337368360	1	0.12	0.000452830188679245	4084	1
1	Drink 2	Intake 2	21	36130	1337368645	/users/cn/jespinosa/phecomp/data/CRG/20120502_FDF_CRG/20120502_FDF_CRG/20120518_FDF_CRG_c12.mtb	1240	NA	WWSS	water	2	36109	1337368624	1	0.04	0.0019047619047619	4085	1
1	Food 1	Intake 3	263	38084	1337370599	/users/cn/jespinosa/phecomp/data/CRG/20120502_FDF_CRG/20120502_FDF_CRG/20120518_FDF_CRG_c12.mtb	2565	509	WWSS	food_sc	3	37821	1337370336	1	0.12	0.000456273764258555	4086	1
1	Drink 2	Intake 2	20	38102	1337370617	/users/cn/jespinosa/phecomp/data/CRG/20120502_FDF_CRG/20120502_FDF_CRG/20120518_FDF_CRG_c12.mtb	1241	NA	WWSS	water	2	38082	1337370597	1	0.04	0.002	4087	1
1	Food 1	Intake 3	59	38652	1337371167	/users/cn/jespinosa/phecomp/data/CRG/20120502_FDF_CRG/20120502_FDF_CRG/20120518_FDF_CRG_c12.mtb	2566	35	WWSS	food_sc	3	38593	1337371108	1	0.02	0.000338983050847458	4088	1
1	Food 1	Intake 3	106	38793	1337371308	/users/cn/jespinosa/phecomp/data/CRG/20120502_FDF_CRG/20120502_FDF_CRG/20120518_FDF_CRG_c12.mtb	2567	15	WWSS	food_sc	3	38687	1337371202	1	0.02	0.000188679245283019	4089	1
1	Food 1	Intake 3	69	38877	1337371392	/users/cn/jespinosa/phecomp/data/CRG/20120502_FDF_CRG/20120502_FDF_CRG/20120518_FDF_CRG_c12.mtb	2568	52	WWSS	food_sc	3	38808	1337371323	1	0.04	0.000579710144927536	4090	1
1	Food 1	Intake 3	33	38962	1337371477	/users/cn/jespinosa/phecomp/data/CRG/20120502_FDF_CRG/20120502_FDF_CRG/20120518_FDF_CRG_c12.mtb	2570	52	WWSS	food_sc	3	38929	1337371444	1	0.0399999999999999	0.00121212121212121	4091	1
1	Drink 1	Intake 1	28	38998	1337371513	/users/cn/jespinosa/phecomp/data/CRG/20120502_FDF_CRG/20120502_FDF_CRG/20120518_FDF_CRG_c12.mtb	2425	NA	WWSS	water	1	38970	1337371485	1	0.06	0.00214285714285714	4092	1
1	Food 1	Intake 3	70	39084	1337371599	/users/cn/jespinosa/phecomp/data/CRG/20120502_FDF_CRG/20120502_FDF_CRG/20120518_FDF_CRG_c12.mtb	2571	84	WWSS	food_sc	3	39014	1337371529	1	0.02	0.000285714285714286	4093	1
1	Drink 2	Intake 2	25	39102	1337371617	/users/cn/jespinosa/phecomp/data/CRG/20120502_FDF_CRG/20120502_FDF_CRG/20120518_FDF_CRG_c12.mtb	1242	NA	WWSS	water	2	39077	1337371592	1	0.1	0.004	4094	1
1	Food 2	Intake 4	44	39212	1337371727	/users/cn/jespinosa/phecomp/data/CRG/20120502_FDF_CRG/20120502_FDF_CRG/20120518_FDF_CRG_c12.mtb	3382	161	WWSS	food_sc	4	39168	1337371683	1	0.02	0.000454545454545455	4095	1
1	Food 1	Intake 3	37	39410	1337371925	/users/cn/jespinosa/phecomp/data/CRG/20120502_FDF_CRG/20120502_FDF_CRG/20120518_FDF_CRG_c12.mtb	2575	20	WWSS	food_sc	3	39373	1337371888	1	0.02	0.000540540540540541	4096	1
1	Drink 2	Intake 2	55	39454	1337371969	/users/cn/jespinosa/phecomp/data/CRG/20120502_FDF_CRG/20120502_FDF_CRG/20120518_FDF_CRG_c12.mtb	1244	NA	WWSS	water	2	39399	1337371914	1	0.02	0.000363636363636364	4097	1
1	Food 2	Intake 4	39	39469	1337371984	/users/cn/jespinosa/phecomp/data/CRG/20120502_FDF_CRG/20120502_FDF_CRG/20120518_FDF_CRG_c12.mtb	3385	644	WWSS	food_sc	4	39430	1337371945	1	0.0599999999999999	0.00153846153846154	4098	1
1	Drink 2	Intake 2	158	39758	1337372273	/users/cn/jespinosa/phecomp/data/CRG/20120502_FDF_CRG/20120502_FDF_CRG/20120518_FDF_CRG_c12.mtb	1247	NA	WWSS	water	2	39600	1337372115	1	0.0600000000000001	0.000379746835443039	4099	1
1	Drink 2	Intake 2	602	40672	1337373187	/users/cn/jespinosa/phecomp/data/CRG/20120502_FDF_CRG/20120502_FDF_CRG/20120518_FDF_CRG_c12.mtb	1249	NA	WWSS	water	2	40070	1337372585	1	0.14	0.000232558139534884	4100	1
1	Food 2	Intake 4	61	40174	1337372689	/users/cn/jespinosa/phecomp/data/CRG/20120502_FDF_CRG/20120502_FDF_CRG/20120518_FDF_CRG_c12.mtb	3389	39	WWSS	food_sc	4	40113	1337372628	1	0.04	0.000655737704918033	4101	1
1	Food 2	Intake 4	56	40269	1337372784	/users/cn/jespinosa/phecomp/data/CRG/20120502_FDF_CRG/20120502_FDF_CRG/20120518_FDF_CRG_c12.mtb	3391	41	WWSS	food_sc	4	40213	1337372728	1	0.02	0.000357142857142857	4102	1
1	Food 1	Intake 3	36	40346	1337372861	/users/cn/jespinosa/phecomp/data/CRG/20120502_FDF_CRG/20120502_FDF_CRG/20120518_FDF_CRG_c12.mtb	2583	12	WWSS	food_sc	3	40310	1337372825	1	0.02	0.000555555555555556	4103	1
1	Food 1	Intake 3	57	40415	1337372930	/users/cn/jespinosa/phecomp/data/CRG/20120502_FDF_CRG/20120502_FDF_CRG/20120518_FDF_CRG_c12.mtb	2584	COLL	WWSS	food_sc	3	40358	1337372873	1	0.02	0.000350877192982456	4104	1
1	Food 2	Intake 4	107	40516	1337373031	/users/cn/jespinosa/phecomp/data/CRG/20120502_FDF_CRG/20120502_FDF_CRG/20120518_FDF_CRG_c12.mtb	3393	104	WWSS	food_sc	4	40409	1337372924	1	0.0599999999999999	0.000560747663551401	4105	1
1	Food 2	Intake 4	74	40694	1337373209	/users/cn/jespinosa/phecomp/data/CRG/20120502_FDF_CRG/20120502_FDF_CRG/20120518_FDF_CRG_c12.mtb	3394	11	WWSS	food_sc	4	40620	1337373135	1	0.02	0.00027027027027027	4106	1
1	Food 2	Intake 4	49	40754	1337373269	/users/cn/jespinosa/phecomp/data/CRG/20120502_FDF_CRG/20120502_FDF_CRG/20120518_FDF_CRG_c12.mtb	3395	149	WWSS	food_sc	4	40705	1337373220	1	0.04	0.000816326530612245	4107	1
1	Food 2	Intake 4	144	41047	1337373562	/users/cn/jespinosa/phecomp/data/CRG/20120502_FDF_CRG/20120502_FDF_CRG/20120518_FDF_CRG_c12.mtb	3397	150	WWSS	food_sc	4	40903	1337373418	1	0.02	0.000138888888888889	4108	1
1	Drink 2	Intake 2	57	40980	1337373495	/users/cn/jespinosa/phecomp/data/CRG/20120502_FDF_CRG/20120502_FDF_CRG/20120518_FDF_CRG_c12.mtb	1251	NA	WWSS	water	2	40923	1337373438	1	0.04	0.000701754385964912	4109	1
1	Drink 2	Intake 2	128	41168	1337373683	/users/cn/jespinosa/phecomp/data/CRG/20120502_FDF_CRG/20120502_FDF_CRG/20120518_FDF_CRG_c12.mtb	1252	NA	WWSS	water	2	41040	1337373555	1	0.04	0.0003125	4110	1
1	Food 2	Intake 4	128	41325	1337373840	/users/cn/jespinosa/phecomp/data/CRG/20120502_FDF_CRG/20120502_FDF_CRG/20120518_FDF_CRG_c12.mtb	3399	2478	WWSS	food_sc	4	41197	1337373712	1	0.02	0.00015625	4111	1
1	Drink 2	Intake 2	79	43780	1337376295	/users/cn/jespinosa/phecomp/data/CRG/20120502_FDF_CRG/20120502_FDF_CRG/20120518_FDF_CRG_c12.mtb	1263	NA	WWSS	water	2	43701	1337376216	1	0.02	0.000253164556962025	4112	1
1	Food 2	Intake 4	32	43835	1337376350	/users/cn/jespinosa/phecomp/data/CRG/20120502_FDF_CRG/20120502_FDF_CRG/20120518_FDF_CRG_c12.mtb	3401	59	WWSS	food_sc	4	43803	1337376318	1	0.04	0.00125	4113	1
1	Food 2	Intake 4	53	43947	1337376462	/users/cn/jespinosa/phecomp/data/CRG/20120502_FDF_CRG/20120502_FDF_CRG/20120518_FDF_CRG_c12.mtb	3403	85	WWSS	food_sc	4	43894	1337376409	1	0.02	0.000377358490566038	4114	1
1	Food 1	Intake 3	123	44155	1337376670	/users/cn/jespinosa/phecomp/data/CRG/20120502_FDF_CRG/20120502_FDF_CRG/20120518_FDF_CRG_c12.mtb	2594	142	WWSS	food_sc	3	44032	1337376547	1	0.04	0.00032520325203252	4115	1
1	Drink 2	Intake 2	18	44205	1337376720	/users/cn/jespinosa/phecomp/data/CRG/20120502_FDF_CRG/20120502_FDF_CRG/20120518_FDF_CRG_c12.mtb	1266	NA	WWSS	water	2	44187	1337376702	1	0.04	0.00222222222222222	4116	1
1	Drink 2	Intake 2	10	44277	1337376792	/users/cn/jespinosa/phecomp/data/CRG/20120502_FDF_CRG/20120502_FDF_CRG/20120518_FDF_CRG_c12.mtb	1267	NA	WWSS	water	2	44267	1337376782	1	0.02	0.002	4117	1
1	Food 2	Intake 4	87	44384	1337376899	/users/cn/jespinosa/phecomp/data/CRG/20120502_FDF_CRG/20120502_FDF_CRG/20120518_FDF_CRG_c12.mtb	3409	39	WWSS	food_sc	4	44297	1337376812	1	0.0599999999999999	0.000689655172413792	4118	1
1	Food 2	Intake 4	87	44510	1337377025	/users/cn/jespinosa/phecomp/data/CRG/20120502_FDF_CRG/20120502_FDF_CRG/20120518_FDF_CRG_c12.mtb	3410	454	WWSS	food_sc	4	44423	1337376938	1	0.02	0.000229885057471264	4119	1
1	Drink 1	Intake 1	17	44519	1337377034	/users/cn/jespinosa/phecomp/data/CRG/20120502_FDF_CRG/20120502_FDF_CRG/20120518_FDF_CRG_c12.mtb	2426	NA	WWSS	water	1	44502	1337377017	1	0.02	0.00117647058823529	4120	1
1	Drink 2	Intake 2	18	44569	1337377084	/users/cn/jespinosa/phecomp/data/CRG/20120502_FDF_CRG/20120502_FDF_CRG/20120518_FDF_CRG_c12.mtb	1268	NA	WWSS	water	2	44551	1337377066	1	0.02	0.00111111111111111	4121	1
1	Drink 2	Intake 2	29	44752	1337377267	/users/cn/jespinosa/phecomp/data/CRG/20120502_FDF_CRG/20120502_FDF_CRG/20120518_FDF_CRG_c12.mtb	1270	NA	WWSS	water	2	44723	1337377238	1	0.02	0.000689655172413793	4122	1
1	Drink 1	Intake 1	148	44903	1337377418	/users/cn/jespinosa/phecomp/data/CRG/20120502_FDF_CRG/20120502_FDF_CRG/20120518_FDF_CRG_c12.mtb	2428	NA	WWSS	water	1	44755	1337377270	1	0.02	0.000135135135135135	4123	1
1	Food 2	Intake 4	34	44998	1337377513	/users/cn/jespinosa/phecomp/data/CRG/20120502_FDF_CRG/20120502_FDF_CRG/20120518_FDF_CRG_c12.mtb	3411	11	WWSS	food_sc	4	44964	1337377479	1	0.02	0.000588235294117647	4124	1
1	Food 2	Intake 4	36	45045	1337377560	/users/cn/jespinosa/phecomp/data/CRG/20120502_FDF_CRG/20120502_FDF_CRG/20120518_FDF_CRG_c12.mtb	3412	641	WWSS	food_sc	4	45009	1337377524	1	0.02	0.000555555555555556	4125	1
1	Drink 1	Intake 1	20	45243	1337377758	/users/cn/jespinosa/phecomp/data/CRG/20120502_FDF_CRG/20120502_FDF_CRG/20120518_FDF_CRG_c12.mtb	2431	NA	WWSS	water	1	45223	1337377738	1	0.02	0.001	4126	1
1	Food 1	Intake 3	95	45781	1337378296	/users/cn/jespinosa/phecomp/data/CRG/20120502_FDF_CRG/20120502_FDF_CRG/20120518_FDF_CRG_c12.mtb	2600	22	WWSS	food_sc	3	45686	1337378201	1	0.02	0.000210526315789474	4127	1
1	Food 1	Intake 3	78	45881	1337378396	/users/cn/jespinosa/phecomp/data/CRG/20120502_FDF_CRG/20120502_FDF_CRG/20120518_FDF_CRG_c12.mtb	2601	384	WWSS	food_sc	3	45803	1337378318	1	0.04	0.000512820512820513	4128	1
1	Food 1	Intake 3	62	46327	1337378842	/users/cn/jespinosa/phecomp/data/CRG/20120502_FDF_CRG/20120502_FDF_CRG/20120518_FDF_CRG_c12.mtb	2603	756	WWSS	food_sc	3	46265	1337378780	1	0.02	0.00032258064516129	4129	1
1	Drink 1	Intake 1	21	46857	1337379372	/users/cn/jespinosa/phecomp/data/CRG/20120502_FDF_CRG/20120502_FDF_CRG/20120518_FDF_CRG_c12.mtb	2432	NA	WWSS	water	1	46836	1337379351	1	0.06	0.00285714285714286	4130	1
1	Food 2	Intake 4	41	47124	1337379639	/users/cn/jespinosa/phecomp/data/CRG/20120502_FDF_CRG/20120502_FDF_CRG/20120518_FDF_CRG_c12.mtb	3418	390	WWSS	food_sc	4	47083	1337379598	1	0.02	0.00048780487804878	4131	1
1	Drink 1	Intake 1	14	47173	1337379688	/users/cn/jespinosa/phecomp/data/CRG/20120502_FDF_CRG/20120502_FDF_CRG/20120518_FDF_CRG_c12.mtb	2433	NA	WWSS	water	1	47159	1337379674	1	0.02	0.00142857142857143	4132	1
1	Drink 1	Intake 1	23	47450	1337379965	/users/cn/jespinosa/phecomp/data/CRG/20120502_FDF_CRG/20120502_FDF_CRG/20120518_FDF_CRG_c12.mtb	2434	NA	WWSS	water	1	47427	1337379942	1	0.08	0.00347826086956522	4133	1
1	Food 1	Intake 3	101	47615	1337380130	/users/cn/jespinosa/phecomp/data/CRG/20120502_FDF_CRG/20120502_FDF_CRG/20120518_FDF_CRG_c12.mtb	2605	284	WWSS	food_sc	3	47514	1337380029	1	0.04	0.000396039603960396	4134	1
1	Food 2	Intake 4	109	48008	1337380523	/users/cn/jespinosa/phecomp/data/CRG/20120502_FDF_CRG/20120502_FDF_CRG/20120518_FDF_CRG_c12.mtb	3419	995	WWSS	food_sc	4	47899	1337380414	1	0.04	0.00036697247706422	4135	1
1	Food 2	Intake 4	70	49073	1337381588	/users/cn/jespinosa/phecomp/data/CRG/20120502_FDF_CRG/20120502_FDF_CRG/20120518_FDF_CRG_c12.mtb	3420	2782	WWSS	food_sc	4	49003	1337381518	1	0.02	0.000285714285714286	4136	1
1	Drink 2	Intake 2	17	49119	1337381634	/users/cn/jespinosa/phecomp/data/CRG/20120502_FDF_CRG/20120502_FDF_CRG/20120518_FDF_CRG_c12.mtb	1273	NA	WWSS	water	2	49102	1337381617	1	0.0600000000000001	0.00352941176470589	4137	1
1	Food 1	Intake 3	122	51977	1337384492	/users/cn/jespinosa/phecomp/data/CRG/20120502_FDF_CRG/20120502_FDF_CRG/20120518_FDF_CRG_c12.mtb	2608	1918	WWSS	food_sc	3	51855	1337384370	1	0.0799999999999998	0.000655737704918031	4138	1
1	Food 2	Intake 4	36	53931	1337386446	/users/cn/jespinosa/phecomp/data/CRG/20120502_FDF_CRG/20120502_FDF_CRG/20120518_FDF_CRG_c12.mtb	3421	8	WWSS	food_sc	4	53895	1337386410	1	0.02	0.000555555555555556	4139	1
1	Food 2	Intake 4	16	53955	1337386470	/users/cn/jespinosa/phecomp/data/CRG/20120502_FDF_CRG/20120502_FDF_CRG/20120518_FDF_CRG_c12.mtb	3422	47	WWSS	food_sc	4	53939	1337386454	1	0.02	0.00125	4140	1
1	Food 2	Intake 4	17	54019	1337386534	/users/cn/jespinosa/phecomp/data/CRG/20120502_FDF_CRG/20120502_FDF_CRG/20120518_FDF_CRG_c12.mtb	3423	29	WWSS	food_sc	4	54002	1337386517	1	0.0399999999999998	0.00235294117647058	4141	1
1	Food 2	Intake 4	70	54118	1337386633	/users/cn/jespinosa/phecomp/data/CRG/20120502_FDF_CRG/20120502_FDF_CRG/20120518_FDF_CRG_c12.mtb	3424	16	WWSS	food_sc	4	54048	1337386563	1	0.04	0.000571428571428571	4142	1
1	Food 2	Intake 4	62	54196	1337386711	/users/cn/jespinosa/phecomp/data/CRG/20120502_FDF_CRG/20120502_FDF_CRG/20120518_FDF_CRG_c12.mtb	3425	163	WWSS	food_sc	4	54134	1337386649	1	0.0600000000000001	0.000967741935483873	4143	1
1	Food 2	Intake 4	194	54553	1337387068	/users/cn/jespinosa/phecomp/data/CRG/20120502_FDF_CRG/20120502_FDF_CRG/20120518_FDF_CRG_c12.mtb	3426	16	WWSS	food_sc	4	54359	1337386874	1	0.04	0.000206185567010309	4144	1
1	Drink 1	Intake 1	31	54578	1337387093	/users/cn/jespinosa/phecomp/data/CRG/20120502_FDF_CRG/20120502_FDF_CRG/20120518_FDF_CRG_c12.mtb	2436	NA	WWSS	water	1	54547	1337387062	1	0.04	0.00129032258064516	4145	1
1	Food 2	Intake 4	147	54716	1337387231	/users/cn/jespinosa/phecomp/data/CRG/20120502_FDF_CRG/20120502_FDF_CRG/20120518_FDF_CRG_c12.mtb	3427	3	WWSS	food_sc	4	54569	1337387084	1	0.02	0.000136054421768707	4146	1
1	Food 1	Intake 3	40	54759	1337387274	/users/cn/jespinosa/phecomp/data/CRG/20120502_FDF_CRG/20120502_FDF_CRG/20120518_FDF_CRG_c12.mtb	2611	72	WWSS	food_sc	3	54719	1337387234	1	0.02	0.0005	4147	1
1	Drink 1	Intake 1	26	54792	1337387307	/users/cn/jespinosa/phecomp/data/CRG/20120502_FDF_CRG/20120502_FDF_CRG/20120518_FDF_CRG_c12.mtb	2437	NA	WWSS	water	1	54766	1337387281	1	0.06	0.00230769230769231	4148	1
1	Food 1	Intake 3	53	54884	1337387399	/users/cn/jespinosa/phecomp/data/CRG/20120502_FDF_CRG/20120502_FDF_CRG/20120518_FDF_CRG_c12.mtb	2612	649	WWSS	food_sc	3	54831	1337387346	1	0.04	0.000754716981132075	4149	1
1	Drink 1	Intake 1	24	55065	1337387580	/users/cn/jespinosa/phecomp/data/CRG/20120502_FDF_CRG/20120502_FDF_CRG/20120518_FDF_CRG_c12.mtb	2438	NA	WWSS	water	1	55041	1337387556	1	0.0599999999999999	0.0025	4150	1
1	Food 2	Intake 4	81	55614	1337388129	/users/cn/jespinosa/phecomp/data/CRG/20120502_FDF_CRG/20120502_FDF_CRG/20120518_FDF_CRG_c12.mtb	3430	916	WWSS	food_sc	4	55533	1337388048	1	0.02	0.000246913580246914	4151	1
1	Drink 2	Intake 2	13	55621	1337388136	/users/cn/jespinosa/phecomp/data/CRG/20120502_FDF_CRG/20120502_FDF_CRG/20120518_FDF_CRG_c12.mtb	1275	NA	WWSS	water	2	55608	1337388123	1	0.02	0.00153846153846154	4152	1
1	Drink 1	Intake 1	19	56146	1337388661	/users/cn/jespinosa/phecomp/data/CRG/20120502_FDF_CRG/20120502_FDF_CRG/20120518_FDF_CRG_c12.mtb	2440	NA	WWSS	water	1	56127	1337388642	1	0.02	0.00105263157894737	4153	1
1	Food 1	Intake 3	118	56648	1337389163	/users/cn/jespinosa/phecomp/data/CRG/20120502_FDF_CRG/20120502_FDF_CRG/20120518_FDF_CRG_c12.mtb	2617	8259	WWSS	food_sc	3	56530	1337389045	1	0.0600000000000001	0.000508474576271187	4154	1
1	Drink 2	Intake 2	23	56666	1337389181	/users/cn/jespinosa/phecomp/data/CRG/20120502_FDF_CRG/20120502_FDF_CRG/20120518_FDF_CRG_c12.mtb	1276	NA	WWSS	water	2	56643	1337389158	1	0.04	0.00173913043478261	4155	1
1	Food 2	Intake 4	370	65277	1337397792	/users/cn/jespinosa/phecomp/data/CRG/20120502_FDF_CRG/20120502_FDF_CRG/20120518_FDF_CRG_c12.mtb	3436	5431	WWSS	food_sc	4	64907	1337397422	1	0.18	0.000486486486486486	4156	1
1	Food 2	Intake 4	91	70799	1337403314	/users/cn/jespinosa/phecomp/data/CRG/20120502_FDF_CRG/20120502_FDF_CRG/20120518_FDF_CRG_c12.mtb	3437	96	WWSS	food_sc	4	70708	1337403223	1	0.04	0.00043956043956044	4157	1
1	Food 1	Intake 3	55	70950	1337403465	/users/cn/jespinosa/phecomp/data/CRG/20120502_FDF_CRG/20120502_FDF_CRG/20120518_FDF_CRG_c12.mtb	2620	20	WWSS	food_sc	3	70895	1337403410	1	0.02	0.000363636363636364	4158	1
1	Food 1	Intake 3	84	71054	1337403569	/users/cn/jespinosa/phecomp/data/CRG/20120502_FDF_CRG/20120502_FDF_CRG/20120518_FDF_CRG_c12.mtb	2621	31	WWSS	food_sc	3	70970	1337403485	1	0.0399999999999998	0.000476190476190474	4159	1
1	Drink 1	Intake 1	29	71087	1337403602	/users/cn/jespinosa/phecomp/data/CRG/20120502_FDF_CRG/20120502_FDF_CRG/20120518_FDF_CRG_c12.mtb	2442	NA	WWSS	water	1	71058	1337403573	1	0.0600000000000001	0.00206896551724138	4160	1
1	Food 1	Intake 3	97	71182	1337403697	/users/cn/jespinosa/phecomp/data/CRG/20120502_FDF_CRG/20120502_FDF_CRG/20120518_FDF_CRG_c12.mtb	2622	14	WWSS	food_sc	3	71085	1337403600	1	0.04	0.000412371134020619	4161	1
1	Drink 2	Intake 2	23	71194	1337403709	/users/cn/jespinosa/phecomp/data/CRG/20120502_FDF_CRG/20120502_FDF_CRG/20120518_FDF_CRG_c12.mtb	1277	NA	WWSS	water	2	71171	1337403686	1	0.04	0.00173913043478261	4162	1
1	Food 1	Intake 3	116	71312	1337403827	/users/cn/jespinosa/phecomp/data/CRG/20120502_FDF_CRG/20120502_FDF_CRG/20120518_FDF_CRG_c12.mtb	2623	COLL	WWSS	food_sc	3	71196	1337403711	1	0.0600000000000001	0.000517241379310346	4163	1
1	Food 2	Intake 4	53	71300	1337403815	/users/cn/jespinosa/phecomp/data/CRG/20120502_FDF_CRG/20120502_FDF_CRG/20120518_FDF_CRG_c12.mtb	3440	40	WWSS	food_sc	4	71247	1337403762	1	0.02	0.000377358490566038	4164	1
1	Drink 1	Intake 1	23	71348	1337403863	/users/cn/jespinosa/phecomp/data/CRG/20120502_FDF_CRG/20120502_FDF_CRG/20120518_FDF_CRG_c12.mtb	2443	NA	WWSS	water	1	71325	1337403840	1	0.08	0.00347826086956522	4165	1
1	Food 1	Intake 3	218	71558	1337404073	/users/cn/jespinosa/phecomp/data/CRG/20120502_FDF_CRG/20120502_FDF_CRG/20120518_FDF_CRG_c12.mtb	2624	7	WWSS	food_sc	3	71340	1337403855	1	0.0800000000000001	0.000366972477064221	4166	1
1	Drink 2	Intake 2	17	71572	1337404087	/users/cn/jespinosa/phecomp/data/CRG/20120502_FDF_CRG/20120502_FDF_CRG/20120518_FDF_CRG_c12.mtb	1278	NA	WWSS	water	2	71555	1337404070	1	0.0399999999999998	0.00235294117647058	4167	1
1	Food 1	Intake 3	101	71666	1337404181	/users/cn/jespinosa/phecomp/data/CRG/20120502_FDF_CRG/20120502_FDF_CRG/20120518_FDF_CRG_c12.mtb	2625	COLL	WWSS	food_sc	3	71565	1337404080	1	0.0600000000000001	0.000594059405940595	4168	1
1	Food 2	Intake 4	67	71720	1337404235	/users/cn/jespinosa/phecomp/data/CRG/20120502_FDF_CRG/20120502_FDF_CRG/20120518_FDF_CRG_c12.mtb	3442	397	WWSS	food_sc	4	71653	1337404168	1	0.02	0.000298507462686567	4169	1
1	Drink 1	Intake 1	21	71741	1337404256	/users/cn/jespinosa/phecomp/data/CRG/20120502_FDF_CRG/20120502_FDF_CRG/20120518_FDF_CRG_c12.mtb	2444	NA	WWSS	water	1	71720	1337404235	1	0.04	0.0019047619047619	4170	1
1	Drink 2	Intake 2	43	72114	1337404629	/users/cn/jespinosa/phecomp/data/CRG/20120502_FDF_CRG/20120502_FDF_CRG/20120518_FDF_CRG_c12.mtb	1279	NA	WWSS	water	2	72071	1337404586	1	0.02	0.000465116279069767	4171	1
1	Food 2	Intake 4	167	72284	1337404799	/users/cn/jespinosa/phecomp/data/CRG/20120502_FDF_CRG/20120502_FDF_CRG/20120518_FDF_CRG_c12.mtb	3446	23	WWSS	food_sc	4	72117	1337404632	1	0.02	0.000119760479041916	4172	1
1	Food 2	Intake 4	104	72411	1337404926	/users/cn/jespinosa/phecomp/data/CRG/20120502_FDF_CRG/20120502_FDF_CRG/20120518_FDF_CRG_c12.mtb	3447	235	WWSS	food_sc	4	72307	1337404822	1	0.0599999999999998	0.000576923076923075	4173	1
1	Drink 2	Intake 2	31	72439	1337404954	/users/cn/jespinosa/phecomp/data/CRG/20120502_FDF_CRG/20120502_FDF_CRG/20120518_FDF_CRG_c12.mtb	1280	NA	WWSS	water	2	72408	1337404923	1	0.1	0.0032258064516129	4174	1
1	Food 1	Intake 3	130	72776	1337405291	/users/cn/jespinosa/phecomp/data/CRG/20120502_FDF_CRG/20120502_FDF_CRG/20120518_FDF_CRG_c12.mtb	2631	136	WWSS	food_sc	3	72646	1337405161	1	0.04	0.000307692307692308	4175	1
1	Drink 2	Intake 2	11	72794	1337405309	/users/cn/jespinosa/phecomp/data/CRG/20120502_FDF_CRG/20120502_FDF_CRG/20120518_FDF_CRG_c12.mtb	1281	NA	WWSS	water	2	72783	1337405298	1	0.02	0.00181818181818182	4176	1
1	Food 1	Intake 3	89	73001	1337405516	/users/cn/jespinosa/phecomp/data/CRG/20120502_FDF_CRG/20120502_FDF_CRG/20120518_FDF_CRG_c12.mtb	2632	151	WWSS	food_sc	3	72912	1337405427	1	0.04	0.000449438202247191	4177	1
1	Drink 1	Intake 1	20	73020	1337405535	/users/cn/jespinosa/phecomp/data/CRG/20120502_FDF_CRG/20120502_FDF_CRG/20120518_FDF_CRG_c12.mtb	2446	NA	WWSS	water	1	73000	1337405515	1	0.0399999999999999	0.00199999999999999	4178	1
1	Food 1	Intake 3	65	73217	1337405732	/users/cn/jespinosa/phecomp/data/CRG/20120502_FDF_CRG/20120502_FDF_CRG/20120518_FDF_CRG_c12.mtb	2635	164	WWSS	food_sc	3	73152	1337405667	1	0.02	0.000307692307692308	4179	1
1	Drink 2	Intake 2	23	73286	1337405801	/users/cn/jespinosa/phecomp/data/CRG/20120502_FDF_CRG/20120502_FDF_CRG/20120518_FDF_CRG_c12.mtb	1282	NA	WWSS	water	2	73263	1337405778	1	0.0599999999999998	0.0026086956521739	4180	1
1	Food 1	Intake 3	23	73404	1337405919	/users/cn/jespinosa/phecomp/data/CRG/20120502_FDF_CRG/20120502_FDF_CRG/20120518_FDF_CRG_c12.mtb	2638	4	WWSS	food_sc	3	73381	1337405896	1	0.02	0.000869565217391304	4181	1
1	Food 1	Intake 3	52	73460	1337405975	/users/cn/jespinosa/phecomp/data/CRG/20120502_FDF_CRG/20120502_FDF_CRG/20120518_FDF_CRG_c12.mtb	2639	53	WWSS	food_sc	3	73408	1337405923	1	0.02	0.000384615384615385	4182	1
1	Drink 2	Intake 2	16	73494	1337406009	/users/cn/jespinosa/phecomp/data/CRG/20120502_FDF_CRG/20120502_FDF_CRG/20120518_FDF_CRG_c12.mtb	1283	NA	WWSS	water	2	73478	1337405993	1	0.04	0.0025	4183	1
1	Food 1	Intake 3	82	73595	1337406110	/users/cn/jespinosa/phecomp/data/CRG/20120502_FDF_CRG/20120502_FDF_CRG/20120518_FDF_CRG_c12.mtb	2640	254	WWSS	food_sc	3	73513	1337406028	1	0.04	0.00048780487804878	4184	1
1	Drink 2	Intake 2	21	73814	1337406329	/users/cn/jespinosa/phecomp/data/CRG/20120502_FDF_CRG/20120502_FDF_CRG/20120518_FDF_CRG_c12.mtb	1284	NA	WWSS	water	2	73793	1337406308	1	0.04	0.0019047619047619	4185	1
1	Food 1	Intake 3	88	73937	1337406452	/users/cn/jespinosa/phecomp/data/CRG/20120502_FDF_CRG/20120502_FDF_CRG/20120518_FDF_CRG_c12.mtb	2642	6	WWSS	food_sc	3	73849	1337406364	1	0.04	0.000454545454545455	4186	1
1	Food 1	Intake 3	52	73995	1337406510	/users/cn/jespinosa/phecomp/data/CRG/20120502_FDF_CRG/20120502_FDF_CRG/20120518_FDF_CRG_c12.mtb	2643	72	WWSS	food_sc	3	73943	1337406458	1	0.02	0.000384615384615385	4187	1
1	Food 1	Intake 3	144	74211	1337406726	/users/cn/jespinosa/phecomp/data/CRG/20120502_FDF_CRG/20120502_FDF_CRG/20120518_FDF_CRG_c12.mtb	2644	12	WWSS	food_sc	3	74067	1337406582	1	0.02	0.000138888888888889	4188	1
1	Drink 2	Intake 2	21	74225	1337406740	/users/cn/jespinosa/phecomp/data/CRG/20120502_FDF_CRG/20120502_FDF_CRG/20120518_FDF_CRG_c12.mtb	1285	NA	WWSS	water	2	74204	1337406719	1	0.04	0.0019047619047619	4189	1
1	Food 1	Intake 3	244	74467	1337406982	/users/cn/jespinosa/phecomp/data/CRG/20120502_FDF_CRG/20120502_FDF_CRG/20120518_FDF_CRG_c12.mtb	2645	446	WWSS	food_sc	3	74223	1337406738	1	0.0600000000000001	0.000245901639344263	4190	1
1	Drink 2	Intake 2	17	74797	1337407312	/users/cn/jespinosa/phecomp/data/CRG/20120502_FDF_CRG/20120502_FDF_CRG/20120518_FDF_CRG_c12.mtb	1286	NA	WWSS	water	2	74780	1337407295	1	0.04	0.00235294117647059	4191	1
1	Food 1	Intake 3	74	74987	1337407502	/users/cn/jespinosa/phecomp/data/CRG/20120502_FDF_CRG/20120502_FDF_CRG/20120518_FDF_CRG_c12.mtb	2649	8	WWSS	food_sc	3	74913	1337407428	1	0.04	0.000540540540540541	4192	1
1	Food 2	Intake 4	84	75079	1337407594	/users/cn/jespinosa/phecomp/data/CRG/20120502_FDF_CRG/20120502_FDF_CRG/20120518_FDF_CRG_c12.mtb	3470	307	WWSS	food_sc	4	74995	1337407510	1	0.02	0.000238095238095238	4193	1
1	Food 2	Intake 4	175	75561	1337408076	/users/cn/jespinosa/phecomp/data/CRG/20120502_FDF_CRG/20120502_FDF_CRG/20120518_FDF_CRG_c12.mtb	3472	COLL	WWSS	food_sc	4	75386	1337407901	1	0.04	0.000228571428571429	4194	1
1	Food 1	Intake 3	156	75660	1337408175	/users/cn/jespinosa/phecomp/data/CRG/20120502_FDF_CRG/20120502_FDF_CRG/20120518_FDF_CRG_c12.mtb	2652	9	WWSS	food_sc	3	75504	1337408019	1	0.0600000000000001	0.000384615384615385	4195	1
1	Food 1	Intake 3	117	75786	1337408301	/users/cn/jespinosa/phecomp/data/CRG/20120502_FDF_CRG/20120502_FDF_CRG/20120518_FDF_CRG_c12.mtb	2653	4217	WWSS	food_sc	3	75669	1337408184	1	0.0800000000000001	0.000683760683760685	4196	1
1	Drink 2	Intake 2	26	75806	1337408321	/users/cn/jespinosa/phecomp/data/CRG/20120502_FDF_CRG/20120502_FDF_CRG/20120518_FDF_CRG_c12.mtb	1287	NA	WWSS	water	2	75780	1337408295	1	0.0800000000000001	0.00307692307692308	4197	1
1	Drink 2	Intake 2	12	76207	1337408722	/users/cn/jespinosa/phecomp/data/CRG/20120502_FDF_CRG/20120502_FDF_CRG/20120518_FDF_CRG_c12.mtb	1288	NA	WWSS	water	2	76195	1337408710	1	0.02	0.00166666666666667	4198	1
1	Food 1	Intake 3	102	80105	1337412620	/users/cn/jespinosa/phecomp/data/CRG/20120502_FDF_CRG/20120502_FDF_CRG/20120518_FDF_CRG_c12.mtb	2658	4551	WWSS	food_sc	3	80003	1337412518	1	0.1	0.000980392156862745	4199	1
1	Food 2	Intake 4	16	84672	1337417187	/users/cn/jespinosa/phecomp/data/CRG/20120502_FDF_CRG/20120502_FDF_CRG/20120518_FDF_CRG_c12.mtb	3476	19	WWSS	food_sc	4	84656	1337417171	1	0.02	0.00125	4200	1
1	Food 2	Intake 4	17	84708	1337417223	/users/cn/jespinosa/phecomp/data/CRG/20120502_FDF_CRG/20120502_FDF_CRG/20120518_FDF_CRG_c12.mtb	3477	6627	WWSS	food_sc	4	84691	1337417206	1	0.02	0.00117647058823529	4201	1
1	Drink 1	Intake 1	15	84721	1337417236	/users/cn/jespinosa/phecomp/data/CRG/20120502_FDF_CRG/20120502_FDF_CRG/20120518_FDF_CRG_c12.mtb	2448	NA	WWSS	water	1	84706	1337417221	1	0.04	0.00266666666666667	4202	1
1	Drink 2	Intake 2	13	84856	1337417371	/users/cn/jespinosa/phecomp/data/CRG/20120502_FDF_CRG/20120502_FDF_CRG/20120518_FDF_CRG_c12.mtb	1289	NA	WWSS	water	2	84843	1337417358	1	0.04	0.00307692307692308	4203	1
1	Drink 2	Intake 2	17	85261	1337417776	/users/cn/jespinosa/phecomp/data/CRG/20120502_FDF_CRG/20120502_FDF_CRG/20120518_FDF_CRG_c12.mtb	1290	NA	WWSS	water	2	85244	1337417759	1	0.0399999999999998	0.00235294117647058	4204	1
1	Food 2	Intake 4	19	91354	1337423869	/users/cn/jespinosa/phecomp/data/CRG/20120502_FDF_CRG/20120502_FDF_CRG/20120518_FDF_CRG_c12.mtb	3479	4117	WWSS	food_sc	4	91335	1337423850	1	0.02	0.00105263157894737	4205	1
1	Food 2	Intake 4	30	95501	1337428016	/users/cn/jespinosa/phecomp/data/CRG/20120502_FDF_CRG/20120502_FDF_CRG/20120518_FDF_CRG_c12.mtb	3480	187	WWSS	food_sc	4	95471	1337427986	1	0.02	0.000666666666666667	4206	1
1	Food 2	Intake 4	25	95713	1337428228	/users/cn/jespinosa/phecomp/data/CRG/20120502_FDF_CRG/20120502_FDF_CRG/20120518_FDF_CRG_c12.mtb	3481	17	WWSS	food_sc	4	95688	1337428203	1	0.04	0.0016	4207	1
1	Food 2	Intake 4	52	95782	1337428297	/users/cn/jespinosa/phecomp/data/CRG/20120502_FDF_CRG/20120502_FDF_CRG/20120518_FDF_CRG_c12.mtb	3482	10756	WWSS	food_sc	4	95730	1337428245	1	0.02	0.000384615384615385	4208	1
1	Drink 2	Intake 2	11	95809	1337428324	/users/cn/jespinosa/phecomp/data/CRG/20120502_FDF_CRG/20120502_FDF_CRG/20120518_FDF_CRG_c12.mtb	1292	NA	WWSS	water	2	95798	1337428313	1	0.04	0.00363636363636364	4209	1
1	Drink 2	Intake 2	126	96404	1337428919	/users/cn/jespinosa/phecomp/data/CRG/20120502_FDF_CRG/20120502_FDF_CRG/20120518_FDF_CRG_c12.mtb	1293	NA	WWSS	water	2	96278	1337428793	1	0.0799999999999998	0.000634920634920633	4210	1
1	Drink 2	Intake 2	15	97487	1337430002	/users/cn/jespinosa/phecomp/data/CRG/20120502_FDF_CRG/20120502_FDF_CRG/20120518_FDF_CRG_c12.mtb	1294	NA	WWSS	water	2	97472	1337429987	1	0.04	0.00266666666666667	4211	1
1	Drink 2	Intake 2	17	102630	1337435145	/users/cn/jespinosa/phecomp/data/CRG/20120502_FDF_CRG/20120502_FDF_CRG/20120518_FDF_CRG_c12.mtb	1295	NA	WWSS	water	2	102613	1337435128	1	0.04	0.00235294117647059	4212	1
1	Food 2	Intake 4	21	106559	1337439074	/users/cn/jespinosa/phecomp/data/CRG/20120502_FDF_CRG/20120502_FDF_CRG/20120518_FDF_CRG_c12.mtb	3484	58	WWSS	food_sc	4	106538	1337439053	1	0.02	0.000952380952380952	4213	1
1	Food 2	Intake 4	39	106656	1337439171	/users/cn/jespinosa/phecomp/data/CRG/20120502_FDF_CRG/20120502_FDF_CRG/20120518_FDF_CRG_c12.mtb	3485	22	WWSS	food_sc	4	106617	1337439132	1	0.04	0.00102564102564103	4214	1
1	Food 2	Intake 4	29	106707	1337439222	/users/cn/jespinosa/phecomp/data/CRG/20120502_FDF_CRG/20120502_FDF_CRG/20120518_FDF_CRG_c12.mtb	3486	35	WWSS	food_sc	4	106678	1337439193	1	0.02	0.000689655172413793	4215	1
1	Food 2	Intake 4	60	106802	1337439317	/users/cn/jespinosa/phecomp/data/CRG/20120502_FDF_CRG/20120502_FDF_CRG/20120518_FDF_CRG_c12.mtb	3487	230	WWSS	food_sc	4	106742	1337439257	1	0.04	0.000666666666666667	4216	1
1	Food 2	Intake 4	16	107048	1337439563	/users/cn/jespinosa/phecomp/data/CRG/20120502_FDF_CRG/20120502_FDF_CRG/20120518_FDF_CRG_c12.mtb	3488	35	WWSS	food_sc	4	107032	1337439547	1	0.02	0.00125	4217	1
1	Food 2	Intake 4	17	107100	1337439615	/users/cn/jespinosa/phecomp/data/CRG/20120502_FDF_CRG/20120502_FDF_CRG/20120518_FDF_CRG_c12.mtb	3489	4614	WWSS	food_sc	4	107083	1337439598	1	0.02	0.00117647058823529	4218	1
1	Food 2	Intake 4	20	111734	1337444249	/users/cn/jespinosa/phecomp/data/CRG/20120502_FDF_CRG/20120502_FDF_CRG/20120518_FDF_CRG_c12.mtb	3491	44	WWSS	food_sc	4	111714	1337444229	1	0.02	0.001	4219	1
1	Food 2	Intake 4	39	111817	1337444332	/users/cn/jespinosa/phecomp/data/CRG/20120502_FDF_CRG/20120502_FDF_CRG/20120518_FDF_CRG_c12.mtb	3492	25	WWSS	food_sc	4	111778	1337444293	1	0.04	0.00102564102564103	4220	1
1	Food 2	Intake 4	88	111930	1337444445	/users/cn/jespinosa/phecomp/data/CRG/20120502_FDF_CRG/20120502_FDF_CRG/20120518_FDF_CRG_c12.mtb	3493	4390	WWSS	food_sc	4	111842	1337444357	1	0.0600000000000001	0.000681818181818183	4221	1
1	Drink 2	Intake 2	15	113365	1337445880	/users/cn/jespinosa/phecomp/data/CRG/20120502_FDF_CRG/20120502_FDF_CRG/20120518_FDF_CRG_c12.mtb	1296	NA	WWSS	water	2	113350	1337445865	1	0.04	0.00266666666666667	4222	1
1	Food 1	Intake 3	31	116351	1337448866	/users/cn/jespinosa/phecomp/data/CRG/20120502_FDF_CRG/20120502_FDF_CRG/20120518_FDF_CRG_c12.mtb	2660	31	WWSS	food_sc	3	116320	1337448835	1	0.0600000000000001	0.00193548387096775	4223	1
1	Food 1	Intake 3	17	116399	1337448914	/users/cn/jespinosa/phecomp/data/CRG/20120502_FDF_CRG/20120502_FDF_CRG/20120518_FDF_CRG_c12.mtb	2661	26	WWSS	food_sc	3	116382	1337448897	1	0.02	0.00117647058823529	4224	1
1	Food 1	Intake 3	32	116457	1337448972	/users/cn/jespinosa/phecomp/data/CRG/20120502_FDF_CRG/20120502_FDF_CRG/20120518_FDF_CRG_c12.mtb	2662	2074	WWSS	food_sc	3	116425	1337448940	1	0.02	0.000625	4225	1
1	Food 1	Intake 3	12	118543	1337451058	/users/cn/jespinosa/phecomp/data/CRG/20120502_FDF_CRG/20120502_FDF_CRG/20120518_FDF_CRG_c12.mtb	2663	666	WWSS	food_sc	3	118531	1337451046	1	0.02	0.00166666666666667	4226	1
1	Food 1	Intake 3	22	119231	1337451746	/users/cn/jespinosa/phecomp/data/CRG/20120502_FDF_CRG/20120502_FDF_CRG/20120518_FDF_CRG_c12.mtb	2664	47	WWSS	food_sc	3	119209	1337451724	1	0.04	0.00181818181818182	4227	1
1	Food 1	Intake 3	70	119348	1337451863	/users/cn/jespinosa/phecomp/data/CRG/20120502_FDF_CRG/20120502_FDF_CRG/20120518_FDF_CRG_c12.mtb	2666	16	WWSS	food_sc	3	119278	1337451793	1	0.04	0.000571428571428571	4228	1
1	Food 1	Intake 3	92	119456	1337451971	/users/cn/jespinosa/phecomp/data/CRG/20120502_FDF_CRG/20120502_FDF_CRG/20120518_FDF_CRG_c12.mtb	2667	90	WWSS	food_sc	3	119364	1337451879	1	0.04	0.000434782608695652	4229	1
1	Drink 2	Intake 2	14	119464	1337451979	/users/cn/jespinosa/phecomp/data/CRG/20120502_FDF_CRG/20120502_FDF_CRG/20120518_FDF_CRG_c12.mtb	1297	NA	WWSS	water	2	119450	1337451965	1	0.04	0.00285714285714286	4230	1
1	Food 2	Intake 4	208	119754	1337452269	/users/cn/jespinosa/phecomp/data/CRG/20120502_FDF_CRG/20120502_FDF_CRG/20120518_FDF_CRG_c12.mtb	3498	1582	WWSS	food_sc	4	119546	1337452061	1	0.04	0.000192307692307692	4231	1
1	Drink 2	Intake 2	26	119789	1337452304	/users/cn/jespinosa/phecomp/data/CRG/20120502_FDF_CRG/20120502_FDF_CRG/20120518_FDF_CRG_c12.mtb	1298	NA	WWSS	water	2	119763	1337452278	1	0.04	0.00153846153846154	4232	1
1	Drink 2	Intake 2	23	120450	1337452965	/users/cn/jespinosa/phecomp/data/CRG/20120502_FDF_CRG/20120502_FDF_CRG/20120518_FDF_CRG_c12.mtb	1299	NA	WWSS	water	2	120427	1337452942	1	0.04	0.00173913043478261	4233	1
1	Food 1	Intake 3	58	121394	1337453909	/users/cn/jespinosa/phecomp/data/CRG/20120502_FDF_CRG/20120502_FDF_CRG/20120518_FDF_CRG_c12.mtb	2675	1299	WWSS	food_sc	3	121336	1337453851	1	0.0600000000000001	0.00103448275862069	4234	1
1	Food 1	Intake 3	81	122774	1337455289	/users/cn/jespinosa/phecomp/data/CRG/20120502_FDF_CRG/20120502_FDF_CRG/20120518_FDF_CRG_c12.mtb	2676	14	WWSS	food_sc	3	122693	1337455208	1	0.02	0.000246913580246914	4235	1
1	Food 1	Intake 3	65	122853	1337455368	/users/cn/jespinosa/phecomp/data/CRG/20120502_FDF_CRG/20120502_FDF_CRG/20120518_FDF_CRG_c12.mtb	2677	39	WWSS	food_sc	3	122788	1337455303	1	0.0800000000000001	0.00123076923076923	4236	1
1	Food 1	Intake 3	59	122951	1337455466	/users/cn/jespinosa/phecomp/data/CRG/20120502_FDF_CRG/20120502_FDF_CRG/20120518_FDF_CRG_c12.mtb	2678	4	WWSS	food_sc	3	122892	1337455407	1	0.02	0.000338983050847458	4237	1
1	Food 1	Intake 3	78	123033	1337455548	/users/cn/jespinosa/phecomp/data/CRG/20120502_FDF_CRG/20120502_FDF_CRG/20120518_FDF_CRG_c12.mtb	2679	49	WWSS	food_sc	3	122955	1337455470	1	0.02	0.000256410256410256	4238	1
1	Drink 2	Intake 2	26	123063	1337455578	/users/cn/jespinosa/phecomp/data/CRG/20120502_FDF_CRG/20120502_FDF_CRG/20120518_FDF_CRG_c12.mtb	1301	NA	WWSS	water	2	123037	1337455552	1	0.0600000000000001	0.00230769230769231	4239	1
1	Food 1	Intake 3	80	123162	1337455677	/users/cn/jespinosa/phecomp/data/CRG/20120502_FDF_CRG/20120502_FDF_CRG/20120518_FDF_CRG_c12.mtb	2680	83	WWSS	food_sc	3	123082	1337455597	1	0.04	0.0005	4240	1
1	Food 1	Intake 3	18	123263	1337455778	/users/cn/jespinosa/phecomp/data/CRG/20120502_FDF_CRG/20120502_FDF_CRG/20120518_FDF_CRG_c12.mtb	2682	55	WWSS	food_sc	3	123245	1337455760	1	0.0200000000000005	0.00111111111111114	4241	1
1	Food 2	Intake 4	179	123497	1337456012	/users/cn/jespinosa/phecomp/data/CRG/20120502_FDF_CRG/20120502_FDF_CRG/20120518_FDF_CRG_c12.mtb	3507	234	WWSS	food_sc	4	123318	1337455833	1	0.04	0.000223463687150838	4242	1
1	Drink 2	Intake 2	20	123506	1337456021	/users/cn/jespinosa/phecomp/data/CRG/20120502_FDF_CRG/20120502_FDF_CRG/20120518_FDF_CRG_c12.mtb	1302	NA	WWSS	water	2	123486	1337456001	1	0.04	0.002	4243	1
1	Food 2	Intake 4	81	123812	1337456327	/users/cn/jespinosa/phecomp/data/CRG/20120502_FDF_CRG/20120502_FDF_CRG/20120518_FDF_CRG_c12.mtb	3509	58	WWSS	food_sc	4	123731	1337456246	1	0.02	0.000246913580246914	4244	1
1	Drink 1	Intake 1	32	123838	1337456353	/users/cn/jespinosa/phecomp/data/CRG/20120502_FDF_CRG/20120502_FDF_CRG/20120518_FDF_CRG_c12.mtb	2452	NA	WWSS	water	1	123806	1337456321	1	0.0600000000000001	0.001875	4245	1
1	Food 2	Intake 4	100	123970	1337456485	/users/cn/jespinosa/phecomp/data/CRG/20120502_FDF_CRG/20120502_FDF_CRG/20120518_FDF_CRG_c12.mtb	3510	59	WWSS	food_sc	4	123870	1337456385	1	0.02	0.0002	4246	1
1	Drink 2	Intake 2	26	124003	1337456518	/users/cn/jespinosa/phecomp/data/CRG/20120502_FDF_CRG/20120502_FDF_CRG/20120518_FDF_CRG_c12.mtb	1303	NA	WWSS	water	2	123977	1337456492	1	0.04	0.00153846153846154	4247	1
1	Food 2	Intake 4	136	124165	1337456680	/users/cn/jespinosa/phecomp/data/CRG/20120502_FDF_CRG/20120502_FDF_CRG/20120518_FDF_CRG_c12.mtb	3512	252	WWSS	food_sc	4	124029	1337456544	1	0.02	0.000147058823529412	4248	1
1	Drink 2	Intake 2	16	124204	1337456719	/users/cn/jespinosa/phecomp/data/CRG/20120502_FDF_CRG/20120502_FDF_CRG/20120518_FDF_CRG_c12.mtb	1304	NA	WWSS	water	2	124188	1337456703	1	0.02	0.00125	4249	1
1	Food 2	Intake 4	231	124648	1337457163	/users/cn/jespinosa/phecomp/data/CRG/20120502_FDF_CRG/20120502_FDF_CRG/20120518_FDF_CRG_c12.mtb	3514	6	WWSS	food_sc	4	124417	1337456932	1	0.0600000000000001	0.00025974025974026	4250	1
1	Food 2	Intake 4	48	124702	1337457217	/users/cn/jespinosa/phecomp/data/CRG/20120502_FDF_CRG/20120502_FDF_CRG/20120518_FDF_CRG_c12.mtb	3515	292	WWSS	food_sc	4	124654	1337457169	1	0.02	0.000416666666666667	4251	1
1	Drink 2	Intake 2	21	124713	1337457228	/users/cn/jespinosa/phecomp/data/CRG/20120502_FDF_CRG/20120502_FDF_CRG/20120518_FDF_CRG_c12.mtb	1305	NA	WWSS	water	2	124692	1337457207	1	0.0399999999999996	0.00190476190476189	4252	1
1	Food 2	Intake 4	89	125083	1337457598	/users/cn/jespinosa/phecomp/data/CRG/20120502_FDF_CRG/20120502_FDF_CRG/20120518_FDF_CRG_c12.mtb	3517	4	WWSS	food_sc	4	124994	1337457509	1	0.02	0.000224719101123596	4253	1
1	Food 2	Intake 4	94	125181	1337457696	/users/cn/jespinosa/phecomp/data/CRG/20120502_FDF_CRG/20120502_FDF_CRG/20120518_FDF_CRG_c12.mtb	3518	302	WWSS	food_sc	4	125087	1337457602	1	0.02	0.000212765957446809	4254	1
1	Drink 2	Intake 2	31	125207	1337457722	/users/cn/jespinosa/phecomp/data/CRG/20120502_FDF_CRG/20120502_FDF_CRG/20120518_FDF_CRG_c12.mtb	1306	NA	WWSS	water	2	125176	1337457691	1	0.0800000000000001	0.00258064516129033	4255	1
1	Food 2	Intake 4	110	125593	1337458108	/users/cn/jespinosa/phecomp/data/CRG/20120502_FDF_CRG/20120502_FDF_CRG/20120518_FDF_CRG_c12.mtb	3521	147	WWSS	food_sc	4	125483	1337457998	1	0.02	0.000181818181818182	4256	1
1	Food 2	Intake 4	138	125878	1337458393	/users/cn/jespinosa/phecomp/data/CRG/20120502_FDF_CRG/20120502_FDF_CRG/20120518_FDF_CRG_c12.mtb	3522	223	WWSS	food_sc	4	125740	1337458255	1	0.04	0.000289855072463768	4257	1
1	Drink 2	Intake 2	19	126040	1337458555	/users/cn/jespinosa/phecomp/data/CRG/20120502_FDF_CRG/20120502_FDF_CRG/20120518_FDF_CRG_c12.mtb	1307	NA	WWSS	water	2	126021	1337458536	1	0.04	0.00210526315789474	4258	1
1	Food 2	Intake 4	144	126245	1337458760	/users/cn/jespinosa/phecomp/data/CRG/20120502_FDF_CRG/20120502_FDF_CRG/20120518_FDF_CRG_c12.mtb	3524	11	WWSS	food_sc	4	126101	1337458616	1	0.04	0.000277777777777778	4259	1
1	Food 2	Intake 4	94	126350	1337458865	/users/cn/jespinosa/phecomp/data/CRG/20120502_FDF_CRG/20120502_FDF_CRG/20120518_FDF_CRG_c12.mtb	3525	54	WWSS	food_sc	4	126256	1337458771	1	0.04	0.000425531914893617	4260	1
1	Food 2	Intake 4	108	126512	1337459027	/users/cn/jespinosa/phecomp/data/CRG/20120502_FDF_CRG/20120502_FDF_CRG/20120518_FDF_CRG_c12.mtb	3526	609	WWSS	food_sc	4	126404	1337458919	1	0.04	0.00037037037037037	4261	1
1	Drink 2	Intake 2	23	126543	1337459058	/users/cn/jespinosa/phecomp/data/CRG/20120502_FDF_CRG/20120502_FDF_CRG/20120518_FDF_CRG_c12.mtb	1308	NA	WWSS	water	2	126520	1337459035	1	0.0600000000000001	0.00260869565217392	4262	1
1	Food 2	Intake 4	68	127189	1337459704	/users/cn/jespinosa/phecomp/data/CRG/20120502_FDF_CRG/20120502_FDF_CRG/20120518_FDF_CRG_c12.mtb	3530	154	WWSS	food_sc	4	127121	1337459636	1	0.04	0.000588235294117647	4263	1
1	Drink 2	Intake 2	20	127221	1337459736	/users/cn/jespinosa/phecomp/data/CRG/20120502_FDF_CRG/20120502_FDF_CRG/20120518_FDF_CRG_c12.mtb	1309	NA	WWSS	water	2	127201	1337459716	1	0.04	0.002	4264	1
1	Food 2	Intake 4	283	127626	1337460141	/users/cn/jespinosa/phecomp/data/CRG/20120502_FDF_CRG/20120502_FDF_CRG/20120518_FDF_CRG_c12.mtb	3532	43	WWSS	food_sc	4	127343	1337459858	1	0.0800000000000001	0.000282685512367492	4265	1
1	Food 2	Intake 4	137	127806	1337460321	/users/cn/jespinosa/phecomp/data/CRG/20120502_FDF_CRG/20120502_FDF_CRG/20120518_FDF_CRG_c12.mtb	3533	4	WWSS	food_sc	4	127669	1337460184	1	0.0999999999999996	0.000729927007299267	4266	1
1	Food 2	Intake 4	88	127898	1337460413	/users/cn/jespinosa/phecomp/data/CRG/20120502_FDF_CRG/20120502_FDF_CRG/20120518_FDF_CRG_c12.mtb	3534	1004	WWSS	food_sc	4	127810	1337460325	1	0.02	0.000227272727272727	4267	1
1	Drink 2	Intake 2	23	127913	1337460428	/users/cn/jespinosa/phecomp/data/CRG/20120502_FDF_CRG/20120502_FDF_CRG/20120518_FDF_CRG_c12.mtb	1310	NA	WWSS	water	2	127890	1337460405	1	0.0800000000000001	0.00347826086956522	4268	1
1	Food 2	Intake 4	15	128917	1337461432	/users/cn/jespinosa/phecomp/data/CRG/20120502_FDF_CRG/20120502_FDF_CRG/20120518_FDF_CRG_c12.mtb	3535	131	WWSS	food_sc	4	128902	1337461417	1	0.02	0.00133333333333333	4269	1
1	Food 1	Intake 3	33	129081	1337461596	/users/cn/jespinosa/phecomp/data/CRG/20120502_FDF_CRG/20120502_FDF_CRG/20120518_FDF_CRG_c12.mtb	2713	909	WWSS	food_sc	3	129048	1337461563	1	0.02	0.000606060606060606	4270	1
1	Drink 2	Intake 2	15	129959	1337462474	/users/cn/jespinosa/phecomp/data/CRG/20120502_FDF_CRG/20120502_FDF_CRG/20120518_FDF_CRG_c12.mtb	1311	NA	WWSS	water	2	129944	1337462459	1	0.02	0.00133333333333333	4271	1
1	Food 2	Intake 4	158	130148	1337462663	/users/cn/jespinosa/phecomp/data/CRG/20120502_FDF_CRG/20120502_FDF_CRG/20120518_FDF_CRG_c12.mtb	3540	84	WWSS	food_sc	4	129990	1337462505	1	0.04	0.000253164556962025	4272	1
1	Food 1	Intake 3	99	130331	1337462846	/users/cn/jespinosa/phecomp/data/CRG/20120502_FDF_CRG/20120502_FDF_CRG/20120518_FDF_CRG_c12.mtb	2717	54	WWSS	food_sc	3	130232	1337462747	1	0.02	0.000202020202020202	4273	1
1	Drink 1	Intake 1	20	130387	1337462902	/users/cn/jespinosa/phecomp/data/CRG/20120502_FDF_CRG/20120502_FDF_CRG/20120518_FDF_CRG_c12.mtb	2455	NA	WWSS	water	1	130367	1337462882	1	0.0399999999999999	0.00199999999999999	4274	1
1	Food 1	Intake 3	66	130451	1337462966	/users/cn/jespinosa/phecomp/data/CRG/20120502_FDF_CRG/20120502_FDF_CRG/20120518_FDF_CRG_c12.mtb	2718	224	WWSS	food_sc	3	130385	1337462900	1	0.04	0.000606060606060606	4275	1
1	Drink 1	Intake 1	22	130495	1337463010	/users/cn/jespinosa/phecomp/data/CRG/20120502_FDF_CRG/20120502_FDF_CRG/20120518_FDF_CRG_c12.mtb	2456	NA	WWSS	water	1	130473	1337462988	1	0.04	0.00181818181818182	4276	1
1	Food 1	Intake 3	35	130710	1337463225	/users/cn/jespinosa/phecomp/data/CRG/20120502_FDF_CRG/20120502_FDF_CRG/20120518_FDF_CRG_c12.mtb	2719	347	WWSS	food_sc	3	130675	1337463190	1	0.02	0.000571428571428571	4277	1
1	Drink 2	Intake 2	15	130896	1337463411	/users/cn/jespinosa/phecomp/data/CRG/20120502_FDF_CRG/20120502_FDF_CRG/20120518_FDF_CRG_c12.mtb	1313	NA	WWSS	water	2	130881	1337463396	1	0.02	0.00133333333333333	4278	1
1	Food 2	Intake 4	305	131362	1337463877	/users/cn/jespinosa/phecomp/data/CRG/20120502_FDF_CRG/20120502_FDF_CRG/20120518_FDF_CRG_c12.mtb	3545	44	WWSS	food_sc	4	131057	1337463572	1	0.36	0.00118032786885246	4279	1
1	Food 2	Intake 4	165	131571	1337464086	/users/cn/jespinosa/phecomp/data/CRG/20120502_FDF_CRG/20120502_FDF_CRG/20120518_FDF_CRG_c12.mtb	3546	32	WWSS	food_sc	4	131406	1337463921	1	0.04	0.000242424242424242	4280	1
1	Drink 2	Intake 2	25	131591	1337464106	/users/cn/jespinosa/phecomp/data/CRG/20120502_FDF_CRG/20120502_FDF_CRG/20120518_FDF_CRG_c12.mtb	1314	NA	WWSS	water	2	131566	1337464081	1	0.0600000000000001	0.0024	4281	1
1	Food 2	Intake 4	55	131658	1337464173	/users/cn/jespinosa/phecomp/data/CRG/20120502_FDF_CRG/20120502_FDF_CRG/20120518_FDF_CRG_c12.mtb	3547	233	WWSS	food_sc	4	131603	1337464118	1	0.02	0.000363636363636364	4282	1
1	Food 2	Intake 4	189	132080	1337464595	/users/cn/jespinosa/phecomp/data/CRG/20120502_FDF_CRG/20120502_FDF_CRG/20120518_FDF_CRG_c12.mtb	3549	44	WWSS	food_sc	4	131891	1337464406	1	0.04	0.000211640211640212	4283	1
1	Drink 2	Intake 2	25	132105	1337464620	/users/cn/jespinosa/phecomp/data/CRG/20120502_FDF_CRG/20120502_FDF_CRG/20120518_FDF_CRG_c12.mtb	1315	NA	WWSS	water	2	132080	1337464595	1	0.04	0.0016	4284	1
1	Food 2	Intake 4	150	132274	1337464789	/users/cn/jespinosa/phecomp/data/CRG/20120502_FDF_CRG/20120502_FDF_CRG/20120518_FDF_CRG_c12.mtb	3550	22	WWSS	food_sc	4	132124	1337464639	1	0.02	0.000133333333333333	4285	1
1	Food 2	Intake 4	93	132389	1337464904	/users/cn/jespinosa/phecomp/data/CRG/20120502_FDF_CRG/20120502_FDF_CRG/20120518_FDF_CRG_c12.mtb	3551	10	WWSS	food_sc	4	132296	1337464811	1	0.02	0.00021505376344086	4286	1
1	Food 2	Intake 4	244	132643	1337465158	/users/cn/jespinosa/phecomp/data/CRG/20120502_FDF_CRG/20120502_FDF_CRG/20120518_FDF_CRG_c12.mtb	3552	69	WWSS	food_sc	4	132399	1337464914	1	0.0800000000000001	0.000327868852459017	4287	1
1	Drink 2	Intake 2	22	132657	1337465172	/users/cn/jespinosa/phecomp/data/CRG/20120502_FDF_CRG/20120502_FDF_CRG/20120518_FDF_CRG_c12.mtb	1316	NA	WWSS	water	2	132635	1337465150	1	0.04	0.00181818181818182	4288	1
1	Food 2	Intake 4	232	132944	1337465459	/users/cn/jespinosa/phecomp/data/CRG/20120502_FDF_CRG/20120502_FDF_CRG/20120518_FDF_CRG_c12.mtb	3553	392	WWSS	food_sc	4	132712	1337465227	1	0.0600000000000001	0.000258620689655173	4289	1
1	Drink 2	Intake 2	17	132958	1337465473	/users/cn/jespinosa/phecomp/data/CRG/20120502_FDF_CRG/20120502_FDF_CRG/20120518_FDF_CRG_c12.mtb	1318	NA	WWSS	water	2	132941	1337465456	1	0.0599999999999996	0.00352941176470586	4290	1
1	Food 2	Intake 4	57	133393	1337465908	/users/cn/jespinosa/phecomp/data/CRG/20120502_FDF_CRG/20120502_FDF_CRG/20120518_FDF_CRG_c12.mtb	3555	56	WWSS	food_sc	4	133336	1337465851	1	0.04	0.000701754385964912	4291	1
1	Food 1	Intake 3	47	133496	1337466011	/users/cn/jespinosa/phecomp/data/CRG/20120502_FDF_CRG/20120502_FDF_CRG/20120518_FDF_CRG_c12.mtb	2733	COLL	WWSS	food_sc	3	133449	1337465964	1	0.02	0.000425531914893617	4292	1
1	Food 2	Intake 4	182	133665	1337466180	/users/cn/jespinosa/phecomp/data/CRG/20120502_FDF_CRG/20120502_FDF_CRG/20120518_FDF_CRG_c12.mtb	3557	80	WWSS	food_sc	4	133483	1337465998	1	0.04	0.00021978021978022	4293	1
1	Drink 2	Intake 2	26	133701	1337466216	/users/cn/jespinosa/phecomp/data/CRG/20120502_FDF_CRG/20120502_FDF_CRG/20120518_FDF_CRG_c12.mtb	1319	NA	WWSS	water	2	133675	1337466190	1	0.04	0.00153846153846154	4294	1
1	Food 2	Intake 4	128	133873	1337466388	/users/cn/jespinosa/phecomp/data/CRG/20120502_FDF_CRG/20120502_FDF_CRG/20120518_FDF_CRG_c12.mtb	3559	324	WWSS	food_sc	4	133745	1337466260	1	0.0600000000000001	0.000468750000000001	4295	1
1	Food 1	Intake 3	46	134243	1337466758	/users/cn/jespinosa/phecomp/data/CRG/20120502_FDF_CRG/20120502_FDF_CRG/20120518_FDF_CRG_c12.mtb	2735	COLL	WWSS	food_sc	3	134197	1337466712	1	0.02	0.000434782608695652	4296	1
1	Food 2	Intake 4	77	134310	1337466825	/users/cn/jespinosa/phecomp/data/CRG/20120502_FDF_CRG/20120502_FDF_CRG/20120518_FDF_CRG_c12.mtb	3562	224	WWSS	food_sc	4	134233	1337466748	1	0.0200000000000005	0.000259740259740266	4297	1
1	Food 2	Intake 4	25	134559	1337467074	/users/cn/jespinosa/phecomp/data/CRG/20120502_FDF_CRG/20120502_FDF_CRG/20120518_FDF_CRG_c12.mtb	3565	719	WWSS	food_sc	4	134534	1337467049	1	0.02	0.0008	4298	1
1	Drink 2	Intake 2	13	134624	1337467139	/users/cn/jespinosa/phecomp/data/CRG/20120502_FDF_CRG/20120502_FDF_CRG/20120518_FDF_CRG_c12.mtb	1320	NA	WWSS	water	2	134611	1337467126	1	0.02	0.00153846153846154	4299	1
1	Drink 2	Intake 2	35	135102	1337467617	/users/cn/jespinosa/phecomp/data/CRG/20120502_FDF_CRG/20120502_FDF_CRG/20120518_FDF_CRG_c12.mtb	1321	NA	WWSS	water	2	135067	1337467582	1	0.1	0.00285714285714286	4300	1
1	Food 1	Intake 3	30	135308	1337467823	/users/cn/jespinosa/phecomp/data/CRG/20120502_FDF_CRG/20120502_FDF_CRG/20120518_FDF_CRG_c12.mtb	2741	1147	WWSS	food_sc	3	135278	1337467793	1	0.02	0.000666666666666667	4301	1
1	Drink 2	Intake 2	17	136071	1337468586	/users/cn/jespinosa/phecomp/data/CRG/20120502_FDF_CRG/20120502_FDF_CRG/20120518_FDF_CRG_c12.mtb	1323	NA	WWSS	water	2	136054	1337468569	1	0.02	0.00117647058823529	4302	1
1	Food 2	Intake 4	138	136593	1337469108	/users/cn/jespinosa/phecomp/data/CRG/20120502_FDF_CRG/20120502_FDF_CRG/20120518_FDF_CRG_c12.mtb	3574	25	WWSS	food_sc	4	136455	1337468970	1	0.0600000000000001	0.000434782608695653	4303	1
1	Drink 2	Intake 2	15	136611	1337469126	/users/cn/jespinosa/phecomp/data/CRG/20120502_FDF_CRG/20120502_FDF_CRG/20120518_FDF_CRG_c12.mtb	1324	NA	WWSS	water	2	136596	1337469111	1	0.02	0.00133333333333333	4304	1
1	Food 2	Intake 4	81	136699	1337469214	/users/cn/jespinosa/phecomp/data/CRG/20120502_FDF_CRG/20120502_FDF_CRG/20120518_FDF_CRG_c12.mtb	3575	550	WWSS	food_sc	4	136618	1337469133	1	0.04	0.000493827160493827	4305	1
1	Drink 2	Intake 2	18	136716	1337469231	/users/cn/jespinosa/phecomp/data/CRG/20120502_FDF_CRG/20120502_FDF_CRG/20120518_FDF_CRG_c12.mtb	1325	NA	WWSS	water	2	136698	1337469213	1	0.02	0.00111111111111111	4306	1
1	Food 2	Intake 4	86	137335	1337469850	/users/cn/jespinosa/phecomp/data/CRG/20120502_FDF_CRG/20120502_FDF_CRG/20120518_FDF_CRG_c12.mtb	3580	71	WWSS	food_sc	4	137249	1337469764	1	0.0600000000000001	0.000697674418604652	4307	1
1	Food 2	Intake 4	141	137547	1337470062	/users/cn/jespinosa/phecomp/data/CRG/20120502_FDF_CRG/20120502_FDF_CRG/20120518_FDF_CRG_c12.mtb	3582	360	WWSS	food_sc	4	137406	1337469921	1	0.0399999999999996	0.000283687943262409	4308	1
1	Drink 2	Intake 2	20	137622	1337470137	/users/cn/jespinosa/phecomp/data/CRG/20120502_FDF_CRG/20120502_FDF_CRG/20120518_FDF_CRG_c12.mtb	1327	NA	WWSS	water	2	137602	1337470117	1	0.04	0.002	4309	1
1	Drink 1	Intake 1	44	137731	1337470246	/users/cn/jespinosa/phecomp/data/CRG/20120502_FDF_CRG/20120502_FDF_CRG/20120518_FDF_CRG_c12.mtb	2461	NA	WWSS	water	1	137687	1337470202	1	0.02	0.000454545454545455	4310	1
1	Food 2	Intake 4	23	137930	1337470445	/users/cn/jespinosa/phecomp/data/CRG/20120502_FDF_CRG/20120502_FDF_CRG/20120518_FDF_CRG_c12.mtb	3585	126	WWSS	food_sc	4	137907	1337470422	1	0.02	0.000869565217391304	4311	1
1	Food 1	Intake 3	189	138245	1337470760	/users/cn/jespinosa/phecomp/data/CRG/20120502_FDF_CRG/20120502_FDF_CRG/20120518_FDF_CRG_c12.mtb	2761	COLL	WWSS	food_sc	3	138056	1337470571	1	0.1	0.000529100529100529	4312	1
1	Food 2	Intake 4	15	138125	1337470640	/users/cn/jespinosa/phecomp/data/CRG/20120502_FDF_CRG/20120502_FDF_CRG/20120518_FDF_CRG_c12.mtb	3588	246	WWSS	food_sc	4	138110	1337470625	1	0.0800000000000001	0.00533333333333334	4313	1
1	Drink 1	Intake 1	14	138254	1337470769	/users/cn/jespinosa/phecomp/data/CRG/20120502_FDF_CRG/20120502_FDF_CRG/20120518_FDF_CRG_c12.mtb	2464	NA	WWSS	water	1	138240	1337470755	1	0.02	0.00142857142857143	4314	1
1	Food 2	Intake 4	65	138436	1337470951	/users/cn/jespinosa/phecomp/data/CRG/20120502_FDF_CRG/20120502_FDF_CRG/20120518_FDF_CRG_c12.mtb	3591	COLL	WWSS	food_sc	4	138371	1337470886	1	0.04	0.000615384615384615	4315	1
1	Food 1	Intake 3	66	138489	1337471004	/users/cn/jespinosa/phecomp/data/CRG/20120502_FDF_CRG/20120502_FDF_CRG/20120518_FDF_CRG_c12.mtb	2763	878	WWSS	food_sc	3	138423	1337470938	1	0.02	0.000303030303030303	4316	1
1	Food 1	Intake 3	63	139430	1337471945	/users/cn/jespinosa/phecomp/data/CRG/20120502_FDF_CRG/20120502_FDF_CRG/20120518_FDF_CRG_c12.mtb	2764	6667	WWSS	food_sc	3	139367	1337471882	1	0.02	0.000317460317460317	4317	1
1	Drink 2	Intake 2	22	139623	1337472138	/users/cn/jespinosa/phecomp/data/CRG/20120502_FDF_CRG/20120502_FDF_CRG/20120518_FDF_CRG_c12.mtb	1329	NA	WWSS	water	2	139601	1337472116	1	0.0800000000000001	0.00363636363636364	4318	1
1	Food 2	Intake 4	16	146113	1337478628	/users/cn/jespinosa/phecomp/data/CRG/20120502_FDF_CRG/20120502_FDF_CRG/20120518_FDF_CRG_c12.mtb	3594	75	WWSS	food_sc	4	146097	1337478612	1	0.0200000000000005	0.00125000000000003	4319	1
1	Food 2	Intake 4	9	146197	1337478712	/users/cn/jespinosa/phecomp/data/CRG/20120502_FDF_CRG/20120502_FDF_CRG/20120518_FDF_CRG_c12.mtb	3596	5496	WWSS	food_sc	4	146188	1337478703	1	0.0200000000000005	0.00222222222222228	4320	1
1	Food 2	Intake 4	33	151726	1337484241	/users/cn/jespinosa/phecomp/data/CRG/20120502_FDF_CRG/20120502_FDF_CRG/20120518_FDF_CRG_c12.mtb	3598	119	WWSS	food_sc	4	151693	1337484208	1	0.04	0.00121212121212121	4321	1
1	Food 2	Intake 4	28	151873	1337484388	/users/cn/jespinosa/phecomp/data/CRG/20120502_FDF_CRG/20120502_FDF_CRG/20120518_FDF_CRG_c12.mtb	3599	2774	WWSS	food_sc	4	151845	1337484360	1	0.0200000000000005	0.000714285714285732	4322	1
1	Food 2	Intake 4	60	154707	1337487222	/users/cn/jespinosa/phecomp/data/CRG/20120502_FDF_CRG/20120502_FDF_CRG/20120518_FDF_CRG_c12.mtb	3603	1673	WWSS	food_sc	4	154647	1337487162	1	0.04	0.000666666666666667	4323	1
1	Food 2	Intake 4	48	156428	1337488943	/users/cn/jespinosa/phecomp/data/CRG/20120502_FDF_CRG/20120502_FDF_CRG/20120518_FDF_CRG_c12.mtb	3606	4	WWSS	food_sc	4	156380	1337488895	1	0.04	0.000833333333333333	4324	1
1	Food 2	Intake 4	58	156490	1337489005	/users/cn/jespinosa/phecomp/data/CRG/20120502_FDF_CRG/20120502_FDF_CRG/20120518_FDF_CRG_c12.mtb	3607	22	WWSS	food_sc	4	156432	1337488947	1	0.04	0.000689655172413793	4325	1
1	Food 2	Intake 4	118	156630	1337489145	/users/cn/jespinosa/phecomp/data/CRG/20120502_FDF_CRG/20120502_FDF_CRG/20120518_FDF_CRG_c12.mtb	3608	36	WWSS	food_sc	4	156512	1337489027	1	0.04	0.000338983050847458	4326	1
1	Drink 1	Intake 1	16	156640	1337489155	/users/cn/jespinosa/phecomp/data/CRG/20120502_FDF_CRG/20120502_FDF_CRG/20120518_FDF_CRG_c12.mtb	2465	NA	WWSS	water	1	156624	1337489139	1	0.1	0.00625	4327	1
1	Food 2	Intake 4	93	156759	1337489274	/users/cn/jespinosa/phecomp/data/CRG/20120502_FDF_CRG/20120502_FDF_CRG/20120518_FDF_CRG_c12.mtb	3609	347	WWSS	food_sc	4	156666	1337489181	1	0.0200000000000005	0.000215053763440866	4328	1
1	Drink 1	Intake 1	20	156768	1337489283	/users/cn/jespinosa/phecomp/data/CRG/20120502_FDF_CRG/20120502_FDF_CRG/20120518_FDF_CRG_c12.mtb	2466	NA	WWSS	water	1	156748	1337489263	1	0.0399999999999998	0.00199999999999999	4329	1
1	Drink 2	Intake 2	21	156953	1337489468	/users/cn/jespinosa/phecomp/data/CRG/20120502_FDF_CRG/20120502_FDF_CRG/20120518_FDF_CRG_c12.mtb	1331	NA	WWSS	water	2	156932	1337489447	1	0.04	0.0019047619047619	4330	1
1	Food 2	Intake 4	53	157159	1337489674	/users/cn/jespinosa/phecomp/data/CRG/20120502_FDF_CRG/20120502_FDF_CRG/20120518_FDF_CRG_c12.mtb	3613	103	WWSS	food_sc	4	157106	1337489621	1	0.0200000000000005	0.000377358490566047	4331	1
1	Food 1	Intake 3	51	157313	1337489828	/users/cn/jespinosa/phecomp/data/CRG/20120502_FDF_CRG/20120502_FDF_CRG/20120518_FDF_CRG_c12.mtb	2773	550	WWSS	food_sc	3	157262	1337489777	1	0.02	0.000392156862745098	4332	1
1	Drink 2	Intake 2	25	157362	1337489877	/users/cn/jespinosa/phecomp/data/CRG/20120502_FDF_CRG/20120502_FDF_CRG/20120518_FDF_CRG_c12.mtb	1332	NA	WWSS	water	2	157337	1337489852	1	0.0799999999999996	0.00319999999999998	4333	1
1	Drink 2	Intake 2	16	157584	1337490099	/users/cn/jespinosa/phecomp/data/CRG/20120502_FDF_CRG/20120502_FDF_CRG/20120518_FDF_CRG_c12.mtb	1333	NA	WWSS	water	2	157568	1337490083	1	0.0200000000000005	0.00125000000000003	4334	1
1	Drink 2	Intake 2	22	157818	1337490333	/users/cn/jespinosa/phecomp/data/CRG/20120502_FDF_CRG/20120502_FDF_CRG/20120518_FDF_CRG_c12.mtb	1334	NA	WWSS	water	2	157796	1337490311	1	0.0399999999999996	0.0018181818181818	4335	1
1	Food 2	Intake 4	139	158002	1337490517	/users/cn/jespinosa/phecomp/data/CRG/20120502_FDF_CRG/20120502_FDF_CRG/20120518_FDF_CRG_c12.mtb	3619	157	WWSS	food_sc	4	157863	1337490378	1	0.0200000000000005	0.000143884892086335	4336	1
1	Food 1	Intake 3	44	158203	1337490718	/users/cn/jespinosa/phecomp/data/CRG/20120502_FDF_CRG/20120502_FDF_CRG/20120518_FDF_CRG_c12.mtb	2777	755	WWSS	food_sc	3	158159	1337490674	1	0.02	0.000454545454545455	4337	1
1	Drink 2	Intake 2	12	158343	1337490858	/users/cn/jespinosa/phecomp/data/CRG/20120502_FDF_CRG/20120502_FDF_CRG/20120518_FDF_CRG_c12.mtb	1335	NA	WWSS	water	2	158331	1337490846	1	0.02	0.00166666666666667	4338	1
1	Drink 2	Intake 2	21	158447	1337490962	/users/cn/jespinosa/phecomp/data/CRG/20120502_FDF_CRG/20120502_FDF_CRG/20120518_FDF_CRG_c12.mtb	1336	NA	WWSS	water	2	158426	1337490941	1	0.04	0.0019047619047619	4339	1
1	Food 2	Intake 4	160	159118	1337491633	/users/cn/jespinosa/phecomp/data/CRG/20120502_FDF_CRG/20120502_FDF_CRG/20120518_FDF_CRG_c12.mtb	3625	75	WWSS	food_sc	4	158958	1337491473	1	0.0400000000000009	0.000250000000000006	4340	1
1	Drink 2	Intake 2	20	159137	1337491652	/users/cn/jespinosa/phecomp/data/CRG/20120502_FDF_CRG/20120502_FDF_CRG/20120518_FDF_CRG_c12.mtb	1338	NA	WWSS	water	2	159117	1337491632	1	0.04	0.002	4341	1
1	Food 2	Intake 4	175	159368	1337491883	/users/cn/jespinosa/phecomp/data/CRG/20120502_FDF_CRG/20120502_FDF_CRG/20120518_FDF_CRG_c12.mtb	3627	10	WWSS	food_sc	4	159193	1337491708	1	0.0399999999999991	0.000228571428571423	4342	1
1	Drink 2	Intake 2	12	159375	1337491890	/users/cn/jespinosa/phecomp/data/CRG/20120502_FDF_CRG/20120502_FDF_CRG/20120518_FDF_CRG_c12.mtb	1339	NA	WWSS	water	2	159363	1337491878	1	0.02	0.00166666666666667	4343	1
1	Food 2	Intake 4	101	159479	1337491994	/users/cn/jespinosa/phecomp/data/CRG/20120502_FDF_CRG/20120502_FDF_CRG/20120518_FDF_CRG_c12.mtb	3628	48	WWSS	food_sc	4	159378	1337491893	1	0.04	0.000396039603960396	4344	1
1	Food 2	Intake 4	148	159675	1337492190	/users/cn/jespinosa/phecomp/data/CRG/20120502_FDF_CRG/20120502_FDF_CRG/20120518_FDF_CRG_c12.mtb	3629	56	WWSS	food_sc	4	159527	1337492042	1	0.0800000000000001	0.000540540540540541	4345	1
1	Drink 2	Intake 2	40	159707	1337492222	/users/cn/jespinosa/phecomp/data/CRG/20120502_FDF_CRG/20120502_FDF_CRG/20120518_FDF_CRG_c12.mtb	1341	NA	WWSS	water	2	159667	1337492182	1	0.02	0.0005	4346	1
1	Food 2	Intake 4	133	159864	1337492379	/users/cn/jespinosa/phecomp/data/CRG/20120502_FDF_CRG/20120502_FDF_CRG/20120518_FDF_CRG_c12.mtb	3630	113	WWSS	food_sc	4	159731	1337492246	1	0.04	0.000300751879699248	4347	1
1	Drink 2	Intake 2	22	159889	1337492404	/users/cn/jespinosa/phecomp/data/CRG/20120502_FDF_CRG/20120502_FDF_CRG/20120518_FDF_CRG_c12.mtb	1342	NA	WWSS	water	2	159867	1337492382	1	0.04	0.00181818181818182	4348	1
1	Food 2	Intake 4	133	160110	1337492625	/users/cn/jespinosa/phecomp/data/CRG/20120502_FDF_CRG/20120502_FDF_CRG/20120518_FDF_CRG_c12.mtb	3632	9	WWSS	food_sc	4	159977	1337492492	1	0.04	0.000300751879699248	4349	1
1	Food 2	Intake 4	193	160312	1337492827	/users/cn/jespinosa/phecomp/data/CRG/20120502_FDF_CRG/20120502_FDF_CRG/20120518_FDF_CRG_c12.mtb	3633	260	WWSS	food_sc	4	160119	1337492634	1	0.04	0.000207253886010363	4350	1
1	Drink 2	Intake 2	16	160501	1337493016	/users/cn/jespinosa/phecomp/data/CRG/20120502_FDF_CRG/20120502_FDF_CRG/20120518_FDF_CRG_c12.mtb	1343	NA	WWSS	water	2	160485	1337493000	1	0.04	0.0025	4351	1
1	Food 2	Intake 4	76	160648	1337493163	/users/cn/jespinosa/phecomp/data/CRG/20120502_FDF_CRG/20120502_FDF_CRG/20120518_FDF_CRG_c12.mtb	3636	74	WWSS	food_sc	4	160572	1337493087	1	0.0200000000000005	0.000263157894736849	4352	1
1	Food 2	Intake 4	164	160886	1337493401	/users/cn/jespinosa/phecomp/data/CRG/20120502_FDF_CRG/20120502_FDF_CRG/20120518_FDF_CRG_c12.mtb	3637	1464	WWSS	food_sc	4	160722	1337493237	1	0.04	0.00024390243902439	4353	1
1	Drink 2	Intake 2	19	160894	1337493409	/users/cn/jespinosa/phecomp/data/CRG/20120502_FDF_CRG/20120502_FDF_CRG/20120518_FDF_CRG_c12.mtb	1344	NA	WWSS	water	2	160875	1337493390	1	0.04	0.00210526315789474	4354	1
1	Drink 1	Intake 1	18	162156	1337494671	/users/cn/jespinosa/phecomp/data/CRG/20120502_FDF_CRG/20120502_FDF_CRG/20120518_FDF_CRG_c12.mtb	2470	NA	WWSS	water	1	162138	1337494653	1	0.02	0.00111111111111111	4355	1
1	Food 2	Intake 4	41	162391	1337494906	/users/cn/jespinosa/phecomp/data/CRG/20120502_FDF_CRG/20120502_FDF_CRG/20120518_FDF_CRG_c12.mtb	3646	4516	WWSS	food_sc	4	162350	1337494865	1	0.0600000000000005	0.00146341463414635	4356	1
1	Food 2	Intake 4	49	166956	1337499471	/users/cn/jespinosa/phecomp/data/CRG/20120502_FDF_CRG/20120502_FDF_CRG/20120518_FDF_CRG_c12.mtb	3649	37	WWSS	food_sc	4	166907	1337499422	1	0.0600000000000005	0.00122448979591838	4357	1
1	Food 2	Intake 4	42	167035	1337499550	/users/cn/jespinosa/phecomp/data/CRG/20120502_FDF_CRG/20120502_FDF_CRG/20120518_FDF_CRG_c12.mtb	3651	5943	WWSS	food_sc	4	166993	1337499508	1	0.04	0.000952380952380952	4358	1
1	Drink 2	Intake 2	20	167065	1337499580	/users/cn/jespinosa/phecomp/data/CRG/20120502_FDF_CRG/20120502_FDF_CRG/20120518_FDF_CRG_c12.mtb	1346	NA	WWSS	water	2	167045	1337499560	1	0.04	0.002	4359	1
1	Drink 2	Intake 2	21	167206	1337499721	/users/cn/jespinosa/phecomp/data/CRG/20120502_FDF_CRG/20120502_FDF_CRG/20120518_FDF_CRG_c12.mtb	1347	NA	WWSS	water	2	167185	1337499700	1	0.0800000000000001	0.00380952380952381	4360	1
1	Drink 1	Intake 1	12	168057	1337500572	/users/cn/jespinosa/phecomp/data/CRG/20120502_FDF_CRG/20120502_FDF_CRG/20120518_FDF_CRG_c12.mtb	2471	NA	WWSS	water	1	168045	1337500560	1	0.04	0.00333333333333333	4361	1
1	Food 2	Intake 4	18	172996	1337505511	/users/cn/jespinosa/phecomp/data/CRG/20120502_FDF_CRG/20120502_FDF_CRG/20120518_FDF_CRG_c12.mtb	3654	2167	WWSS	food_sc	4	172978	1337505493	1	0.0200000000000005	0.00111111111111114	4362	1
1	Food 2	Intake 4	155	175318	1337507833	/users/cn/jespinosa/phecomp/data/CRG/20120502_FDF_CRG/20120502_FDF_CRG/20120518_FDF_CRG_c12.mtb	3656	9	WWSS	food_sc	4	175163	1337507678	1	0.16	0.00103225806451613	4363	1
1	Food 2	Intake 4	69	175396	1337507911	/users/cn/jespinosa/phecomp/data/CRG/20120502_FDF_CRG/20120502_FDF_CRG/20120518_FDF_CRG_c12.mtb	3657	54	WWSS	food_sc	4	175327	1337507842	1	0.04	0.000579710144927536	4364	1
1	Food 2	Intake 4	18	175468	1337507983	/users/cn/jespinosa/phecomp/data/CRG/20120502_FDF_CRG/20120502_FDF_CRG/20120518_FDF_CRG_c12.mtb	3658	4830	WWSS	food_sc	4	175450	1337507965	1	0.0200000000000005	0.00111111111111114	4365	1
1	Food 2	Intake 4	39	180337	1337512852	/users/cn/jespinosa/phecomp/data/CRG/20120502_FDF_CRG/20120502_FDF_CRG/20120518_FDF_CRG_c12.mtb	3660	6	WWSS	food_sc	4	180298	1337512813	1	0.04	0.00102564102564103	4366	1
1	Food 2	Intake 4	30	180373	1337512888	/users/cn/jespinosa/phecomp/data/CRG/20120502_FDF_CRG/20120502_FDF_CRG/20120518_FDF_CRG_c12.mtb	3661	9107	WWSS	food_sc	4	180343	1337512858	1	0.04	0.00133333333333333	4367	1
1	Drink 2	Intake 2	14	180889	1337513404	/users/cn/jespinosa/phecomp/data/CRG/20120502_FDF_CRG/20120502_FDF_CRG/20120518_FDF_CRG_c12.mtb	1351	NA	WWSS	water	2	180875	1337513390	1	0.04	0.00285714285714286	4368	1
1	Drink 1	Intake 1	15	181977	1337514492	/users/cn/jespinosa/phecomp/data/CRG/20120502_FDF_CRG/20120502_FDF_CRG/20120518_FDF_CRG_c12.mtb	2472	NA	WWSS	water	1	181962	1337514477	1	0.02	0.00133333333333333	4369	1
1	Food 2	Intake 4	123	189603	1337522118	/users/cn/jespinosa/phecomp/data/CRG/20120502_FDF_CRG/20120502_FDF_CRG/20120518_FDF_CRG_c12.mtb	3665	15	WWSS	food_sc	4	189480	1337521995	1	0.0800000000000001	0.000650406504065041	4370	1
1	Food 2	Intake 4	119	189737	1337522252	/users/cn/jespinosa/phecomp/data/CRG/20120502_FDF_CRG/20120502_FDF_CRG/20120518_FDF_CRG_c12.mtb	3666	3681	WWSS	food_sc	4	189618	1337522133	1	0.0799999999999992	0.000672268907563019	4371	1
1	Food 2	Intake 4	95	193513	1337526028	/users/cn/jespinosa/phecomp/data/CRG/20120502_FDF_CRG/20120502_FDF_CRG/20120518_FDF_CRG_c12.mtb	3669	3636	WWSS	food_sc	4	193418	1337525933	1	0.04	0.000421052631578947	4372	1
1	Food 2	Intake 4	57	197206	1337529721	/users/cn/jespinosa/phecomp/data/CRG/20120502_FDF_CRG/20120502_FDF_CRG/20120518_FDF_CRG_c12.mtb	3670	4145	WWSS	food_sc	4	197149	1337529664	1	0.4	0.00701754385964912	4373	1
1	Food 2	Intake 4	51	201402	1337533917	/users/cn/jespinosa/phecomp/data/CRG/20120502_FDF_CRG/20120502_FDF_CRG/20120518_FDF_CRG_c12.mtb	3674	27	WWSS	food_sc	4	201351	1337533866	1	0.0200000000000005	0.000392156862745108	4374	1
1	Food 2	Intake 4	61	201490	1337534005	/users/cn/jespinosa/phecomp/data/CRG/20120502_FDF_CRG/20120502_FDF_CRG/20120518_FDF_CRG_c12.mtb	3675	4104	WWSS	food_sc	4	201429	1337533944	1	0.0599999999999996	0.000983606557377043	4375	1
1	Drink 2	Intake 2	45	204732	1337537247	/users/cn/jespinosa/phecomp/data/CRG/20120502_FDF_CRG/20120502_FDF_CRG/20120518_FDF_CRG_c12.mtb	1353	NA	WWSS	water	2	204687	1337537202	1	0.0200000000000005	0.000444444444444456	4376	1
1	Food 2	Intake 4	31	205625	1337538140	/users/cn/jespinosa/phecomp/data/CRG/20120502_FDF_CRG/20120502_FDF_CRG/20120518_FDF_CRG_c12.mtb	3679	40	WWSS	food_sc	4	205594	1337538109	1	0.0200000000000005	0.000645161290322597	4377	1
1	Food 2	Intake 4	118	205783	1337538298	/users/cn/jespinosa/phecomp/data/CRG/20120502_FDF_CRG/20120502_FDF_CRG/20120518_FDF_CRG_c12.mtb	3680	123	WWSS	food_sc	4	205665	1337538180	1	0.0599999999999996	0.000508474576271183	4378	1
1	Drink 2	Intake 2	26	205806	1337538321	/users/cn/jespinosa/phecomp/data/CRG/20120502_FDF_CRG/20120502_FDF_CRG/20120518_FDF_CRG_c12.mtb	1354	NA	WWSS	water	2	205780	1337538295	1	0.0399999999999996	0.00153846153846152	4379	1
1	Food 2	Intake 4	96	206002	1337538517	/users/cn/jespinosa/phecomp/data/CRG/20120502_FDF_CRG/20120502_FDF_CRG/20120518_FDF_CRG_c12.mtb	3682	517	WWSS	food_sc	4	205906	1337538421	1	0.0200000000000005	0.000208333333333339	4380	1
1	Drink 2	Intake 2	18	206015	1337538530	/users/cn/jespinosa/phecomp/data/CRG/20120502_FDF_CRG/20120502_FDF_CRG/20120518_FDF_CRG_c12.mtb	1355	NA	WWSS	water	2	205997	1337538512	1	0.02	0.00111111111111111	4381	1
1	Drink 2	Intake 2	31	206331	1337538846	/users/cn/jespinosa/phecomp/data/CRG/20120502_FDF_CRG/20120502_FDF_CRG/20120518_FDF_CRG_c12.mtb	1356	NA	WWSS	water	2	206300	1337538815	1	0.1	0.0032258064516129	4382	1
1	Food 1	Intake 3	101	206620	1337539135	/users/cn/jespinosa/phecomp/data/CRG/20120502_FDF_CRG/20120502_FDF_CRG/20120518_FDF_CRG_c12.mtb	2813	251	WWSS	food_sc	3	206519	1337539034	1	0.02	0.000198019801980198	4383	1
1	Drink 2	Intake 2	14	206853	1337539368	/users/cn/jespinosa/phecomp/data/CRG/20120502_FDF_CRG/20120502_FDF_CRG/20120518_FDF_CRG_c12.mtb	1358	NA	WWSS	water	2	206839	1337539354	1	0.02	0.00142857142857143	4384	1
1	Food 2	Intake 4	262	207133	1337539648	/users/cn/jespinosa/phecomp/data/CRG/20120502_FDF_CRG/20120502_FDF_CRG/20120518_FDF_CRG_c12.mtb	3693	247	WWSS	food_sc	4	206871	1337539386	1	0.04	0.000152671755725191	4385	1
1	Drink 1	Intake 1	54	207294	1337539809	/users/cn/jespinosa/phecomp/data/CRG/20120502_FDF_CRG/20120502_FDF_CRG/20120518_FDF_CRG_c12.mtb	2476	NA	WWSS	water	1	207240	1337539755	1	0.0999999999999999	0.00185185185185185	4386	1
1	Drink 2	Intake 2	41	207331	1337539846	/users/cn/jespinosa/phecomp/data/CRG/20120502_FDF_CRG/20120502_FDF_CRG/20120518_FDF_CRG_c12.mtb	1359	NA	WWSS	water	2	207290	1337539805	1	0.02	0.00048780487804878	4387	1
1	Food 2	Intake 4	81	207461	1337539976	/users/cn/jespinosa/phecomp/data/CRG/20120502_FDF_CRG/20120502_FDF_CRG/20120518_FDF_CRG_c12.mtb	3695	265	WWSS	food_sc	4	207380	1337539895	1	0.0200000000000005	0.00024691358024692	4388	1
1	Drink 1	Intake 1	25	207563	1337540078	/users/cn/jespinosa/phecomp/data/CRG/20120502_FDF_CRG/20120502_FDF_CRG/20120518_FDF_CRG_c12.mtb	2477	NA	WWSS	water	1	207538	1337540053	1	0.04	0.0016	4389	1
1	Drink 1	Intake 1	16	207609	1337540124	/users/cn/jespinosa/phecomp/data/CRG/20120502_FDF_CRG/20120502_FDF_CRG/20120518_FDF_CRG_c12.mtb	2478	NA	WWSS	water	1	207593	1337540108	1	0.02	0.00125	4390	1
1	Food 2	Intake 4	41	207767	1337540282	/users/cn/jespinosa/phecomp/data/CRG/20120502_FDF_CRG/20120502_FDF_CRG/20120518_FDF_CRG_c12.mtb	3699	667	WWSS	food_sc	4	207726	1337540241	1	0.0200000000000005	0.000487804878048793	4391	1
1	Food 1	Intake 3	47	208481	1337540996	/users/cn/jespinosa/phecomp/data/CRG/20120502_FDF_CRG/20120502_FDF_CRG/20120518_FDF_CRG_c12.mtb	2821	6	WWSS	food_sc	3	208434	1337540949	1	0.02	0.000425531914893617	4392	1
1	Food 1	Intake 3	39	208526	1337541041	/users/cn/jespinosa/phecomp/data/CRG/20120502_FDF_CRG/20120502_FDF_CRG/20120518_FDF_CRG_c12.mtb	2822	3573	WWSS	food_sc	3	208487	1337541002	1	0.04	0.00102564102564103	4393	1
1	Drink 2	Intake 2	22	210358	1337542873	/users/cn/jespinosa/phecomp/data/CRG/20120502_FDF_CRG/20120502_FDF_CRG/20120518_FDF_CRG_c12.mtb	1360	NA	WWSS	water	2	210336	1337542851	1	0.0399999999999996	0.0018181818181818	4394	1
1	Food 1	Intake 3	17	212116	1337544631	/users/cn/jespinosa/phecomp/data/CRG/20120502_FDF_CRG/20120502_FDF_CRG/20120518_FDF_CRG_c12.mtb	2823	75	WWSS	food_sc	3	212099	1337544614	1	0.02	0.00117647058823529	4395	1
1	Food 1	Intake 3	29	212220	1337544735	/users/cn/jespinosa/phecomp/data/CRG/20120502_FDF_CRG/20120502_FDF_CRG/20120518_FDF_CRG_c12.mtb	2825	53	WWSS	food_sc	3	212191	1337544706	1	0.0200000000000005	0.00068965517241381	4396	1
1	Drink 2	Intake 2	28	212283	1337544798	/users/cn/jespinosa/phecomp/data/CRG/20120502_FDF_CRG/20120502_FDF_CRG/20120518_FDF_CRG_c12.mtb	1361	NA	WWSS	water	2	212255	1337544770	1	0.0200000000000005	0.000714285714285732	4397	1
1	Food 1	Intake 3	89	212362	1337544877	/users/cn/jespinosa/phecomp/data/CRG/20120502_FDF_CRG/20120502_FDF_CRG/20120518_FDF_CRG_c12.mtb	2826	1497	WWSS	food_sc	3	212273	1337544788	1	0.0399999999999996	0.000449438202247186	4398	1
1	Drink 2	Intake 2	23	212379	1337544894	/users/cn/jespinosa/phecomp/data/CRG/20120502_FDF_CRG/20120502_FDF_CRG/20120518_FDF_CRG_c12.mtb	1362	NA	WWSS	water	2	212356	1337544871	1	0.04	0.00173913043478261	4399	1
1	Food 2	Intake 4	390	214249	1337546764	/users/cn/jespinosa/phecomp/data/CRG/20120502_FDF_CRG/20120502_FDF_CRG/20120518_FDF_CRG_c12.mtb	3707	234	WWSS	food_sc	4	213859	1337546374	1	0.18	0.000461538461538462	4400	1
1	Drink 2	Intake 2	42	214494	1337547009	/users/cn/jespinosa/phecomp/data/CRG/20120502_FDF_CRG/20120502_FDF_CRG/20120518_FDF_CRG_c12.mtb	1363	NA	WWSS	water	2	214452	1337546967	1	0.0599999999999996	0.00142857142857142	4401	1
1	Food 2	Intake 4	123	214606	1337547121	/users/cn/jespinosa/phecomp/data/CRG/20120502_FDF_CRG/20120502_FDF_CRG/20120518_FDF_CRG_c12.mtb	3710	151	WWSS	food_sc	4	214483	1337546998	1	0.04	0.00032520325203252	4402	1
1	Drink 1	Intake 1	18	214618	1337547133	/users/cn/jespinosa/phecomp/data/CRG/20120502_FDF_CRG/20120502_FDF_CRG/20120518_FDF_CRG_c12.mtb	2481	NA	WWSS	water	1	214600	1337547115	1	0.04	0.00222222222222222	4403	1
1	Food 2	Intake 4	116	214873	1337547388	/users/cn/jespinosa/phecomp/data/CRG/20120502_FDF_CRG/20120502_FDF_CRG/20120518_FDF_CRG_c12.mtb	3711	164	WWSS	food_sc	4	214757	1337547272	1	0.0200000000000005	0.000172413793103453	4404	1
1	Food 1	Intake 3	94	215131	1337547646	/users/cn/jespinosa/phecomp/data/CRG/20120502_FDF_CRG/20120502_FDF_CRG/20120518_FDF_CRG_c12.mtb	2829	COLL	WWSS	food_sc	3	215037	1337547552	1	0.02	0.000212765957446809	4405	1
1	Food 2	Intake 4	96	215202	1337547717	/users/cn/jespinosa/phecomp/data/CRG/20120502_FDF_CRG/20120502_FDF_CRG/20120518_FDF_CRG_c12.mtb	3713	215	WWSS	food_sc	4	215106	1337547621	1	0.04	0.000416666666666667	4406	1
1	Drink 2	Intake 2	27	215223	1337547738	/users/cn/jespinosa/phecomp/data/CRG/20120502_FDF_CRG/20120502_FDF_CRG/20120518_FDF_CRG_c12.mtb	1364	NA	WWSS	water	2	215196	1337547711	1	0.0600000000000005	0.00222222222222224	4407	1
1	Food 2	Intake 4	86	215503	1337548018	/users/cn/jespinosa/phecomp/data/CRG/20120502_FDF_CRG/20120502_FDF_CRG/20120518_FDF_CRG_c12.mtb	3715	884	WWSS	food_sc	4	215417	1337547932	1	0.0200000000000005	0.00023255813953489	4408	1
1	Drink 1	Intake 1	16	215514	1337548029	/users/cn/jespinosa/phecomp/data/CRG/20120502_FDF_CRG/20120502_FDF_CRG/20120518_FDF_CRG_c12.mtb	2482	NA	WWSS	water	1	215498	1337548013	1	0.02	0.00125	4409	1
1	Drink 1	Intake 1	24	215584	1337548099	/users/cn/jespinosa/phecomp/data/CRG/20120502_FDF_CRG/20120502_FDF_CRG/20120518_FDF_CRG_c12.mtb	2484	NA	WWSS	water	1	215560	1337548075	1	0.02	0.000833333333333333	4410	1
1	Drink 2	Intake 2	23	215909	1337548424	/users/cn/jespinosa/phecomp/data/CRG/20120502_FDF_CRG/20120502_FDF_CRG/20120518_FDF_CRG_c12.mtb	1366	NA	WWSS	water	2	215886	1337548401	1	0.0599999999999996	0.0026086956521739	4411	1
1	Food 2	Intake 4	96	216483	1337548998	/users/cn/jespinosa/phecomp/data/CRG/20120502_FDF_CRG/20120502_FDF_CRG/20120518_FDF_CRG_c12.mtb	3721	40	WWSS	food_sc	4	216387	1337548902	1	0.04	0.000416666666666667	4412	1
1	Food 2	Intake 4	156	216679	1337549194	/users/cn/jespinosa/phecomp/data/CRG/20120502_FDF_CRG/20120502_FDF_CRG/20120518_FDF_CRG_c12.mtb	3722	138	WWSS	food_sc	4	216523	1337549038	1	0.0200000000000005	0.000128205128205131	4413	1
1	Food 2	Intake 4	100	216917	1337549432	/users/cn/jespinosa/phecomp/data/CRG/20120502_FDF_CRG/20120502_FDF_CRG/20120518_FDF_CRG_c12.mtb	3724	343	WWSS	food_sc	4	216817	1337549332	1	0.04	0.0004	4414	1
1	Drink 2	Intake 2	17	217023	1337549538	/users/cn/jespinosa/phecomp/data/CRG/20120502_FDF_CRG/20120502_FDF_CRG/20120518_FDF_CRG_c12.mtb	1369	NA	WWSS	water	2	217006	1337549521	1	0.0200000000000005	0.00117647058823532	4415	1
1	Drink 1	Intake 1	18	217146	1337549661	/users/cn/jespinosa/phecomp/data/CRG/20120502_FDF_CRG/20120502_FDF_CRG/20120518_FDF_CRG_c12.mtb	2486	NA	WWSS	water	1	217128	1337549643	1	0.0600000000000001	0.00333333333333334	4416	1
1	Food 2	Intake 4	42	217302	1337549817	/users/cn/jespinosa/phecomp/data/CRG/20120502_FDF_CRG/20120502_FDF_CRG/20120518_FDF_CRG_c12.mtb	3727	4	WWSS	food_sc	4	217260	1337549775	1	0.0200000000000005	0.000476190476190488	4417	1
1	Food 2	Intake 4	145	217451	1337549966	/users/cn/jespinosa/phecomp/data/CRG/20120502_FDF_CRG/20120502_FDF_CRG/20120518_FDF_CRG_c12.mtb	3728	322	WWSS	food_sc	4	217306	1337549821	1	0.0399999999999991	0.000275862068965511	4418	1
1	Food 2	Intake 4	92	217865	1337550380	/users/cn/jespinosa/phecomp/data/CRG/20120502_FDF_CRG/20120502_FDF_CRG/20120518_FDF_CRG_c12.mtb	3731	32	WWSS	food_sc	4	217773	1337550288	1	0.0200000000000005	0.000217391304347832	4419	1
1	Food 2	Intake 4	126	218023	1337550538	/users/cn/jespinosa/phecomp/data/CRG/20120502_FDF_CRG/20120502_FDF_CRG/20120518_FDF_CRG_c12.mtb	3732	600	WWSS	food_sc	4	217897	1337550412	1	0.0599999999999996	0.000476190476190473	4420	1
1	Drink 2	Intake 2	28	218043	1337550558	/users/cn/jespinosa/phecomp/data/CRG/20120502_FDF_CRG/20120502_FDF_CRG/20120518_FDF_CRG_c12.mtb	1370	NA	WWSS	water	2	218015	1337550530	1	0.0599999999999996	0.00214285714285713	4421	1
1	Food 1	Intake 3	94	218717	1337551232	/users/cn/jespinosa/phecomp/data/CRG/20120502_FDF_CRG/20120502_FDF_CRG/20120518_FDF_CRG_c12.mtb	2840	41	WWSS	food_sc	3	218623	1337551138	1	0.02	0.000212765957446809	4422	1
1	Drink 2	Intake 2	19	218736	1337551251	/users/cn/jespinosa/phecomp/data/CRG/20120502_FDF_CRG/20120502_FDF_CRG/20120518_FDF_CRG_c12.mtb	1372	NA	WWSS	water	2	218717	1337551232	1	0.0200000000000005	0.00105263157894739	4423	1
1	Food 2	Intake 4	56	218814	1337551329	/users/cn/jespinosa/phecomp/data/CRG/20120502_FDF_CRG/20120502_FDF_CRG/20120518_FDF_CRG_c12.mtb	3736	28	WWSS	food_sc	4	218758	1337551273	1	0.04	0.000714285714285714	4424	1
1	Food 2	Intake 4	121	218963	1337551478	/users/cn/jespinosa/phecomp/data/CRG/20120502_FDF_CRG/20120502_FDF_CRG/20120518_FDF_CRG_c12.mtb	3737	299	WWSS	food_sc	4	218842	1337551357	1	0.0200000000000005	0.000165289256198351	4425	1
1	Drink 2	Intake 2	25	218980	1337551495	/users/cn/jespinosa/phecomp/data/CRG/20120502_FDF_CRG/20120502_FDF_CRG/20120518_FDF_CRG_c12.mtb	1373	NA	WWSS	water	2	218955	1337551470	1	0.0599999999999996	0.00239999999999998	4426	1
1	Drink 2	Intake 2	18	219241	1337551756	/users/cn/jespinosa/phecomp/data/CRG/20120502_FDF_CRG/20120502_FDF_CRG/20120518_FDF_CRG_c12.mtb	1374	NA	WWSS	water	2	219223	1337551738	1	0.0200000000000005	0.00111111111111114	4427	1
1	Food 2	Intake 4	120	219382	1337551897	/users/cn/jespinosa/phecomp/data/CRG/20120502_FDF_CRG/20120502_FDF_CRG/20120518_FDF_CRG_c12.mtb	3739	1775	WWSS	food_sc	4	219262	1337551777	1	0.0200000000000005	0.000166666666666671	4428	1
1	Drink 2	Intake 2	44	219883	1337552398	/users/cn/jespinosa/phecomp/data/CRG/20120502_FDF_CRG/20120502_FDF_CRG/20120518_FDF_CRG_c12.mtb	1375	NA	WWSS	water	2	219839	1337552354	1	0.12	0.00272727272727273	4429	1
1	Food 2	Intake 4	64	221221	1337553736	/users/cn/jespinosa/phecomp/data/CRG/20120502_FDF_CRG/20120502_FDF_CRG/20120518_FDF_CRG_c12.mtb	3748	263	WWSS	food_sc	4	221157	1337553672	1	0.04	0.000625	4430	1
1	Food 2	Intake 4	57	221541	1337554056	/users/cn/jespinosa/phecomp/data/CRG/20120502_FDF_CRG/20120502_FDF_CRG/20120518_FDF_CRG_c12.mtb	3751	86	WWSS	food_sc	4	221484	1337553999	1	0.04	0.000701754385964912	4431	1
1	Food 1	Intake 3	143	221770	1337554285	/users/cn/jespinosa/phecomp/data/CRG/20120502_FDF_CRG/20120502_FDF_CRG/20120518_FDF_CRG_c12.mtb	2853	11	WWSS	food_sc	3	221627	1337554142	1	0.04	0.00027972027972028	4432	1
1	Food 1	Intake 3	64	221845	1337554360	/users/cn/jespinosa/phecomp/data/CRG/20120502_FDF_CRG/20120502_FDF_CRG/20120518_FDF_CRG_c12.mtb	2854	81	WWSS	food_sc	3	221781	1337554296	1	0.02	0.0003125	4433	1
1	Drink 1	Intake 1	13	221855	1337554370	/users/cn/jespinosa/phecomp/data/CRG/20120502_FDF_CRG/20120502_FDF_CRG/20120518_FDF_CRG_c12.mtb	2492	NA	WWSS	water	1	221842	1337554357	1	0.04	0.00307692307692308	4434	1
1	Food 1	Intake 3	85	222011	1337554526	/users/cn/jespinosa/phecomp/data/CRG/20120502_FDF_CRG/20120502_FDF_CRG/20120518_FDF_CRG_c12.mtb	2855	270	WWSS	food_sc	3	221926	1337554441	1	0.04	0.000470588235294118	4435	1
1	Drink 2	Intake 2	34	222047	1337554562	/users/cn/jespinosa/phecomp/data/CRG/20120502_FDF_CRG/20120502_FDF_CRG/20120518_FDF_CRG_c12.mtb	1379	NA	WWSS	water	2	222013	1337554528	1	0.0800000000000001	0.00235294117647059	4436	1
1	Food 1	Intake 3	92	222373	1337554888	/users/cn/jespinosa/phecomp/data/CRG/20120502_FDF_CRG/20120502_FDF_CRG/20120518_FDF_CRG_c12.mtb	2856	143	WWSS	food_sc	3	222281	1337554796	1	0.02	0.000217391304347826	4437	1
1	Food 1	Intake 3	108	222624	1337555139	/users/cn/jespinosa/phecomp/data/CRG/20120502_FDF_CRG/20120502_FDF_CRG/20120518_FDF_CRG_c12.mtb	2858	556	WWSS	food_sc	3	222516	1337555031	1	0.02	0.000185185185185185	4438	1
1	Food 1	Intake 3	86	223266	1337555781	/users/cn/jespinosa/phecomp/data/CRG/20120502_FDF_CRG/20120502_FDF_CRG/20120518_FDF_CRG_c12.mtb	2859	1006	WWSS	food_sc	3	223180	1337555695	1	0.04	0.000465116279069767	4439	1
1	Food 1	Intake 3	58	224330	1337556845	/users/cn/jespinosa/phecomp/data/CRG/20120502_FDF_CRG/20120502_FDF_CRG/20120518_FDF_CRG_c12.mtb	2868	6164	WWSS	food_sc	3	224272	1337556787	1	0.0600000000000001	0.00103448275862069	4440	1
1	Drink 1	Intake 1	26	224434	1337556949	/users/cn/jespinosa/phecomp/data/CRG/20120502_FDF_CRG/20120502_FDF_CRG/20120518_FDF_CRG_c12.mtb	2495	NA	WWSS	water	1	224408	1337556923	1	0.0999999999999999	0.00384615384615384	4441	1
1	Food 2	Intake 4	37	230531	1337563046	/users/cn/jespinosa/phecomp/data/CRG/20120502_FDF_CRG/20120502_FDF_CRG/20120518_FDF_CRG_c12.mtb	3770	133	WWSS	food_sc	4	230494	1337563009	1	0.0200000000000005	0.000540540540540554	4442	1
1	Food 2	Intake 4	89	230753	1337563268	/users/cn/jespinosa/phecomp/data/CRG/20120502_FDF_CRG/20120502_FDF_CRG/20120518_FDF_CRG_c12.mtb	3772	74	WWSS	food_sc	4	230664	1337563179	1	0.0200000000000005	0.000224719101123601	4443	1
1	Food 2	Intake 4	231	231058	1337563573	/users/cn/jespinosa/phecomp/data/CRG/20120502_FDF_CRG/20120502_FDF_CRG/20120518_FDF_CRG_c12.mtb	3773	220	WWSS	food_sc	4	230827	1337563342	1	0.0800000000000001	0.000346320346320347	4444	1
1	Drink 2	Intake 2	26	231079	1337563594	/users/cn/jespinosa/phecomp/data/CRG/20120502_FDF_CRG/20120502_FDF_CRG/20120518_FDF_CRG_c12.mtb	1383	NA	WWSS	water	2	231053	1337563568	1	0.0600000000000005	0.00230769230769233	4445	1
1	Food 1	Intake 3	110	231388	1337563903	/users/cn/jespinosa/phecomp/data/CRG/20120502_FDF_CRG/20120502_FDF_CRG/20120518_FDF_CRG_c12.mtb	2878	11	WWSS	food_sc	3	231278	1337563793	1	0.02	0.000181818181818182	4446	1
1	Food 1	Intake 3	79	231478	1337563993	/users/cn/jespinosa/phecomp/data/CRG/20120502_FDF_CRG/20120502_FDF_CRG/20120518_FDF_CRG_c12.mtb	2879	130	WWSS	food_sc	3	231399	1337563914	1	0.02	0.000253164556962025	4447	1
1	Food 1	Intake 3	87	231695	1337564210	/users/cn/jespinosa/phecomp/data/CRG/20120502_FDF_CRG/20120502_FDF_CRG/20120518_FDF_CRG_c12.mtb	2880	278	WWSS	food_sc	3	231608	1337564123	1	0.04	0.000459770114942529	4448	1
1	Drink 2	Intake 2	16	231706	1337564221	/users/cn/jespinosa/phecomp/data/CRG/20120502_FDF_CRG/20120502_FDF_CRG/20120518_FDF_CRG_c12.mtb	1385	NA	WWSS	water	2	231690	1337564205	1	0.0599999999999996	0.00374999999999998	4449	1
1	Drink 1	Intake 1	20	231772	1337564287	/users/cn/jespinosa/phecomp/data/CRG/20120502_FDF_CRG/20120502_FDF_CRG/20120518_FDF_CRG_c12.mtb	2498	NA	WWSS	water	1	231752	1337564267	1	0.02	0.001	4450	1
1	Drink 2	Intake 2	17	231922	1337564437	/users/cn/jespinosa/phecomp/data/CRG/20120502_FDF_CRG/20120502_FDF_CRG/20120518_FDF_CRG_c12.mtb	1387	NA	WWSS	water	2	231905	1337564420	1	0.0200000000000005	0.00117647058823532	4451	1
1	Food 1	Intake 3	18	231991	1337564506	/users/cn/jespinosa/phecomp/data/CRG/20120502_FDF_CRG/20120502_FDF_CRG/20120518_FDF_CRG_c12.mtb	2882	1328	WWSS	food_sc	3	231973	1337564488	1	0.02	0.00111111111111111	4452	1
1	Drink 2	Intake 2	33	232421	1337564936	/users/cn/jespinosa/phecomp/data/CRG/20120502_FDF_CRG/20120502_FDF_CRG/20120518_FDF_CRG_c12.mtb	1388	NA	WWSS	water	2	232388	1337564903	1	0.0999999999999996	0.00303030303030302	4453	1
1	Food 2	Intake 4	16	233335	1337565850	/users/cn/jespinosa/phecomp/data/CRG/20120502_FDF_CRG/20120502_FDF_CRG/20120518_FDF_CRG_c12.mtb	3779	9782	WWSS	food_sc	4	233319	1337565834	1	0.0200000000000005	0.00125000000000003	4454	1
1	Food 1	Intake 3	63	243180	1337575695	/users/cn/jespinosa/phecomp/data/CRG/20120502_FDF_CRG/20120502_FDF_CRG/20120518_FDF_CRG_c12.mtb	2888	277	WWSS	food_sc	3	243117	1337575632	1	0.04	0.000634920634920635	4455	1
1	Food 2	Intake 4	169	243626	1337576141	/users/cn/jespinosa/phecomp/data/CRG/20120502_FDF_CRG/20120502_FDF_CRG/20120518_FDF_CRG_c12.mtb	3784	224	WWSS	food_sc	4	243457	1337575972	1	0.0800000000000001	0.000473372781065089	4456	1
1	Drink 2	Intake 2	24	243650	1337576165	/users/cn/jespinosa/phecomp/data/CRG/20120502_FDF_CRG/20120502_FDF_CRG/20120518_FDF_CRG_c12.mtb	1389	NA	WWSS	water	2	243626	1337576141	1	0.0600000000000005	0.00250000000000002	4457	1
1	Food 2	Intake 4	112	243962	1337576477	/users/cn/jespinosa/phecomp/data/CRG/20120502_FDF_CRG/20120502_FDF_CRG/20120518_FDF_CRG_c12.mtb	3787	148	WWSS	food_sc	4	243850	1337576365	1	0.04	0.000357142857142857	4458	1
1	Drink 1	Intake 1	25	244001	1337576516	/users/cn/jespinosa/phecomp/data/CRG/20120502_FDF_CRG/20120502_FDF_CRG/20120518_FDF_CRG_c12.mtb	2503	NA	WWSS	water	1	243976	1337576491	1	0.0600000000000001	0.0024	4459	1
1	Food 1	Intake 3	156	244266	1337576781	/users/cn/jespinosa/phecomp/data/CRG/20120502_FDF_CRG/20120502_FDF_CRG/20120518_FDF_CRG_c12.mtb	2896	46	WWSS	food_sc	3	244110	1337576625	1	0.04	0.000256410256410256	4460	1
1	Drink 1	Intake 1	18	244281	1337576796	/users/cn/jespinosa/phecomp/data/CRG/20120502_FDF_CRG/20120502_FDF_CRG/20120518_FDF_CRG_c12.mtb	2504	NA	WWSS	water	1	244263	1337576778	1	0.0399999999999998	0.00222222222222221	4461	1
1	Food 1	Intake 3	155	244467	1337576982	/users/cn/jespinosa/phecomp/data/CRG/20120502_FDF_CRG/20120502_FDF_CRG/20120518_FDF_CRG_c12.mtb	2897	14	WWSS	food_sc	3	244312	1337576827	1	0.02	0.000129032258064516	4462	1
1	Food 1	Intake 3	63	244544	1337577059	/users/cn/jespinosa/phecomp/data/CRG/20120502_FDF_CRG/20120502_FDF_CRG/20120518_FDF_CRG_c12.mtb	2898	25	WWSS	food_sc	3	244481	1337576996	1	0.04	0.000634920634920635	4463	1
1	Drink 1	Intake 1	20	244563	1337577078	/users/cn/jespinosa/phecomp/data/CRG/20120502_FDF_CRG/20120502_FDF_CRG/20120518_FDF_CRG_c12.mtb	2505	NA	WWSS	water	1	244543	1337577058	1	0.02	0.001	4464	1
1	Food 1	Intake 3	120	244689	1337577204	/users/cn/jespinosa/phecomp/data/CRG/20120502_FDF_CRG/20120502_FDF_CRG/20120518_FDF_CRG_c12.mtb	2899	166	WWSS	food_sc	3	244569	1337577084	1	0.02	0.000166666666666667	4465	1
1	Drink 2	Intake 2	17	244768	1337577283	/users/cn/jespinosa/phecomp/data/CRG/20120502_FDF_CRG/20120502_FDF_CRG/20120518_FDF_CRG_c12.mtb	1392	NA	WWSS	water	2	244751	1337577266	1	0.0200000000000005	0.00117647058823532	4466	1
1	Food 2	Intake 4	34	244889	1337577404	/users/cn/jespinosa/phecomp/data/CRG/20120502_FDF_CRG/20120502_FDF_CRG/20120518_FDF_CRG_c12.mtb	3792	81	WWSS	food_sc	4	244855	1337577370	1	0.0200000000000005	0.000588235294117662	4467	1
1	Food 1	Intake 3	92	245062	1337577577	/users/cn/jespinosa/phecomp/data/CRG/20120502_FDF_CRG/20120502_FDF_CRG/20120518_FDF_CRG_c12.mtb	2904	203	WWSS	food_sc	3	244970	1337577485	1	0.04	0.000434782608695652	4468	1
1	Drink 2	Intake 2	36	245096	1337577611	/users/cn/jespinosa/phecomp/data/CRG/20120502_FDF_CRG/20120502_FDF_CRG/20120518_FDF_CRG_c12.mtb	1393	NA	WWSS	water	2	245060	1337577575	1	0.0999999999999996	0.00277777777777777	4469	1
1	Food 1	Intake 3	170	245435	1337577950	/users/cn/jespinosa/phecomp/data/CRG/20120502_FDF_CRG/20120502_FDF_CRG/20120518_FDF_CRG_c12.mtb	2905	13	WWSS	food_sc	3	245265	1337577780	1	0.02	0.000117647058823529	4470	1
1	Food 1	Intake 3	135	245583	1337578098	/users/cn/jespinosa/phecomp/data/CRG/20120502_FDF_CRG/20120502_FDF_CRG/20120518_FDF_CRG_c12.mtb	2906	28	WWSS	food_sc	3	245448	1337577963	1	0.04	0.000296296296296296	4471	1
1	Food 1	Intake 3	55	245666	1337578181	/users/cn/jespinosa/phecomp/data/CRG/20120502_FDF_CRG/20120502_FDF_CRG/20120518_FDF_CRG_c12.mtb	2907	50	WWSS	food_sc	3	245611	1337578126	1	0.02	0.000363636363636364	4472	1
1	Drink 2	Intake 2	11	245685	1337578200	/users/cn/jespinosa/phecomp/data/CRG/20120502_FDF_CRG/20120502_FDF_CRG/20120518_FDF_CRG_c12.mtb	1394	NA	WWSS	water	2	245674	1337578189	1	0.04	0.00363636363636364	4473	1
1	Food 1	Intake 3	113	245829	1337578344	/users/cn/jespinosa/phecomp/data/CRG/20120502_FDF_CRG/20120502_FDF_CRG/20120518_FDF_CRG_c12.mtb	2908	66	WWSS	food_sc	3	245716	1337578231	1	0.04	0.000353982300884956	4474	1
1	Drink 2	Intake 2	22	245882	1337578397	/users/cn/jespinosa/phecomp/data/CRG/20120502_FDF_CRG/20120502_FDF_CRG/20120518_FDF_CRG_c12.mtb	1395	NA	WWSS	water	2	245860	1337578375	1	0.0200000000000005	0.000909090909090932	4475	1
1	Food 1	Intake 3	57	245952	1337578467	/users/cn/jespinosa/phecomp/data/CRG/20120502_FDF_CRG/20120502_FDF_CRG/20120518_FDF_CRG_c12.mtb	2909	583	WWSS	food_sc	3	245895	1337578410	1	0.38	0.00666666666666667	4476	1
1	Drink 2	Intake 2	12	245958	1337578473	/users/cn/jespinosa/phecomp/data/CRG/20120502_FDF_CRG/20120502_FDF_CRG/20120518_FDF_CRG_c12.mtb	1396	NA	WWSS	water	2	245946	1337578461	1	0.04	0.00333333333333333	4477	1
1	Drink 1	Intake 1	19	246314	1337578829	/users/cn/jespinosa/phecomp/data/CRG/20120502_FDF_CRG/20120502_FDF_CRG/20120518_FDF_CRG_c12.mtb	2506	NA	WWSS	water	1	246295	1337578810	1	0.02	0.00105263157894737	4478	1
1	Food 1	Intake 3	35	246570	1337579085	/users/cn/jespinosa/phecomp/data/CRG/20120502_FDF_CRG/20120502_FDF_CRG/20120518_FDF_CRG_c12.mtb	2915	1311	WWSS	food_sc	3	246535	1337579050	1	0.0200000000000005	0.000571428571428586	4479	1
1	Drink 2	Intake 2	15	246974	1337579489	/users/cn/jespinosa/phecomp/data/CRG/20120502_FDF_CRG/20120502_FDF_CRG/20120518_FDF_CRG_c12.mtb	1398	NA	WWSS	water	2	246959	1337579474	1	0.04	0.00266666666666667	4480	1
1	Drink 2	Intake 2	18	247240	1337579755	/users/cn/jespinosa/phecomp/data/CRG/20120502_FDF_CRG/20120502_FDF_CRG/20120518_FDF_CRG_c12.mtb	1399	NA	WWSS	water	2	247222	1337579737	1	0.04	0.00222222222222222	4481	1
1	Food 2	Intake 4	125	248006	1337580521	/users/cn/jespinosa/phecomp/data/CRG/20120502_FDF_CRG/20120502_FDF_CRG/20120518_FDF_CRG_c12.mtb	3813	469	WWSS	food_sc	4	247881	1337580396	1	0.0200000000000005	0.000160000000000004	4482	1
1	Drink 1	Intake 1	36	248422	1337580937	/users/cn/jespinosa/phecomp/data/CRG/20120502_FDF_CRG/20120502_FDF_CRG/20120518_FDF_CRG_c12.mtb	2507	NA	WWSS	water	1	248386	1337580901	1	0.12	0.00333333333333333	4483	1
1	Food 1	Intake 3	236	248711	1337581226	/users/cn/jespinosa/phecomp/data/CRG/20120502_FDF_CRG/20120502_FDF_CRG/20120518_FDF_CRG_c12.mtb	2927	3564	WWSS	food_sc	3	248475	1337580990	1	0.04	0.000169491525423729	4484	1
1	Drink 1	Intake 1	83	249883	1337582398	/users/cn/jespinosa/phecomp/data/CRG/20120502_FDF_CRG/20120502_FDF_CRG/20120518_FDF_CRG_c12.mtb	2508	NA	WWSS	water	1	249800	1337582315	1	0.02	0.000240963855421687	4485	1
1	Food 2	Intake 4	76	252351	1337584866	/users/cn/jespinosa/phecomp/data/CRG/20120502_FDF_CRG/20120502_FDF_CRG/20120518_FDF_CRG_c12.mtb	3819	20976	WWSS	food_sc	4	252275	1337584790	1	0.04	0.000526315789473684	4486	1
1	Drink 1	Intake 1	91	261723	1337594238	/users/cn/jespinosa/phecomp/data/CRG/20120502_FDF_CRG/20120502_FDF_CRG/20120518_FDF_CRG_c12.mtb	2514	NA	WWSS	water	1	261632	1337594147	1	0.02	0.00021978021978022	4487	1
1	Drink 2	Intake 2	59	261851	1337594366	/users/cn/jespinosa/phecomp/data/CRG/20120502_FDF_CRG/20120502_FDF_CRG/20120518_FDF_CRG_c12.mtb	1403	NA	WWSS	water	2	261792	1337594307	1	0.04	0.000677966101694915	4488	1
1	Food 1	Intake 3	108	4006	1337605950	/users/cn/jespinosa/phecomp/data/CRG/20120502_FDF_CRG/20120502_FDF_CRG/20120521_FDF_CRG_c12.mtb	3206	80	WWSS	food_sc	3	3898	1337605842	1	0.08	0.000740740740740741	4489	1
1	Food 1	Intake 3	47	4133	1337606077	/users/cn/jespinosa/phecomp/data/CRG/20120502_FDF_CRG/20120502_FDF_CRG/20120521_FDF_CRG_c12.mtb	3207	7719	WWSS	food_sc	3	4086	1337606030	1	0.04	0.000851063829787234	4490	1
1	Food 2	Intake 4	37	11889	1337613833	/users/cn/jespinosa/phecomp/data/CRG/20120502_FDF_CRG/20120502_FDF_CRG/20120521_FDF_CRG_c12.mtb	4187	5	WWSS	food_sc	4	11852	1337613796	1	0.02	0.000540540540540541	4491	1
1	Food 2	Intake 4	155	12049	1337613993	/users/cn/jespinosa/phecomp/data/CRG/20120502_FDF_CRG/20120502_FDF_CRG/20120521_FDF_CRG_c12.mtb	4188	COLL	WWSS	food_sc	4	11894	1337613838	1	0.08	0.000516129032258065	4492	1
1	Food 1	Intake 3	174	12214	1337614158	/users/cn/jespinosa/phecomp/data/CRG/20120502_FDF_CRG/20120502_FDF_CRG/20120521_FDF_CRG_c12.mtb	3209	3748	WWSS	food_sc	3	12040	1337613984	1	0.14	0.000804597701149425	4493	1
1	Food 2	Intake 4	122	16084	1337618028	/users/cn/jespinosa/phecomp/data/CRG/20120502_FDF_CRG/20120502_FDF_CRG/20120521_FDF_CRG_c12.mtb	4190	49	WWSS	food_sc	4	15962	1337617906	1	0.1	0.000819672131147541	4494	1
1	Food 2	Intake 4	89	16222	1337618166	/users/cn/jespinosa/phecomp/data/CRG/20120502_FDF_CRG/20120502_FDF_CRG/20120521_FDF_CRG_c12.mtb	4191	15	WWSS	food_sc	4	16133	1337618077	1	0.06	0.000674157303370786	4495	1
1	Food 2	Intake 4	85	16322	1337618266	/users/cn/jespinosa/phecomp/data/CRG/20120502_FDF_CRG/20120502_FDF_CRG/20120521_FDF_CRG_c12.mtb	4192	4158	WWSS	food_sc	4	16237	1337618181	1	0.08	0.000941176470588235	4496	1
1	Drink 2	Intake 2	20	17569	1337619513	/users/cn/jespinosa/phecomp/data/CRG/20120502_FDF_CRG/20120502_FDF_CRG/20120521_FDF_CRG_c12.mtb	1476	NA	WWSS	water	2	17549	1337619493	1	0.08	0.004	4497	1
1	Food 2	Intake 4	332	20812	1337622756	/users/cn/jespinosa/phecomp/data/CRG/20120502_FDF_CRG/20120502_FDF_CRG/20120521_FDF_CRG_c12.mtb	4194	2446	WWSS	food_sc	4	20480	1337622424	1	0.12	0.00036144578313253	4498	1
1	Food 1	Intake 3	192	23450	1337625394	/users/cn/jespinosa/phecomp/data/CRG/20120502_FDF_CRG/20120502_FDF_CRG/20120521_FDF_CRG_c12.mtb	3213	77	WWSS	food_sc	3	23258	1337625202	1	0.08	0.000416666666666667	4499	1
1	Drink 2	Intake 2	20	23475	1337625419	/users/cn/jespinosa/phecomp/data/CRG/20120502_FDF_CRG/20120502_FDF_CRG/20120521_FDF_CRG_c12.mtb	1477	NA	WWSS	water	2	23455	1337625399	1	0.06	0.003	4500	1
1	Food 1	Intake 3	68	23595	1337625539	/users/cn/jespinosa/phecomp/data/CRG/20120502_FDF_CRG/20120502_FDF_CRG/20120521_FDF_CRG_c12.mtb	3214	1403	WWSS	food_sc	3	23527	1337625471	1	0.02	0.000294117647058824	4501	1
1	Drink 2	Intake 2	21	23606	1337625550	/users/cn/jespinosa/phecomp/data/CRG/20120502_FDF_CRG/20120502_FDF_CRG/20120521_FDF_CRG_c12.mtb	1478	NA	WWSS	water	2	23585	1337625529	1	0.02	0.000952380952380952	4502	1
1	Drink 2	Intake 2	13	23665	1337625609	/users/cn/jespinosa/phecomp/data/CRG/20120502_FDF_CRG/20120502_FDF_CRG/20120521_FDF_CRG_c12.mtb	1479	NA	WWSS	water	2	23652	1337625596	1	0.04	0.00307692307692308	4503	1
1	Food 1	Intake 3	229	25227	1337627171	/users/cn/jespinosa/phecomp/data/CRG/20120502_FDF_CRG/20120502_FDF_CRG/20120521_FDF_CRG_c12.mtb	3215	7	WWSS	food_sc	3	24998	1337626942	1	0.1	0.000436681222707424	4504	1
1	Food 1	Intake 3	108	25342	1337627286	/users/cn/jespinosa/phecomp/data/CRG/20120502_FDF_CRG/20120502_FDF_CRG/20120521_FDF_CRG_c12.mtb	3216	2098	WWSS	food_sc	3	25234	1337627178	1	0.04	0.00037037037037037	4505	1
1	Drink 1	Intake 1	26	25403	1337627347	/users/cn/jespinosa/phecomp/data/CRG/20120502_FDF_CRG/20120502_FDF_CRG/20120521_FDF_CRG_c12.mtb	2782	NA	WWSS	water	1	25377	1337627321	1	0.04	0.00153846153846154	4506	1
1	Food 1	Intake 3	124	27564	1337629508	/users/cn/jespinosa/phecomp/data/CRG/20120502_FDF_CRG/20120502_FDF_CRG/20120521_FDF_CRG_c12.mtb	3217	112	WWSS	food_sc	3	27440	1337629384	1	0.34	0.00274193548387097	4507	1
1	Food 1	Intake 3	207	27883	1337629827	/users/cn/jespinosa/phecomp/data/CRG/20120502_FDF_CRG/20120502_FDF_CRG/20120521_FDF_CRG_c12.mtb	3218	2089	WWSS	food_sc	3	27676	1337629620	1	0.0800000000000001	0.000386473429951691	4508	1
1	Drink 2	Intake 2	31	27916	1337629860	/users/cn/jespinosa/phecomp/data/CRG/20120502_FDF_CRG/20120502_FDF_CRG/20120521_FDF_CRG_c12.mtb	1480	NA	WWSS	water	2	27885	1337629829	1	0.1	0.0032258064516129	4509	1
1	Drink 1	Intake 1	15	28626	1337630570	/users/cn/jespinosa/phecomp/data/CRG/20120502_FDF_CRG/20120502_FDF_CRG/20120521_FDF_CRG_c12.mtb	2783	NA	WWSS	water	1	28611	1337630555	1	0.04	0.00266666666666667	4510	1
1	Food 2	Intake 4	26	29998	1337631942	/users/cn/jespinosa/phecomp/data/CRG/20120502_FDF_CRG/20120502_FDF_CRG/20120521_FDF_CRG_c12.mtb	4197	89	WWSS	food_sc	4	29972	1337631916	1	0.02	0.000769230769230769	4511	1
1	Food 1	Intake 3	95	30182	1337632126	/users/cn/jespinosa/phecomp/data/CRG/20120502_FDF_CRG/20120502_FDF_CRG/20120521_FDF_CRG_c12.mtb	3221	24	WWSS	food_sc	3	30087	1337632031	1	0.04	0.000421052631578947	4512	1
1	Food 1	Intake 3	122	30328	1337632272	/users/cn/jespinosa/phecomp/data/CRG/20120502_FDF_CRG/20120502_FDF_CRG/20120521_FDF_CRG_c12.mtb	3222	7	WWSS	food_sc	3	30206	1337632150	1	0.0600000000000001	0.000491803278688525	4513	1
1	Food 1	Intake 3	71	30406	1337632350	/users/cn/jespinosa/phecomp/data/CRG/20120502_FDF_CRG/20120502_FDF_CRG/20120521_FDF_CRG_c12.mtb	3223	129	WWSS	food_sc	3	30335	1337632279	1	0.02	0.00028169014084507	4514	1
1	Drink 1	Intake 1	16	30415	1337632359	/users/cn/jespinosa/phecomp/data/CRG/20120502_FDF_CRG/20120502_FDF_CRG/20120521_FDF_CRG_c12.mtb	2784	NA	WWSS	water	1	30399	1337632343	1	0.04	0.0025	4515	1
1	Drink 1	Intake 1	19	30496	1337632440	/users/cn/jespinosa/phecomp/data/CRG/20120502_FDF_CRG/20120502_FDF_CRG/20120521_FDF_CRG_c12.mtb	2785	NA	WWSS	water	1	30477	1337632421	1	0.02	0.00105263157894737	4516	1
1	Food 1	Intake 3	61	30596	1337632540	/users/cn/jespinosa/phecomp/data/CRG/20120502_FDF_CRG/20120502_FDF_CRG/20120521_FDF_CRG_c12.mtb	3224	133	WWSS	food_sc	3	30535	1337632479	1	0.0600000000000001	0.000983606557377051	4517	1
1	Drink 1	Intake 1	12	30702	1337632646	/users/cn/jespinosa/phecomp/data/CRG/20120502_FDF_CRG/20120502_FDF_CRG/20120521_FDF_CRG_c12.mtb	2786	NA	WWSS	water	1	30690	1337632634	1	0.02	0.00166666666666667	4518	1
1	Food 1	Intake 3	41	30770	1337632714	/users/cn/jespinosa/phecomp/data/CRG/20120502_FDF_CRG/20120502_FDF_CRG/20120521_FDF_CRG_c12.mtb	3225	3	WWSS	food_sc	3	30729	1337632673	1	0.02	0.00048780487804878	4519	1
1	Food 2	Intake 4	96	30869	1337632813	/users/cn/jespinosa/phecomp/data/CRG/20120502_FDF_CRG/20120502_FDF_CRG/20120521_FDF_CRG_c12.mtb	4199	223	WWSS	food_sc	4	30773	1337632717	1	0.02	0.000208333333333333	4520	1
1	Drink 1	Intake 1	15	30948	1337632892	/users/cn/jespinosa/phecomp/data/CRG/20120502_FDF_CRG/20120502_FDF_CRG/20120521_FDF_CRG_c12.mtb	2787	NA	WWSS	water	1	30933	1337632877	1	0.02	0.00133333333333333	4521	1
1	Food 2	Intake 4	53	31145	1337633089	/users/cn/jespinosa/phecomp/data/CRG/20120502_FDF_CRG/20120502_FDF_CRG/20120521_FDF_CRG_c12.mtb	4202	48	WWSS	food_sc	4	31092	1337633036	1	0.02	0.000377358490566038	4522	1
1	Drink 2	Intake 2	17	31174	1337633118	/users/cn/jespinosa/phecomp/data/CRG/20120502_FDF_CRG/20120502_FDF_CRG/20120521_FDF_CRG_c12.mtb	1482	NA	WWSS	water	2	31157	1337633101	1	0.02	0.00117647058823529	4523	1
1	Food 1	Intake 3	57	31250	1337633194	/users/cn/jespinosa/phecomp/data/CRG/20120502_FDF_CRG/20120502_FDF_CRG/20120521_FDF_CRG_c12.mtb	3230	536	WWSS	food_sc	3	31193	1337633137	1	0.0600000000000001	0.00105263157894737	4524	1
1	Drink 1	Intake 1	19	31694	1337633638	/users/cn/jespinosa/phecomp/data/CRG/20120502_FDF_CRG/20120502_FDF_CRG/20120521_FDF_CRG_c12.mtb	2788	NA	WWSS	water	1	31675	1337633619	1	0.06	0.00315789473684211	4525	1
1	Food 1	Intake 3	40	31826	1337633770	/users/cn/jespinosa/phecomp/data/CRG/20120502_FDF_CRG/20120502_FDF_CRG/20120521_FDF_CRG_c12.mtb	3236	12	WWSS	food_sc	3	31786	1337633730	1	0.02	0.0005	4526	1
1	Food 2	Intake 4	96	31934	1337633878	/users/cn/jespinosa/phecomp/data/CRG/20120502_FDF_CRG/20120502_FDF_CRG/20120521_FDF_CRG_c12.mtb	4208	99	WWSS	food_sc	4	31838	1337633782	1	0.02	0.000208333333333333	4527	1
1	Drink 2	Intake 2	17	31975	1337633919	/users/cn/jespinosa/phecomp/data/CRG/20120502_FDF_CRG/20120502_FDF_CRG/20120521_FDF_CRG_c12.mtb	1483	NA	WWSS	water	2	31958	1337633902	1	0.02	0.00117647058823529	4528	1
1	Food 1	Intake 3	16	32049	1337633993	/users/cn/jespinosa/phecomp/data/CRG/20120502_FDF_CRG/20120502_FDF_CRG/20120521_FDF_CRG_c12.mtb	3238	2925	WWSS	food_sc	3	32033	1337633977	1	0.02	0.00125	4529	1
1	Drink 1	Intake 1	19	32352	1337634296	/users/cn/jespinosa/phecomp/data/CRG/20120502_FDF_CRG/20120502_FDF_CRG/20120521_FDF_CRG_c12.mtb	2790	NA	WWSS	water	1	32333	1337634277	1	0.02	0.00105263157894737	4530	1
1	Food 2	Intake 4	25	34999	1337636943	/users/cn/jespinosa/phecomp/data/CRG/20120502_FDF_CRG/20120502_FDF_CRG/20120521_FDF_CRG_c12.mtb	4212	168	WWSS	food_sc	4	34974	1337636918	1	0.02	0.0008	4531	1
1	Food 1	Intake 3	89	35256	1337637200	/users/cn/jespinosa/phecomp/data/CRG/20120502_FDF_CRG/20120502_FDF_CRG/20120521_FDF_CRG_c12.mtb	3241	72	WWSS	food_sc	3	35167	1337637111	1	0.02	0.000224719101123596	4532	1
1	Food 2	Intake 4	228	35556	1337637500	/users/cn/jespinosa/phecomp/data/CRG/20120502_FDF_CRG/20120502_FDF_CRG/20120521_FDF_CRG_c12.mtb	4215	6	WWSS	food_sc	4	35328	1337637272	1	0.04	0.000175438596491228	4533	1
1	Drink 1	Intake 1	14	35562	1337637506	/users/cn/jespinosa/phecomp/data/CRG/20120502_FDF_CRG/20120502_FDF_CRG/20120521_FDF_CRG_c12.mtb	2791	NA	WWSS	water	1	35548	1337637492	1	0.02	0.00142857142857143	4534	1
1	Food 2	Intake 4	69	35631	1337637575	/users/cn/jespinosa/phecomp/data/CRG/20120502_FDF_CRG/20120502_FDF_CRG/20120521_FDF_CRG_c12.mtb	4216	125	WWSS	food_sc	4	35562	1337637506	1	0.04	0.000579710144927536	4535	1
1	Drink 1	Intake 1	35	35653	1337637597	/users/cn/jespinosa/phecomp/data/CRG/20120502_FDF_CRG/20120502_FDF_CRG/20120521_FDF_CRG_c12.mtb	2792	NA	WWSS	water	1	35618	1337637562	1	0.04	0.00114285714285714	4536	1
1	Drink 2	Intake 2	43	35737	1337637681	/users/cn/jespinosa/phecomp/data/CRG/20120502_FDF_CRG/20120502_FDF_CRG/20120521_FDF_CRG_c12.mtb	1484	NA	WWSS	water	2	35694	1337637638	1	0.04	0.000930232558139535	4537	1
1	Food 1	Intake 3	31	35787	1337637731	/users/cn/jespinosa/phecomp/data/CRG/20120502_FDF_CRG/20120502_FDF_CRG/20120521_FDF_CRG_c12.mtb	3245	COLL	WWSS	food_sc	3	35756	1337637700	1	0.02	0.000645161290322581	4538	1
1	Food 2	Intake 4	102	35876	1337637820	/users/cn/jespinosa/phecomp/data/CRG/20120502_FDF_CRG/20120502_FDF_CRG/20120521_FDF_CRG_c12.mtb	4217	794	WWSS	food_sc	4	35774	1337637718	1	0.02	0.000196078431372549	4539	1
1	Drink 1	Intake 1	17	35885	1337637829	/users/cn/jespinosa/phecomp/data/CRG/20120502_FDF_CRG/20120502_FDF_CRG/20120521_FDF_CRG_c12.mtb	2793	NA	WWSS	water	1	35868	1337637812	1	0.02	0.00117647058823529	4540	1
1	Drink 1	Intake 1	23	36028	1337637972	/users/cn/jespinosa/phecomp/data/CRG/20120502_FDF_CRG/20120502_FDF_CRG/20120521_FDF_CRG_c12.mtb	2794	NA	WWSS	water	1	36005	1337637949	1	0.04	0.00173913043478261	4541	1
1	Drink 1	Intake 1	11	36142	1337638086	/users/cn/jespinosa/phecomp/data/CRG/20120502_FDF_CRG/20120502_FDF_CRG/20120521_FDF_CRG_c12.mtb	2795	NA	WWSS	water	1	36131	1337638075	1	0.02	0.00181818181818182	4542	1
1	Drink 2	Intake 2	18	36451	1337638395	/users/cn/jespinosa/phecomp/data/CRG/20120502_FDF_CRG/20120502_FDF_CRG/20120521_FDF_CRG_c12.mtb	1486	NA	WWSS	water	2	36433	1337638377	1	0.04	0.00222222222222222	4543	1
1	Food 1	Intake 3	18	36688	1337638632	/users/cn/jespinosa/phecomp/data/CRG/20120502_FDF_CRG/20120502_FDF_CRG/20120521_FDF_CRG_c12.mtb	3252	27	WWSS	food_sc	3	36670	1337638614	1	0.02	0.00111111111111111	4544	1
1	Food 1	Intake 3	116	36831	1337638775	/users/cn/jespinosa/phecomp/data/CRG/20120502_FDF_CRG/20120502_FDF_CRG/20120521_FDF_CRG_c12.mtb	3253	23	WWSS	food_sc	3	36715	1337638659	1	0.0599999999999998	0.000517241379310343	4545	1
1	Drink 2	Intake 2	24	36847	1337638791	/users/cn/jespinosa/phecomp/data/CRG/20120502_FDF_CRG/20120502_FDF_CRG/20120521_FDF_CRG_c12.mtb	1488	NA	WWSS	water	2	36823	1337638767	1	0.06	0.0025	4546	1
1	Food 1	Intake 3	140	36994	1337638938	/users/cn/jespinosa/phecomp/data/CRG/20120502_FDF_CRG/20120502_FDF_CRG/20120521_FDF_CRG_c12.mtb	3254	257	WWSS	food_sc	3	36854	1337638798	1	0.02	0.000142857142857143	4547	1
1	Food 1	Intake 3	60	37311	1337639255	/users/cn/jespinosa/phecomp/data/CRG/20120502_FDF_CRG/20120502_FDF_CRG/20120521_FDF_CRG_c12.mtb	3256	248	WWSS	food_sc	3	37251	1337639195	1	0.02	0.000333333333333333	4548	1
1	Food 2	Intake 4	55	37614	1337639558	/users/cn/jespinosa/phecomp/data/CRG/20120502_FDF_CRG/20120502_FDF_CRG/20120521_FDF_CRG_c12.mtb	4227	542	WWSS	food_sc	4	37559	1337639503	1	0.02	0.000363636363636364	4549	1
1	Drink 1	Intake 1	17	37620	1337639564	/users/cn/jespinosa/phecomp/data/CRG/20120502_FDF_CRG/20120502_FDF_CRG/20120521_FDF_CRG_c12.mtb	2798	NA	WWSS	water	1	37603	1337639547	1	0.04	0.00235294117647059	4550	1
1	Drink 1	Intake 1	26	37845	1337639789	/users/cn/jespinosa/phecomp/data/CRG/20120502_FDF_CRG/20120502_FDF_CRG/20120521_FDF_CRG_c12.mtb	2799	NA	WWSS	water	1	37819	1337639763	1	0.02	0.000769230769230769	4551	1
1	Food 2	Intake 4	62	38218	1337640162	/users/cn/jespinosa/phecomp/data/CRG/20120502_FDF_CRG/20120502_FDF_CRG/20120521_FDF_CRG_c12.mtb	4231	70	WWSS	food_sc	4	38156	1337640100	1	0.02	0.00032258064516129	4552	1
1	Food 1	Intake 3	102	38390	1337640334	/users/cn/jespinosa/phecomp/data/CRG/20120502_FDF_CRG/20120502_FDF_CRG/20120521_FDF_CRG_c12.mtb	3259	201	WWSS	food_sc	3	38288	1337640232	1	0.02	0.000196078431372549	4553	1
1	Drink 1	Intake 1	16	38397	1337640341	/users/cn/jespinosa/phecomp/data/CRG/20120502_FDF_CRG/20120502_FDF_CRG/20120521_FDF_CRG_c12.mtb	2800	NA	WWSS	water	1	38381	1337640325	1	0.02	0.00125	4554	1
1	Food 2	Intake 4	84	38675	1337640619	/users/cn/jespinosa/phecomp/data/CRG/20120502_FDF_CRG/20120502_FDF_CRG/20120521_FDF_CRG_c12.mtb	4234	196	WWSS	food_sc	4	38591	1337640535	1	0.0600000000000001	0.000714285714285715	4555	1
1	Drink 2	Intake 2	19	38696	1337640640	/users/cn/jespinosa/phecomp/data/CRG/20120502_FDF_CRG/20120502_FDF_CRG/20120521_FDF_CRG_c12.mtb	1490	NA	WWSS	water	2	38677	1337640621	1	0.04	0.00210526315789474	4556	1
1	Food 2	Intake 4	96	38967	1337640911	/users/cn/jespinosa/phecomp/data/CRG/20120502_FDF_CRG/20120502_FDF_CRG/20120521_FDF_CRG_c12.mtb	4237	85	WWSS	food_sc	4	38871	1337640815	1	0.02	0.000208333333333333	4557	1
1	Drink 1	Intake 1	30	39010	1337640954	/users/cn/jespinosa/phecomp/data/CRG/20120502_FDF_CRG/20120502_FDF_CRG/20120521_FDF_CRG_c12.mtb	2801	NA	WWSS	water	1	38980	1337640924	1	0.0600000000000001	0.002	4558	1
1	Food 2	Intake 4	224	39276	1337641220	/users/cn/jespinosa/phecomp/data/CRG/20120502_FDF_CRG/20120502_FDF_CRG/20120521_FDF_CRG_c12.mtb	4238	40	WWSS	food_sc	4	39052	1337640996	1	0.02	8.92857142857143e-05	4559	1
1	Food 2	Intake 4	44	39360	1337641304	/users/cn/jespinosa/phecomp/data/CRG/20120502_FDF_CRG/20120502_FDF_CRG/20120521_FDF_CRG_c12.mtb	4239	26	WWSS	food_sc	4	39316	1337641260	1	0.02	0.000454545454545455	4560	1
1	Food 2	Intake 4	104	39490	1337641434	/users/cn/jespinosa/phecomp/data/CRG/20120502_FDF_CRG/20120502_FDF_CRG/20120521_FDF_CRG_c12.mtb	4240	72	WWSS	food_sc	4	39386	1337641330	1	0.02	0.000192307692307692	4561	1
1	Drink 2	Intake 2	24	39505	1337641449	/users/cn/jespinosa/phecomp/data/CRG/20120502_FDF_CRG/20120502_FDF_CRG/20120521_FDF_CRG_c12.mtb	1491	NA	WWSS	water	2	39481	1337641425	1	0.02	0.000833333333333333	4562	1
1	Food 2	Intake 4	25	39587	1337641531	/users/cn/jespinosa/phecomp/data/CRG/20120502_FDF_CRG/20120502_FDF_CRG/20120521_FDF_CRG_c12.mtb	4241	152	WWSS	food_sc	4	39562	1337641506	1	0.02	0.0008	4563	1
1	Drink 2	Intake 2	16	39740	1337641684	/users/cn/jespinosa/phecomp/data/CRG/20120502_FDF_CRG/20120502_FDF_CRG/20120521_FDF_CRG_c12.mtb	1492	NA	WWSS	water	2	39724	1337641668	1	0.0399999999999999	0.00249999999999999	4564	1
1	Food 2	Intake 4	115	39854	1337641798	/users/cn/jespinosa/phecomp/data/CRG/20120502_FDF_CRG/20120502_FDF_CRG/20120521_FDF_CRG_c12.mtb	4243	204	WWSS	food_sc	4	39739	1337641683	1	0.0399999999999999	0.000347826086956521	4565	1
1	Drink 2	Intake 2	18	39877	1337641821	/users/cn/jespinosa/phecomp/data/CRG/20120502_FDF_CRG/20120502_FDF_CRG/20120521_FDF_CRG_c12.mtb	1493	NA	WWSS	water	2	39859	1337641803	1	0.02	0.00111111111111111	4566	1
1	Drink 1	Intake 1	22	40009	1337641953	/users/cn/jespinosa/phecomp/data/CRG/20120502_FDF_CRG/20120502_FDF_CRG/20120521_FDF_CRG_c12.mtb	2803	NA	WWSS	water	1	39987	1337641931	1	0.0399999999999999	0.00181818181818181	4567	1
1	Food 2	Intake 4	155	40213	1337642157	/users/cn/jespinosa/phecomp/data/CRG/20120502_FDF_CRG/20120502_FDF_CRG/20120521_FDF_CRG_c12.mtb	4247	20	WWSS	food_sc	4	40058	1337642002	1	0.02	0.000129032258064516	4568	1
1	Food 2	Intake 4	150	40383	1337642327	/users/cn/jespinosa/phecomp/data/CRG/20120502_FDF_CRG/20120502_FDF_CRG/20120521_FDF_CRG_c12.mtb	4248	540	WWSS	food_sc	4	40233	1337642177	1	0.04	0.000266666666666667	4569	1
1	Drink 2	Intake 2	27	40713	1337642657	/users/cn/jespinosa/phecomp/data/CRG/20120502_FDF_CRG/20120502_FDF_CRG/20120521_FDF_CRG_c12.mtb	1494	NA	WWSS	water	2	40686	1337642630	1	0.04	0.00148148148148148	4570	1
1	Food 1	Intake 3	104	41027	1337642971	/users/cn/jespinosa/phecomp/data/CRG/20120502_FDF_CRG/20120502_FDF_CRG/20120521_FDF_CRG_c12.mtb	3272	1796	WWSS	food_sc	3	40923	1337642867	1	0.02	0.000192307692307692	4571	1
1	Drink 2	Intake 2	25	41077	1337643021	/users/cn/jespinosa/phecomp/data/CRG/20120502_FDF_CRG/20120502_FDF_CRG/20120521_FDF_CRG_c12.mtb	1495	NA	WWSS	water	2	41052	1337642996	1	0.0599999999999999	0.0024	4572	1
1	Drink 2	Intake 2	17	42139	1337644083	/users/cn/jespinosa/phecomp/data/CRG/20120502_FDF_CRG/20120502_FDF_CRG/20120521_FDF_CRG_c12.mtb	1496	NA	WWSS	water	2	42122	1337644066	1	0.04	0.00235294117647059	4573	1
1	Food 1	Intake 3	49	42872	1337644816	/users/cn/jespinosa/phecomp/data/CRG/20120502_FDF_CRG/20120502_FDF_CRG/20120521_FDF_CRG_c12.mtb	3277	168	WWSS	food_sc	3	42823	1337644767	1	0.02	0.000408163265306122	4574	1
1	Food 2	Intake 4	67	43107	1337645051	/users/cn/jespinosa/phecomp/data/CRG/20120502_FDF_CRG/20120502_FDF_CRG/20120521_FDF_CRG_c12.mtb	4256	4966	WWSS	food_sc	4	43040	1337644984	1	0.02	0.000298507462686567	4575	1
1	Food 1	Intake 3	42	48115	1337650059	/users/cn/jespinosa/phecomp/data/CRG/20120502_FDF_CRG/20120502_FDF_CRG/20120521_FDF_CRG_c12.mtb	3280	80	WWSS	food_sc	3	48073	1337650017	1	0.04	0.000952380952380952	4576	1
1	Food 1	Intake 3	34	48229	1337650173	/users/cn/jespinosa/phecomp/data/CRG/20120502_FDF_CRG/20120502_FDF_CRG/20120521_FDF_CRG_c12.mtb	3281	11	WWSS	food_sc	3	48195	1337650139	1	0.02	0.000588235294117647	4577	1
1	Food 1	Intake 3	52	48292	1337650236	/users/cn/jespinosa/phecomp/data/CRG/20120502_FDF_CRG/20120502_FDF_CRG/20120521_FDF_CRG_c12.mtb	3282	7	WWSS	food_sc	3	48240	1337650184	1	0.0600000000000001	0.00115384615384616	4578	1
1	Food 1	Intake 3	39	48338	1337650282	/users/cn/jespinosa/phecomp/data/CRG/20120502_FDF_CRG/20120502_FDF_CRG/20120521_FDF_CRG_c12.mtb	3283	15	WWSS	food_sc	3	48299	1337650243	1	0.04	0.00102564102564103	4579	1
1	Food 1	Intake 3	58	48411	1337650355	/users/cn/jespinosa/phecomp/data/CRG/20120502_FDF_CRG/20120502_FDF_CRG/20120521_FDF_CRG_c12.mtb	3284	379	WWSS	food_sc	3	48353	1337650297	1	0.04	0.000689655172413793	4580	1
1	Drink 1	Intake 1	17	48763	1337650707	/users/cn/jespinosa/phecomp/data/CRG/20120502_FDF_CRG/20120502_FDF_CRG/20120521_FDF_CRG_c12.mtb	2804	NA	WWSS	water	1	48746	1337650690	1	0.04	0.00235294117647059	4581	1
1	Food 1	Intake 3	141	48931	1337650875	/users/cn/jespinosa/phecomp/data/CRG/20120502_FDF_CRG/20120502_FDF_CRG/20120521_FDF_CRG_c12.mtb	3286	5077	WWSS	food_sc	3	48790	1337650734	1	0.0399999999999998	0.00028368794326241	4582	1
1	Drink 2	Intake 2	16	48948	1337650892	/users/cn/jespinosa/phecomp/data/CRG/20120502_FDF_CRG/20120502_FDF_CRG/20120521_FDF_CRG_c12.mtb	1498	NA	WWSS	water	2	48932	1337650876	1	0.02	0.00125	4583	1
1	Drink 2	Intake 2	17	50308	1337652252	/users/cn/jespinosa/phecomp/data/CRG/20120502_FDF_CRG/20120502_FDF_CRG/20120521_FDF_CRG_c12.mtb	1499	NA	WWSS	water	2	50291	1337652235	1	0.02	0.00117647058823529	4584	1
1	Food 2	Intake 4	15	54023	1337655967	/users/cn/jespinosa/phecomp/data/CRG/20120502_FDF_CRG/20120502_FDF_CRG/20120521_FDF_CRG_c12.mtb	4262	69	WWSS	food_sc	4	54008	1337655952	1	0.02	0.00133333333333333	4585	1
1	Food 2	Intake 4	65	54157	1337656101	/users/cn/jespinosa/phecomp/data/CRG/20120502_FDF_CRG/20120502_FDF_CRG/20120521_FDF_CRG_c12.mtb	4263	4930	WWSS	food_sc	4	54092	1337656036	1	0.04	0.000615384615384615	4586	1
1	Drink 1	Intake 1	31	54646	1337656590	/users/cn/jespinosa/phecomp/data/CRG/20120502_FDF_CRG/20120502_FDF_CRG/20120521_FDF_CRG_c12.mtb	2805	NA	WWSS	water	1	54615	1337656559	1	0.04	0.00129032258064516	4587	1
1	Food 2	Intake 4	20	59107	1337661051	/users/cn/jespinosa/phecomp/data/CRG/20120502_FDF_CRG/20120502_FDF_CRG/20120521_FDF_CRG_c12.mtb	4265	83	WWSS	food_sc	4	59087	1337661031	1	0.02	0.001	4588	1
1	Food 2	Intake 4	32	59222	1337661166	/users/cn/jespinosa/phecomp/data/CRG/20120502_FDF_CRG/20120502_FDF_CRG/20120521_FDF_CRG_c12.mtb	4266	1625	WWSS	food_sc	4	59190	1337661134	1	0.0599999999999998	0.00187499999999999	4589	1
1	Food 1	Intake 3	89	60936	1337662880	/users/cn/jespinosa/phecomp/data/CRG/20120502_FDF_CRG/20120502_FDF_CRG/20120521_FDF_CRG_c12.mtb	3287	43	WWSS	food_sc	3	60847	1337662791	1	0.02	0.000224719101123596	4590	1
1	Drink 1	Intake 1	17	60947	1337662891	/users/cn/jespinosa/phecomp/data/CRG/20120502_FDF_CRG/20120502_FDF_CRG/20120521_FDF_CRG_c12.mtb	2806	NA	WWSS	water	1	60930	1337662874	1	0.0599999999999999	0.00352941176470588	4591	1
1	Food 1	Intake 3	233	61212	1337663156	/users/cn/jespinosa/phecomp/data/CRG/20120502_FDF_CRG/20120502_FDF_CRG/20120521_FDF_CRG_c12.mtb	3288	152	WWSS	food_sc	3	60979	1337662923	1	0.0999999999999999	0.000429184549356223	4592	1
1	Drink 2	Intake 2	20	61366	1337663310	/users/cn/jespinosa/phecomp/data/CRG/20120502_FDF_CRG/20120502_FDF_CRG/20120521_FDF_CRG_c12.mtb	1501	NA	WWSS	water	2	61346	1337663290	1	0.02	0.001	4593	1
1	Food 1	Intake 3	57	61421	1337663365	/users/cn/jespinosa/phecomp/data/CRG/20120502_FDF_CRG/20120502_FDF_CRG/20120521_FDF_CRG_c12.mtb	3289	185	WWSS	food_sc	3	61364	1337663308	1	0.02	0.000350877192982456	4594	1
1	Drink 1	Intake 1	21	61431	1337663375	/users/cn/jespinosa/phecomp/data/CRG/20120502_FDF_CRG/20120502_FDF_CRG/20120521_FDF_CRG_c12.mtb	2807	NA	WWSS	water	1	61410	1337663354	1	0.04	0.0019047619047619	4595	1
1	Food 1	Intake 3	27	61633	1337663577	/users/cn/jespinosa/phecomp/data/CRG/20120502_FDF_CRG/20120502_FDF_CRG/20120521_FDF_CRG_c12.mtb	3291	66	WWSS	food_sc	3	61606	1337663550	1	0.04	0.00148148148148148	4596	1
1	Drink 2	Intake 2	21	61685	1337663629	/users/cn/jespinosa/phecomp/data/CRG/20120502_FDF_CRG/20120502_FDF_CRG/20120521_FDF_CRG_c12.mtb	1502	NA	WWSS	water	2	61664	1337663608	1	0.0599999999999999	0.00285714285714285	4597	1
1	Food 1	Intake 3	16	61715	1337663659	/users/cn/jespinosa/phecomp/data/CRG/20120502_FDF_CRG/20120502_FDF_CRG/20120521_FDF_CRG_c12.mtb	3292	85	WWSS	food_sc	3	61699	1337663643	1	0.02	0.00125	4598	1
1	Drink 1	Intake 1	22	61792	1337663736	/users/cn/jespinosa/phecomp/data/CRG/20120502_FDF_CRG/20120502_FDF_CRG/20120521_FDF_CRG_c12.mtb	2808	NA	WWSS	water	1	61770	1337663714	1	0.04	0.00181818181818182	4599	1
1	Food 2	Intake 4	202	62002	1337663946	/users/cn/jespinosa/phecomp/data/CRG/20120502_FDF_CRG/20120502_FDF_CRG/20120521_FDF_CRG_c12.mtb	4270	38	WWSS	food_sc	4	61800	1337663744	1	0.02	9.9009900990099e-05	4600	1
1	Food 2	Intake 4	95	62135	1337664079	/users/cn/jespinosa/phecomp/data/CRG/20120502_FDF_CRG/20120502_FDF_CRG/20120521_FDF_CRG_c12.mtb	4271	COLL	WWSS	food_sc	4	62040	1337663984	1	0.02	0.000210526315789474	4601	1
1	Food 1	Intake 3	23	62069	1337664013	/users/cn/jespinosa/phecomp/data/CRG/20120502_FDF_CRG/20120502_FDF_CRG/20120521_FDF_CRG_c12.mtb	3295	145	WWSS	food_sc	3	62046	1337663990	1	0.02	0.000869565217391304	4602	1
1	Drink 1	Intake 1	16	62173	1337664117	/users/cn/jespinosa/phecomp/data/CRG/20120502_FDF_CRG/20120502_FDF_CRG/20120521_FDF_CRG_c12.mtb	2809	NA	WWSS	water	1	62157	1337664101	1	0.0599999999999999	0.00374999999999999	4603	1
1	Food 2	Intake 4	80	62294	1337664238	/users/cn/jespinosa/phecomp/data/CRG/20120502_FDF_CRG/20120502_FDF_CRG/20120521_FDF_CRG_c12.mtb	4274	83	WWSS	food_sc	4	62214	1337664158	1	0.02	0.00025	4604	1
1	Drink 1	Intake 1	38	62328	1337664272	/users/cn/jespinosa/phecomp/data/CRG/20120502_FDF_CRG/20120502_FDF_CRG/20120521_FDF_CRG_c12.mtb	2810	NA	WWSS	water	1	62290	1337664234	1	0.12	0.00315789473684211	4605	1
1	Food 2	Intake 4	68	62445	1337664389	/users/cn/jespinosa/phecomp/data/CRG/20120502_FDF_CRG/20120502_FDF_CRG/20120521_FDF_CRG_c12.mtb	4275	COLL	WWSS	food_sc	4	62377	1337664321	1	0.02	0.000294117647058824	4606	1
1	Food 1	Intake 3	84	62517	1337664461	/users/cn/jespinosa/phecomp/data/CRG/20120502_FDF_CRG/20120502_FDF_CRG/20120521_FDF_CRG_c12.mtb	3298	191	WWSS	food_sc	3	62433	1337664377	1	0.02	0.000238095238095238	4607	1
1	Drink 2	Intake 2	14	62530	1337664474	/users/cn/jespinosa/phecomp/data/CRG/20120502_FDF_CRG/20120502_FDF_CRG/20120521_FDF_CRG_c12.mtb	1503	NA	WWSS	water	2	62516	1337664460	1	0.02	0.00142857142857143	4608	1
1	Food 1	Intake 3	105	62813	1337664757	/users/cn/jespinosa/phecomp/data/CRG/20120502_FDF_CRG/20120502_FDF_CRG/20120521_FDF_CRG_c12.mtb	3299	11	WWSS	food_sc	3	62708	1337664652	1	0.02	0.00019047619047619	4609	1
1	Food 1	Intake 3	81	62905	1337664849	/users/cn/jespinosa/phecomp/data/CRG/20120502_FDF_CRG/20120502_FDF_CRG/20120521_FDF_CRG_c12.mtb	3300	132	WWSS	food_sc	3	62824	1337664768	1	0.02	0.000246913580246914	4610	1
1	Food 2	Intake 4	144	63181	1337665125	/users/cn/jespinosa/phecomp/data/CRG/20120502_FDF_CRG/20120502_FDF_CRG/20120521_FDF_CRG_c12.mtb	4277	9	WWSS	food_sc	4	63037	1337664981	1	0.02	0.000138888888888889	4611	1
1	Food 2	Intake 4	163	63353	1337665297	/users/cn/jespinosa/phecomp/data/CRG/20120502_FDF_CRG/20120502_FDF_CRG/20120521_FDF_CRG_c12.mtb	4278	338	WWSS	food_sc	4	63190	1337665134	1	0.04	0.000245398773006135	4612	1
1	Drink 2	Intake 2	23	63373	1337665317	/users/cn/jespinosa/phecomp/data/CRG/20120502_FDF_CRG/20120502_FDF_CRG/20120521_FDF_CRG_c12.mtb	1504	NA	WWSS	water	2	63350	1337665294	1	0.1	0.00434782608695652	4613	1
1	Food 2	Intake 4	68	63759	1337665703	/users/cn/jespinosa/phecomp/data/CRG/20120502_FDF_CRG/20120502_FDF_CRG/20120521_FDF_CRG_c12.mtb	4281	548	WWSS	food_sc	4	63691	1337665635	1	0.02	0.000294117647058824	4614	1
1	Drink 2	Intake 2	24	63779	1337665723	/users/cn/jespinosa/phecomp/data/CRG/20120502_FDF_CRG/20120502_FDF_CRG/20120521_FDF_CRG_c12.mtb	1505	NA	WWSS	water	2	63755	1337665699	1	0.0600000000000001	0.0025	4615	1
1	Food 1	Intake 3	91	64398	1337666342	/users/cn/jespinosa/phecomp/data/CRG/20120502_FDF_CRG/20120502_FDF_CRG/20120521_FDF_CRG_c12.mtb	3303	6	WWSS	food_sc	3	64307	1337666251	1	0.02	0.00021978021978022	4616	1
1	Food 1	Intake 3	126	64530	1337666474	/users/cn/jespinosa/phecomp/data/CRG/20120502_FDF_CRG/20120502_FDF_CRG/20120521_FDF_CRG_c12.mtb	3304	787	WWSS	food_sc	3	64404	1337666348	1	0.04	0.000317460317460317	4617	1
1	Drink 2	Intake 2	18	64814	1337666758	/users/cn/jespinosa/phecomp/data/CRG/20120502_FDF_CRG/20120502_FDF_CRG/20120521_FDF_CRG_c12.mtb	1506	NA	WWSS	water	2	64796	1337666740	1	0.04	0.00222222222222222	4618	1
1	Food 1	Intake 3	107	65424	1337667368	/users/cn/jespinosa/phecomp/data/CRG/20120502_FDF_CRG/20120502_FDF_CRG/20120521_FDF_CRG_c12.mtb	3311	343	WWSS	food_sc	3	65317	1337667261	1	0.04	0.000373831775700935	4619	1
1	Drink 1	Intake 1	17	65436	1337667380	/users/cn/jespinosa/phecomp/data/CRG/20120502_FDF_CRG/20120502_FDF_CRG/20120521_FDF_CRG_c12.mtb	2811	NA	WWSS	water	1	65419	1337667363	1	0.04	0.00235294117647059	4620	1
1	Drink 2	Intake 2	18	65602	1337667546	/users/cn/jespinosa/phecomp/data/CRG/20120502_FDF_CRG/20120502_FDF_CRG/20120521_FDF_CRG_c12.mtb	1507	NA	WWSS	water	2	65584	1337667528	1	0.02	0.00111111111111111	4621	1
1	Food 2	Intake 4	31	65798	1337667742	/users/cn/jespinosa/phecomp/data/CRG/20120502_FDF_CRG/20120502_FDF_CRG/20120521_FDF_CRG_c12.mtb	4296	67	WWSS	food_sc	4	65767	1337667711	1	0.02	0.000645161290322581	4622	1
1	Food 2	Intake 4	128	65993	1337667937	/users/cn/jespinosa/phecomp/data/CRG/20120502_FDF_CRG/20120502_FDF_CRG/20120521_FDF_CRG_c12.mtb	4297	COLL	WWSS	food_sc	4	65865	1337667809	1	0.04	0.0003125	4623	1
1	Food 1	Intake 3	36	66018	1337667962	/users/cn/jespinosa/phecomp/data/CRG/20120502_FDF_CRG/20120502_FDF_CRG/20120521_FDF_CRG_c12.mtb	3317	724	WWSS	food_sc	3	65982	1337667926	1	0.02	0.000555555555555556	4624	1
1	Drink 2	Intake 2	32	66137	1337668081	/users/cn/jespinosa/phecomp/data/CRG/20120502_FDF_CRG/20120502_FDF_CRG/20120521_FDF_CRG_c12.mtb	1508	NA	WWSS	water	2	66105	1337668049	1	0.0999999999999999	0.003125	4625	1
1	Food 2	Intake 4	18	66760	1337668704	/users/cn/jespinosa/phecomp/data/CRG/20120502_FDF_CRG/20120502_FDF_CRG/20120521_FDF_CRG_c12.mtb	4299	3994	WWSS	food_sc	4	66742	1337668686	1	0.02	0.00111111111111111	4626	1
1	Drink 1	Intake 1	17	66812	1337668756	/users/cn/jespinosa/phecomp/data/CRG/20120502_FDF_CRG/20120502_FDF_CRG/20120521_FDF_CRG_c12.mtb	2812	NA	WWSS	water	1	66795	1337668739	1	0.02	0.00117647058823529	4627	1
1	Food 2	Intake 4	77	70831	1337672775	/users/cn/jespinosa/phecomp/data/CRG/20120502_FDF_CRG/20120502_FDF_CRG/20120521_FDF_CRG_c12.mtb	4300	9	WWSS	food_sc	4	70754	1337672698	1	0.04	0.000519480519480519	4628	1
1	Food 2	Intake 4	36	70876	1337672820	/users/cn/jespinosa/phecomp/data/CRG/20120502_FDF_CRG/20120502_FDF_CRG/20120521_FDF_CRG_c12.mtb	4301	3130	WWSS	food_sc	4	70840	1337672784	1	0.04	0.00111111111111111	4629	1
1	Food 1	Intake 3	40	74046	1337675990	/users/cn/jespinosa/phecomp/data/CRG/20120502_FDF_CRG/20120502_FDF_CRG/20120521_FDF_CRG_c12.mtb	3319	47	WWSS	food_sc	3	74006	1337675950	1	0.02	0.0005	4630	1
1	Food 1	Intake 3	37	74130	1337676074	/users/cn/jespinosa/phecomp/data/CRG/20120502_FDF_CRG/20120502_FDF_CRG/20120521_FDF_CRG_c12.mtb	3320	194	WWSS	food_sc	3	74093	1337676037	1	0.02	0.000540540540540541	4631	1
1	Food 1	Intake 3	131	74455	1337676399	/users/cn/jespinosa/phecomp/data/CRG/20120502_FDF_CRG/20120502_FDF_CRG/20120521_FDF_CRG_c12.mtb	3321	19	WWSS	food_sc	3	74324	1337676268	1	0.0600000000000001	0.000458015267175573	4632	1
1	Food 1	Intake 3	39	74513	1337676457	/users/cn/jespinosa/phecomp/data/CRG/20120502_FDF_CRG/20120502_FDF_CRG/20120521_FDF_CRG_c12.mtb	3322	7556	WWSS	food_sc	3	74474	1337676418	1	0.0399999999999996	0.00102564102564102	4633	1
1	Drink 2	Intake 2	37	74752	1337676696	/users/cn/jespinosa/phecomp/data/CRG/20120502_FDF_CRG/20120502_FDF_CRG/20120521_FDF_CRG_c12.mtb	1509	NA	WWSS	water	2	74715	1337676659	1	0.12	0.00324324324324324	4634	1
1	Food 2	Intake 4	49	82118	1337684062	/users/cn/jespinosa/phecomp/data/CRG/20120502_FDF_CRG/20120502_FDF_CRG/20120521_FDF_CRG_c12.mtb	4304	11310	WWSS	food_sc	4	82069	1337684013	1	0.04	0.000816326530612245	4635	1
1	Food 1	Intake 3	141	93569	1337695513	/users/cn/jespinosa/phecomp/data/CRG/20120502_FDF_CRG/20120502_FDF_CRG/20120521_FDF_CRG_c12.mtb	3326	37	WWSS	food_sc	3	93428	1337695372	1	0.0800000000000001	0.000567375886524823	4636	1
1	Food 2	Intake 4	52	93658	1337695602	/users/cn/jespinosa/phecomp/data/CRG/20120502_FDF_CRG/20120502_FDF_CRG/20120521_FDF_CRG_c12.mtb	4306	126	WWSS	food_sc	4	93606	1337695550	1	0.02	0.000384615384615385	4637	1
1	Food 2	Intake 4	22	93806	1337695750	/users/cn/jespinosa/phecomp/data/CRG/20120502_FDF_CRG/20120502_FDF_CRG/20120521_FDF_CRG_c12.mtb	4307	8071	WWSS	food_sc	4	93784	1337695728	1	0.02	0.000909090909090909	4638	1
1	Food 1	Intake 3	52	101929	1337703873	/users/cn/jespinosa/phecomp/data/CRG/20120502_FDF_CRG/20120502_FDF_CRG/20120521_FDF_CRG_c12.mtb	3327	12	WWSS	food_sc	3	101877	1337703821	1	0.04	0.000769230769230769	4639	1
1	Food 1	Intake 3	41	101982	1337703926	/users/cn/jespinosa/phecomp/data/CRG/20120502_FDF_CRG/20120502_FDF_CRG/20120521_FDF_CRG_c12.mtb	3328	262	WWSS	food_sc	3	101941	1337703885	1	0.02	0.00048780487804878	4640	1
1	Food 2	Intake 4	31	102275	1337704219	/users/cn/jespinosa/phecomp/data/CRG/20120502_FDF_CRG/20120502_FDF_CRG/20120521_FDF_CRG_c12.mtb	4309	3103	WWSS	food_sc	4	102244	1337704188	1	0.02	0.000645161290322581	4641	1
1	Food 1	Intake 3	227	105605	1337707549	/users/cn/jespinosa/phecomp/data/CRG/20120502_FDF_CRG/20120502_FDF_CRG/20120521_FDF_CRG_c12.mtb	3329	2461	WWSS	food_sc	3	105378	1337707322	1	0.0800000000000001	0.000352422907488987	4642	1
1	Food 1	Intake 3	155	108221	1337710165	/users/cn/jespinosa/phecomp/data/CRG/20120502_FDF_CRG/20120502_FDF_CRG/20120521_FDF_CRG_c12.mtb	3331	32	WWSS	food_sc	3	108066	1337710010	1	0.04	0.000258064516129032	4643	1
1	Food 1	Intake 3	36	108289	1337710233	/users/cn/jespinosa/phecomp/data/CRG/20120502_FDF_CRG/20120502_FDF_CRG/20120521_FDF_CRG_c12.mtb	3332	1227	WWSS	food_sc	3	108253	1337710197	1	0.02	0.000555555555555556	4644	1
1	Food 1	Intake 3	339	109855	1337711799	/users/cn/jespinosa/phecomp/data/CRG/20120502_FDF_CRG/20120502_FDF_CRG/20120521_FDF_CRG_c12.mtb	3333	4	WWSS	food_sc	3	109516	1337711460	1	0.12	0.000353982300884956	4645	1
1	Food 1	Intake 3	104	109963	1337711907	/users/cn/jespinosa/phecomp/data/CRG/20120502_FDF_CRG/20120502_FDF_CRG/20120521_FDF_CRG_c12.mtb	3334	350	WWSS	food_sc	3	109859	1337711803	1	0.04	0.000384615384615385	4646	1
1	Drink 2	Intake 2	34	109996	1337711940	/users/cn/jespinosa/phecomp/data/CRG/20120502_FDF_CRG/20120502_FDF_CRG/20120521_FDF_CRG_c12.mtb	1512	NA	WWSS	water	2	109962	1337711906	1	0.0999999999999999	0.00294117647058823	4647	1
1	Drink 2	Intake 2	25	110318	1337712262	/users/cn/jespinosa/phecomp/data/CRG/20120502_FDF_CRG/20120502_FDF_CRG/20120521_FDF_CRG_c12.mtb	1513	NA	WWSS	water	2	110293	1337712237	1	0.04	0.0016	4648	1
1	Food 2	Intake 4	91	110404	1337712348	/users/cn/jespinosa/phecomp/data/CRG/20120502_FDF_CRG/20120502_FDF_CRG/20120521_FDF_CRG_c12.mtb	4313	135	WWSS	food_sc	4	110313	1337712257	1	0.02	0.00021978021978022	4649	1
1	Food 2	Intake 4	107	110646	1337712590	/users/cn/jespinosa/phecomp/data/CRG/20120502_FDF_CRG/20120502_FDF_CRG/20120521_FDF_CRG_c12.mtb	4315	336	WWSS	food_sc	4	110539	1337712483	1	0.04	0.000373831775700935	4650	1
1	Drink 2	Intake 2	15	110638	1337712582	/users/cn/jespinosa/phecomp/data/CRG/20120502_FDF_CRG/20120502_FDF_CRG/20120521_FDF_CRG_c12.mtb	1514	NA	WWSS	water	2	110623	1337712567	1	0.02	0.00133333333333333	4651	1
1	Drink 1	Intake 1	20	110746	1337712690	/users/cn/jespinosa/phecomp/data/CRG/20120502_FDF_CRG/20120502_FDF_CRG/20120521_FDF_CRG_c12.mtb	2813	NA	WWSS	water	1	110726	1337712670	1	0.04	0.002	4652	1
1	Drink 1	Intake 1	27	110859	1337712803	/users/cn/jespinosa/phecomp/data/CRG/20120502_FDF_CRG/20120502_FDF_CRG/20120521_FDF_CRG_c12.mtb	2814	NA	WWSS	water	1	110832	1337712776	1	0.04	0.00148148148148148	4653	1
1	Food 2	Intake 4	66	111048	1337712992	/users/cn/jespinosa/phecomp/data/CRG/20120502_FDF_CRG/20120502_FDF_CRG/20120521_FDF_CRG_c12.mtb	4319	69	WWSS	food_sc	4	110982	1337712926	1	0.02	0.000303030303030303	4654	1
1	Drink 1	Intake 1	15	111058	1337713002	/users/cn/jespinosa/phecomp/data/CRG/20120502_FDF_CRG/20120502_FDF_CRG/20120521_FDF_CRG_c12.mtb	2815	NA	WWSS	water	1	111043	1337712987	1	0.0399999999999998	0.00266666666666665	4655	1
1	Drink 2	Intake 2	9	111064	1337713008	/users/cn/jespinosa/phecomp/data/CRG/20120502_FDF_CRG/20120502_FDF_CRG/20120521_FDF_CRG_c12.mtb	1515	NA	WWSS	water	2	111055	1337712999	1	0.02	0.00222222222222222	4656	1
1	Food 2	Intake 4	76	111193	1337713137	/users/cn/jespinosa/phecomp/data/CRG/20120502_FDF_CRG/20120502_FDF_CRG/20120521_FDF_CRG_c12.mtb	4320	331	WWSS	food_sc	4	111117	1337713061	1	0.02	0.000263157894736842	4657	1
1	Drink 2	Intake 2	21	111210	1337713154	/users/cn/jespinosa/phecomp/data/CRG/20120502_FDF_CRG/20120502_FDF_CRG/20120521_FDF_CRG_c12.mtb	1516	NA	WWSS	water	2	111189	1337713133	1	0.02	0.000952380952380952	4658	1
1	Drink 1	Intake 1	64	111426	1337713370	/users/cn/jespinosa/phecomp/data/CRG/20120502_FDF_CRG/20120502_FDF_CRG/20120521_FDF_CRG_c12.mtb	2816	NA	WWSS	water	1	111362	1337713306	1	0.02	0.0003125	4659	1
1	Drink 1	Intake 1	17	111498	1337713442	/users/cn/jespinosa/phecomp/data/CRG/20120502_FDF_CRG/20120502_FDF_CRG/20120521_FDF_CRG_c12.mtb	2817	NA	WWSS	water	1	111481	1337713425	1	0.02	0.00117647058823529	4660	1
1	Food 1	Intake 3	78	111602	1337713546	/users/cn/jespinosa/phecomp/data/CRG/20120502_FDF_CRG/20120502_FDF_CRG/20120521_FDF_CRG_c12.mtb	3341	2005	WWSS	food_sc	3	111524	1337713468	1	0.0200000000000005	0.000256410256410263	4661	1
1	Drink 2	Intake 2	19	111816	1337713760	/users/cn/jespinosa/phecomp/data/CRG/20120502_FDF_CRG/20120502_FDF_CRG/20120521_FDF_CRG_c12.mtb	1517	NA	WWSS	water	2	111797	1337713741	1	0.04	0.00210526315789474	4662	1
1	Food 1	Intake 3	49	113656	1337715600	/users/cn/jespinosa/phecomp/data/CRG/20120502_FDF_CRG/20120502_FDF_CRG/20120521_FDF_CRG_c12.mtb	3342	8	WWSS	food_sc	3	113607	1337715551	1	0.04	0.000816326530612245	4663	1
1	Food 1	Intake 3	129	113793	1337715737	/users/cn/jespinosa/phecomp/data/CRG/20120502_FDF_CRG/20120502_FDF_CRG/20120521_FDF_CRG_c12.mtb	3343	1867	WWSS	food_sc	3	113664	1337715608	1	0.0399999999999996	0.000310077519379842	4664	1
1	Food 2	Intake 4	20	115680	1337717624	/users/cn/jespinosa/phecomp/data/CRG/20120502_FDF_CRG/20120502_FDF_CRG/20120521_FDF_CRG_c12.mtb	4323	56	WWSS	food_sc	4	115660	1337717604	1	0.02	0.001	4665	1
1	Food 2	Intake 4	117	115853	1337717797	/users/cn/jespinosa/phecomp/data/CRG/20120502_FDF_CRG/20120502_FDF_CRG/20120521_FDF_CRG_c12.mtb	4325	42	WWSS	food_sc	4	115736	1337717680	1	0.04	0.000341880341880342	4666	1
1	Food 1	Intake 3	70	115965	1337717909	/users/cn/jespinosa/phecomp/data/CRG/20120502_FDF_CRG/20120502_FDF_CRG/20120521_FDF_CRG_c12.mtb	3345	1533	WWSS	food_sc	3	115895	1337717839	1	0.02	0.000285714285714286	4667	1
1	Drink 1	Intake 1	38	115993	1337717937	/users/cn/jespinosa/phecomp/data/CRG/20120502_FDF_CRG/20120502_FDF_CRG/20120521_FDF_CRG_c12.mtb	2818	NA	WWSS	water	1	115955	1337717899	1	0.0600000000000001	0.00157894736842106	4668	1
1	Food 2	Intake 4	289	117787	1337719731	/users/cn/jespinosa/phecomp/data/CRG/20120502_FDF_CRG/20120502_FDF_CRG/20120521_FDF_CRG_c12.mtb	4328	4	WWSS	food_sc	4	117498	1337719442	1	0.1	0.000346020761245675	4669	1
1	Food 2	Intake 4	151	117942	1337719886	/users/cn/jespinosa/phecomp/data/CRG/20120502_FDF_CRG/20120502_FDF_CRG/20120521_FDF_CRG_c12.mtb	4329	168	WWSS	food_sc	4	117791	1337719735	1	0.0800000000000001	0.000529801324503312	4670	1
1	Drink 1	Intake 1	20	117965	1337719909	/users/cn/jespinosa/phecomp/data/CRG/20120502_FDF_CRG/20120502_FDF_CRG/20120521_FDF_CRG_c12.mtb	2819	NA	WWSS	water	1	117945	1337719889	1	0.0800000000000001	0.00400000000000001	4671	1
1	Food 2	Intake 4	33	118143	1337720087	/users/cn/jespinosa/phecomp/data/CRG/20120502_FDF_CRG/20120502_FDF_CRG/20120521_FDF_CRG_c12.mtb	4331	6	WWSS	food_sc	4	118110	1337720054	1	0.02	0.000606060606060606	4672	1
1	Food 2	Intake 4	124	118273	1337720217	/users/cn/jespinosa/phecomp/data/CRG/20120502_FDF_CRG/20120502_FDF_CRG/20120521_FDF_CRG_c12.mtb	4332	8	WWSS	food_sc	4	118149	1337720093	1	0.04	0.00032258064516129	4673	1
1	Food 2	Intake 4	32	118313	1337720257	/users/cn/jespinosa/phecomp/data/CRG/20120502_FDF_CRG/20120502_FDF_CRG/20120521_FDF_CRG_c12.mtb	4333	48	WWSS	food_sc	4	118281	1337720225	1	0.02	0.000625	4674	1
1	Drink 1	Intake 1	25	118330	1337720274	/users/cn/jespinosa/phecomp/data/CRG/20120502_FDF_CRG/20120502_FDF_CRG/20120521_FDF_CRG_c12.mtb	2820	NA	WWSS	water	1	118305	1337720249	1	0.0799999999999998	0.00319999999999999	4675	1
1	Food 2	Intake 4	108	118469	1337720413	/users/cn/jespinosa/phecomp/data/CRG/20120502_FDF_CRG/20120502_FDF_CRG/20120521_FDF_CRG_c12.mtb	4334	220	WWSS	food_sc	4	118361	1337720305	1	0.02	0.000185185185185185	4676	1
1	Drink 2	Intake 2	14	118603	1337720547	/users/cn/jespinosa/phecomp/data/CRG/20120502_FDF_CRG/20120502_FDF_CRG/20120521_FDF_CRG_c12.mtb	1519	NA	WWSS	water	2	118589	1337720533	1	0.02	0.00142857142857143	4677	1
1	Food 2	Intake 4	91	118780	1337720724	/users/cn/jespinosa/phecomp/data/CRG/20120502_FDF_CRG/20120502_FDF_CRG/20120521_FDF_CRG_c12.mtb	4337	30	WWSS	food_sc	4	118689	1337720633	1	0.02	0.00021978021978022	4678	1
1	Drink 1	Intake 1	16	118785	1337720729	/users/cn/jespinosa/phecomp/data/CRG/20120502_FDF_CRG/20120502_FDF_CRG/20120521_FDF_CRG_c12.mtb	2823	NA	WWSS	water	1	118769	1337720713	1	0.02	0.00125	4679	1
1	Drink 1	Intake 1	19	118810	1337720754	/users/cn/jespinosa/phecomp/data/CRG/20120502_FDF_CRG/20120502_FDF_CRG/20120521_FDF_CRG_c12.mtb	2824	NA	WWSS	water	1	118791	1337720735	1	0.02	0.00105263157894737	4680	1
1	Food 2	Intake 4	17	118827	1337720771	/users/cn/jespinosa/phecomp/data/CRG/20120502_FDF_CRG/20120502_FDF_CRG/20120521_FDF_CRG_c12.mtb	4338	9	WWSS	food_sc	4	118810	1337720754	1	0.02	0.00117647058823529	4681	1
1	Food 2	Intake 4	99	118935	1337720879	/users/cn/jespinosa/phecomp/data/CRG/20120502_FDF_CRG/20120502_FDF_CRG/20120521_FDF_CRG_c12.mtb	4339	110	WWSS	food_sc	4	118836	1337720780	1	0.02	0.000202020202020202	4682	1
1	Drink 1	Intake 1	31	118964	1337720908	/users/cn/jespinosa/phecomp/data/CRG/20120502_FDF_CRG/20120502_FDF_CRG/20120521_FDF_CRG_c12.mtb	2825	NA	WWSS	water	1	118933	1337720877	1	0.0800000000000001	0.00258064516129033	4683	1
1	Food 2	Intake 4	70	119115	1337721059	/users/cn/jespinosa/phecomp/data/CRG/20120502_FDF_CRG/20120502_FDF_CRG/20120521_FDF_CRG_c12.mtb	4340	128	WWSS	food_sc	4	119045	1337720989	1	0.0800000000000001	0.00114285714285714	4684	1
1	Food 2	Intake 4	102	119345	1337721289	/users/cn/jespinosa/phecomp/data/CRG/20120502_FDF_CRG/20120502_FDF_CRG/20120521_FDF_CRG_c12.mtb	4342	672	WWSS	food_sc	4	119243	1337721187	1	0.04	0.000392156862745098	4685	1
1	Drink 1	Intake 1	8	119358	1337721302	/users/cn/jespinosa/phecomp/data/CRG/20120502_FDF_CRG/20120502_FDF_CRG/20120521_FDF_CRG_c12.mtb	2826	NA	WWSS	water	1	119350	1337721294	1	0.02	0.0025	4686	1
1	Food 2	Intake 4	131	120148	1337722092	/users/cn/jespinosa/phecomp/data/CRG/20120502_FDF_CRG/20120502_FDF_CRG/20120521_FDF_CRG_c12.mtb	4345	74	WWSS	food_sc	4	120017	1337721961	1	0.04	0.000305343511450382	4687	1
1	Drink 1	Intake 1	17	120157	1337722101	/users/cn/jespinosa/phecomp/data/CRG/20120502_FDF_CRG/20120502_FDF_CRG/20120521_FDF_CRG_c12.mtb	2828	NA	WWSS	water	1	120140	1337722084	1	0.02	0.00117647058823529	4688	1
1	Food 2	Intake 4	108	120330	1337722274	/users/cn/jespinosa/phecomp/data/CRG/20120502_FDF_CRG/20120502_FDF_CRG/20120521_FDF_CRG_c12.mtb	4346	2982	WWSS	food_sc	4	120222	1337722166	1	0.0600000000000001	0.000555555555555557	4689	1
1	Drink 1	Intake 1	40	120360	1337722304	/users/cn/jespinosa/phecomp/data/CRG/20120502_FDF_CRG/20120502_FDF_CRG/20120521_FDF_CRG_c12.mtb	2829	NA	WWSS	water	1	120320	1337722264	1	0.1	0.0025	4690	1
1	Food 2	Intake 4	9	123321	1337725265	/users/cn/jespinosa/phecomp/data/CRG/20120502_FDF_CRG/20120502_FDF_CRG/20120521_FDF_CRG_c12.mtb	4348	82	WWSS	food_sc	4	123312	1337725256	1	0.04	0.00444444444444444	4691	1
1	Food 2	Intake 4	116	123519	1337725463	/users/cn/jespinosa/phecomp/data/CRG/20120502_FDF_CRG/20120502_FDF_CRG/20120521_FDF_CRG_c12.mtb	4350	138	WWSS	food_sc	4	123403	1337725347	1	0.0600000000000001	0.000517241379310346	4692	1
1	Food 2	Intake 4	70	123727	1337725671	/users/cn/jespinosa/phecomp/data/CRG/20120502_FDF_CRG/20120502_FDF_CRG/20120521_FDF_CRG_c12.mtb	4353	152	WWSS	food_sc	4	123657	1337725601	1	0.02	0.000285714285714286	4693	1
1	Food 2	Intake 4	80	123959	1337725903	/users/cn/jespinosa/phecomp/data/CRG/20120502_FDF_CRG/20120502_FDF_CRG/20120521_FDF_CRG_c12.mtb	4355	57	WWSS	food_sc	4	123879	1337725823	1	0.04	0.0005	4694	1
1	Food 2	Intake 4	81	124097	1337726041	/users/cn/jespinosa/phecomp/data/CRG/20120502_FDF_CRG/20120502_FDF_CRG/20120521_FDF_CRG_c12.mtb	4356	404	WWSS	food_sc	4	124016	1337725960	1	0.02	0.000246913580246914	4695	1
1	Drink 1	Intake 1	18	124104	1337726048	/users/cn/jespinosa/phecomp/data/CRG/20120502_FDF_CRG/20120502_FDF_CRG/20120521_FDF_CRG_c12.mtb	2830	NA	WWSS	water	1	124086	1337726030	1	0.0399999999999998	0.00222222222222221	4696	1
1	Food 2	Intake 4	23	124524	1337726468	/users/cn/jespinosa/phecomp/data/CRG/20120502_FDF_CRG/20120502_FDF_CRG/20120521_FDF_CRG_c12.mtb	4358	173	WWSS	food_sc	4	124501	1337726445	1	0.02	0.000869565217391304	4697	1
1	Drink 1	Intake 1	23	124674	1337726618	/users/cn/jespinosa/phecomp/data/CRG/20120502_FDF_CRG/20120502_FDF_CRG/20120521_FDF_CRG_c12.mtb	2831	NA	WWSS	water	1	124651	1337726595	1	0.02	0.000869565217391304	4698	1
1	Food 2	Intake 4	113	124810	1337726754	/users/cn/jespinosa/phecomp/data/CRG/20120502_FDF_CRG/20120502_FDF_CRG/20120521_FDF_CRG_c12.mtb	4360	61	WWSS	food_sc	4	124697	1337726641	1	0.02	0.000176991150442478	4699	1
1	Drink 2	Intake 2	15	124866	1337726810	/users/cn/jespinosa/phecomp/data/CRG/20120502_FDF_CRG/20120502_FDF_CRG/20120521_FDF_CRG_c12.mtb	1524	NA	WWSS	water	2	124851	1337726795	1	0.02	0.00133333333333333	4700	1
1	Food 2	Intake 4	89	124960	1337726904	/users/cn/jespinosa/phecomp/data/CRG/20120502_FDF_CRG/20120502_FDF_CRG/20120521_FDF_CRG_c12.mtb	4361	75	WWSS	food_sc	4	124871	1337726815	1	0.02	0.000224719101123596	4701	1
1	Food 2	Intake 4	110	125145	1337727089	/users/cn/jespinosa/phecomp/data/CRG/20120502_FDF_CRG/20120502_FDF_CRG/20120521_FDF_CRG_c12.mtb	4362	216	WWSS	food_sc	4	125035	1337726979	1	0.02	0.000181818181818182	4702	1
1	Drink 2	Intake 2	17	125315	1337727259	/users/cn/jespinosa/phecomp/data/CRG/20120502_FDF_CRG/20120502_FDF_CRG/20120521_FDF_CRG_c12.mtb	1525	NA	WWSS	water	2	125298	1337727242	1	0.0600000000000001	0.00352941176470589	4703	1
1	Drink 2	Intake 2	14	125346	1337727290	/users/cn/jespinosa/phecomp/data/CRG/20120502_FDF_CRG/20120502_FDF_CRG/20120521_FDF_CRG_c12.mtb	1526	NA	WWSS	water	2	125332	1337727276	1	0.02	0.00142857142857143	4704	1
1	Food 2	Intake 4	121	125482	1337727426	/users/cn/jespinosa/phecomp/data/CRG/20120502_FDF_CRG/20120502_FDF_CRG/20120521_FDF_CRG_c12.mtb	4364	46	WWSS	food_sc	4	125361	1337727305	1	0.02	0.000165289256198347	4705	1
1	Food 2	Intake 4	123	125651	1337727595	/users/cn/jespinosa/phecomp/data/CRG/20120502_FDF_CRG/20120502_FDF_CRG/20120521_FDF_CRG_c12.mtb	4365	361	WWSS	food_sc	4	125528	1337727472	1	0.02	0.00016260162601626	4706	1
1	Drink 2	Intake 2	24	125957	1337727901	/users/cn/jespinosa/phecomp/data/CRG/20120502_FDF_CRG/20120502_FDF_CRG/20120521_FDF_CRG_c12.mtb	1527	NA	WWSS	water	2	125933	1337727877	1	0.0599999999999998	0.00249999999999999	4707	1
1	Food 2	Intake 4	118	126130	1337728074	/users/cn/jespinosa/phecomp/data/CRG/20120502_FDF_CRG/20120502_FDF_CRG/20120521_FDF_CRG_c12.mtb	4367	249	WWSS	food_sc	4	126012	1337727956	1	0.04	0.000338983050847458	4708	1
1	Food 2	Intake 4	76	126455	1337728399	/users/cn/jespinosa/phecomp/data/CRG/20120502_FDF_CRG/20120502_FDF_CRG/20120521_FDF_CRG_c12.mtb	4369	37	WWSS	food_sc	4	126379	1337728323	1	0.0200000000000005	0.000263157894736849	4709	1
1	Food 2	Intake 4	107	126599	1337728543	/users/cn/jespinosa/phecomp/data/CRG/20120502_FDF_CRG/20120502_FDF_CRG/20120521_FDF_CRG_c12.mtb	4370	67	WWSS	food_sc	4	126492	1337728436	1	0.0399999999999996	0.000373831775700931	4710	1
1	Drink 2	Intake 2	16	126677	1337728621	/users/cn/jespinosa/phecomp/data/CRG/20120502_FDF_CRG/20120502_FDF_CRG/20120521_FDF_CRG_c12.mtb	1529	NA	WWSS	water	2	126661	1337728605	1	0.04	0.0025	4711	1
1	Food 2	Intake 4	82	126748	1337728692	/users/cn/jespinosa/phecomp/data/CRG/20120502_FDF_CRG/20120502_FDF_CRG/20120521_FDF_CRG_c12.mtb	4372	254	WWSS	food_sc	4	126666	1337728610	1	0.02	0.00024390243902439	4712	1
1	Food 2	Intake 4	73	127075	1337729019	/users/cn/jespinosa/phecomp/data/CRG/20120502_FDF_CRG/20120502_FDF_CRG/20120521_FDF_CRG_c12.mtb	4374	4	WWSS	food_sc	4	127002	1337728946	1	0.02	0.000273972602739726	4713	1
1	Food 2	Intake 4	62	127141	1337729085	/users/cn/jespinosa/phecomp/data/CRG/20120502_FDF_CRG/20120502_FDF_CRG/20120521_FDF_CRG_c12.mtb	4375	COLL	WWSS	food_sc	4	127079	1337729023	1	0.02	0.00032258064516129	4714	1
1	Food 1	Intake 3	112	127243	1337729187	/users/cn/jespinosa/phecomp/data/CRG/20120502_FDF_CRG/20120502_FDF_CRG/20120521_FDF_CRG_c12.mtb	3369	138	WWSS	food_sc	3	127131	1337729075	1	0.02	0.000178571428571429	4715	1
1	Drink 2	Intake 2	23	127266	1337729210	/users/cn/jespinosa/phecomp/data/CRG/20120502_FDF_CRG/20120502_FDF_CRG/20120521_FDF_CRG_c12.mtb	1530	NA	WWSS	water	2	127243	1337729187	1	0.02	0.000869565217391304	4716	1
1	Food 1	Intake 3	82	127463	1337729407	/users/cn/jespinosa/phecomp/data/CRG/20120502_FDF_CRG/20120502_FDF_CRG/20120521_FDF_CRG_c12.mtb	3371	106	WWSS	food_sc	3	127381	1337729325	1	0.04	0.00048780487804878	4717	1
1	Food 2	Intake 4	92	127661	1337729605	/users/cn/jespinosa/phecomp/data/CRG/20120502_FDF_CRG/20120502_FDF_CRG/20120521_FDF_CRG_c12.mtb	4377	689	WWSS	food_sc	4	127569	1337729513	1	0.02	0.000217391304347826	4718	1
1	Drink 2	Intake 2	25	127677	1337729621	/users/cn/jespinosa/phecomp/data/CRG/20120502_FDF_CRG/20120502_FDF_CRG/20120521_FDF_CRG_c12.mtb	1531	NA	WWSS	water	2	127652	1337729596	1	0.0599999999999998	0.00239999999999999	4719	1
1	Drink 2	Intake 2	31	128045	1337729989	/users/cn/jespinosa/phecomp/data/CRG/20120502_FDF_CRG/20120502_FDF_CRG/20120521_FDF_CRG_c12.mtb	1532	NA	WWSS	water	2	128014	1337729958	1	0.0800000000000001	0.00258064516129033	4720	1
1	Food 2	Intake 4	179	128529	1337730473	/users/cn/jespinosa/phecomp/data/CRG/20120502_FDF_CRG/20120502_FDF_CRG/20120521_FDF_CRG_c12.mtb	4380	335	WWSS	food_sc	4	128350	1337730294	1	0.04	0.000223463687150838	4721	1
1	Drink 1	Intake 1	16	128830	1337730774	/users/cn/jespinosa/phecomp/data/CRG/20120502_FDF_CRG/20120502_FDF_CRG/20120521_FDF_CRG_c12.mtb	2832	NA	WWSS	water	1	128814	1337730758	1	0.02	0.00125	4722	1
1	Food 1	Intake 3	32	128896	1337730840	/users/cn/jespinosa/phecomp/data/CRG/20120502_FDF_CRG/20120502_FDF_CRG/20120521_FDF_CRG_c12.mtb	3376	52	WWSS	food_sc	3	128864	1337730808	1	0.02	0.000625	4723	1
1	Food 2	Intake 4	141	129089	1337731033	/users/cn/jespinosa/phecomp/data/CRG/20120502_FDF_CRG/20120502_FDF_CRG/20120521_FDF_CRG_c12.mtb	4381	96	WWSS	food_sc	4	128948	1337730892	1	0.04	0.000283687943262411	4724	1
1	Food 2	Intake 4	176	129361	1337731305	/users/cn/jespinosa/phecomp/data/CRG/20120502_FDF_CRG/20120502_FDF_CRG/20120521_FDF_CRG_c12.mtb	4382	209	WWSS	food_sc	4	129185	1337731129	1	0.02	0.000113636363636364	4725	1
1	Food 2	Intake 4	129	129699	1337731643	/users/cn/jespinosa/phecomp/data/CRG/20120502_FDF_CRG/20120502_FDF_CRG/20120521_FDF_CRG_c12.mtb	4383	17	WWSS	food_sc	4	129570	1337731514	1	0.02	0.000155038759689922	4726	1
1	Drink 2	Intake 2	17	129713	1337731657	/users/cn/jespinosa/phecomp/data/CRG/20120502_FDF_CRG/20120502_FDF_CRG/20120521_FDF_CRG_c12.mtb	1533	NA	WWSS	water	2	129696	1337731640	1	0.02	0.00117647058823529	4727	1
1	Food 2	Intake 4	184	129900	1337731844	/users/cn/jespinosa/phecomp/data/CRG/20120502_FDF_CRG/20120502_FDF_CRG/20120521_FDF_CRG_c12.mtb	4384	83	WWSS	food_sc	4	129716	1337731660	1	0.04	0.000217391304347826	4728	1
1	Drink 1	Intake 1	13	129919	1337731863	/users/cn/jespinosa/phecomp/data/CRG/20120502_FDF_CRG/20120502_FDF_CRG/20120521_FDF_CRG_c12.mtb	2833	NA	WWSS	water	1	129906	1337731850	1	0.02	0.00153846153846154	4729	1
1	Food 1	Intake 3	36	130019	1337731963	/users/cn/jespinosa/phecomp/data/CRG/20120502_FDF_CRG/20120502_FDF_CRG/20120521_FDF_CRG_c12.mtb	3378	COLL	WWSS	food_sc	3	129983	1337731927	1	0.02	0.000555555555555556	4730	1
1	Food 2	Intake 4	193	130200	1337732144	/users/cn/jespinosa/phecomp/data/CRG/20120502_FDF_CRG/20120502_FDF_CRG/20120521_FDF_CRG_c12.mtb	4385	469	WWSS	food_sc	4	130007	1337731951	1	0.04	0.000207253886010363	4731	1
1	Food 2	Intake 4	171	130840	1337732784	/users/cn/jespinosa/phecomp/data/CRG/20120502_FDF_CRG/20120502_FDF_CRG/20120521_FDF_CRG_c12.mtb	4389	10	WWSS	food_sc	4	130669	1337732613	1	0.04	0.000233918128654971	4732	1
1	Food 2	Intake 4	90	130940	1337732884	/users/cn/jespinosa/phecomp/data/CRG/20120502_FDF_CRG/20120502_FDF_CRG/20120521_FDF_CRG_c12.mtb	4390	236	WWSS	food_sc	4	130850	1337732794	1	0.02	0.000222222222222222	4733	1
1	Drink 1	Intake 1	38	131008	1337732952	/users/cn/jespinosa/phecomp/data/CRG/20120502_FDF_CRG/20120502_FDF_CRG/20120521_FDF_CRG_c12.mtb	2834	NA	WWSS	water	1	130970	1337732914	1	0.02	0.000526315789473684	4734	1
1	Food 2	Intake 4	43	131219	1337733163	/users/cn/jespinosa/phecomp/data/CRG/20120502_FDF_CRG/20120502_FDF_CRG/20120521_FDF_CRG_c12.mtb	4393	3	WWSS	food_sc	4	131176	1337733120	1	0.36	0.00837209302325581	4735	1
1	Food 2	Intake 4	225	131447	1337733391	/users/cn/jespinosa/phecomp/data/CRG/20120502_FDF_CRG/20120502_FDF_CRG/20120521_FDF_CRG_c12.mtb	4394	5731	WWSS	food_sc	4	131222	1337733166	1	0.04	0.000177777777777778	4736	1
1	Drink 2	Intake 2	20	131472	1337733416	/users/cn/jespinosa/phecomp/data/CRG/20120502_FDF_CRG/20120502_FDF_CRG/20120521_FDF_CRG_c12.mtb	1535	NA	WWSS	water	2	131452	1337733396	1	0.02	0.001	4737	1
1	Drink 2	Intake 2	42	131560	1337733504	/users/cn/jespinosa/phecomp/data/CRG/20120502_FDF_CRG/20120502_FDF_CRG/20120521_FDF_CRG_c12.mtb	1536	NA	WWSS	water	2	131518	1337733462	1	0.1	0.00238095238095238	4738	1
1	Food 2	Intake 4	50	137228	1337739172	/users/cn/jespinosa/phecomp/data/CRG/20120502_FDF_CRG/20120502_FDF_CRG/20120521_FDF_CRG_c12.mtb	4395	24	WWSS	food_sc	4	137178	1337739122	1	0.04	0.0008	4739	1
1	Food 2	Intake 4	9	137261	1337739205	/users/cn/jespinosa/phecomp/data/CRG/20120502_FDF_CRG/20120502_FDF_CRG/20120521_FDF_CRG_c12.mtb	4396	20	WWSS	food_sc	4	137252	1337739196	1	0.02	0.00222222222222222	4740	1
1	Food 2	Intake 4	17	137298	1337739242	/users/cn/jespinosa/phecomp/data/CRG/20120502_FDF_CRG/20120502_FDF_CRG/20120521_FDF_CRG_c12.mtb	4397	6199	WWSS	food_sc	4	137281	1337739225	1	0.02	0.00117647058823529	4741	1
1	Food 2	Intake 4	73	143570	1337745514	/users/cn/jespinosa/phecomp/data/CRG/20120502_FDF_CRG/20120502_FDF_CRG/20120521_FDF_CRG_c12.mtb	4399	1777	WWSS	food_sc	4	143497	1337745441	1	0.0600000000000001	0.000821917808219179	4742	1
1	Food 2	Intake 4	43	145390	1337747334	/users/cn/jespinosa/phecomp/data/CRG/20120502_FDF_CRG/20120502_FDF_CRG/20120521_FDF_CRG_c12.mtb	4401	339	WWSS	food_sc	4	145347	1337747291	1	0.0200000000000005	0.000465116279069779	4743	1
1	Drink 1	Intake 1	20	145698	1337747642	/users/cn/jespinosa/phecomp/data/CRG/20120502_FDF_CRG/20120502_FDF_CRG/20120521_FDF_CRG_c12.mtb	2835	NA	WWSS	water	1	145678	1337747622	1	0.0799999999999998	0.00399999999999999	4744	1
1	Food 2	Intake 4	100	145829	1337747773	/users/cn/jespinosa/phecomp/data/CRG/20120502_FDF_CRG/20120502_FDF_CRG/20120521_FDF_CRG_c12.mtb	4403	16	WWSS	food_sc	4	145729	1337747673	1	0.0600000000000001	0.000600000000000001	4745	1
1	Drink 1	Intake 1	29	145857	1337747801	/users/cn/jespinosa/phecomp/data/CRG/20120502_FDF_CRG/20120502_FDF_CRG/20120521_FDF_CRG_c12.mtb	2836	NA	WWSS	water	1	145828	1337747772	1	0.02	0.000689655172413793	4746	1
1	Food 2	Intake 4	54	145899	1337747843	/users/cn/jespinosa/phecomp/data/CRG/20120502_FDF_CRG/20120502_FDF_CRG/20120521_FDF_CRG_c12.mtb	4404	5	WWSS	food_sc	4	145845	1337747789	1	0.02	0.00037037037037037	4747	1
1	Food 2	Intake 4	88	145992	1337747936	/users/cn/jespinosa/phecomp/data/CRG/20120502_FDF_CRG/20120502_FDF_CRG/20120521_FDF_CRG_c12.mtb	4405	210	WWSS	food_sc	4	145904	1337747848	1	0.02	0.000227272727272727	4748	1
1	Drink 2	Intake 2	26	146007	1337747951	/users/cn/jespinosa/phecomp/data/CRG/20120502_FDF_CRG/20120502_FDF_CRG/20120521_FDF_CRG_c12.mtb	1537	NA	WWSS	water	2	145981	1337747925	1	0.0600000000000001	0.00230769230769231	4749	1
1	Food 1	Intake 3	33	146235	1337748179	/users/cn/jespinosa/phecomp/data/CRG/20120502_FDF_CRG/20120502_FDF_CRG/20120521_FDF_CRG_c12.mtb	3389	158	WWSS	food_sc	3	146202	1337748146	1	0.02	0.000606060606060606	4750	1
1	Drink 2	Intake 2	8	146277	1337748221	/users/cn/jespinosa/phecomp/data/CRG/20120502_FDF_CRG/20120502_FDF_CRG/20120521_FDF_CRG_c12.mtb	1539	NA	WWSS	water	2	146269	1337748213	1	0.04	0.005	4751	1
1	Food 1	Intake 3	41	146434	1337748378	/users/cn/jespinosa/phecomp/data/CRG/20120502_FDF_CRG/20120502_FDF_CRG/20120521_FDF_CRG_c12.mtb	3390	833	WWSS	food_sc	3	146393	1337748337	1	0.02	0.00048780487804878	4752	1
1	Drink 1	Intake 1	23	146509	1337748453	/users/cn/jespinosa/phecomp/data/CRG/20120502_FDF_CRG/20120502_FDF_CRG/20120521_FDF_CRG_c12.mtb	2838	NA	WWSS	water	1	146486	1337748430	1	0.02	0.000869565217391304	4753	1
1	Drink 1	Intake 1	23	146837	1337748781	/users/cn/jespinosa/phecomp/data/CRG/20120502_FDF_CRG/20120502_FDF_CRG/20120521_FDF_CRG_c12.mtb	2839	NA	WWSS	water	1	146814	1337748758	1	0.0600000000000001	0.00260869565217392	4754	1
1	Food 2	Intake 4	35	147302	1337749246	/users/cn/jespinosa/phecomp/data/CRG/20120502_FDF_CRG/20120502_FDF_CRG/20120521_FDF_CRG_c12.mtb	4410	COLL	WWSS	food_sc	4	147267	1337749211	1	0.02	0.000571428571428571	4755	1
1	Food 1	Intake 3	96	147384	1337749328	/users/cn/jespinosa/phecomp/data/CRG/20120502_FDF_CRG/20120502_FDF_CRG/20120521_FDF_CRG_c12.mtb	3392	562	WWSS	food_sc	3	147288	1337749232	1	0.04	0.000416666666666667	4756	1
1	Food 1	Intake 3	33	147979	1337749923	/users/cn/jespinosa/phecomp/data/CRG/20120502_FDF_CRG/20120502_FDF_CRG/20120521_FDF_CRG_c12.mtb	3393	47	WWSS	food_sc	3	147946	1337749890	1	0.02	0.000606060606060606	4757	1
1	Food 1	Intake 3	76	148102	1337750046	/users/cn/jespinosa/phecomp/data/CRG/20120502_FDF_CRG/20120502_FDF_CRG/20120521_FDF_CRG_c12.mtb	3394	609	WWSS	food_sc	3	148026	1337749970	1	0.0600000000000001	0.000789473684210528	4758	1
1	Drink 1	Intake 1	17	148138	1337750082	/users/cn/jespinosa/phecomp/data/CRG/20120502_FDF_CRG/20120502_FDF_CRG/20120521_FDF_CRG_c12.mtb	2840	NA	WWSS	water	1	148121	1337750065	1	0.04	0.00235294117647059	4759	1
1	Drink 1	Intake 1	41	148325	1337750269	/users/cn/jespinosa/phecomp/data/CRG/20120502_FDF_CRG/20120502_FDF_CRG/20120521_FDF_CRG_c12.mtb	2841	NA	WWSS	water	1	148284	1337750228	1	0.04	0.000975609756097561	4760	1
1	Drink 2	Intake 2	13	148439	1337750383	/users/cn/jespinosa/phecomp/data/CRG/20120502_FDF_CRG/20120502_FDF_CRG/20120521_FDF_CRG_c12.mtb	1542	NA	WWSS	water	2	148426	1337750370	1	0.02	0.00153846153846154	4761	1
1	Food 1	Intake 3	48	148759	1337750703	/users/cn/jespinosa/phecomp/data/CRG/20120502_FDF_CRG/20120502_FDF_CRG/20120521_FDF_CRG_c12.mtb	3398	87	WWSS	food_sc	3	148711	1337750655	1	0.02	0.000416666666666667	4762	1
1	Drink 1	Intake 1	19	148768	1337750712	/users/cn/jespinosa/phecomp/data/CRG/20120502_FDF_CRG/20120502_FDF_CRG/20120521_FDF_CRG_c12.mtb	2843	NA	WWSS	water	1	148749	1337750693	1	0.02	0.00105263157894737	4763	1
1	Food 1	Intake 3	40	148886	1337750830	/users/cn/jespinosa/phecomp/data/CRG/20120502_FDF_CRG/20120502_FDF_CRG/20120521_FDF_CRG_c12.mtb	3400	204	WWSS	food_sc	3	148846	1337750790	1	0.02	0.0005	4764	1
1	Drink 2	Intake 2	44	148935	1337750879	/users/cn/jespinosa/phecomp/data/CRG/20120502_FDF_CRG/20120502_FDF_CRG/20120521_FDF_CRG_c12.mtb	1543	NA	WWSS	water	2	148891	1337750835	1	0.18	0.00409090909090909	4765	1
1	Food 1	Intake 3	25	149115	1337751059	/users/cn/jespinosa/phecomp/data/CRG/20120502_FDF_CRG/20120502_FDF_CRG/20120521_FDF_CRG_c12.mtb	3402	44	WWSS	food_sc	3	149090	1337751034	1	0.02	0.0008	4766	1
1	Food 1	Intake 3	39	149198	1337751142	/users/cn/jespinosa/phecomp/data/CRG/20120502_FDF_CRG/20120502_FDF_CRG/20120521_FDF_CRG_c12.mtb	3404	72	WWSS	food_sc	3	149159	1337751103	1	0.02	0.000512820512820513	4767	1
1	Food 1	Intake 3	55	149325	1337751269	/users/cn/jespinosa/phecomp/data/CRG/20120502_FDF_CRG/20120502_FDF_CRG/20120521_FDF_CRG_c12.mtb	3406	257	WWSS	food_sc	3	149270	1337751214	1	0.04	0.000727272727272727	4768	1
1	Drink 2	Intake 2	17	149346	1337751290	/users/cn/jespinosa/phecomp/data/CRG/20120502_FDF_CRG/20120502_FDF_CRG/20120521_FDF_CRG_c12.mtb	1544	NA	WWSS	water	2	149329	1337751273	1	0.02	0.00117647058823529	4769	1
1	Food 1	Intake 3	120	149702	1337751646	/users/cn/jespinosa/phecomp/data/CRG/20120502_FDF_CRG/20120502_FDF_CRG/20120521_FDF_CRG_c12.mtb	3408	62	WWSS	food_sc	3	149582	1337751526	1	0.0399999999999996	0.00033333333333333	4770	1
1	Food 1	Intake 3	40	149804	1337751748	/users/cn/jespinosa/phecomp/data/CRG/20120502_FDF_CRG/20120502_FDF_CRG/20120521_FDF_CRG_c12.mtb	3410	608	WWSS	food_sc	3	149764	1337751708	1	0.0200000000000005	0.000500000000000012	4771	1
1	Drink 2	Intake 2	17	150314	1337752258	/users/cn/jespinosa/phecomp/data/CRG/20120502_FDF_CRG/20120502_FDF_CRG/20120521_FDF_CRG_c12.mtb	1547	NA	WWSS	water	2	150297	1337752241	1	0.02	0.00117647058823529	4772	1
1	Food 1	Intake 3	203	150615	1337752559	/users/cn/jespinosa/phecomp/data/CRG/20120502_FDF_CRG/20120502_FDF_CRG/20120521_FDF_CRG_c12.mtb	3411	156	WWSS	food_sc	3	150412	1337752356	1	0.0399999999999996	0.000197044334975367	4773	1
1	Food 1	Intake 3	92	150863	1337752807	/users/cn/jespinosa/phecomp/data/CRG/20120502_FDF_CRG/20120502_FDF_CRG/20120521_FDF_CRG_c12.mtb	3413	8	WWSS	food_sc	3	150771	1337752715	1	0.02	0.000217391304347826	4774	1
1	Food 1	Intake 3	187	151058	1337753002	/users/cn/jespinosa/phecomp/data/CRG/20120502_FDF_CRG/20120502_FDF_CRG/20120521_FDF_CRG_c12.mtb	3414	14	WWSS	food_sc	3	150871	1337752815	1	0.12	0.000641711229946524	4775	1
1	Food 1	Intake 3	271	151343	1337753287	/users/cn/jespinosa/phecomp/data/CRG/20120502_FDF_CRG/20120502_FDF_CRG/20120521_FDF_CRG_c12.mtb	3415	42	WWSS	food_sc	3	151072	1337753016	1	0.92	0.00339483394833948	4776	1
1	Drink 2	Intake 2	23	151367	1337753311	/users/cn/jespinosa/phecomp/data/CRG/20120502_FDF_CRG/20120502_FDF_CRG/20120521_FDF_CRG_c12.mtb	1550	NA	WWSS	water	2	151344	1337753288	1	0.0800000000000001	0.00347826086956522	4777	1
1	Food 1	Intake 3	77	151462	1337753406	/users/cn/jespinosa/phecomp/data/CRG/20120502_FDF_CRG/20120502_FDF_CRG/20120521_FDF_CRG_c12.mtb	3416	45	WWSS	food_sc	3	151385	1337753329	1	0.0200000000000005	0.000259740259740266	4778	1
1	Food 2	Intake 4	15	151522	1337753466	/users/cn/jespinosa/phecomp/data/CRG/20120502_FDF_CRG/20120502_FDF_CRG/20120521_FDF_CRG_c12.mtb	4438	17	WWSS	food_sc	4	151507	1337753451	1	0.02	0.00133333333333333	4779	1
1	Food 2	Intake 4	28	151567	1337753511	/users/cn/jespinosa/phecomp/data/CRG/20120502_FDF_CRG/20120502_FDF_CRG/20120521_FDF_CRG_c12.mtb	4439	35	WWSS	food_sc	4	151539	1337753483	1	0.02	0.000714285714285714	4780	1
1	Food 1	Intake 3	148	151750	1337753694	/users/cn/jespinosa/phecomp/data/CRG/20120502_FDF_CRG/20120502_FDF_CRG/20120521_FDF_CRG_c12.mtb	3419	COLL	WWSS	food_sc	3	151602	1337753546	1	0.0800000000000001	0.000540540540540541	4781	1
1	Food 2	Intake 4	15	151747	1337753691	/users/cn/jespinosa/phecomp/data/CRG/20120502_FDF_CRG/20120502_FDF_CRG/20120521_FDF_CRG_c12.mtb	4442	6738	WWSS	food_sc	4	151732	1337753676	1	0.02	0.00133333333333333	4782	1
1	Drink 2	Intake 2	9	151792	1337753736	/users/cn/jespinosa/phecomp/data/CRG/20120502_FDF_CRG/20120502_FDF_CRG/20120521_FDF_CRG_c12.mtb	1551	NA	WWSS	water	2	151783	1337753727	1	0.02	0.00222222222222222	4783	1
1	Drink 1	Intake 1	28	151944	1337753888	/users/cn/jespinosa/phecomp/data/CRG/20120502_FDF_CRG/20120502_FDF_CRG/20120521_FDF_CRG_c12.mtb	2845	NA	WWSS	water	1	151916	1337753860	1	0.0600000000000001	0.00214285714285715	4784	1
1	Drink 2	Intake 2	13	152368	1337754312	/users/cn/jespinosa/phecomp/data/CRG/20120502_FDF_CRG/20120502_FDF_CRG/20120521_FDF_CRG_c12.mtb	1552	NA	WWSS	water	2	152355	1337754299	1	0.02	0.00153846153846154	4785	1
1	Food 2	Intake 4	59	158544	1337760488	/users/cn/jespinosa/phecomp/data/CRG/20120502_FDF_CRG/20120502_FDF_CRG/20120521_FDF_CRG_c12.mtb	4447	5368	WWSS	food_sc	4	158485	1337760429	1	0.0600000000000001	0.00101694915254237	4786	1
1	Drink 1	Intake 1	22	163846	1337765790	/users/cn/jespinosa/phecomp/data/CRG/20120502_FDF_CRG/20120502_FDF_CRG/20120521_FDF_CRG_c12.mtb	2846	NA	WWSS	water	1	163824	1337765768	1	0.02	0.000909090909090909	4787	1
1	Food 2	Intake 4	48	163960	1337765904	/users/cn/jespinosa/phecomp/data/CRG/20120502_FDF_CRG/20120502_FDF_CRG/20120521_FDF_CRG_c12.mtb	4450	LAST	WWSS	food_sc	4	163912	1337765856	1	0.02	0.000416666666666667	4788	1
1	Drink 2	Intake 2	54	164101	1337766045	/users/cn/jespinosa/phecomp/data/CRG/20120502_FDF_CRG/20120502_FDF_CRG/20120521_FDF_CRG_c12.mtb	1555	LAST	WWSS	water	2	164047	1337765991	1	0.02	0.00037037037037037	4789	1
1	Drink 1	Intake 1	16	969	1335958977	/users/cn/jespinosa/phecomp/data/CRG/20120502_FDF_CRG/20120502_FDF_CRG/20120502_FDF_CRG_c12.mtb	245	NA	WWSS	water	1	953	1335958961	1	0.02	0.00125	2017	1
1	Food 1	Intake 3	94	1569	1335959577	/users/cn/jespinosa/phecomp/data/CRG/20120502_FDF_CRG/20120502_FDF_CRG/20120502_FDF_CRG_c12.mtb	207	700	WWSS	food_sc	3	1475	1335959483	1	0.04	0.000425531914893617	2018	1
1	Food 1	Intake 3	86	2355	1335960363	/users/cn/jespinosa/phecomp/data/CRG/20120502_FDF_CRG/20120502_FDF_CRG/20120502_FDF_CRG_c12.mtb	209	415	WWSS	food_sc	3	2269	1335960277	1	0.02	0.000232558139534884	2019	1
1	Food 1	Intake 3	28	2798	1335960806	/users/cn/jespinosa/phecomp/data/CRG/20120502_FDF_CRG/20120502_FDF_CRG/20120502_FDF_CRG_c12.mtb	211	6695	WWSS	food_sc	3	2770	1335960778	1	0.02	0.000714285714285714	2020	1
1	Drink 1	Intake 1	17	2944	1335960952	/users/cn/jespinosa/phecomp/data/CRG/20120502_FDF_CRG/20120502_FDF_CRG/20120502_FDF_CRG_c12.mtb	270	NA	WWSS	water	1	2927	1335960935	1	0.02	0.00117647058823529	2021	1
1	Drink 1	Intake 1	20	3045	1335961053	/users/cn/jespinosa/phecomp/data/CRG/20120502_FDF_CRG/20120502_FDF_CRG/20120502_FDF_CRG_c12.mtb	271	NA	WWSS	water	1	3025	1335961033	1	0.02	0.001	2022	1
1	Food 1	Intake 3	311	9804	1335967812	/users/cn/jespinosa/phecomp/data/CRG/20120502_FDF_CRG/20120502_FDF_CRG/20120502_FDF_CRG_c12.mtb	214	11	WWSS	food_sc	3	9493	1335967501	1	0.1	0.000321543408360129	2023	1
1	Food 1	Intake 3	52	9867	1335967875	/users/cn/jespinosa/phecomp/data/CRG/20120502_FDF_CRG/20120502_FDF_CRG/20120502_FDF_CRG_c12.mtb	215	4846	WWSS	food_sc	3	9815	1335967823	1	0.02	0.000384615384615385	2024	1
1	Drink 2	Intake 2	82	11794	1335969802	/users/cn/jespinosa/phecomp/data/CRG/20120502_FDF_CRG/20120502_FDF_CRG/20120502_FDF_CRG_c12.mtb	94	NA	WWSS	water	2	11712	1335969720	1	0.06	0.000731707317073171	2025	1
1	Drink 1	Intake 1	18	14660	1335972668	/users/cn/jespinosa/phecomp/data/CRG/20120502_FDF_CRG/20120502_FDF_CRG/20120502_FDF_CRG_c12.mtb	289	NA	WWSS	water	1	14642	1335972650	1	0.02	0.00111111111111111	2026	1
1	Food 1	Intake 3	294	15007	1335973015	/users/cn/jespinosa/phecomp/data/CRG/20120502_FDF_CRG/20120502_FDF_CRG/20120502_FDF_CRG_c12.mtb	224	4067	WWSS	food_sc	3	14713	1335972721	1	0.1	0.000340136054421769	2027	1
1	Food 1	Intake 3	390	19464	1335977472	/users/cn/jespinosa/phecomp/data/CRG/20120502_FDF_CRG/20120502_FDF_CRG/20120502_FDF_CRG_c12.mtb	226	15	WWSS	food_sc	3	19074	1335977082	1	0.1	0.000256410256410256	2028	1
1	Food 1	Intake 3	279	19758	1335977766	/users/cn/jespinosa/phecomp/data/CRG/20120502_FDF_CRG/20120502_FDF_CRG/20120502_FDF_CRG_c12.mtb	227	54	WWSS	food_sc	3	19479	1335977487	1	0.08	0.00028673835125448	2029	1
1	Food 1	Intake 3	83	19895	1335977903	/users/cn/jespinosa/phecomp/data/CRG/20120502_FDF_CRG/20120502_FDF_CRG/20120502_FDF_CRG_c12.mtb	229	2351	WWSS	food_sc	3	19812	1335977820	1	0.02	0.000240963855421687	2030	1
1	Drink 2	Intake 2	75	19967	1335977975	/users/cn/jespinosa/phecomp/data/CRG/20120502_FDF_CRG/20120502_FDF_CRG/20120502_FDF_CRG_c12.mtb	95	NA	WWSS	water	2	19892	1335977900	1	0.18	0.0024	2031	1
1	Drink 1	Intake 1	34	20552	1335978560	/users/cn/jespinosa/phecomp/data/CRG/20120502_FDF_CRG/20120502_FDF_CRG/20120502_FDF_CRG_c12.mtb	296	NA	WWSS	water	1	20518	1335978526	1	0.06	0.00176470588235294	2032	1
1	Food 1	Intake 3	118	22364	1335980372	/users/cn/jespinosa/phecomp/data/CRG/20120502_FDF_CRG/20120502_FDF_CRG/20120502_FDF_CRG_c12.mtb	230	697	WWSS	food_sc	3	22246	1335980254	1	0.02	0.000169491525423729	2033	1
1	Drink 1	Intake 1	163	22754	1335980762	/users/cn/jespinosa/phecomp/data/CRG/20120502_FDF_CRG/20120502_FDF_CRG/20120502_FDF_CRG_c12.mtb	298	NA	WWSS	water	1	22591	1335980599	1	0.02	0.000122699386503067	2034	1
1	Food 1	Intake 3	371	23432	1335981440	/users/cn/jespinosa/phecomp/data/CRG/20120502_FDF_CRG/20120502_FDF_CRG/20120502_FDF_CRG_c12.mtb	232	743	WWSS	food_sc	3	23061	1335981069	1	0.0599999999999999	0.000161725067385444	2035	1
1	Food 1	Intake 3	166	24341	1335982349	/users/cn/jespinosa/phecomp/data/CRG/20120502_FDF_CRG/20120502_FDF_CRG/20120502_FDF_CRG_c12.mtb	235	1687	WWSS	food_sc	3	24175	1335982183	1	0.04	0.000240963855421687	2036	1
1	Food 1	Intake 3	355	26383	1335984391	/users/cn/jespinosa/phecomp/data/CRG/20120502_FDF_CRG/20120502_FDF_CRG/20120502_FDF_CRG_c12.mtb	237	310	WWSS	food_sc	3	26028	1335984036	1	0.08	0.000225352112676056	2037	1
1	Food 2	Intake 4	160	26853	1335984861	/users/cn/jespinosa/phecomp/data/CRG/20120502_FDF_CRG/20120502_FDF_CRG/20120502_FDF_CRG_c12.mtb	164	85	WWSS	food_sc	4	26693	1335984701	1	0.08	0.0005	2038	1
1	Food 2	Intake 4	36	26974	1335984982	/users/cn/jespinosa/phecomp/data/CRG/20120502_FDF_CRG/20120502_FDF_CRG/20120502_FDF_CRG_c12.mtb	165	17	WWSS	food_sc	4	26938	1335984946	1	0.02	0.000555555555555556	2039	1
1	Food 1	Intake 3	20	27011	1335985019	/users/cn/jespinosa/phecomp/data/CRG/20120502_FDF_CRG/20120502_FDF_CRG/20120502_FDF_CRG_c12.mtb	238	1132	WWSS	food_sc	3	26991	1335984999	1	0.02	0.001	2040	1
1	Drink 1	Intake 1	45	27140	1335985148	/users/cn/jespinosa/phecomp/data/CRG/20120502_FDF_CRG/20120502_FDF_CRG/20120502_FDF_CRG_c12.mtb	311	NA	WWSS	water	1	27095	1335985103	1	0.06	0.00133333333333333	2041	1
1	Food 2	Intake 4	110	28253	1335986261	/users/cn/jespinosa/phecomp/data/CRG/20120502_FDF_CRG/20120502_FDF_CRG/20120502_FDF_CRG_c12.mtb	175	14	WWSS	food_sc	4	28143	1335986151	1	0.06	0.000545454545454545	2042	1
1	Food 2	Intake 4	55	28322	1335986330	/users/cn/jespinosa/phecomp/data/CRG/20120502_FDF_CRG/20120502_FDF_CRG/20120502_FDF_CRG_c12.mtb	176	11	WWSS	food_sc	4	28267	1335986275	1	0.02	0.000363636363636364	2043	1
1	Food 2	Intake 4	86	28419	1335986427	/users/cn/jespinosa/phecomp/data/CRG/20120502_FDF_CRG/20120502_FDF_CRG/20120502_FDF_CRG_c12.mtb	177	418	WWSS	food_sc	4	28333	1335986341	1	0.02	0.000232558139534884	2044	1
1	Drink 2	Intake 2	31	28443	1335986451	/users/cn/jespinosa/phecomp/data/CRG/20120502_FDF_CRG/20120502_FDF_CRG/20120502_FDF_CRG_c12.mtb	103	NA	WWSS	water	2	28412	1335986420	1	0.08	0.00258064516129032	2045	1
1	Drink 1	Intake 1	12	28545	1335986553	/users/cn/jespinosa/phecomp/data/CRG/20120502_FDF_CRG/20120502_FDF_CRG/20120502_FDF_CRG_c12.mtb	317	NA	WWSS	water	1	28533	1335986541	1	0.02	0.00166666666666667	2046	1
1	Drink 1	Intake 1	12	28836	1335986844	/users/cn/jespinosa/phecomp/data/CRG/20120502_FDF_CRG/20120502_FDF_CRG/20120502_FDF_CRG_c12.mtb	319	NA	WWSS	water	1	28824	1335986832	1	0.02	0.00166666666666667	2047	1
1	Food 2	Intake 4	102	28939	1335986947	/users/cn/jespinosa/phecomp/data/CRG/20120502_FDF_CRG/20120502_FDF_CRG/20120502_FDF_CRG_c12.mtb	179	142	WWSS	food_sc	4	28837	1335986845	1	0.02	0.000196078431372549	2048	1
1	Drink 2	Intake 2	15	29051	1335987059	/users/cn/jespinosa/phecomp/data/CRG/20120502_FDF_CRG/20120502_FDF_CRG/20120502_FDF_CRG_c12.mtb	105	NA	WWSS	water	2	29036	1335987044	1	0.02	0.00133333333333333	2049	1
1	Food 2	Intake 4	134	29215	1335987223	/users/cn/jespinosa/phecomp/data/CRG/20120502_FDF_CRG/20120502_FDF_CRG/20120502_FDF_CRG_c12.mtb	181	201	WWSS	food_sc	4	29081	1335987089	1	0.02	0.000149253731343284	2050	1
1	Food 1	Intake 3	71	29487	1335987495	/users/cn/jespinosa/phecomp/data/CRG/20120502_FDF_CRG/20120502_FDF_CRG/20120502_FDF_CRG_c12.mtb	245	307	WWSS	food_sc	3	29416	1335987424	1	0.02	0.00028169014084507	2051	1
1	Drink 2	Intake 2	28	29566	1335987574	/users/cn/jespinosa/phecomp/data/CRG/20120502_FDF_CRG/20120502_FDF_CRG/20120502_FDF_CRG_c12.mtb	106	NA	WWSS	water	2	29538	1335987546	1	0.04	0.00142857142857143	2052	1
1	Food 2	Intake 4	91	29885	1335987893	/users/cn/jespinosa/phecomp/data/CRG/20120502_FDF_CRG/20120502_FDF_CRG/20120502_FDF_CRG_c12.mtb	186	196	WWSS	food_sc	4	29794	1335987802	1	0.02	0.00021978021978022	2053	1
1	Drink 1	Intake 1	15	29903	1335987911	/users/cn/jespinosa/phecomp/data/CRG/20120502_FDF_CRG/20120502_FDF_CRG/20120502_FDF_CRG_c12.mtb	327	NA	WWSS	water	1	29888	1335987896	1	0.02	0.00133333333333333	2054	1
1	Food 2	Intake 4	46	30127	1335988135	/users/cn/jespinosa/phecomp/data/CRG/20120502_FDF_CRG/20120502_FDF_CRG/20120502_FDF_CRG_c12.mtb	188	119	WWSS	food_sc	4	30081	1335988089	1	0.02	0.000434782608695652	2055	1
1	Food 1	Intake 3	66	30312	1335988320	/users/cn/jespinosa/phecomp/data/CRG/20120502_FDF_CRG/20120502_FDF_CRG/20120502_FDF_CRG_c12.mtb	250	378	WWSS	food_sc	3	30246	1335988254	1	0.02	0.000303030303030303	2056	1
1	Drink 2	Intake 2	23	30329	1335988337	/users/cn/jespinosa/phecomp/data/CRG/20120502_FDF_CRG/20120502_FDF_CRG/20120502_FDF_CRG_c12.mtb	108	NA	WWSS	water	2	30306	1335988314	1	0.06	0.00260869565217391	2057	1
1	Drink 2	Intake 2	29	30372	1335988380	/users/cn/jespinosa/phecomp/data/CRG/20120502_FDF_CRG/20120502_FDF_CRG/20120502_FDF_CRG_c12.mtb	109	NA	WWSS	water	2	30343	1335988351	1	0.02	0.000689655172413793	2058	1
1	Food 1	Intake 3	79	30769	1335988777	/users/cn/jespinosa/phecomp/data/CRG/20120502_FDF_CRG/20120502_FDF_CRG/20120502_FDF_CRG_c12.mtb	253	1053	WWSS	food_sc	3	30690	1335988698	1	0.02	0.000253164556962025	2059	1
1	Drink 2	Intake 2	17	30795	1335988803	/users/cn/jespinosa/phecomp/data/CRG/20120502_FDF_CRG/20120502_FDF_CRG/20120502_FDF_CRG_c12.mtb	110	NA	WWSS	water	2	30778	1335988786	1	0.02	0.00117647058823529	2060	1
1	Drink 2	Intake 2	10	31028	1335989036	/users/cn/jespinosa/phecomp/data/CRG/20120502_FDF_CRG/20120502_FDF_CRG/20120502_FDF_CRG_c12.mtb	111	NA	WWSS	water	2	31018	1335989026	1	0.02	0.002	2061	1
1	Drink 2	Intake 2	33	31075	1335989083	/users/cn/jespinosa/phecomp/data/CRG/20120502_FDF_CRG/20120502_FDF_CRG/20120502_FDF_CRG_c12.mtb	112	NA	WWSS	water	2	31042	1335989050	1	0.02	0.000606060606060606	2062	1
1	Drink 1	Intake 1	88	31355	1335989363	/users/cn/jespinosa/phecomp/data/CRG/20120502_FDF_CRG/20120502_FDF_CRG/20120502_FDF_CRG_c12.mtb	333	NA	WWSS	water	1	31267	1335989275	1	0.02	0.000227272727272727	2063	1
1	Food 2	Intake 4	411	32233	1335990241	/users/cn/jespinosa/phecomp/data/CRG/20120502_FDF_CRG/20120502_FDF_CRG/20120502_FDF_CRG_c12.mtb	194	1228	WWSS	food_sc	4	31822	1335989830	1	0.14	0.000340632603406326	2064	1
1	Drink 1	Intake 1	74	32304	1335990312	/users/cn/jespinosa/phecomp/data/CRG/20120502_FDF_CRG/20120502_FDF_CRG/20120502_FDF_CRG_c12.mtb	339	NA	WWSS	water	1	32230	1335990238	1	0.02	0.00027027027027027	2065	1
1	Drink 2	Intake 2	15	32329	1335990337	/users/cn/jespinosa/phecomp/data/CRG/20120502_FDF_CRG/20120502_FDF_CRG/20120502_FDF_CRG_c12.mtb	114	NA	WWSS	water	2	32314	1335990322	1	0.04	0.00266666666666667	2066	1
1	Drink 1	Intake 1	18	33145	1335991153	/users/cn/jespinosa/phecomp/data/CRG/20120502_FDF_CRG/20120502_FDF_CRG/20120502_FDF_CRG_c12.mtb	351	NA	WWSS	water	1	33127	1335991135	1	0.02	0.00111111111111111	2067	1
1	Drink 1	Intake 1	52	33356	1335991364	/users/cn/jespinosa/phecomp/data/CRG/20120502_FDF_CRG/20120502_FDF_CRG/20120502_FDF_CRG_c12.mtb	354	NA	WWSS	water	1	33304	1335991312	1	0.02	0.000384615384615385	2068	1
1	Food 2	Intake 4	62	33523	1335991531	/users/cn/jespinosa/phecomp/data/CRG/20120502_FDF_CRG/20120502_FDF_CRG/20120502_FDF_CRG_c12.mtb	198	14	WWSS	food_sc	4	33461	1335991469	1	0.02	0.00032258064516129	2069	1
1	Food 2	Intake 4	44	33581	1335991589	/users/cn/jespinosa/phecomp/data/CRG/20120502_FDF_CRG/20120502_FDF_CRG/20120502_FDF_CRG_c12.mtb	199	572	WWSS	food_sc	4	33537	1335991545	1	0.02	0.000454545454545455	2070	1
1	Drink 1	Intake 1	36	34066	1335992074	/users/cn/jespinosa/phecomp/data/CRG/20120502_FDF_CRG/20120502_FDF_CRG/20120502_FDF_CRG_c12.mtb	359	NA	WWSS	water	1	34030	1335992038	1	0.04	0.00111111111111111	2071	1
1	Drink 2	Intake 2	28	34145	1335992153	/users/cn/jespinosa/phecomp/data/CRG/20120502_FDF_CRG/20120502_FDF_CRG/20120502_FDF_CRG_c12.mtb	121	NA	WWSS	water	2	34117	1335992125	1	0.02	0.000714285714285714	2072	1
1	Food 2	Intake 4	186	34339	1335992347	/users/cn/jespinosa/phecomp/data/CRG/20120502_FDF_CRG/20120502_FDF_CRG/20120502_FDF_CRG_c12.mtb	202	33	WWSS	food_sc	4	34153	1335992161	1	0.02	0.00010752688172043	2073	1
1	Food 2	Intake 4	282	34654	1335992662	/users/cn/jespinosa/phecomp/data/CRG/20120502_FDF_CRG/20120502_FDF_CRG/20120502_FDF_CRG_c12.mtb	203	526	WWSS	food_sc	4	34372	1335992380	1	0.1	0.000354609929078014	2074	1
1	Drink 1	Intake 1	42	34690	1335992698	/users/cn/jespinosa/phecomp/data/CRG/20120502_FDF_CRG/20120502_FDF_CRG/20120502_FDF_CRG_c12.mtb	361	NA	WWSS	water	1	34648	1335992656	1	0.08	0.0019047619047619	2075	1
1	Drink 1	Intake 1	22	34840	1335992848	/users/cn/jespinosa/phecomp/data/CRG/20120502_FDF_CRG/20120502_FDF_CRG/20120502_FDF_CRG_c12.mtb	363	NA	WWSS	water	1	34818	1335992826	1	0.02	0.000909090909090909	2076	1
1	Drink 1	Intake 1	17	35072	1335993080	/users/cn/jespinosa/phecomp/data/CRG/20120502_FDF_CRG/20120502_FDF_CRG/20120502_FDF_CRG_c12.mtb	366	NA	WWSS	water	1	35055	1335993063	1	0.04	0.00235294117647059	2077	1
1	Food 2	Intake 4	31	35211	1335993219	/users/cn/jespinosa/phecomp/data/CRG/20120502_FDF_CRG/20120502_FDF_CRG/20120502_FDF_CRG_c12.mtb	204	8	WWSS	food_sc	4	35180	1335993188	1	0.02	0.000645161290322581	2078	1
1	Food 2	Intake 4	135	35354	1335993362	/users/cn/jespinosa/phecomp/data/CRG/20120502_FDF_CRG/20120502_FDF_CRG/20120502_FDF_CRG_c12.mtb	205	877	WWSS	food_sc	4	35219	1335993227	1	0.0600000000000001	0.000444444444444445	2079	1
1	Drink 2	Intake 2	22	35374	1335993382	/users/cn/jespinosa/phecomp/data/CRG/20120502_FDF_CRG/20120502_FDF_CRG/20120502_FDF_CRG_c12.mtb	124	NA	WWSS	water	2	35352	1335993360	1	0.02	0.000909090909090909	2080	1
1	Drink 2	Intake 2	18	35434	1335993442	/users/cn/jespinosa/phecomp/data/CRG/20120502_FDF_CRG/20120502_FDF_CRG/20120502_FDF_CRG_c12.mtb	125	NA	WWSS	water	2	35416	1335993424	1	0.02	0.00111111111111111	2081	1
1	Drink 1	Intake 1	18	35749	1335993757	/users/cn/jespinosa/phecomp/data/CRG/20120502_FDF_CRG/20120502_FDF_CRG/20120502_FDF_CRG_c12.mtb	374	NA	WWSS	water	1	35731	1335993739	1	0.02	0.00111111111111111	2082	1
1	Drink 1	Intake 1	27	35906	1335993914	/users/cn/jespinosa/phecomp/data/CRG/20120502_FDF_CRG/20120502_FDF_CRG/20120502_FDF_CRG_c12.mtb	375	NA	WWSS	water	1	35879	1335993887	1	0.0599999999999999	0.00222222222222222	2083	1
1	Food 2	Intake 4	83	36314	1335994322	/users/cn/jespinosa/phecomp/data/CRG/20120502_FDF_CRG/20120502_FDF_CRG/20120502_FDF_CRG_c12.mtb	206	11	WWSS	food_sc	4	36231	1335994239	1	0.02	0.000240963855421687	2084	1
1	Food 2	Intake 4	124	36449	1335994457	/users/cn/jespinosa/phecomp/data/CRG/20120502_FDF_CRG/20120502_FDF_CRG/20120502_FDF_CRG_c12.mtb	207	1876	WWSS	food_sc	4	36325	1335994333	1	0.0399999999999999	0.00032258064516129	2085	1
1	Food 2	Intake 4	342	38667	1335996675	/users/cn/jespinosa/phecomp/data/CRG/20120502_FDF_CRG/20120502_FDF_CRG/20120502_FDF_CRG_c12.mtb	209	611	WWSS	food_sc	4	38325	1335996333	1	0.0600000000000001	0.000175438596491228	2086	1
1	Drink 2	Intake 2	44	39275	1335997283	/users/cn/jespinosa/phecomp/data/CRG/20120502_FDF_CRG/20120502_FDF_CRG/20120502_FDF_CRG_c12.mtb	130	NA	WWSS	water	2	39231	1335997239	1	0.04	0.000909090909090909	2087	1
1	Food 2	Intake 4	183	39461	1335997469	/users/cn/jespinosa/phecomp/data/CRG/20120502_FDF_CRG/20120502_FDF_CRG/20120502_FDF_CRG_c12.mtb	213	6	WWSS	food_sc	4	39278	1335997286	1	0.0399999999999999	0.000218579234972677	2088	1
1	Food 2	Intake 4	113	39580	1335997588	/users/cn/jespinosa/phecomp/data/CRG/20120502_FDF_CRG/20120502_FDF_CRG/20120502_FDF_CRG_c12.mtb	214	754	WWSS	food_sc	4	39467	1335997475	1	0.02	0.000176991150442478	2089	1
1	Drink 1	Intake 1	21	39795	1335997803	/users/cn/jespinosa/phecomp/data/CRG/20120502_FDF_CRG/20120502_FDF_CRG/20120502_FDF_CRG_c12.mtb	395	NA	WWSS	water	1	39774	1335997782	1	0.02	0.000952380952380952	2090	1
1	Drink 1	Intake 1	52	40117	1335998125	/users/cn/jespinosa/phecomp/data/CRG/20120502_FDF_CRG/20120502_FDF_CRG/20120502_FDF_CRG_c12.mtb	398	NA	WWSS	water	1	40065	1335998073	1	0.0599999999999999	0.00115384615384615	2091	1
1	Food 1	Intake 3	309	40643	1335998651	/users/cn/jespinosa/phecomp/data/CRG/20120502_FDF_CRG/20120502_FDF_CRG/20120502_FDF_CRG_c12.mtb	262	113	WWSS	food_sc	3	40334	1335998342	1	0.12	0.000388349514563107	2092	1
1	Drink 1	Intake 1	33	40668	1335998676	/users/cn/jespinosa/phecomp/data/CRG/20120502_FDF_CRG/20120502_FDF_CRG/20120502_FDF_CRG_c12.mtb	401	NA	WWSS	water	1	40635	1335998643	1	0.0600000000000001	0.00181818181818182	2093	1
1	Drink 2	Intake 2	15	40676	1335998684	/users/cn/jespinosa/phecomp/data/CRG/20120502_FDF_CRG/20120502_FDF_CRG/20120502_FDF_CRG_c12.mtb	132	NA	WWSS	water	2	40661	1335998669	1	0.02	0.00133333333333333	2094	1
1	Food 1	Intake 3	220	40976	1335998984	/users/cn/jespinosa/phecomp/data/CRG/20120502_FDF_CRG/20120502_FDF_CRG/20120502_FDF_CRG_c12.mtb	263	748	WWSS	food_sc	3	40756	1335998764	1	0.08	0.000363636363636364	2095	1
1	Drink 2	Intake 2	55	41022	1335999030	/users/cn/jespinosa/phecomp/data/CRG/20120502_FDF_CRG/20120502_FDF_CRG/20120502_FDF_CRG_c12.mtb	133	NA	WWSS	water	2	40967	1335998975	1	0.0800000000000001	0.00145454545454546	2096	1
1	Drink 1	Intake 1	34	41337	1335999345	/users/cn/jespinosa/phecomp/data/CRG/20120502_FDF_CRG/20120502_FDF_CRG/20120502_FDF_CRG_c12.mtb	406	NA	WWSS	water	1	41303	1335999311	1	0.02	0.000588235294117647	2097	1
1	Food 1	Intake 3	204	41928	1335999936	/users/cn/jespinosa/phecomp/data/CRG/20120502_FDF_CRG/20120502_FDF_CRG/20120502_FDF_CRG_c12.mtb	266	143	WWSS	food_sc	3	41724	1335999732	1	0.02	9.80392156862745e-05	2098	1
1	Drink 1	Intake 1	18	41964	1335999972	/users/cn/jespinosa/phecomp/data/CRG/20120502_FDF_CRG/20120502_FDF_CRG/20120502_FDF_CRG_c12.mtb	412	NA	WWSS	water	1	41946	1335999954	1	0.02	0.00111111111111111	2099	1
1	Food 2	Intake 4	313	42384	1336000392	/users/cn/jespinosa/phecomp/data/CRG/20120502_FDF_CRG/20120502_FDF_CRG/20120502_FDF_CRG_c12.mtb	225	265	WWSS	food_sc	4	42071	1336000079	1	0.1	0.000319488817891374	2100	1
1	Drink 1	Intake 1	73	42448	1336000456	/users/cn/jespinosa/phecomp/data/CRG/20120502_FDF_CRG/20120502_FDF_CRG/20120502_FDF_CRG_c12.mtb	415	NA	WWSS	water	1	42375	1336000383	1	0.0800000000000001	0.00109589041095891	2101	1
1	Drink 1	Intake 1	33	42492	1336000500	/users/cn/jespinosa/phecomp/data/CRG/20120502_FDF_CRG/20120502_FDF_CRG/20120502_FDF_CRG_c12.mtb	416	NA	WWSS	water	1	42459	1336000467	1	0.02	0.000606060606060606	2102	1
1	Food 2	Intake 4	107	42756	1336000764	/users/cn/jespinosa/phecomp/data/CRG/20120502_FDF_CRG/20120502_FDF_CRG/20120502_FDF_CRG_c12.mtb	226	7745	WWSS	food_sc	4	42649	1336000657	1	0.04	0.000373831775700935	2103	1
1	Drink 1	Intake 1	94	42843	1336000851	/users/cn/jespinosa/phecomp/data/CRG/20120502_FDF_CRG/20120502_FDF_CRG/20120502_FDF_CRG_c12.mtb	420	NA	WWSS	water	1	42749	1336000757	1	0.08	0.000851063829787234	2104	1
1	Drink 1	Intake 1	52	43051	1336001059	/users/cn/jespinosa/phecomp/data/CRG/20120502_FDF_CRG/20120502_FDF_CRG/20120502_FDF_CRG_c12.mtb	424	NA	WWSS	water	1	42999	1336001007	1	0.02	0.000384615384615385	2105	1
1	Drink 2	Intake 2	17	43492	1336001500	/users/cn/jespinosa/phecomp/data/CRG/20120502_FDF_CRG/20120502_FDF_CRG/20120502_FDF_CRG_c12.mtb	136	NA	WWSS	water	2	43475	1336001483	1	0.02	0.00117647058823529	2106	1
1	Drink 1	Intake 1	17	44478	1336002486	/users/cn/jespinosa/phecomp/data/CRG/20120502_FDF_CRG/20120502_FDF_CRG/20120502_FDF_CRG_c12.mtb	435	NA	WWSS	water	1	44461	1336002469	1	0.02	0.00117647058823529	2107	1
1	Food 1	Intake 3	340	50841	1336008849	/users/cn/jespinosa/phecomp/data/CRG/20120502_FDF_CRG/20120502_FDF_CRG/20120502_FDF_CRG_c12.mtb	269	COLL	WWSS	food_sc	3	50501	1336008509	1	0.1	0.000294117647058824	2108	1
1	Food 2	Intake 4	17	50557	1336008565	/users/cn/jespinosa/phecomp/data/CRG/20120502_FDF_CRG/20120502_FDF_CRG/20120502_FDF_CRG_c12.mtb	233	353	WWSS	food_sc	4	50540	1336008548	1	0.02	0.00117647058823529	2109	1
1	Food 1	Intake 3	274	51184	1336009192	/users/cn/jespinosa/phecomp/data/CRG/20120502_FDF_CRG/20120502_FDF_CRG/20120502_FDF_CRG_c12.mtb	271	370	WWSS	food_sc	3	50910	1336008918	1	0.0599999999999998	0.00021897810218978	2110	1
1	Drink 1	Intake 1	26	51207	1336009215	/users/cn/jespinosa/phecomp/data/CRG/20120502_FDF_CRG/20120502_FDF_CRG/20120502_FDF_CRG_c12.mtb	446	NA	WWSS	water	1	51181	1336009189	1	0.0600000000000001	0.00230769230769231	2111	1
1	Drink 2	Intake 2	24	51440	1336009448	/users/cn/jespinosa/phecomp/data/CRG/20120502_FDF_CRG/20120502_FDF_CRG/20120502_FDF_CRG_c12.mtb	138	NA	WWSS	water	2	51416	1336009424	1	0.04	0.00166666666666667	2112	1
1	Drink 2	Intake 2	15	51525	1336009533	/users/cn/jespinosa/phecomp/data/CRG/20120502_FDF_CRG/20120502_FDF_CRG/20120502_FDF_CRG_c12.mtb	139	NA	WWSS	water	2	51510	1336009518	1	0.02	0.00133333333333333	2113	1
1	Food 2	Intake 4	232	51786	1336009794	/users/cn/jespinosa/phecomp/data/CRG/20120502_FDF_CRG/20120502_FDF_CRG/20120502_FDF_CRG_c12.mtb	237	237	WWSS	food_sc	4	51554	1336009562	1	0.02	8.62068965517241e-05	2114	1
1	Drink 2	Intake 2	42	51820	1336009828	/users/cn/jespinosa/phecomp/data/CRG/20120502_FDF_CRG/20120502_FDF_CRG/20120502_FDF_CRG_c12.mtb	140	NA	WWSS	water	2	51778	1336009786	1	0.12	0.00285714285714286	2115	1
1	Food 1	Intake 3	119	52142	1336010150	/users/cn/jespinosa/phecomp/data/CRG/20120502_FDF_CRG/20120502_FDF_CRG/20120502_FDF_CRG_c12.mtb	275	144	WWSS	food_sc	3	52023	1336010031	1	0.04	0.000336134453781513	2116	1
1	Drink 1	Intake 1	29	52176	1336010184	/users/cn/jespinosa/phecomp/data/CRG/20120502_FDF_CRG/20120502_FDF_CRG/20120502_FDF_CRG_c12.mtb	453	NA	WWSS	water	1	52147	1336010155	1	0.04	0.00137931034482759	2117	1
1	Food 1	Intake 3	195	52481	1336010489	/users/cn/jespinosa/phecomp/data/CRG/20120502_FDF_CRG/20120502_FDF_CRG/20120502_FDF_CRG_c12.mtb	278	450	WWSS	food_sc	3	52286	1336010294	1	0.0800000000000001	0.000410256410256411	2118	1
1	Drink 1	Intake 1	36	52513	1336010521	/users/cn/jespinosa/phecomp/data/CRG/20120502_FDF_CRG/20120502_FDF_CRG/20120502_FDF_CRG_c12.mtb	455	NA	WWSS	water	1	52477	1336010485	1	0.0599999999999998	0.00166666666666666	2119	1
1	Drink 2	Intake 2	16	52627	1336010635	/users/cn/jespinosa/phecomp/data/CRG/20120502_FDF_CRG/20120502_FDF_CRG/20120502_FDF_CRG_c12.mtb	141	NA	WWSS	water	2	52611	1336010619	1	0.04	0.0025	2120	1
1	Drink 2	Intake 2	27	52861	1336010869	/users/cn/jespinosa/phecomp/data/CRG/20120502_FDF_CRG/20120502_FDF_CRG/20120502_FDF_CRG_c12.mtb	142	NA	WWSS	water	2	52834	1336010842	1	0.04	0.00148148148148148	2121	1
1	Food 1	Intake 3	81	53012	1336011020	/users/cn/jespinosa/phecomp/data/CRG/20120502_FDF_CRG/20120502_FDF_CRG/20120502_FDF_CRG_c12.mtb	279	9	WWSS	food_sc	3	52931	1336010939	1	0.04	0.000493827160493827	2122	1
1	Food 1	Intake 3	56	53077	1336011085	/users/cn/jespinosa/phecomp/data/CRG/20120502_FDF_CRG/20120502_FDF_CRG/20120502_FDF_CRG_c12.mtb	280	75	WWSS	food_sc	3	53021	1336011029	1	0.0399999999999998	0.000714285714285711	2123	1
1	Drink 1	Intake 1	30	53097	1336011105	/users/cn/jespinosa/phecomp/data/CRG/20120502_FDF_CRG/20120502_FDF_CRG/20120502_FDF_CRG_c12.mtb	459	NA	WWSS	water	1	53067	1336011075	1	0.04	0.00133333333333333	2124	1
1	Food 2	Intake 4	245	53397	1336011405	/users/cn/jespinosa/phecomp/data/CRG/20120502_FDF_CRG/20120502_FDF_CRG/20120502_FDF_CRG_c12.mtb	244	260	WWSS	food_sc	4	53152	1336011160	1	0.0600000000000001	0.000244897959183674	2125	1
1	Drink 1	Intake 1	59	53451	1336011459	/users/cn/jespinosa/phecomp/data/CRG/20120502_FDF_CRG/20120502_FDF_CRG/20120502_FDF_CRG_c12.mtb	460	NA	WWSS	water	1	53392	1336011400	1	0.12	0.00203389830508475	2126	1
1	Food 2	Intake 4	112	53769	1336011777	/users/cn/jespinosa/phecomp/data/CRG/20120502_FDF_CRG/20120502_FDF_CRG/20120502_FDF_CRG_c12.mtb	246	12	WWSS	food_sc	4	53657	1336011665	1	0.02	0.000178571428571429	2127	1
1	Food 1	Intake 3	47	53828	1336011836	/users/cn/jespinosa/phecomp/data/CRG/20120502_FDF_CRG/20120502_FDF_CRG/20120502_FDF_CRG_c12.mtb	281	6	WWSS	food_sc	3	53781	1336011789	1	0.02	0.000425531914893617	2128	1
1	Food 1	Intake 3	199	54033	1336012041	/users/cn/jespinosa/phecomp/data/CRG/20120502_FDF_CRG/20120502_FDF_CRG/20120502_FDF_CRG_c12.mtb	282	895	WWSS	food_sc	3	53834	1336011842	1	0.02	0.000100502512562814	2129	1
1	Drink 1	Intake 1	47	54123	1336012131	/users/cn/jespinosa/phecomp/data/CRG/20120502_FDF_CRG/20120502_FDF_CRG/20120502_FDF_CRG_c12.mtb	465	NA	WWSS	water	1	54076	1336012084	1	0.02	0.000425531914893617	2130	1
1	Drink 2	Intake 2	18	54135	1336012143	/users/cn/jespinosa/phecomp/data/CRG/20120502_FDF_CRG/20120502_FDF_CRG/20120502_FDF_CRG_c12.mtb	143	NA	WWSS	water	2	54117	1336012125	1	0.02	0.00111111111111111	2131	1
1	Drink 2	Intake 2	17	54462	1336012470	/users/cn/jespinosa/phecomp/data/CRG/20120502_FDF_CRG/20120502_FDF_CRG/20120502_FDF_CRG_c12.mtb	145	NA	WWSS	water	2	54445	1336012453	1	0.02	0.00117647058823529	2132	1
1	Food 1	Intake 3	36	54964	1336012972	/users/cn/jespinosa/phecomp/data/CRG/20120502_FDF_CRG/20120502_FDF_CRG/20120502_FDF_CRG_c12.mtb	284	685	WWSS	food_sc	3	54928	1336012936	1	0.02	0.000555555555555556	2133	1
1	Drink 2	Intake 2	22	55038	1336013046	/users/cn/jespinosa/phecomp/data/CRG/20120502_FDF_CRG/20120502_FDF_CRG/20120502_FDF_CRG_c12.mtb	146	NA	WWSS	water	2	55016	1336013024	1	0.0399999999999998	0.00181818181818181	2134	1
1	Food 1	Intake 3	39	55688	1336013696	/users/cn/jespinosa/phecomp/data/CRG/20120502_FDF_CRG/20120502_FDF_CRG/20120502_FDF_CRG_c12.mtb	285	4808	WWSS	food_sc	3	55649	1336013657	1	0.02	0.000512820512820513	2135	1
1	Drink 2	Intake 2	18	56181	1336014189	/users/cn/jespinosa/phecomp/data/CRG/20120502_FDF_CRG/20120502_FDF_CRG/20120502_FDF_CRG_c12.mtb	149	NA	WWSS	water	2	56163	1336014171	1	0.02	0.00111111111111111	2136	1
1	Food 1	Intake 3	172	60668	1336018676	/users/cn/jespinosa/phecomp/data/CRG/20120502_FDF_CRG/20120502_FDF_CRG/20120502_FDF_CRG_c12.mtb	292	21	WWSS	food_sc	3	60496	1336018504	1	0.04	0.000232558139534884	2137	1
1	Food 1	Intake 3	299	60988	1336018996	/users/cn/jespinosa/phecomp/data/CRG/20120502_FDF_CRG/20120502_FDF_CRG/20120502_FDF_CRG_c12.mtb	293	323	WWSS	food_sc	3	60689	1336018697	1	0.1	0.000334448160535117	2138	1
1	Drink 1	Intake 1	37	61019	1336019027	/users/cn/jespinosa/phecomp/data/CRG/20120502_FDF_CRG/20120502_FDF_CRG/20120502_FDF_CRG_c12.mtb	485	NA	WWSS	water	1	60982	1336018990	1	0.0600000000000001	0.00162162162162162	2139	1
1	Drink 2	Intake 2	16	61065	1336019073	/users/cn/jespinosa/phecomp/data/CRG/20120502_FDF_CRG/20120502_FDF_CRG/20120502_FDF_CRG_c12.mtb	150	NA	WWSS	water	2	61049	1336019057	1	0.02	0.00125	2140	1
1	Drink 2	Intake 2	21	61182	1336019190	/users/cn/jespinosa/phecomp/data/CRG/20120502_FDF_CRG/20120502_FDF_CRG/20120502_FDF_CRG_c12.mtb	151	NA	WWSS	water	2	61161	1336019169	1	0.0600000000000001	0.00285714285714286	2141	1
1	Food 1	Intake 3	145	61456	1336019464	/users/cn/jespinosa/phecomp/data/CRG/20120502_FDF_CRG/20120502_FDF_CRG/20120502_FDF_CRG_c12.mtb	296	467	WWSS	food_sc	3	61311	1336019319	1	0.02	0.000137931034482759	2142	1
1	Drink 1	Intake 1	23	61473	1336019481	/users/cn/jespinosa/phecomp/data/CRG/20120502_FDF_CRG/20120502_FDF_CRG/20120502_FDF_CRG_c12.mtb	488	NA	WWSS	water	1	61450	1336019458	1	0.0800000000000001	0.00347826086956522	2143	1
1	Drink 1	Intake 1	18	61798	1336019806	/users/cn/jespinosa/phecomp/data/CRG/20120502_FDF_CRG/20120502_FDF_CRG/20120502_FDF_CRG_c12.mtb	489	NA	WWSS	water	1	61780	1336019788	1	0.02	0.00111111111111111	2144	1
1	Food 1	Intake 3	316	62239	1336020247	/users/cn/jespinosa/phecomp/data/CRG/20120502_FDF_CRG/20120502_FDF_CRG/20120502_FDF_CRG_c12.mtb	300	917	WWSS	food_sc	3	61923	1336019931	1	0.0999999999999999	0.000316455696202531	2145	1
1	Drink 1	Intake 1	78	62309	1336020317	/users/cn/jespinosa/phecomp/data/CRG/20120502_FDF_CRG/20120502_FDF_CRG/20120502_FDF_CRG_c12.mtb	491	NA	WWSS	water	1	62231	1336020239	1	0.2	0.00256410256410256	2146	1
1	Food 1	Intake 3	118	63274	1336021282	/users/cn/jespinosa/phecomp/data/CRG/20120502_FDF_CRG/20120502_FDF_CRG/20120502_FDF_CRG_c12.mtb	304	117	WWSS	food_sc	3	63156	1336021164	1	0.02	0.000169491525423729	2147	1
1	Food 1	Intake 3	147	63538	1336021546	/users/cn/jespinosa/phecomp/data/CRG/20120502_FDF_CRG/20120502_FDF_CRG/20120502_FDF_CRG_c12.mtb	306	12018	WWSS	food_sc	3	63391	1336021399	1	0.04	0.000272108843537415	2148	1
1	Drink 2	Intake 2	25	63559	1336021567	/users/cn/jespinosa/phecomp/data/CRG/20120502_FDF_CRG/20120502_FDF_CRG/20120502_FDF_CRG_c12.mtb	152	NA	WWSS	water	2	63534	1336021542	1	0.0600000000000001	0.0024	2149	1
1	Drink 1	Intake 1	57	64441	1336022449	/users/cn/jespinosa/phecomp/data/CRG/20120502_FDF_CRG/20120502_FDF_CRG/20120502_FDF_CRG_c12.mtb	501	NA	WWSS	water	1	64384	1336022392	1	0.02	0.000350877192982456	2150	1
1	Drink 1	Intake 1	87	64975	1336022983	/users/cn/jespinosa/phecomp/data/CRG/20120502_FDF_CRG/20120502_FDF_CRG/20120502_FDF_CRG_c12.mtb	508	NA	WWSS	water	1	64888	1336022896	1	0.04	0.000459770114942529	2151	1
1	Drink 2	Intake 2	17	65423	1336023431	/users/cn/jespinosa/phecomp/data/CRG/20120502_FDF_CRG/20120502_FDF_CRG/20120502_FDF_CRG_c12.mtb	161	NA	WWSS	water	2	65406	1336023414	1	0.02	0.00117647058823529	2152	1
1	Drink 2	Intake 2	17	66569	1336024577	/users/cn/jespinosa/phecomp/data/CRG/20120502_FDF_CRG/20120502_FDF_CRG/20120502_FDF_CRG_c12.mtb	166	NA	WWSS	water	2	66552	1336024560	1	0.02	0.00117647058823529	2153	1
1	Drink 2	Intake 2	33	75363	1336033371	/users/cn/jespinosa/phecomp/data/CRG/20120502_FDF_CRG/20120502_FDF_CRG/20120502_FDF_CRG_c12.mtb	168	NA	WWSS	water	2	75330	1336033338	1	0.04	0.00121212121212121	2154	1
1	Drink 2	Intake 2	17	75434	1336033442	/users/cn/jespinosa/phecomp/data/CRG/20120502_FDF_CRG/20120502_FDF_CRG/20120502_FDF_CRG_c12.mtb	169	NA	WWSS	water	2	75417	1336033425	1	0.02	0.00117647058823529	2155	1
1	Food 2	Intake 4	107	75663	1336033671	/users/cn/jespinosa/phecomp/data/CRG/20120502_FDF_CRG/20120502_FDF_CRG/20120502_FDF_CRG_c12.mtb	279	7351	WWSS	food_sc	4	75556	1336033564	1	0.02	0.000186915887850467	2156	1
1	Drink 1	Intake 1	27	76167	1336034175	/users/cn/jespinosa/phecomp/data/CRG/20120502_FDF_CRG/20120502_FDF_CRG/20120502_FDF_CRG_c12.mtb	547	NA	WWSS	water	1	76140	1336034148	1	0.0800000000000001	0.00296296296296297	2157	1
1	Drink 1	Intake 1	22	82521	1336040529	/users/cn/jespinosa/phecomp/data/CRG/20120502_FDF_CRG/20120502_FDF_CRG/20120502_FDF_CRG_c12.mtb	550	NA	WWSS	water	1	82499	1336040507	1	0.02	0.000909090909090909	2158	1
1	Drink 2	Intake 2	19	82543	1336040551	/users/cn/jespinosa/phecomp/data/CRG/20120502_FDF_CRG/20120502_FDF_CRG/20120502_FDF_CRG_c12.mtb	170	NA	WWSS	water	2	82524	1336040532	1	0.0600000000000001	0.00315789473684211	2159	1
1	Food 1	Intake 3	447	83461	1336041469	/users/cn/jespinosa/phecomp/data/CRG/20120502_FDF_CRG/20120502_FDF_CRG/20120502_FDF_CRG_c12.mtb	313	10564	WWSS	food_sc	3	83014	1336041022	1	0.0999999999999999	0.000223713646532438	2160	1
1	Drink 2	Intake 2	24	83521	1336041529	/users/cn/jespinosa/phecomp/data/CRG/20120502_FDF_CRG/20120502_FDF_CRG/20120502_FDF_CRG_c12.mtb	173	NA	WWSS	water	2	83497	1336041505	1	0.0800000000000001	0.00333333333333334	2161	1
1	Drink 2	Intake 2	23	84094	1336042102	/users/cn/jespinosa/phecomp/data/CRG/20120502_FDF_CRG/20120502_FDF_CRG/20120502_FDF_CRG_c12.mtb	174	NA	WWSS	water	2	84071	1336042079	1	0.02	0.000869565217391304	2162	1
1	Drink 1	Intake 1	70	84155	1336042163	/users/cn/jespinosa/phecomp/data/CRG/20120502_FDF_CRG/20120502_FDF_CRG/20120502_FDF_CRG_c12.mtb	557	NA	WWSS	water	1	84085	1336042093	1	0.02	0.000285714285714286	2163	1
1	Drink 1	Intake 1	89	84401	1336042409	/users/cn/jespinosa/phecomp/data/CRG/20120502_FDF_CRG/20120502_FDF_CRG/20120502_FDF_CRG_c12.mtb	560	NA	WWSS	water	1	84312	1336042320	1	0.02	0.000224719101123596	2164	1
1	Drink 2	Intake 2	13	85500	1336043508	/users/cn/jespinosa/phecomp/data/CRG/20120502_FDF_CRG/20120502_FDF_CRG/20120502_FDF_CRG_c12.mtb	176	NA	WWSS	water	2	85487	1336043495	1	0.02	0.00153846153846154	2165	1
1	Food 1	Intake 3	265	94290	1336052298	/users/cn/jespinosa/phecomp/data/CRG/20120502_FDF_CRG/20120502_FDF_CRG/20120502_FDF_CRG_c12.mtb	317	104	WWSS	food_sc	3	94025	1336052033	1	0.02	7.54716981132076e-05	2166	1
1	Drink 2	Intake 2	14	94346	1336052354	/users/cn/jespinosa/phecomp/data/CRG/20120502_FDF_CRG/20120502_FDF_CRG/20120502_FDF_CRG_c12.mtb	177	NA	WWSS	water	2	94332	1336052340	1	0.0599999999999998	0.00428571428571427	2167	1
1	Food 1	Intake 3	47	94441	1336052449	/users/cn/jespinosa/phecomp/data/CRG/20120502_FDF_CRG/20120502_FDF_CRG/20120502_FDF_CRG_c12.mtb	318	7397	WWSS	food_sc	3	94394	1336052402	1	0.02	0.000425531914893617	2168	1
1	Drink 1	Intake 1	18	101414	1336059422	/users/cn/jespinosa/phecomp/data/CRG/20120502_FDF_CRG/20120502_FDF_CRG/20120502_FDF_CRG_c12.mtb	572	NA	WWSS	water	1	101396	1336059404	1	0.02	0.00111111111111111	2169	1
1	Drink 2	Intake 2	14	101423	1336059431	/users/cn/jespinosa/phecomp/data/CRG/20120502_FDF_CRG/20120502_FDF_CRG/20120502_FDF_CRG_c12.mtb	178	NA	WWSS	water	2	101409	1336059417	1	0.12	0.00857142857142857	2170	1
1	Food 1	Intake 3	636	102474	1336060482	/users/cn/jespinosa/phecomp/data/CRG/20120502_FDF_CRG/20120502_FDF_CRG/20120502_FDF_CRG_c12.mtb	320	6898	WWSS	food_sc	3	101838	1336059846	1	0.14	0.000220125786163522	2171	1
1	Drink 2	Intake 2	22	103038	1336061046	/users/cn/jespinosa/phecomp/data/CRG/20120502_FDF_CRG/20120502_FDF_CRG/20120502_FDF_CRG_c12.mtb	179	NA	WWSS	water	2	103016	1336061024	1	0.04	0.00181818181818182	2172	1
1	Food 1	Intake 3	612	109984	1336067992	/users/cn/jespinosa/phecomp/data/CRG/20120502_FDF_CRG/20120502_FDF_CRG/20120502_FDF_CRG_c12.mtb	325	1856	WWSS	food_sc	3	109372	1336067380	1	0.1	0.000163398692810458	2173	1
1	Drink 1	Intake 1	25	110546	1336068554	/users/cn/jespinosa/phecomp/data/CRG/20120502_FDF_CRG/20120502_FDF_CRG/20120502_FDF_CRG_c12.mtb	576	NA	WWSS	water	1	110521	1336068529	1	0.04	0.0016	2174	1
1	Food 1	Intake 3	582	112422	1336070430	/users/cn/jespinosa/phecomp/data/CRG/20120502_FDF_CRG/20120502_FDF_CRG/20120502_FDF_CRG_c12.mtb	326	896	WWSS	food_sc	3	111840	1336069848	1	0.22	0.000378006872852234	2175	1
1	Drink 2	Intake 2	28	112447	1336070455	/users/cn/jespinosa/phecomp/data/CRG/20120502_FDF_CRG/20120502_FDF_CRG/20120502_FDF_CRG_c12.mtb	180	NA	WWSS	water	2	112419	1336070427	1	0.0600000000000001	0.00214285714285715	2176	1
1	Drink 1	Intake 1	16	112849	1336070857	/users/cn/jespinosa/phecomp/data/CRG/20120502_FDF_CRG/20120502_FDF_CRG/20120502_FDF_CRG_c12.mtb	581	NA	WWSS	water	1	112833	1336070841	1	0.0800000000000001	0.00500000000000001	2177	1
1	Drink 1	Intake 1	17	113286	1336071294	/users/cn/jespinosa/phecomp/data/CRG/20120502_FDF_CRG/20120502_FDF_CRG/20120502_FDF_CRG_c12.mtb	582	NA	WWSS	water	1	113269	1336071277	1	0.02	0.00117647058823529	2178	1
1	Food 1	Intake 3	116	113434	1336071442	/users/cn/jespinosa/phecomp/data/CRG/20120502_FDF_CRG/20120502_FDF_CRG/20120502_FDF_CRG_c12.mtb	328	5	WWSS	food_sc	3	113318	1336071326	1	0.0600000000000001	0.000517241379310346	2179	1
1	Food 1	Intake 3	113	113552	1336071560	/users/cn/jespinosa/phecomp/data/CRG/20120502_FDF_CRG/20120502_FDF_CRG/20120502_FDF_CRG_c12.mtb	329	444	WWSS	food_sc	3	113439	1336071447	1	0.0600000000000001	0.000530973451327435	2180	1
1	Drink 1	Intake 1	26	113743	1336071751	/users/cn/jespinosa/phecomp/data/CRG/20120502_FDF_CRG/20120502_FDF_CRG/20120502_FDF_CRG_c12.mtb	585	NA	WWSS	water	1	113717	1336071725	1	0.02	0.000769230769230769	2181	1
1	Food 1	Intake 3	87	114083	1336072091	/users/cn/jespinosa/phecomp/data/CRG/20120502_FDF_CRG/20120502_FDF_CRG/20120502_FDF_CRG_c12.mtb	330	91	WWSS	food_sc	3	113996	1336072004	1	0.04	0.000459770114942529	2182	1
1	Drink 1	Intake 1	41	114113	1336072121	/users/cn/jespinosa/phecomp/data/CRG/20120502_FDF_CRG/20120502_FDF_CRG/20120502_FDF_CRG_c12.mtb	587	NA	WWSS	water	1	114072	1336072080	1	0.0600000000000001	0.00146341463414634	2183	1
1	Food 1	Intake 3	56	114230	1336072238	/users/cn/jespinosa/phecomp/data/CRG/20120502_FDF_CRG/20120502_FDF_CRG/20120502_FDF_CRG_c12.mtb	331	59	WWSS	food_sc	3	114174	1336072182	1	0.02	0.000357142857142857	2184	1
1	Food 1	Intake 3	77	114366	1336072374	/users/cn/jespinosa/phecomp/data/CRG/20120502_FDF_CRG/20120502_FDF_CRG/20120502_FDF_CRG_c12.mtb	332	109	WWSS	food_sc	3	114289	1336072297	1	0.02	0.00025974025974026	2185	1
1	Drink 1	Intake 1	24	114396	1336072404	/users/cn/jespinosa/phecomp/data/CRG/20120502_FDF_CRG/20120502_FDF_CRG/20120502_FDF_CRG_c12.mtb	589	NA	WWSS	water	1	114372	1336072380	1	0.04	0.00166666666666667	2186	1
1	Food 1	Intake 3	275	114750	1336072758	/users/cn/jespinosa/phecomp/data/CRG/20120502_FDF_CRG/20120502_FDF_CRG/20120502_FDF_CRG_c12.mtb	333	667	WWSS	food_sc	3	114475	1336072483	1	0.02	7.27272727272727e-05	2187	1
1	Drink 2	Intake 2	18	115393	1336073401	/users/cn/jespinosa/phecomp/data/CRG/20120502_FDF_CRG/20120502_FDF_CRG/20120502_FDF_CRG_c12.mtb	184	NA	WWSS	water	2	115375	1336073383	1	0.02	0.00111111111111111	2188	1
1	Food 1	Intake 3	192	115609	1336073617	/users/cn/jespinosa/phecomp/data/CRG/20120502_FDF_CRG/20120502_FDF_CRG/20120502_FDF_CRG_c12.mtb	335	1006	WWSS	food_sc	3	115417	1336073425	1	0.5	0.00260416666666667	2189	1
1	Drink 1	Intake 1	44	115768	1336073776	/users/cn/jespinosa/phecomp/data/CRG/20120502_FDF_CRG/20120502_FDF_CRG/20120502_FDF_CRG_c12.mtb	596	NA	WWSS	water	1	115724	1336073732	1	0.0999999999999996	0.00227272727272726	2190	1
1	Drink 2	Intake 2	26	116233	1336074241	/users/cn/jespinosa/phecomp/data/CRG/20120502_FDF_CRG/20120502_FDF_CRG/20120502_FDF_CRG_c12.mtb	185	NA	WWSS	water	2	116207	1336074215	1	0.0600000000000001	0.00230769230769231	2191	1
1	Drink 1	Intake 1	18	116471	1336074479	/users/cn/jespinosa/phecomp/data/CRG/20120502_FDF_CRG/20120502_FDF_CRG/20120502_FDF_CRG_c12.mtb	604	NA	WWSS	water	1	116453	1336074461	1	0.02	0.00111111111111111	2192	1
1	Food 1	Intake 3	195	116810	1336074818	/users/cn/jespinosa/phecomp/data/CRG/20120502_FDF_CRG/20120502_FDF_CRG/20120502_FDF_CRG_c12.mtb	340	17	WWSS	food_sc	3	116615	1336074623	1	0.0800000000000001	0.000410256410256411	2193	1
1	Food 1	Intake 3	78	116905	1336074913	/users/cn/jespinosa/phecomp/data/CRG/20120502_FDF_CRG/20120502_FDF_CRG/20120502_FDF_CRG_c12.mtb	341	46	WWSS	food_sc	3	116827	1336074835	1	0.02	0.000256410256410256	2194	1
1	Drink 1	Intake 1	36	116938	1336074946	/users/cn/jespinosa/phecomp/data/CRG/20120502_FDF_CRG/20120502_FDF_CRG/20120502_FDF_CRG_c12.mtb	605	NA	WWSS	water	1	116902	1336074910	1	0.0800000000000001	0.00222222222222222	2195	1
1	Food 1	Intake 3	34	116985	1336074993	/users/cn/jespinosa/phecomp/data/CRG/20120502_FDF_CRG/20120502_FDF_CRG/20120502_FDF_CRG_c12.mtb	342	397	WWSS	food_sc	3	116951	1336074959	1	0.02	0.000588235294117647	2196	1
1	Drink 1	Intake 1	23	117086	1336075094	/users/cn/jespinosa/phecomp/data/CRG/20120502_FDF_CRG/20120502_FDF_CRG/20120502_FDF_CRG_c12.mtb	606	NA	WWSS	water	1	117063	1336075071	1	0.04	0.00173913043478261	2197	1
1	Food 2	Intake 4	66	117448	1336075456	/users/cn/jespinosa/phecomp/data/CRG/20120502_FDF_CRG/20120502_FDF_CRG/20120502_FDF_CRG_c12.mtb	308	328	WWSS	food_sc	4	117382	1336075390	1	0.02	0.000303030303030303	2198	1
1	Drink 1	Intake 1	48	117565	1336075573	/users/cn/jespinosa/phecomp/data/CRG/20120502_FDF_CRG/20120502_FDF_CRG/20120502_FDF_CRG_c12.mtb	607	NA	WWSS	water	1	117517	1336075525	1	0.0800000000000001	0.00166666666666667	2199	1
1	Drink 1	Intake 1	16	117642	1336075650	/users/cn/jespinosa/phecomp/data/CRG/20120502_FDF_CRG/20120502_FDF_CRG/20120502_FDF_CRG_c12.mtb	608	NA	WWSS	water	1	117626	1336075634	1	0.02	0.00125	2200	1
1	Food 2	Intake 4	39	117815	1336075823	/users/cn/jespinosa/phecomp/data/CRG/20120502_FDF_CRG/20120502_FDF_CRG/20120502_FDF_CRG_c12.mtb	310	31	WWSS	food_sc	4	117776	1336075784	1	0.04	0.00102564102564103	2201	1
1	Food 2	Intake 4	56	117902	1336075910	/users/cn/jespinosa/phecomp/data/CRG/20120502_FDF_CRG/20120502_FDF_CRG/20120502_FDF_CRG_c12.mtb	311	347	WWSS	food_sc	4	117846	1336075854	1	0.02	0.000357142857142857	2202	1
1	Food 2	Intake 4	73	118322	1336076330	/users/cn/jespinosa/phecomp/data/CRG/20120502_FDF_CRG/20120502_FDF_CRG/20120502_FDF_CRG_c12.mtb	314	1866	WWSS	food_sc	4	118249	1336076257	1	0.02	0.000273972602739726	2203	1
1	Drink 1	Intake 1	18	118725	1336076733	/users/cn/jespinosa/phecomp/data/CRG/20120502_FDF_CRG/20120502_FDF_CRG/20120502_FDF_CRG_c12.mtb	616	NA	WWSS	water	1	118707	1336076715	1	0.02	0.00111111111111111	2204	1
1	Drink 2	Intake 2	19	118785	1336076793	/users/cn/jespinosa/phecomp/data/CRG/20120502_FDF_CRG/20120502_FDF_CRG/20120502_FDF_CRG_c12.mtb	188	NA	WWSS	water	2	118766	1336076774	1	0.02	0.00105263157894737	2205	1
1	Drink 2	Intake 2	20	119346	1336077354	/users/cn/jespinosa/phecomp/data/CRG/20120502_FDF_CRG/20120502_FDF_CRG/20120502_FDF_CRG_c12.mtb	189	NA	WWSS	water	2	119326	1336077334	1	0.04	0.002	2206	1
1	Drink 1	Intake 1	23	119371	1336077379	/users/cn/jespinosa/phecomp/data/CRG/20120502_FDF_CRG/20120502_FDF_CRG/20120502_FDF_CRG_c12.mtb	619	NA	WWSS	water	1	119348	1336077356	1	0.02	0.000869565217391304	2207	1
1	Drink 2	Intake 2	16	119500	1336077508	/users/cn/jespinosa/phecomp/data/CRG/20120502_FDF_CRG/20120502_FDF_CRG/20120502_FDF_CRG_c12.mtb	191	NA	WWSS	water	2	119484	1336077492	1	0.02	0.00125	2208	1
1	Drink 2	Intake 2	19	119932	1336077940	/users/cn/jespinosa/phecomp/data/CRG/20120502_FDF_CRG/20120502_FDF_CRG/20120502_FDF_CRG_c12.mtb	192	NA	WWSS	water	2	119913	1336077921	1	0.04	0.00210526315789474	2209	1
1	Food 2	Intake 4	42	120230	1336078238	/users/cn/jespinosa/phecomp/data/CRG/20120502_FDF_CRG/20120502_FDF_CRG/20120502_FDF_CRG_c12.mtb	321	4969	WWSS	food_sc	4	120188	1336078196	1	0.02	0.000476190476190476	2210	1
1	Drink 1	Intake 1	64	120313	1336078321	/users/cn/jespinosa/phecomp/data/CRG/20120502_FDF_CRG/20120502_FDF_CRG/20120502_FDF_CRG_c12.mtb	622	NA	WWSS	water	1	120249	1336078257	1	0.0800000000000001	0.00125	2211	1
1	Drink 1	Intake 1	54	120601	1336078609	/users/cn/jespinosa/phecomp/data/CRG/20120502_FDF_CRG/20120502_FDF_CRG/20120502_FDF_CRG_c12.mtb	625	NA	WWSS	water	1	120547	1336078555	1	0.04	0.000740740740740741	2212	1
1	Food 2	Intake 4	365	125564	1336083572	/users/cn/jespinosa/phecomp/data/CRG/20120502_FDF_CRG/20120502_FDF_CRG/20120502_FDF_CRG_c12.mtb	326	56	WWSS	food_sc	4	125199	1336083207	1	0.04	0.00010958904109589	2213	1
1	Food 1	Intake 3	178	125798	1336083806	/users/cn/jespinosa/phecomp/data/CRG/20120502_FDF_CRG/20120502_FDF_CRG/20120502_FDF_CRG_c12.mtb	356	217	WWSS	food_sc	3	125620	1336083628	1	0.0599999999999996	0.000337078651685391	2214	1
1	Food 2	Intake 4	27	126042	1336084050	/users/cn/jespinosa/phecomp/data/CRG/20120502_FDF_CRG/20120502_FDF_CRG/20120502_FDF_CRG_c12.mtb	330	94	WWSS	food_sc	4	126015	1336084023	1	0.04	0.00148148148148148	2215	1
1	Drink 1	Intake 1	56	126110	1336084118	/users/cn/jespinosa/phecomp/data/CRG/20120502_FDF_CRG/20120502_FDF_CRG/20120502_FDF_CRG_c12.mtb	644	NA	WWSS	water	1	126054	1336084062	1	0.12	0.00214285714285714	2216	1
1	Food 2	Intake 4	124	126260	1336084268	/users/cn/jespinosa/phecomp/data/CRG/20120502_FDF_CRG/20120502_FDF_CRG/20120502_FDF_CRG_c12.mtb	332	1981	WWSS	food_sc	4	126136	1336084144	1	0.0599999999999998	0.000483870967741934	2217	1
1	Drink 1	Intake 1	34	126420	1336084428	/users/cn/jespinosa/phecomp/data/CRG/20120502_FDF_CRG/20120502_FDF_CRG/20120502_FDF_CRG_c12.mtb	646	NA	WWSS	water	1	126386	1336084394	1	0.0600000000000001	0.00176470588235294	2218	1
1	Drink 1	Intake 1	76	126530	1336084538	/users/cn/jespinosa/phecomp/data/CRG/20120502_FDF_CRG/20120502_FDF_CRG/20120502_FDF_CRG_c12.mtb	647	NA	WWSS	water	1	126454	1336084462	1	0.02	0.000263157894736842	2219	1
1	Drink 2	Intake 2	20	127975	1336085983	/users/cn/jespinosa/phecomp/data/CRG/20120502_FDF_CRG/20120502_FDF_CRG/20120502_FDF_CRG_c12.mtb	198	NA	WWSS	water	2	127955	1336085963	1	0.0800000000000001	0.00400000000000001	2220	1
1	Food 1	Intake 3	323	128564	1336086572	/users/cn/jespinosa/phecomp/data/CRG/20120502_FDF_CRG/20120502_FDF_CRG/20120502_FDF_CRG_c12.mtb	364	27	WWSS	food_sc	3	128241	1336086249	1	0.0600000000000001	0.000185758513931889	2221	1
1	Food 1	Intake 3	89	128680	1336086688	/users/cn/jespinosa/phecomp/data/CRG/20120502_FDF_CRG/20120502_FDF_CRG/20120502_FDF_CRG_c12.mtb	365	107	WWSS	food_sc	3	128591	1336086599	1	0.04	0.000449438202247191	2222	1
1	Drink 2	Intake 2	47	128723	1336086731	/users/cn/jespinosa/phecomp/data/CRG/20120502_FDF_CRG/20120502_FDF_CRG/20120502_FDF_CRG_c12.mtb	199	NA	WWSS	water	2	128676	1336086684	1	0.0800000000000001	0.00170212765957447	2223	1
1	Food 1	Intake 3	80	128867	1336086875	/users/cn/jespinosa/phecomp/data/CRG/20120502_FDF_CRG/20120502_FDF_CRG/20120502_FDF_CRG_c12.mtb	366	21	WWSS	food_sc	3	128787	1336086795	1	0.02	0.00025	2224	1
1	Food 2	Intake 4	118	129006	1336087014	/users/cn/jespinosa/phecomp/data/CRG/20120502_FDF_CRG/20120502_FDF_CRG/20120502_FDF_CRG_c12.mtb	342	4334	WWSS	food_sc	4	128888	1336086896	1	0.04	0.000338983050847458	2225	1
1	Drink 1	Intake 1	17	129027	1336087035	/users/cn/jespinosa/phecomp/data/CRG/20120502_FDF_CRG/20120502_FDF_CRG/20120502_FDF_CRG_c12.mtb	655	NA	WWSS	water	1	129010	1336087018	1	0.02	0.00117647058823529	2226	1
1	Drink 2	Intake 2	23	129145	1336087153	/users/cn/jespinosa/phecomp/data/CRG/20120502_FDF_CRG/20120502_FDF_CRG/20120502_FDF_CRG_c12.mtb	202	NA	WWSS	water	2	129122	1336087130	1	0.0399999999999996	0.00173913043478259	2227	1
1	Drink 2	Intake 2	213	129744	1336087752	/users/cn/jespinosa/phecomp/data/CRG/20120502_FDF_CRG/20120502_FDF_CRG/20120502_FDF_CRG_c12.mtb	205	NA	WWSS	water	2	129531	1336087539	1	0.02	9.38967136150235e-05	2228	1
1	Drink 2	Intake 2	158	129927	1336087935	/users/cn/jespinosa/phecomp/data/CRG/20120502_FDF_CRG/20120502_FDF_CRG/20120502_FDF_CRG_c12.mtb	206	NA	WWSS	water	2	129769	1336087777	1	0.02	0.000126582278481013	2229	1
1	Drink 2	Intake 2	191	130419	1336088427	/users/cn/jespinosa/phecomp/data/CRG/20120502_FDF_CRG/20120502_FDF_CRG/20120502_FDF_CRG_c12.mtb	209	NA	WWSS	water	2	130228	1336088236	1	0.02	0.000104712041884817	2230	1
1	Drink 2	Intake 2	146	130879	1336088887	/users/cn/jespinosa/phecomp/data/CRG/20120502_FDF_CRG/20120502_FDF_CRG/20120502_FDF_CRG_c12.mtb	211	NA	WWSS	water	2	130733	1336088741	1	0.02	0.000136986301369863	2231	1
1	Drink 2	Intake 2	27	131882	1336089890	/users/cn/jespinosa/phecomp/data/CRG/20120502_FDF_CRG/20120502_FDF_CRG/20120502_FDF_CRG_c12.mtb	216	NA	WWSS	water	2	131855	1336089863	1	0.02	0.000740740740740741	2232	1
1	Food 1	Intake 3	361	133701	1336091709	/users/cn/jespinosa/phecomp/data/CRG/20120502_FDF_CRG/20120502_FDF_CRG/20120502_FDF_CRG_c12.mtb	370	17	WWSS	food_sc	3	133340	1336091348	1	0.0600000000000001	0.000166204986149585	2233	1
1	Food 2	Intake 4	196	133914	1336091922	/users/cn/jespinosa/phecomp/data/CRG/20120502_FDF_CRG/20120502_FDF_CRG/20120502_FDF_CRG_c12.mtb	345	281	WWSS	food_sc	4	133718	1336091726	1	0.0600000000000001	0.000306122448979592	2234	1
1	Drink 1	Intake 1	20	134132	1336092140	/users/cn/jespinosa/phecomp/data/CRG/20120502_FDF_CRG/20120502_FDF_CRG/20120502_FDF_CRG_c12.mtb	664	NA	WWSS	water	1	134112	1336092120	1	0.02	0.001	2235	1
1	Food 2	Intake 4	86	134281	1336092289	/users/cn/jespinosa/phecomp/data/CRG/20120502_FDF_CRG/20120502_FDF_CRG/20120502_FDF_CRG_c12.mtb	348	178	WWSS	food_sc	4	134195	1336092203	1	0.04	0.000465116279069767	2236	1
1	Food 2	Intake 4	44	134503	1336092511	/users/cn/jespinosa/phecomp/data/CRG/20120502_FDF_CRG/20120502_FDF_CRG/20120502_FDF_CRG_c12.mtb	350	327	WWSS	food_sc	4	134459	1336092467	1	0.02	0.000454545454545455	2237	1
1	Drink 2	Intake 2	56	134665	1336092673	/users/cn/jespinosa/phecomp/data/CRG/20120502_FDF_CRG/20120502_FDF_CRG/20120502_FDF_CRG_c12.mtb	232	NA	WWSS	water	2	134609	1336092617	1	0.02	0.000357142857142857	2238	1
1	Drink 2	Intake 2	37	134761	1336092769	/users/cn/jespinosa/phecomp/data/CRG/20120502_FDF_CRG/20120502_FDF_CRG/20120502_FDF_CRG_c12.mtb	233	NA	WWSS	water	2	134724	1336092732	1	0.02	0.000540540540540541	2239	1
1	Drink 2	Intake 2	25	134813	1336092821	/users/cn/jespinosa/phecomp/data/CRG/20120502_FDF_CRG/20120502_FDF_CRG/20120502_FDF_CRG_c12.mtb	234	NA	WWSS	water	2	134788	1336092796	1	0.04	0.0016	2240	1
1	Food 1	Intake 3	136	134966	1336092974	/users/cn/jespinosa/phecomp/data/CRG/20120502_FDF_CRG/20120502_FDF_CRG/20120502_FDF_CRG_c12.mtb	376	62	WWSS	food_sc	3	134830	1336092838	1	0.04	0.000294117647058824	2241	1
1	Food 1	Intake 3	76	135104	1336093112	/users/cn/jespinosa/phecomp/data/CRG/20120502_FDF_CRG/20120502_FDF_CRG/20120502_FDF_CRG_c12.mtb	377	893	WWSS	food_sc	3	135028	1336093036	1	0.02	0.000263157894736842	2242	1
1	Drink 1	Intake 1	40	135178	1336093186	/users/cn/jespinosa/phecomp/data/CRG/20120502_FDF_CRG/20120502_FDF_CRG/20120502_FDF_CRG_c12.mtb	667	NA	WWSS	water	1	135138	1336093146	1	0.0800000000000001	0.002	2243	1
1	Drink 2	Intake 2	484	135751	1336093759	/users/cn/jespinosa/phecomp/data/CRG/20120502_FDF_CRG/20120502_FDF_CRG/20120502_FDF_CRG_c12.mtb	238	NA	WWSS	water	2	135267	1336093275	1	0.04	8.26446280991736e-05	2244	1
1	Drink 2	Intake 2	83	135939	1336093947	/users/cn/jespinosa/phecomp/data/CRG/20120502_FDF_CRG/20120502_FDF_CRG/20120502_FDF_CRG_c12.mtb	239	NA	WWSS	water	2	135856	1336093864	1	0.02	0.000240963855421687	2245	1
1	Food 1	Intake 3	76	136073	1336094081	/users/cn/jespinosa/phecomp/data/CRG/20120502_FDF_CRG/20120502_FDF_CRG/20120502_FDF_CRG_c12.mtb	379	809	WWSS	food_sc	3	135997	1336094005	1	0.02	0.000263157894736842	2246	1
1	Drink 2	Intake 2	472	136900	1336094908	/users/cn/jespinosa/phecomp/data/CRG/20120502_FDF_CRG/20120502_FDF_CRG/20120502_FDF_CRG_c12.mtb	243	NA	WWSS	water	2	136428	1336094436	1	0.02	4.23728813559322e-05	2247	1
1	Food 2	Intake 4	68	136950	1336094958	/users/cn/jespinosa/phecomp/data/CRG/20120502_FDF_CRG/20120502_FDF_CRG/20120502_FDF_CRG_c12.mtb	358	59	WWSS	food_sc	4	136882	1336094890	1	0.02	0.000294117647058824	2248	1
1	Drink 2	Intake 2	92	137028	1336095036	/users/cn/jespinosa/phecomp/data/CRG/20120502_FDF_CRG/20120502_FDF_CRG/20120502_FDF_CRG_c12.mtb	244	NA	WWSS	water	2	136936	1336094944	1	0.02	0.000217391304347826	2249	1
1	Food 2	Intake 4	151	137160	1336095168	/users/cn/jespinosa/phecomp/data/CRG/20120502_FDF_CRG/20120502_FDF_CRG/20120502_FDF_CRG_c12.mtb	360	241	WWSS	food_sc	4	137009	1336095017	1	0.02	0.000132450331125828	2250	1
1	Drink 2	Intake 2	363	137429	1336095437	/users/cn/jespinosa/phecomp/data/CRG/20120502_FDF_CRG/20120502_FDF_CRG/20120502_FDF_CRG_c12.mtb	245	NA	WWSS	water	2	137066	1336095074	1	0.02	5.50964187327824e-05	2251	1
1	Food 2	Intake 4	85	137486	1336095494	/users/cn/jespinosa/phecomp/data/CRG/20120502_FDF_CRG/20120502_FDF_CRG/20120502_FDF_CRG_c12.mtb	364	1022	WWSS	food_sc	4	137401	1336095409	1	0.02	0.000235294117647059	2252	1
1	Drink 2	Intake 2	93	138066	1336096074	/users/cn/jespinosa/phecomp/data/CRG/20120502_FDF_CRG/20120502_FDF_CRG/20120502_FDF_CRG_c12.mtb	248	NA	WWSS	water	2	137973	1336095981	1	0.02	0.00021505376344086	2253	1
1	Drink 1	Intake 1	15	138496	1336096504	/users/cn/jespinosa/phecomp/data/CRG/20120502_FDF_CRG/20120502_FDF_CRG/20120502_FDF_CRG_c12.mtb	683	NA	WWSS	water	1	138481	1336096489	1	0.02	0.00133333333333333	2254	1
1	Food 2	Intake 4	76	138584	1336096592	/users/cn/jespinosa/phecomp/data/CRG/20120502_FDF_CRG/20120502_FDF_CRG/20120502_FDF_CRG_c12.mtb	365	4819	WWSS	food_sc	4	138508	1336096516	1	0.02	0.000263157894736842	2255	1
1	Drink 2	Intake 2	133	138770	1336096778	/users/cn/jespinosa/phecomp/data/CRG/20120502_FDF_CRG/20120502_FDF_CRG/20120502_FDF_CRG_c12.mtb	252	NA	WWSS	water	2	138637	1336096645	1	0.04	0.000300751879699248	2256	1
1	Drink 2	Intake 2	49	138865	1336096873	/users/cn/jespinosa/phecomp/data/CRG/20120502_FDF_CRG/20120502_FDF_CRG/20120502_FDF_CRG_c12.mtb	253	NA	WWSS	water	2	138816	1336096824	1	0.02	0.000408163265306122	2257	1
1	Drink 2	Intake 2	33	140700	1336098708	/users/cn/jespinosa/phecomp/data/CRG/20120502_FDF_CRG/20120502_FDF_CRG/20120502_FDF_CRG_c12.mtb	258	NA	WWSS	water	2	140667	1336098675	1	0.02	0.000606060606060606	2258	1
1	Drink 2	Intake 2	47	140758	1336098766	/users/cn/jespinosa/phecomp/data/CRG/20120502_FDF_CRG/20120502_FDF_CRG/20120502_FDF_CRG_c12.mtb	259	NA	WWSS	water	2	140711	1336098719	1	0.02	0.000425531914893617	2259	1
1	Drink 2	Intake 2	10	141474	1336099482	/users/cn/jespinosa/phecomp/data/CRG/20120502_FDF_CRG/20120502_FDF_CRG/20120502_FDF_CRG_c12.mtb	263	NA	WWSS	water	2	141464	1336099472	1	0.0200000000000005	0.00200000000000005	2260	1
1	Drink 2	Intake 2	33	142420	1336100428	/users/cn/jespinosa/phecomp/data/CRG/20120502_FDF_CRG/20120502_FDF_CRG/20120502_FDF_CRG_c12.mtb	269	NA	WWSS	water	2	142387	1336100395	1	0.0200000000000005	0.000606060606060621	2261	1
1	Drink 2	Intake 2	76	142846	1336100854	/users/cn/jespinosa/phecomp/data/CRG/20120502_FDF_CRG/20120502_FDF_CRG/20120502_FDF_CRG_c12.mtb	272	NA	WWSS	water	2	142770	1336100778	1	0.02	0.000263157894736842	2262	1
1	Drink 2	Intake 2	13	142883	1336100891	/users/cn/jespinosa/phecomp/data/CRG/20120502_FDF_CRG/20120502_FDF_CRG/20120502_FDF_CRG_c12.mtb	273	NA	WWSS	water	2	142870	1336100878	1	0.02	0.00153846153846154	2263	1
1	Drink 2	Intake 2	15	143146	1336101154	/users/cn/jespinosa/phecomp/data/CRG/20120502_FDF_CRG/20120502_FDF_CRG/20120502_FDF_CRG_c12.mtb	275	NA	WWSS	water	2	143131	1336101139	1	0.02	0.00133333333333333	2264	1
1	Food 2	Intake 4	52	143455	1336101463	/users/cn/jespinosa/phecomp/data/CRG/20120502_FDF_CRG/20120502_FDF_CRG/20120502_FDF_CRG_c12.mtb	369	15	WWSS	food_sc	4	143403	1336101411	1	0.02	0.000384615384615385	2265	1
1	Food 2	Intake 4	85	143555	1336101563	/users/cn/jespinosa/phecomp/data/CRG/20120502_FDF_CRG/20120502_FDF_CRG/20120502_FDF_CRG_c12.mtb	370	17	WWSS	food_sc	4	143470	1336101478	1	0.02	0.000235294117647059	2266	1
1	Food 1	Intake 3	67	143639	1336101647	/users/cn/jespinosa/phecomp/data/CRG/20120502_FDF_CRG/20120502_FDF_CRG/20120502_FDF_CRG_c12.mtb	385	33	WWSS	food_sc	3	143572	1336101580	1	0.04	0.000597014925373134	2267	1
1	Food 2	Intake 4	34	143706	1336101714	/users/cn/jespinosa/phecomp/data/CRG/20120502_FDF_CRG/20120502_FDF_CRG/20120502_FDF_CRG_c12.mtb	372	277	WWSS	food_sc	4	143672	1336101680	1	0.04	0.00117647058823529	2268	1
1	Food 2	Intake 4	151	144134	1336102142	/users/cn/jespinosa/phecomp/data/CRG/20120502_FDF_CRG/20120502_FDF_CRG/20120502_FDF_CRG_c12.mtb	376	128	WWSS	food_sc	4	143983	1336101991	1	0.04	0.000264900662251656	2269	1
1	Drink 2	Intake 2	27	144055	1336102063	/users/cn/jespinosa/phecomp/data/CRG/20120502_FDF_CRG/20120502_FDF_CRG/20120502_FDF_CRG_c12.mtb	279	NA	WWSS	water	2	144028	1336102036	1	0.02	0.000740740740740741	2270	1
1	Drink 1	Intake 1	31	144164	1336102172	/users/cn/jespinosa/phecomp/data/CRG/20120502_FDF_CRG/20120502_FDF_CRG/20120502_FDF_CRG_c12.mtb	690	NA	WWSS	water	1	144133	1336102141	1	0.0800000000000001	0.00258064516129033	2271	1
1	Food 2	Intake 4	265	144527	1336102535	/users/cn/jespinosa/phecomp/data/CRG/20120502_FDF_CRG/20120502_FDF_CRG/20120502_FDF_CRG_c12.mtb	378	289	WWSS	food_sc	4	144262	1336102270	1	0.0599999999999998	0.000226415094339622	2272	1
1	Drink 1	Intake 1	40	144560	1336102568	/users/cn/jespinosa/phecomp/data/CRG/20120502_FDF_CRG/20120502_FDF_CRG/20120502_FDF_CRG_c12.mtb	692	NA	WWSS	water	1	144520	1336102528	1	0.16	0.004	2273	1
1	Food 2	Intake 4	255	145071	1336103079	/users/cn/jespinosa/phecomp/data/CRG/20120502_FDF_CRG/20120502_FDF_CRG/20120502_FDF_CRG_c12.mtb	381	155	WWSS	food_sc	4	144816	1336102824	1	0.0600000000000001	0.000235294117647059	2274	1
1	Drink 1	Intake 1	23	145087	1336103095	/users/cn/jespinosa/phecomp/data/CRG/20120502_FDF_CRG/20120502_FDF_CRG/20120502_FDF_CRG_c12.mtb	693	NA	WWSS	water	1	145064	1336103072	1	0.0600000000000001	0.00260869565217392	2275	1
1	Food 2	Intake 4	36	145262	1336103270	/users/cn/jespinosa/phecomp/data/CRG/20120502_FDF_CRG/20120502_FDF_CRG/20120502_FDF_CRG_c12.mtb	383	11	WWSS	food_sc	4	145226	1336103234	1	0.04	0.00111111111111111	2276	1
1	Food 2	Intake 4	39	145312	1336103320	/users/cn/jespinosa/phecomp/data/CRG/20120502_FDF_CRG/20120502_FDF_CRG/20120502_FDF_CRG_c12.mtb	384	1260	WWSS	food_sc	4	145273	1336103281	1	0.04	0.00102564102564103	2277	1
1	Drink 1	Intake 1	36	145385	1336103393	/users/cn/jespinosa/phecomp/data/CRG/20120502_FDF_CRG/20120502_FDF_CRG/20120502_FDF_CRG_c12.mtb	694	NA	WWSS	water	1	145349	1336103357	1	0.1	0.00277777777777778	2278	1
1	Drink 2	Intake 2	23	146260	1336104268	/users/cn/jespinosa/phecomp/data/CRG/20120502_FDF_CRG/20120502_FDF_CRG/20120502_FDF_CRG_c12.mtb	292	NA	WWSS	water	2	146237	1336104245	1	0.0800000000000001	0.00347826086956522	2279	1
1	Food 1	Intake 3	98	146670	1336104678	/users/cn/jespinosa/phecomp/data/CRG/20120502_FDF_CRG/20120502_FDF_CRG/20120502_FDF_CRG_c12.mtb	402	20	WWSS	food_sc	3	146572	1336104580	1	0.02	0.000204081632653061	2280	1
1	Food 1	Intake 3	313	147003	1336105011	/users/cn/jespinosa/phecomp/data/CRG/20120502_FDF_CRG/20120502_FDF_CRG/20120502_FDF_CRG_c12.mtb	403	3160	WWSS	food_sc	3	146690	1336104698	1	0.02	6.38977635782748e-05	2281	1
1	Drink 1	Intake 1	26	147021	1336105029	/users/cn/jespinosa/phecomp/data/CRG/20120502_FDF_CRG/20120502_FDF_CRG/20120502_FDF_CRG_c12.mtb	696	NA	WWSS	water	1	146995	1336105003	1	0.0800000000000001	0.00307692307692308	2282	1
1	Drink 1	Intake 1	31	150171	1336108179	/users/cn/jespinosa/phecomp/data/CRG/20120502_FDF_CRG/20120502_FDF_CRG/20120502_FDF_CRG_c12.mtb	706	NA	WWSS	water	1	150140	1336108148	1	0.0600000000000001	0.00193548387096775	2283	1
1	Food 1	Intake 3	136	150299	1336108307	/users/cn/jespinosa/phecomp/data/CRG/20120502_FDF_CRG/20120502_FDF_CRG/20120502_FDF_CRG_c12.mtb	408	143	WWSS	food_sc	3	150163	1336108171	1	0.02	0.000147058823529412	2284	1
1	Food 1	Intake 3	161	150603	1336108611	/users/cn/jespinosa/phecomp/data/CRG/20120502_FDF_CRG/20120502_FDF_CRG/20120502_FDF_CRG_c12.mtb	410	85	WWSS	food_sc	3	150442	1336108450	1	0.04	0.000248447204968944	2285	1
1	Drink 1	Intake 1	22	150617	1336108625	/users/cn/jespinosa/phecomp/data/CRG/20120502_FDF_CRG/20120502_FDF_CRG/20120502_FDF_CRG_c12.mtb	708	NA	WWSS	water	1	150595	1336108603	1	0.04	0.00181818181818182	2286	1
1	Food 1	Intake 3	86	150774	1336108782	/users/cn/jespinosa/phecomp/data/CRG/20120502_FDF_CRG/20120502_FDF_CRG/20120502_FDF_CRG_c12.mtb	411	17	WWSS	food_sc	3	150688	1336108696	1	0.02	0.000232558139534884	2287	1
1	Food 1	Intake 3	246	151037	1336109045	/users/cn/jespinosa/phecomp/data/CRG/20120502_FDF_CRG/20120502_FDF_CRG/20120502_FDF_CRG_c12.mtb	412	57	WWSS	food_sc	3	150791	1336108799	1	0.02	8.13008130081301e-05	2288	1
1	Drink 2	Intake 2	25	151059	1336109067	/users/cn/jespinosa/phecomp/data/CRG/20120502_FDF_CRG/20120502_FDF_CRG/20120502_FDF_CRG_c12.mtb	295	NA	WWSS	water	2	151034	1336109042	1	0.0800000000000001	0.0032	2289	1
1	Food 1	Intake 3	189	151283	1336109291	/users/cn/jespinosa/phecomp/data/CRG/20120502_FDF_CRG/20120502_FDF_CRG/20120502_FDF_CRG_c12.mtb	413	6260	WWSS	food_sc	3	151094	1336109102	1	0.0599999999999996	0.000317460317460315	2290	1
1	Drink 1	Intake 1	36	151425	1336109433	/users/cn/jespinosa/phecomp/data/CRG/20120502_FDF_CRG/20120502_FDF_CRG/20120502_FDF_CRG_c12.mtb	710	NA	WWSS	water	1	151389	1336109397	1	0.12	0.00333333333333333	2291	1
1	Food 1	Intake 3	36	157579	1336115587	/users/cn/jespinosa/phecomp/data/CRG/20120502_FDF_CRG/20120502_FDF_CRG/20120502_FDF_CRG_c12.mtb	419	105	WWSS	food_sc	3	157543	1336115551	1	0.0200000000000005	0.000555555555555569	2292	1
1	Food 2	Intake 4	62	157746	1336115754	/users/cn/jespinosa/phecomp/data/CRG/20120502_FDF_CRG/20120502_FDF_CRG/20120502_FDF_CRG_c12.mtb	420	8	WWSS	food_sc	4	157684	1336115692	1	0.02	0.00032258064516129	2293	1
1	Food 2	Intake 4	36	157790	1336115798	/users/cn/jespinosa/phecomp/data/CRG/20120502_FDF_CRG/20120502_FDF_CRG/20120502_FDF_CRG_c12.mtb	421	18916	WWSS	food_sc	4	157754	1336115762	1	0.04	0.00111111111111111	2294	1
1	Drink 1	Intake 1	104	159007	1336117015	/users/cn/jespinosa/phecomp/data/CRG/20120502_FDF_CRG/20120502_FDF_CRG/20120502_FDF_CRG_c12.mtb	727	NA	WWSS	water	1	158903	1336116911	1	0.02	0.000192307692307692	2295	1
1	Drink 2	Intake 2	174	1099	1336123285	/users/cn/jespinosa/phecomp/data/CRG/20120502_FDF_CRG/20120502_FDF_CRG/20120504_FDF_CRG_c12.mtb	371	NA	WWSS	water	2	925	1336123111	1	0.02	0.000114942528735632	2296	1
1	Drink 2	Intake 2	84	1229	1336123415	/users/cn/jespinosa/phecomp/data/CRG/20120502_FDF_CRG/20120502_FDF_CRG/20120504_FDF_CRG_c12.mtb	372	NA	WWSS	water	2	1145	1336123331	1	0.02	0.000238095238095238	2297	1
1	Drink 2	Intake 2	38	2172	1336124358	/users/cn/jespinosa/phecomp/data/CRG/20120502_FDF_CRG/20120502_FDF_CRG/20120504_FDF_CRG_c12.mtb	376	NA	WWSS	water	2	2134	1336124320	1	0.02	0.000526315789473684	2298	1
1	Drink 2	Intake 2	62	3174	1336125360	/users/cn/jespinosa/phecomp/data/CRG/20120502_FDF_CRG/20120502_FDF_CRG/20120504_FDF_CRG_c12.mtb	384	NA	WWSS	water	2	3112	1336125298	1	0.02	0.00032258064516129	2299	1
1	Drink 2	Intake 2	246	3997	1336126183	/users/cn/jespinosa/phecomp/data/CRG/20120502_FDF_CRG/20120502_FDF_CRG/20120504_FDF_CRG_c12.mtb	389	NA	WWSS	water	2	3751	1336125937	1	0.04	0.00016260162601626	2300	1
1	Drink 2	Intake 2	54	5513	1336127699	/users/cn/jespinosa/phecomp/data/CRG/20120502_FDF_CRG/20120502_FDF_CRG/20120504_FDF_CRG_c12.mtb	398	NA	WWSS	water	2	5459	1336127645	1	0.02	0.00037037037037037	2301	1
1	Drink 1	Intake 1	17	6431	1336128617	/users/cn/jespinosa/phecomp/data/CRG/20120502_FDF_CRG/20120502_FDF_CRG/20120504_FDF_CRG_c12.mtb	923	NA	WWSS	water	1	6414	1336128600	1	0.02	0.00117647058823529	2302	1
1	Drink 2	Intake 2	149	7591	1336129777	/users/cn/jespinosa/phecomp/data/CRG/20120502_FDF_CRG/20120502_FDF_CRG/20120504_FDF_CRG_c12.mtb	406	NA	WWSS	water	2	7442	1336129628	1	0.02	0.000134228187919463	2303	1
1	Food 2	Intake 4	59	12587	1336134773	/users/cn/jespinosa/phecomp/data/CRG/20120502_FDF_CRG/20120502_FDF_CRG/20120504_FDF_CRG_c12.mtb	742	428	WWSS	food_sc	4	12528	1336134714	1	0.02	0.000338983050847458	2304	1
1	Food 1	Intake 3	286	13301	1336135487	/users/cn/jespinosa/phecomp/data/CRG/20120502_FDF_CRG/20120502_FDF_CRG/20120504_FDF_CRG_c12.mtb	556	8445	WWSS	food_sc	3	13015	1336135201	1	0.08	0.00027972027972028	2305	1
1	Drink 1	Intake 1	30	13329	1336135515	/users/cn/jespinosa/phecomp/data/CRG/20120502_FDF_CRG/20120502_FDF_CRG/20120504_FDF_CRG_c12.mtb	930	NA	WWSS	water	1	13299	1336135485	1	0.04	0.00133333333333333	2306	1
1	Drink 2	Intake 2	18	13519	1336135705	/users/cn/jespinosa/phecomp/data/CRG/20120502_FDF_CRG/20120502_FDF_CRG/20120504_FDF_CRG_c12.mtb	411	NA	WWSS	water	2	13501	1336135687	1	0.02	0.00111111111111111	2307	1
1	Food 1	Intake 3	426	22172	1336144358	/users/cn/jespinosa/phecomp/data/CRG/20120502_FDF_CRG/20120502_FDF_CRG/20120504_FDF_CRG_c12.mtb	559	5032	WWSS	food_sc	3	21746	1336143932	1	0.12	0.00028169014084507	2308	1
1	Drink 1	Intake 1	16	22185	1336144371	/users/cn/jespinosa/phecomp/data/CRG/20120502_FDF_CRG/20120502_FDF_CRG/20120504_FDF_CRG_c12.mtb	932	NA	WWSS	water	1	22169	1336144355	1	0.04	0.0025	2309	1
1	Drink 1	Intake 1	17	22956	1336145142	/users/cn/jespinosa/phecomp/data/CRG/20120502_FDF_CRG/20120502_FDF_CRG/20120504_FDF_CRG_c12.mtb	936	NA	WWSS	water	1	22939	1336145125	1	0.08	0.00470588235294118	2310	1
1	Drink 2	Intake 2	17	25303	1336147489	/users/cn/jespinosa/phecomp/data/CRG/20120502_FDF_CRG/20120502_FDF_CRG/20120504_FDF_CRG_c12.mtb	413	NA	WWSS	water	2	25286	1336147472	1	0.04	0.00235294117647059	2311	1
1	Drink 2	Intake 2	557	26353	1336148539	/users/cn/jespinosa/phecomp/data/CRG/20120502_FDF_CRG/20120502_FDF_CRG/20120504_FDF_CRG_c12.mtb	416	NA	WWSS	water	2	25796	1336147982	1	0.02	3.59066427289048e-05	2312	1
1	Drink 2	Intake 2	64	26587	1336148773	/users/cn/jespinosa/phecomp/data/CRG/20120502_FDF_CRG/20120502_FDF_CRG/20120504_FDF_CRG_c12.mtb	418	NA	WWSS	water	2	26523	1336148709	1	0.04	0.000625	2313	1
1	Food 1	Intake 3	150	27354	1336149540	/users/cn/jespinosa/phecomp/data/CRG/20120502_FDF_CRG/20120502_FDF_CRG/20120504_FDF_CRG_c12.mtb	561	5	WWSS	food_sc	3	27204	1336149390	1	0.02	0.000133333333333333	2314	1
1	Food 1	Intake 3	383	27742	1336149928	/users/cn/jespinosa/phecomp/data/CRG/20120502_FDF_CRG/20120502_FDF_CRG/20120504_FDF_CRG_c12.mtb	562	3419	WWSS	food_sc	3	27359	1336149545	1	0.1	0.000261096605744125	2315	1
1	Drink 1	Intake 1	20	28381	1336150567	/users/cn/jespinosa/phecomp/data/CRG/20120502_FDF_CRG/20120502_FDF_CRG/20120504_FDF_CRG_c12.mtb	942	NA	WWSS	water	1	28361	1336150547	1	0.14	0.007	2316	1
1	Food 1	Intake 3	335	31496	1336153682	/users/cn/jespinosa/phecomp/data/CRG/20120502_FDF_CRG/20120502_FDF_CRG/20120504_FDF_CRG_c12.mtb	563	24	WWSS	food_sc	3	31161	1336153347	1	0.1	0.000298507462686567	2317	1
1	Food 1	Intake 3	110	31630	1336153816	/users/cn/jespinosa/phecomp/data/CRG/20120502_FDF_CRG/20120502_FDF_CRG/20120504_FDF_CRG_c12.mtb	564	530	WWSS	food_sc	3	31520	1336153706	1	0.1	0.000909090909090909	2318	1
1	Drink 1	Intake 1	23	31677	1336153863	/users/cn/jespinosa/phecomp/data/CRG/20120502_FDF_CRG/20120502_FDF_CRG/20120504_FDF_CRG_c12.mtb	944	NA	WWSS	water	1	31654	1336153840	1	0.02	0.000869565217391304	2319	1
1	Drink 1	Intake 1	13	32124	1336154310	/users/cn/jespinosa/phecomp/data/CRG/20120502_FDF_CRG/20120502_FDF_CRG/20120504_FDF_CRG_c12.mtb	945	NA	WWSS	water	1	32111	1336154297	1	0.06	0.00461538461538461	2320	1
1	Food 1	Intake 3	218	32378	1336154564	/users/cn/jespinosa/phecomp/data/CRG/20120502_FDF_CRG/20120502_FDF_CRG/20120504_FDF_CRG_c12.mtb	565	1610	WWSS	food_sc	3	32160	1336154346	1	0.0599999999999999	0.000275229357798165	2321	1
1	Drink 1	Intake 1	17	33523	1336155709	/users/cn/jespinosa/phecomp/data/CRG/20120502_FDF_CRG/20120502_FDF_CRG/20120504_FDF_CRG_c12.mtb	947	NA	WWSS	water	1	33506	1336155692	1	0.08	0.00470588235294118	2322	1
1	Food 1	Intake 3	340	34328	1336156514	/users/cn/jespinosa/phecomp/data/CRG/20120502_FDF_CRG/20120502_FDF_CRG/20120504_FDF_CRG_c12.mtb	567	19	WWSS	food_sc	3	33988	1336156174	1	0.0600000000000001	0.000176470588235294	2323	1
1	Food 1	Intake 3	23	34370	1336156556	/users/cn/jespinosa/phecomp/data/CRG/20120502_FDF_CRG/20120502_FDF_CRG/20120504_FDF_CRG_c12.mtb	568	494	WWSS	food_sc	3	34347	1336156533	1	0.02	0.000869565217391304	2324	1
1	Food 2	Intake 4	282	35146	1336157332	/users/cn/jespinosa/phecomp/data/CRG/20120502_FDF_CRG/20120502_FDF_CRG/20120504_FDF_CRG_c12.mtb	748	441	WWSS	food_sc	4	34864	1336157050	1	0.1	0.000354609929078014	2325	1
1	Drink 1	Intake 1	26	35171	1336157357	/users/cn/jespinosa/phecomp/data/CRG/20120502_FDF_CRG/20120502_FDF_CRG/20120504_FDF_CRG_c12.mtb	949	NA	WWSS	water	1	35145	1336157331	1	0.0800000000000001	0.00307692307692308	2326	1
1	Food 2	Intake 4	177	35764	1336157950	/users/cn/jespinosa/phecomp/data/CRG/20120502_FDF_CRG/20120502_FDF_CRG/20120504_FDF_CRG_c12.mtb	750	746	WWSS	food_sc	4	35587	1336157773	1	0.06	0.000338983050847458	2327	1
1	Food 2	Intake 4	391	36901	1336159087	/users/cn/jespinosa/phecomp/data/CRG/20120502_FDF_CRG/20120502_FDF_CRG/20120504_FDF_CRG_c12.mtb	758	538	WWSS	food_sc	4	36510	1336158696	1	0.16	0.00040920716112532	2328	1
1	Drink 1	Intake 1	34	36928	1336159114	/users/cn/jespinosa/phecomp/data/CRG/20120502_FDF_CRG/20120502_FDF_CRG/20120504_FDF_CRG_c12.mtb	960	NA	WWSS	water	1	36894	1336159080	1	0.0800000000000001	0.00235294117647059	2329	1
1	Drink 1	Intake 1	12	37349	1336159535	/users/cn/jespinosa/phecomp/data/CRG/20120502_FDF_CRG/20120502_FDF_CRG/20120504_FDF_CRG_c12.mtb	962	NA	WWSS	water	1	37337	1336159523	1	0.0399999999999999	0.00333333333333332	2330	1
1	Food 2	Intake 4	241	37680	1336159866	/users/cn/jespinosa/phecomp/data/CRG/20120502_FDF_CRG/20120502_FDF_CRG/20120504_FDF_CRG_c12.mtb	761	2019	WWSS	food_sc	4	37439	1336159625	1	0.08	0.00033195020746888	2331	1
1	Drink 2	Intake 2	11	37688	1336159874	/users/cn/jespinosa/phecomp/data/CRG/20120502_FDF_CRG/20120502_FDF_CRG/20120504_FDF_CRG_c12.mtb	423	NA	WWSS	water	2	37677	1336159863	1	0.06	0.00545454545454545	2332	1
1	Food 2	Intake 4	371	40070	1336162256	/users/cn/jespinosa/phecomp/data/CRG/20120502_FDF_CRG/20120502_FDF_CRG/20120504_FDF_CRG_c12.mtb	763	19	WWSS	food_sc	4	39699	1336161885	1	0.12	0.000323450134770889	2333	1
1	Food 2	Intake 4	168	40257	1336162443	/users/cn/jespinosa/phecomp/data/CRG/20120502_FDF_CRG/20120502_FDF_CRG/20120504_FDF_CRG_c12.mtb	764	961	WWSS	food_sc	4	40089	1336162275	1	0.08	0.000476190476190476	2334	1
1	Drink 1	Intake 1	27	40280	1336162466	/users/cn/jespinosa/phecomp/data/CRG/20120502_FDF_CRG/20120502_FDF_CRG/20120504_FDF_CRG_c12.mtb	970	NA	WWSS	water	1	40253	1336162439	1	0.0600000000000001	0.00222222222222223	2335	1
1	Drink 1	Intake 1	16	40793	1336162979	/users/cn/jespinosa/phecomp/data/CRG/20120502_FDF_CRG/20120502_FDF_CRG/20120504_FDF_CRG_c12.mtb	972	NA	WWSS	water	1	40777	1336162963	1	0.02	0.00125	2336	1
1	Food 2	Intake 4	150	41368	1336163554	/users/cn/jespinosa/phecomp/data/CRG/20120502_FDF_CRG/20120502_FDF_CRG/20120504_FDF_CRG_c12.mtb	772	50	WWSS	food_sc	4	41218	1336163404	1	0.02	0.000133333333333333	2337	1
1	Food 2	Intake 4	41	41459	1336163645	/users/cn/jespinosa/phecomp/data/CRG/20120502_FDF_CRG/20120502_FDF_CRG/20120504_FDF_CRG_c12.mtb	773	319	WWSS	food_sc	4	41418	1336163604	1	0.02	0.00048780487804878	2338	1
1	Drink 1	Intake 1	16	41534	1336163720	/users/cn/jespinosa/phecomp/data/CRG/20120502_FDF_CRG/20120502_FDF_CRG/20120504_FDF_CRG_c12.mtb	975	NA	WWSS	water	1	41518	1336163704	1	0.0399999999999999	0.00249999999999999	2339	1
1	Drink 1	Intake 1	16	41580	1336163766	/users/cn/jespinosa/phecomp/data/CRG/20120502_FDF_CRG/20120502_FDF_CRG/20120504_FDF_CRG_c12.mtb	976	NA	WWSS	water	1	41564	1336163750	1	0.02	0.00125	2340	1
1	Food 2	Intake 4	159	41937	1336164123	/users/cn/jespinosa/phecomp/data/CRG/20120502_FDF_CRG/20120502_FDF_CRG/20120504_FDF_CRG_c12.mtb	774	1216	WWSS	food_sc	4	41778	1336163964	1	0.02	0.000125786163522013	2341	1
1	Drink 1	Intake 1	23	42887	1336165073	/users/cn/jespinosa/phecomp/data/CRG/20120502_FDF_CRG/20120502_FDF_CRG/20120504_FDF_CRG_c12.mtb	982	NA	WWSS	water	1	42864	1336165050	1	0.02	0.000869565217391304	2342	1
1	Food 1	Intake 3	451	43604	1336165790	/users/cn/jespinosa/phecomp/data/CRG/20120502_FDF_CRG/20120502_FDF_CRG/20120504_FDF_CRG_c12.mtb	591	521	WWSS	food_sc	3	43153	1336165339	1	0.16	0.000354767184035477	2343	1
1	Drink 1	Intake 1	31	43629	1336165815	/users/cn/jespinosa/phecomp/data/CRG/20120502_FDF_CRG/20120502_FDF_CRG/20120504_FDF_CRG_c12.mtb	983	NA	WWSS	water	1	43598	1336165784	1	0.12	0.00387096774193548	2344	1
1	Food 1	Intake 3	146	44271	1336166457	/users/cn/jespinosa/phecomp/data/CRG/20120502_FDF_CRG/20120502_FDF_CRG/20120504_FDF_CRG_c12.mtb	594	951	WWSS	food_sc	3	44125	1336166311	1	0.04	0.000273972602739726	2345	1
1	Drink 2	Intake 2	12	44472	1336166658	/users/cn/jespinosa/phecomp/data/CRG/20120502_FDF_CRG/20120502_FDF_CRG/20120504_FDF_CRG_c12.mtb	424	NA	WWSS	water	2	44460	1336166646	1	0.04	0.00333333333333333	2346	1
1	Drink 1	Intake 1	10	44518	1336166704	/users/cn/jespinosa/phecomp/data/CRG/20120502_FDF_CRG/20120502_FDF_CRG/20120504_FDF_CRG_c12.mtb	987	NA	WWSS	water	1	44508	1336166694	1	0.02	0.002	2347	1
1	Drink 1	Intake 1	23	45163	1336167349	/users/cn/jespinosa/phecomp/data/CRG/20120502_FDF_CRG/20120502_FDF_CRG/20120504_FDF_CRG_c12.mtb	989	NA	WWSS	water	1	45140	1336167326	1	0.02	0.000869565217391304	2348	1
1	Food 1	Intake 3	69	45291	1336167477	/users/cn/jespinosa/phecomp/data/CRG/20120502_FDF_CRG/20120502_FDF_CRG/20120504_FDF_CRG_c12.mtb	597	17	WWSS	food_sc	3	45222	1336167408	1	0.04	0.000579710144927536	2349	1
1	Food 1	Intake 3	260	45568	1336167754	/users/cn/jespinosa/phecomp/data/CRG/20120502_FDF_CRG/20120502_FDF_CRG/20120504_FDF_CRG_c12.mtb	598	3805	WWSS	food_sc	3	45308	1336167494	1	0.08	0.000307692307692308	2350	1
1	Drink 2	Intake 2	12	45573	1336167759	/users/cn/jespinosa/phecomp/data/CRG/20120502_FDF_CRG/20120502_FDF_CRG/20120504_FDF_CRG_c12.mtb	425	NA	WWSS	water	2	45561	1336167747	1	0.04	0.00333333333333333	2351	1
1	Food 1	Intake 3	369	49742	1336171928	/users/cn/jespinosa/phecomp/data/CRG/20120502_FDF_CRG/20120502_FDF_CRG/20120504_FDF_CRG_c12.mtb	600	117	WWSS	food_sc	3	49373	1336171559	1	0.0600000000000001	0.00016260162601626	2352	1
1	Food 1	Intake 3	361	50220	1336172406	/users/cn/jespinosa/phecomp/data/CRG/20120502_FDF_CRG/20120502_FDF_CRG/20120504_FDF_CRG_c12.mtb	601	664	WWSS	food_sc	3	49859	1336172045	1	0.14	0.000387811634349031	2353	1
1	Drink 2	Intake 2	28	50247	1336172433	/users/cn/jespinosa/phecomp/data/CRG/20120502_FDF_CRG/20120502_FDF_CRG/20120504_FDF_CRG_c12.mtb	426	NA	WWSS	water	2	50219	1336172405	1	0.08	0.00285714285714286	2354	1
1	Drink 2	Intake 2	15	50730	1336172916	/users/cn/jespinosa/phecomp/data/CRG/20120502_FDF_CRG/20120502_FDF_CRG/20120504_FDF_CRG_c12.mtb	428	NA	WWSS	water	2	50715	1336172901	1	0.02	0.00133333333333333	2355	1
1	Drink 2	Intake 2	20	50754	1336172940	/users/cn/jespinosa/phecomp/data/CRG/20120502_FDF_CRG/20120502_FDF_CRG/20120504_FDF_CRG_c12.mtb	429	NA	WWSS	water	2	50734	1336172920	1	0.08	0.004	2356	1
1	Food 1	Intake 3	260	51144	1336173330	/users/cn/jespinosa/phecomp/data/CRG/20120502_FDF_CRG/20120502_FDF_CRG/20120504_FDF_CRG_c12.mtb	607	513	WWSS	food_sc	3	50884	1336173070	1	0.04	0.000153846153846154	2357	1
1	Drink 2	Intake 2	24	51165	1336173351	/users/cn/jespinosa/phecomp/data/CRG/20120502_FDF_CRG/20120502_FDF_CRG/20120504_FDF_CRG_c12.mtb	430	NA	WWSS	water	2	51141	1336173327	1	0.0599999999999999	0.0025	2358	1
1	Drink 2	Intake 2	35	51363	1336173549	/users/cn/jespinosa/phecomp/data/CRG/20120502_FDF_CRG/20120502_FDF_CRG/20120504_FDF_CRG_c12.mtb	432	NA	WWSS	water	2	51328	1336173514	1	0.02	0.000571428571428571	2359	1
1	Drink 2	Intake 2	13	51528	1336173714	/users/cn/jespinosa/phecomp/data/CRG/20120502_FDF_CRG/20120502_FDF_CRG/20120504_FDF_CRG_c12.mtb	433	NA	WWSS	water	2	51515	1336173701	1	0.0600000000000001	0.00461538461538462	2360	1
1	Food 1	Intake 3	186	51843	1336174029	/users/cn/jespinosa/phecomp/data/CRG/20120502_FDF_CRG/20120502_FDF_CRG/20120504_FDF_CRG_c12.mtb	609	73	WWSS	food_sc	3	51657	1336173843	1	0.0600000000000001	0.000322580645161291	2361	1
1	Drink 1	Intake 1	26	51922	1336174108	/users/cn/jespinosa/phecomp/data/CRG/20120502_FDF_CRG/20120502_FDF_CRG/20120504_FDF_CRG_c12.mtb	1000	NA	WWSS	water	1	51896	1336174082	1	0.02	0.000769230769230769	2362	1
1	Food 1	Intake 3	86	52002	1336174188	/users/cn/jespinosa/phecomp/data/CRG/20120502_FDF_CRG/20120502_FDF_CRG/20120504_FDF_CRG_c12.mtb	610	6	WWSS	food_sc	3	51916	1336174102	1	0.02	0.000232558139534884	2363	1
1	Food 1	Intake 3	303	52311	1336174497	/users/cn/jespinosa/phecomp/data/CRG/20120502_FDF_CRG/20120502_FDF_CRG/20120504_FDF_CRG_c12.mtb	611	4	WWSS	food_sc	3	52008	1336174194	1	0.14	0.000462046204620462	2364	1
1	Food 1	Intake 3	62	52377	1336174563	/users/cn/jespinosa/phecomp/data/CRG/20120502_FDF_CRG/20120502_FDF_CRG/20120504_FDF_CRG_c12.mtb	612	714	WWSS	food_sc	3	52315	1336174501	1	0.04	0.000645161290322581	2365	1
1	Drink 1	Intake 1	17	52486	1336174672	/users/cn/jespinosa/phecomp/data/CRG/20120502_FDF_CRG/20120502_FDF_CRG/20120504_FDF_CRG_c12.mtb	1001	NA	WWSS	water	1	52469	1336174655	1	0.02	0.00117647058823529	2366	1
1	Drink 1	Intake 1	16	52611	1336174797	/users/cn/jespinosa/phecomp/data/CRG/20120502_FDF_CRG/20120502_FDF_CRG/20120504_FDF_CRG_c12.mtb	1002	NA	WWSS	water	1	52595	1336174781	1	0.02	0.00125	2367	1
1	Drink 2	Intake 2	51	52744	1336174930	/users/cn/jespinosa/phecomp/data/CRG/20120502_FDF_CRG/20120502_FDF_CRG/20120504_FDF_CRG_c12.mtb	435	NA	WWSS	water	2	52693	1336174879	1	0.1	0.00196078431372549	2368	1
1	Drink 2	Intake 2	12	52779	1336174965	/users/cn/jespinosa/phecomp/data/CRG/20120502_FDF_CRG/20120502_FDF_CRG/20120504_FDF_CRG_c12.mtb	436	NA	WWSS	water	2	52767	1336174953	1	0.02	0.00166666666666667	2369	1
1	Drink 1	Intake 1	21	53094	1336175280	/users/cn/jespinosa/phecomp/data/CRG/20120502_FDF_CRG/20120502_FDF_CRG/20120504_FDF_CRG_c12.mtb	1005	NA	WWSS	water	1	53073	1336175259	1	0.02	0.000952380952380952	2370	1
1	Food 1	Intake 3	78	53169	1336175355	/users/cn/jespinosa/phecomp/data/CRG/20120502_FDF_CRG/20120502_FDF_CRG/20120504_FDF_CRG_c12.mtb	615	2757	WWSS	food_sc	3	53091	1336175277	1	0.04	0.000512820512820513	2371	1
1	Drink 1	Intake 1	9	53234	1336175420	/users/cn/jespinosa/phecomp/data/CRG/20120502_FDF_CRG/20120502_FDF_CRG/20120504_FDF_CRG_c12.mtb	1006	NA	WWSS	water	1	53225	1336175411	1	0.02	0.00222222222222222	2372	1
1	Drink 1	Intake 1	17	53276	1336175462	/users/cn/jespinosa/phecomp/data/CRG/20120502_FDF_CRG/20120502_FDF_CRG/20120504_FDF_CRG_c12.mtb	1007	NA	WWSS	water	1	53259	1336175445	1	0.02	0.00117647058823529	2373	1
1	Drink 2	Intake 2	21	53466	1336175652	/users/cn/jespinosa/phecomp/data/CRG/20120502_FDF_CRG/20120502_FDF_CRG/20120504_FDF_CRG_c12.mtb	437	NA	WWSS	water	2	53445	1336175631	1	0.0399999999999999	0.0019047619047619	2374	1
1	Drink 1	Intake 1	17	54380	1336176566	/users/cn/jespinosa/phecomp/data/CRG/20120502_FDF_CRG/20120502_FDF_CRG/20120504_FDF_CRG_c12.mtb	1009	NA	WWSS	water	1	54363	1336176549	1	0.0399999999999998	0.00235294117647058	2375	1
1	Food 1	Intake 3	18	55944	1336178130	/users/cn/jespinosa/phecomp/data/CRG/20120502_FDF_CRG/20120502_FDF_CRG/20120504_FDF_CRG_c12.mtb	617	12505	WWSS	food_sc	3	55926	1336178112	1	0.32	0.0177777777777778	2376	1
1	Drink 1	Intake 1	36	56386	1336178572	/users/cn/jespinosa/phecomp/data/CRG/20120502_FDF_CRG/20120502_FDF_CRG/20120504_FDF_CRG_c12.mtb	1010	NA	WWSS	water	1	56350	1336178536	1	0.0600000000000001	0.00166666666666667	2377	1
1	Drink 1	Intake 1	23	56891	1336179077	/users/cn/jespinosa/phecomp/data/CRG/20120502_FDF_CRG/20120502_FDF_CRG/20120504_FDF_CRG_c12.mtb	1013	NA	WWSS	water	1	56868	1336179054	1	0.04	0.00173913043478261	2378	1
1	Drink 2	Intake 2	23	57165	1336179351	/users/cn/jespinosa/phecomp/data/CRG/20120502_FDF_CRG/20120502_FDF_CRG/20120504_FDF_CRG_c12.mtb	439	NA	WWSS	water	2	57142	1336179328	1	0.04	0.00173913043478261	2379	1
1	Drink 1	Intake 1	24	57285	1336179471	/users/cn/jespinosa/phecomp/data/CRG/20120502_FDF_CRG/20120502_FDF_CRG/20120504_FDF_CRG_c12.mtb	1014	NA	WWSS	water	1	57261	1336179447	1	0.04	0.00166666666666667	2380	1
1	Drink 2	Intake 2	15	57611	1336179797	/users/cn/jespinosa/phecomp/data/CRG/20120502_FDF_CRG/20120502_FDF_CRG/20120504_FDF_CRG_c12.mtb	440	NA	WWSS	water	2	57596	1336179782	1	0.02	0.00133333333333333	2381	1
1	Drink 2	Intake 2	39	58874	1336181060	/users/cn/jespinosa/phecomp/data/CRG/20120502_FDF_CRG/20120502_FDF_CRG/20120504_FDF_CRG_c12.mtb	441	NA	WWSS	water	2	58835	1336181021	1	0.08	0.00205128205128205	2382	1
1	Drink 2	Intake 2	17	58908	1336181094	/users/cn/jespinosa/phecomp/data/CRG/20120502_FDF_CRG/20120502_FDF_CRG/20120504_FDF_CRG_c12.mtb	442	NA	WWSS	water	2	58891	1336181077	1	0.02	0.00117647058823529	2383	1
1	Drink 2	Intake 2	19	58950	1336181136	/users/cn/jespinosa/phecomp/data/CRG/20120502_FDF_CRG/20120502_FDF_CRG/20120504_FDF_CRG_c12.mtb	443	NA	WWSS	water	2	58931	1336181117	1	0.0600000000000001	0.00315789473684211	2384	1
1	Drink 2	Intake 2	25	59059	1336181245	/users/cn/jespinosa/phecomp/data/CRG/20120502_FDF_CRG/20120502_FDF_CRG/20120504_FDF_CRG_c12.mtb	444	NA	WWSS	water	2	59034	1336181220	1	0.04	0.0016	2385	1
1	Drink 1	Intake 1	16	63614	1336185800	/users/cn/jespinosa/phecomp/data/CRG/20120502_FDF_CRG/20120502_FDF_CRG/20120504_FDF_CRG_c12.mtb	1019	NA	WWSS	water	1	63598	1336185784	1	0.02	0.00125	2386	1
1	Food 1	Intake 3	72	68521	1336190707	/users/cn/jespinosa/phecomp/data/CRG/20120502_FDF_CRG/20120502_FDF_CRG/20120504_FDF_CRG_c12.mtb	623	15	WWSS	food_sc	3	68449	1336190635	1	0.02	0.000277777777777778	2387	1
1	Food 1	Intake 3	551	69087	1336191273	/users/cn/jespinosa/phecomp/data/CRG/20120502_FDF_CRG/20120502_FDF_CRG/20120504_FDF_CRG_c12.mtb	624	54	WWSS	food_sc	3	68536	1336190722	1	0.1	0.000181488203266788	2388	1
1	Drink 2	Intake 2	22	69111	1336191297	/users/cn/jespinosa/phecomp/data/CRG/20120502_FDF_CRG/20120502_FDF_CRG/20120504_FDF_CRG_c12.mtb	446	NA	WWSS	water	2	69089	1336191275	1	0.0799999999999998	0.00363636363636363	2389	1
1	Food 1	Intake 3	35	69176	1336191362	/users/cn/jespinosa/phecomp/data/CRG/20120502_FDF_CRG/20120502_FDF_CRG/20120504_FDF_CRG_c12.mtb	625	35	WWSS	food_sc	3	69141	1336191327	1	0.02	0.000571428571428571	2390	1
1	Food 1	Intake 3	311	69522	1336191708	/users/cn/jespinosa/phecomp/data/CRG/20120502_FDF_CRG/20120502_FDF_CRG/20120504_FDF_CRG_c12.mtb	626	73	WWSS	food_sc	3	69211	1336191397	1	0.0800000000000001	0.000257234726688103	2391	1
1	Drink 1	Intake 1	36	69555	1336191741	/users/cn/jespinosa/phecomp/data/CRG/20120502_FDF_CRG/20120502_FDF_CRG/20120504_FDF_CRG_c12.mtb	1021	NA	WWSS	water	1	69519	1336191705	1	0.16	0.00444444444444444	2392	1
1	Food 1	Intake 3	137	69732	1336191918	/users/cn/jespinosa/phecomp/data/CRG/20120502_FDF_CRG/20120502_FDF_CRG/20120504_FDF_CRG_c12.mtb	627	452	WWSS	food_sc	3	69595	1336191781	1	0.0600000000000001	0.000437956204379563	2393	1
1	Drink 2	Intake 2	21	69933	1336192119	/users/cn/jespinosa/phecomp/data/CRG/20120502_FDF_CRG/20120502_FDF_CRG/20120504_FDF_CRG_c12.mtb	447	NA	WWSS	water	2	69912	1336192098	1	0.0600000000000001	0.00285714285714286	2394	1
1	Drink 1	Intake 1	30	70184	1336192370	/users/cn/jespinosa/phecomp/data/CRG/20120502_FDF_CRG/20120502_FDF_CRG/20120504_FDF_CRG_c12.mtb	1024	NA	WWSS	water	1	70154	1336192340	1	0.02	0.000666666666666667	2395	1
1	Food 1	Intake 3	230	70414	1336192600	/users/cn/jespinosa/phecomp/data/CRG/20120502_FDF_CRG/20120502_FDF_CRG/20120504_FDF_CRG_c12.mtb	629	6363	WWSS	food_sc	3	70184	1336192370	1	0.0600000000000001	0.000260869565217392	2396	1
1	Drink 1	Intake 1	30	70438	1336192624	/users/cn/jespinosa/phecomp/data/CRG/20120502_FDF_CRG/20120502_FDF_CRG/20120504_FDF_CRG_c12.mtb	1025	NA	WWSS	water	1	70408	1336192594	1	0.0800000000000001	0.00266666666666667	2397	1
1	Drink 2	Intake 2	17	71208	1336193394	/users/cn/jespinosa/phecomp/data/CRG/20120502_FDF_CRG/20120502_FDF_CRG/20120504_FDF_CRG_c12.mtb	449	NA	WWSS	water	2	71191	1336193377	1	0.02	0.00117647058823529	2398	1
1	Drink 1	Intake 1	53	71830	1336194016	/users/cn/jespinosa/phecomp/data/CRG/20120502_FDF_CRG/20120502_FDF_CRG/20120504_FDF_CRG_c12.mtb	1028	NA	WWSS	water	1	71777	1336193963	1	0.02	0.000377358490566038	2399	1
1	Drink 1	Intake 1	96	72982	1336195168	/users/cn/jespinosa/phecomp/data/CRG/20120502_FDF_CRG/20120502_FDF_CRG/20120504_FDF_CRG_c12.mtb	1044	NA	WWSS	water	1	72886	1336195072	1	0.02	0.000208333333333333	2400	1
1	Drink 2	Intake 2	15	74801	1336196987	/users/cn/jespinosa/phecomp/data/CRG/20120502_FDF_CRG/20120502_FDF_CRG/20120504_FDF_CRG_c12.mtb	463	NA	WWSS	water	2	74786	1336196972	1	0.02	0.00133333333333333	2401	1
1	Food 1	Intake 3	109	76886	1336199072	/users/cn/jespinosa/phecomp/data/CRG/20120502_FDF_CRG/20120502_FDF_CRG/20120504_FDF_CRG_c12.mtb	639	390	WWSS	food_sc	3	76777	1336198963	1	0.02	0.00018348623853211	2402	1
1	Drink 1	Intake 1	24	77191	1336199377	/users/cn/jespinosa/phecomp/data/CRG/20120502_FDF_CRG/20120502_FDF_CRG/20120504_FDF_CRG_c12.mtb	1056	NA	WWSS	water	1	77167	1336199353	1	0.04	0.00166666666666667	2403	1
1	Drink 1	Intake 1	31	77263	1336199449	/users/cn/jespinosa/phecomp/data/CRG/20120502_FDF_CRG/20120502_FDF_CRG/20120504_FDF_CRG_c12.mtb	1057	NA	WWSS	water	1	77232	1336199418	1	0.0799999999999998	0.00258064516129032	2404	1
1	Food 1	Intake 3	105	77381	1336199567	/users/cn/jespinosa/phecomp/data/CRG/20120502_FDF_CRG/20120502_FDF_CRG/20120504_FDF_CRG_c12.mtb	642	1631	WWSS	food_sc	3	77276	1336199462	1	0.02	0.00019047619047619	2405	1
1	Drink 1	Intake 1	28	77944	1336200130	/users/cn/jespinosa/phecomp/data/CRG/20120502_FDF_CRG/20120502_FDF_CRG/20120504_FDF_CRG_c12.mtb	1059	NA	WWSS	water	1	77916	1336200102	1	0.02	0.000714285714285714	2406	1
1	Drink 1	Intake 1	26	78014	1336200200	/users/cn/jespinosa/phecomp/data/CRG/20120502_FDF_CRG/20120502_FDF_CRG/20120504_FDF_CRG_c12.mtb	1060	NA	WWSS	water	1	77988	1336200174	1	0.0399999999999998	0.00153846153846153	2407	1
1	Drink 1	Intake 1	109	78129	1336200315	/users/cn/jespinosa/phecomp/data/CRG/20120502_FDF_CRG/20120502_FDF_CRG/20120504_FDF_CRG_c12.mtb	1061	NA	WWSS	water	1	78020	1336200206	1	0.1	0.000917431192660551	2408	1
1	Drink 1	Intake 1	50	78334	1336200520	/users/cn/jespinosa/phecomp/data/CRG/20120502_FDF_CRG/20120502_FDF_CRG/20120504_FDF_CRG_c12.mtb	1063	NA	WWSS	water	1	78284	1336200470	1	0.02	0.0004	2409	1
1	Drink 1	Intake 1	23	78994	1336201180	/users/cn/jespinosa/phecomp/data/CRG/20120502_FDF_CRG/20120502_FDF_CRG/20120504_FDF_CRG_c12.mtb	1066	NA	WWSS	water	1	78971	1336201157	1	0.02	0.000869565217391304	2410	1
1	Food 2	Intake 4	54	79066	1336201252	/users/cn/jespinosa/phecomp/data/CRG/20120502_FDF_CRG/20120502_FDF_CRG/20120504_FDF_CRG_c12.mtb	824	2076	WWSS	food_sc	4	79012	1336201198	1	0.02	0.00037037037037037	2411	1
1	Drink 2	Intake 2	45	79245	1336201431	/users/cn/jespinosa/phecomp/data/CRG/20120502_FDF_CRG/20120502_FDF_CRG/20120504_FDF_CRG_c12.mtb	465	NA	WWSS	water	2	79200	1336201386	1	0.02	0.000444444444444444	2412	1
1	Drink 1	Intake 1	16	79494	1336201680	/users/cn/jespinosa/phecomp/data/CRG/20120502_FDF_CRG/20120502_FDF_CRG/20120504_FDF_CRG_c12.mtb	1072	NA	WWSS	water	1	79478	1336201664	1	0.02	0.00125	2413	1
1	Food 2	Intake 4	38	81180	1336203366	/users/cn/jespinosa/phecomp/data/CRG/20120502_FDF_CRG/20120502_FDF_CRG/20120504_FDF_CRG_c12.mtb	826	4	WWSS	food_sc	4	81142	1336203328	1	0.02	0.000526315789473684	2414	1
1	Food 2	Intake 4	51	81235	1336203421	/users/cn/jespinosa/phecomp/data/CRG/20120502_FDF_CRG/20120502_FDF_CRG/20120504_FDF_CRG_c12.mtb	827	327	WWSS	food_sc	4	81184	1336203370	1	0.02	0.000392156862745098	2415	1
1	Food 1	Intake 3	206	81768	1336203954	/users/cn/jespinosa/phecomp/data/CRG/20120502_FDF_CRG/20120502_FDF_CRG/20120504_FDF_CRG_c12.mtb	648	9842	WWSS	food_sc	3	81562	1336203748	1	0.0399999999999996	0.000194174757281551	2416	1
1	Drink 2	Intake 2	25	82051	1336204237	/users/cn/jespinosa/phecomp/data/CRG/20120502_FDF_CRG/20120502_FDF_CRG/20120504_FDF_CRG_c12.mtb	467	NA	WWSS	water	2	82026	1336204212	1	0.04	0.0016	2417	1
1	Drink 1	Intake 1	16	82171	1336204357	/users/cn/jespinosa/phecomp/data/CRG/20120502_FDF_CRG/20120502_FDF_CRG/20120504_FDF_CRG_c12.mtb	1085	NA	WWSS	water	1	82155	1336204341	1	0.02	0.00125	2418	1
1	Drink 1	Intake 1	153	82967	1336205153	/users/cn/jespinosa/phecomp/data/CRG/20120502_FDF_CRG/20120502_FDF_CRG/20120504_FDF_CRG_c12.mtb	1089	NA	WWSS	water	1	82814	1336205000	1	0.02	0.000130718954248366	2419	1
1	Drink 1	Intake 1	44	83311	1336205497	/users/cn/jespinosa/phecomp/data/CRG/20120502_FDF_CRG/20120502_FDF_CRG/20120504_FDF_CRG_c12.mtb	1092	NA	WWSS	water	1	83267	1336205453	1	0.02	0.000454545454545455	2420	1
1	Drink 1	Intake 1	619	84408	1336206594	/users/cn/jespinosa/phecomp/data/CRG/20120502_FDF_CRG/20120502_FDF_CRG/20120504_FDF_CRG_c12.mtb	1096	NA	WWSS	water	1	83789	1336205975	1	0.02	3.23101777059774e-05	2421	1
1	Drink 1	Intake 1	137	86361	1336208547	/users/cn/jespinosa/phecomp/data/CRG/20120502_FDF_CRG/20120502_FDF_CRG/20120504_FDF_CRG_c12.mtb	1106	NA	WWSS	water	1	86224	1336208410	1	0.02	0.000145985401459854	2422	1
1	Drink 1	Intake 1	63	89277	1336211463	/users/cn/jespinosa/phecomp/data/CRG/20120502_FDF_CRG/20120502_FDF_CRG/20120504_FDF_CRG_c12.mtb	1122	NA	WWSS	water	1	89214	1336211400	1	0.02	0.000317460317460317	2423	1
1	Drink 1	Intake 1	26	90718	1336212904	/users/cn/jespinosa/phecomp/data/CRG/20120502_FDF_CRG/20120502_FDF_CRG/20120504_FDF_CRG_c12.mtb	1124	NA	WWSS	water	1	90692	1336212878	1	0.02	0.000769230769230769	2424	1
1	Food 2	Intake 4	182	91792	1336213978	/users/cn/jespinosa/phecomp/data/CRG/20120502_FDF_CRG/20120502_FDF_CRG/20120504_FDF_CRG_c12.mtb	833	17112	WWSS	food_sc	4	91610	1336213796	1	0.0599999999999999	0.000329670329670329	2425	1
1	Drink 1	Intake 1	21	93157	1336215343	/users/cn/jespinosa/phecomp/data/CRG/20120502_FDF_CRG/20120502_FDF_CRG/20120504_FDF_CRG_c12.mtb	1126	NA	WWSS	water	1	93136	1336215322	1	0.02	0.000952380952380952	2426	1
1	Food 1	Intake 3	122	109026	1336231212	/users/cn/jespinosa/phecomp/data/CRG/20120502_FDF_CRG/20120502_FDF_CRG/20120504_FDF_CRG_c12.mtb	656	50	WWSS	food_sc	3	108904	1336231090	1	0.0600000000000001	0.000491803278688525	2427	1
1	Food 1	Intake 3	81	109157	1336231343	/users/cn/jespinosa/phecomp/data/CRG/20120502_FDF_CRG/20120502_FDF_CRG/20120504_FDF_CRG_c12.mtb	658	15	WWSS	food_sc	3	109076	1336231262	1	0.04	0.000493827160493827	2428	1
1	Food 1	Intake 3	120	109292	1336231478	/users/cn/jespinosa/phecomp/data/CRG/20120502_FDF_CRG/20120502_FDF_CRG/20120504_FDF_CRG_c12.mtb	659	68	WWSS	food_sc	3	109172	1336231358	1	0.02	0.000166666666666667	2429	1
1	Food 1	Intake 3	86	109446	1336231632	/users/cn/jespinosa/phecomp/data/CRG/20120502_FDF_CRG/20120502_FDF_CRG/20120504_FDF_CRG_c12.mtb	660	3905	WWSS	food_sc	3	109360	1336231546	1	0.04	0.000465116279069767	2430	1
1	Drink 1	Intake 1	21	109572	1336231758	/users/cn/jespinosa/phecomp/data/CRG/20120502_FDF_CRG/20120502_FDF_CRG/20120504_FDF_CRG_c12.mtb	1130	NA	WWSS	water	1	109551	1336231737	1	0.02	0.000952380952380952	2431	1
1	Food 1	Intake 3	569	113920	1336236106	/users/cn/jespinosa/phecomp/data/CRG/20120502_FDF_CRG/20120502_FDF_CRG/20120504_FDF_CRG_c12.mtb	661	3135	WWSS	food_sc	3	113351	1336235537	1	0.2	0.000351493848857645	2432	1
1	Drink 1	Intake 1	20	113933	1336236119	/users/cn/jespinosa/phecomp/data/CRG/20120502_FDF_CRG/20120502_FDF_CRG/20120504_FDF_CRG_c12.mtb	1131	NA	WWSS	water	1	113913	1336236099	1	0.04	0.002	2433	1
1	Drink 1	Intake 1	23	114184	1336236370	/users/cn/jespinosa/phecomp/data/CRG/20120502_FDF_CRG/20120502_FDF_CRG/20120504_FDF_CRG_c12.mtb	1132	NA	WWSS	water	1	114161	1336236347	1	0.12	0.00521739130434783	2434	1
1	Food 1	Intake 3	202	117257	1336239443	/users/cn/jespinosa/phecomp/data/CRG/20120502_FDF_CRG/20120502_FDF_CRG/20120504_FDF_CRG_c12.mtb	664	18	WWSS	food_sc	3	117055	1336239241	1	0.0600000000000001	0.000297029702970298	2435	1
1	Food 1	Intake 3	117	117392	1336239578	/users/cn/jespinosa/phecomp/data/CRG/20120502_FDF_CRG/20120502_FDF_CRG/20120504_FDF_CRG_c12.mtb	665	153	WWSS	food_sc	3	117275	1336239461	1	0.0600000000000001	0.000512820512820514	2436	1
1	Food 1	Intake 3	124	117669	1336239855	/users/cn/jespinosa/phecomp/data/CRG/20120502_FDF_CRG/20120502_FDF_CRG/20120504_FDF_CRG_c12.mtb	666	1709	WWSS	food_sc	3	117545	1336239731	1	0.04	0.00032258064516129	2437	1
1	Drink 1	Intake 1	18	117740	1336239926	/users/cn/jespinosa/phecomp/data/CRG/20120502_FDF_CRG/20120502_FDF_CRG/20120504_FDF_CRG_c12.mtb	1135	NA	WWSS	water	1	117722	1336239908	1	0.0200000000000005	0.00111111111111114	2438	1
1	Drink 1	Intake 1	23	118995	1336241181	/users/cn/jespinosa/phecomp/data/CRG/20120502_FDF_CRG/20120502_FDF_CRG/20120504_FDF_CRG_c12.mtb	1136	NA	WWSS	water	1	118972	1336241158	1	0.0799999999999996	0.0034782608695652	2439	1
1	Food 1	Intake 3	347	119725	1336241911	/users/cn/jespinosa/phecomp/data/CRG/20120502_FDF_CRG/20120502_FDF_CRG/20120504_FDF_CRG_c12.mtb	671	429	WWSS	food_sc	3	119378	1336241564	1	0.0800000000000001	0.000230547550432277	2440	1
1	Drink 1	Intake 1	15	119751	1336241937	/users/cn/jespinosa/phecomp/data/CRG/20120502_FDF_CRG/20120502_FDF_CRG/20120504_FDF_CRG_c12.mtb	1137	NA	WWSS	water	1	119736	1336241922	1	0.04	0.00266666666666667	2441	1
1	Food 1	Intake 3	131	120285	1336242471	/users/cn/jespinosa/phecomp/data/CRG/20120502_FDF_CRG/20120502_FDF_CRG/20120504_FDF_CRG_c12.mtb	673	669	WWSS	food_sc	3	120154	1336242340	1	0.02	0.000152671755725191	2442	1
1	Drink 1	Intake 1	23	120303	1336242489	/users/cn/jespinosa/phecomp/data/CRG/20120502_FDF_CRG/20120502_FDF_CRG/20120504_FDF_CRG_c12.mtb	1139	NA	WWSS	water	1	120280	1336242466	1	0.0800000000000001	0.00347826086956522	2443	1
1	Food 1	Intake 3	372	121326	1336243512	/users/cn/jespinosa/phecomp/data/CRG/20120502_FDF_CRG/20120502_FDF_CRG/20120504_FDF_CRG_c12.mtb	674	330	WWSS	food_sc	3	120954	1336243140	1	0.1	0.000268817204301075	2444	1
1	Food 1	Intake 3	132	121788	1336243974	/users/cn/jespinosa/phecomp/data/CRG/20120502_FDF_CRG/20120502_FDF_CRG/20120504_FDF_CRG_c12.mtb	676	1057	WWSS	food_sc	3	121656	1336243842	1	0.02	0.000151515151515152	2445	1
1	Food 1	Intake 3	308	123153	1336245339	/users/cn/jespinosa/phecomp/data/CRG/20120502_FDF_CRG/20120502_FDF_CRG/20120504_FDF_CRG_c12.mtb	682	321	WWSS	food_sc	3	122845	1336245031	1	0.02	6.49350649350649e-05	2446	1
1	Drink 2	Intake 2	25	123172	1336245358	/users/cn/jespinosa/phecomp/data/CRG/20120502_FDF_CRG/20120502_FDF_CRG/20120504_FDF_CRG_c12.mtb	470	NA	WWSS	water	2	123147	1336245333	1	0.12	0.0048	2447	1
1	Food 1	Intake 3	418	123892	1336246078	/users/cn/jespinosa/phecomp/data/CRG/20120502_FDF_CRG/20120502_FDF_CRG/20120504_FDF_CRG_c12.mtb	684	638	WWSS	food_sc	3	123474	1336245660	1	0.18	0.000430622009569378	2448	1
1	Drink 1	Intake 1	35	123944	1336246130	/users/cn/jespinosa/phecomp/data/CRG/20120502_FDF_CRG/20120502_FDF_CRG/20120504_FDF_CRG_c12.mtb	1145	NA	WWSS	water	1	123909	1336246095	1	0.14	0.004	2449	1
1	Food 1	Intake 3	91	124621	1336246807	/users/cn/jespinosa/phecomp/data/CRG/20120502_FDF_CRG/20120502_FDF_CRG/20120504_FDF_CRG_c12.mtb	686	157	WWSS	food_sc	3	124530	1336246716	1	0.02	0.00021978021978022	2450	1
1	Food 1	Intake 3	191	124969	1336247155	/users/cn/jespinosa/phecomp/data/CRG/20120502_FDF_CRG/20120502_FDF_CRG/20120504_FDF_CRG_c12.mtb	688	847	WWSS	food_sc	3	124778	1336246964	1	0.0999999999999996	0.000523560209424082	2451	1
1	Drink 1	Intake 1	41	125003	1336247189	/users/cn/jespinosa/phecomp/data/CRG/20120502_FDF_CRG/20120502_FDF_CRG/20120504_FDF_CRG_c12.mtb	1148	NA	WWSS	water	1	124962	1336247148	1	0.0800000000000001	0.00195121951219512	2452	1
1	Drink 1	Intake 1	30	125533	1336247719	/users/cn/jespinosa/phecomp/data/CRG/20120502_FDF_CRG/20120502_FDF_CRG/20120504_FDF_CRG_c12.mtb	1150	NA	WWSS	water	1	125503	1336247689	1	0.0800000000000001	0.00266666666666667	2453	1
1	Food 1	Intake 3	40	125856	1336248042	/users/cn/jespinosa/phecomp/data/CRG/20120502_FDF_CRG/20120502_FDF_CRG/20120504_FDF_CRG_c12.mtb	693	1305	WWSS	food_sc	3	125816	1336248002	1	0.02	0.0005	2454	1
1	Food 1	Intake 3	247	127408	1336249594	/users/cn/jespinosa/phecomp/data/CRG/20120502_FDF_CRG/20120502_FDF_CRG/20120504_FDF_CRG_c12.mtb	695	23	WWSS	food_sc	3	127161	1336249347	1	0.04	0.000161943319838057	2455	1
1	Food 1	Intake 3	178	127609	1336249795	/users/cn/jespinosa/phecomp/data/CRG/20120502_FDF_CRG/20120502_FDF_CRG/20120504_FDF_CRG_c12.mtb	696	1611	WWSS	food_sc	3	127431	1336249617	1	0.0600000000000001	0.000337078651685394	2456	1
1	Food 1	Intake 3	115	129335	1336251521	/users/cn/jespinosa/phecomp/data/CRG/20120502_FDF_CRG/20120502_FDF_CRG/20120504_FDF_CRG_c12.mtb	697	72	WWSS	food_sc	3	129220	1336251406	1	0.02	0.000173913043478261	2457	1
1	Food 2	Intake 4	186	129593	1336251779	/users/cn/jespinosa/phecomp/data/CRG/20120502_FDF_CRG/20120502_FDF_CRG/20120504_FDF_CRG_c12.mtb	852	160	WWSS	food_sc	4	129407	1336251593	1	0.04	0.00021505376344086	2458	1
1	Food 2	Intake 4	110	129863	1336252049	/users/cn/jespinosa/phecomp/data/CRG/20120502_FDF_CRG/20120502_FDF_CRG/20120504_FDF_CRG_c12.mtb	855	228	WWSS	food_sc	4	129753	1336251939	1	0.02	0.000181818181818182	2459	1
1	Food 2	Intake 4	33	130124	1336252310	/users/cn/jespinosa/phecomp/data/CRG/20120502_FDF_CRG/20120502_FDF_CRG/20120504_FDF_CRG_c12.mtb	858	33	WWSS	food_sc	4	130091	1336252277	1	0.02	0.000606060606060606	2460	1
1	Food 2	Intake 4	277	130434	1336252620	/users/cn/jespinosa/phecomp/data/CRG/20120502_FDF_CRG/20120502_FDF_CRG/20120504_FDF_CRG_c12.mtb	859	8	WWSS	food_sc	4	130157	1336252343	1	0.0599999999999999	0.000216606498194945	2461	1
1	Food 2	Intake 4	29	130471	1336252657	/users/cn/jespinosa/phecomp/data/CRG/20120502_FDF_CRG/20120502_FDF_CRG/20120504_FDF_CRG_c12.mtb	860	37	WWSS	food_sc	4	130442	1336252628	1	0.0600000000000001	0.00206896551724138	2462	1
1	Food 2	Intake 4	112	130620	1336252806	/users/cn/jespinosa/phecomp/data/CRG/20120502_FDF_CRG/20120502_FDF_CRG/20120504_FDF_CRG_c12.mtb	861	9	WWSS	food_sc	4	130508	1336252694	1	0.0600000000000001	0.000535714285714287	2463	1
1	Food 2	Intake 4	132	130761	1336252947	/users/cn/jespinosa/phecomp/data/CRG/20120502_FDF_CRG/20120502_FDF_CRG/20120504_FDF_CRG_c12.mtb	862	790	WWSS	food_sc	4	130629	1336252815	1	0.0600000000000001	0.000454545454545455	2464	1
1	Drink 1	Intake 1	39	130794	1336252980	/users/cn/jespinosa/phecomp/data/CRG/20120502_FDF_CRG/20120502_FDF_CRG/20120504_FDF_CRG_c12.mtb	1154	NA	WWSS	water	1	130755	1336252941	1	0.12	0.00307692307692308	2465	1
1	Drink 2	Intake 2	17	130801	1336252987	/users/cn/jespinosa/phecomp/data/CRG/20120502_FDF_CRG/20120502_FDF_CRG/20120504_FDF_CRG_c12.mtb	471	NA	WWSS	water	2	130784	1336252970	1	0.02	0.00117647058823529	2466	1
1	Drink 1	Intake 1	31	131446	1336253632	/users/cn/jespinosa/phecomp/data/CRG/20120502_FDF_CRG/20120502_FDF_CRG/20120504_FDF_CRG_c12.mtb	1158	NA	WWSS	water	1	131415	1336253601	1	0.1	0.0032258064516129	2467	1
1	Food 2	Intake 4	271	131822	1336254008	/users/cn/jespinosa/phecomp/data/CRG/20120502_FDF_CRG/20120502_FDF_CRG/20120504_FDF_CRG_c12.mtb	865	932	WWSS	food_sc	4	131551	1336253737	1	0.0999999999999999	0.0003690036900369	2468	1
1	Drink 1	Intake 1	20	131839	1336254025	/users/cn/jespinosa/phecomp/data/CRG/20120502_FDF_CRG/20120502_FDF_CRG/20120504_FDF_CRG_c12.mtb	1159	NA	WWSS	water	1	131819	1336254005	1	0.02	0.001	2469	1
1	Drink 1	Intake 1	29	132046	1336254232	/users/cn/jespinosa/phecomp/data/CRG/20120502_FDF_CRG/20120502_FDF_CRG/20120504_FDF_CRG_c12.mtb	1160	NA	WWSS	water	1	132017	1336254203	1	0.02	0.000689655172413793	2470	1
1	Food 2	Intake 4	89	132843	1336255029	/users/cn/jespinosa/phecomp/data/CRG/20120502_FDF_CRG/20120502_FDF_CRG/20120504_FDF_CRG_c12.mtb	871	2993	WWSS	food_sc	4	132754	1336254940	1	0.04	0.000449438202247191	2471	1
1	Drink 1	Intake 1	26	132993	1336255179	/users/cn/jespinosa/phecomp/data/CRG/20120502_FDF_CRG/20120502_FDF_CRG/20120504_FDF_CRG_c12.mtb	1163	NA	WWSS	water	1	132967	1336255153	1	0.0800000000000001	0.00307692307692308	2472	1
1	Food 2	Intake 4	24	135860	1336258046	/users/cn/jespinosa/phecomp/data/CRG/20120502_FDF_CRG/20120502_FDF_CRG/20120504_FDF_CRG_c12.mtb	875	17	WWSS	food_sc	4	135836	1336258022	1	0.02	0.000833333333333333	2473	1
1	Food 2	Intake 4	543	136420	1336258606	/users/cn/jespinosa/phecomp/data/CRG/20120502_FDF_CRG/20120502_FDF_CRG/20120504_FDF_CRG_c12.mtb	876	471	WWSS	food_sc	4	135877	1336258063	1	0.18	0.000331491712707182	2474	1
1	Drink 1	Intake 1	45	136457	1336258643	/users/cn/jespinosa/phecomp/data/CRG/20120502_FDF_CRG/20120502_FDF_CRG/20120504_FDF_CRG_c12.mtb	1168	NA	WWSS	water	1	136412	1336258598	1	0.04	0.000888888888888889	2475	1
1	Drink 1	Intake 1	22	136868	1336259054	/users/cn/jespinosa/phecomp/data/CRG/20120502_FDF_CRG/20120502_FDF_CRG/20120504_FDF_CRG_c12.mtb	1172	NA	WWSS	water	1	136846	1336259032	1	0.02	0.000909090909090909	2476	1
1	Food 2	Intake 4	129	137020	1336259206	/users/cn/jespinosa/phecomp/data/CRG/20120502_FDF_CRG/20120502_FDF_CRG/20120504_FDF_CRG_c12.mtb	881	188	WWSS	food_sc	4	136891	1336259077	1	0.04	0.000310077519379845	2477	1
1	Drink 1	Intake 1	39	137055	1336259241	/users/cn/jespinosa/phecomp/data/CRG/20120502_FDF_CRG/20120502_FDF_CRG/20120504_FDF_CRG_c12.mtb	1173	NA	WWSS	water	1	137016	1336259202	1	0.16	0.0041025641025641	2478	1
1	Food 2	Intake 4	134	137342	1336259528	/users/cn/jespinosa/phecomp/data/CRG/20120502_FDF_CRG/20120502_FDF_CRG/20120504_FDF_CRG_c12.mtb	882	59	WWSS	food_sc	4	137208	1336259394	1	0.0600000000000001	0.000447761194029852	2479	1
1	Food 2	Intake 4	49	137450	1336259636	/users/cn/jespinosa/phecomp/data/CRG/20120502_FDF_CRG/20120502_FDF_CRG/20120504_FDF_CRG_c12.mtb	883	1073	WWSS	food_sc	4	137401	1336259587	1	0.04	0.000816326530612245	2480	1
1	Drink 2	Intake 2	26	137655	1336259841	/users/cn/jespinosa/phecomp/data/CRG/20120502_FDF_CRG/20120502_FDF_CRG/20120504_FDF_CRG_c12.mtb	474	NA	WWSS	water	2	137629	1336259815	1	0.04	0.00153846153846154	2481	1
1	Drink 1	Intake 1	36	138222	1336260408	/users/cn/jespinosa/phecomp/data/CRG/20120502_FDF_CRG/20120502_FDF_CRG/20120504_FDF_CRG_c12.mtb	1178	NA	WWSS	water	1	138186	1336260372	1	0.02	0.000555555555555556	2482	1
1	Drink 2	Intake 2	22	138327	1336260513	/users/cn/jespinosa/phecomp/data/CRG/20120502_FDF_CRG/20120502_FDF_CRG/20120504_FDF_CRG_c12.mtb	476	NA	WWSS	water	2	138305	1336260491	1	0.0600000000000001	0.00272727272727273	2483	1
1	Food 2	Intake 4	91	138614	1336260800	/users/cn/jespinosa/phecomp/data/CRG/20120502_FDF_CRG/20120502_FDF_CRG/20120504_FDF_CRG_c12.mtb	887	831	WWSS	food_sc	4	138523	1336260709	1	0.0600000000000001	0.00065934065934066	2484	1
1	Food 2	Intake 4	75	139520	1336261706	/users/cn/jespinosa/phecomp/data/CRG/20120502_FDF_CRG/20120502_FDF_CRG/20120504_FDF_CRG_c12.mtb	891	582	WWSS	food_sc	4	139445	1336261631	1	0.4	0.00533333333333333	2485	1
1	Drink 1	Intake 1	18	139620	1336261806	/users/cn/jespinosa/phecomp/data/CRG/20120502_FDF_CRG/20120502_FDF_CRG/20120504_FDF_CRG_c12.mtb	1181	NA	WWSS	water	1	139602	1336261788	1	0.02	0.00111111111111111	2486	1
1	Drink 2	Intake 2	47	139872	1336262058	/users/cn/jespinosa/phecomp/data/CRG/20120502_FDF_CRG/20120502_FDF_CRG/20120504_FDF_CRG_c12.mtb	477	NA	WWSS	water	2	139825	1336262011	1	0.04	0.000851063829787234	2487	1
1	Food 2	Intake 4	59	140161	1336262347	/users/cn/jespinosa/phecomp/data/CRG/20120502_FDF_CRG/20120502_FDF_CRG/20120504_FDF_CRG_c12.mtb	895	11910	WWSS	food_sc	4	140102	1336262288	1	0.02	0.000338983050847458	2488	1
1	Drink 1	Intake 1	20	140412	1336262598	/users/cn/jespinosa/phecomp/data/CRG/20120502_FDF_CRG/20120502_FDF_CRG/20120504_FDF_CRG_c12.mtb	1184	NA	WWSS	water	1	140392	1336262578	1	0.04	0.002	2489	1
1	Drink 1	Intake 1	36	140502	1336262688	/users/cn/jespinosa/phecomp/data/CRG/20120502_FDF_CRG/20120502_FDF_CRG/20120504_FDF_CRG_c12.mtb	1185	NA	WWSS	water	1	140466	1336262652	1	0.0600000000000001	0.00166666666666667	2490	1
1	Drink 1	Intake 1	17	140715	1336262901	/users/cn/jespinosa/phecomp/data/CRG/20120502_FDF_CRG/20120502_FDF_CRG/20120504_FDF_CRG_c12.mtb	1186	NA	WWSS	water	1	140698	1336262884	1	0.02	0.00117647058823529	2491	1
1	Drink 2	Intake 2	17	144763	1336266949	/users/cn/jespinosa/phecomp/data/CRG/20120502_FDF_CRG/20120502_FDF_CRG/20120504_FDF_CRG_c12.mtb	480	NA	WWSS	water	2	144746	1336266932	1	0.02	0.00117647058823529	2492	1
1	Drink 1	Intake 1	36	148400	1336270586	/users/cn/jespinosa/phecomp/data/CRG/20120502_FDF_CRG/20120502_FDF_CRG/20120504_FDF_CRG_c12.mtb	1196	NA	WWSS	water	1	148364	1336270550	1	0.16	0.00444444444444444	2493	1
1	Food 2	Intake 4	102	152173	1336274359	/users/cn/jespinosa/phecomp/data/CRG/20120502_FDF_CRG/20120502_FDF_CRG/20120504_FDF_CRG_c12.mtb	907	12	WWSS	food_sc	4	152071	1336274257	1	0.02	0.000196078431372549	2494	1
1	Food 2	Intake 4	316	152501	1336274687	/users/cn/jespinosa/phecomp/data/CRG/20120502_FDF_CRG/20120502_FDF_CRG/20120504_FDF_CRG_c12.mtb	908	347	WWSS	food_sc	4	152185	1336274371	1	0.14	0.000443037974683544	2495	1
1	Drink 1	Intake 1	33	152529	1336274715	/users/cn/jespinosa/phecomp/data/CRG/20120502_FDF_CRG/20120502_FDF_CRG/20120504_FDF_CRG_c12.mtb	1198	NA	WWSS	water	1	152496	1336274682	1	0.0800000000000001	0.00242424242424243	2496	1
1	Food 2	Intake 4	78	152926	1336275112	/users/cn/jespinosa/phecomp/data/CRG/20120502_FDF_CRG/20120502_FDF_CRG/20120504_FDF_CRG_c12.mtb	912	54	WWSS	food_sc	4	152848	1336275034	1	0.0600000000000001	0.000769230769230771	2497	1
1	Food 2	Intake 4	51	153031	1336275217	/users/cn/jespinosa/phecomp/data/CRG/20120502_FDF_CRG/20120502_FDF_CRG/20120504_FDF_CRG_c12.mtb	913	131	WWSS	food_sc	4	152980	1336275166	1	0.02	0.000392156862745098	2498	1
1	Drink 1	Intake 1	65	153132	1336275318	/users/cn/jespinosa/phecomp/data/CRG/20120502_FDF_CRG/20120502_FDF_CRG/20120504_FDF_CRG_c12.mtb	1200	NA	WWSS	water	1	153067	1336275253	1	0.0999999999999996	0.00153846153846153	2499	1
1	Food 2	Intake 4	80	153242	1336275428	/users/cn/jespinosa/phecomp/data/CRG/20120502_FDF_CRG/20120502_FDF_CRG/20120504_FDF_CRG_c12.mtb	915	101	WWSS	food_sc	4	153162	1336275348	1	0.02	0.00025	2500	1
1	Drink 1	Intake 1	20	153254	1336275440	/users/cn/jespinosa/phecomp/data/CRG/20120502_FDF_CRG/20120502_FDF_CRG/20120504_FDF_CRG_c12.mtb	1201	NA	WWSS	water	1	153234	1336275420	1	0.02	0.001	2501	1
1	Food 2	Intake 4	88	153431	1336275617	/users/cn/jespinosa/phecomp/data/CRG/20120502_FDF_CRG/20120502_FDF_CRG/20120504_FDF_CRG_c12.mtb	916	2644	WWSS	food_sc	4	153343	1336275529	1	0.02	0.000227272727272727	2502	1
1	Drink 2	Intake 2	23	153459	1336275645	/users/cn/jespinosa/phecomp/data/CRG/20120502_FDF_CRG/20120502_FDF_CRG/20120504_FDF_CRG_c12.mtb	481	NA	WWSS	water	2	153436	1336275622	1	0.04	0.00173913043478261	2503	1
1	Drink 1	Intake 1	33	153552	1336275738	/users/cn/jespinosa/phecomp/data/CRG/20120502_FDF_CRG/20120502_FDF_CRG/20120504_FDF_CRG_c12.mtb	1203	NA	WWSS	water	1	153519	1336275705	1	0.02	0.000606060606060606	2504	1
1	Drink 1	Intake 1	28	153703	1336275889	/users/cn/jespinosa/phecomp/data/CRG/20120502_FDF_CRG/20120502_FDF_CRG/20120504_FDF_CRG_c12.mtb	1204	NA	WWSS	water	1	153675	1336275861	1	0.0800000000000001	0.00285714285714286	2505	1
1	Food 2	Intake 4	40	156115	1336278301	/users/cn/jespinosa/phecomp/data/CRG/20120502_FDF_CRG/20120502_FDF_CRG/20120504_FDF_CRG_c12.mtb	918	62	WWSS	food_sc	4	156075	1336278261	1	0.02	0.0005	2506	1
1	Food 2	Intake 4	87	156264	1336278450	/users/cn/jespinosa/phecomp/data/CRG/20120502_FDF_CRG/20120502_FDF_CRG/20120504_FDF_CRG_c12.mtb	919	4	WWSS	food_sc	4	156177	1336278363	1	0.04	0.000459770114942529	2507	1
1	Food 2	Intake 4	75	156343	1336278529	/users/cn/jespinosa/phecomp/data/CRG/20120502_FDF_CRG/20120502_FDF_CRG/20120504_FDF_CRG_c12.mtb	920	248	WWSS	food_sc	4	156268	1336278454	1	0.02	0.000266666666666667	2508	1
1	Food 1	Intake 3	58	156649	1336278835	/users/cn/jespinosa/phecomp/data/CRG/20120502_FDF_CRG/20120502_FDF_CRG/20120504_FDF_CRG_c12.mtb	760	120	WWSS	food_sc	3	156591	1336278777	1	0.02	0.000344827586206897	2509	1
1	Drink 2	Intake 2	25	156666	1336278852	/users/cn/jespinosa/phecomp/data/CRG/20120502_FDF_CRG/20120502_FDF_CRG/20120504_FDF_CRG_c12.mtb	484	NA	WWSS	water	2	156641	1336278827	1	0.02	0.0008	2510	1
1	Drink 1	Intake 1	17	156764	1336278950	/users/cn/jespinosa/phecomp/data/CRG/20120502_FDF_CRG/20120502_FDF_CRG/20120504_FDF_CRG_c12.mtb	1207	NA	WWSS	water	1	156747	1336278933	1	0.02	0.00117647058823529	2511	1
1	Food 2	Intake 4	118	156887	1336279073	/users/cn/jespinosa/phecomp/data/CRG/20120502_FDF_CRG/20120502_FDF_CRG/20120504_FDF_CRG_c12.mtb	925	248	WWSS	food_sc	4	156769	1336278955	1	0.02	0.000169491525423729	2512	1
1	Food 2	Intake 4	89	157224	1336279410	/users/cn/jespinosa/phecomp/data/CRG/20120502_FDF_CRG/20120502_FDF_CRG/20120504_FDF_CRG_c12.mtb	928	89	WWSS	food_sc	4	157135	1336279321	1	0.02	0.000224719101123596	2513	1
1	Drink 2	Intake 2	41	157307	1336279493	/users/cn/jespinosa/phecomp/data/CRG/20120502_FDF_CRG/20120502_FDF_CRG/20120504_FDF_CRG_c12.mtb	485	NA	WWSS	water	2	157266	1336279452	1	0.0999999999999999	0.0024390243902439	2514	1
1	Food 2	Intake 4	197	157510	1336279696	/users/cn/jespinosa/phecomp/data/CRG/20120502_FDF_CRG/20120502_FDF_CRG/20120504_FDF_CRG_c12.mtb	929	116	WWSS	food_sc	4	157313	1336279499	1	0.0600000000000001	0.000304568527918782	2515	1
1	Food 2	Intake 4	141	157767	1336279953	/users/cn/jespinosa/phecomp/data/CRG/20120502_FDF_CRG/20120502_FDF_CRG/20120504_FDF_CRG_c12.mtb	931	672	WWSS	food_sc	4	157626	1336279812	1	0.04	0.000283687943262411	2516	1
1	Drink 1	Intake 1	25	157967	1336280153	/users/cn/jespinosa/phecomp/data/CRG/20120502_FDF_CRG/20120502_FDF_CRG/20120504_FDF_CRG_c12.mtb	1208	NA	WWSS	water	1	157942	1336280128	1	0.1	0.004	2517	1
1	Food 2	Intake 4	55	158494	1336280680	/users/cn/jespinosa/phecomp/data/CRG/20120502_FDF_CRG/20120502_FDF_CRG/20120504_FDF_CRG_c12.mtb	936	446	WWSS	food_sc	4	158439	1336280625	1	0.04	0.000727272727272727	2518	1
1	Food 2	Intake 4	108	159048	1336281234	/users/cn/jespinosa/phecomp/data/CRG/20120502_FDF_CRG/20120502_FDF_CRG/20120504_FDF_CRG_c12.mtb	938	434	WWSS	food_sc	4	158940	1336281126	1	0.02	0.000185185185185185	2519	1
1	Food 2	Intake 4	112	159594	1336281780	/users/cn/jespinosa/phecomp/data/CRG/20120502_FDF_CRG/20120502_FDF_CRG/20120504_FDF_CRG_c12.mtb	939	6	WWSS	food_sc	4	159482	1336281668	1	0.02	0.000178571428571429	2520	1
1	Food 2	Intake 4	144	159744	1336281930	/users/cn/jespinosa/phecomp/data/CRG/20120502_FDF_CRG/20120502_FDF_CRG/20120504_FDF_CRG_c12.mtb	940	489	WWSS	food_sc	4	159600	1336281786	1	0.02	0.000138888888888889	2521	1
1	Drink 1	Intake 1	9	159754	1336281940	/users/cn/jespinosa/phecomp/data/CRG/20120502_FDF_CRG/20120502_FDF_CRG/20120504_FDF_CRG_c12.mtb	1211	NA	WWSS	water	1	159745	1336281931	1	0.0200000000000005	0.00222222222222228	2522	1
1	Food 2	Intake 4	98	160331	1336282517	/users/cn/jespinosa/phecomp/data/CRG/20120502_FDF_CRG/20120502_FDF_CRG/20120504_FDF_CRG_c12.mtb	944	244	WWSS	food_sc	4	160233	1336282419	1	0.04	0.000408163265306122	2523	1
1	Food 1	Intake 3	100	160675	1336282861	/users/cn/jespinosa/phecomp/data/CRG/20120502_FDF_CRG/20120502_FDF_CRG/20120504_FDF_CRG_c12.mtb	782	69	WWSS	food_sc	3	160575	1336282761	1	0.34	0.0034	2524	1
1	Food 1	Intake 3	51	160795	1336282981	/users/cn/jespinosa/phecomp/data/CRG/20120502_FDF_CRG/20120502_FDF_CRG/20120504_FDF_CRG_c12.mtb	783	856	WWSS	food_sc	3	160744	1336282930	1	0.02	0.000392156862745098	2525	1
1	Drink 1	Intake 1	35	161265	1336283451	/users/cn/jespinosa/phecomp/data/CRG/20120502_FDF_CRG/20120502_FDF_CRG/20120504_FDF_CRG_c12.mtb	1214	NA	WWSS	water	1	161230	1336283416	1	0.12	0.00342857142857143	2526	1
1	Food 2	Intake 4	15	161666	1336283852	/users/cn/jespinosa/phecomp/data/CRG/20120502_FDF_CRG/20120502_FDF_CRG/20120504_FDF_CRG_c12.mtb	953	28702	WWSS	food_sc	4	161651	1336283837	1	0.0200000000000005	0.00133333333333337	2527	1
1	Drink 2	Intake 2	20	165200	1336287386	/users/cn/jespinosa/phecomp/data/CRG/20120502_FDF_CRG/20120502_FDF_CRG/20120504_FDF_CRG_c12.mtb	487	NA	WWSS	water	2	165180	1336287366	1	0.02	0.001	2528	1
1	Drink 1	Intake 1	33	173284	1336295470	/users/cn/jespinosa/phecomp/data/CRG/20120502_FDF_CRG/20120502_FDF_CRG/20120504_FDF_CRG_c12.mtb	1217	NA	WWSS	water	1	173251	1336295437	1	0.2	0.00606060606060606	2529	1
1	Drink 2	Intake 2	15	175071	1336297257	/users/cn/jespinosa/phecomp/data/CRG/20120502_FDF_CRG/20120502_FDF_CRG/20120504_FDF_CRG_c12.mtb	490	NA	WWSS	water	2	175056	1336297242	1	0.04	0.00266666666666667	2530	1
1	Food 2	Intake 4	16	190384	1336312570	/users/cn/jespinosa/phecomp/data/CRG/20120502_FDF_CRG/20120502_FDF_CRG/20120504_FDF_CRG_c12.mtb	961	1327	WWSS	food_sc	4	190368	1336312554	1	0.02	0.00125	2531	1
1	Food 2	Intake 4	172	191883	1336314069	/users/cn/jespinosa/phecomp/data/CRG/20120502_FDF_CRG/20120502_FDF_CRG/20120504_FDF_CRG_c12.mtb	964	891	WWSS	food_sc	4	191711	1336313897	1	0.04	0.000232558139534884	2532	1
1	Food 2	Intake 4	20	192794	1336314980	/users/cn/jespinosa/phecomp/data/CRG/20120502_FDF_CRG/20120502_FDF_CRG/20120504_FDF_CRG_c12.mtb	968	8082	WWSS	food_sc	4	192774	1336314960	1	0.02	0.001	2533	1
1	Food 2	Intake 4	874	201750	1336323936	/users/cn/jespinosa/phecomp/data/CRG/20120502_FDF_CRG/20120502_FDF_CRG/20120504_FDF_CRG_c12.mtb	972	2084	WWSS	food_sc	4	200876	1336323062	1	0.1	0.00011441647597254	2534	1
1	Food 2	Intake 4	973	204807	1336326993	/users/cn/jespinosa/phecomp/data/CRG/20120502_FDF_CRG/20120502_FDF_CRG/20120504_FDF_CRG_c12.mtb	974	1088	WWSS	food_sc	4	203834	1336326020	1	0.2	0.000205549845837616	2535	1
1	Drink 1	Intake 1	44	204844	1336327030	/users/cn/jespinosa/phecomp/data/CRG/20120502_FDF_CRG/20120502_FDF_CRG/20120504_FDF_CRG_c12.mtb	1220	NA	WWSS	water	1	204800	1336326986	1	0.0200000000000005	0.000454545454545466	2536	1
1	Drink 2	Intake 2	16	205890	1336328076	/users/cn/jespinosa/phecomp/data/CRG/20120502_FDF_CRG/20120502_FDF_CRG/20120504_FDF_CRG_c12.mtb	493	NA	WWSS	water	2	205874	1336328060	1	0.04	0.0025	2537	1
1	Food 2	Intake 4	24	205919	1336328105	/users/cn/jespinosa/phecomp/data/CRG/20120502_FDF_CRG/20120502_FDF_CRG/20120504_FDF_CRG_c12.mtb	975	11	WWSS	food_sc	4	205895	1336328081	1	0.02	0.000833333333333333	2538	1
1	Food 2	Intake 4	249	206179	1336328365	/users/cn/jespinosa/phecomp/data/CRG/20120502_FDF_CRG/20120502_FDF_CRG/20120504_FDF_CRG_c12.mtb	976	1052	WWSS	food_sc	4	205930	1336328116	1	0.0599999999999996	0.000240963855421685	2539	1
1	Food 2	Intake 4	238	207469	1336329655	/users/cn/jespinosa/phecomp/data/CRG/20120502_FDF_CRG/20120502_FDF_CRG/20120504_FDF_CRG_c12.mtb	977	1148	WWSS	food_sc	4	207231	1336329417	1	0.0600000000000001	0.000252100840336135	2540	1
1	Drink 1	Intake 1	12	208332	1336330518	/users/cn/jespinosa/phecomp/data/CRG/20120502_FDF_CRG/20120502_FDF_CRG/20120504_FDF_CRG_c12.mtb	1225	NA	WWSS	water	1	208320	1336330506	1	0.0600000000000005	0.00500000000000004	2541	1
1	Food 2	Intake 4	463	209080	1336331266	/users/cn/jespinosa/phecomp/data/CRG/20120502_FDF_CRG/20120502_FDF_CRG/20120504_FDF_CRG_c12.mtb	980	31	WWSS	food_sc	4	208617	1336330803	1	0.14	0.000302375809935205	2542	1
1	Food 2	Intake 4	180	209291	1336331477	/users/cn/jespinosa/phecomp/data/CRG/20120502_FDF_CRG/20120502_FDF_CRG/20120504_FDF_CRG_c12.mtb	981	823	WWSS	food_sc	4	209111	1336331297	1	0.0600000000000001	0.000333333333333334	2543	1
1	Drink 1	Intake 1	36	209318	1336331504	/users/cn/jespinosa/phecomp/data/CRG/20120502_FDF_CRG/20120502_FDF_CRG/20120504_FDF_CRG_c12.mtb	1226	NA	WWSS	water	1	209282	1336331468	1	0.0399999999999991	0.00111111111111109	2544	1
1	Food 2	Intake 4	126	210240	1336332426	/users/cn/jespinosa/phecomp/data/CRG/20120502_FDF_CRG/20120502_FDF_CRG/20120504_FDF_CRG_c12.mtb	984	1226	WWSS	food_sc	4	210114	1336332300	1	0.04	0.000317460317460317	2545	1
1	Drink 1	Intake 1	26	210275	1336332461	/users/cn/jespinosa/phecomp/data/CRG/20120502_FDF_CRG/20120502_FDF_CRG/20120504_FDF_CRG_c12.mtb	1229	NA	WWSS	water	1	210249	1336332435	1	0.12	0.00461538461538461	2546	1
1	Food 2	Intake 4	389	211855	1336334041	/users/cn/jespinosa/phecomp/data/CRG/20120502_FDF_CRG/20120502_FDF_CRG/20120504_FDF_CRG_c12.mtb	985	569	WWSS	food_sc	4	211466	1336333652	1	0.1	0.00025706940874036	2547	1
1	Drink 1	Intake 1	15	211958	1336334144	/users/cn/jespinosa/phecomp/data/CRG/20120502_FDF_CRG/20120502_FDF_CRG/20120504_FDF_CRG_c12.mtb	1230	NA	WWSS	water	1	211943	1336334129	1	0.0200000000000005	0.00133333333333337	2548	1
1	Food 2	Intake 4	135	212559	1336334745	/users/cn/jespinosa/phecomp/data/CRG/20120502_FDF_CRG/20120502_FDF_CRG/20120504_FDF_CRG_c12.mtb	986	842	WWSS	food_sc	4	212424	1336334610	1	0.04	0.000296296296296296	2549	1
1	Food 2	Intake 4	416	213817	1336336003	/users/cn/jespinosa/phecomp/data/CRG/20120502_FDF_CRG/20120502_FDF_CRG/20120504_FDF_CRG_c12.mtb	995	746	WWSS	food_sc	4	213401	1336335587	1	0.16	0.000384615384615385	2550	1
1	Drink 2	Intake 2	15	213825	1336336011	/users/cn/jespinosa/phecomp/data/CRG/20120502_FDF_CRG/20120502_FDF_CRG/20120504_FDF_CRG_c12.mtb	501	NA	WWSS	water	2	213810	1336335996	1	0.02	0.00133333333333333	2551	1
1	Drink 1	Intake 1	50	214018	1336336204	/users/cn/jespinosa/phecomp/data/CRG/20120502_FDF_CRG/20120502_FDF_CRG/20120504_FDF_CRG_c12.mtb	1244	NA	WWSS	water	1	213968	1336336154	1	0.0800000000000001	0.0016	2552	1
1	Food 2	Intake 4	65	214628	1336336814	/users/cn/jespinosa/phecomp/data/CRG/20120502_FDF_CRG/20120502_FDF_CRG/20120504_FDF_CRG_c12.mtb	999	11	WWSS	food_sc	4	214563	1336336749	1	0.02	0.000307692307692308	2553	1
1	Food 2	Intake 4	120	214759	1336336945	/users/cn/jespinosa/phecomp/data/CRG/20120502_FDF_CRG/20120502_FDF_CRG/20120504_FDF_CRG_c12.mtb	1000	42	WWSS	food_sc	4	214639	1336336825	1	0.02	0.000166666666666667	2554	1
1	Food 2	Intake 4	99	214900	1336337086	/users/cn/jespinosa/phecomp/data/CRG/20120502_FDF_CRG/20120502_FDF_CRG/20120504_FDF_CRG_c12.mtb	1001	282	WWSS	food_sc	4	214801	1336336987	1	0.04	0.000404040404040404	2555	1
1	Drink 1	Intake 1	28	214939	1336337125	/users/cn/jespinosa/phecomp/data/CRG/20120502_FDF_CRG/20120502_FDF_CRG/20120504_FDF_CRG_c12.mtb	1250	NA	WWSS	water	1	214911	1336337097	1	0.0999999999999996	0.00357142857142856	2556	1
1	Food 2	Intake 4	47	215229	1336337415	/users/cn/jespinosa/phecomp/data/CRG/20120502_FDF_CRG/20120502_FDF_CRG/20120504_FDF_CRG_c12.mtb	1002	25	WWSS	food_sc	4	215182	1336337368	1	0.02	0.000425531914893617	2557	1
1	Food 2	Intake 4	196	215450	1336337636	/users/cn/jespinosa/phecomp/data/CRG/20120502_FDF_CRG/20120502_FDF_CRG/20120504_FDF_CRG_c12.mtb	1003	313	WWSS	food_sc	4	215254	1336337440	1	0.12	0.000612244897959184	2558	1
1	Food 2	Intake 4	60	215823	1336338009	/users/cn/jespinosa/phecomp/data/CRG/20120502_FDF_CRG/20120502_FDF_CRG/20120504_FDF_CRG_c12.mtb	1005	442	WWSS	food_sc	4	215763	1336337949	1	0.0200000000000005	0.000333333333333342	2559	1
1	Drink 1	Intake 1	33	216109	1336338295	/users/cn/jespinosa/phecomp/data/CRG/20120502_FDF_CRG/20120502_FDF_CRG/20120504_FDF_CRG_c12.mtb	1257	NA	WWSS	water	1	216076	1336338262	1	0.0800000000000001	0.00242424242424243	2560	1
1	Food 2	Intake 4	181	216446	1336338632	/users/cn/jespinosa/phecomp/data/CRG/20120502_FDF_CRG/20120502_FDF_CRG/20120504_FDF_CRG_c12.mtb	1007	383	WWSS	food_sc	4	216265	1336338451	1	0.04	0.000220994475138122	2561	1
1	Drink 1	Intake 1	21	216662	1336338848	/users/cn/jespinosa/phecomp/data/CRG/20120502_FDF_CRG/20120502_FDF_CRG/20120504_FDF_CRG_c12.mtb	1261	NA	WWSS	water	1	216641	1336338827	1	0.0200000000000005	0.000952380952380976	2562	1
1	Food 2	Intake 4	81	216910	1336339096	/users/cn/jespinosa/phecomp/data/CRG/20120502_FDF_CRG/20120502_FDF_CRG/20120504_FDF_CRG_c12.mtb	1010	49	WWSS	food_sc	4	216829	1336339015	1	0.0200000000000005	0.00024691358024692	2563	1
1	Food 2	Intake 4	159	217118	1336339304	/users/cn/jespinosa/phecomp/data/CRG/20120502_FDF_CRG/20120502_FDF_CRG/20120504_FDF_CRG_c12.mtb	1011	942	WWSS	food_sc	4	216959	1336339145	1	0.04	0.000251572327044025	2564	1
1	Drink 1	Intake 1	25	217133	1336339319	/users/cn/jespinosa/phecomp/data/CRG/20120502_FDF_CRG/20120502_FDF_CRG/20120504_FDF_CRG_c12.mtb	1262	NA	WWSS	water	1	217108	1336339294	1	0.0599999999999996	0.00239999999999998	2565	1
1	Drink 1	Intake 1	38	217907	1336340093	/users/cn/jespinosa/phecomp/data/CRG/20120502_FDF_CRG/20120502_FDF_CRG/20120504_FDF_CRG_c12.mtb	1267	NA	WWSS	water	1	217869	1336340055	1	0.0800000000000001	0.00210526315789474	2566	1
1	Food 2	Intake 4	102	218162	1336340348	/users/cn/jespinosa/phecomp/data/CRG/20120502_FDF_CRG/20120502_FDF_CRG/20120504_FDF_CRG_c12.mtb	1016	61	WWSS	food_sc	4	218060	1336340246	1	0.04	0.000392156862745098	2567	1
1	Food 2	Intake 4	81	218304	1336340490	/users/cn/jespinosa/phecomp/data/CRG/20120502_FDF_CRG/20120502_FDF_CRG/20120504_FDF_CRG_c12.mtb	1018	5355	WWSS	food_sc	4	218223	1336340409	1	0.04	0.000493827160493827	2568	1
1	Food 2	Intake 4	52	223711	1336345897	/users/cn/jespinosa/phecomp/data/CRG/20120502_FDF_CRG/20120502_FDF_CRG/20120504_FDF_CRG_c12.mtb	1023	77	WWSS	food_sc	4	223659	1336345845	1	0.0200000000000005	0.000384615384615394	2569	1
1	Food 2	Intake 4	119	223907	1336346093	/users/cn/jespinosa/phecomp/data/CRG/20120502_FDF_CRG/20120502_FDF_CRG/20120504_FDF_CRG_c12.mtb	1025	14	WWSS	food_sc	4	223788	1336345974	1	0.04	0.000336134453781513	2570	1
1	Food 2	Intake 4	440	224361	1336346547	/users/cn/jespinosa/phecomp/data/CRG/20120502_FDF_CRG/20120502_FDF_CRG/20120504_FDF_CRG_c12.mtb	1026	1138	WWSS	food_sc	4	223921	1336346107	1	0.18	0.000409090909090909	2571	1
1	Drink 1	Intake 1	25	224381	1336346567	/users/cn/jespinosa/phecomp/data/CRG/20120502_FDF_CRG/20120502_FDF_CRG/20120504_FDF_CRG_c12.mtb	1271	NA	WWSS	water	1	224356	1336346542	1	0.0800000000000001	0.0032	2572	1
1	Drink 1	Intake 1	16	224672	1336346858	/users/cn/jespinosa/phecomp/data/CRG/20120502_FDF_CRG/20120502_FDF_CRG/20120504_FDF_CRG_c12.mtb	1272	NA	WWSS	water	1	224656	1336346842	1	0.0200000000000005	0.00125000000000003	2573	1
1	Drink 1	Intake 1	30	224916	1336347102	/users/cn/jespinosa/phecomp/data/CRG/20120502_FDF_CRG/20120502_FDF_CRG/20120504_FDF_CRG_c12.mtb	1273	NA	WWSS	water	1	224886	1336347072	1	0.0999999999999996	0.00333333333333332	2574	1
1	Drink 1	Intake 1	18	225076	1336347262	/users/cn/jespinosa/phecomp/data/CRG/20120502_FDF_CRG/20120502_FDF_CRG/20120504_FDF_CRG_c12.mtb	1274	NA	WWSS	water	1	225058	1336347244	1	0.0200000000000005	0.00111111111111114	2575	1
1	Drink 2	Intake 2	28	225259	1336347445	/users/cn/jespinosa/phecomp/data/CRG/20120502_FDF_CRG/20120502_FDF_CRG/20120504_FDF_CRG_c12.mtb	502	NA	WWSS	water	2	225231	1336347417	1	0.1	0.00357142857142857	2576	1
1	Food 2	Intake 4	104	225603	1336347789	/users/cn/jespinosa/phecomp/data/CRG/20120502_FDF_CRG/20120502_FDF_CRG/20120504_FDF_CRG_c12.mtb	1033	319	WWSS	food_sc	4	225499	1336347685	1	0.0200000000000005	0.000192307692307697	2577	1
1	Drink 2	Intake 2	13	225608	1336347794	/users/cn/jespinosa/phecomp/data/CRG/20120502_FDF_CRG/20120502_FDF_CRG/20120504_FDF_CRG_c12.mtb	504	NA	WWSS	water	2	225595	1336347781	1	0.02	0.00153846153846154	2578	1
1	Drink 2	Intake 2	23	225777	1336347963	/users/cn/jespinosa/phecomp/data/CRG/20120502_FDF_CRG/20120502_FDF_CRG/20120504_FDF_CRG_c12.mtb	505	NA	WWSS	water	2	225754	1336347940	1	0.04	0.00173913043478261	2579	1
1	Food 2	Intake 4	107	226029	1336348215	/users/cn/jespinosa/phecomp/data/CRG/20120502_FDF_CRG/20120502_FDF_CRG/20120504_FDF_CRG_c12.mtb	1035	30	WWSS	food_sc	4	225922	1336348108	1	0.0599999999999996	0.000560747663551398	2580	1
1	Food 2	Intake 4	89	226148	1336348334	/users/cn/jespinosa/phecomp/data/CRG/20120502_FDF_CRG/20120502_FDF_CRG/20120504_FDF_CRG_c12.mtb	1036	862	WWSS	food_sc	4	226059	1336348245	1	0.04	0.000449438202247191	2581	1
1	Food 2	Intake 4	81	227091	1336349277	/users/cn/jespinosa/phecomp/data/CRG/20120502_FDF_CRG/20120502_FDF_CRG/20120504_FDF_CRG_c12.mtb	1040	578	WWSS	food_sc	4	227010	1336349196	1	0.0200000000000005	0.00024691358024692	2582	1
1	Food 2	Intake 4	82	227751	1336349937	/users/cn/jespinosa/phecomp/data/CRG/20120502_FDF_CRG/20120502_FDF_CRG/20120504_FDF_CRG_c12.mtb	1042	1569	WWSS	food_sc	4	227669	1336349855	1	0.0200000000000005	0.000243902439024396	2583	1
1	Drink 2	Intake 2	24	227771	1336349957	/users/cn/jespinosa/phecomp/data/CRG/20120502_FDF_CRG/20120502_FDF_CRG/20120504_FDF_CRG_c12.mtb	506	NA	WWSS	water	2	227747	1336349933	1	0.0800000000000001	0.00333333333333334	2584	1
1	Food 2	Intake 4	123	229443	1336351629	/users/cn/jespinosa/phecomp/data/CRG/20120502_FDF_CRG/20120502_FDF_CRG/20120504_FDF_CRG_c12.mtb	1045	6440	WWSS	food_sc	4	229320	1336351506	1	0.04	0.00032520325203252	2585	1
1	Food 2	Intake 4	24	235907	1336358093	/users/cn/jespinosa/phecomp/data/CRG/20120502_FDF_CRG/20120502_FDF_CRG/20120504_FDF_CRG_c12.mtb	1046	76	WWSS	food_sc	4	235883	1336358069	1	0.04	0.00166666666666667	2586	1
1	Food 2	Intake 4	470	236453	1336358639	/users/cn/jespinosa/phecomp/data/CRG/20120502_FDF_CRG/20120502_FDF_CRG/20120504_FDF_CRG_c12.mtb	1048	370	WWSS	food_sc	4	235983	1336358169	1	0.22	0.000468085106382979	2587	1
1	Drink 1	Intake 1	27	236724	1336358910	/users/cn/jespinosa/phecomp/data/CRG/20120502_FDF_CRG/20120502_FDF_CRG/20120504_FDF_CRG_c12.mtb	1288	NA	WWSS	water	1	236697	1336358883	1	0.12	0.00444444444444444	2588	1
1	Food 2	Intake 4	84	236907	1336359093	/users/cn/jespinosa/phecomp/data/CRG/20120502_FDF_CRG/20120502_FDF_CRG/20120504_FDF_CRG_c12.mtb	1050	4	WWSS	food_sc	4	236823	1336359009	1	0.0200000000000005	0.000238095238095244	2589	1
1	Food 2	Intake 4	68	236979	1336359165	/users/cn/jespinosa/phecomp/data/CRG/20120502_FDF_CRG/20120502_FDF_CRG/20120504_FDF_CRG_c12.mtb	1051	4976	WWSS	food_sc	4	236911	1336359097	1	0.04	0.000588235294117647	2590	1
1	Drink 1	Intake 1	31	237150	1336359336	/users/cn/jespinosa/phecomp/data/CRG/20120502_FDF_CRG/20120502_FDF_CRG/20120504_FDF_CRG_c12.mtb	1289	NA	WWSS	water	1	237119	1336359305	1	0.0200000000000005	0.000645161290322597	2591	1
1	Drink 2	Intake 2	35	237376	1336359562	/users/cn/jespinosa/phecomp/data/CRG/20120502_FDF_CRG/20120502_FDF_CRG/20120504_FDF_CRG_c12.mtb	507	NA	WWSS	water	2	237341	1336359527	1	0.14	0.004	2592	1
1	Food 2	Intake 4	23	241978	1336364164	/users/cn/jespinosa/phecomp/data/CRG/20120502_FDF_CRG/20120502_FDF_CRG/20120504_FDF_CRG_c12.mtb	1054	332	WWSS	food_sc	4	241955	1336364141	1	0.0200000000000005	0.000869565217391326	2593	1
1	Food 2	Intake 4	231	242541	1336364727	/users/cn/jespinosa/phecomp/data/CRG/20120502_FDF_CRG/20120502_FDF_CRG/20120504_FDF_CRG_c12.mtb	1055	146	WWSS	food_sc	4	242310	1336364496	1	0.04	0.000173160173160173	2594	1
1	Drink 2	Intake 2	20	242584	1336364770	/users/cn/jespinosa/phecomp/data/CRG/20120502_FDF_CRG/20120502_FDF_CRG/20120504_FDF_CRG_c12.mtb	508	NA	WWSS	water	2	242564	1336364750	1	0.0800000000000001	0.00400000000000001	2595	1
1	Food 2	Intake 4	211	242898	1336365084	/users/cn/jespinosa/phecomp/data/CRG/20120502_FDF_CRG/20120502_FDF_CRG/20120504_FDF_CRG_c12.mtb	1058	115	WWSS	food_sc	4	242687	1336364873	1	0.0800000000000001	0.00037914691943128	2596	1
1	Drink 1	Intake 1	26	242921	1336365107	/users/cn/jespinosa/phecomp/data/CRG/20120502_FDF_CRG/20120502_FDF_CRG/20120504_FDF_CRG_c12.mtb	1292	NA	WWSS	water	1	242895	1336365081	1	0.0599999999999996	0.00230769230769229	2597	1
1	Food 2	Intake 4	52	243065	1336365251	/users/cn/jespinosa/phecomp/data/CRG/20120502_FDF_CRG/20120502_FDF_CRG/20120504_FDF_CRG_c12.mtb	1060	93	WWSS	food_sc	4	243013	1336365199	1	0.0200000000000005	0.000384615384615394	2598	1
1	Food 2	Intake 4	49	243207	1336365393	/users/cn/jespinosa/phecomp/data/CRG/20120502_FDF_CRG/20120502_FDF_CRG/20120504_FDF_CRG_c12.mtb	1062	799	WWSS	food_sc	4	243158	1336365344	1	0.04	0.000816326530612245	2599	1
1	Drink 2	Intake 2	44	243341	1336365527	/users/cn/jespinosa/phecomp/data/CRG/20120502_FDF_CRG/20120502_FDF_CRG/20120504_FDF_CRG_c12.mtb	509	NA	WWSS	water	2	243297	1336365483	1	0.14	0.00318181818181818	2600	1
1	Food 2	Intake 4	151	244157	1336366343	/users/cn/jespinosa/phecomp/data/CRG/20120502_FDF_CRG/20120502_FDF_CRG/20120504_FDF_CRG_c12.mtb	1066	694	WWSS	food_sc	4	244006	1336366192	1	0.04	0.000264900662251656	2601	1
1	Drink 2	Intake 2	17	244164	1336366350	/users/cn/jespinosa/phecomp/data/CRG/20120502_FDF_CRG/20120502_FDF_CRG/20120504_FDF_CRG_c12.mtb	511	NA	WWSS	water	2	244147	1336366333	1	0.04	0.00235294117647059	2602	1
1	Drink 2	Intake 2	17	244195	1336366381	/users/cn/jespinosa/phecomp/data/CRG/20120502_FDF_CRG/20120502_FDF_CRG/20120504_FDF_CRG_c12.mtb	512	NA	WWSS	water	2	244178	1336366364	1	0.02	0.00117647058823529	2603	1
1	Drink 2	Intake 2	24	244795	1336366981	/users/cn/jespinosa/phecomp/data/CRG/20120502_FDF_CRG/20120502_FDF_CRG/20120504_FDF_CRG_c12.mtb	513	NA	WWSS	water	2	244771	1336366957	1	0.0600000000000001	0.0025	2604	1
1	Food 2	Intake 4	146	244997	1336367183	/users/cn/jespinosa/phecomp/data/CRG/20120502_FDF_CRG/20120502_FDF_CRG/20120504_FDF_CRG_c12.mtb	1069	52	WWSS	food_sc	4	244851	1336367037	1	0.04	0.000273972602739726	2605	1
1	Food 2	Intake 4	111	245160	1336367346	/users/cn/jespinosa/phecomp/data/CRG/20120502_FDF_CRG/20120502_FDF_CRG/20120504_FDF_CRG_c12.mtb	1070	1161	WWSS	food_sc	4	245049	1336367235	1	0.04	0.00036036036036036	2606	1
1	Drink 1	Intake 1	34	245393	1336367579	/users/cn/jespinosa/phecomp/data/CRG/20120502_FDF_CRG/20120502_FDF_CRG/20120504_FDF_CRG_c12.mtb	1300	NA	WWSS	water	1	245359	1336367545	1	0.0200000000000005	0.000588235294117662	2607	1
1	Food 2	Intake 4	110	246431	1336368617	/users/cn/jespinosa/phecomp/data/CRG/20120502_FDF_CRG/20120502_FDF_CRG/20120504_FDF_CRG_c12.mtb	1079	20703	WWSS	food_sc	4	246321	1336368507	1	0.04	0.000363636363636364	2608	1
1	Drink 1	Intake 1	20	247018	1336369204	/users/cn/jespinosa/phecomp/data/CRG/20120502_FDF_CRG/20120502_FDF_CRG/20120504_FDF_CRG_c12.mtb	1310	NA	WWSS	water	1	246998	1336369184	1	0.04	0.002	2609	1
1	Drink 1	Intake 1	37	249877	1336372063	/users/cn/jespinosa/phecomp/data/CRG/20120502_FDF_CRG/20120502_FDF_CRG/20120504_FDF_CRG_c12.mtb	1313	NA	WWSS	water	1	249840	1336372026	1	0.0200000000000005	0.000540540540540554	2610	1
1	Drink 2	Intake 2	15	251988	1336374174	/users/cn/jespinosa/phecomp/data/CRG/20120502_FDF_CRG/20120502_FDF_CRG/20120504_FDF_CRG_c12.mtb	514	NA	WWSS	water	2	251973	1336374159	1	0.02	0.00133333333333333	2611	1
1	Drink 2	Intake 2	33	309	1336382820	/users/cn/jespinosa/phecomp/data/CRG/20120502_FDF_CRG/20120502_FDF_CRG/20120507_FDF_CRG_c12.mtb	587	NA	WWSS	water	2	276	1336382787	1	0.02	0.000606060606060606	2612	1
1	Food 2	Intake 4	281	7090	1336389601	/users/cn/jespinosa/phecomp/data/CRG/20120502_FDF_CRG/20120502_FDF_CRG/20120507_FDF_CRG_c12.mtb	1277	12036	WWSS	food_sc	4	6809	1336389320	1	0.1	0.000355871886120996	2613	1
1	Food 2	Intake 4	506	19632	1336402143	/users/cn/jespinosa/phecomp/data/CRG/20120502_FDF_CRG/20120502_FDF_CRG/20120507_FDF_CRG_c12.mtb	1280	70	WWSS	food_sc	4	19126	1336401637	1	0.1	0.000197628458498024	2614	1
1	Food 2	Intake 4	66	19768	1336402279	/users/cn/jespinosa/phecomp/data/CRG/20120502_FDF_CRG/20120502_FDF_CRG/20120507_FDF_CRG_c12.mtb	1281	5994	WWSS	food_sc	4	19702	1336402213	1	0.02	0.000303030303030303	2615	1
1	Drink 1	Intake 1	23	19790	1336402301	/users/cn/jespinosa/phecomp/data/CRG/20120502_FDF_CRG/20120502_FDF_CRG/20120507_FDF_CRG_c12.mtb	1449	NA	WWSS	water	1	19767	1336402278	1	0.06	0.00260869565217391	2616	1
1	Food 2	Intake 4	591	26353	1336408864	/users/cn/jespinosa/phecomp/data/CRG/20120502_FDF_CRG/20120502_FDF_CRG/20120507_FDF_CRG_c12.mtb	1283	3670	WWSS	food_sc	4	25762	1336408273	1	0.12	0.000203045685279188	2617	1
1	Food 2	Intake 4	359	30382	1336412893	/users/cn/jespinosa/phecomp/data/CRG/20120502_FDF_CRG/20120502_FDF_CRG/20120507_FDF_CRG_c12.mtb	1284	4	WWSS	food_sc	4	30023	1336412534	1	0.12	0.000334261838440111	2618	1
1	Food 2	Intake 4	252	30638	1336413149	/users/cn/jespinosa/phecomp/data/CRG/20120502_FDF_CRG/20120502_FDF_CRG/20120507_FDF_CRG_c12.mtb	1285	1874	WWSS	food_sc	4	30386	1336412897	1	0.1	0.000396825396825397	2619	1
1	Drink 1	Intake 1	23	30659	1336413170	/users/cn/jespinosa/phecomp/data/CRG/20120502_FDF_CRG/20120502_FDF_CRG/20120507_FDF_CRG_c12.mtb	1451	NA	WWSS	water	1	30636	1336413147	1	0.04	0.00173913043478261	2620	1
1	Drink 1	Intake 1	19	31415	1336413926	/users/cn/jespinosa/phecomp/data/CRG/20120502_FDF_CRG/20120502_FDF_CRG/20120507_FDF_CRG_c12.mtb	1452	NA	WWSS	water	1	31396	1336413907	1	0.04	0.00210526315789474	2621	1
1	Food 2	Intake 4	292	32804	1336415315	/users/cn/jespinosa/phecomp/data/CRG/20120502_FDF_CRG/20120502_FDF_CRG/20120507_FDF_CRG_c12.mtb	1289	416	WWSS	food_sc	4	32512	1336415023	1	0.12	0.000410958904109589	2622	1
1	Drink 1	Intake 1	31	32841	1336415352	/users/cn/jespinosa/phecomp/data/CRG/20120502_FDF_CRG/20120502_FDF_CRG/20120507_FDF_CRG_c12.mtb	1453	NA	WWSS	water	1	32810	1336415321	1	0.08	0.00258064516129032	2623	1
1	Food 2	Intake 4	191	33411	1336415922	/users/cn/jespinosa/phecomp/data/CRG/20120502_FDF_CRG/20120502_FDF_CRG/20120507_FDF_CRG_c12.mtb	1291	1082	WWSS	food_sc	4	33220	1336415731	1	0.0399999999999999	0.000209424083769633	2624	1
1	Drink 1	Intake 1	22	33429	1336415940	/users/cn/jespinosa/phecomp/data/CRG/20120502_FDF_CRG/20120502_FDF_CRG/20120507_FDF_CRG_c12.mtb	1455	NA	WWSS	water	1	33407	1336415918	1	0.12	0.00545454545454545	2625	1
1	Food 1	Intake 3	203	34696	1336417207	/users/cn/jespinosa/phecomp/data/CRG/20120502_FDF_CRG/20120502_FDF_CRG/20120507_FDF_CRG_c12.mtb	942	1257	WWSS	food_sc	3	34493	1336417004	1	0.08	0.000394088669950739	2626	1
1	Drink 1	Intake 1	16	35151	1336417662	/users/cn/jespinosa/phecomp/data/CRG/20120502_FDF_CRG/20120502_FDF_CRG/20120507_FDF_CRG_c12.mtb	1459	NA	WWSS	water	1	35135	1336417646	1	0.04	0.0025	2627	1
1	Food 2	Intake 4	620	36573	1336419084	/users/cn/jespinosa/phecomp/data/CRG/20120502_FDF_CRG/20120502_FDF_CRG/20120507_FDF_CRG_c12.mtb	1292	658	WWSS	food_sc	4	35953	1336418464	1	0.22	0.000354838709677419	2628	1
1	Drink 2	Intake 2	20	36645	1336419156	/users/cn/jespinosa/phecomp/data/CRG/20120502_FDF_CRG/20120502_FDF_CRG/20120507_FDF_CRG_c12.mtb	591	NA	WWSS	water	2	36625	1336419136	1	0.02	0.001	2629	1
1	Drink 2	Intake 2	25	37086	1336419597	/users/cn/jespinosa/phecomp/data/CRG/20120502_FDF_CRG/20120502_FDF_CRG/20120507_FDF_CRG_c12.mtb	592	NA	WWSS	water	2	37061	1336419572	1	0.06	0.0024	2630	1
1	Food 2	Intake 4	87	37318	1336419829	/users/cn/jespinosa/phecomp/data/CRG/20120502_FDF_CRG/20120502_FDF_CRG/20120507_FDF_CRG_c12.mtb	1296	31	WWSS	food_sc	4	37231	1336419742	1	0.02	0.000229885057471264	2631	1
1	Food 1	Intake 3	43	37392	1336419903	/users/cn/jespinosa/phecomp/data/CRG/20120502_FDF_CRG/20120502_FDF_CRG/20120507_FDF_CRG_c12.mtb	946	612	WWSS	food_sc	3	37349	1336419860	1	0.02	0.000465116279069767	2632	1
1	Drink 2	Intake 2	20	37406	1336419917	/users/cn/jespinosa/phecomp/data/CRG/20120502_FDF_CRG/20120502_FDF_CRG/20120507_FDF_CRG_c12.mtb	593	NA	WWSS	water	2	37386	1336419897	1	0.04	0.002	2633	1
1	Food 2	Intake 4	68	38072	1336420583	/users/cn/jespinosa/phecomp/data/CRG/20120502_FDF_CRG/20120502_FDF_CRG/20120507_FDF_CRG_c12.mtb	1300	166	WWSS	food_sc	4	38004	1336420515	1	0.02	0.000294117647058824	2634	1
1	Food 2	Intake 4	148	38386	1336420897	/users/cn/jespinosa/phecomp/data/CRG/20120502_FDF_CRG/20120502_FDF_CRG/20120507_FDF_CRG_c12.mtb	1301	155	WWSS	food_sc	4	38238	1336420749	1	0.04	0.00027027027027027	2635	1
1	Drink 1	Intake 1	22	38407	1336420918	/users/cn/jespinosa/phecomp/data/CRG/20120502_FDF_CRG/20120502_FDF_CRG/20120507_FDF_CRG_c12.mtb	1463	NA	WWSS	water	1	38385	1336420896	1	0.06	0.00272727272727273	2636	1
1	Food 2	Intake 4	114	38655	1336421166	/users/cn/jespinosa/phecomp/data/CRG/20120502_FDF_CRG/20120502_FDF_CRG/20120507_FDF_CRG_c12.mtb	1302	2496	WWSS	food_sc	4	38541	1336421052	1	0.0600000000000001	0.000526315789473685	2637	1
1	Drink 1	Intake 1	28	38726	1336421237	/users/cn/jespinosa/phecomp/data/CRG/20120502_FDF_CRG/20120502_FDF_CRG/20120507_FDF_CRG_c12.mtb	1465	NA	WWSS	water	1	38698	1336421209	1	0.12	0.00428571428571429	2638	1
1	Food 2	Intake 4	32	41183	1336423694	/users/cn/jespinosa/phecomp/data/CRG/20120502_FDF_CRG/20120502_FDF_CRG/20120507_FDF_CRG_c12.mtb	1306	204	WWSS	food_sc	4	41151	1336423662	1	0.02	0.000625	2639	1
1	Food 2	Intake 4	220	41607	1336424118	/users/cn/jespinosa/phecomp/data/CRG/20120502_FDF_CRG/20120502_FDF_CRG/20120507_FDF_CRG_c12.mtb	1308	36	WWSS	food_sc	4	41387	1336423898	1	0.0599999999999998	0.000272727272727272	2640	1
1	Food 2	Intake 4	125	41768	1336424279	/users/cn/jespinosa/phecomp/data/CRG/20120502_FDF_CRG/20120502_FDF_CRG/20120507_FDF_CRG_c12.mtb	1309	15	WWSS	food_sc	4	41643	1336424154	1	0.0600000000000001	0.000480000000000001	2641	1
1	Food 2	Intake 4	73	41856	1336424367	/users/cn/jespinosa/phecomp/data/CRG/20120502_FDF_CRG/20120502_FDF_CRG/20120507_FDF_CRG_c12.mtb	1310	124	WWSS	food_sc	4	41783	1336424294	1	0.04	0.000547945205479452	2642	1
1	Drink 1	Intake 1	19	41872	1336424383	/users/cn/jespinosa/phecomp/data/CRG/20120502_FDF_CRG/20120502_FDF_CRG/20120507_FDF_CRG_c12.mtb	1469	NA	WWSS	water	1	41853	1336424364	1	0.0399999999999999	0.00210526315789473	2643	1
1	Food 2	Intake 4	74	42054	1336424565	/users/cn/jespinosa/phecomp/data/CRG/20120502_FDF_CRG/20120502_FDF_CRG/20120507_FDF_CRG_c12.mtb	1312	529	WWSS	food_sc	4	41980	1336424491	1	0.04	0.000540540540540541	2644	1
1	Drink 1	Intake 1	16	42077	1336424588	/users/cn/jespinosa/phecomp/data/CRG/20120502_FDF_CRG/20120502_FDF_CRG/20120507_FDF_CRG_c12.mtb	1470	NA	WWSS	water	1	42061	1336424572	1	0.04	0.0025	2645	1
1	Drink 1	Intake 1	25	42583	1336425094	/users/cn/jespinosa/phecomp/data/CRG/20120502_FDF_CRG/20120502_FDF_CRG/20120507_FDF_CRG_c12.mtb	1472	NA	WWSS	water	1	42558	1336425069	1	0.0599999999999999	0.0024	2646	1
1	Food 2	Intake 4	114	42697	1336425208	/users/cn/jespinosa/phecomp/data/CRG/20120502_FDF_CRG/20120502_FDF_CRG/20120507_FDF_CRG_c12.mtb	1316	282	WWSS	food_sc	4	42583	1336425094	1	0.04	0.000350877192982456	2647	1
1	Food 2	Intake 4	123	43102	1336425613	/users/cn/jespinosa/phecomp/data/CRG/20120502_FDF_CRG/20120502_FDF_CRG/20120507_FDF_CRG_c12.mtb	1317	198	WWSS	food_sc	4	42979	1336425490	1	0.0399999999999998	0.000325203252032519	2648	1
1	Drink 2	Intake 2	14	43152	1336425663	/users/cn/jespinosa/phecomp/data/CRG/20120502_FDF_CRG/20120502_FDF_CRG/20120507_FDF_CRG_c12.mtb	595	NA	WWSS	water	2	43138	1336425649	1	0.02	0.00142857142857143	2649	1
1	Food 2	Intake 4	87	43387	1336425898	/users/cn/jespinosa/phecomp/data/CRG/20120502_FDF_CRG/20120502_FDF_CRG/20120507_FDF_CRG_c12.mtb	1319	289	WWSS	food_sc	4	43300	1336425811	1	0.02	0.000229885057471264	2650	1
1	Drink 1	Intake 1	34	43413	1336425924	/users/cn/jespinosa/phecomp/data/CRG/20120502_FDF_CRG/20120502_FDF_CRG/20120507_FDF_CRG_c12.mtb	1474	NA	WWSS	water	1	43379	1336425890	1	0.0800000000000001	0.00235294117647059	2651	1
1	Food 2	Intake 4	34	43710	1336426221	/users/cn/jespinosa/phecomp/data/CRG/20120502_FDF_CRG/20120502_FDF_CRG/20120507_FDF_CRG_c12.mtb	1320	35	WWSS	food_sc	4	43676	1336426187	1	0.02	0.000588235294117647	2652	1
1	Food 2	Intake 4	73	43818	1336426329	/users/cn/jespinosa/phecomp/data/CRG/20120502_FDF_CRG/20120502_FDF_CRG/20120507_FDF_CRG_c12.mtb	1322	1036	WWSS	food_sc	4	43745	1336426256	1	0.04	0.000547945205479452	2653	1
1	Drink 1	Intake 1	31	44560	1336427071	/users/cn/jespinosa/phecomp/data/CRG/20120502_FDF_CRG/20120502_FDF_CRG/20120507_FDF_CRG_c12.mtb	1477	NA	WWSS	water	1	44529	1336427040	1	0.1	0.0032258064516129	2654	1
1	Food 2	Intake 4	68	44922	1336427433	/users/cn/jespinosa/phecomp/data/CRG/20120502_FDF_CRG/20120502_FDF_CRG/20120507_FDF_CRG_c12.mtb	1325	114	WWSS	food_sc	4	44854	1336427365	1	0.02	0.000294117647058824	2655	1
1	Food 2	Intake 4	17	45053	1336427564	/users/cn/jespinosa/phecomp/data/CRG/20120502_FDF_CRG/20120502_FDF_CRG/20120507_FDF_CRG_c12.mtb	1326	697	WWSS	food_sc	4	45036	1336427547	1	0.02	0.00117647058823529	2656	1
1	Drink 1	Intake 1	16	45724	1336428235	/users/cn/jespinosa/phecomp/data/CRG/20120502_FDF_CRG/20120502_FDF_CRG/20120507_FDF_CRG_c12.mtb	1478	NA	WWSS	water	1	45708	1336428219	1	0.02	0.00125	2657	1
1	Food 1	Intake 3	191	45941	1336428452	/users/cn/jespinosa/phecomp/data/CRG/20120502_FDF_CRG/20120502_FDF_CRG/20120507_FDF_CRG_c12.mtb	961	2	WWSS	food_sc	3	45750	1336428261	1	0.04	0.000209424083769634	2658	1
1	Food 2	Intake 4	79	46022	1336428533	/users/cn/jespinosa/phecomp/data/CRG/20120502_FDF_CRG/20120502_FDF_CRG/20120507_FDF_CRG_c12.mtb	1329	1201	WWSS	food_sc	4	45943	1336428454	1	0.02	0.000253164556962025	2659	1
1	Food 2	Intake 4	42	47265	1336429776	/users/cn/jespinosa/phecomp/data/CRG/20120502_FDF_CRG/20120502_FDF_CRG/20120507_FDF_CRG_c12.mtb	1330	3810	WWSS	food_sc	4	47223	1336429734	1	0.02	0.000476190476190476	2660	1
1	Food 2	Intake 4	461	51536	1336434047	/users/cn/jespinosa/phecomp/data/CRG/20120502_FDF_CRG/20120502_FDF_CRG/20120507_FDF_CRG_c12.mtb	1333	53	WWSS	food_sc	4	51075	1336433586	1	0.12	0.000260303687635575	2661	1
1	Food 2	Intake 4	306	51895	1336434406	/users/cn/jespinosa/phecomp/data/CRG/20120502_FDF_CRG/20120502_FDF_CRG/20120507_FDF_CRG_c12.mtb	1334	217	WWSS	food_sc	4	51589	1336434100	1	0.12	0.000392156862745098	2662	1
1	Drink 1	Intake 1	21	51913	1336434424	/users/cn/jespinosa/phecomp/data/CRG/20120502_FDF_CRG/20120502_FDF_CRG/20120507_FDF_CRG_c12.mtb	1481	NA	WWSS	water	1	51892	1336434403	1	0.0399999999999999	0.0019047619047619	2663	1
1	Food 2	Intake 4	84	52196	1336434707	/users/cn/jespinosa/phecomp/data/CRG/20120502_FDF_CRG/20120502_FDF_CRG/20120507_FDF_CRG_c12.mtb	1337	453	WWSS	food_sc	4	52112	1336434623	1	0.0399999999999998	0.000476190476190474	2664	1
1	Drink 1	Intake 1	23	52211	1336434722	/users/cn/jespinosa/phecomp/data/CRG/20120502_FDF_CRG/20120502_FDF_CRG/20120507_FDF_CRG_c12.mtb	1482	NA	WWSS	water	1	52188	1336434699	1	0.0600000000000001	0.00260869565217392	2665	1
1	Drink 2	Intake 2	22	52593	1336435104	/users/cn/jespinosa/phecomp/data/CRG/20120502_FDF_CRG/20120502_FDF_CRG/20120507_FDF_CRG_c12.mtb	597	NA	WWSS	water	2	52571	1336435082	1	0.06	0.00272727272727273	2666	1
1	Food 2	Intake 4	114	52763	1336435274	/users/cn/jespinosa/phecomp/data/CRG/20120502_FDF_CRG/20120502_FDF_CRG/20120507_FDF_CRG_c12.mtb	1341	131	WWSS	food_sc	4	52649	1336435160	1	0.02	0.000175438596491228	2667	1
1	Drink 1	Intake 1	23	52790	1336435301	/users/cn/jespinosa/phecomp/data/CRG/20120502_FDF_CRG/20120502_FDF_CRG/20120507_FDF_CRG_c12.mtb	1483	NA	WWSS	water	1	52767	1336435278	1	0.02	0.000869565217391304	2668	1
1	Drink 2	Intake 2	23	52791	1336435302	/users/cn/jespinosa/phecomp/data/CRG/20120502_FDF_CRG/20120502_FDF_CRG/20120507_FDF_CRG_c12.mtb	598	NA	WWSS	water	2	52768	1336435279	1	0.04	0.00173913043478261	2669	1
1	Food 1	Intake 3	112	53006	1336435517	/users/cn/jespinosa/phecomp/data/CRG/20120502_FDF_CRG/20120502_FDF_CRG/20120507_FDF_CRG_c12.mtb	968	75	WWSS	food_sc	3	52894	1336435405	1	0.08	0.000714285714285714	2670	1
1	Drink 1	Intake 1	36	53042	1336435553	/users/cn/jespinosa/phecomp/data/CRG/20120502_FDF_CRG/20120502_FDF_CRG/20120507_FDF_CRG_c12.mtb	1484	NA	WWSS	water	1	53006	1336435517	1	0.1	0.00277777777777778	2671	1
1	Food 1	Intake 3	79	53160	1336435671	/users/cn/jespinosa/phecomp/data/CRG/20120502_FDF_CRG/20120502_FDF_CRG/20120507_FDF_CRG_c12.mtb	969	COLL	WWSS	food_sc	3	53081	1336435592	1	0.02	0.000253164556962025	2672	1
1	Food 2	Intake 4	34	53181	1336435692	/users/cn/jespinosa/phecomp/data/CRG/20120502_FDF_CRG/20120502_FDF_CRG/20120507_FDF_CRG_c12.mtb	1345	100	WWSS	food_sc	4	53147	1336435658	1	0.02	0.000588235294117647	2673	1
1	Food 2	Intake 4	64	53345	1336435856	/users/cn/jespinosa/phecomp/data/CRG/20120502_FDF_CRG/20120502_FDF_CRG/20120507_FDF_CRG_c12.mtb	1348	9303	WWSS	food_sc	4	53281	1336435792	1	0.02	0.0003125	2674	1
1	Drink 1	Intake 1	13	53354	1336435865	/users/cn/jespinosa/phecomp/data/CRG/20120502_FDF_CRG/20120502_FDF_CRG/20120507_FDF_CRG_c12.mtb	1485	NA	WWSS	water	1	53341	1336435852	1	0.02	0.00153846153846154	2675	1
1	Food 2	Intake 4	27	62675	1336445186	/users/cn/jespinosa/phecomp/data/CRG/20120502_FDF_CRG/20120502_FDF_CRG/20120507_FDF_CRG_c12.mtb	1352	43	WWSS	food_sc	4	62648	1336445159	1	0.02	0.000740740740740741	2676	1
1	Food 2	Intake 4	566	63284	1336445795	/users/cn/jespinosa/phecomp/data/CRG/20120502_FDF_CRG/20120502_FDF_CRG/20120507_FDF_CRG_c12.mtb	1353	230	WWSS	food_sc	4	62718	1336445229	1	0.16	0.000282685512367491	2677	1
1	Food 2	Intake 4	102	63616	1336446127	/users/cn/jespinosa/phecomp/data/CRG/20120502_FDF_CRG/20120502_FDF_CRG/20120507_FDF_CRG_c12.mtb	1356	157	WWSS	food_sc	4	63514	1336446025	1	0.02	0.000196078431372549	2678	1
1	Drink 1	Intake 1	25	63707	1336446218	/users/cn/jespinosa/phecomp/data/CRG/20120502_FDF_CRG/20120502_FDF_CRG/20120507_FDF_CRG_c12.mtb	1490	NA	WWSS	water	1	63682	1336446193	1	0.0799999999999998	0.00319999999999999	2679	1
1	Food 1	Intake 3	174	63947	1336446458	/users/cn/jespinosa/phecomp/data/CRG/20120502_FDF_CRG/20120502_FDF_CRG/20120507_FDF_CRG_c12.mtb	977	73	WWSS	food_sc	3	63773	1336446284	1	0.04	0.000229885057471264	2680	1
1	Food 1	Intake 3	75	64095	1336446606	/users/cn/jespinosa/phecomp/data/CRG/20120502_FDF_CRG/20120502_FDF_CRG/20120507_FDF_CRG_c12.mtb	979	130	WWSS	food_sc	3	64020	1336446531	1	0.02	0.000266666666666667	2681	1
1	Drink 1	Intake 1	33	64122	1336446633	/users/cn/jespinosa/phecomp/data/CRG/20120502_FDF_CRG/20120502_FDF_CRG/20120507_FDF_CRG_c12.mtb	1492	NA	WWSS	water	1	64089	1336446600	1	0.1	0.00303030303030303	2682	1
1	Food 1	Intake 3	72	64297	1336446808	/users/cn/jespinosa/phecomp/data/CRG/20120502_FDF_CRG/20120502_FDF_CRG/20120507_FDF_CRG_c12.mtb	980	730	WWSS	food_sc	3	64225	1336446736	1	0.02	0.000277777777777778	2683	1
1	Drink 1	Intake 1	18	64747	1336447258	/users/cn/jespinosa/phecomp/data/CRG/20120502_FDF_CRG/20120502_FDF_CRG/20120507_FDF_CRG_c12.mtb	1493	NA	WWSS	water	1	64729	1336447240	1	0.02	0.00111111111111111	2684	1
1	Drink 1	Intake 1	37	64877	1336447388	/users/cn/jespinosa/phecomp/data/CRG/20120502_FDF_CRG/20120502_FDF_CRG/20120507_FDF_CRG_c12.mtb	1495	NA	WWSS	water	1	64840	1336447351	1	0.12	0.00324324324324324	2685	1
1	Food 2	Intake 4	142	65169	1336447680	/users/cn/jespinosa/phecomp/data/CRG/20120502_FDF_CRG/20120502_FDF_CRG/20120507_FDF_CRG_c12.mtb	1362	42	WWSS	food_sc	4	65027	1336447538	1	0.04	0.00028169014084507	2686	1
1	Food 1	Intake 3	175	65386	1336447897	/users/cn/jespinosa/phecomp/data/CRG/20120502_FDF_CRG/20120502_FDF_CRG/20120507_FDF_CRG_c12.mtb	984	3795	WWSS	food_sc	3	65211	1336447722	1	0.08	0.000457142857142857	2687	1
1	Drink 1	Intake 1	26	65478	1336447989	/users/cn/jespinosa/phecomp/data/CRG/20120502_FDF_CRG/20120502_FDF_CRG/20120507_FDF_CRG_c12.mtb	1496	NA	WWSS	water	1	65452	1336447963	1	0.02	0.000769230769230769	2688	1
1	Drink 1	Intake 1	20	65573	1336448084	/users/cn/jespinosa/phecomp/data/CRG/20120502_FDF_CRG/20120502_FDF_CRG/20120507_FDF_CRG_c12.mtb	1497	NA	WWSS	water	1	65553	1336448064	1	0.04	0.002	2689	1
1	Drink 1	Intake 1	46	66024	1336448535	/users/cn/jespinosa/phecomp/data/CRG/20120502_FDF_CRG/20120502_FDF_CRG/20120507_FDF_CRG_c12.mtb	1498	NA	WWSS	water	1	65978	1336448489	1	0.0800000000000001	0.00173913043478261	2690	1
1	Drink 1	Intake 1	17	68908	1336451419	/users/cn/jespinosa/phecomp/data/CRG/20120502_FDF_CRG/20120502_FDF_CRG/20120507_FDF_CRG_c12.mtb	1500	NA	WWSS	water	1	68891	1336451402	1	0.02	0.00117647058823529	2691	1
1	Food 1	Intake 3	339	69520	1336452031	/users/cn/jespinosa/phecomp/data/CRG/20120502_FDF_CRG/20120502_FDF_CRG/20120507_FDF_CRG_c12.mtb	987	22	WWSS	food_sc	3	69181	1336451692	1	0.12	0.000353982300884956	2692	1
1	Food 1	Intake 3	74	69616	1336452127	/users/cn/jespinosa/phecomp/data/CRG/20120502_FDF_CRG/20120502_FDF_CRG/20120507_FDF_CRG_c12.mtb	988	52	WWSS	food_sc	3	69542	1336452053	1	0.02	0.00027027027027027	2693	1
1	Drink 1	Intake 1	25	69643	1336452154	/users/cn/jespinosa/phecomp/data/CRG/20120502_FDF_CRG/20120502_FDF_CRG/20120507_FDF_CRG_c12.mtb	1502	NA	WWSS	water	1	69618	1336452129	1	0.04	0.0016	2694	1
1	Food 1	Intake 3	66	69734	1336452245	/users/cn/jespinosa/phecomp/data/CRG/20120502_FDF_CRG/20120502_FDF_CRG/20120507_FDF_CRG_c12.mtb	989	69	WWSS	food_sc	3	69668	1336452179	1	0.02	0.000303030303030303	2695	1
1	Drink 1	Intake 1	21	69796	1336452307	/users/cn/jespinosa/phecomp/data/CRG/20120502_FDF_CRG/20120502_FDF_CRG/20120507_FDF_CRG_c12.mtb	1503	NA	WWSS	water	1	69775	1336452286	1	0.0399999999999998	0.0019047619047619	2696	1
1	Food 1	Intake 3	134	69937	1336452448	/users/cn/jespinosa/phecomp/data/CRG/20120502_FDF_CRG/20120502_FDF_CRG/20120507_FDF_CRG_c12.mtb	990	347	WWSS	food_sc	3	69803	1336452314	1	0.0399999999999999	0.000298507462686566	2697	1
1	Drink 2	Intake 2	17	70212	1336452723	/users/cn/jespinosa/phecomp/data/CRG/20120502_FDF_CRG/20120502_FDF_CRG/20120507_FDF_CRG_c12.mtb	601	NA	WWSS	water	2	70195	1336452706	1	0.02	0.00117647058823529	2698	1
1	Food 1	Intake 3	116	70400	1336452911	/users/cn/jespinosa/phecomp/data/CRG/20120502_FDF_CRG/20120502_FDF_CRG/20120507_FDF_CRG_c12.mtb	992	297	WWSS	food_sc	3	70284	1336452795	1	0.02	0.000172413793103448	2699	1
1	Drink 2	Intake 2	37	70664	1336453175	/users/cn/jespinosa/phecomp/data/CRG/20120502_FDF_CRG/20120502_FDF_CRG/20120507_FDF_CRG_c12.mtb	602	NA	WWSS	water	2	70627	1336453138	1	0.06	0.00162162162162162	2700	1
1	Food 1	Intake 3	99	70796	1336453307	/users/cn/jespinosa/phecomp/data/CRG/20120502_FDF_CRG/20120502_FDF_CRG/20120507_FDF_CRG_c12.mtb	994	46	WWSS	food_sc	3	70697	1336453208	1	0.04	0.000404040404040404	2701	1
1	Drink 1	Intake 1	18	70821	1336453332	/users/cn/jespinosa/phecomp/data/CRG/20120502_FDF_CRG/20120502_FDF_CRG/20120507_FDF_CRG_c12.mtb	1504	NA	WWSS	water	1	70803	1336453314	1	0.02	0.00111111111111111	2702	1
1	Food 1	Intake 3	162	71004	1336453515	/users/cn/jespinosa/phecomp/data/CRG/20120502_FDF_CRG/20120502_FDF_CRG/20120507_FDF_CRG_c12.mtb	995	85	WWSS	food_sc	3	70842	1336453353	1	0.0399999999999999	0.000246913580246913	2703	1
1	Drink 1	Intake 1	27	71047	1336453558	/users/cn/jespinosa/phecomp/data/CRG/20120502_FDF_CRG/20120502_FDF_CRG/20120507_FDF_CRG_c12.mtb	1505	NA	WWSS	water	1	71020	1336453531	1	0.12	0.00444444444444444	2704	1
1	Food 1	Intake 3	187	71276	1336453787	/users/cn/jespinosa/phecomp/data/CRG/20120502_FDF_CRG/20120502_FDF_CRG/20120507_FDF_CRG_c12.mtb	996	186	WWSS	food_sc	3	71089	1336453600	1	0.04	0.000213903743315508	2705	1
1	Food 1	Intake 3	139	71601	1336454112	/users/cn/jespinosa/phecomp/data/CRG/20120502_FDF_CRG/20120502_FDF_CRG/20120507_FDF_CRG_c12.mtb	997	6	WWSS	food_sc	3	71462	1336453973	1	0.04	0.000287769784172662	2706	1
1	Food 1	Intake 3	18	71625	1336454136	/users/cn/jespinosa/phecomp/data/CRG/20120502_FDF_CRG/20120502_FDF_CRG/20120507_FDF_CRG_c12.mtb	998	291	WWSS	food_sc	3	71607	1336454118	1	0.02	0.00111111111111111	2707	1
1	Drink 1	Intake 1	27	71855	1336454366	/users/cn/jespinosa/phecomp/data/CRG/20120502_FDF_CRG/20120502_FDF_CRG/20120507_FDF_CRG_c12.mtb	1508	NA	WWSS	water	1	71828	1336454339	1	0.0800000000000001	0.00296296296296297	2708	1
1	Food 1	Intake 3	147	72063	1336454574	/users/cn/jespinosa/phecomp/data/CRG/20120502_FDF_CRG/20120502_FDF_CRG/20120507_FDF_CRG_c12.mtb	1003	278	WWSS	food_sc	3	71916	1336454427	1	0.04	0.000272108843537415	2709	1
1	Food 1	Intake 3	110	72451	1336454962	/users/cn/jespinosa/phecomp/data/CRG/20120502_FDF_CRG/20120502_FDF_CRG/20120507_FDF_CRG_c12.mtb	1005	362	WWSS	food_sc	3	72341	1336454852	1	0.04	0.000363636363636364	2710	1
1	Drink 1	Intake 1	38	72782	1336455293	/users/cn/jespinosa/phecomp/data/CRG/20120502_FDF_CRG/20120502_FDF_CRG/20120507_FDF_CRG_c12.mtb	1510	NA	WWSS	water	1	72744	1336455255	1	0.0800000000000001	0.00210526315789474	2711	1
1	Food 1	Intake 3	71	72884	1336455395	/users/cn/jespinosa/phecomp/data/CRG/20120502_FDF_CRG/20120502_FDF_CRG/20120507_FDF_CRG_c12.mtb	1007	529	WWSS	food_sc	3	72813	1336455324	1	0.02	0.00028169014084507	2712	1
1	Food 1	Intake 3	70	73483	1336455994	/users/cn/jespinosa/phecomp/data/CRG/20120502_FDF_CRG/20120502_FDF_CRG/20120507_FDF_CRG_c12.mtb	1010	8381	WWSS	food_sc	3	73413	1336455924	1	0.04	0.000571428571428571	2713	1
1	Drink 1	Intake 1	20	73717	1336456228	/users/cn/jespinosa/phecomp/data/CRG/20120502_FDF_CRG/20120502_FDF_CRG/20120507_FDF_CRG_c12.mtb	1513	NA	WWSS	water	1	73697	1336456208	1	0.02	0.001	2714	1
1	Drink 1	Intake 1	45	74523	1336457034	/users/cn/jespinosa/phecomp/data/CRG/20120502_FDF_CRG/20120502_FDF_CRG/20120507_FDF_CRG_c12.mtb	1515	NA	WWSS	water	1	74478	1336456989	1	0.04	0.000888888888888889	2715	1
1	Food 1	Intake 3	33	81897	1336464408	/users/cn/jespinosa/phecomp/data/CRG/20120502_FDF_CRG/20120502_FDF_CRG/20120507_FDF_CRG_c12.mtb	1019	7	WWSS	food_sc	3	81864	1336464375	1	0.04	0.00121212121212121	2716	1
1	Food 1	Intake 3	122	82026	1336464537	/users/cn/jespinosa/phecomp/data/CRG/20120502_FDF_CRG/20120502_FDF_CRG/20120507_FDF_CRG_c12.mtb	1020	408	WWSS	food_sc	3	81904	1336464415	1	0.04	0.000327868852459016	2717	1
1	Food 1	Intake 3	142	82576	1336465087	/users/cn/jespinosa/phecomp/data/CRG/20120502_FDF_CRG/20120502_FDF_CRG/20120507_FDF_CRG_c12.mtb	1022	19646	WWSS	food_sc	3	82434	1336464945	1	0.04	0.00028169014084507	2718	1
1	Drink 2	Intake 2	31	84188	1336466699	/users/cn/jespinosa/phecomp/data/CRG/20120502_FDF_CRG/20120502_FDF_CRG/20120507_FDF_CRG_c12.mtb	605	NA	WWSS	water	2	84157	1336466668	1	0.06	0.00193548387096774	2719	1
1	Drink 2	Intake 2	46	84325	1336466836	/users/cn/jespinosa/phecomp/data/CRG/20120502_FDF_CRG/20120502_FDF_CRG/20120507_FDF_CRG_c12.mtb	606	NA	WWSS	water	2	84279	1336466790	1	0.06	0.00130434782608696	2720	1
1	Drink 2	Intake 2	17	92726	1336475237	/users/cn/jespinosa/phecomp/data/CRG/20120502_FDF_CRG/20120502_FDF_CRG/20120507_FDF_CRG_c12.mtb	608	NA	WWSS	water	2	92709	1336475220	1	0.02	0.00117647058823529	2721	1
1	Food 1	Intake 3	318	102540	1336485051	/users/cn/jespinosa/phecomp/data/CRG/20120502_FDF_CRG/20120502_FDF_CRG/20120507_FDF_CRG_c12.mtb	1025	6780	WWSS	food_sc	3	102222	1336484733	1	0.0799999999999998	0.000251572327044024	2722	1
1	Food 1	Intake 3	20	109340	1336491851	/users/cn/jespinosa/phecomp/data/CRG/20120502_FDF_CRG/20120502_FDF_CRG/20120507_FDF_CRG_c12.mtb	1029	2452	WWSS	food_sc	3	109320	1336491831	1	0.02	0.001	2723	1
1	Food 1	Intake 3	424	112216	1336494727	/users/cn/jespinosa/phecomp/data/CRG/20120502_FDF_CRG/20120502_FDF_CRG/20120507_FDF_CRG_c12.mtb	1031	3387	WWSS	food_sc	3	111792	1336494303	1	0.12	0.000283018867924528	2724	1
1	Food 1	Intake 3	558	116161	1336498672	/users/cn/jespinosa/phecomp/data/CRG/20120502_FDF_CRG/20120502_FDF_CRG/20120507_FDF_CRG_c12.mtb	1033	2140	WWSS	food_sc	3	115603	1336498114	1	0.2	0.0003584229390681	2725	1
1	Drink 1	Intake 1	13	116184	1336498695	/users/cn/jespinosa/phecomp/data/CRG/20120502_FDF_CRG/20120502_FDF_CRG/20120507_FDF_CRG_c12.mtb	1527	NA	WWSS	water	1	116171	1336498682	1	0.04	0.00307692307692308	2726	1
1	Drink 1	Intake 1	22	117830	1336500341	/users/cn/jespinosa/phecomp/data/CRG/20120502_FDF_CRG/20120502_FDF_CRG/20120507_FDF_CRG_c12.mtb	1528	NA	WWSS	water	1	117808	1336500319	1	0.1	0.00454545454545455	2727	1
1	Food 1	Intake 3	302	118603	1336501114	/users/cn/jespinosa/phecomp/data/CRG/20120502_FDF_CRG/20120502_FDF_CRG/20120507_FDF_CRG_c12.mtb	1034	8	WWSS	food_sc	3	118301	1336500812	1	0.0800000000000001	0.000264900662251656	2728	1
1	Food 1	Intake 3	119	118730	1336501241	/users/cn/jespinosa/phecomp/data/CRG/20120502_FDF_CRG/20120502_FDF_CRG/20120507_FDF_CRG_c12.mtb	1035	705	WWSS	food_sc	3	118611	1336501122	1	0.0800000000000001	0.000672268907563026	2729	1
1	Food 1	Intake 3	23	119458	1336501969	/users/cn/jespinosa/phecomp/data/CRG/20120502_FDF_CRG/20120502_FDF_CRG/20120507_FDF_CRG_c12.mtb	1039	751	WWSS	food_sc	3	119435	1336501946	1	0.3	0.0130434782608696	2730	1
1	Drink 1	Intake 1	38	119557	1336502068	/users/cn/jespinosa/phecomp/data/CRG/20120502_FDF_CRG/20120502_FDF_CRG/20120507_FDF_CRG_c12.mtb	1531	NA	WWSS	water	1	119519	1336502030	1	0.0799999999999996	0.00210526315789473	2731	1
1	Food 1	Intake 3	51	120260	1336502771	/users/cn/jespinosa/phecomp/data/CRG/20120502_FDF_CRG/20120502_FDF_CRG/20120507_FDF_CRG_c12.mtb	1047	115	WWSS	food_sc	3	120209	1336502720	1	0.02	0.000392156862745098	2732	1
1	Food 1	Intake 3	94	120469	1336502980	/users/cn/jespinosa/phecomp/data/CRG/20120502_FDF_CRG/20120502_FDF_CRG/20120507_FDF_CRG_c12.mtb	1049	27	WWSS	food_sc	3	120375	1336502886	1	0.02	0.000212765957446809	2733	1
1	Food 1	Intake 3	81	120577	1336503088	/users/cn/jespinosa/phecomp/data/CRG/20120502_FDF_CRG/20120502_FDF_CRG/20120507_FDF_CRG_c12.mtb	1050	70	WWSS	food_sc	3	120496	1336503007	1	0.02	0.000246913580246914	2734	1
1	Drink 2	Intake 2	13	120586	1336503097	/users/cn/jespinosa/phecomp/data/CRG/20120502_FDF_CRG/20120502_FDF_CRG/20120507_FDF_CRG_c12.mtb	612	NA	WWSS	water	2	120573	1336503084	1	0.04	0.00307692307692308	2735	1
1	Food 1	Intake 3	99	120746	1336503257	/users/cn/jespinosa/phecomp/data/CRG/20120502_FDF_CRG/20120502_FDF_CRG/20120507_FDF_CRG_c12.mtb	1051	22	WWSS	food_sc	3	120647	1336503158	1	0.02	0.000202020202020202	2736	1
1	Food 1	Intake 3	107	120875	1336503386	/users/cn/jespinosa/phecomp/data/CRG/20120502_FDF_CRG/20120502_FDF_CRG/20120507_FDF_CRG_c12.mtb	1052	225	WWSS	food_sc	3	120768	1336503279	1	0.04	0.000373831775700935	2737	1
1	Drink 2	Intake 2	25	120891	1336503402	/users/cn/jespinosa/phecomp/data/CRG/20120502_FDF_CRG/20120502_FDF_CRG/20120507_FDF_CRG_c12.mtb	614	NA	WWSS	water	2	120866	1336503377	1	0.04	0.0016	2738	1
1	Food 1	Intake 3	104	121204	1336503715	/users/cn/jespinosa/phecomp/data/CRG/20120502_FDF_CRG/20120502_FDF_CRG/20120507_FDF_CRG_c12.mtb	1054	134	WWSS	food_sc	3	121100	1336503611	1	0.02	0.000192307692307692	2739	1
1	Food 1	Intake 3	57	121395	1336503906	/users/cn/jespinosa/phecomp/data/CRG/20120502_FDF_CRG/20120502_FDF_CRG/20120507_FDF_CRG_c12.mtb	1055	1052	WWSS	food_sc	3	121338	1336503849	1	0.02	0.000350877192982456	2740	1
1	Drink 2	Intake 2	41	121644	1336504155	/users/cn/jespinosa/phecomp/data/CRG/20120502_FDF_CRG/20120502_FDF_CRG/20120507_FDF_CRG_c12.mtb	616	NA	WWSS	water	2	121603	1336504114	1	0.1	0.0024390243902439	2741	1
1	Food 1	Intake 3	34	122481	1336504992	/users/cn/jespinosa/phecomp/data/CRG/20120502_FDF_CRG/20120502_FDF_CRG/20120507_FDF_CRG_c12.mtb	1062	320	WWSS	food_sc	3	122447	1336504958	1	0.02	0.000588235294117647	2742	1
1	Drink 2	Intake 2	19	122491	1336505002	/users/cn/jespinosa/phecomp/data/CRG/20120502_FDF_CRG/20120502_FDF_CRG/20120507_FDF_CRG_c12.mtb	618	NA	WWSS	water	2	122472	1336504983	1	0.0399999999999999	0.00210526315789473	2743	1
1	Food 2	Intake 4	120	122921	1336505432	/users/cn/jespinosa/phecomp/data/CRG/20120502_FDF_CRG/20120502_FDF_CRG/20120507_FDF_CRG_c12.mtb	1430	4619	WWSS	food_sc	4	122801	1336505312	1	0.04	0.000333333333333333	2744	1
1	Drink 2	Intake 2	19	123756	1336506267	/users/cn/jespinosa/phecomp/data/CRG/20120502_FDF_CRG/20120502_FDF_CRG/20120507_FDF_CRG_c12.mtb	619	NA	WWSS	water	2	123737	1336506248	1	0.04	0.00210526315789474	2745	1
1	Drink 1	Intake 1	23	123913	1336506424	/users/cn/jespinosa/phecomp/data/CRG/20120502_FDF_CRG/20120502_FDF_CRG/20120507_FDF_CRG_c12.mtb	1541	NA	WWSS	water	1	123890	1336506401	1	0.02	0.000869565217391304	2746	1
1	Drink 1	Intake 1	17	124902	1336507413	/users/cn/jespinosa/phecomp/data/CRG/20120502_FDF_CRG/20120502_FDF_CRG/20120507_FDF_CRG_c12.mtb	1543	NA	WWSS	water	1	124885	1336507396	1	0.02	0.00117647058823529	2747	1
1	Food 1	Intake 3	76	127616	1336510127	/users/cn/jespinosa/phecomp/data/CRG/20120502_FDF_CRG/20120502_FDF_CRG/20120507_FDF_CRG_c12.mtb	1071	4	WWSS	food_sc	3	127540	1336510051	1	0.02	0.000263157894736842	2748	1
1	Food 1	Intake 3	73	127693	1336510204	/users/cn/jespinosa/phecomp/data/CRG/20120502_FDF_CRG/20120502_FDF_CRG/20120507_FDF_CRG_c12.mtb	1072	14	WWSS	food_sc	3	127620	1336510131	1	0.02	0.000273972602739726	2749	1
1	Food 2	Intake 4	279	127986	1336510497	/users/cn/jespinosa/phecomp/data/CRG/20120502_FDF_CRG/20120502_FDF_CRG/20120507_FDF_CRG_c12.mtb	1434	257	WWSS	food_sc	4	127707	1336510218	1	0.0999999999999996	0.000358422939068099	2750	1
1	Food 2	Intake 4	51	128294	1336510805	/users/cn/jespinosa/phecomp/data/CRG/20120502_FDF_CRG/20120502_FDF_CRG/20120507_FDF_CRG_c12.mtb	1438	26	WWSS	food_sc	4	128243	1336510754	1	0.0200000000000005	0.000392156862745108	2751	1
1	Food 1	Intake 3	109	128429	1336510940	/users/cn/jespinosa/phecomp/data/CRG/20120502_FDF_CRG/20120502_FDF_CRG/20120507_FDF_CRG_c12.mtb	1076	257	WWSS	food_sc	3	128320	1336510831	1	0.02	0.00018348623853211	2752	1
1	Drink 1	Intake 1	32	128450	1336510961	/users/cn/jespinosa/phecomp/data/CRG/20120502_FDF_CRG/20120502_FDF_CRG/20120507_FDF_CRG_c12.mtb	1546	NA	WWSS	water	1	128418	1336510929	1	0.02	0.000625	2753	1
1	Food 2	Intake 4	65	128751	1336511262	/users/cn/jespinosa/phecomp/data/CRG/20120502_FDF_CRG/20120502_FDF_CRG/20120507_FDF_CRG_c12.mtb	1442	346	WWSS	food_sc	4	128686	1336511197	1	0.02	0.000307692307692308	2754	1
1	Drink 1	Intake 1	28	128785	1336511296	/users/cn/jespinosa/phecomp/data/CRG/20120502_FDF_CRG/20120502_FDF_CRG/20120507_FDF_CRG_c12.mtb	1547	NA	WWSS	water	1	128757	1336511268	1	0.0800000000000001	0.00285714285714286	2755	1
1	Food 2	Intake 4	71	129168	1336511679	/users/cn/jespinosa/phecomp/data/CRG/20120502_FDF_CRG/20120502_FDF_CRG/20120507_FDF_CRG_c12.mtb	1445	337	WWSS	food_sc	4	129097	1336511608	1	0.02	0.00028169014084507	2756	1
1	Drink 1	Intake 1	48	129412	1336511923	/users/cn/jespinosa/phecomp/data/CRG/20120502_FDF_CRG/20120502_FDF_CRG/20120507_FDF_CRG_c12.mtb	1550	NA	WWSS	water	1	129364	1336511875	1	0.04	0.000833333333333333	2757	1
1	Food 2	Intake 4	106	129611	1336512122	/users/cn/jespinosa/phecomp/data/CRG/20120502_FDF_CRG/20120502_FDF_CRG/20120507_FDF_CRG_c12.mtb	1447	96	WWSS	food_sc	4	129505	1336512016	1	0.02	0.000188679245283019	2758	1
1	Food 2	Intake 4	237	129944	1336512455	/users/cn/jespinosa/phecomp/data/CRG/20120502_FDF_CRG/20120502_FDF_CRG/20120507_FDF_CRG_c12.mtb	1448	485	WWSS	food_sc	4	129707	1336512218	1	0.42	0.00177215189873418	2759	1
1	Drink 1	Intake 1	25	129980	1336512491	/users/cn/jespinosa/phecomp/data/CRG/20120502_FDF_CRG/20120502_FDF_CRG/20120507_FDF_CRG_c12.mtb	1552	NA	WWSS	water	1	129955	1336512466	1	0.0600000000000001	0.0024	2760	1
1	Food 1	Intake 3	49	130478	1336512989	/users/cn/jespinosa/phecomp/data/CRG/20120502_FDF_CRG/20120502_FDF_CRG/20120507_FDF_CRG_c12.mtb	1094	180	WWSS	food_sc	3	130429	1336512940	1	0.36	0.0073469387755102	2761	1
1	Food 1	Intake 3	65	130723	1336513234	/users/cn/jespinosa/phecomp/data/CRG/20120502_FDF_CRG/20120502_FDF_CRG/20120507_FDF_CRG_c12.mtb	1097	1966	WWSS	food_sc	3	130658	1336513169	1	0.02	0.000307692307692308	2762	1
1	Drink 2	Intake 2	22	130739	1336513250	/users/cn/jespinosa/phecomp/data/CRG/20120502_FDF_CRG/20120502_FDF_CRG/20120507_FDF_CRG_c12.mtb	622	NA	WWSS	water	2	130717	1336513228	1	0.0600000000000001	0.00272727272727273	2763	1
1	Drink 1	Intake 1	17	132555	1336515066	/users/cn/jespinosa/phecomp/data/CRG/20120502_FDF_CRG/20120502_FDF_CRG/20120507_FDF_CRG_c12.mtb	1557	NA	WWSS	water	1	132538	1336515049	1	0.02	0.00117647058823529	2764	1
1	Food 1	Intake 3	8	132697	1336515208	/users/cn/jespinosa/phecomp/data/CRG/20120502_FDF_CRG/20120502_FDF_CRG/20120507_FDF_CRG_c12.mtb	1108	COLL	WWSS	food_sc	3	132689	1336515200	1	0.02	0.0025	2765	1
1	Food 2	Intake 4	255	132949	1336515460	/users/cn/jespinosa/phecomp/data/CRG/20120502_FDF_CRG/20120502_FDF_CRG/20120507_FDF_CRG_c12.mtb	1467	260	WWSS	food_sc	4	132694	1336515205	1	0.0800000000000001	0.000313725490196079	2766	1
1	Food 2	Intake 4	189	133398	1336515909	/users/cn/jespinosa/phecomp/data/CRG/20120502_FDF_CRG/20120502_FDF_CRG/20120507_FDF_CRG_c12.mtb	1470	721	WWSS	food_sc	4	133209	1336515720	1	0.0600000000000001	0.000317460317460318	2767	1
1	Drink 1	Intake 1	23	133811	1336516322	/users/cn/jespinosa/phecomp/data/CRG/20120502_FDF_CRG/20120502_FDF_CRG/20120507_FDF_CRG_c12.mtb	1560	NA	WWSS	water	1	133788	1336516299	1	0.0600000000000001	0.00260869565217392	2768	1
1	Food 2	Intake 4	205	134324	1336516835	/users/cn/jespinosa/phecomp/data/CRG/20120502_FDF_CRG/20120502_FDF_CRG/20120507_FDF_CRG_c12.mtb	1474	3853	WWSS	food_sc	4	134119	1336516630	1	0.04	0.000195121951219512	2769	1
1	Food 2	Intake 4	16	138193	1336520704	/users/cn/jespinosa/phecomp/data/CRG/20120502_FDF_CRG/20120502_FDF_CRG/20120507_FDF_CRG_c12.mtb	1475	753	WWSS	food_sc	4	138177	1336520688	1	0.02	0.00125	2770	1
1	Drink 1	Intake 1	31	138218	1336520729	/users/cn/jespinosa/phecomp/data/CRG/20120502_FDF_CRG/20120502_FDF_CRG/20120507_FDF_CRG_c12.mtb	1561	NA	WWSS	water	1	138187	1336520698	1	0.02	0.000645161290322581	2771	1
1	Drink 1	Intake 1	22	138510	1336521021	/users/cn/jespinosa/phecomp/data/CRG/20120502_FDF_CRG/20120502_FDF_CRG/20120507_FDF_CRG_c12.mtb	1563	NA	WWSS	water	1	138488	1336520999	1	0.02	0.000909090909090909	2772	1
1	Drink 1	Intake 1	28	138810	1336521321	/users/cn/jespinosa/phecomp/data/CRG/20120502_FDF_CRG/20120502_FDF_CRG/20120507_FDF_CRG_c12.mtb	1564	NA	WWSS	water	1	138782	1336521293	1	0.0999999999999996	0.00357142857142856	2773	1
1	Food 1	Intake 3	216	139162	1336521673	/users/cn/jespinosa/phecomp/data/CRG/20120502_FDF_CRG/20120502_FDF_CRG/20120507_FDF_CRG_c12.mtb	1117	4	WWSS	food_sc	3	138946	1336521457	1	0.04	0.000185185185185185	2774	1
1	Food 1	Intake 3	186	139352	1336521863	/users/cn/jespinosa/phecomp/data/CRG/20120502_FDF_CRG/20120502_FDF_CRG/20120507_FDF_CRG_c12.mtb	1118	1094	WWSS	food_sc	3	139166	1336521677	1	0.0600000000000001	0.000322580645161291	2775	1
1	Drink 1	Intake 1	34	139378	1336521889	/users/cn/jespinosa/phecomp/data/CRG/20120502_FDF_CRG/20120502_FDF_CRG/20120507_FDF_CRG_c12.mtb	1565	NA	WWSS	water	1	139344	1336521855	1	0.12	0.00352941176470588	2776	1
1	Food 2	Intake 4	239	140685	1336523196	/users/cn/jespinosa/phecomp/data/CRG/20120502_FDF_CRG/20120502_FDF_CRG/20120507_FDF_CRG_c12.mtb	1482	436	WWSS	food_sc	4	140446	1336522957	1	0.12	0.000502092050209205	2777	1
1	Drink 1	Intake 1	22	140703	1336523214	/users/cn/jespinosa/phecomp/data/CRG/20120502_FDF_CRG/20120502_FDF_CRG/20120507_FDF_CRG_c12.mtb	1567	NA	WWSS	water	1	140681	1336523192	1	0.0600000000000001	0.00272727272727273	2778	1
1	Food 2	Intake 4	99	141220	1336523731	/users/cn/jespinosa/phecomp/data/CRG/20120502_FDF_CRG/20120502_FDF_CRG/20120507_FDF_CRG_c12.mtb	1486	820	WWSS	food_sc	4	141121	1336523632	1	0.04	0.000404040404040404	2779	1
1	Drink 2	Intake 2	22	141866	1336524377	/users/cn/jespinosa/phecomp/data/CRG/20120502_FDF_CRG/20120502_FDF_CRG/20120507_FDF_CRG_c12.mtb	627	NA	WWSS	water	2	141844	1336524355	1	0.04	0.00181818181818182	2780	1
1	Food 2	Intake 4	125	142165	1336524676	/users/cn/jespinosa/phecomp/data/CRG/20120502_FDF_CRG/20120502_FDF_CRG/20120507_FDF_CRG_c12.mtb	1490	1157	WWSS	food_sc	4	142040	1336524551	1	0.02	0.00016	2781	1
1	Drink 1	Intake 1	14	142919	1336525430	/users/cn/jespinosa/phecomp/data/CRG/20120502_FDF_CRG/20120502_FDF_CRG/20120507_FDF_CRG_c12.mtb	1569	NA	WWSS	water	1	142905	1336525416	1	0.04	0.00285714285714286	2782	1
1	Food 2	Intake 4	50	143372	1336525883	/users/cn/jespinosa/phecomp/data/CRG/20120502_FDF_CRG/20120502_FDF_CRG/20120507_FDF_CRG_c12.mtb	1494	7534	WWSS	food_sc	4	143322	1336525833	1	0.02	0.0004	2783	1
1	Food 2	Intake 4	70	150976	1336533487	/users/cn/jespinosa/phecomp/data/CRG/20120502_FDF_CRG/20120502_FDF_CRG/20120507_FDF_CRG_c12.mtb	1497	4196	WWSS	food_sc	4	150906	1336533417	1	0.04	0.000571428571428571	2784	1
1	Drink 1	Intake 1	35	151089	1336533600	/users/cn/jespinosa/phecomp/data/CRG/20120502_FDF_CRG/20120502_FDF_CRG/20120507_FDF_CRG_c12.mtb	1571	NA	WWSS	water	1	151054	1336533565	1	0.04	0.00114285714285714	2785	1
1	Drink 1	Intake 1	14	151324	1336533835	/users/cn/jespinosa/phecomp/data/CRG/20120502_FDF_CRG/20120502_FDF_CRG/20120507_FDF_CRG_c12.mtb	1572	NA	WWSS	water	1	151310	1336533821	1	0.0600000000000001	0.00428571428571429	2786	1
1	Food 2	Intake 4	120	155292	1336537803	/users/cn/jespinosa/phecomp/data/CRG/20120502_FDF_CRG/20120502_FDF_CRG/20120507_FDF_CRG_c12.mtb	1500	COLL	WWSS	food_sc	4	155172	1336537683	1	0.0200000000000005	0.000166666666666671	2787	1
1	Food 1	Intake 3	59	155348	1336537859	/users/cn/jespinosa/phecomp/data/CRG/20120502_FDF_CRG/20120502_FDF_CRG/20120507_FDF_CRG_c12.mtb	1130	94	WWSS	food_sc	3	155289	1336537800	1	0.04	0.000677966101694915	2788	1
1	Food 1	Intake 3	86	155528	1336538039	/users/cn/jespinosa/phecomp/data/CRG/20120502_FDF_CRG/20120502_FDF_CRG/20120507_FDF_CRG_c12.mtb	1131	12	WWSS	food_sc	3	155442	1336537953	1	0.02	0.000232558139534884	2789	1
1	Drink 2	Intake 2	17	155542	1336538053	/users/cn/jespinosa/phecomp/data/CRG/20120502_FDF_CRG/20120502_FDF_CRG/20120507_FDF_CRG_c12.mtb	628	NA	WWSS	water	2	155525	1336538036	1	0.02	0.00117647058823529	2790	1
1	Food 1	Intake 3	146	155686	1336538197	/users/cn/jespinosa/phecomp/data/CRG/20120502_FDF_CRG/20120502_FDF_CRG/20120507_FDF_CRG_c12.mtb	1132	75	WWSS	food_sc	3	155540	1336538051	1	0.0600000000000001	0.00041095890410959	2791	1
1	Drink 1	Intake 1	33	155712	1336538223	/users/cn/jespinosa/phecomp/data/CRG/20120502_FDF_CRG/20120502_FDF_CRG/20120507_FDF_CRG_c12.mtb	1574	NA	WWSS	water	1	155679	1336538190	1	0.1	0.00303030303030303	2792	1
1	Food 1	Intake 3	245	156006	1336538517	/users/cn/jespinosa/phecomp/data/CRG/20120502_FDF_CRG/20120502_FDF_CRG/20120507_FDF_CRG_c12.mtb	1133	535	WWSS	food_sc	3	155761	1336538272	1	0.1	0.000408163265306122	2793	1
1	Drink 2	Intake 2	21	156038	1336538549	/users/cn/jespinosa/phecomp/data/CRG/20120502_FDF_CRG/20120502_FDF_CRG/20120507_FDF_CRG_c12.mtb	629	NA	WWSS	water	2	156017	1336538528	1	0.08	0.00380952380952381	2794	1
1	Drink 2	Intake 2	30	156386	1336538897	/users/cn/jespinosa/phecomp/data/CRG/20120502_FDF_CRG/20120502_FDF_CRG/20120507_FDF_CRG_c12.mtb	630	NA	WWSS	water	2	156356	1336538867	1	0.0800000000000001	0.00266666666666667	2795	1
1	Food 1	Intake 3	125	156666	1336539177	/users/cn/jespinosa/phecomp/data/CRG/20120502_FDF_CRG/20120502_FDF_CRG/20120507_FDF_CRG_c12.mtb	1138	185	WWSS	food_sc	3	156541	1336539052	1	0.02	0.00016	2796	1
1	Drink 1	Intake 1	29	156789	1336539300	/users/cn/jespinosa/phecomp/data/CRG/20120502_FDF_CRG/20120502_FDF_CRG/20120507_FDF_CRG_c12.mtb	1575	NA	WWSS	water	1	156760	1336539271	1	0.04	0.00137931034482759	2797	1
1	Food 2	Intake 4	41	156892	1336539403	/users/cn/jespinosa/phecomp/data/CRG/20120502_FDF_CRG/20120502_FDF_CRG/20120507_FDF_CRG_c12.mtb	1509	33	WWSS	food_sc	4	156851	1336539362	1	0.02	0.00048780487804878	2798	1
1	Food 2	Intake 4	84	157009	1336539520	/users/cn/jespinosa/phecomp/data/CRG/20120502_FDF_CRG/20120502_FDF_CRG/20120507_FDF_CRG_c12.mtb	1510	838	WWSS	food_sc	4	156925	1336539436	1	0.02	0.000238095238095238	2799	1
1	Drink 1	Intake 1	22	157335	1336539846	/users/cn/jespinosa/phecomp/data/CRG/20120502_FDF_CRG/20120502_FDF_CRG/20120507_FDF_CRG_c12.mtb	1576	NA	WWSS	water	1	157313	1336539824	1	0.0399999999999996	0.0018181818181818	2800	1
1	Food 2	Intake 4	101	157948	1336540459	/users/cn/jespinosa/phecomp/data/CRG/20120502_FDF_CRG/20120502_FDF_CRG/20120507_FDF_CRG_c12.mtb	1516	470	WWSS	food_sc	4	157847	1336540358	1	0.04	0.000396039603960396	2801	1
1	Drink 1	Intake 1	43	157982	1336540493	/users/cn/jespinosa/phecomp/data/CRG/20120502_FDF_CRG/20120502_FDF_CRG/20120507_FDF_CRG_c12.mtb	1577	NA	WWSS	water	1	157939	1336540450	1	0.12	0.0027906976744186	2802	1
1	Food 2	Intake 4	120	158538	1336541049	/users/cn/jespinosa/phecomp/data/CRG/20120502_FDF_CRG/20120502_FDF_CRG/20120507_FDF_CRG_c12.mtb	1520	112	WWSS	food_sc	4	158418	1336540929	1	0.04	0.000333333333333333	2803	1
1	Food 2	Intake 4	33	158683	1336541194	/users/cn/jespinosa/phecomp/data/CRG/20120502_FDF_CRG/20120502_FDF_CRG/20120507_FDF_CRG_c12.mtb	1522	449	WWSS	food_sc	4	158650	1336541161	1	0.02	0.000606060606060606	2804	1
1	Food 1	Intake 3	61	159193	1336541704	/users/cn/jespinosa/phecomp/data/CRG/20120502_FDF_CRG/20120502_FDF_CRG/20120507_FDF_CRG_c12.mtb	1155	6	WWSS	food_sc	3	159132	1336541643	1	0.02	0.000327868852459016	2805	1
1	Food 2	Intake 4	107	159306	1336541817	/users/cn/jespinosa/phecomp/data/CRG/20120502_FDF_CRG/20120502_FDF_CRG/20120507_FDF_CRG_c12.mtb	1526	403	WWSS	food_sc	4	159199	1336541710	1	0.02	0.000186915887850467	2806	1
1	Drink 2	Intake 2	14	159570	1336542081	/users/cn/jespinosa/phecomp/data/CRG/20120502_FDF_CRG/20120502_FDF_CRG/20120507_FDF_CRG_c12.mtb	634	NA	WWSS	water	2	159556	1336542067	1	0.02	0.00142857142857143	2807	1
1	Food 1	Intake 3	152	159861	1336542372	/users/cn/jespinosa/phecomp/data/CRG/20120502_FDF_CRG/20120502_FDF_CRG/20120507_FDF_CRG_c12.mtb	1161	41	WWSS	food_sc	3	159709	1336542220	1	0.0600000000000001	0.000394736842105264	2808	1
1	Drink 2	Intake 2	30	159896	1336542407	/users/cn/jespinosa/phecomp/data/CRG/20120502_FDF_CRG/20120502_FDF_CRG/20120507_FDF_CRG_c12.mtb	635	NA	WWSS	water	2	159866	1336542377	1	0.0600000000000001	0.002	2809	1
1	Food 1	Intake 3	150	160052	1336542563	/users/cn/jespinosa/phecomp/data/CRG/20120502_FDF_CRG/20120502_FDF_CRG/20120507_FDF_CRG_c12.mtb	1162	136	WWSS	food_sc	3	159902	1336542413	1	0.04	0.000266666666666667	2810	1
1	Food 1	Intake 3	97	160285	1336542796	/users/cn/jespinosa/phecomp/data/CRG/20120502_FDF_CRG/20120502_FDF_CRG/20120507_FDF_CRG_c12.mtb	1164	795	WWSS	food_sc	3	160188	1336542699	1	0.02	0.000206185567010309	2811	1
1	Drink 1	Intake 1	14	160364	1336542875	/users/cn/jespinosa/phecomp/data/CRG/20120502_FDF_CRG/20120502_FDF_CRG/20120507_FDF_CRG_c12.mtb	1581	NA	WWSS	water	1	160350	1336542861	1	0.04	0.00285714285714286	2812	1
1	Food 1	Intake 3	57	161137	1336543648	/users/cn/jespinosa/phecomp/data/CRG/20120502_FDF_CRG/20120502_FDF_CRG/20120507_FDF_CRG_c12.mtb	1167	244	WWSS	food_sc	3	161080	1336543591	1	0.02	0.000350877192982456	2813	1
1	Food 1	Intake 3	126	161507	1336544018	/users/cn/jespinosa/phecomp/data/CRG/20120502_FDF_CRG/20120502_FDF_CRG/20120507_FDF_CRG_c12.mtb	1168	847	WWSS	food_sc	3	161381	1336543892	1	0.02	0.000158730158730159	2814	1
1	Drink 2	Intake 2	23	161643	1336544154	/users/cn/jespinosa/phecomp/data/CRG/20120502_FDF_CRG/20120502_FDF_CRG/20120507_FDF_CRG_c12.mtb	637	NA	WWSS	water	2	161620	1336544131	1	0.0799999999999998	0.00347826086956521	2815	1
1	Food 1	Intake 3	47	162401	1336544912	/users/cn/jespinosa/phecomp/data/CRG/20120502_FDF_CRG/20120502_FDF_CRG/20120507_FDF_CRG_c12.mtb	1170	14225	WWSS	food_sc	3	162354	1336544865	1	0.02	0.000425531914893617	2816	1
1	Food 1	Intake 3	149	5598	1336559286	/users/cn/jespinosa/phecomp/data/CRG/20120502_FDF_CRG/20120502_FDF_CRG/20120509_FDF_CRG_c12.mtb	1280	COLL	WWSS	food_sc	3	5449	1336559137	1	0.02	0.000134228187919463	2817	1
1	Food 2	Intake 4	87	5674	1336559362	/users/cn/jespinosa/phecomp/data/CRG/20120502_FDF_CRG/20120502_FDF_CRG/20120509_FDF_CRG_c12.mtb	1691	630	WWSS	food_sc	4	5587	1336559275	1	0.02	0.000229885057471264	2818	1
1	Drink 2	Intake 2	25	5696	1336559384	/users/cn/jespinosa/phecomp/data/CRG/20120502_FDF_CRG/20120502_FDF_CRG/20120509_FDF_CRG_c12.mtb	712	NA	WWSS	water	2	5671	1336559359	1	0.06	0.0024	2819	1
1	Food 1	Intake 3	97	6401	1336560089	/users/cn/jespinosa/phecomp/data/CRG/20120502_FDF_CRG/20120502_FDF_CRG/20120509_FDF_CRG_c12.mtb	1282	8335	WWSS	food_sc	3	6304	1336559992	1	0.04	0.000412371134020619	2820	1
1	Drink 1	Intake 1	28	7100	1336560788	/users/cn/jespinosa/phecomp/data/CRG/20120502_FDF_CRG/20120502_FDF_CRG/20120509_FDF_CRG_c12.mtb	1727	NA	WWSS	water	1	7072	1336560760	1	0.02	0.000714285714285714	2821	1
1	Food 2	Intake 4	21	14757	1336568445	/users/cn/jespinosa/phecomp/data/CRG/20120502_FDF_CRG/20120502_FDF_CRG/20120509_FDF_CRG_c12.mtb	1694	24	WWSS	food_sc	4	14736	1336568424	1	0.02	0.000952380952380952	2822	1
1	Food 2	Intake 4	44	14825	1336568513	/users/cn/jespinosa/phecomp/data/CRG/20120502_FDF_CRG/20120502_FDF_CRG/20120509_FDF_CRG_c12.mtb	1695	36	WWSS	food_sc	4	14781	1336568469	1	0.04	0.000909090909090909	2823	1
1	Food 2	Intake 4	67	14928	1336568616	/users/cn/jespinosa/phecomp/data/CRG/20120502_FDF_CRG/20120502_FDF_CRG/20120509_FDF_CRG_c12.mtb	1696	14714	WWSS	food_sc	4	14861	1336568549	1	0.04	0.000597014925373134	2824	1
1	Food 1	Intake 3	18	29660	1336583348	/users/cn/jespinosa/phecomp/data/CRG/20120502_FDF_CRG/20120502_FDF_CRG/20120509_FDF_CRG_c12.mtb	1286	2163	WWSS	food_sc	3	29642	1336583330	1	0.02	0.00111111111111111	2825	1
1	Food 2	Intake 4	17	31840	1336585528	/users/cn/jespinosa/phecomp/data/CRG/20120502_FDF_CRG/20120502_FDF_CRG/20120509_FDF_CRG_c12.mtb	1700	46	WWSS	food_sc	4	31823	1336585511	1	0.02	0.00117647058823529	2826	1
1	Food 1	Intake 3	16	31902	1336585590	/users/cn/jespinosa/phecomp/data/CRG/20120502_FDF_CRG/20120502_FDF_CRG/20120509_FDF_CRG_c12.mtb	1288	19	WWSS	food_sc	3	31886	1336585574	1	0.02	0.00125	2827	1
1	Food 1	Intake 3	257	32178	1336585866	/users/cn/jespinosa/phecomp/data/CRG/20120502_FDF_CRG/20120502_FDF_CRG/20120509_FDF_CRG_c12.mtb	1289	1954	WWSS	food_sc	3	31921	1336585609	1	0.12	0.00046692607003891	2828	1
1	Drink 1	Intake 1	17	33556	1336587244	/users/cn/jespinosa/phecomp/data/CRG/20120502_FDF_CRG/20120502_FDF_CRG/20120509_FDF_CRG_c12.mtb	1729	NA	WWSS	water	1	33539	1336587227	1	0.02	0.00117647058823529	2829	1
1	Food 1	Intake 3	150	34282	1336587970	/users/cn/jespinosa/phecomp/data/CRG/20120502_FDF_CRG/20120502_FDF_CRG/20120509_FDF_CRG_c12.mtb	1290	COLL	WWSS	food_sc	3	34132	1336587820	1	0.06	0.0004	2830	1
1	Food 2	Intake 4	139	34410	1336588098	/users/cn/jespinosa/phecomp/data/CRG/20120502_FDF_CRG/20120502_FDF_CRG/20120509_FDF_CRG_c12.mtb	1701	20	WWSS	food_sc	4	34271	1336587959	1	0.06	0.000431654676258993	2831	1
1	Food 1	Intake 3	67	34497	1336588185	/users/cn/jespinosa/phecomp/data/CRG/20120502_FDF_CRG/20120502_FDF_CRG/20120509_FDF_CRG_c12.mtb	1291	18	WWSS	food_sc	3	34430	1336588118	1	0.02	0.000298507462686567	2832	1
1	Drink 1	Intake 1	12	34507	1336588195	/users/cn/jespinosa/phecomp/data/CRG/20120502_FDF_CRG/20120502_FDF_CRG/20120509_FDF_CRG_c12.mtb	1730	NA	WWSS	water	1	34495	1336588183	1	0.02	0.00166666666666667	2833	1
1	Food 1	Intake 3	70	34585	1336588273	/users/cn/jespinosa/phecomp/data/CRG/20120502_FDF_CRG/20120502_FDF_CRG/20120509_FDF_CRG_c12.mtb	1292	57	WWSS	food_sc	3	34515	1336588203	1	0.02	0.000285714285714286	2834	1
1	Drink 2	Intake 2	37	34618	1336588306	/users/cn/jespinosa/phecomp/data/CRG/20120502_FDF_CRG/20120502_FDF_CRG/20120509_FDF_CRG_c12.mtb	713	NA	WWSS	water	2	34581	1336588269	1	0.06	0.00162162162162162	2835	1
1	Food 1	Intake 3	51	34693	1336588381	/users/cn/jespinosa/phecomp/data/CRG/20120502_FDF_CRG/20120502_FDF_CRG/20120509_FDF_CRG_c12.mtb	1293	59	WWSS	food_sc	3	34642	1336588330	1	0.02	0.000392156862745098	2836	1
1	Food 2	Intake 4	65	34817	1336588505	/users/cn/jespinosa/phecomp/data/CRG/20120502_FDF_CRG/20120502_FDF_CRG/20120509_FDF_CRG_c12.mtb	1703	1253	WWSS	food_sc	4	34752	1336588440	1	0.02	0.000307692307692308	2837	1
1	Food 2	Intake 4	309	36379	1336590067	/users/cn/jespinosa/phecomp/data/CRG/20120502_FDF_CRG/20120502_FDF_CRG/20120509_FDF_CRG_c12.mtb	1705	1200	WWSS	food_sc	4	36070	1336589758	1	0.1	0.000323624595469256	2838	1
1	Drink 2	Intake 2	27	36403	1336590091	/users/cn/jespinosa/phecomp/data/CRG/20120502_FDF_CRG/20120502_FDF_CRG/20120509_FDF_CRG_c12.mtb	714	NA	WWSS	water	2	36376	1336590064	1	0.08	0.00296296296296296	2839	1
1	Food 2	Intake 4	223	37802	1336591490	/users/cn/jespinosa/phecomp/data/CRG/20120502_FDF_CRG/20120502_FDF_CRG/20120509_FDF_CRG_c12.mtb	1707	508	WWSS	food_sc	4	37579	1336591267	1	0.08	0.000358744394618834	2840	1
1	Drink 2	Intake 2	16	37816	1336591504	/users/cn/jespinosa/phecomp/data/CRG/20120502_FDF_CRG/20120502_FDF_CRG/20120509_FDF_CRG_c12.mtb	715	NA	WWSS	water	2	37800	1336591488	1	0.04	0.0025	2841	1
1	Drink 1	Intake 1	22	38287	1336591975	/users/cn/jespinosa/phecomp/data/CRG/20120502_FDF_CRG/20120502_FDF_CRG/20120509_FDF_CRG_c12.mtb	1732	NA	WWSS	water	1	38265	1336591953	1	0.02	0.000909090909090909	2842	1
1	Food 2	Intake 4	310	38620	1336592308	/users/cn/jespinosa/phecomp/data/CRG/20120502_FDF_CRG/20120502_FDF_CRG/20120509_FDF_CRG_c12.mtb	1708	1209	WWSS	food_sc	4	38310	1336591998	1	0.12	0.000387096774193548	2843	1
1	Drink 1	Intake 1	13	38636	1336592324	/users/cn/jespinosa/phecomp/data/CRG/20120502_FDF_CRG/20120502_FDF_CRG/20120509_FDF_CRG_c12.mtb	1733	NA	WWSS	water	1	38623	1336592311	1	0.06	0.00461538461538461	2844	1
1	Drink 1	Intake 1	15	38787	1336592475	/users/cn/jespinosa/phecomp/data/CRG/20120502_FDF_CRG/20120502_FDF_CRG/20120509_FDF_CRG_c12.mtb	1734	NA	WWSS	water	1	38772	1336592460	1	0.02	0.00133333333333333	2845	1
1	Food 2	Intake 4	187	40016	1336593704	/users/cn/jespinosa/phecomp/data/CRG/20120502_FDF_CRG/20120502_FDF_CRG/20120509_FDF_CRG_c12.mtb	1711	89	WWSS	food_sc	4	39829	1336593517	1	0.12	0.000641711229946524	2846	1
1	Food 2	Intake 4	49	40154	1336593842	/users/cn/jespinosa/phecomp/data/CRG/20120502_FDF_CRG/20120502_FDF_CRG/20120509_FDF_CRG_c12.mtb	1713	58	WWSS	food_sc	4	40105	1336593793	1	0.02	0.000408163265306122	2847	1
1	Food 1	Intake 3	48	40260	1336593948	/users/cn/jespinosa/phecomp/data/CRG/20120502_FDF_CRG/20120502_FDF_CRG/20120509_FDF_CRG_c12.mtb	1297	365	WWSS	food_sc	3	40212	1336593900	1	0.02	0.000416666666666667	2848	1
1	Food 2	Intake 4	162	40787	1336594475	/users/cn/jespinosa/phecomp/data/CRG/20120502_FDF_CRG/20120502_FDF_CRG/20120509_FDF_CRG_c12.mtb	1717	208	WWSS	food_sc	4	40625	1336594313	1	0.02	0.000123456790123457	2849	1
1	Drink 2	Intake 2	23	40805	1336594493	/users/cn/jespinosa/phecomp/data/CRG/20120502_FDF_CRG/20120502_FDF_CRG/20120509_FDF_CRG_c12.mtb	716	NA	WWSS	water	2	40782	1336594470	1	0.04	0.00173913043478261	2850	1
1	Food 2	Intake 4	80	41075	1336594763	/users/cn/jespinosa/phecomp/data/CRG/20120502_FDF_CRG/20120502_FDF_CRG/20120509_FDF_CRG_c12.mtb	1720	141	WWSS	food_sc	4	40995	1336594683	1	0.02	0.00025	2851	1
1	Drink 2	Intake 2	26	41096	1336594784	/users/cn/jespinosa/phecomp/data/CRG/20120502_FDF_CRG/20120502_FDF_CRG/20120509_FDF_CRG_c12.mtb	717	NA	WWSS	water	2	41070	1336594758	1	0.1	0.00384615384615385	2852	1
1	Food 2	Intake 4	97	41313	1336595001	/users/cn/jespinosa/phecomp/data/CRG/20120502_FDF_CRG/20120502_FDF_CRG/20120509_FDF_CRG_c12.mtb	1722	93	WWSS	food_sc	4	41216	1336594904	1	0.04	0.000412371134020619	2853	1
1	Drink 1	Intake 1	26	41342	1336595030	/users/cn/jespinosa/phecomp/data/CRG/20120502_FDF_CRG/20120502_FDF_CRG/20120509_FDF_CRG_c12.mtb	1737	NA	WWSS	water	1	41316	1336595004	1	0.02	0.000769230769230769	2854	1
1	Food 1	Intake 3	44	41450	1336595138	/users/cn/jespinosa/phecomp/data/CRG/20120502_FDF_CRG/20120502_FDF_CRG/20120509_FDF_CRG_c12.mtb	1303	46	WWSS	food_sc	3	41406	1336595094	1	0.02	0.000454545454545455	2855	1
1	Food 2	Intake 4	113	41609	1336595297	/users/cn/jespinosa/phecomp/data/CRG/20120502_FDF_CRG/20120502_FDF_CRG/20120509_FDF_CRG_c12.mtb	1723	COLL	WWSS	food_sc	4	41496	1336595184	1	0.02	0.000176991150442478	2856	1
1	Food 1	Intake 3	130	41726	1336595414	/users/cn/jespinosa/phecomp/data/CRG/20120502_FDF_CRG/20120502_FDF_CRG/20120509_FDF_CRG_c12.mtb	1306	484	WWSS	food_sc	3	41596	1336595284	1	0.04	0.000307692307692308	2857	1
1	Drink 2	Intake 2	28	41766	1336595454	/users/cn/jespinosa/phecomp/data/CRG/20120502_FDF_CRG/20120502_FDF_CRG/20120509_FDF_CRG_c12.mtb	718	NA	WWSS	water	2	41738	1336595426	1	0.06	0.00214285714285714	2858	1
1	Food 1	Intake 3	45	42255	1336595943	/users/cn/jespinosa/phecomp/data/CRG/20120502_FDF_CRG/20120502_FDF_CRG/20120509_FDF_CRG_c12.mtb	1307	101	WWSS	food_sc	3	42210	1336595898	1	0.02	0.000444444444444444	2859	1
1	Food 1	Intake 3	127	42483	1336596171	/users/cn/jespinosa/phecomp/data/CRG/20120502_FDF_CRG/20120502_FDF_CRG/20120509_FDF_CRG_c12.mtb	1308	279	WWSS	food_sc	3	42356	1336596044	1	0.02	0.00015748031496063	2860	1
1	Drink 2	Intake 2	28	42602	1336596290	/users/cn/jespinosa/phecomp/data/CRG/20120502_FDF_CRG/20120502_FDF_CRG/20120509_FDF_CRG_c12.mtb	719	NA	WWSS	water	2	42574	1336596262	1	0.1	0.00357142857142857	2861	1
1	Drink 1	Intake 1	17	42647	1336596335	/users/cn/jespinosa/phecomp/data/CRG/20120502_FDF_CRG/20120502_FDF_CRG/20120509_FDF_CRG_c12.mtb	1739	NA	WWSS	water	1	42630	1336596318	1	0.02	0.00117647058823529	2862	1
1	Food 2	Intake 4	21	42783	1336596471	/users/cn/jespinosa/phecomp/data/CRG/20120502_FDF_CRG/20120502_FDF_CRG/20120509_FDF_CRG_c12.mtb	1725	101	WWSS	food_sc	4	42762	1336596450	1	0.02	0.000952380952380952	2863	1
1	Food 2	Intake 4	111	42995	1336596683	/users/cn/jespinosa/phecomp/data/CRG/20120502_FDF_CRG/20120502_FDF_CRG/20120509_FDF_CRG_c12.mtb	1727	1077	WWSS	food_sc	4	42884	1336596572	1	0.0399999999999999	0.000360360360360359	2864	1
1	Drink 2	Intake 2	29	43030	1336596718	/users/cn/jespinosa/phecomp/data/CRG/20120502_FDF_CRG/20120502_FDF_CRG/20120509_FDF_CRG_c12.mtb	720	NA	WWSS	water	2	43001	1336596689	1	0.08	0.00275862068965517	2865	1
1	Food 2	Intake 4	17	44089	1336597777	/users/cn/jespinosa/phecomp/data/CRG/20120502_FDF_CRG/20120502_FDF_CRG/20120509_FDF_CRG_c12.mtb	1728	45	WWSS	food_sc	4	44072	1336597760	1	0.02	0.00117647058823529	2866	1
1	Food 2	Intake 4	39	44173	1336597861	/users/cn/jespinosa/phecomp/data/CRG/20120502_FDF_CRG/20120502_FDF_CRG/20120509_FDF_CRG_c12.mtb	1729	9	WWSS	food_sc	4	44134	1336597822	1	0.02	0.000512820512820513	2867	1
1	Food 2	Intake 4	74	44256	1336597944	/users/cn/jespinosa/phecomp/data/CRG/20120502_FDF_CRG/20120502_FDF_CRG/20120509_FDF_CRG_c12.mtb	1730	45	WWSS	food_sc	4	44182	1336597870	1	0.02	0.00027027027027027	2868	1
1	Food 2	Intake 4	220	44521	1336598209	/users/cn/jespinosa/phecomp/data/CRG/20120502_FDF_CRG/20120502_FDF_CRG/20120509_FDF_CRG_c12.mtb	1731	918	WWSS	food_sc	4	44301	1336597989	1	0.1	0.000454545454545455	2869	1
1	Drink 2	Intake 2	36	44552	1336598240	/users/cn/jespinosa/phecomp/data/CRG/20120502_FDF_CRG/20120502_FDF_CRG/20120509_FDF_CRG_c12.mtb	721	NA	WWSS	water	2	44516	1336598204	1	0.08	0.00222222222222222	2870	1
1	Food 2	Intake 4	128	45567	1336599255	/users/cn/jespinosa/phecomp/data/CRG/20120502_FDF_CRG/20120502_FDF_CRG/20120509_FDF_CRG_c12.mtb	1732	43	WWSS	food_sc	4	45439	1336599127	1	0.02	0.00015625	2871	1
1	Food 2	Intake 4	157	45767	1336599455	/users/cn/jespinosa/phecomp/data/CRG/20120502_FDF_CRG/20120502_FDF_CRG/20120509_FDF_CRG_c12.mtb	1733	COLL	WWSS	food_sc	4	45610	1336599298	1	0.02	0.000127388535031847	2872	1
1	Food 1	Intake 3	173	45926	1336599614	/users/cn/jespinosa/phecomp/data/CRG/20120502_FDF_CRG/20120502_FDF_CRG/20120509_FDF_CRG_c12.mtb	1316	73	WWSS	food_sc	3	45753	1336599441	1	0.04	0.00023121387283237	2873	1
1	Drink 1	Intake 1	31	45952	1336599640	/users/cn/jespinosa/phecomp/data/CRG/20120502_FDF_CRG/20120502_FDF_CRG/20120509_FDF_CRG_c12.mtb	1741	NA	WWSS	water	1	45921	1336599609	1	0.06	0.00193548387096774	2874	1
1	Food 1	Intake 3	160	46159	1336599847	/users/cn/jespinosa/phecomp/data/CRG/20120502_FDF_CRG/20120502_FDF_CRG/20120509_FDF_CRG_c12.mtb	1317	20	WWSS	food_sc	3	45999	1336599687	1	0.08	0.0005	2875	1
1	Food 1	Intake 3	82	46261	1336599949	/users/cn/jespinosa/phecomp/data/CRG/20120502_FDF_CRG/20120502_FDF_CRG/20120509_FDF_CRG_c12.mtb	1318	1945	WWSS	food_sc	3	46179	1336599867	1	0.0600000000000001	0.000731707317073172	2876	1
1	Drink 2	Intake 2	37	46300	1336599988	/users/cn/jespinosa/phecomp/data/CRG/20120502_FDF_CRG/20120502_FDF_CRG/20120509_FDF_CRG_c12.mtb	722	NA	WWSS	water	2	46263	1336599951	1	0.1	0.0027027027027027	2877	1
1	Food 1	Intake 3	58	48264	1336601952	/users/cn/jespinosa/phecomp/data/CRG/20120502_FDF_CRG/20120502_FDF_CRG/20120509_FDF_CRG_c12.mtb	1320	308	WWSS	food_sc	3	48206	1336601894	1	0.04	0.000689655172413793	2878	1
1	Food 1	Intake 3	203	48775	1336602463	/users/cn/jespinosa/phecomp/data/CRG/20120502_FDF_CRG/20120502_FDF_CRG/20120509_FDF_CRG_c12.mtb	1321	615	WWSS	food_sc	3	48572	1336602260	1	0.1	0.000492610837438424	2879	1
1	Drink 2	Intake 2	32	48867	1336602555	/users/cn/jespinosa/phecomp/data/CRG/20120502_FDF_CRG/20120502_FDF_CRG/20120509_FDF_CRG_c12.mtb	723	NA	WWSS	water	2	48835	1336602523	1	0.0599999999999999	0.001875	2880	1
1	Food 1	Intake 3	166	49556	1336603244	/users/cn/jespinosa/phecomp/data/CRG/20120502_FDF_CRG/20120502_FDF_CRG/20120509_FDF_CRG_c12.mtb	1322	418	WWSS	food_sc	3	49390	1336603078	1	0.0399999999999999	0.000240963855421686	2881	1
1	Drink 2	Intake 2	16	49565	1336603253	/users/cn/jespinosa/phecomp/data/CRG/20120502_FDF_CRG/20120502_FDF_CRG/20120509_FDF_CRG_c12.mtb	724	NA	WWSS	water	2	49549	1336603237	1	0.02	0.00125	2882	1
1	Food 1	Intake 3	160	50134	1336603822	/users/cn/jespinosa/phecomp/data/CRG/20120502_FDF_CRG/20120502_FDF_CRG/20120509_FDF_CRG_c12.mtb	1323	4	WWSS	food_sc	3	49974	1336603662	1	0.04	0.00025	2883	1
1	Food 1	Intake 3	80	50218	1336603906	/users/cn/jespinosa/phecomp/data/CRG/20120502_FDF_CRG/20120502_FDF_CRG/20120509_FDF_CRG_c12.mtb	1324	1781	WWSS	food_sc	3	50138	1336603826	1	0.04	0.0005	2884	1
1	Drink 1	Intake 1	46	50254	1336603942	/users/cn/jespinosa/phecomp/data/CRG/20120502_FDF_CRG/20120502_FDF_CRG/20120509_FDF_CRG_c12.mtb	1742	NA	WWSS	water	1	50208	1336603896	1	0.06	0.00130434782608696	2885	1
1	Food 1	Intake 3	74	52073	1336605761	/users/cn/jespinosa/phecomp/data/CRG/20120502_FDF_CRG/20120502_FDF_CRG/20120509_FDF_CRG_c12.mtb	1325	66	WWSS	food_sc	3	51999	1336605687	1	0.02	0.00027027027027027	2886	1
1	Food 1	Intake 3	244	52383	1336606071	/users/cn/jespinosa/phecomp/data/CRG/20120502_FDF_CRG/20120502_FDF_CRG/20120509_FDF_CRG_c12.mtb	1326	934	WWSS	food_sc	3	52139	1336605827	1	0.08	0.000327868852459016	2887	1
1	Drink 2	Intake 2	17	52412	1336606100	/users/cn/jespinosa/phecomp/data/CRG/20120502_FDF_CRG/20120502_FDF_CRG/20120509_FDF_CRG_c12.mtb	725	NA	WWSS	water	2	52395	1336606083	1	0.02	0.00117647058823529	2888	1
1	Drink 1	Intake 1	21	52498	1336606186	/users/cn/jespinosa/phecomp/data/CRG/20120502_FDF_CRG/20120502_FDF_CRG/20120509_FDF_CRG_c12.mtb	1743	NA	WWSS	water	1	52477	1336606165	1	0.02	0.000952380952380952	2889	1
1	Drink 1	Intake 1	23	52709	1336606397	/users/cn/jespinosa/phecomp/data/CRG/20120502_FDF_CRG/20120502_FDF_CRG/20120509_FDF_CRG_c12.mtb	1744	NA	WWSS	water	1	52686	1336606374	1	0.02	0.000869565217391304	2890	1
1	Drink 2	Intake 2	8	53186	1336606874	/users/cn/jespinosa/phecomp/data/CRG/20120502_FDF_CRG/20120502_FDF_CRG/20120509_FDF_CRG_c12.mtb	726	NA	WWSS	water	2	53178	1336606866	1	0.02	0.0025	2891	1
1	Food 1	Intake 3	57	53374	1336607062	/users/cn/jespinosa/phecomp/data/CRG/20120502_FDF_CRG/20120502_FDF_CRG/20120509_FDF_CRG_c12.mtb	1331	17	WWSS	food_sc	3	53317	1336607005	1	0.04	0.000701754385964912	2892	1
1	Food 1	Intake 3	55	53446	1336607134	/users/cn/jespinosa/phecomp/data/CRG/20120502_FDF_CRG/20120502_FDF_CRG/20120509_FDF_CRG_c12.mtb	1332	1189	WWSS	food_sc	3	53391	1336607079	1	0.04	0.000727272727272727	2893	1
1	Drink 2	Intake 2	25	53484	1336607172	/users/cn/jespinosa/phecomp/data/CRG/20120502_FDF_CRG/20120502_FDF_CRG/20120509_FDF_CRG_c12.mtb	727	NA	WWSS	water	2	53459	1336607147	1	0.08	0.0032	2894	1
1	Food 1	Intake 3	44	54679	1336608367	/users/cn/jespinosa/phecomp/data/CRG/20120502_FDF_CRG/20120502_FDF_CRG/20120509_FDF_CRG_c12.mtb	1334	182	WWSS	food_sc	3	54635	1336608323	1	0.02	0.000454545454545455	2895	1
1	Drink 2	Intake 2	19	54737	1336608425	/users/cn/jespinosa/phecomp/data/CRG/20120502_FDF_CRG/20120502_FDF_CRG/20120509_FDF_CRG_c12.mtb	728	NA	WWSS	water	2	54718	1336608406	1	0.02	0.00105263157894737	2896	1
1	Food 2	Intake 4	103	54964	1336608652	/users/cn/jespinosa/phecomp/data/CRG/20120502_FDF_CRG/20120502_FDF_CRG/20120509_FDF_CRG_c12.mtb	1751	48	WWSS	food_sc	4	54861	1336608549	1	0.04	0.000388349514563107	2897	1
1	Drink 2	Intake 2	46	55022	1336608710	/users/cn/jespinosa/phecomp/data/CRG/20120502_FDF_CRG/20120502_FDF_CRG/20120509_FDF_CRG_c12.mtb	729	NA	WWSS	water	2	54976	1336608664	1	0.02	0.000434782608695652	2898	1
1	Food 2	Intake 4	86	55098	1336608786	/users/cn/jespinosa/phecomp/data/CRG/20120502_FDF_CRG/20120502_FDF_CRG/20120509_FDF_CRG_c12.mtb	1752	4650	WWSS	food_sc	4	55012	1336608700	1	0.04	0.000465116279069767	2899	1
1	Drink 2	Intake 2	23	55269	1336608957	/users/cn/jespinosa/phecomp/data/CRG/20120502_FDF_CRG/20120502_FDF_CRG/20120509_FDF_CRG_c12.mtb	730	NA	WWSS	water	2	55246	1336608934	1	0.0600000000000001	0.00260869565217392	2900	1
1	Food 2	Intake 4	67	59815	1336613503	/users/cn/jespinosa/phecomp/data/CRG/20120502_FDF_CRG/20120502_FDF_CRG/20120509_FDF_CRG_c12.mtb	1755	13	WWSS	food_sc	4	59748	1336613436	1	0.0399999999999998	0.000597014925373131	2901	1
1	Food 2	Intake 4	164	59992	1336613680	/users/cn/jespinosa/phecomp/data/CRG/20120502_FDF_CRG/20120502_FDF_CRG/20120509_FDF_CRG_c12.mtb	1756	2366	WWSS	food_sc	4	59828	1336613516	1	0.0600000000000001	0.000365853658536586	2902	1
1	Food 1	Intake 3	21	62379	1336616067	/users/cn/jespinosa/phecomp/data/CRG/20120502_FDF_CRG/20120502_FDF_CRG/20120509_FDF_CRG_c12.mtb	1339	14	WWSS	food_sc	3	62358	1336616046	1	0.02	0.000952380952380952	2903	1
1	Food 2	Intake 4	30	62423	1336616111	/users/cn/jespinosa/phecomp/data/CRG/20120502_FDF_CRG/20120502_FDF_CRG/20120509_FDF_CRG_c12.mtb	1757	26	WWSS	food_sc	4	62393	1336616081	1	0.02	0.000666666666666667	2904	1
1	Food 1	Intake 3	132	62581	1336616269	/users/cn/jespinosa/phecomp/data/CRG/20120502_FDF_CRG/20120502_FDF_CRG/20120509_FDF_CRG_c12.mtb	1340	15	WWSS	food_sc	3	62449	1336616137	1	0.0599999999999998	0.000454545454545453	2905	1
1	Food 1	Intake 3	20	62616	1336616304	/users/cn/jespinosa/phecomp/data/CRG/20120502_FDF_CRG/20120502_FDF_CRG/20120509_FDF_CRG_c12.mtb	1341	22	WWSS	food_sc	3	62596	1336616284	1	0.04	0.002	2906	1
1	Food 1	Intake 3	23	62661	1336616349	/users/cn/jespinosa/phecomp/data/CRG/20120502_FDF_CRG/20120502_FDF_CRG/20120509_FDF_CRG_c12.mtb	1342	73	WWSS	food_sc	3	62638	1336616326	1	0.04	0.00173913043478261	2907	1
1	Food 1	Intake 3	34	62768	1336616456	/users/cn/jespinosa/phecomp/data/CRG/20120502_FDF_CRG/20120502_FDF_CRG/20120509_FDF_CRG_c12.mtb	1343	16	WWSS	food_sc	3	62734	1336616422	1	0.02	0.000588235294117647	2908	1
1	Food 2	Intake 4	159	62943	1336616631	/users/cn/jespinosa/phecomp/data/CRG/20120502_FDF_CRG/20120502_FDF_CRG/20120509_FDF_CRG_c12.mtb	1759	4066	WWSS	food_sc	4	62784	1336616472	1	0.04	0.000251572327044025	2909	1
1	Drink 1	Intake 1	16	62954	1336616642	/users/cn/jespinosa/phecomp/data/CRG/20120502_FDF_CRG/20120502_FDF_CRG/20120509_FDF_CRG_c12.mtb	1751	NA	WWSS	water	1	62938	1336616626	1	0.02	0.00125	2910	1
1	Drink 2	Intake 2	17	62961	1336616649	/users/cn/jespinosa/phecomp/data/CRG/20120502_FDF_CRG/20120502_FDF_CRG/20120509_FDF_CRG_c12.mtb	732	NA	WWSS	water	2	62944	1336616632	1	0.02	0.00117647058823529	2911	1
1	Drink 2	Intake 2	32	63380	1336617068	/users/cn/jespinosa/phecomp/data/CRG/20120502_FDF_CRG/20120502_FDF_CRG/20120509_FDF_CRG_c12.mtb	733	NA	WWSS	water	2	63348	1336617036	1	0.0599999999999998	0.00187499999999999	2912	1
1	Drink 2	Intake 2	20	63830	1336617518	/users/cn/jespinosa/phecomp/data/CRG/20120502_FDF_CRG/20120502_FDF_CRG/20120509_FDF_CRG_c12.mtb	734	NA	WWSS	water	2	63810	1336617498	1	0.0800000000000001	0.00400000000000001	2913	1
1	Food 2	Intake 4	189	67198	1336620886	/users/cn/jespinosa/phecomp/data/CRG/20120502_FDF_CRG/20120502_FDF_CRG/20120509_FDF_CRG_c12.mtb	1761	48	WWSS	food_sc	4	67009	1336620697	1	0.0799999999999998	0.000423280423280422	2914	1
1	Food 2	Intake 4	121	67367	1336621055	/users/cn/jespinosa/phecomp/data/CRG/20120502_FDF_CRG/20120502_FDF_CRG/20120509_FDF_CRG_c12.mtb	1762	1603	WWSS	food_sc	4	67246	1336620934	1	0.02	0.000165289256198347	2915	1
1	Food 2	Intake 4	370	69340	1336623028	/users/cn/jespinosa/phecomp/data/CRG/20120502_FDF_CRG/20120502_FDF_CRG/20120509_FDF_CRG_c12.mtb	1763	190	WWSS	food_sc	4	68970	1336622658	1	0.1	0.00027027027027027	2916	1
1	Drink 2	Intake 2	32	69365	1336623053	/users/cn/jespinosa/phecomp/data/CRG/20120502_FDF_CRG/20120502_FDF_CRG/20120509_FDF_CRG_c12.mtb	735	NA	WWSS	water	2	69333	1336623021	1	0.12	0.00375	2917	1
1	Food 1	Intake 3	172	69702	1336623390	/users/cn/jespinosa/phecomp/data/CRG/20120502_FDF_CRG/20120502_FDF_CRG/20120509_FDF_CRG_c12.mtb	1349	135	WWSS	food_sc	3	69530	1336623218	1	0.0600000000000001	0.000348837209302326	2918	1
1	Drink 2	Intake 2	20	69716	1336623404	/users/cn/jespinosa/phecomp/data/CRG/20120502_FDF_CRG/20120502_FDF_CRG/20120509_FDF_CRG_c12.mtb	736	NA	WWSS	water	2	69696	1336623384	1	0.0600000000000001	0.00300000000000001	2919	1
1	Food 2	Intake 4	112	69949	1336623637	/users/cn/jespinosa/phecomp/data/CRG/20120502_FDF_CRG/20120502_FDF_CRG/20120509_FDF_CRG_c12.mtb	1768	663	WWSS	food_sc	4	69837	1336623525	1	0.04	0.000357142857142857	2920	1
1	Drink 2	Intake 2	27	69967	1336623655	/users/cn/jespinosa/phecomp/data/CRG/20120502_FDF_CRG/20120502_FDF_CRG/20120509_FDF_CRG_c12.mtb	737	NA	WWSS	water	2	69940	1336623628	1	0.0600000000000001	0.00222222222222223	2921	1
1	Drink 1	Intake 1	16	70544	1336624232	/users/cn/jespinosa/phecomp/data/CRG/20120502_FDF_CRG/20120502_FDF_CRG/20120509_FDF_CRG_c12.mtb	1754	NA	WWSS	water	1	70528	1336624216	1	0.02	0.00125	2922	1
1	Food 2	Intake 4	82	70694	1336624382	/users/cn/jespinosa/phecomp/data/CRG/20120502_FDF_CRG/20120502_FDF_CRG/20120509_FDF_CRG_c12.mtb	1770	134	WWSS	food_sc	4	70612	1336624300	1	0.02	0.00024390243902439	2923	1
1	Drink 2	Intake 2	24	70714	1336624402	/users/cn/jespinosa/phecomp/data/CRG/20120502_FDF_CRG/20120502_FDF_CRG/20120509_FDF_CRG_c12.mtb	738	NA	WWSS	water	2	70690	1336624378	1	0.0800000000000001	0.00333333333333334	2924	1
1	Food 2	Intake 4	167	70995	1336624683	/users/cn/jespinosa/phecomp/data/CRG/20120502_FDF_CRG/20120502_FDF_CRG/20120509_FDF_CRG_c12.mtb	1773	169	WWSS	food_sc	4	70828	1336624516	1	0.0600000000000001	0.000359281437125749	2925	1
1	Drink 2	Intake 2	20	71010	1336624698	/users/cn/jespinosa/phecomp/data/CRG/20120502_FDF_CRG/20120502_FDF_CRG/20120509_FDF_CRG_c12.mtb	739	NA	WWSS	water	2	70990	1336624678	1	0.02	0.001	2926	1
1	Food 2	Intake 4	62	71226	1336624914	/users/cn/jespinosa/phecomp/data/CRG/20120502_FDF_CRG/20120502_FDF_CRG/20120509_FDF_CRG_c12.mtb	1775	24	WWSS	food_sc	4	71164	1336624852	1	0.02	0.00032258064516129	2927	1
1	Food 2	Intake 4	102	71352	1336625040	/users/cn/jespinosa/phecomp/data/CRG/20120502_FDF_CRG/20120502_FDF_CRG/20120509_FDF_CRG_c12.mtb	1776	146	WWSS	food_sc	4	71250	1336624938	1	0.04	0.000392156862745098	2928	1
1	Drink 2	Intake 2	25	71379	1336625067	/users/cn/jespinosa/phecomp/data/CRG/20120502_FDF_CRG/20120502_FDF_CRG/20120509_FDF_CRG_c12.mtb	740	NA	WWSS	water	2	71354	1336625042	1	0.04	0.0016	2929	1
1	Food 2	Intake 4	73	71571	1336625259	/users/cn/jespinosa/phecomp/data/CRG/20120502_FDF_CRG/20120502_FDF_CRG/20120509_FDF_CRG_c12.mtb	1778	324	WWSS	food_sc	4	71498	1336625186	1	0.02	0.000273972602739726	2930	1
1	Food 2	Intake 4	80	71975	1336625663	/users/cn/jespinosa/phecomp/data/CRG/20120502_FDF_CRG/20120502_FDF_CRG/20120509_FDF_CRG_c12.mtb	1780	2726	WWSS	food_sc	4	71895	1336625583	1	0.04	0.0005	2931	1
1	Drink 2	Intake 2	27	72401	1336626089	/users/cn/jespinosa/phecomp/data/CRG/20120502_FDF_CRG/20120502_FDF_CRG/20120509_FDF_CRG_c12.mtb	741	NA	WWSS	water	2	72374	1336626062	1	0.0799999999999998	0.00296296296296296	2932	1
1	Food 1	Intake 3	31	74732	1336628420	/users/cn/jespinosa/phecomp/data/CRG/20120502_FDF_CRG/20120502_FDF_CRG/20120509_FDF_CRG_c12.mtb	1362	40	WWSS	food_sc	3	74701	1336628389	1	0.02	0.000645161290322581	2933	1
1	Food 2	Intake 4	45	74817	1336628505	/users/cn/jespinosa/phecomp/data/CRG/20120502_FDF_CRG/20120502_FDF_CRG/20120509_FDF_CRG_c12.mtb	1786	100	WWSS	food_sc	4	74772	1336628460	1	0.04	0.000888888888888889	2934	1
1	Food 2	Intake 4	77	74994	1336628682	/users/cn/jespinosa/phecomp/data/CRG/20120502_FDF_CRG/20120502_FDF_CRG/20120509_FDF_CRG_c12.mtb	1787	168	WWSS	food_sc	4	74917	1336628605	1	0.02	0.00025974025974026	2935	1
1	Drink 1	Intake 1	15	75129	1336628817	/users/cn/jespinosa/phecomp/data/CRG/20120502_FDF_CRG/20120502_FDF_CRG/20120509_FDF_CRG_c12.mtb	1756	NA	WWSS	water	1	75114	1336628802	1	0.04	0.00266666666666667	2936	1
1	Food 2	Intake 4	83	75245	1336628933	/users/cn/jespinosa/phecomp/data/CRG/20120502_FDF_CRG/20120502_FDF_CRG/20120509_FDF_CRG_c12.mtb	1790	532	WWSS	food_sc	4	75162	1336628850	1	0.0600000000000001	0.000722891566265061	2937	1
1	Drink 2	Intake 2	20	75320	1336629008	/users/cn/jespinosa/phecomp/data/CRG/20120502_FDF_CRG/20120502_FDF_CRG/20120509_FDF_CRG_c12.mtb	742	NA	WWSS	water	2	75300	1336628988	1	0.02	0.001	2938	1
1	Food 2	Intake 4	47	75824	1336629512	/users/cn/jespinosa/phecomp/data/CRG/20120502_FDF_CRG/20120502_FDF_CRG/20120509_FDF_CRG_c12.mtb	1792	40	WWSS	food_sc	4	75777	1336629465	1	0.02	0.000425531914893617	2939	1
1	Food 2	Intake 4	99	75963	1336629651	/users/cn/jespinosa/phecomp/data/CRG/20120502_FDF_CRG/20120502_FDF_CRG/20120509_FDF_CRG_c12.mtb	1793	2618	WWSS	food_sc	4	75864	1336629552	1	0.02	0.000202020202020202	2940	1
1	Drink 2	Intake 2	38	76086	1336629774	/users/cn/jespinosa/phecomp/data/CRG/20120502_FDF_CRG/20120502_FDF_CRG/20120509_FDF_CRG_c12.mtb	743	NA	WWSS	water	2	76048	1336629736	1	0.16	0.00421052631578947	2941	1
1	Food 2	Intake 4	17	78598	1336632286	/users/cn/jespinosa/phecomp/data/CRG/20120502_FDF_CRG/20120502_FDF_CRG/20120509_FDF_CRG_c12.mtb	1795	8311	WWSS	food_sc	4	78581	1336632269	1	0.02	0.00117647058823529	2942	1
1	Food 2	Intake 4	37	86946	1336640634	/users/cn/jespinosa/phecomp/data/CRG/20120502_FDF_CRG/20120502_FDF_CRG/20120509_FDF_CRG_c12.mtb	1798	210	WWSS	food_sc	4	86909	1336640597	1	0.02	0.000540540540540541	2943	1
1	Food 2	Intake 4	120	87276	1336640964	/users/cn/jespinosa/phecomp/data/CRG/20120502_FDF_CRG/20120502_FDF_CRG/20120509_FDF_CRG_c12.mtb	1800	445	WWSS	food_sc	4	87156	1336640844	1	0.0600000000000001	0.000500000000000001	2944	1
1	Food 2	Intake 4	57	87778	1336641466	/users/cn/jespinosa/phecomp/data/CRG/20120502_FDF_CRG/20120502_FDF_CRG/20120509_FDF_CRG_c12.mtb	1802	14490	WWSS	food_sc	4	87721	1336641409	1	0.02	0.000350877192982456	2945	1
1	Drink 2	Intake 2	8	87866	1336641554	/users/cn/jespinosa/phecomp/data/CRG/20120502_FDF_CRG/20120502_FDF_CRG/20120509_FDF_CRG_c12.mtb	747	NA	WWSS	water	2	87858	1336641546	1	0.02	0.0025	2946	1
1	Drink 2	Intake 2	18	89236	1336642924	/users/cn/jespinosa/phecomp/data/CRG/20120502_FDF_CRG/20120502_FDF_CRG/20120509_FDF_CRG_c12.mtb	748	NA	WWSS	water	2	89218	1336642906	1	0.0600000000000001	0.00333333333333334	2947	1
1	Food 2	Intake 4	364	102632	1336656320	/users/cn/jespinosa/phecomp/data/CRG/20120502_FDF_CRG/20120502_FDF_CRG/20120509_FDF_CRG_c12.mtb	1807	14	WWSS	food_sc	4	102268	1336655956	1	0.14	0.000384615384615385	2948	1
1	Food 2	Intake 4	123	102769	1336656457	/users/cn/jespinosa/phecomp/data/CRG/20120502_FDF_CRG/20120502_FDF_CRG/20120509_FDF_CRG_c12.mtb	1808	8755	WWSS	food_sc	4	102646	1336656334	1	0.0600000000000001	0.000487804878048781	2949	1
1	Food 2	Intake 4	495	112019	1336665707	/users/cn/jespinosa/phecomp/data/CRG/20120502_FDF_CRG/20120502_FDF_CRG/20120509_FDF_CRG_c12.mtb	1810	7978	WWSS	food_sc	4	111524	1336665212	1	0.16	0.000323232323232323	2950	1
1	Food 2	Intake 4	247	120244	1336673932	/users/cn/jespinosa/phecomp/data/CRG/20120502_FDF_CRG/20120502_FDF_CRG/20120509_FDF_CRG_c12.mtb	1813	88	WWSS	food_sc	4	119997	1336673685	1	0.0800000000000001	0.000323886639676114	2951	1
1	Food 2	Intake 4	56	120388	1336674076	/users/cn/jespinosa/phecomp/data/CRG/20120502_FDF_CRG/20120502_FDF_CRG/20120509_FDF_CRG_c12.mtb	1815	2173	WWSS	food_sc	4	120332	1336674020	1	0.02	0.000357142857142857	2952	1
1	Food 2	Intake 4	644	123205	1336676893	/users/cn/jespinosa/phecomp/data/CRG/20120502_FDF_CRG/20120502_FDF_CRG/20120509_FDF_CRG_c12.mtb	1816	2798	WWSS	food_sc	4	122561	1336676249	1	0.22	0.000341614906832298	2953	1
1	Drink 2	Intake 2	11	123220	1336676908	/users/cn/jespinosa/phecomp/data/CRG/20120502_FDF_CRG/20120502_FDF_CRG/20120509_FDF_CRG_c12.mtb	751	NA	WWSS	water	2	123209	1336676897	1	0.04	0.00363636363636364	2954	1
1	Drink 2	Intake 2	25	124447	1336678135	/users/cn/jespinosa/phecomp/data/CRG/20120502_FDF_CRG/20120502_FDF_CRG/20120509_FDF_CRG_c12.mtb	752	NA	WWSS	water	2	124422	1336678110	1	0.1	0.004	2955	1
1	Food 2	Intake 4	43	126046	1336679734	/users/cn/jespinosa/phecomp/data/CRG/20120502_FDF_CRG/20120502_FDF_CRG/20120509_FDF_CRG_c12.mtb	1818	43	WWSS	food_sc	4	126003	1336679691	1	0.0200000000000005	0.000465116279069779	2956	1
1	Food 1	Intake 3	133	126222	1336679910	/users/cn/jespinosa/phecomp/data/CRG/20120502_FDF_CRG/20120502_FDF_CRG/20120509_FDF_CRG_c12.mtb	1383	7	WWSS	food_sc	3	126089	1336679777	1	0.04	0.000300751879699248	2957	1
1	Food 1	Intake 3	110	126339	1336680027	/users/cn/jespinosa/phecomp/data/CRG/20120502_FDF_CRG/20120502_FDF_CRG/20120509_FDF_CRG_c12.mtb	1384	1423	WWSS	food_sc	3	126229	1336679917	1	0.04	0.000363636363636364	2958	1
1	Food 2	Intake 4	131	127893	1336681581	/users/cn/jespinosa/phecomp/data/CRG/20120502_FDF_CRG/20120502_FDF_CRG/20120509_FDF_CRG_c12.mtb	1825	COLL	WWSS	food_sc	4	127762	1336681450	1	0.04	0.000305343511450382	2959	1
1	Food 1	Intake 3	17	127782	1336681470	/users/cn/jespinosa/phecomp/data/CRG/20120502_FDF_CRG/20120502_FDF_CRG/20120509_FDF_CRG_c12.mtb	1385	115	WWSS	food_sc	3	127765	1336681453	1	0.02	0.00117647058823529	2960	1
1	Food 2	Intake 4	139	128036	1336681724	/users/cn/jespinosa/phecomp/data/CRG/20120502_FDF_CRG/20120502_FDF_CRG/20120509_FDF_CRG_c12.mtb	1826	27	WWSS	food_sc	4	127897	1336681585	1	0.04	0.000287769784172662	2961	1
1	Food 2	Intake 4	96	128159	1336681847	/users/cn/jespinosa/phecomp/data/CRG/20120502_FDF_CRG/20120502_FDF_CRG/20120509_FDF_CRG_c12.mtb	1827	1511	WWSS	food_sc	4	128063	1336681751	1	0.02	0.000208333333333333	2962	1
1	Drink 1	Intake 1	20	128307	1336681995	/users/cn/jespinosa/phecomp/data/CRG/20120502_FDF_CRG/20120502_FDF_CRG/20120509_FDF_CRG_c12.mtb	1764	NA	WWSS	water	1	128287	1336681975	1	0.1	0.005	2963	1
1	Food 2	Intake 4	322	129992	1336683680	/users/cn/jespinosa/phecomp/data/CRG/20120502_FDF_CRG/20120502_FDF_CRG/20120509_FDF_CRG_c12.mtb	1829	78	WWSS	food_sc	4	129670	1336683358	1	0.0600000000000001	0.000186335403726708	2964	1
1	Food 1	Intake 3	266	130336	1336684024	/users/cn/jespinosa/phecomp/data/CRG/20120502_FDF_CRG/20120502_FDF_CRG/20120509_FDF_CRG_c12.mtb	1387	5	WWSS	food_sc	3	130070	1336683758	1	0.1	0.00037593984962406	2965	1
1	Food 1	Intake 3	158	130499	1336684187	/users/cn/jespinosa/phecomp/data/CRG/20120502_FDF_CRG/20120502_FDF_CRG/20120509_FDF_CRG_c12.mtb	1388	125	WWSS	food_sc	3	130341	1336684029	1	0.1	0.000632911392405063	2966	1
1	Drink 2	Intake 2	33	130547	1336684235	/users/cn/jespinosa/phecomp/data/CRG/20120502_FDF_CRG/20120502_FDF_CRG/20120509_FDF_CRG_c12.mtb	753	NA	WWSS	water	2	130514	1336684202	1	0.12	0.00363636363636364	2967	1
1	Food 1	Intake 3	104	130728	1336684416	/users/cn/jespinosa/phecomp/data/CRG/20120502_FDF_CRG/20120502_FDF_CRG/20120509_FDF_CRG_c12.mtb	1390	2578	WWSS	food_sc	3	130624	1336684312	1	0.0399999999999998	0.000384615384615383	2968	1
1	Drink 2	Intake 2	20	130742	1336684430	/users/cn/jespinosa/phecomp/data/CRG/20120502_FDF_CRG/20120502_FDF_CRG/20120509_FDF_CRG_c12.mtb	754	NA	WWSS	water	2	130722	1336684410	1	0.04	0.002	2969	1
1	Drink 2	Intake 2	18	131038	1336684726	/users/cn/jespinosa/phecomp/data/CRG/20120502_FDF_CRG/20120502_FDF_CRG/20120509_FDF_CRG_c12.mtb	755	NA	WWSS	water	2	131020	1336684708	1	0.0399999999999996	0.0022222222222222	2970	1
1	Food 1	Intake 3	387	133693	1336687381	/users/cn/jespinosa/phecomp/data/CRG/20120502_FDF_CRG/20120502_FDF_CRG/20120509_FDF_CRG_c12.mtb	1392	491	WWSS	food_sc	3	133306	1336686994	1	0.2	0.000516795865633075	2971	1
1	Drink 2	Intake 2	19	133709	1336687397	/users/cn/jespinosa/phecomp/data/CRG/20120502_FDF_CRG/20120502_FDF_CRG/20120509_FDF_CRG_c12.mtb	756	NA	WWSS	water	2	133690	1336687378	1	0.04	0.00210526315789474	2972	1
1	Food 1	Intake 3	65	134249	1336687937	/users/cn/jespinosa/phecomp/data/CRG/20120502_FDF_CRG/20120502_FDF_CRG/20120509_FDF_CRG_c12.mtb	1397	COLL	WWSS	food_sc	3	134184	1336687872	1	0.02	0.000307692307692308	2973	1
1	Food 2	Intake 4	172	134408	1336688096	/users/cn/jespinosa/phecomp/data/CRG/20120502_FDF_CRG/20120502_FDF_CRG/20120509_FDF_CRG_c12.mtb	1837	34	WWSS	food_sc	4	134236	1336687924	1	0.02	0.000116279069767442	2974	1
1	Drink 1	Intake 1	44	134446	1336688134	/users/cn/jespinosa/phecomp/data/CRG/20120502_FDF_CRG/20120502_FDF_CRG/20120509_FDF_CRG_c12.mtb	1765	NA	WWSS	water	1	134402	1336688090	1	0.14	0.00318181818181818	2975	1
1	Food 2	Intake 4	110	134552	1336688240	/users/cn/jespinosa/phecomp/data/CRG/20120502_FDF_CRG/20120502_FDF_CRG/20120509_FDF_CRG_c12.mtb	1838	307	WWSS	food_sc	4	134442	1336688130	1	0.02	0.000181818181818182	2976	1
1	Food 2	Intake 4	57	134916	1336688604	/users/cn/jespinosa/phecomp/data/CRG/20120502_FDF_CRG/20120502_FDF_CRG/20120509_FDF_CRG_c12.mtb	1840	5	WWSS	food_sc	4	134859	1336688547	1	0.0600000000000001	0.00105263157894737	2977	1
1	Food 2	Intake 4	93	135014	1336688702	/users/cn/jespinosa/phecomp/data/CRG/20120502_FDF_CRG/20120502_FDF_CRG/20120509_FDF_CRG_c12.mtb	1841	218	WWSS	food_sc	4	134921	1336688609	1	0.04	0.00043010752688172	2978	1
1	Drink 1	Intake 1	32	135044	1336688732	/users/cn/jespinosa/phecomp/data/CRG/20120502_FDF_CRG/20120502_FDF_CRG/20120509_FDF_CRG_c12.mtb	1767	NA	WWSS	water	1	135012	1336688700	1	0.0800000000000001	0.0025	2979	1
1	Food 2	Intake 4	149	135381	1336689069	/users/cn/jespinosa/phecomp/data/CRG/20120502_FDF_CRG/20120502_FDF_CRG/20120509_FDF_CRG_c12.mtb	1845	904	WWSS	food_sc	4	135232	1336688920	1	0.04	0.000268456375838926	2980	1
1	Drink 2	Intake 2	18	135629	1336689317	/users/cn/jespinosa/phecomp/data/CRG/20120502_FDF_CRG/20120502_FDF_CRG/20120509_FDF_CRG_c12.mtb	758	NA	WWSS	water	2	135611	1336689299	1	0.02	0.00111111111111111	2981	1
1	Food 2	Intake 4	145	136430	1336690118	/users/cn/jespinosa/phecomp/data/CRG/20120502_FDF_CRG/20120502_FDF_CRG/20120509_FDF_CRG_c12.mtb	1850	173	WWSS	food_sc	4	136285	1336689973	1	0.04	0.000275862068965517	2982	1
1	Drink 2	Intake 2	21	136442	1336690130	/users/cn/jespinosa/phecomp/data/CRG/20120502_FDF_CRG/20120502_FDF_CRG/20120509_FDF_CRG_c12.mtb	760	NA	WWSS	water	2	136421	1336690109	1	0.0800000000000001	0.00380952380952381	2983	1
1	Food 1	Intake 3	52	136655	1336690343	/users/cn/jespinosa/phecomp/data/CRG/20120502_FDF_CRG/20120502_FDF_CRG/20120509_FDF_CRG_c12.mtb	1409	67	WWSS	food_sc	3	136603	1336690291	1	0.04	0.000769230769230769	2984	1
1	Food 1	Intake 3	120	136842	1336690530	/users/cn/jespinosa/phecomp/data/CRG/20120502_FDF_CRG/20120502_FDF_CRG/20120509_FDF_CRG_c12.mtb	1410	COLL	WWSS	food_sc	3	136722	1336690410	1	0.02	0.000166666666666667	2985	1
1	Food 2	Intake 4	18	136770	1336690458	/users/cn/jespinosa/phecomp/data/CRG/20120502_FDF_CRG/20120502_FDF_CRG/20120509_FDF_CRG_c12.mtb	1851	5210	WWSS	food_sc	4	136752	1336690440	1	0.02	0.00111111111111111	2986	1
1	Drink 2	Intake 2	24	137114	1336690802	/users/cn/jespinosa/phecomp/data/CRG/20120502_FDF_CRG/20120502_FDF_CRG/20120509_FDF_CRG_c12.mtb	761	NA	WWSS	water	2	137090	1336690778	1	0.04	0.00166666666666667	2987	1
1	Food 1	Intake 3	118	142098	1336695786	/users/cn/jespinosa/phecomp/data/CRG/20120502_FDF_CRG/20120502_FDF_CRG/20120509_FDF_CRG_c12.mtb	1412	28	WWSS	food_sc	3	141980	1336695668	1	0.04	0.000338983050847458	2988	1
1	Food 1	Intake 3	332	142458	1336696146	/users/cn/jespinosa/phecomp/data/CRG/20120502_FDF_CRG/20120502_FDF_CRG/20120509_FDF_CRG_c12.mtb	1413	101	WWSS	food_sc	3	142126	1336695814	1	0.12	0.00036144578313253	2989	1
1	Drink 2	Intake 2	27	142479	1336696167	/users/cn/jespinosa/phecomp/data/CRG/20120502_FDF_CRG/20120502_FDF_CRG/20120509_FDF_CRG_c12.mtb	762	NA	WWSS	water	2	142452	1336696140	1	0.0800000000000001	0.00296296296296297	2990	1
1	Food 1	Intake 3	105	142664	1336696352	/users/cn/jespinosa/phecomp/data/CRG/20120502_FDF_CRG/20120502_FDF_CRG/20120509_FDF_CRG_c12.mtb	1414	20	WWSS	food_sc	3	142559	1336696247	1	0.02	0.00019047619047619	2991	1
1	Food 1	Intake 3	136	142820	1336696508	/users/cn/jespinosa/phecomp/data/CRG/20120502_FDF_CRG/20120502_FDF_CRG/20120509_FDF_CRG_c12.mtb	1415	2879	WWSS	food_sc	3	142684	1336696372	1	0.0600000000000001	0.000441176470588236	2992	1
1	Drink 2	Intake 2	18	142847	1336696535	/users/cn/jespinosa/phecomp/data/CRG/20120502_FDF_CRG/20120502_FDF_CRG/20120509_FDF_CRG_c12.mtb	763	NA	WWSS	water	2	142829	1336696517	1	0.02	0.00111111111111111	2993	1
1	Food 1	Intake 3	85	145784	1336699472	/users/cn/jespinosa/phecomp/data/CRG/20120502_FDF_CRG/20120502_FDF_CRG/20120509_FDF_CRG_c12.mtb	1417	112	WWSS	food_sc	3	145699	1336699387	1	0.04	0.000470588235294118	2994	1
1	Food 1	Intake 3	73	145969	1336699657	/users/cn/jespinosa/phecomp/data/CRG/20120502_FDF_CRG/20120502_FDF_CRG/20120509_FDF_CRG_c12.mtb	1418	7	WWSS	food_sc	3	145896	1336699584	1	0.04	0.000547945205479452	2995	1
1	Food 1	Intake 3	77	146053	1336699741	/users/cn/jespinosa/phecomp/data/CRG/20120502_FDF_CRG/20120502_FDF_CRG/20120509_FDF_CRG_c12.mtb	1419	185	WWSS	food_sc	3	145976	1336699664	1	0.04	0.000519480519480519	2996	1
1	Drink 2	Intake 2	33	146081	1336699769	/users/cn/jespinosa/phecomp/data/CRG/20120502_FDF_CRG/20120502_FDF_CRG/20120509_FDF_CRG_c12.mtb	765	NA	WWSS	water	2	146048	1336699736	1	0.0800000000000001	0.00242424242424243	2997	1
1	Food 2	Intake 4	36	146274	1336699962	/users/cn/jespinosa/phecomp/data/CRG/20120502_FDF_CRG/20120502_FDF_CRG/20120509_FDF_CRG_c12.mtb	1870	52	WWSS	food_sc	4	146238	1336699926	1	0.02	0.000555555555555556	2998	1
1	Food 1	Intake 3	95	146421	1336700109	/users/cn/jespinosa/phecomp/data/CRG/20120502_FDF_CRG/20120502_FDF_CRG/20120509_FDF_CRG_c12.mtb	1423	COLL	WWSS	food_sc	3	146326	1336700014	1	0.02	0.000210526315789474	2999	1
1	Food 2	Intake 4	21	146436	1336700124	/users/cn/jespinosa/phecomp/data/CRG/20120502_FDF_CRG/20120502_FDF_CRG/20120509_FDF_CRG_c12.mtb	1872	735	WWSS	food_sc	4	146415	1336700103	1	0.02	0.000952380952380952	3000	1
1	Drink 2	Intake 2	21	146453	1336700141	/users/cn/jespinosa/phecomp/data/CRG/20120502_FDF_CRG/20120502_FDF_CRG/20120509_FDF_CRG_c12.mtb	767	NA	WWSS	water	2	146432	1336700120	1	0.0399999999999996	0.00190476190476189	3001	1
1	Drink 2	Intake 2	34	147034	1336700722	/users/cn/jespinosa/phecomp/data/CRG/20120502_FDF_CRG/20120502_FDF_CRG/20120509_FDF_CRG_c12.mtb	768	NA	WWSS	water	2	147000	1336700688	1	0.12	0.00352941176470588	3002	1
1	Food 1	Intake 3	144	147315	1336701003	/users/cn/jespinosa/phecomp/data/CRG/20120502_FDF_CRG/20120502_FDF_CRG/20120509_FDF_CRG_c12.mtb	1427	70	WWSS	food_sc	3	147171	1336700859	1	0.0600000000000001	0.000416666666666667	3003	1
1	Food 1	Intake 3	197	147582	1336701270	/users/cn/jespinosa/phecomp/data/CRG/20120502_FDF_CRG/20120502_FDF_CRG/20120509_FDF_CRG_c12.mtb	1428	525	WWSS	food_sc	3	147385	1336701073	1	0.0600000000000001	0.000304568527918782	3004	1
1	Drink 2	Intake 2	20	147596	1336701284	/users/cn/jespinosa/phecomp/data/CRG/20120502_FDF_CRG/20120502_FDF_CRG/20120509_FDF_CRG_c12.mtb	769	NA	WWSS	water	2	147576	1336701264	1	0.0600000000000001	0.00300000000000001	3005	1
1	Drink 2	Intake 2	21	147985	1336701673	/users/cn/jespinosa/phecomp/data/CRG/20120502_FDF_CRG/20120502_FDF_CRG/20120509_FDF_CRG_c12.mtb	770	NA	WWSS	water	2	147964	1336701652	1	0.02	0.000952380952380952	3006	1
1	Food 1	Intake 3	134	148241	1336701929	/users/cn/jespinosa/phecomp/data/CRG/20120502_FDF_CRG/20120502_FDF_CRG/20120509_FDF_CRG_c12.mtb	1430	3796	WWSS	food_sc	3	148107	1336701795	1	0.04	0.000298507462686567	3007	1
1	Drink 2	Intake 2	27	148264	1336701952	/users/cn/jespinosa/phecomp/data/CRG/20120502_FDF_CRG/20120502_FDF_CRG/20120509_FDF_CRG_c12.mtb	772	NA	WWSS	water	2	148237	1336701925	1	0.0600000000000001	0.00222222222222223	3008	1
1	Food 1	Intake 3	77	152114	1336705802	/users/cn/jespinosa/phecomp/data/CRG/20120502_FDF_CRG/20120502_FDF_CRG/20120509_FDF_CRG_c12.mtb	1431	128	WWSS	food_sc	3	152037	1336705725	1	0.04	0.000519480519480519	3009	1
1	Food 1	Intake 3	91	152333	1336706021	/users/cn/jespinosa/phecomp/data/CRG/20120502_FDF_CRG/20120502_FDF_CRG/20120509_FDF_CRG_c12.mtb	1433	76	WWSS	food_sc	3	152242	1336705930	1	0.0600000000000001	0.00065934065934066	3010	1
1	Food 1	Intake 3	49	152458	1336706146	/users/cn/jespinosa/phecomp/data/CRG/20120502_FDF_CRG/20120502_FDF_CRG/20120509_FDF_CRG_c12.mtb	1435	122	WWSS	food_sc	3	152409	1336706097	1	0.02	0.000408163265306122	3011	1
1	Drink 2	Intake 2	29	152540	1336706228	/users/cn/jespinosa/phecomp/data/CRG/20120502_FDF_CRG/20120502_FDF_CRG/20120509_FDF_CRG_c12.mtb	775	NA	WWSS	water	2	152511	1336706199	1	0.1	0.00344827586206897	3012	1
1	Food 1	Intake 3	70	152650	1336706338	/users/cn/jespinosa/phecomp/data/CRG/20120502_FDF_CRG/20120502_FDF_CRG/20120509_FDF_CRG_c12.mtb	1436	17	WWSS	food_sc	3	152580	1336706268	1	0.02	0.000285714285714286	3013	1
1	Food 1	Intake 3	115	152782	1336706470	/users/cn/jespinosa/phecomp/data/CRG/20120502_FDF_CRG/20120502_FDF_CRG/20120509_FDF_CRG_c12.mtb	1437	32	WWSS	food_sc	3	152667	1336706355	1	0.04	0.000347826086956522	3014	1
1	Food 2	Intake 4	107	152921	1336706609	/users/cn/jespinosa/phecomp/data/CRG/20120502_FDF_CRG/20120502_FDF_CRG/20120509_FDF_CRG_c12.mtb	1889	342	WWSS	food_sc	4	152814	1336706502	1	0.04	0.000373831775700935	3015	1
1	Drink 2	Intake 2	24	152937	1336706625	/users/cn/jespinosa/phecomp/data/CRG/20120502_FDF_CRG/20120502_FDF_CRG/20120509_FDF_CRG_c12.mtb	777	NA	WWSS	water	2	152913	1336706601	1	0.0600000000000001	0.0025	3016	1
1	Food 2	Intake 4	113	153376	1336707064	/users/cn/jespinosa/phecomp/data/CRG/20120502_FDF_CRG/20120502_FDF_CRG/20120509_FDF_CRG_c12.mtb	1891	38	WWSS	food_sc	4	153263	1336706951	1	0.0599999999999996	0.00053097345132743	3017	1
1	Food 2	Intake 4	70	153484	1336707172	/users/cn/jespinosa/phecomp/data/CRG/20120502_FDF_CRG/20120502_FDF_CRG/20120509_FDF_CRG_c12.mtb	1892	107	WWSS	food_sc	4	153414	1336707102	1	0.02	0.000285714285714286	3018	1
1	Drink 2	Intake 2	31	153520	1336707208	/users/cn/jespinosa/phecomp/data/CRG/20120502_FDF_CRG/20120502_FDF_CRG/20120509_FDF_CRG_c12.mtb	778	NA	WWSS	water	2	153489	1336707177	1	0.1	0.0032258064516129	3019	1
1	Food 1	Intake 3	102	153693	1336707381	/users/cn/jespinosa/phecomp/data/CRG/20120502_FDF_CRG/20120502_FDF_CRG/20120509_FDF_CRG_c12.mtb	1444	214	WWSS	food_sc	3	153591	1336707279	1	0.04	0.000392156862745098	3020	1
1	Food 2	Intake 4	31	153938	1336707626	/users/cn/jespinosa/phecomp/data/CRG/20120502_FDF_CRG/20120502_FDF_CRG/20120509_FDF_CRG_c12.mtb	1897	2822	WWSS	food_sc	4	153907	1336707595	1	0.02	0.000645161290322581	3021	1
1	Drink 2	Intake 2	23	154061	1336707749	/users/cn/jespinosa/phecomp/data/CRG/20120502_FDF_CRG/20120502_FDF_CRG/20120509_FDF_CRG_c12.mtb	779	NA	WWSS	water	2	154038	1336707726	1	0.04	0.00173913043478261	3022	1
1	Food 1	Intake 3	109	156869	1336710557	/users/cn/jespinosa/phecomp/data/CRG/20120502_FDF_CRG/20120502_FDF_CRG/20120509_FDF_CRG_c12.mtb	1451	98	WWSS	food_sc	3	156760	1336710448	1	0.02	0.00018348623853211	3023	1
1	Food 1	Intake 3	165	157132	1336710820	/users/cn/jespinosa/phecomp/data/CRG/20120502_FDF_CRG/20120502_FDF_CRG/20120509_FDF_CRG_c12.mtb	1452	104	WWSS	food_sc	3	156967	1336710655	1	0.0600000000000001	0.000363636363636364	3024	1
1	Drink 1	Intake 1	18	157188	1336710876	/users/cn/jespinosa/phecomp/data/CRG/20120502_FDF_CRG/20120502_FDF_CRG/20120509_FDF_CRG_c12.mtb	1773	NA	WWSS	water	1	157170	1336710858	1	0.0599999999999999	0.00333333333333333	3025	1
1	Food 1	Intake 3	225	157461	1336711149	/users/cn/jespinosa/phecomp/data/CRG/20120502_FDF_CRG/20120502_FDF_CRG/20120509_FDF_CRG_c12.mtb	1453	674	WWSS	food_sc	3	157236	1336710924	1	0.0600000000000001	0.000266666666666667	3026	1
1	Drink 2	Intake 2	15	157486	1336711174	/users/cn/jespinosa/phecomp/data/CRG/20120502_FDF_CRG/20120502_FDF_CRG/20120509_FDF_CRG_c12.mtb	781	NA	WWSS	water	2	157471	1336711159	1	0.04	0.00266666666666667	3027	1
1	Food 2	Intake 4	60	158195	1336711883	/users/cn/jespinosa/phecomp/data/CRG/20120502_FDF_CRG/20120502_FDF_CRG/20120509_FDF_CRG_c12.mtb	1910	15	WWSS	food_sc	4	158135	1336711823	1	0.02	0.000333333333333333	3028	1
1	Food 2	Intake 4	183	158393	1336712081	/users/cn/jespinosa/phecomp/data/CRG/20120502_FDF_CRG/20120502_FDF_CRG/20120509_FDF_CRG_c12.mtb	1911	143	WWSS	food_sc	4	158210	1336711898	1	0.0800000000000001	0.000437158469945356	3029	1
1	Drink 2	Intake 2	22	158412	1336712100	/users/cn/jespinosa/phecomp/data/CRG/20120502_FDF_CRG/20120502_FDF_CRG/20120509_FDF_CRG_c12.mtb	782	NA	WWSS	water	2	158390	1336712078	1	0.0600000000000001	0.00272727272727273	3030	1
1	Food 2	Intake 4	231	158767	1336712455	/users/cn/jespinosa/phecomp/data/CRG/20120502_FDF_CRG/20120502_FDF_CRG/20120509_FDF_CRG_c12.mtb	1912	341	WWSS	food_sc	4	158536	1336712224	1	0.04	0.000173160173160173	3031	1
1	Drink 2	Intake 2	23	158784	1336712472	/users/cn/jespinosa/phecomp/data/CRG/20120502_FDF_CRG/20120502_FDF_CRG/20120509_FDF_CRG_c12.mtb	783	NA	WWSS	water	2	158761	1336712449	1	0.0600000000000001	0.00260869565217392	3032	1
1	Drink 2	Intake 2	20	159014	1336712702	/users/cn/jespinosa/phecomp/data/CRG/20120502_FDF_CRG/20120502_FDF_CRG/20120509_FDF_CRG_c12.mtb	784	NA	WWSS	water	2	158994	1336712682	1	0.02	0.001	3033	1
1	Food 2	Intake 4	181	159289	1336712977	/users/cn/jespinosa/phecomp/data/CRG/20120502_FDF_CRG/20120502_FDF_CRG/20120509_FDF_CRG_c12.mtb	1914	56	WWSS	food_sc	4	159108	1336712796	1	0.02	0.000110497237569061	3034	1
1	Food 2	Intake 4	163	159508	1336713196	/users/cn/jespinosa/phecomp/data/CRG/20120502_FDF_CRG/20120502_FDF_CRG/20120509_FDF_CRG_c12.mtb	1915	363	WWSS	food_sc	4	159345	1336713033	1	0.02	0.000122699386503067	3035	1
1	Drink 2	Intake 2	23	159526	1336713214	/users/cn/jespinosa/phecomp/data/CRG/20120502_FDF_CRG/20120502_FDF_CRG/20120509_FDF_CRG_c12.mtb	786	NA	WWSS	water	2	159503	1336713191	1	0.0600000000000001	0.00260869565217392	3036	1
1	Food 1	Intake 3	52	159923	1336713611	/users/cn/jespinosa/phecomp/data/CRG/20120502_FDF_CRG/20120502_FDF_CRG/20120509_FDF_CRG_c12.mtb	1465	248	WWSS	food_sc	3	159871	1336713559	1	0.02	0.000384615384615385	3037	1
1	Food 2	Intake 4	131	160302	1336713990	/users/cn/jespinosa/phecomp/data/CRG/20120502_FDF_CRG/20120502_FDF_CRG/20120509_FDF_CRG_c12.mtb	1920	407	WWSS	food_sc	4	160171	1336713859	1	0.04	0.000305343511450382	3038	1
1	Drink 2	Intake 2	38	160330	1336714018	/users/cn/jespinosa/phecomp/data/CRG/20120502_FDF_CRG/20120502_FDF_CRG/20120509_FDF_CRG_c12.mtb	788	NA	WWSS	water	2	160292	1336713980	1	0.0600000000000001	0.00157894736842106	3039	1
1	Food 2	Intake 4	205	160914	1336714602	/users/cn/jespinosa/phecomp/data/CRG/20120502_FDF_CRG/20120502_FDF_CRG/20120509_FDF_CRG_c12.mtb	1921	149	WWSS	food_sc	4	160709	1336714397	1	0.0600000000000001	0.000292682926829269	3040	1
1	Food 2	Intake 4	115	161178	1336714866	/users/cn/jespinosa/phecomp/data/CRG/20120502_FDF_CRG/20120502_FDF_CRG/20120509_FDF_CRG_c12.mtb	1923	267	WWSS	food_sc	4	161063	1336714751	1	0.04	0.000347826086956522	3041	1
1	Drink 2	Intake 2	36	161206	1336714894	/users/cn/jespinosa/phecomp/data/CRG/20120502_FDF_CRG/20120502_FDF_CRG/20120509_FDF_CRG_c12.mtb	789	NA	WWSS	water	2	161170	1336714858	1	0.1	0.00277777777777778	3042	1
1	Food 2	Intake 4	326	161771	1336715459	/users/cn/jespinosa/phecomp/data/CRG/20120502_FDF_CRG/20120502_FDF_CRG/20120509_FDF_CRG_c12.mtb	1924	28	WWSS	food_sc	4	161445	1336715133	1	0.04	0.000122699386503067	3043	1
1	Food 2	Intake 4	147	161946	1336715634	/users/cn/jespinosa/phecomp/data/CRG/20120502_FDF_CRG/20120502_FDF_CRG/20120509_FDF_CRG_c12.mtb	1925	119	WWSS	food_sc	4	161799	1336715487	1	0.04	0.000272108843537415	3044	1
1	Food 2	Intake 4	285	162350	1336716038	/users/cn/jespinosa/phecomp/data/CRG/20120502_FDF_CRG/20120502_FDF_CRG/20120509_FDF_CRG_c12.mtb	1927	189	WWSS	food_sc	4	162065	1336715753	1	0.0200000000000005	7.0175438596493e-05	3045	1
1	Drink 2	Intake 2	16	162539	1336716227	/users/cn/jespinosa/phecomp/data/CRG/20120502_FDF_CRG/20120502_FDF_CRG/20120509_FDF_CRG_c12.mtb	791	NA	WWSS	water	2	162523	1336716211	1	0.0200000000000005	0.00125000000000003	3046	1
1	Food 2	Intake 4	347	162886	1336716574	/users/cn/jespinosa/phecomp/data/CRG/20120502_FDF_CRG/20120502_FDF_CRG/20120509_FDF_CRG_c12.mtb	1929	251	WWSS	food_sc	4	162539	1336716227	1	0.0599999999999996	0.000172910662824206	3047	1
1	Drink 2	Intake 2	24	162906	1336716594	/users/cn/jespinosa/phecomp/data/CRG/20120502_FDF_CRG/20120502_FDF_CRG/20120509_FDF_CRG_c12.mtb	792	NA	WWSS	water	2	162882	1336716570	1	0.04	0.00166666666666667	3048	1
1	Drink 2	Intake 2	33	162985	1336716673	/users/cn/jespinosa/phecomp/data/CRG/20120502_FDF_CRG/20120502_FDF_CRG/20120509_FDF_CRG_c12.mtb	793	NA	WWSS	water	2	162952	1336716640	1	0.0799999999999996	0.00242424242424241	3049	1
1	Food 2	Intake 4	295	163432	1336717120	/users/cn/jespinosa/phecomp/data/CRG/20120502_FDF_CRG/20120502_FDF_CRG/20120509_FDF_CRG_c12.mtb	1930	4675	WWSS	food_sc	4	163137	1336716825	1	0.04	0.000135593220338983	3050	1
1	Food 2	Intake 4	25	168132	1336721820	/users/cn/jespinosa/phecomp/data/CRG/20120502_FDF_CRG/20120502_FDF_CRG/20120509_FDF_CRG_c12.mtb	1931	9	WWSS	food_sc	4	168107	1336721795	1	0.02	0.0008	3051	1
1	Food 2	Intake 4	29	168170	1336721858	/users/cn/jespinosa/phecomp/data/CRG/20120502_FDF_CRG/20120502_FDF_CRG/20120509_FDF_CRG_c12.mtb	1932	30	WWSS	food_sc	4	168141	1336721829	1	0.02	0.000689655172413793	3052	1
1	Food 2	Intake 4	23	168223	1336721911	/users/cn/jespinosa/phecomp/data/CRG/20120502_FDF_CRG/20120502_FDF_CRG/20120509_FDF_CRG_c12.mtb	1933	32	WWSS	food_sc	4	168200	1336721888	1	0.02	0.000869565217391304	3053	1
1	Food 2	Intake 4	28	168283	1336721971	/users/cn/jespinosa/phecomp/data/CRG/20120502_FDF_CRG/20120502_FDF_CRG/20120509_FDF_CRG_c12.mtb	1934	15635	WWSS	food_sc	4	168255	1336721943	1	0.02	0.000714285714285714	3054	1
1	Drink 1	Intake 1	28	168980	1336722668	/users/cn/jespinosa/phecomp/data/CRG/20120502_FDF_CRG/20120502_FDF_CRG/20120509_FDF_CRG_c12.mtb	1782	NA	WWSS	water	1	168952	1336722640	1	0.02	0.000714285714285714	3055	1
1	Drink 1	Intake 1	33	542	1336731407	/users/cn/jespinosa/phecomp/data/CRG/20120502_FDF_CRG/20120502_FDF_CRG/20120511_FDF_CRG_c12.mtb	1936	NA	WWSS	water	1	509	1336731374	1	0.02	0.000606060606060606	3056	1
1	Food 1	Intake 3	71	6812	1336737677	/users/cn/jespinosa/phecomp/data/CRG/20120502_FDF_CRG/20120502_FDF_CRG/20120511_FDF_CRG_c12.mtb	1581	26	WWSS	food_sc	3	6741	1336737606	1	0.06	0.000845070422535211	3057	1
1	Food 1	Intake 3	38	6876	1336737741	/users/cn/jespinosa/phecomp/data/CRG/20120502_FDF_CRG/20120502_FDF_CRG/20120511_FDF_CRG_c12.mtb	1582	192	WWSS	food_sc	3	6838	1336737703	1	0.04	0.00105263157894737	3058	1
1	Food 2	Intake 4	30	7098	1336737963	/users/cn/jespinosa/phecomp/data/CRG/20120502_FDF_CRG/20120502_FDF_CRG/20120511_FDF_CRG_c12.mtb	2207	1192	WWSS	food_sc	4	7068	1336737933	1	0.02	0.000666666666666667	3059	1
1	Food 2	Intake 4	24	8314	1336739179	/users/cn/jespinosa/phecomp/data/CRG/20120502_FDF_CRG/20120502_FDF_CRG/20120511_FDF_CRG_c12.mtb	2208	COLL	WWSS	food_sc	4	8290	1336739155	1	0.02	0.000833333333333333	3060	1
1	Food 1	Intake 3	154	8457	1336739322	/users/cn/jespinosa/phecomp/data/CRG/20120502_FDF_CRG/20120502_FDF_CRG/20120511_FDF_CRG_c12.mtb	1583	1408	WWSS	food_sc	3	8303	1336739168	1	0.08	0.000519480519480519	3061	1
1	Drink 2	Intake 2	21	8478	1336739343	/users/cn/jespinosa/phecomp/data/CRG/20120502_FDF_CRG/20120502_FDF_CRG/20120511_FDF_CRG_c12.mtb	860	NA	WWSS	water	2	8457	1336739322	1	0.04	0.0019047619047619	3062	1
1	Food 1	Intake 3	73	9938	1336740803	/users/cn/jespinosa/phecomp/data/CRG/20120502_FDF_CRG/20120502_FDF_CRG/20120511_FDF_CRG_c12.mtb	1584	7824	WWSS	food_sc	3	9865	1336740730	1	0.02	0.000273972602739726	3063	1
1	Drink 2	Intake 2	30	10147	1336741012	/users/cn/jespinosa/phecomp/data/CRG/20120502_FDF_CRG/20120502_FDF_CRG/20120511_FDF_CRG_c12.mtb	861	NA	WWSS	water	2	10117	1336740982	1	0.02	0.000666666666666667	3064	1
1	Drink 2	Intake 2	17	10436	1336741301	/users/cn/jespinosa/phecomp/data/CRG/20120502_FDF_CRG/20120502_FDF_CRG/20120511_FDF_CRG_c12.mtb	862	NA	WWSS	water	2	10419	1336741284	1	0.04	0.00235294117647059	3065	1
1	Drink 2	Intake 2	22	10496	1336741361	/users/cn/jespinosa/phecomp/data/CRG/20120502_FDF_CRG/20120502_FDF_CRG/20120511_FDF_CRG_c12.mtb	863	NA	WWSS	water	2	10474	1336741339	1	0.02	0.000909090909090909	3066	1
1	Drink 2	Intake 2	16	10545	1336741410	/users/cn/jespinosa/phecomp/data/CRG/20120502_FDF_CRG/20120502_FDF_CRG/20120511_FDF_CRG_c12.mtb	864	NA	WWSS	water	2	10529	1336741394	1	0.02	0.00125	3067	1
1	Food 2	Intake 4	16	17778	1336748643	/users/cn/jespinosa/phecomp/data/CRG/20120502_FDF_CRG/20120502_FDF_CRG/20120511_FDF_CRG_c12.mtb	2210	22	WWSS	food_sc	4	17762	1336748627	1	0.02	0.00125	3068	1
1	Food 2	Intake 4	9	17809	1336748674	/users/cn/jespinosa/phecomp/data/CRG/20120502_FDF_CRG/20120502_FDF_CRG/20120511_FDF_CRG_c12.mtb	2211	17	WWSS	food_sc	4	17800	1336748665	1	0.02	0.00222222222222222	3069	1
1	Food 2	Intake 4	72	17898	1336748763	/users/cn/jespinosa/phecomp/data/CRG/20120502_FDF_CRG/20120502_FDF_CRG/20120511_FDF_CRG_c12.mtb	2212	25	WWSS	food_sc	4	17826	1336748691	1	0.08	0.00111111111111111	3070	1
1	Food 2	Intake 4	36	17959	1336748824	/users/cn/jespinosa/phecomp/data/CRG/20120502_FDF_CRG/20120502_FDF_CRG/20120511_FDF_CRG_c12.mtb	2213	6824	WWSS	food_sc	4	17923	1336748788	1	0.02	0.000555555555555556	3071	1
1	Food 2	Intake 4	22	24805	1336755670	/users/cn/jespinosa/phecomp/data/CRG/20120502_FDF_CRG/20120502_FDF_CRG/20120511_FDF_CRG_c12.mtb	2214	2288	WWSS	food_sc	4	24783	1336755648	1	0.02	0.000909090909090909	3072	1
1	Food 2	Intake 4	9	27102	1336757967	/users/cn/jespinosa/phecomp/data/CRG/20120502_FDF_CRG/20120502_FDF_CRG/20120511_FDF_CRG_c12.mtb	2215	11	WWSS	food_sc	4	27093	1336757958	1	0.02	0.00222222222222222	3073	1
1	Food 2	Intake 4	122	27235	1336758100	/users/cn/jespinosa/phecomp/data/CRG/20120502_FDF_CRG/20120502_FDF_CRG/20120511_FDF_CRG_c12.mtb	2216	13	WWSS	food_sc	4	27113	1336757978	1	0.14	0.00114754098360656	3074	1
1	Food 2	Intake 4	18	27266	1336758131	/users/cn/jespinosa/phecomp/data/CRG/20120502_FDF_CRG/20120502_FDF_CRG/20120511_FDF_CRG_c12.mtb	2217	3059	WWSS	food_sc	4	27248	1336758113	1	0.02	0.00111111111111111	3075	1
1	Food 1	Intake 3	116	30441	1336761306	/users/cn/jespinosa/phecomp/data/CRG/20120502_FDF_CRG/20120502_FDF_CRG/20120511_FDF_CRG_c12.mtb	1586	37	WWSS	food_sc	3	30325	1336761190	1	0.12	0.00103448275862069	3076	1
1	Food 1	Intake 3	90	30568	1336761433	/users/cn/jespinosa/phecomp/data/CRG/20120502_FDF_CRG/20120502_FDF_CRG/20120511_FDF_CRG_c12.mtb	1587	1631	WWSS	food_sc	3	30478	1336761343	1	0.06	0.000666666666666667	3077	1
1	Drink 2	Intake 2	18	31734	1336762599	/users/cn/jespinosa/phecomp/data/CRG/20120502_FDF_CRG/20120502_FDF_CRG/20120511_FDF_CRG_c12.mtb	865	NA	WWSS	water	2	31716	1336762581	1	0.04	0.00222222222222222	3078	1
1	Food 1	Intake 3	25	32224	1336763089	/users/cn/jespinosa/phecomp/data/CRG/20120502_FDF_CRG/20120502_FDF_CRG/20120511_FDF_CRG_c12.mtb	1588	20	WWSS	food_sc	3	32199	1336763064	1	0.02	0.0008	3079	1
1	Food 1	Intake 3	63	32307	1336763172	/users/cn/jespinosa/phecomp/data/CRG/20120502_FDF_CRG/20120502_FDF_CRG/20120511_FDF_CRG_c12.mtb	1589	106	WWSS	food_sc	3	32244	1336763109	1	0.02	0.000317460317460317	3080	1
1	Food 1	Intake 3	27	32440	1336763305	/users/cn/jespinosa/phecomp/data/CRG/20120502_FDF_CRG/20120502_FDF_CRG/20120511_FDF_CRG_c12.mtb	1590	39	WWSS	food_sc	3	32413	1336763278	1	0.02	0.000740740740740741	3081	1
1	Food 2	Intake 4	119	32598	1336763463	/users/cn/jespinosa/phecomp/data/CRG/20120502_FDF_CRG/20120502_FDF_CRG/20120511_FDF_CRG_c12.mtb	2221	COLL	WWSS	food_sc	4	32479	1336763344	1	0.02	0.000168067226890756	3082	1
1	Food 1	Intake 3	51	32636	1336763501	/users/cn/jespinosa/phecomp/data/CRG/20120502_FDF_CRG/20120502_FDF_CRG/20120511_FDF_CRG_c12.mtb	1591	COLL	WWSS	food_sc	3	32585	1336763450	1	0.02	0.000392156862745098	3083	1
1	Food 2	Intake 4	78	32681	1336763546	/users/cn/jespinosa/phecomp/data/CRG/20120502_FDF_CRG/20120502_FDF_CRG/20120511_FDF_CRG_c12.mtb	2222	2523	WWSS	food_sc	4	32603	1336763468	1	0.02	0.000256410256410256	3084	1
1	Drink 2	Intake 2	20	32693	1336763558	/users/cn/jespinosa/phecomp/data/CRG/20120502_FDF_CRG/20120502_FDF_CRG/20120511_FDF_CRG_c12.mtb	866	NA	WWSS	water	2	32673	1336763538	1	0.04	0.002	3085	1
1	Drink 2	Intake 2	14	33448	1336764313	/users/cn/jespinosa/phecomp/data/CRG/20120502_FDF_CRG/20120502_FDF_CRG/20120511_FDF_CRG_c12.mtb	867	NA	WWSS	water	2	33434	1336764299	1	0.06	0.00428571428571429	3086	1
1	Food 2	Intake 4	101	35305	1336766170	/users/cn/jespinosa/phecomp/data/CRG/20120502_FDF_CRG/20120502_FDF_CRG/20120511_FDF_CRG_c12.mtb	2225	COLL	WWSS	food_sc	4	35204	1336766069	1	0.02	0.000198019801980198	3087	1
1	Food 1	Intake 3	38	35330	1336766195	/users/cn/jespinosa/phecomp/data/CRG/20120502_FDF_CRG/20120502_FDF_CRG/20120511_FDF_CRG_c12.mtb	1592	27	WWSS	food_sc	3	35292	1336766157	1	0.02	0.000526315789473684	3088	1
1	Food 1	Intake 3	17	35374	1336766239	/users/cn/jespinosa/phecomp/data/CRG/20120502_FDF_CRG/20120502_FDF_CRG/20120511_FDF_CRG_c12.mtb	1593	COLL	WWSS	food_sc	3	35357	1336766222	1	0.02	0.00117647058823529	3089	1
1	Food 2	Intake 4	213	35582	1336766447	/users/cn/jespinosa/phecomp/data/CRG/20120502_FDF_CRG/20120502_FDF_CRG/20120511_FDF_CRG_c12.mtb	2226	65	WWSS	food_sc	4	35369	1336766234	1	0.1	0.000469483568075117	3090	1
1	Drink 1	Intake 1	28	35601	1336766466	/users/cn/jespinosa/phecomp/data/CRG/20120502_FDF_CRG/20120502_FDF_CRG/20120511_FDF_CRG_c12.mtb	1943	NA	WWSS	water	1	35573	1336766438	1	0.04	0.00142857142857143	3091	1
1	Food 2	Intake 4	144	35791	1336766656	/users/cn/jespinosa/phecomp/data/CRG/20120502_FDF_CRG/20120502_FDF_CRG/20120511_FDF_CRG_c12.mtb	2227	534	WWSS	food_sc	4	35647	1336766512	1	0.02	0.000138888888888889	3092	1
1	Drink 2	Intake 2	18	35830	1336766695	/users/cn/jespinosa/phecomp/data/CRG/20120502_FDF_CRG/20120502_FDF_CRG/20120511_FDF_CRG_c12.mtb	869	NA	WWSS	water	2	35812	1336766677	1	0.02	0.00111111111111111	3093	1
1	Drink 2	Intake 2	28	35979	1336766844	/users/cn/jespinosa/phecomp/data/CRG/20120502_FDF_CRG/20120502_FDF_CRG/20120511_FDF_CRG_c12.mtb	870	NA	WWSS	water	2	35951	1336766816	1	0.1	0.00357142857142857	3094	1
1	Food 2	Intake 4	73	36398	1336767263	/users/cn/jespinosa/phecomp/data/CRG/20120502_FDF_CRG/20120502_FDF_CRG/20120511_FDF_CRG_c12.mtb	2229	312	WWSS	food_sc	4	36325	1336767190	1	0.04	0.000547945205479452	3095	1
1	Drink 2	Intake 2	27	36419	1336767284	/users/cn/jespinosa/phecomp/data/CRG/20120502_FDF_CRG/20120502_FDF_CRG/20120511_FDF_CRG_c12.mtb	871	NA	WWSS	water	2	36392	1336767257	1	0.08	0.00296296296296296	3096	1
1	Food 2	Intake 4	97	36807	1336767672	/users/cn/jespinosa/phecomp/data/CRG/20120502_FDF_CRG/20120502_FDF_CRG/20120511_FDF_CRG_c12.mtb	2231	2833	WWSS	food_sc	4	36710	1336767575	1	0.02	0.000206185567010309	3097	1
1	Food 2	Intake 4	51	39691	1336770556	/users/cn/jespinosa/phecomp/data/CRG/20120502_FDF_CRG/20120502_FDF_CRG/20120511_FDF_CRG_c12.mtb	2232	15	WWSS	food_sc	4	39640	1336770505	1	0.02	0.000392156862745098	3098	1
1	Food 2	Intake 4	28	39734	1336770599	/users/cn/jespinosa/phecomp/data/CRG/20120502_FDF_CRG/20120502_FDF_CRG/20120511_FDF_CRG_c12.mtb	2233	25	WWSS	food_sc	4	39706	1336770571	1	0.02	0.000714285714285714	3099	1
1	Food 2	Intake 4	41	39800	1336770665	/users/cn/jespinosa/phecomp/data/CRG/20120502_FDF_CRG/20120502_FDF_CRG/20120511_FDF_CRG_c12.mtb	2234	49	WWSS	food_sc	4	39759	1336770624	1	0.0399999999999999	0.000975609756097558	3100	1
1	Food 2	Intake 4	88	39937	1336770802	/users/cn/jespinosa/phecomp/data/CRG/20120502_FDF_CRG/20120502_FDF_CRG/20120511_FDF_CRG_c12.mtb	2235	2180	WWSS	food_sc	4	39849	1336770714	1	0.04	0.000454545454545455	3101	1
1	Drink 2	Intake 2	16	39956	1336770821	/users/cn/jespinosa/phecomp/data/CRG/20120502_FDF_CRG/20120502_FDF_CRG/20120511_FDF_CRG_c12.mtb	872	NA	WWSS	water	2	39940	1336770805	1	0.02	0.00125	3102	1
1	Food 2	Intake 4	88	42205	1336773070	/users/cn/jespinosa/phecomp/data/CRG/20120502_FDF_CRG/20120502_FDF_CRG/20120511_FDF_CRG_c12.mtb	2236	627	WWSS	food_sc	4	42117	1336772982	1	0.0599999999999999	0.000681818181818181	3103	1
1	Food 2	Intake 4	100	42932	1336773797	/users/cn/jespinosa/phecomp/data/CRG/20120502_FDF_CRG/20120502_FDF_CRG/20120511_FDF_CRG_c12.mtb	2238	22	WWSS	food_sc	4	42832	1336773697	1	0.04	0.0004	3104	1
1	Food 2	Intake 4	36	42990	1336773855	/users/cn/jespinosa/phecomp/data/CRG/20120502_FDF_CRG/20120502_FDF_CRG/20120511_FDF_CRG_c12.mtb	2239	20	WWSS	food_sc	4	42954	1336773819	1	0.04	0.00111111111111111	3105	1
1	Food 2	Intake 4	65	43075	1336773940	/users/cn/jespinosa/phecomp/data/CRG/20120502_FDF_CRG/20120502_FDF_CRG/20120511_FDF_CRG_c12.mtb	2240	15	WWSS	food_sc	4	43010	1336773875	1	0.0399999999999999	0.000615384615384614	3106	1
1	Food 2	Intake 4	77	43167	1336774032	/users/cn/jespinosa/phecomp/data/CRG/20120502_FDF_CRG/20120502_FDF_CRG/20120511_FDF_CRG_c12.mtb	2241	99	WWSS	food_sc	4	43090	1336773955	1	0.04	0.000519480519480519	3107	1
1	Drink 2	Intake 2	9	43179	1336774044	/users/cn/jespinosa/phecomp/data/CRG/20120502_FDF_CRG/20120502_FDF_CRG/20120511_FDF_CRG_c12.mtb	873	NA	WWSS	water	2	43170	1336774035	1	0.02	0.00222222222222222	3108	1
1	Food 1	Intake 3	52	43318	1336774183	/users/cn/jespinosa/phecomp/data/CRG/20120502_FDF_CRG/20120502_FDF_CRG/20120511_FDF_CRG_c12.mtb	1599	COLL	WWSS	food_sc	3	43266	1336774131	1	0.02	0.000384615384615385	3109	1
1	Food 2	Intake 4	93	43399	1336774264	/users/cn/jespinosa/phecomp/data/CRG/20120502_FDF_CRG/20120502_FDF_CRG/20120511_FDF_CRG_c12.mtb	2244	80	WWSS	food_sc	4	43306	1336774171	1	0.02	0.00021505376344086	3110	1
1	Drink 2	Intake 2	21	43420	1336774285	/users/cn/jespinosa/phecomp/data/CRG/20120502_FDF_CRG/20120502_FDF_CRG/20120511_FDF_CRG_c12.mtb	874	NA	WWSS	water	2	43399	1336774264	1	0.0599999999999999	0.00285714285714285	3111	1
1	Food 2	Intake 4	196	43675	1336774540	/users/cn/jespinosa/phecomp/data/CRG/20120502_FDF_CRG/20120502_FDF_CRG/20120511_FDF_CRG_c12.mtb	2245	169	WWSS	food_sc	4	43479	1336774344	1	0.04	0.000204081632653061	3112	1
1	Drink 1	Intake 1	15	43750	1336774615	/users/cn/jespinosa/phecomp/data/CRG/20120502_FDF_CRG/20120502_FDF_CRG/20120511_FDF_CRG_c12.mtb	1946	NA	WWSS	water	1	43735	1336774600	1	0.04	0.00266666666666667	3113	1
1	Drink 2	Intake 2	16	43758	1336774623	/users/cn/jespinosa/phecomp/data/CRG/20120502_FDF_CRG/20120502_FDF_CRG/20120511_FDF_CRG_c12.mtb	875	NA	WWSS	water	2	43742	1336774607	1	0.02	0.00125	3114	1
1	Food 2	Intake 4	102	43946	1336774811	/users/cn/jespinosa/phecomp/data/CRG/20120502_FDF_CRG/20120502_FDF_CRG/20120511_FDF_CRG_c12.mtb	2247	640	WWSS	food_sc	4	43844	1336774709	1	0.04	0.000392156862745098	3115	1
1	Drink 2	Intake 2	33	43972	1336774837	/users/cn/jespinosa/phecomp/data/CRG/20120502_FDF_CRG/20120502_FDF_CRG/20120511_FDF_CRG_c12.mtb	876	NA	WWSS	water	2	43939	1336774804	1	0.0600000000000001	0.00181818181818182	3116	1
1	Food 2	Intake 4	184	44770	1336775635	/users/cn/jespinosa/phecomp/data/CRG/20120502_FDF_CRG/20120502_FDF_CRG/20120511_FDF_CRG_c12.mtb	2249	73	WWSS	food_sc	4	44586	1336775451	1	0.04	0.000217391304347826	3117	1
1	Drink 1	Intake 1	19	44785	1336775650	/users/cn/jespinosa/phecomp/data/CRG/20120502_FDF_CRG/20120502_FDF_CRG/20120511_FDF_CRG_c12.mtb	1948	NA	WWSS	water	1	44766	1336775631	1	0.04	0.00210526315789474	3118	1
1	Food 2	Intake 4	104	44947	1336775812	/users/cn/jespinosa/phecomp/data/CRG/20120502_FDF_CRG/20120502_FDF_CRG/20120511_FDF_CRG_c12.mtb	2250	42	WWSS	food_sc	4	44843	1336775708	1	0.0399999999999998	0.000384615384615383	3119	1
1	Food 2	Intake 4	127	45116	1336775981	/users/cn/jespinosa/phecomp/data/CRG/20120502_FDF_CRG/20120502_FDF_CRG/20120511_FDF_CRG_c12.mtb	2251	482	WWSS	food_sc	4	44989	1336775854	1	0.04	0.00031496062992126	3120	1
1	Drink 1	Intake 1	26	45156	1336776021	/users/cn/jespinosa/phecomp/data/CRG/20120502_FDF_CRG/20120502_FDF_CRG/20120511_FDF_CRG_c12.mtb	1950	NA	WWSS	water	1	45130	1336775995	1	0.06	0.00230769230769231	3121	1
1	Food 2	Intake 4	131	45729	1336776594	/users/cn/jespinosa/phecomp/data/CRG/20120502_FDF_CRG/20120502_FDF_CRG/20120511_FDF_CRG_c12.mtb	2253	79	WWSS	food_sc	4	45598	1336776463	1	0.02	0.000152671755725191	3122	1
1	Drink 2	Intake 2	26	45752	1336776617	/users/cn/jespinosa/phecomp/data/CRG/20120502_FDF_CRG/20120502_FDF_CRG/20120511_FDF_CRG_c12.mtb	879	NA	WWSS	water	2	45726	1336776591	1	0.0599999999999999	0.0023076923076923	3123	1
1	Food 2	Intake 4	183	45991	1336776856	/users/cn/jespinosa/phecomp/data/CRG/20120502_FDF_CRG/20120502_FDF_CRG/20120511_FDF_CRG_c12.mtb	2254	502	WWSS	food_sc	4	45808	1336776673	1	0.04	0.000218579234972678	3124	1
1	Drink 2	Intake 2	20	46238	1336777103	/users/cn/jespinosa/phecomp/data/CRG/20120502_FDF_CRG/20120502_FDF_CRG/20120511_FDF_CRG_c12.mtb	880	NA	WWSS	water	2	46218	1336777083	1	0.0600000000000001	0.00300000000000001	3125	1
1	Food 2	Intake 4	16	46509	1336777374	/users/cn/jespinosa/phecomp/data/CRG/20120502_FDF_CRG/20120502_FDF_CRG/20120511_FDF_CRG_c12.mtb	2255	438	WWSS	food_sc	4	46493	1336777358	1	0.02	0.00125	3126	1
1	Food 2	Intake 4	260	47207	1336778072	/users/cn/jespinosa/phecomp/data/CRG/20120502_FDF_CRG/20120502_FDF_CRG/20120511_FDF_CRG_c12.mtb	2257	972	WWSS	food_sc	4	46947	1336777812	1	0.0799999999999998	0.000307692307692307	3127	1
1	Food 2	Intake 4	186	48365	1336779230	/users/cn/jespinosa/phecomp/data/CRG/20120502_FDF_CRG/20120502_FDF_CRG/20120511_FDF_CRG_c12.mtb	2258	1929	WWSS	food_sc	4	48179	1336779044	1	0.04	0.00021505376344086	3128	1
1	Food 2	Intake 4	50	50344	1336781209	/users/cn/jespinosa/phecomp/data/CRG/20120502_FDF_CRG/20120502_FDF_CRG/20120511_FDF_CRG_c12.mtb	2259	2702	WWSS	food_sc	4	50294	1336781159	1	0.04	0.0008	3129	1
1	Food 2	Intake 4	35	53081	1336783946	/users/cn/jespinosa/phecomp/data/CRG/20120502_FDF_CRG/20120502_FDF_CRG/20120511_FDF_CRG_c12.mtb	2260	35	WWSS	food_sc	4	53046	1336783911	1	0.02	0.000571428571428571	3130	1
1	Food 2	Intake 4	42	53158	1336784023	/users/cn/jespinosa/phecomp/data/CRG/20120502_FDF_CRG/20120502_FDF_CRG/20120511_FDF_CRG_c12.mtb	2261	2952	WWSS	food_sc	4	53116	1336783981	1	0.02	0.000476190476190476	3131	1
1	Food 2	Intake 4	73	56183	1336787048	/users/cn/jespinosa/phecomp/data/CRG/20120502_FDF_CRG/20120502_FDF_CRG/20120511_FDF_CRG_c12.mtb	2262	8	WWSS	food_sc	4	56110	1336786975	1	0.04	0.000547945205479452	3132	1
1	Food 2	Intake 4	44	56235	1336787100	/users/cn/jespinosa/phecomp/data/CRG/20120502_FDF_CRG/20120502_FDF_CRG/20120511_FDF_CRG_c12.mtb	2263	33	WWSS	food_sc	4	56191	1336787056	1	0.04	0.000909090909090909	3133	1
1	Food 2	Intake 4	170	56438	1336787303	/users/cn/jespinosa/phecomp/data/CRG/20120502_FDF_CRG/20120502_FDF_CRG/20120511_FDF_CRG_c12.mtb	2264	120	WWSS	food_sc	4	56268	1336787133	1	0.0800000000000001	0.000470588235294118	3134	1
1	Drink 2	Intake 2	17	56456	1336787321	/users/cn/jespinosa/phecomp/data/CRG/20120502_FDF_CRG/20120502_FDF_CRG/20120511_FDF_CRG_c12.mtb	881	NA	WWSS	water	2	56439	1336787304	1	0.02	0.00117647058823529	3135	1
1	Food 2	Intake 4	115	56673	1336787538	/users/cn/jespinosa/phecomp/data/CRG/20120502_FDF_CRG/20120502_FDF_CRG/20120511_FDF_CRG_c12.mtb	2265	38	WWSS	food_sc	4	56558	1336787423	1	0.04	0.000347826086956522	3136	1
1	Drink 2	Intake 2	29	56702	1336787567	/users/cn/jespinosa/phecomp/data/CRG/20120502_FDF_CRG/20120502_FDF_CRG/20120511_FDF_CRG_c12.mtb	882	NA	WWSS	water	2	56673	1336787538	1	0.0399999999999999	0.00137931034482758	3137	1
1	Food 2	Intake 4	69	56780	1336787645	/users/cn/jespinosa/phecomp/data/CRG/20120502_FDF_CRG/20120502_FDF_CRG/20120511_FDF_CRG_c12.mtb	2266	481	WWSS	food_sc	4	56711	1336787576	1	0.0399999999999998	0.000579710144927533	3138	1
1	Drink 1	Intake 1	21	56797	1336787662	/users/cn/jespinosa/phecomp/data/CRG/20120502_FDF_CRG/20120502_FDF_CRG/20120511_FDF_CRG_c12.mtb	1953	NA	WWSS	water	1	56776	1336787641	1	0.04	0.0019047619047619	3139	1
1	Drink 1	Intake 1	17	56875	1336787740	/users/cn/jespinosa/phecomp/data/CRG/20120502_FDF_CRG/20120502_FDF_CRG/20120511_FDF_CRG_c12.mtb	1954	NA	WWSS	water	1	56858	1336787723	1	0.02	0.00117647058823529	3140	1
1	Drink 2	Intake 2	36	56905	1336787770	/users/cn/jespinosa/phecomp/data/CRG/20120502_FDF_CRG/20120502_FDF_CRG/20120511_FDF_CRG_c12.mtb	883	NA	WWSS	water	2	56869	1336787734	1	0.04	0.00111111111111111	3141	1
1	Drink 2	Intake 2	33	57066	1336787931	/users/cn/jespinosa/phecomp/data/CRG/20120502_FDF_CRG/20120502_FDF_CRG/20120511_FDF_CRG_c12.mtb	884	NA	WWSS	water	2	57033	1336787898	1	0.02	0.000606060606060606	3142	1
1	Drink 2	Intake 2	22	57218	1336788083	/users/cn/jespinosa/phecomp/data/CRG/20120502_FDF_CRG/20120502_FDF_CRG/20120511_FDF_CRG_c12.mtb	885	NA	WWSS	water	2	57196	1336788061	1	0.0599999999999999	0.00272727272727272	3143	1
1	Food 1	Intake 3	36	57297	1336788162	/users/cn/jespinosa/phecomp/data/CRG/20120502_FDF_CRG/20120502_FDF_CRG/20120511_FDF_CRG_c12.mtb	1606	COLL	WWSS	food_sc	3	57261	1336788126	1	0.02	0.000555555555555556	3144	1
1	Food 2	Intake 4	80	57362	1336788227	/users/cn/jespinosa/phecomp/data/CRG/20120502_FDF_CRG/20120502_FDF_CRG/20120511_FDF_CRG_c12.mtb	2268	COLL	WWSS	food_sc	4	57282	1336788147	1	0.02	0.00025	3145	1
1	Food 1	Intake 3	69	57418	1336788283	/users/cn/jespinosa/phecomp/data/CRG/20120502_FDF_CRG/20120502_FDF_CRG/20120511_FDF_CRG_c12.mtb	1608	4571	WWSS	food_sc	3	57349	1336788214	1	0.02	0.000289855072463768	3146	1
1	Drink 2	Intake 2	25	57496	1336788361	/users/cn/jespinosa/phecomp/data/CRG/20120502_FDF_CRG/20120502_FDF_CRG/20120511_FDF_CRG_c12.mtb	886	NA	WWSS	water	2	57471	1336788336	1	0.04	0.0016	3147	1
1	Food 1	Intake 3	121	62110	1336792975	/users/cn/jespinosa/phecomp/data/CRG/20120502_FDF_CRG/20120502_FDF_CRG/20120511_FDF_CRG_c12.mtb	1610	2400	WWSS	food_sc	3	61989	1336792854	1	0.0600000000000001	0.000495867768595042	3148	1
1	Food 1	Intake 3	194	64704	1336795569	/users/cn/jespinosa/phecomp/data/CRG/20120502_FDF_CRG/20120502_FDF_CRG/20120511_FDF_CRG_c12.mtb	1613	7	WWSS	food_sc	3	64510	1336795375	1	0.1	0.000515463917525773	3149	1
1	Food 1	Intake 3	107	64818	1336795683	/users/cn/jespinosa/phecomp/data/CRG/20120502_FDF_CRG/20120502_FDF_CRG/20120511_FDF_CRG_c12.mtb	1614	11	WWSS	food_sc	3	64711	1336795576	1	0.04	0.000373831775700935	3150	1
1	Food 2	Intake 4	65	64894	1336795759	/users/cn/jespinosa/phecomp/data/CRG/20120502_FDF_CRG/20120502_FDF_CRG/20120511_FDF_CRG_c12.mtb	2274	64	WWSS	food_sc	4	64829	1336795694	1	0.02	0.000307692307692308	3151	1
1	Food 2	Intake 4	72	65030	1336795895	/users/cn/jespinosa/phecomp/data/CRG/20120502_FDF_CRG/20120502_FDF_CRG/20120511_FDF_CRG_c12.mtb	2275	100	WWSS	food_sc	4	64958	1336795823	1	0.02	0.000277777777777778	3152	1
1	Drink 2	Intake 2	34	65056	1336795921	/users/cn/jespinosa/phecomp/data/CRG/20120502_FDF_CRG/20120502_FDF_CRG/20120511_FDF_CRG_c12.mtb	887	NA	WWSS	water	2	65022	1336795887	1	0.12	0.00352941176470588	3153	1
1	Drink 2	Intake 2	24	65098	1336795963	/users/cn/jespinosa/phecomp/data/CRG/20120502_FDF_CRG/20120502_FDF_CRG/20120511_FDF_CRG_c12.mtb	888	NA	WWSS	water	2	65074	1336795939	1	0.0599999999999998	0.00249999999999999	3154	1
1	Food 2	Intake 4	156	65286	1336796151	/users/cn/jespinosa/phecomp/data/CRG/20120502_FDF_CRG/20120502_FDF_CRG/20120511_FDF_CRG_c12.mtb	2277	95	WWSS	food_sc	4	65130	1336795995	1	0.02	0.000128205128205128	3155	1
1	Food 1	Intake 3	29	65410	1336796275	/users/cn/jespinosa/phecomp/data/CRG/20120502_FDF_CRG/20120502_FDF_CRG/20120511_FDF_CRG_c12.mtb	1621	29	WWSS	food_sc	3	65381	1336796246	1	0.02	0.000689655172413793	3156	1
1	Drink 1	Intake 1	19	65433	1336796298	/users/cn/jespinosa/phecomp/data/CRG/20120502_FDF_CRG/20120502_FDF_CRG/20120511_FDF_CRG_c12.mtb	1955	NA	WWSS	water	1	65414	1336796279	1	0.06	0.00315789473684211	3157	1
1	Food 1	Intake 3	116	65555	1336796420	/users/cn/jespinosa/phecomp/data/CRG/20120502_FDF_CRG/20120502_FDF_CRG/20120511_FDF_CRG_c12.mtb	1622	42	WWSS	food_sc	3	65439	1336796304	1	0.0399999999999999	0.000344827586206896	3158	1
1	Food 1	Intake 3	56	65653	1336796518	/users/cn/jespinosa/phecomp/data/CRG/20120502_FDF_CRG/20120502_FDF_CRG/20120511_FDF_CRG_c12.mtb	1623	COLL	WWSS	food_sc	3	65597	1336796462	1	0.02	0.000357142857142857	3159	1
1	Food 2	Intake 4	76	65715	1336796580	/users/cn/jespinosa/phecomp/data/CRG/20120502_FDF_CRG/20120502_FDF_CRG/20120511_FDF_CRG_c12.mtb	2281	579	WWSS	food_sc	4	65639	1336796504	1	0.04	0.000526315789473684	3160	1
1	Drink 1	Intake 1	23	65735	1336796600	/users/cn/jespinosa/phecomp/data/CRG/20120502_FDF_CRG/20120502_FDF_CRG/20120511_FDF_CRG_c12.mtb	1956	NA	WWSS	water	1	65712	1336796577	1	0.06	0.00260869565217391	3161	1
1	Drink 2	Intake 2	32	66199	1336797064	/users/cn/jespinosa/phecomp/data/CRG/20120502_FDF_CRG/20120502_FDF_CRG/20120511_FDF_CRG_c12.mtb	889	NA	WWSS	water	2	66167	1336797032	1	0.1	0.003125	3162	1
1	Food 2	Intake 4	113	66407	1336797272	/users/cn/jespinosa/phecomp/data/CRG/20120502_FDF_CRG/20120502_FDF_CRG/20120511_FDF_CRG_c12.mtb	2285	70	WWSS	food_sc	4	66294	1336797159	1	0.0600000000000001	0.000530973451327435	3163	1
1	Food 1	Intake 3	142	66619	1336797484	/users/cn/jespinosa/phecomp/data/CRG/20120502_FDF_CRG/20120502_FDF_CRG/20120511_FDF_CRG_c12.mtb	1630	423	WWSS	food_sc	3	66477	1336797342	1	0.04	0.00028169014084507	3164	1
1	Drink 2	Intake 2	29	66681	1336797546	/users/cn/jespinosa/phecomp/data/CRG/20120502_FDF_CRG/20120502_FDF_CRG/20120511_FDF_CRG_c12.mtb	890	NA	WWSS	water	2	66652	1336797517	1	0.0799999999999998	0.00275862068965517	3165	1
1	Food 2	Intake 4	58	67100	1336797965	/users/cn/jespinosa/phecomp/data/CRG/20120502_FDF_CRG/20120502_FDF_CRG/20120511_FDF_CRG_c12.mtb	2292	286	WWSS	food_sc	4	67042	1336797907	1	0.04	0.000689655172413793	3166	1
1	Drink 2	Intake 2	29	67122	1336797987	/users/cn/jespinosa/phecomp/data/CRG/20120502_FDF_CRG/20120502_FDF_CRG/20120511_FDF_CRG_c12.mtb	891	NA	WWSS	water	2	67093	1336797958	1	0.0600000000000001	0.00206896551724138	3167	1
1	Food 1	Intake 3	29	67415	1336798280	/users/cn/jespinosa/phecomp/data/CRG/20120502_FDF_CRG/20120502_FDF_CRG/20120511_FDF_CRG_c12.mtb	1634	102	WWSS	food_sc	3	67386	1336798251	1	0.02	0.000689655172413793	3168	1
1	Food 2	Intake 4	247	67764	1336798629	/users/cn/jespinosa/phecomp/data/CRG/20120502_FDF_CRG/20120502_FDF_CRG/20120511_FDF_CRG_c12.mtb	2295	23	WWSS	food_sc	4	67517	1336798382	1	0.0600000000000001	0.000242914979757085	3169	1
1	Drink 1	Intake 1	28	67790	1336798655	/users/cn/jespinosa/phecomp/data/CRG/20120502_FDF_CRG/20120502_FDF_CRG/20120511_FDF_CRG_c12.mtb	1958	NA	WWSS	water	1	67762	1336798627	1	0.1	0.00357142857142857	3170	1
1	Food 2	Intake 4	83	67870	1336798735	/users/cn/jespinosa/phecomp/data/CRG/20120502_FDF_CRG/20120502_FDF_CRG/20120511_FDF_CRG_c12.mtb	2296	89	WWSS	food_sc	4	67787	1336798652	1	0.02	0.000240963855421687	3171	1
1	Food 1	Intake 3	81	68040	1336798905	/users/cn/jespinosa/phecomp/data/CRG/20120502_FDF_CRG/20120502_FDF_CRG/20120511_FDF_CRG_c12.mtb	1641	146	WWSS	food_sc	3	67959	1336798824	1	0.0399999999999999	0.000493827160493826	3172	1
1	Drink 2	Intake 2	28	68067	1336798932	/users/cn/jespinosa/phecomp/data/CRG/20120502_FDF_CRG/20120502_FDF_CRG/20120511_FDF_CRG_c12.mtb	892	NA	WWSS	water	2	68039	1336798904	1	0.04	0.00142857142857143	3173	1
1	Food 1	Intake 3	67	68253	1336799118	/users/cn/jespinosa/phecomp/data/CRG/20120502_FDF_CRG/20120502_FDF_CRG/20120511_FDF_CRG_c12.mtb	1643	COLL	WWSS	food_sc	3	68186	1336799051	1	0.02	0.000298507462686567	3174	1
1	Food 2	Intake 4	96	68337	1336799202	/users/cn/jespinosa/phecomp/data/CRG/20120502_FDF_CRG/20120502_FDF_CRG/20120511_FDF_CRG_c12.mtb	2300	147	WWSS	food_sc	4	68241	1336799106	1	0.04	0.000416666666666667	3175	1
1	Food 1	Intake 3	26	68510	1336799375	/users/cn/jespinosa/phecomp/data/CRG/20120502_FDF_CRG/20120502_FDF_CRG/20120511_FDF_CRG_c12.mtb	1645	165	WWSS	food_sc	3	68484	1336799349	1	0.02	0.000769230769230769	3176	1
1	Food 1	Intake 3	19	68694	1336799559	/users/cn/jespinosa/phecomp/data/CRG/20120502_FDF_CRG/20120502_FDF_CRG/20120511_FDF_CRG_c12.mtb	1649	112	WWSS	food_sc	3	68675	1336799540	1	0.02	0.00105263157894737	3177	1
1	Drink 2	Intake 2	28	68718	1336799583	/users/cn/jespinosa/phecomp/data/CRG/20120502_FDF_CRG/20120502_FDF_CRG/20120511_FDF_CRG_c12.mtb	893	NA	WWSS	water	2	68690	1336799555	1	0.0800000000000001	0.00285714285714286	3178	1
1	Food 2	Intake 4	166	68972	1336799837	/users/cn/jespinosa/phecomp/data/CRG/20120502_FDF_CRG/20120502_FDF_CRG/20120511_FDF_CRG_c12.mtb	2304	335	WWSS	food_sc	4	68806	1336799671	1	0.0600000000000001	0.000361445783132531	3179	1
1	Drink 2	Intake 2	18	69252	1336800117	/users/cn/jespinosa/phecomp/data/CRG/20120502_FDF_CRG/20120502_FDF_CRG/20120511_FDF_CRG_c12.mtb	894	NA	WWSS	water	2	69234	1336800099	1	0.04	0.00222222222222222	3180	1
1	Food 1	Intake 3	92	69399	1336800264	/users/cn/jespinosa/phecomp/data/CRG/20120502_FDF_CRG/20120502_FDF_CRG/20120511_FDF_CRG_c12.mtb	1656	54	WWSS	food_sc	3	69307	1336800172	1	0.02	0.000217391304347826	3181	1
1	Food 1	Intake 3	54	69507	1336800372	/users/cn/jespinosa/phecomp/data/CRG/20120502_FDF_CRG/20120502_FDF_CRG/20120511_FDF_CRG_c12.mtb	1658	58	WWSS	food_sc	3	69453	1336800318	1	0.02	0.00037037037037037	3182	1
1	Food 1	Intake 3	58	69623	1336800488	/users/cn/jespinosa/phecomp/data/CRG/20120502_FDF_CRG/20120502_FDF_CRG/20120511_FDF_CRG_c12.mtb	1659	COLL	WWSS	food_sc	3	69565	1336800430	1	0.02	0.000344827586206897	3183	1
1	Food 2	Intake 4	49	69659	1336800524	/users/cn/jespinosa/phecomp/data/CRG/20120502_FDF_CRG/20120502_FDF_CRG/20120511_FDF_CRG_c12.mtb	2316	96	WWSS	food_sc	4	69610	1336800475	1	0.02	0.000408163265306122	3184	1
1	Food 2	Intake 4	152	69907	1336800772	/users/cn/jespinosa/phecomp/data/CRG/20120502_FDF_CRG/20120502_FDF_CRG/20120511_FDF_CRG_c12.mtb	2317	146	WWSS	food_sc	4	69755	1336800620	1	0.0800000000000001	0.000526315789473685	3185	1
1	Drink 1	Intake 1	20	69978	1336800843	/users/cn/jespinosa/phecomp/data/CRG/20120502_FDF_CRG/20120502_FDF_CRG/20120511_FDF_CRG_c12.mtb	1959	NA	WWSS	water	1	69958	1336800823	1	0.04	0.002	3186	1
1	Food 2	Intake 4	139	70192	1336801057	/users/cn/jespinosa/phecomp/data/CRG/20120502_FDF_CRG/20120502_FDF_CRG/20120511_FDF_CRG_c12.mtb	2319	4	WWSS	food_sc	4	70053	1336800918	1	0.0599999999999996	0.00043165467625899	3187	1
1	Food 2	Intake 4	54	70250	1336801115	/users/cn/jespinosa/phecomp/data/CRG/20120502_FDF_CRG/20120502_FDF_CRG/20120511_FDF_CRG_c12.mtb	2320	363	WWSS	food_sc	4	70196	1336801061	1	0.02	0.00037037037037037	3188	1
1	Drink 2	Intake 2	25	70533	1336801398	/users/cn/jespinosa/phecomp/data/CRG/20120502_FDF_CRG/20120502_FDF_CRG/20120511_FDF_CRG_c12.mtb	896	NA	WWSS	water	2	70508	1336801373	1	0.04	0.0016	3189	1
1	Food 2	Intake 4	86	70699	1336801564	/users/cn/jespinosa/phecomp/data/CRG/20120502_FDF_CRG/20120502_FDF_CRG/20120511_FDF_CRG_c12.mtb	2326	COLL	WWSS	food_sc	4	70613	1336801478	1	0.02	0.000232558139534884	3190	1
1	Food 1	Intake 3	109	70796	1336801661	/users/cn/jespinosa/phecomp/data/CRG/20120502_FDF_CRG/20120502_FDF_CRG/20120511_FDF_CRG_c12.mtb	1672	65	WWSS	food_sc	3	70687	1336801552	1	0.04	0.00036697247706422	3191	1
1	Drink 2	Intake 2	28	70819	1336801684	/users/cn/jespinosa/phecomp/data/CRG/20120502_FDF_CRG/20120502_FDF_CRG/20120511_FDF_CRG_c12.mtb	897	NA	WWSS	water	2	70791	1336801656	1	0.04	0.00142857142857143	3192	1
1	Food 1	Intake 3	63	70924	1336801789	/users/cn/jespinosa/phecomp/data/CRG/20120502_FDF_CRG/20120502_FDF_CRG/20120511_FDF_CRG_c12.mtb	1673	55	WWSS	food_sc	3	70861	1336801726	1	0.02	0.000317460317460317	3193	1
1	Food 2	Intake 4	155	71134	1336801999	/users/cn/jespinosa/phecomp/data/CRG/20120502_FDF_CRG/20120502_FDF_CRG/20120511_FDF_CRG_c12.mtb	2330	9	WWSS	food_sc	4	70979	1336801844	1	0.0800000000000001	0.000516129032258065	3194	1
1	Food 1	Intake 3	60	71203	1336802068	/users/cn/jespinosa/phecomp/data/CRG/20120502_FDF_CRG/20120502_FDF_CRG/20120511_FDF_CRG_c12.mtb	1677	59	WWSS	food_sc	3	71143	1336802008	1	0.02	0.000333333333333333	3195	1
1	Food 1	Intake 3	91	71353	1336802218	/users/cn/jespinosa/phecomp/data/CRG/20120502_FDF_CRG/20120502_FDF_CRG/20120511_FDF_CRG_c12.mtb	1678	93	WWSS	food_sc	3	71262	1336802127	1	0.02	0.00021978021978022	3196	1
1	Food 2	Intake 4	30	71476	1336802341	/users/cn/jespinosa/phecomp/data/CRG/20120502_FDF_CRG/20120502_FDF_CRG/20120511_FDF_CRG_c12.mtb	2334	6	WWSS	food_sc	4	71446	1336802311	1	0.02	0.000666666666666667	3197	1
1	Food 2	Intake 4	23	71505	1336802370	/users/cn/jespinosa/phecomp/data/CRG/20120502_FDF_CRG/20120502_FDF_CRG/20120511_FDF_CRG_c12.mtb	2335	23	WWSS	food_sc	4	71482	1336802347	1	0.02	0.000869565217391304	3198	1
1	Food 1	Intake 3	118	71646	1336802511	/users/cn/jespinosa/phecomp/data/CRG/20120502_FDF_CRG/20120502_FDF_CRG/20120511_FDF_CRG_c12.mtb	1681	9	WWSS	food_sc	3	71528	1336802393	1	0.02	0.000169491525423729	3199	1
1	Food 1	Intake 3	80	71735	1336802600	/users/cn/jespinosa/phecomp/data/CRG/20120502_FDF_CRG/20120502_FDF_CRG/20120511_FDF_CRG_c12.mtb	1682	113	WWSS	food_sc	3	71655	1336802520	1	0.02	0.00025	3200	1
1	Food 1	Intake 3	110	71958	1336802823	/users/cn/jespinosa/phecomp/data/CRG/20120502_FDF_CRG/20120502_FDF_CRG/20120511_FDF_CRG_c12.mtb	1684	COLL	WWSS	food_sc	3	71848	1336802713	1	0.04	0.000363636363636364	3201	1
1	Food 2	Intake 4	51	71971	1336802836	/users/cn/jespinosa/phecomp/data/CRG/20120502_FDF_CRG/20120502_FDF_CRG/20120511_FDF_CRG_c12.mtb	2341	50	WWSS	food_sc	4	71920	1336802785	1	0.02	0.000392156862745098	3202	1
1	Drink 1	Intake 1	46	72022	1336802887	/users/cn/jespinosa/phecomp/data/CRG/20120502_FDF_CRG/20120502_FDF_CRG/20120511_FDF_CRG_c12.mtb	1960	NA	WWSS	water	1	71976	1336802841	1	0.08	0.00173913043478261	3203	1
1	Food 1	Intake 3	66	72087	1336802952	/users/cn/jespinosa/phecomp/data/CRG/20120502_FDF_CRG/20120502_FDF_CRG/20120511_FDF_CRG_c12.mtb	1685	COLL	WWSS	food_sc	3	72021	1336802886	1	0.02	0.000303030303030303	3204	1
1	Food 2	Intake 4	28	72068	1336802933	/users/cn/jespinosa/phecomp/data/CRG/20120502_FDF_CRG/20120502_FDF_CRG/20120511_FDF_CRG_c12.mtb	2342	25	WWSS	food_sc	4	72040	1336802905	1	0.02	0.000714285714285714	3205	1
1	Food 1	Intake 3	76	72169	1336803034	/users/cn/jespinosa/phecomp/data/CRG/20120502_FDF_CRG/20120502_FDF_CRG/20120511_FDF_CRG_c12.mtb	1686	45	WWSS	food_sc	3	72093	1336802958	1	0.04	0.000526315789473684	3206	1
1	Food 2	Intake 4	35	72249	1336803114	/users/cn/jespinosa/phecomp/data/CRG/20120502_FDF_CRG/20120502_FDF_CRG/20120511_FDF_CRG_c12.mtb	2346	41	WWSS	food_sc	4	72214	1336803079	1	0.02	0.000571428571428571	3207	1
1	Food 1	Intake 3	28	72318	1336803183	/users/cn/jespinosa/phecomp/data/CRG/20120502_FDF_CRG/20120502_FDF_CRG/20120511_FDF_CRG_c12.mtb	1688	60	WWSS	food_sc	3	72290	1336803155	1	0.02	0.000714285714285714	3208	1
1	Drink 2	Intake 2	21	72362	1336803227	/users/cn/jespinosa/phecomp/data/CRG/20120502_FDF_CRG/20120502_FDF_CRG/20120511_FDF_CRG_c12.mtb	898	NA	WWSS	water	2	72341	1336803206	1	0.0399999999999998	0.0019047619047619	3209	1
1	Food 1	Intake 3	31	72409	1336803274	/users/cn/jespinosa/phecomp/data/CRG/20120502_FDF_CRG/20120502_FDF_CRG/20120511_FDF_CRG_c12.mtb	1689	COLL	WWSS	food_sc	3	72378	1336803243	1	0.02	0.000645161290322581	3210	1
1	Food 2	Intake 4	86	72482	1336803347	/users/cn/jespinosa/phecomp/data/CRG/20120502_FDF_CRG/20120502_FDF_CRG/20120511_FDF_CRG_c12.mtb	2348	COLL	WWSS	food_sc	4	72396	1336803261	1	0.02	0.000232558139534884	3211	1
1	Food 1	Intake 3	99	72567	1336803432	/users/cn/jespinosa/phecomp/data/CRG/20120502_FDF_CRG/20120502_FDF_CRG/20120511_FDF_CRG_c12.mtb	1691	COLL	WWSS	food_sc	3	72468	1336803333	1	0.04	0.000404040404040404	3212	1
1	Food 2	Intake 4	57	72611	1336803476	/users/cn/jespinosa/phecomp/data/CRG/20120502_FDF_CRG/20120502_FDF_CRG/20120511_FDF_CRG_c12.mtb	2351	4	WWSS	food_sc	4	72554	1336803419	1	0.02	0.000350877192982456	3213	1
1	Food 2	Intake 4	52	72667	1336803532	/users/cn/jespinosa/phecomp/data/CRG/20120502_FDF_CRG/20120502_FDF_CRG/20120511_FDF_CRG_c12.mtb	2352	27	WWSS	food_sc	4	72615	1336803480	1	0.02	0.000384615384615385	3214	1
1	Food 2	Intake 4	102	72796	1336803661	/users/cn/jespinosa/phecomp/data/CRG/20120502_FDF_CRG/20120502_FDF_CRG/20120511_FDF_CRG_c12.mtb	2353	2	WWSS	food_sc	4	72694	1336803559	1	0.02	0.000196078431372549	3215	1
1	Food 1	Intake 3	128	72926	1336803791	/users/cn/jespinosa/phecomp/data/CRG/20120502_FDF_CRG/20120502_FDF_CRG/20120511_FDF_CRG_c12.mtb	1697	COLL	WWSS	food_sc	3	72798	1336803663	1	0.04	0.0003125	3216	1
1	Food 2	Intake 4	35	72848	1336803713	/users/cn/jespinosa/phecomp/data/CRG/20120502_FDF_CRG/20120502_FDF_CRG/20120511_FDF_CRG_c12.mtb	2354	4015	WWSS	food_sc	4	72813	1336803678	1	0.02	0.000571428571428571	3217	1
1	Drink 2	Intake 2	43	72963	1336803828	/users/cn/jespinosa/phecomp/data/CRG/20120502_FDF_CRG/20120502_FDF_CRG/20120511_FDF_CRG_c12.mtb	899	NA	WWSS	water	2	72920	1336803785	1	0.0800000000000001	0.00186046511627907	3218	1
1	Food 1	Intake 3	65	76928	1336807793	/users/cn/jespinosa/phecomp/data/CRG/20120502_FDF_CRG/20120502_FDF_CRG/20120511_FDF_CRG_c12.mtb	1698	COLL	WWSS	food_sc	3	76863	1336807728	1	0.04	0.000615384615384615	3219	1
1	Food 2	Intake 4	49	76917	1336807782	/users/cn/jespinosa/phecomp/data/CRG/20120502_FDF_CRG/20120502_FDF_CRG/20120511_FDF_CRG_c12.mtb	2356	110	WWSS	food_sc	4	76868	1336807733	1	0.02	0.000408163265306122	3220	1
1	Food 2	Intake 4	17	77044	1336807909	/users/cn/jespinosa/phecomp/data/CRG/20120502_FDF_CRG/20120502_FDF_CRG/20120511_FDF_CRG_c12.mtb	2357	320	WWSS	food_sc	4	77027	1336807892	1	0.02	0.00117647058823529	3221	1
1	Drink 2	Intake 2	25	77138	1336808003	/users/cn/jespinosa/phecomp/data/CRG/20120502_FDF_CRG/20120502_FDF_CRG/20120511_FDF_CRG_c12.mtb	901	NA	WWSS	water	2	77113	1336807978	1	0.0399999999999998	0.00159999999999999	3222	1
1	Food 1	Intake 3	135	77499	1336808364	/users/cn/jespinosa/phecomp/data/CRG/20120502_FDF_CRG/20120502_FDF_CRG/20120511_FDF_CRG_c12.mtb	1700	892	WWSS	food_sc	3	77364	1336808229	1	0.0600000000000001	0.000444444444444445	3223	1
1	Drink 2	Intake 2	13	77540	1336808405	/users/cn/jespinosa/phecomp/data/CRG/20120502_FDF_CRG/20120502_FDF_CRG/20120511_FDF_CRG_c12.mtb	902	NA	WWSS	water	2	77527	1336808392	1	0.04	0.00307692307692308	3224	1
1	Food 1	Intake 3	140	78531	1336809396	/users/cn/jespinosa/phecomp/data/CRG/20120502_FDF_CRG/20120502_FDF_CRG/20120511_FDF_CRG_c12.mtb	1702	COLL	WWSS	food_sc	3	78391	1336809256	1	0.02	0.000142857142857143	3225	1
1	Food 2	Intake 4	17	78538	1336809403	/users/cn/jespinosa/phecomp/data/CRG/20120502_FDF_CRG/20120502_FDF_CRG/20120511_FDF_CRG_c12.mtb	2361	8315	WWSS	food_sc	4	78521	1336809386	1	0.04	0.00235294117647059	3226	1
1	Drink 2	Intake 2	24	78595	1336809460	/users/cn/jespinosa/phecomp/data/CRG/20120502_FDF_CRG/20120502_FDF_CRG/20120511_FDF_CRG_c12.mtb	903	NA	WWSS	water	2	78571	1336809436	1	0.04	0.00166666666666667	3227	1
1	Food 2	Intake 4	30	86883	1336817748	/users/cn/jespinosa/phecomp/data/CRG/20120502_FDF_CRG/20120502_FDF_CRG/20120511_FDF_CRG_c12.mtb	2365	166	WWSS	food_sc	4	86853	1336817718	1	0.0200000000000005	0.000666666666666683	3228	1
1	Food 1	Intake 3	40	87089	1336817954	/users/cn/jespinosa/phecomp/data/CRG/20120502_FDF_CRG/20120502_FDF_CRG/20120511_FDF_CRG_c12.mtb	1704	33	WWSS	food_sc	3	87049	1336817914	1	0.02	0.0005	3229	1
1	Food 1	Intake 3	21	87143	1336818008	/users/cn/jespinosa/phecomp/data/CRG/20120502_FDF_CRG/20120502_FDF_CRG/20120511_FDF_CRG_c12.mtb	1706	9272	WWSS	food_sc	3	87122	1336817987	1	0.02	0.000952380952380952	3230	1
1	Drink 2	Intake 2	14	87328	1336818193	/users/cn/jespinosa/phecomp/data/CRG/20120502_FDF_CRG/20120502_FDF_CRG/20120511_FDF_CRG_c12.mtb	904	NA	WWSS	water	2	87314	1336818179	1	0.02	0.00142857142857143	3231	1
1	Food 2	Intake 4	23	96438	1336827303	/users/cn/jespinosa/phecomp/data/CRG/20120502_FDF_CRG/20120502_FDF_CRG/20120511_FDF_CRG_c12.mtb	2369	129	WWSS	food_sc	4	96415	1336827280	1	0.04	0.00173913043478261	3232	1
1	Food 2	Intake 4	16	96583	1336827448	/users/cn/jespinosa/phecomp/data/CRG/20120502_FDF_CRG/20120502_FDF_CRG/20120511_FDF_CRG_c12.mtb	2370	252	WWSS	food_sc	4	96567	1336827432	1	0.02	0.00125	3233	1
1	Food 2	Intake 4	25	96860	1336827725	/users/cn/jespinosa/phecomp/data/CRG/20120502_FDF_CRG/20120502_FDF_CRG/20120511_FDF_CRG_c12.mtb	2371	95	WWSS	food_sc	4	96835	1336827700	1	0.02	0.0008	3234	1
1	Food 1	Intake 3	36	96991	1336827856	/users/cn/jespinosa/phecomp/data/CRG/20120502_FDF_CRG/20120502_FDF_CRG/20120511_FDF_CRG_c12.mtb	1709	6136	WWSS	food_sc	3	96955	1336827820	1	0.02	0.000555555555555556	3235	1
1	Food 1	Intake 3	12	103139	1336834004	/users/cn/jespinosa/phecomp/data/CRG/20120502_FDF_CRG/20120502_FDF_CRG/20120511_FDF_CRG_c12.mtb	1711	808	WWSS	food_sc	3	103127	1336833992	1	0.02	0.00166666666666667	3236	1
1	Food 1	Intake 3	41	103988	1336834853	/users/cn/jespinosa/phecomp/data/CRG/20120502_FDF_CRG/20120502_FDF_CRG/20120511_FDF_CRG_c12.mtb	1713	1869	WWSS	food_sc	3	103947	1336834812	1	0.02	0.00048780487804878	3237	1
1	Food 1	Intake 3	57	105914	1336836779	/users/cn/jespinosa/phecomp/data/CRG/20120502_FDF_CRG/20120502_FDF_CRG/20120511_FDF_CRG_c12.mtb	1715	8025	WWSS	food_sc	3	105857	1336836722	1	0.04	0.000701754385964912	3238	1
1	Food 2	Intake 4	16	113955	1336844820	/users/cn/jespinosa/phecomp/data/CRG/20120502_FDF_CRG/20120502_FDF_CRG/20120511_FDF_CRG_c12.mtb	2375	62	WWSS	food_sc	4	113939	1336844804	1	0.04	0.0025	3239	1
1	Food 2	Intake 4	32	114049	1336844914	/users/cn/jespinosa/phecomp/data/CRG/20120502_FDF_CRG/20120502_FDF_CRG/20120511_FDF_CRG_c12.mtb	2376	12	WWSS	food_sc	4	114017	1336844882	1	0.02	0.000625	3240	1
1	Food 2	Intake 4	17	114078	1336844943	/users/cn/jespinosa/phecomp/data/CRG/20120502_FDF_CRG/20120502_FDF_CRG/20120511_FDF_CRG_c12.mtb	2377	28	WWSS	food_sc	4	114061	1336844926	1	0.04	0.00235294117647059	3241	1
1	Food 2	Intake 4	16	114122	1336844987	/users/cn/jespinosa/phecomp/data/CRG/20120502_FDF_CRG/20120502_FDF_CRG/20120511_FDF_CRG_c12.mtb	2378	2088	WWSS	food_sc	4	114106	1336844971	1	0.02	0.00125	3242	1
1	Drink 2	Intake 2	17	114146	1336845011	/users/cn/jespinosa/phecomp/data/CRG/20120502_FDF_CRG/20120502_FDF_CRG/20120511_FDF_CRG_c12.mtb	909	NA	WWSS	water	2	114129	1336844994	1	0.02	0.00117647058823529	3243	1
1	Food 2	Intake 4	73	116283	1336847148	/users/cn/jespinosa/phecomp/data/CRG/20120502_FDF_CRG/20120502_FDF_CRG/20120511_FDF_CRG_c12.mtb	2379	32	WWSS	food_sc	4	116210	1336847075	1	0.04	0.000547945205479452	3244	1
1	Food 1	Intake 3	47	116362	1336847227	/users/cn/jespinosa/phecomp/data/CRG/20120502_FDF_CRG/20120502_FDF_CRG/20120511_FDF_CRG_c12.mtb	1717	50	WWSS	food_sc	3	116315	1336847180	1	0.04	0.000851063829787234	3245	1
1	Drink 2	Intake 2	15	116382	1336847247	/users/cn/jespinosa/phecomp/data/CRG/20120502_FDF_CRG/20120502_FDF_CRG/20120511_FDF_CRG_c12.mtb	911	NA	WWSS	water	2	116367	1336847232	1	0.02	0.00133333333333333	3246	1
1	Food 2	Intake 4	50	116462	1336847327	/users/cn/jespinosa/phecomp/data/CRG/20120502_FDF_CRG/20120502_FDF_CRG/20120511_FDF_CRG_c12.mtb	2381	1506	WWSS	food_sc	4	116412	1336847277	1	0.02	0.0004	3247	1
1	Drink 2	Intake 2	9	116616	1336847481	/users/cn/jespinosa/phecomp/data/CRG/20120502_FDF_CRG/20120502_FDF_CRG/20120511_FDF_CRG_c12.mtb	912	NA	WWSS	water	2	116607	1336847472	1	0.02	0.00222222222222222	3248	1
1	Drink 1	Intake 1	17	116912	1336847777	/users/cn/jespinosa/phecomp/data/CRG/20120502_FDF_CRG/20120502_FDF_CRG/20120511_FDF_CRG_c12.mtb	1966	NA	WWSS	water	1	116895	1336847760	1	0.02	0.00117647058823529	3249	1
1	Drink 2	Intake 2	13	117708	1336848573	/users/cn/jespinosa/phecomp/data/CRG/20120502_FDF_CRG/20120502_FDF_CRG/20120511_FDF_CRG_c12.mtb	914	NA	WWSS	water	2	117695	1336848560	1	0.0600000000000001	0.00461538461538462	3250	1
1	Food 2	Intake 4	9	117977	1336848842	/users/cn/jespinosa/phecomp/data/CRG/20120502_FDF_CRG/20120502_FDF_CRG/20120511_FDF_CRG_c12.mtb	2388	26	WWSS	food_sc	4	117968	1336848833	1	0.02	0.00222222222222222	3251	1
1	Food 2	Intake 4	33	118036	1336848901	/users/cn/jespinosa/phecomp/data/CRG/20120502_FDF_CRG/20120502_FDF_CRG/20120511_FDF_CRG_c12.mtb	2389	27	WWSS	food_sc	4	118003	1336848868	1	0.04	0.00121212121212121	3252	1
1	Food 2	Intake 4	17	118080	1336848945	/users/cn/jespinosa/phecomp/data/CRG/20120502_FDF_CRG/20120502_FDF_CRG/20120511_FDF_CRG_c12.mtb	2390	17	WWSS	food_sc	4	118063	1336848928	1	0.02	0.00117647058823529	3253	1
1	Food 2	Intake 4	36	118133	1336848998	/users/cn/jespinosa/phecomp/data/CRG/20120502_FDF_CRG/20120502_FDF_CRG/20120511_FDF_CRG_c12.mtb	2391	1301	WWSS	food_sc	4	118097	1336848962	1	0.02	0.000555555555555556	3254	1
1	Food 2	Intake 4	9	119443	1336850308	/users/cn/jespinosa/phecomp/data/CRG/20120502_FDF_CRG/20120502_FDF_CRG/20120511_FDF_CRG_c12.mtb	2393	6	WWSS	food_sc	4	119434	1336850299	1	0.02	0.00222222222222222	3255	1
1	Food 2	Intake 4	70	119519	1336850384	/users/cn/jespinosa/phecomp/data/CRG/20120502_FDF_CRG/20120502_FDF_CRG/20120511_FDF_CRG_c12.mtb	2394	1005	WWSS	food_sc	4	119449	1336850314	1	0.0600000000000001	0.000857142857142859	3256	1
1	Drink 2	Intake 2	26	119540	1336850405	/users/cn/jespinosa/phecomp/data/CRG/20120502_FDF_CRG/20120502_FDF_CRG/20120511_FDF_CRG_c12.mtb	915	NA	WWSS	water	2	119514	1336850379	1	0.0600000000000001	0.00230769230769231	3257	1
1	Food 2	Intake 4	20	120544	1336851409	/users/cn/jespinosa/phecomp/data/CRG/20120502_FDF_CRG/20120502_FDF_CRG/20120511_FDF_CRG_c12.mtb	2395	8	WWSS	food_sc	4	120524	1336851389	1	0.02	0.001	3258	1
1	Food 2	Intake 4	63	120615	1336851480	/users/cn/jespinosa/phecomp/data/CRG/20120502_FDF_CRG/20120502_FDF_CRG/20120511_FDF_CRG_c12.mtb	2396	1121	WWSS	food_sc	4	120552	1336851417	1	0.0600000000000001	0.000952380952380954	3259	1
1	Drink 2	Intake 2	18	120862	1336851727	/users/cn/jespinosa/phecomp/data/CRG/20120502_FDF_CRG/20120502_FDF_CRG/20120511_FDF_CRG_c12.mtb	916	NA	WWSS	water	2	120844	1336851709	1	0.0800000000000001	0.00444444444444445	3260	1
1	Food 1	Intake 3	16	121752	1336852617	/users/cn/jespinosa/phecomp/data/CRG/20120502_FDF_CRG/20120502_FDF_CRG/20120511_FDF_CRG_c12.mtb	1726	32	WWSS	food_sc	3	121736	1336852601	1	0.02	0.00125	3261	1
1	Food 1	Intake 3	51	121835	1336852700	/users/cn/jespinosa/phecomp/data/CRG/20120502_FDF_CRG/20120502_FDF_CRG/20120511_FDF_CRG_c12.mtb	1727	122	WWSS	food_sc	3	121784	1336852649	1	0.0600000000000001	0.0011764705882353	3262	1
1	Food 2	Intake 4	293	122250	1336853115	/users/cn/jespinosa/phecomp/data/CRG/20120502_FDF_CRG/20120502_FDF_CRG/20120511_FDF_CRG_c12.mtb	2397	COLL	WWSS	food_sc	4	121957	1336852822	1	0.0399999999999996	0.000136518771331057	3263	1
1	Food 1	Intake 3	98	122289	1336853154	/users/cn/jespinosa/phecomp/data/CRG/20120502_FDF_CRG/20120502_FDF_CRG/20120511_FDF_CRG_c12.mtb	1730	9	WWSS	food_sc	3	122191	1336853056	1	0.02	0.000204081632653061	3264	1
1	Drink 2	Intake 2	18	122304	1336853169	/users/cn/jespinosa/phecomp/data/CRG/20120502_FDF_CRG/20120502_FDF_CRG/20120511_FDF_CRG_c12.mtb	917	NA	WWSS	water	2	122286	1336853151	1	0.02	0.00111111111111111	3265	1
1	Food 2	Intake 4	208	122506	1336853371	/users/cn/jespinosa/phecomp/data/CRG/20120502_FDF_CRG/20120502_FDF_CRG/20120511_FDF_CRG_c12.mtb	2398	420	WWSS	food_sc	4	122298	1336853163	1	0.02	9.61538461538462e-05	3266	1
1	Drink 2	Intake 2	22	122517	1336853382	/users/cn/jespinosa/phecomp/data/CRG/20120502_FDF_CRG/20120502_FDF_CRG/20120511_FDF_CRG_c12.mtb	918	NA	WWSS	water	2	122495	1336853360	1	0.04	0.00181818181818182	3267	1
1	Drink 2	Intake 2	25	122897	1336853762	/users/cn/jespinosa/phecomp/data/CRG/20120502_FDF_CRG/20120502_FDF_CRG/20120511_FDF_CRG_c12.mtb	919	NA	WWSS	water	2	122872	1336853737	1	0.0599999999999996	0.00239999999999998	3268	1
1	Food 2	Intake 4	118	123044	1336853909	/users/cn/jespinosa/phecomp/data/CRG/20120502_FDF_CRG/20120502_FDF_CRG/20120511_FDF_CRG_c12.mtb	2401	122	WWSS	food_sc	4	122926	1336853791	1	0.02	0.000169491525423729	3269	1
1	Food 2	Intake 4	60	123226	1336854091	/users/cn/jespinosa/phecomp/data/CRG/20120502_FDF_CRG/20120502_FDF_CRG/20120511_FDF_CRG_c12.mtb	2403	306	WWSS	food_sc	4	123166	1336854031	1	0.02	0.000333333333333333	3270	1
1	Food 2	Intake 4	65	123597	1336854462	/users/cn/jespinosa/phecomp/data/CRG/20120502_FDF_CRG/20120502_FDF_CRG/20120511_FDF_CRG_c12.mtb	2409	63	WWSS	food_sc	4	123532	1336854397	1	0.02	0.000307692307692308	3271	1
1	Drink 1	Intake 1	21	123653	1336854518	/users/cn/jespinosa/phecomp/data/CRG/20120502_FDF_CRG/20120502_FDF_CRG/20120511_FDF_CRG_c12.mtb	1969	NA	WWSS	water	1	123632	1336854497	1	0.04	0.0019047619047619	3272	1
1	Food 2	Intake 4	85	123745	1336854610	/users/cn/jespinosa/phecomp/data/CRG/20120502_FDF_CRG/20120502_FDF_CRG/20120511_FDF_CRG_c12.mtb	2411	259	WWSS	food_sc	4	123660	1336854525	1	0.02	0.000235294117647059	3273	1
1	Drink 2	Intake 2	23	123939	1336854804	/users/cn/jespinosa/phecomp/data/CRG/20120502_FDF_CRG/20120502_FDF_CRG/20120511_FDF_CRG_c12.mtb	921	NA	WWSS	water	2	123916	1336854781	1	0.0800000000000001	0.00347826086956522	3274	1
1	Food 2	Intake 4	31	124035	1336854900	/users/cn/jespinosa/phecomp/data/CRG/20120502_FDF_CRG/20120502_FDF_CRG/20120511_FDF_CRG_c12.mtb	2414	45	WWSS	food_sc	4	124004	1336854869	1	0.02	0.000645161290322581	3275	1
1	Food 1	Intake 3	120	124200	1336855065	/users/cn/jespinosa/phecomp/data/CRG/20120502_FDF_CRG/20120502_FDF_CRG/20120511_FDF_CRG_c12.mtb	1746	27	WWSS	food_sc	3	124080	1336854945	1	0.02	0.000166666666666667	3276	1
1	Food 1	Intake 3	146	124373	1336855238	/users/cn/jespinosa/phecomp/data/CRG/20120502_FDF_CRG/20120502_FDF_CRG/20120511_FDF_CRG_c12.mtb	1748	227	WWSS	food_sc	3	124227	1336855092	1	0.0600000000000001	0.00041095890410959	3277	1
1	Food 2	Intake 4	156	124756	1336855621	/users/cn/jespinosa/phecomp/data/CRG/20120502_FDF_CRG/20120502_FDF_CRG/20120511_FDF_CRG_c12.mtb	2416	409	WWSS	food_sc	4	124600	1336855465	1	0.04	0.000256410256410256	3278	1
1	Drink 2	Intake 2	36	124812	1336855677	/users/cn/jespinosa/phecomp/data/CRG/20120502_FDF_CRG/20120502_FDF_CRG/20120511_FDF_CRG_c12.mtb	922	NA	WWSS	water	2	124776	1336855641	1	0.1	0.00277777777777778	3279	1
1	Food 2	Intake 4	60	125225	1336856090	/users/cn/jespinosa/phecomp/data/CRG/20120502_FDF_CRG/20120502_FDF_CRG/20120511_FDF_CRG_c12.mtb	2419	48	WWSS	food_sc	4	125165	1336856030	1	0.02	0.000333333333333333	3280	1
1	Food 2	Intake 4	187	125460	1336856325	/users/cn/jespinosa/phecomp/data/CRG/20120502_FDF_CRG/20120502_FDF_CRG/20120511_FDF_CRG_c12.mtb	2420	670	WWSS	food_sc	4	125273	1336856138	1	0.04	0.000213903743315508	3281	1
1	Drink 2	Intake 2	34	125489	1336856354	/users/cn/jespinosa/phecomp/data/CRG/20120502_FDF_CRG/20120502_FDF_CRG/20120511_FDF_CRG_c12.mtb	923	NA	WWSS	water	2	125455	1336856320	1	0.0800000000000001	0.00235294117647059	3282	1
1	Drink 1	Intake 1	20	125840	1336856705	/users/cn/jespinosa/phecomp/data/CRG/20120502_FDF_CRG/20120502_FDF_CRG/20120511_FDF_CRG_c12.mtb	1972	NA	WWSS	water	1	125820	1336856685	1	0.0599999999999999	0.00299999999999999	3283	1
1	Drink 1	Intake 1	34	125919	1336856784	/users/cn/jespinosa/phecomp/data/CRG/20120502_FDF_CRG/20120502_FDF_CRG/20120511_FDF_CRG_c12.mtb	1973	NA	WWSS	water	1	125885	1336856750	1	0.04	0.00117647058823529	3284	1
1	Drink 1	Intake 1	54	125984	1336856849	/users/cn/jespinosa/phecomp/data/CRG/20120502_FDF_CRG/20120502_FDF_CRG/20120511_FDF_CRG_c12.mtb	1974	NA	WWSS	water	1	125930	1336856795	1	0.12	0.00222222222222222	3285	1
1	Food 2	Intake 4	92	126222	1336857087	/users/cn/jespinosa/phecomp/data/CRG/20120502_FDF_CRG/20120502_FDF_CRG/20120511_FDF_CRG_c12.mtb	2423	221	WWSS	food_sc	4	126130	1336856995	1	0.02	0.000217391304347826	3286	1
1	Food 1	Intake 3	140	126583	1336857448	/users/cn/jespinosa/phecomp/data/CRG/20120502_FDF_CRG/20120502_FDF_CRG/20120511_FDF_CRG_c12.mtb	1762	71	WWSS	food_sc	3	126443	1336857308	1	0.0600000000000001	0.000428571428571429	3287	1
1	Drink 2	Intake 2	19	126599	1336857464	/users/cn/jespinosa/phecomp/data/CRG/20120502_FDF_CRG/20120502_FDF_CRG/20120511_FDF_CRG_c12.mtb	924	NA	WWSS	water	2	126580	1336857445	1	0.02	0.00105263157894737	3288	1
1	Food 1	Intake 3	58	126712	1336857577	/users/cn/jespinosa/phecomp/data/CRG/20120502_FDF_CRG/20120502_FDF_CRG/20120511_FDF_CRG_c12.mtb	1763	46	WWSS	food_sc	3	126654	1336857519	1	0.0800000000000001	0.00137931034482759	3289	1
1	Food 1	Intake 3	168	126926	1336857791	/users/cn/jespinosa/phecomp/data/CRG/20120502_FDF_CRG/20120502_FDF_CRG/20120511_FDF_CRG_c12.mtb	1764	51	WWSS	food_sc	3	126758	1336857623	1	0.04	0.000238095238095238	3290	1
1	Food 1	Intake 3	150	127127	1336857992	/users/cn/jespinosa/phecomp/data/CRG/20120502_FDF_CRG/20120502_FDF_CRG/20120511_FDF_CRG_c12.mtb	1765	713	WWSS	food_sc	3	126977	1336857842	1	0.02	0.000133333333333333	3291	1
1	Food 1	Intake 3	239	128079	1336858944	/users/cn/jespinosa/phecomp/data/CRG/20120502_FDF_CRG/20120502_FDF_CRG/20120511_FDF_CRG_c12.mtb	1769	4	WWSS	food_sc	3	127840	1336858705	1	0.04	0.000167364016736402	3292	1
1	Food 2	Intake 4	27	128110	1336858975	/users/cn/jespinosa/phecomp/data/CRG/20120502_FDF_CRG/20120502_FDF_CRG/20120511_FDF_CRG_c12.mtb	2436	132	WWSS	food_sc	4	128083	1336858948	1	0.02	0.000740740740740741	3293	1
1	Food 1	Intake 3	114	128356	1336859221	/users/cn/jespinosa/phecomp/data/CRG/20120502_FDF_CRG/20120502_FDF_CRG/20120511_FDF_CRG_c12.mtb	1771	487	WWSS	food_sc	3	128242	1336859107	1	0.0200000000000005	0.000175438596491232	3294	1
1	Drink 2	Intake 2	19	128452	1336859317	/users/cn/jespinosa/phecomp/data/CRG/20120502_FDF_CRG/20120502_FDF_CRG/20120511_FDF_CRG_c12.mtb	925	NA	WWSS	water	2	128433	1336859298	1	0.02	0.00105263157894737	3295	1
1	Food 2	Intake 4	87	128930	1336859795	/users/cn/jespinosa/phecomp/data/CRG/20120502_FDF_CRG/20120502_FDF_CRG/20120511_FDF_CRG_c12.mtb	2441	20	WWSS	food_sc	4	128843	1336859708	1	0.02	0.000229885057471264	3296	1
1	Food 1	Intake 3	43	128993	1336859858	/users/cn/jespinosa/phecomp/data/CRG/20120502_FDF_CRG/20120502_FDF_CRG/20120511_FDF_CRG_c12.mtb	1775	9	WWSS	food_sc	3	128950	1336859815	1	0.02	0.000465116279069767	3297	1
1	Food 1	Intake 3	92	129094	1336859959	/users/cn/jespinosa/phecomp/data/CRG/20120502_FDF_CRG/20120502_FDF_CRG/20120511_FDF_CRG_c12.mtb	1776	632	WWSS	food_sc	3	129002	1336859867	1	0.02	0.000217391304347826	3298	1
1	Drink 1	Intake 1	16	129109	1336859974	/users/cn/jespinosa/phecomp/data/CRG/20120502_FDF_CRG/20120502_FDF_CRG/20120511_FDF_CRG_c12.mtb	1976	NA	WWSS	water	1	129093	1336859958	1	0.02	0.00125	3299	1
1	Drink 2	Intake 2	24	129120	1336859985	/users/cn/jespinosa/phecomp/data/CRG/20120502_FDF_CRG/20120502_FDF_CRG/20120511_FDF_CRG_c12.mtb	926	NA	WWSS	water	2	129096	1336859961	1	0.0600000000000001	0.0025	3300	1
1	Food 2	Intake 4	52	129778	1336860643	/users/cn/jespinosa/phecomp/data/CRG/20120502_FDF_CRG/20120502_FDF_CRG/20120511_FDF_CRG_c12.mtb	2446	3764	WWSS	food_sc	4	129726	1336860591	1	0.02	0.000384615384615385	3301	1
1	Drink 1	Intake 1	62	129903	1336860768	/users/cn/jespinosa/phecomp/data/CRG/20120502_FDF_CRG/20120502_FDF_CRG/20120511_FDF_CRG_c12.mtb	1978	NA	WWSS	water	1	129841	1336860706	1	0.1	0.00161290322580645	3302	1
1	Drink 1	Intake 1	9	130011	1336860876	/users/cn/jespinosa/phecomp/data/CRG/20120502_FDF_CRG/20120502_FDF_CRG/20120511_FDF_CRG_c12.mtb	1979	NA	WWSS	water	1	130002	1336860867	1	0.02	0.00222222222222222	3303	1
1	Drink 1	Intake 1	15	130035	1336860900	/users/cn/jespinosa/phecomp/data/CRG/20120502_FDF_CRG/20120502_FDF_CRG/20120511_FDF_CRG_c12.mtb	1980	NA	WWSS	water	1	130020	1336860885	1	0.02	0.00133333333333333	3304	1
1	Food 2	Intake 4	14	133556	1336864421	/users/cn/jespinosa/phecomp/data/CRG/20120502_FDF_CRG/20120502_FDF_CRG/20120511_FDF_CRG_c12.mtb	2448	20	WWSS	food_sc	4	133542	1336864407	1	0.02	0.00142857142857143	3305	1
1	Food 2	Intake 4	9	133585	1336864450	/users/cn/jespinosa/phecomp/data/CRG/20120502_FDF_CRG/20120502_FDF_CRG/20120511_FDF_CRG_c12.mtb	2449	212	WWSS	food_sc	4	133576	1336864441	1	0.02	0.00222222222222222	3306	1
1	Food 2	Intake 4	18	133815	1336864680	/users/cn/jespinosa/phecomp/data/CRG/20120502_FDF_CRG/20120502_FDF_CRG/20120511_FDF_CRG_c12.mtb	2451	38	WWSS	food_sc	4	133797	1336864662	1	0.02	0.00111111111111111	3307	1
1	Drink 1	Intake 1	14	133852	1336864717	/users/cn/jespinosa/phecomp/data/CRG/20120502_FDF_CRG/20120502_FDF_CRG/20120511_FDF_CRG_c12.mtb	1981	NA	WWSS	water	1	133838	1336864703	1	0.02	0.00142857142857143	3308	1
1	Food 2	Intake 4	228	134081	1336864946	/users/cn/jespinosa/phecomp/data/CRG/20120502_FDF_CRG/20120502_FDF_CRG/20120511_FDF_CRG_c12.mtb	2453	COLL	WWSS	food_sc	4	133853	1336864718	1	0.02	8.7719298245614e-05	3309	1
1	Food 1	Intake 3	55	133914	1336864779	/users/cn/jespinosa/phecomp/data/CRG/20120502_FDF_CRG/20120502_FDF_CRG/20120511_FDF_CRG_c12.mtb	1779	188	WWSS	food_sc	3	133859	1336864724	1	0.02	0.000363636363636364	3310	1
1	Drink 1	Intake 1	18	134089	1336864954	/users/cn/jespinosa/phecomp/data/CRG/20120502_FDF_CRG/20120502_FDF_CRG/20120511_FDF_CRG_c12.mtb	1982	NA	WWSS	water	1	134071	1336864936	1	0.02	0.00111111111111111	3311	1
1	Food 2	Intake 4	78	134180	1336865045	/users/cn/jespinosa/phecomp/data/CRG/20120502_FDF_CRG/20120502_FDF_CRG/20120511_FDF_CRG_c12.mtb	2454	104	WWSS	food_sc	4	134102	1336864967	1	0.0599999999999996	0.000769230769230764	3312	1
1	Drink 1	Intake 1	36	134232	1336865097	/users/cn/jespinosa/phecomp/data/CRG/20120502_FDF_CRG/20120502_FDF_CRG/20120511_FDF_CRG_c12.mtb	1983	NA	WWSS	water	1	134196	1336865061	1	0.04	0.00111111111111111	3313	1
1	Food 2	Intake 4	38	134322	1336865187	/users/cn/jespinosa/phecomp/data/CRG/20120502_FDF_CRG/20120502_FDF_CRG/20120511_FDF_CRG_c12.mtb	2456	1187	WWSS	food_sc	4	134284	1336865149	1	0.0200000000000005	0.000526315789473697	3314	1
1	Drink 1	Intake 1	17	134350	1336865215	/users/cn/jespinosa/phecomp/data/CRG/20120502_FDF_CRG/20120502_FDF_CRG/20120511_FDF_CRG_c12.mtb	1984	NA	WWSS	water	1	134333	1336865198	1	0.02	0.00117647058823529	3315	1
1	Drink 2	Intake 2	17	134912	1336865777	/users/cn/jespinosa/phecomp/data/CRG/20120502_FDF_CRG/20120502_FDF_CRG/20120511_FDF_CRG_c12.mtb	928	NA	WWSS	water	2	134895	1336865760	1	0.02	0.00117647058823529	3316	1
1	Drink 2	Intake 2	41	135087	1336865952	/users/cn/jespinosa/phecomp/data/CRG/20120502_FDF_CRG/20120502_FDF_CRG/20120511_FDF_CRG_c12.mtb	929	NA	WWSS	water	2	135046	1336865911	1	0.14	0.00341463414634146	3317	1
1	Food 2	Intake 4	81	135590	1336866455	/users/cn/jespinosa/phecomp/data/CRG/20120502_FDF_CRG/20120502_FDF_CRG/20120511_FDF_CRG_c12.mtb	2463	5	WWSS	food_sc	4	135509	1336866374	1	0.02	0.000246913580246914	3318	1
1	Food 2	Intake 4	105	135700	1336866565	/users/cn/jespinosa/phecomp/data/CRG/20120502_FDF_CRG/20120502_FDF_CRG/20120511_FDF_CRG_c12.mtb	2464	1408	WWSS	food_sc	4	135595	1336866460	1	0.0600000000000001	0.000571428571428572	3319	1
1	Food 2	Intake 4	62	137170	1336868035	/users/cn/jespinosa/phecomp/data/CRG/20120502_FDF_CRG/20120502_FDF_CRG/20120511_FDF_CRG_c12.mtb	2467	761	WWSS	food_sc	4	137108	1336867973	1	0.04	0.000645161290322581	3320	1
1	Drink 1	Intake 1	16	137283	1336868148	/users/cn/jespinosa/phecomp/data/CRG/20120502_FDF_CRG/20120502_FDF_CRG/20120511_FDF_CRG_c12.mtb	1987	NA	WWSS	water	1	137267	1336868132	1	0.0799999999999998	0.00499999999999999	3321	1
1	Food 2	Intake 4	109	138040	1336868905	/users/cn/jespinosa/phecomp/data/CRG/20120502_FDF_CRG/20120502_FDF_CRG/20120511_FDF_CRG_c12.mtb	2468	125	WWSS	food_sc	4	137931	1336868796	1	0.02	0.00018348623853211	3322	1
1	Food 2	Intake 4	61	138226	1336869091	/users/cn/jespinosa/phecomp/data/CRG/20120502_FDF_CRG/20120502_FDF_CRG/20120511_FDF_CRG_c12.mtb	2470	727	WWSS	food_sc	4	138165	1336869030	1	0.02	0.000327868852459016	3323	1
1	Drink 2	Intake 2	23	138348	1336869213	/users/cn/jespinosa/phecomp/data/CRG/20120502_FDF_CRG/20120502_FDF_CRG/20120511_FDF_CRG_c12.mtb	931	NA	WWSS	water	2	138325	1336869190	1	0.04	0.00173913043478261	3324	1
1	Food 2	Intake 4	20	138973	1336869838	/users/cn/jespinosa/phecomp/data/CRG/20120502_FDF_CRG/20120502_FDF_CRG/20120511_FDF_CRG_c12.mtb	2471	5214	WWSS	food_sc	4	138953	1336869818	1	0.02	0.001	3325	1
1	Food 2	Intake 4	15	144202	1336875067	/users/cn/jespinosa/phecomp/data/CRG/20120502_FDF_CRG/20120502_FDF_CRG/20120511_FDF_CRG_c12.mtb	2474	1545	WWSS	food_sc	4	144187	1336875052	1	0.02	0.00133333333333333	3326	1
1	Food 1	Intake 3	15	145762	1336876627	/users/cn/jespinosa/phecomp/data/CRG/20120502_FDF_CRG/20120502_FDF_CRG/20120511_FDF_CRG_c12.mtb	1797	2384	WWSS	food_sc	3	145747	1336876612	1	0.04	0.00266666666666667	3327	1
1	Food 2	Intake 4	49	148195	1336879060	/users/cn/jespinosa/phecomp/data/CRG/20120502_FDF_CRG/20120502_FDF_CRG/20120511_FDF_CRG_c12.mtb	2475	3282	WWSS	food_sc	4	148146	1336879011	1	0.0800000000000001	0.00163265306122449	3328	1
1	Food 2	Intake 4	36	151513	1336882378	/users/cn/jespinosa/phecomp/data/CRG/20120502_FDF_CRG/20120502_FDF_CRG/20120511_FDF_CRG_c12.mtb	2478	12	WWSS	food_sc	4	151477	1336882342	1	0.04	0.00111111111111111	3329	1
1	Food 2	Intake 4	17	151542	1336882407	/users/cn/jespinosa/phecomp/data/CRG/20120502_FDF_CRG/20120502_FDF_CRG/20120511_FDF_CRG_c12.mtb	2479	17	WWSS	food_sc	4	151525	1336882390	1	0.04	0.00235294117647059	3330	1
1	Food 2	Intake 4	8	151567	1336882432	/users/cn/jespinosa/phecomp/data/CRG/20120502_FDF_CRG/20120502_FDF_CRG/20120511_FDF_CRG_c12.mtb	2480	7	WWSS	food_sc	4	151559	1336882424	1	0.0200000000000005	0.00250000000000006	3331	1
1	Food 2	Intake 4	119	151693	1336882558	/users/cn/jespinosa/phecomp/data/CRG/20120502_FDF_CRG/20120502_FDF_CRG/20120511_FDF_CRG_c12.mtb	2481	508	WWSS	food_sc	4	151574	1336882439	1	0.0599999999999996	0.000504201680672266	3332	1
1	Food 2	Intake 4	43	152244	1336883109	/users/cn/jespinosa/phecomp/data/CRG/20120502_FDF_CRG/20120502_FDF_CRG/20120511_FDF_CRG_c12.mtb	2482	65	WWSS	food_sc	4	152201	1336883066	1	0.0200000000000005	0.000465116279069779	3333	1
1	Drink 2	Intake 2	23	152310	1336883175	/users/cn/jespinosa/phecomp/data/CRG/20120502_FDF_CRG/20120502_FDF_CRG/20120511_FDF_CRG_c12.mtb	934	NA	WWSS	water	2	152287	1336883152	1	0.0800000000000001	0.00347826086956522	3334	1
1	Food 1	Intake 3	121	152430	1336883295	/users/cn/jespinosa/phecomp/data/CRG/20120502_FDF_CRG/20120502_FDF_CRG/20120511_FDF_CRG_c12.mtb	1800	9	WWSS	food_sc	3	152309	1336883174	1	0.04	0.000330578512396694	3335	1
1	Drink 2	Intake 2	17	152444	1336883309	/users/cn/jespinosa/phecomp/data/CRG/20120502_FDF_CRG/20120502_FDF_CRG/20120511_FDF_CRG_c12.mtb	935	NA	WWSS	water	2	152427	1336883292	1	0.02	0.00117647058823529	3336	1
1	Food 1	Intake 3	89	152528	1336883393	/users/cn/jespinosa/phecomp/data/CRG/20120502_FDF_CRG/20120502_FDF_CRG/20120511_FDF_CRG_c12.mtb	1801	29	WWSS	food_sc	3	152439	1336883304	1	0.02	0.000224719101123596	3337	1
1	Food 2	Intake 4	116	152673	1336883538	/users/cn/jespinosa/phecomp/data/CRG/20120502_FDF_CRG/20120502_FDF_CRG/20120511_FDF_CRG_c12.mtb	2485	59	WWSS	food_sc	4	152557	1336883422	1	0.04	0.000344827586206897	3338	1
1	Drink 1	Intake 1	28	152696	1336883561	/users/cn/jespinosa/phecomp/data/CRG/20120502_FDF_CRG/20120502_FDF_CRG/20120511_FDF_CRG_c12.mtb	1990	NA	WWSS	water	1	152668	1336883533	1	0.0800000000000001	0.00285714285714286	3339	1
1	Food 2	Intake 4	36	152768	1336883633	/users/cn/jespinosa/phecomp/data/CRG/20120502_FDF_CRG/20120502_FDF_CRG/20120511_FDF_CRG_c12.mtb	2486	386	WWSS	food_sc	4	152732	1336883597	1	0.0200000000000005	0.000555555555555569	3340	1
1	Drink 2	Intake 2	28	153083	1336883948	/users/cn/jespinosa/phecomp/data/CRG/20120502_FDF_CRG/20120502_FDF_CRG/20120511_FDF_CRG_c12.mtb	936	NA	WWSS	water	2	153055	1336883920	1	0.0600000000000001	0.00214285714285715	3341	1
1	Food 2	Intake 4	112	153266	1336884131	/users/cn/jespinosa/phecomp/data/CRG/20120502_FDF_CRG/20120502_FDF_CRG/20120511_FDF_CRG_c12.mtb	2488	210	WWSS	food_sc	4	153154	1336884019	1	0.04	0.000357142857142857	3342	1
1	Drink 1	Intake 1	37	153308	1336884173	/users/cn/jespinosa/phecomp/data/CRG/20120502_FDF_CRG/20120502_FDF_CRG/20120511_FDF_CRG_c12.mtb	1991	NA	WWSS	water	1	153271	1336884136	1	0.04	0.00108108108108108	3343	1
1	Drink 2	Intake 2	25	153339	1336884204	/users/cn/jespinosa/phecomp/data/CRG/20120502_FDF_CRG/20120502_FDF_CRG/20120511_FDF_CRG_c12.mtb	937	NA	WWSS	water	2	153314	1336884179	1	0.02	0.0008	3344	1
1	Food 1	Intake 3	132	153608	1336884473	/users/cn/jespinosa/phecomp/data/CRG/20120502_FDF_CRG/20120502_FDF_CRG/20120511_FDF_CRG_c12.mtb	1806	135	WWSS	food_sc	3	153476	1336884341	1	0.02	0.000151515151515152	3345	1
1	Drink 2	Intake 2	27	153631	1336884496	/users/cn/jespinosa/phecomp/data/CRG/20120502_FDF_CRG/20120502_FDF_CRG/20120511_FDF_CRG_c12.mtb	938	NA	WWSS	water	2	153604	1336884469	1	0.0800000000000001	0.00296296296296297	3346	1
1	Drink 1	Intake 1	9	153740	1336884605	/users/cn/jespinosa/phecomp/data/CRG/20120502_FDF_CRG/20120502_FDF_CRG/20120511_FDF_CRG_c12.mtb	1995	NA	WWSS	water	1	153731	1336884596	1	0.02	0.00222222222222222	3347	1
1	Food 1	Intake 3	163	153906	1336884771	/users/cn/jespinosa/phecomp/data/CRG/20120502_FDF_CRG/20120502_FDF_CRG/20120511_FDF_CRG_c12.mtb	1807	COLL	WWSS	food_sc	3	153743	1336884608	1	0.0600000000000001	0.000368098159509203	3348	1
1	Food 2	Intake 4	49	153950	1336884815	/users/cn/jespinosa/phecomp/data/CRG/20120502_FDF_CRG/20120502_FDF_CRG/20120511_FDF_CRG_c12.mtb	2493	COLL	WWSS	food_sc	4	153901	1336884766	1	0.0200000000000005	0.000408163265306133	3349	1
1	Food 1	Intake 3	178	154114	1336884979	/users/cn/jespinosa/phecomp/data/CRG/20120502_FDF_CRG/20120502_FDF_CRG/20120511_FDF_CRG_c12.mtb	1808	146	WWSS	food_sc	3	153936	1336884801	1	0.02	0.000112359550561798	3350	1
1	Food 1	Intake 3	136	154396	1336885261	/users/cn/jespinosa/phecomp/data/CRG/20120502_FDF_CRG/20120502_FDF_CRG/20120511_FDF_CRG_c12.mtb	1810	COLL	WWSS	food_sc	3	154260	1336885125	1	0.04	0.000294117647058824	3351	1
1	Food 2	Intake 4	74	154457	1336885322	/users/cn/jespinosa/phecomp/data/CRG/20120502_FDF_CRG/20120502_FDF_CRG/20120511_FDF_CRG_c12.mtb	2499	589	WWSS	food_sc	4	154383	1336885248	1	0.04	0.000540540540540541	3352	1
1	Drink 2	Intake 2	27	154478	1336885343	/users/cn/jespinosa/phecomp/data/CRG/20120502_FDF_CRG/20120502_FDF_CRG/20120511_FDF_CRG_c12.mtb	939	NA	WWSS	water	2	154451	1336885316	1	0.04	0.00148148148148148	3353	1
1	Food 2	Intake 4	183	155229	1336886094	/users/cn/jespinosa/phecomp/data/CRG/20120502_FDF_CRG/20120502_FDF_CRG/20120511_FDF_CRG_c12.mtb	2503	39	WWSS	food_sc	4	155046	1336885911	1	0.0200000000000005	0.000109289617486342	3354	1
1	Drink 2	Intake 2	17	155172	1336886037	/users/cn/jespinosa/phecomp/data/CRG/20120502_FDF_CRG/20120502_FDF_CRG/20120511_FDF_CRG_c12.mtb	940	NA	WWSS	water	2	155155	1336886020	1	0.02	0.00117647058823529	3355	1
1	Food 2	Intake 4	80	155348	1336886213	/users/cn/jespinosa/phecomp/data/CRG/20120502_FDF_CRG/20120502_FDF_CRG/20120511_FDF_CRG_c12.mtb	2504	227	WWSS	food_sc	4	155268	1336886133	1	0.0200000000000005	0.000250000000000006	3356	1
1	Drink 1	Intake 1	40	155381	1336886246	/users/cn/jespinosa/phecomp/data/CRG/20120502_FDF_CRG/20120502_FDF_CRG/20120511_FDF_CRG_c12.mtb	1996	NA	WWSS	water	1	155341	1336886206	1	0.0600000000000001	0.0015	3357	1
1	Food 2	Intake 4	140	155715	1336886580	/users/cn/jespinosa/phecomp/data/CRG/20120502_FDF_CRG/20120502_FDF_CRG/20120511_FDF_CRG_c12.mtb	2507	8	WWSS	food_sc	4	155575	1336886440	1	0.0200000000000005	0.000142857142857146	3358	1
1	Food 2	Intake 4	157	155880	1336886745	/users/cn/jespinosa/phecomp/data/CRG/20120502_FDF_CRG/20120502_FDF_CRG/20120511_FDF_CRG_c12.mtb	2508	294	WWSS	food_sc	4	155723	1336886588	1	0.0599999999999996	0.000382165605095539	3359	1
1	Drink 2	Intake 2	38	155932	1336886797	/users/cn/jespinosa/phecomp/data/CRG/20120502_FDF_CRG/20120502_FDF_CRG/20120511_FDF_CRG_c12.mtb	942	NA	WWSS	water	2	155894	1336886759	1	0.1	0.00263157894736842	3360	1
1	Food 2	Intake 4	20	156194	1336887059	/users/cn/jespinosa/phecomp/data/CRG/20120502_FDF_CRG/20120502_FDF_CRG/20120511_FDF_CRG_c12.mtb	2512	28	WWSS	food_sc	4	156174	1336887039	1	0.36	0.018	3361	1
1	Food 1	Intake 3	136	156358	1336887223	/users/cn/jespinosa/phecomp/data/CRG/20120502_FDF_CRG/20120502_FDF_CRG/20120511_FDF_CRG_c12.mtb	1826	152	WWSS	food_sc	3	156222	1336887087	1	0.04	0.000294117647058824	3362	1
1	Food 1	Intake 3	120	156630	1336887495	/users/cn/jespinosa/phecomp/data/CRG/20120502_FDF_CRG/20120502_FDF_CRG/20120511_FDF_CRG_c12.mtb	1828	175	WWSS	food_sc	3	156510	1336887375	1	0.02	0.000166666666666667	3363	1
1	Food 1	Intake 3	160	156965	1336887830	/users/cn/jespinosa/phecomp/data/CRG/20120502_FDF_CRG/20120502_FDF_CRG/20120511_FDF_CRG_c12.mtb	1830	403	WWSS	food_sc	3	156805	1336887670	1	0.04	0.00025	3364	1
1	Drink 2	Intake 2	24	157348	1336888213	/users/cn/jespinosa/phecomp/data/CRG/20120502_FDF_CRG/20120502_FDF_CRG/20120511_FDF_CRG_c12.mtb	944	NA	WWSS	water	2	157324	1336888189	1	0.04	0.00166666666666667	3365	1
1	Food 1	Intake 3	61	157429	1336888294	/users/cn/jespinosa/phecomp/data/CRG/20120502_FDF_CRG/20120502_FDF_CRG/20120511_FDF_CRG_c12.mtb	1834	26	WWSS	food_sc	3	157368	1336888233	1	0.0200000000000005	0.000327868852459025	3366	1
1	Food 1	Intake 3	253	157708	1336888573	/users/cn/jespinosa/phecomp/data/CRG/20120502_FDF_CRG/20120502_FDF_CRG/20120511_FDF_CRG_c12.mtb	1835	30	WWSS	food_sc	3	157455	1336888320	1	0.0599999999999996	0.000237154150197627	3367	1
1	Food 1	Intake 3	168	157906	1336888771	/users/cn/jespinosa/phecomp/data/CRG/20120502_FDF_CRG/20120502_FDF_CRG/20120511_FDF_CRG_c12.mtb	1836	COLL	WWSS	food_sc	3	157738	1336888603	1	0.02	0.000119047619047619	3368	1
1	Food 2	Intake 4	44	157889	1336888754	/users/cn/jespinosa/phecomp/data/CRG/20120502_FDF_CRG/20120502_FDF_CRG/20120511_FDF_CRG_c12.mtb	2524	316	WWSS	food_sc	4	157845	1336888710	1	0.0200000000000005	0.000454545454545466	3369	1
1	Drink 2	Intake 2	23	158086	1336888951	/users/cn/jespinosa/phecomp/data/CRG/20120502_FDF_CRG/20120502_FDF_CRG/20120511_FDF_CRG_c12.mtb	945	NA	WWSS	water	2	158063	1336888928	1	0.0800000000000001	0.00347826086956522	3370	1
1	Food 1	Intake 3	128	158333	1336889198	/users/cn/jespinosa/phecomp/data/CRG/20120502_FDF_CRG/20120502_FDF_CRG/20120511_FDF_CRG_c12.mtb	1839	46	WWSS	food_sc	3	158205	1336889070	1	0.0800000000000001	0.000625000000000001	3371	1
1	Drink 1	Intake 1	15	158353	1336889218	/users/cn/jespinosa/phecomp/data/CRG/20120502_FDF_CRG/20120502_FDF_CRG/20120511_FDF_CRG_c12.mtb	1998	NA	WWSS	water	1	158338	1336889203	1	0.04	0.00266666666666667	3372	1
1	Food 1	Intake 3	178	158557	1336889422	/users/cn/jespinosa/phecomp/data/CRG/20120502_FDF_CRG/20120502_FDF_CRG/20120511_FDF_CRG_c12.mtb	1840	204	WWSS	food_sc	3	158379	1336889244	1	0.04	0.000224719101123596	3373	1
1	Drink 1	Intake 1	39	158601	1336889466	/users/cn/jespinosa/phecomp/data/CRG/20120502_FDF_CRG/20120502_FDF_CRG/20120511_FDF_CRG_c12.mtb	1999	NA	WWSS	water	1	158562	1336889427	1	0.04	0.00102564102564103	3374	1
1	Drink 1	Intake 1	31	158669	1336889534	/users/cn/jespinosa/phecomp/data/CRG/20120502_FDF_CRG/20120502_FDF_CRG/20120511_FDF_CRG_c12.mtb	2000	NA	WWSS	water	1	158638	1336889503	1	0.02	0.000645161290322581	3375	1
1	Food 1	Intake 3	197	158958	1336889823	/users/cn/jespinosa/phecomp/data/CRG/20120502_FDF_CRG/20120502_FDF_CRG/20120511_FDF_CRG_c12.mtb	1842	27	WWSS	food_sc	3	158761	1336889626	1	0.0600000000000001	0.000304568527918782	3376	1
1	Drink 1	Intake 1	20	158972	1336889837	/users/cn/jespinosa/phecomp/data/CRG/20120502_FDF_CRG/20120502_FDF_CRG/20120511_FDF_CRG_c12.mtb	2001	NA	WWSS	water	1	158952	1336889817	1	0.02	0.001	3377	1
1	Food 1	Intake 3	351	159336	1336890201	/users/cn/jespinosa/phecomp/data/CRG/20120502_FDF_CRG/20120502_FDF_CRG/20120511_FDF_CRG_c12.mtb	1843	634	WWSS	food_sc	3	158985	1336889850	1	0.0600000000000001	0.000170940170940171	3378	1
1	Drink 1	Intake 1	18	159550	1336890415	/users/cn/jespinosa/phecomp/data/CRG/20120502_FDF_CRG/20120502_FDF_CRG/20120511_FDF_CRG_c12.mtb	2002	NA	WWSS	water	1	159532	1336890397	1	0.02	0.00111111111111111	3379	1
1	Food 1	Intake 3	121	160091	1336890956	/users/cn/jespinosa/phecomp/data/CRG/20120502_FDF_CRG/20120502_FDF_CRG/20120511_FDF_CRG_c12.mtb	1845	17497	WWSS	food_sc	3	159970	1336890835	1	0.02	0.000165289256198347	3380	1
1	Drink 2	Intake 2	15	160519	1336891384	/users/cn/jespinosa/phecomp/data/CRG/20120502_FDF_CRG/20120502_FDF_CRG/20120511_FDF_CRG_c12.mtb	947	NA	WWSS	water	2	160504	1336891369	1	0.02	0.00133333333333333	3381	1
1	Drink 1	Intake 1	20	168802	1336899667	/users/cn/jespinosa/phecomp/data/CRG/20120502_FDF_CRG/20120502_FDF_CRG/20120511_FDF_CRG_c12.mtb	2004	NA	WWSS	water	1	168782	1336899647	1	0.0600000000000001	0.00300000000000001	3382	1
1	Food 1	Intake 3	16	177604	1336908469	/users/cn/jespinosa/phecomp/data/CRG/20120502_FDF_CRG/20120502_FDF_CRG/20120511_FDF_CRG_c12.mtb	1851	3408	WWSS	food_sc	3	177588	1336908453	1	0.02	0.00125	3383	1
1	Food 2	Intake 4	15	181027	1336911892	/users/cn/jespinosa/phecomp/data/CRG/20120502_FDF_CRG/20120502_FDF_CRG/20120511_FDF_CRG_c12.mtb	2537	9673	WWSS	food_sc	4	181012	1336911877	1	0.0200000000000005	0.00133333333333337	3384	1
1	Food 2	Intake 4	9	190709	1336921574	/users/cn/jespinosa/phecomp/data/CRG/20120502_FDF_CRG/20120502_FDF_CRG/20120511_FDF_CRG_c12.mtb	2540	110	WWSS	food_sc	4	190700	1336921565	1	0.0200000000000005	0.00222222222222228	3385	1
1	Food 2	Intake 4	46	190865	1336921730	/users/cn/jespinosa/phecomp/data/CRG/20120502_FDF_CRG/20120502_FDF_CRG/20120511_FDF_CRG_c12.mtb	2542	3533	WWSS	food_sc	4	190819	1336921684	1	0.04	0.000869565217391304	3386	1
1	Drink 2	Intake 2	17	191300	1336922165	/users/cn/jespinosa/phecomp/data/CRG/20120502_FDF_CRG/20120502_FDF_CRG/20120511_FDF_CRG_c12.mtb	948	NA	WWSS	water	2	191283	1336922148	1	0.0600000000000001	0.00352941176470589	3387	1
1	Food 2	Intake 4	65	194463	1336925328	/users/cn/jespinosa/phecomp/data/CRG/20120502_FDF_CRG/20120502_FDF_CRG/20120511_FDF_CRG_c12.mtb	2544	106	WWSS	food_sc	4	194398	1336925263	1	0.0600000000000005	0.000923076923076931	3388	1
1	Food 2	Intake 4	47	194616	1336925481	/users/cn/jespinosa/phecomp/data/CRG/20120502_FDF_CRG/20120502_FDF_CRG/20120511_FDF_CRG_c12.mtb	2546	3079	WWSS	food_sc	4	194569	1336925434	1	0.04	0.000851063829787234	3389	1
1	Drink 2	Intake 2	20	196151	1336927016	/users/cn/jespinosa/phecomp/data/CRG/20120502_FDF_CRG/20120502_FDF_CRG/20120511_FDF_CRG_c12.mtb	949	NA	WWSS	water	2	196131	1336926996	1	0.1	0.005	3390	1
1	Food 2	Intake 4	41	197736	1336928601	/users/cn/jespinosa/phecomp/data/CRG/20120502_FDF_CRG/20120502_FDF_CRG/20120511_FDF_CRG_c12.mtb	2547	41	WWSS	food_sc	4	197695	1336928560	1	0.0200000000000005	0.000487804878048793	3391	1
1	Food 2	Intake 4	69	197846	1336928711	/users/cn/jespinosa/phecomp/data/CRG/20120502_FDF_CRG/20120502_FDF_CRG/20120511_FDF_CRG_c12.mtb	2548	60	WWSS	food_sc	4	197777	1336928642	1	0.0599999999999996	0.000869565217391299	3392	1
1	Food 2	Intake 4	25	197931	1336928796	/users/cn/jespinosa/phecomp/data/CRG/20120502_FDF_CRG/20120502_FDF_CRG/20120511_FDF_CRG_c12.mtb	2549	65	WWSS	food_sc	4	197906	1336928771	1	0.0200000000000005	0.00080000000000002	3393	1
1	Food 2	Intake 4	38	198034	1336928899	/users/cn/jespinosa/phecomp/data/CRG/20120502_FDF_CRG/20120502_FDF_CRG/20120511_FDF_CRG_c12.mtb	2551	1772	WWSS	food_sc	4	197996	1336928861	1	0.0200000000000005	0.000526315789473697	3394	1
1	Food 2	Intake 4	68	199874	1336930739	/users/cn/jespinosa/phecomp/data/CRG/20120502_FDF_CRG/20120502_FDF_CRG/20120511_FDF_CRG_c12.mtb	2552	19	WWSS	food_sc	4	199806	1336930671	1	0.0399999999999991	0.000588235294117634	3395	1
1	Food 2	Intake 4	95	199988	1336930853	/users/cn/jespinosa/phecomp/data/CRG/20120502_FDF_CRG/20120502_FDF_CRG/20120511_FDF_CRG_c12.mtb	2553	2341	WWSS	food_sc	4	199893	1336930758	1	0.100000000000001	0.00105263157894738	3396	1
1	Drink 1	Intake 1	16	200075	1336930940	/users/cn/jespinosa/phecomp/data/CRG/20120502_FDF_CRG/20120502_FDF_CRG/20120511_FDF_CRG_c12.mtb	2007	NA	WWSS	water	1	200059	1336930924	1	0.02	0.00125	3397	1
1	Food 2	Intake 4	18	202347	1336933212	/users/cn/jespinosa/phecomp/data/CRG/20120502_FDF_CRG/20120502_FDF_CRG/20120511_FDF_CRG_c12.mtb	2555	212	WWSS	food_sc	4	202329	1336933194	1	0.42	0.0233333333333333	3398	1
1	Food 2	Intake 4	55	202614	1336933479	/users/cn/jespinosa/phecomp/data/CRG/20120502_FDF_CRG/20120502_FDF_CRG/20120511_FDF_CRG_c12.mtb	2557	479	WWSS	food_sc	4	202559	1336933424	1	0.0200000000000005	0.000363636363636373	3399	1
1	Food 1	Intake 3	129	203222	1336934087	/users/cn/jespinosa/phecomp/data/CRG/20120502_FDF_CRG/20120502_FDF_CRG/20120511_FDF_CRG_c12.mtb	1855	90	WWSS	food_sc	3	203093	1336933958	1	0.0600000000000001	0.000465116279069768	3400	1
1	Food 1	Intake 3	87	203399	1336934264	/users/cn/jespinosa/phecomp/data/CRG/20120502_FDF_CRG/20120502_FDF_CRG/20120511_FDF_CRG_c12.mtb	1856	512	WWSS	food_sc	3	203312	1336934177	1	0.02	0.000229885057471264	3401	1
1	Drink 2	Intake 2	24	203532	1336934397	/users/cn/jespinosa/phecomp/data/CRG/20120502_FDF_CRG/20120502_FDF_CRG/20120511_FDF_CRG_c12.mtb	952	NA	WWSS	water	2	203508	1336934373	1	0.0800000000000001	0.00333333333333334	3402	1
1	Food 1	Intake 3	44	203955	1336934820	/users/cn/jespinosa/phecomp/data/CRG/20120502_FDF_CRG/20120502_FDF_CRG/20120511_FDF_CRG_c12.mtb	1859	47	WWSS	food_sc	3	203911	1336934776	1	0.02	0.000454545454545455	3403	1
1	Food 1	Intake 3	67	204069	1336934934	/users/cn/jespinosa/phecomp/data/CRG/20120502_FDF_CRG/20120502_FDF_CRG/20120511_FDF_CRG_c12.mtb	1860	60	WWSS	food_sc	3	204002	1336934867	1	0.02	0.000298507462686567	3404	1
1	Food 1	Intake 3	102	204231	1336935096	/users/cn/jespinosa/phecomp/data/CRG/20120502_FDF_CRG/20120502_FDF_CRG/20120511_FDF_CRG_c12.mtb	1862	829	WWSS	food_sc	3	204129	1336934994	1	0.02	0.000196078431372549	3405	1
1	Drink 1	Intake 1	19	204339	1336935204	/users/cn/jespinosa/phecomp/data/CRG/20120502_FDF_CRG/20120502_FDF_CRG/20120511_FDF_CRG_c12.mtb	2009	NA	WWSS	water	1	204320	1336935185	1	0.02	0.00105263157894737	3406	1
1	Drink 2	Intake 2	32	204605	1336935470	/users/cn/jespinosa/phecomp/data/CRG/20120502_FDF_CRG/20120502_FDF_CRG/20120511_FDF_CRG_c12.mtb	954	NA	WWSS	water	2	204573	1336935438	1	0.1	0.003125	3407	1
1	Food 1	Intake 3	68	205128	1336935993	/users/cn/jespinosa/phecomp/data/CRG/20120502_FDF_CRG/20120502_FDF_CRG/20120511_FDF_CRG_c12.mtb	1866	20	WWSS	food_sc	3	205060	1336935925	1	0.0600000000000001	0.000882352941176472	3408	1
1	Food 1	Intake 3	9	205157	1336936022	/users/cn/jespinosa/phecomp/data/CRG/20120502_FDF_CRG/20120502_FDF_CRG/20120511_FDF_CRG_c12.mtb	1867	32	WWSS	food_sc	3	205148	1336936013	1	0.02	0.00222222222222222	3409	1
1	Food 1	Intake 3	13	205202	1336936067	/users/cn/jespinosa/phecomp/data/CRG/20120502_FDF_CRG/20120502_FDF_CRG/20120511_FDF_CRG_c12.mtb	1868	157	WWSS	food_sc	3	205189	1336936054	1	0.02	0.00153846153846154	3410	1
1	Food 1	Intake 3	194	205553	1336936418	/users/cn/jespinosa/phecomp/data/CRG/20120502_FDF_CRG/20120502_FDF_CRG/20120511_FDF_CRG_c12.mtb	1871	32	WWSS	food_sc	3	205359	1336936224	1	0.0600000000000001	0.000309278350515464	3411	1
1	Food 1	Intake 3	76	205661	1336936526	/users/cn/jespinosa/phecomp/data/CRG/20120502_FDF_CRG/20120502_FDF_CRG/20120511_FDF_CRG_c12.mtb	1872	14	WWSS	food_sc	3	205585	1336936450	1	0.02	0.000263157894736842	3412	1
1	Food 1	Intake 3	17	205692	1336936557	/users/cn/jespinosa/phecomp/data/CRG/20120502_FDF_CRG/20120502_FDF_CRG/20120511_FDF_CRG_c12.mtb	1873	2116	WWSS	food_sc	3	205675	1336936540	1	0.02	0.00117647058823529	3413	1
1	Drink 2	Intake 2	33	205899	1336936764	/users/cn/jespinosa/phecomp/data/CRG/20120502_FDF_CRG/20120502_FDF_CRG/20120511_FDF_CRG_c12.mtb	955	NA	WWSS	water	2	205866	1336936731	1	0.0799999999999996	0.00242424242424241	3414	1
1	Drink 2	Intake 2	17	207515	1336938380	/users/cn/jespinosa/phecomp/data/CRG/20120502_FDF_CRG/20120502_FDF_CRG/20120511_FDF_CRG_c12.mtb	956	NA	WWSS	water	2	207498	1336938363	1	0.02	0.00117647058823529	3415	1
1	Drink 2	Intake 2	18	207716	1336938581	/users/cn/jespinosa/phecomp/data/CRG/20120502_FDF_CRG/20120502_FDF_CRG/20120511_FDF_CRG_c12.mtb	957	NA	WWSS	water	2	207698	1336938563	1	0.04	0.00222222222222222	3416	1
1	Food 1	Intake 3	73	207881	1336938746	/users/cn/jespinosa/phecomp/data/CRG/20120502_FDF_CRG/20120502_FDF_CRG/20120511_FDF_CRG_c12.mtb	1875	73	WWSS	food_sc	3	207808	1336938673	1	0.04	0.000547945205479452	3417	1
1	Food 1	Intake 3	120	208074	1336938939	/users/cn/jespinosa/phecomp/data/CRG/20120502_FDF_CRG/20120502_FDF_CRG/20120511_FDF_CRG_c12.mtb	1877	3446	WWSS	food_sc	3	207954	1336938819	1	0.04	0.000333333333333333	3418	1
1	Drink 1	Intake 1	20	210247	1336941112	/users/cn/jespinosa/phecomp/data/CRG/20120502_FDF_CRG/20120502_FDF_CRG/20120511_FDF_CRG_c12.mtb	2013	NA	WWSS	water	1	210227	1336941092	1	0.0399999999999998	0.00199999999999999	3419	1
1	Food 1	Intake 3	39	211559	1336942424	/users/cn/jespinosa/phecomp/data/CRG/20120502_FDF_CRG/20120502_FDF_CRG/20120511_FDF_CRG_c12.mtb	1880	68	WWSS	food_sc	3	211520	1336942385	1	0.04	0.00102564102564103	3420	1
1	Food 1	Intake 3	49	211676	1336942541	/users/cn/jespinosa/phecomp/data/CRG/20120502_FDF_CRG/20120502_FDF_CRG/20120511_FDF_CRG_c12.mtb	1881	317	WWSS	food_sc	3	211627	1336942492	1	0.0600000000000001	0.00122448979591837	3421	1
1	Drink 2	Intake 2	20	211708	1336942573	/users/cn/jespinosa/phecomp/data/CRG/20120502_FDF_CRG/20120502_FDF_CRG/20120511_FDF_CRG_c12.mtb	960	NA	WWSS	water	2	211688	1336942553	1	0.04	0.002	3422	1
1	Food 1	Intake 3	94	212087	1336942952	/users/cn/jespinosa/phecomp/data/CRG/20120502_FDF_CRG/20120502_FDF_CRG/20120511_FDF_CRG_c12.mtb	1885	405	WWSS	food_sc	3	211993	1336942858	1	0.02	0.000212765957446809	3423	1
1	Drink 2	Intake 2	22	212098	1336942963	/users/cn/jespinosa/phecomp/data/CRG/20120502_FDF_CRG/20120502_FDF_CRG/20120511_FDF_CRG_c12.mtb	961	NA	WWSS	water	2	212076	1336942941	1	0.0999999999999996	0.00454545454545453	3424	1
1	Food 1	Intake 3	121	212613	1336943478	/users/cn/jespinosa/phecomp/data/CRG/20120502_FDF_CRG/20120502_FDF_CRG/20120511_FDF_CRG_c12.mtb	1889	19	WWSS	food_sc	3	212492	1336943357	1	0.02	0.000165289256198347	3425	1
1	Food 1	Intake 3	170	212802	1336943667	/users/cn/jespinosa/phecomp/data/CRG/20120502_FDF_CRG/20120502_FDF_CRG/20120511_FDF_CRG_c12.mtb	1890	14	WWSS	food_sc	3	212632	1336943497	1	0.0399999999999996	0.000235294117647056	3426	1
1	Food 1	Intake 3	105	212921	1336943786	/users/cn/jespinosa/phecomp/data/CRG/20120502_FDF_CRG/20120502_FDF_CRG/20120511_FDF_CRG_c12.mtb	1891	425	WWSS	food_sc	3	212816	1336943681	1	0.0600000000000005	0.000571428571428576	3427	1
1	Drink 2	Intake 2	34	212949	1336943814	/users/cn/jespinosa/phecomp/data/CRG/20120502_FDF_CRG/20120502_FDF_CRG/20120511_FDF_CRG_c12.mtb	963	NA	WWSS	water	2	212915	1336943780	1	0.100000000000001	0.00294117647058826	3428	1
1	Food 1	Intake 3	105	213451	1336944316	/users/cn/jespinosa/phecomp/data/CRG/20120502_FDF_CRG/20120502_FDF_CRG/20120511_FDF_CRG_c12.mtb	1894	985	WWSS	food_sc	3	213346	1336944211	1	0.02	0.00019047619047619	3429	1
1	Drink 2	Intake 2	24	213759	1336944624	/users/cn/jespinosa/phecomp/data/CRG/20120502_FDF_CRG/20120502_FDF_CRG/20120511_FDF_CRG_c12.mtb	966	NA	WWSS	water	2	213735	1336944600	1	0.0600000000000005	0.00250000000000002	3430	1
1	Food 1	Intake 3	53	214489	1336945354	/users/cn/jespinosa/phecomp/data/CRG/20120502_FDF_CRG/20120502_FDF_CRG/20120511_FDF_CRG_c12.mtb	1900	21	WWSS	food_sc	3	214436	1336945301	1	0.02	0.000377358490566038	3431	1
1	Food 1	Intake 3	149	214659	1336945524	/users/cn/jespinosa/phecomp/data/CRG/20120502_FDF_CRG/20120502_FDF_CRG/20120511_FDF_CRG_c12.mtb	1901	559	WWSS	food_sc	3	214510	1336945375	1	0.02	0.000134228187919463	3432	1
1	Food 1	Intake 3	150	215368	1336946233	/users/cn/jespinosa/phecomp/data/CRG/20120502_FDF_CRG/20120502_FDF_CRG/20120511_FDF_CRG_c12.mtb	1903	531	WWSS	food_sc	3	215218	1336946083	1	0.0800000000000001	0.000533333333333334	3433	1
1	Drink 2	Intake 2	21	215387	1336946252	/users/cn/jespinosa/phecomp/data/CRG/20120502_FDF_CRG/20120502_FDF_CRG/20120511_FDF_CRG_c12.mtb	968	NA	WWSS	water	2	215366	1336946231	1	0.04	0.0019047619047619	3434	1
1	Drink 2	Intake 2	30	215445	1336946310	/users/cn/jespinosa/phecomp/data/CRG/20120502_FDF_CRG/20120502_FDF_CRG/20120511_FDF_CRG_c12.mtb	969	NA	WWSS	water	2	215415	1336946280	1	0.04	0.00133333333333333	3435	1
1	Food 2	Intake 4	141	216040	1336946905	/users/cn/jespinosa/phecomp/data/CRG/20120502_FDF_CRG/20120502_FDF_CRG/20120511_FDF_CRG_c12.mtb	2613	537	WWSS	food_sc	4	215899	1336946764	1	0.04	0.000283687943262411	3436	1
1	Drink 2	Intake 2	17	216058	1336946923	/users/cn/jespinosa/phecomp/data/CRG/20120502_FDF_CRG/20120502_FDF_CRG/20120511_FDF_CRG_c12.mtb	970	NA	WWSS	water	2	216041	1336946906	1	0.04	0.00235294117647059	3437	1
1	Food 2	Intake 4	23	216600	1336947465	/users/cn/jespinosa/phecomp/data/CRG/20120502_FDF_CRG/20120502_FDF_CRG/20120511_FDF_CRG_c12.mtb	2615	218	WWSS	food_sc	4	216577	1336947442	1	0.0200000000000005	0.000869565217391326	3438	1
1	Food 1	Intake 3	141	216959	1336947824	/users/cn/jespinosa/phecomp/data/CRG/20120502_FDF_CRG/20120502_FDF_CRG/20120511_FDF_CRG_c12.mtb	1907	88	WWSS	food_sc	3	216818	1336947683	1	0.02	0.000141843971631206	3439	1
1	Food 1	Intake 3	18	217065	1336947930	/users/cn/jespinosa/phecomp/data/CRG/20120502_FDF_CRG/20120502_FDF_CRG/20120511_FDF_CRG_c12.mtb	1908	493	WWSS	food_sc	3	217047	1336947912	1	0.02	0.00111111111111111	3440	1
1	Food 2	Intake 4	26	217584	1336948449	/users/cn/jespinosa/phecomp/data/CRG/20120502_FDF_CRG/20120502_FDF_CRG/20120511_FDF_CRG_c12.mtb	2619	859	WWSS	food_sc	4	217558	1336948423	1	0.359999999999999	0.0138461538461538	3441	1
1	Food 2	Intake 4	72	218515	1336949380	/users/cn/jespinosa/phecomp/data/CRG/20120502_FDF_CRG/20120502_FDF_CRG/20120511_FDF_CRG_c12.mtb	2623	46	WWSS	food_sc	4	218443	1336949308	1	0.0200000000000005	0.000277777777777785	3442	1
1	Food 2	Intake 4	68	218629	1336949494	/users/cn/jespinosa/phecomp/data/CRG/20120502_FDF_CRG/20120502_FDF_CRG/20120511_FDF_CRG_c12.mtb	2624	5541	WWSS	food_sc	4	218561	1336949426	1	0.0200000000000005	0.000294117647058831	3443	1
1	Drink 1	Intake 1	20	218992	1336949857	/users/cn/jespinosa/phecomp/data/CRG/20120502_FDF_CRG/20120502_FDF_CRG/20120511_FDF_CRG_c12.mtb	2022	NA	WWSS	water	1	218972	1336949837	1	0.04	0.002	3444	1
1	Drink 2	Intake 2	15	218996	1336949861	/users/cn/jespinosa/phecomp/data/CRG/20120502_FDF_CRG/20120502_FDF_CRG/20120511_FDF_CRG_c12.mtb	974	NA	WWSS	water	2	218981	1336949846	1	0.0200000000000005	0.00133333333333337	3445	1
1	Drink 2	Intake 2	29	219058	1336949923	/users/cn/jespinosa/phecomp/data/CRG/20120502_FDF_CRG/20120502_FDF_CRG/20120511_FDF_CRG_c12.mtb	975	NA	WWSS	water	2	219029	1336949894	1	0.04	0.00137931034482759	3446	1
1	Food 2	Intake 4	34	224204	1336955069	/users/cn/jespinosa/phecomp/data/CRG/20120502_FDF_CRG/20120502_FDF_CRG/20120511_FDF_CRG_c12.mtb	2628	16	WWSS	food_sc	4	224170	1336955035	1	0.04	0.00117647058823529	3447	1
1	Food 2	Intake 4	100	224320	1336955185	/users/cn/jespinosa/phecomp/data/CRG/20120502_FDF_CRG/20120502_FDF_CRG/20120511_FDF_CRG_c12.mtb	2629	15	WWSS	food_sc	4	224220	1336955085	1	0.0999999999999996	0.000999999999999996	3448	1
1	Food 1	Intake 3	101	224436	1336955301	/users/cn/jespinosa/phecomp/data/CRG/20120502_FDF_CRG/20120502_FDF_CRG/20120511_FDF_CRG_c12.mtb	1918	104	WWSS	food_sc	3	224335	1336955200	1	0.04	0.000396039603960396	3449	1
1	Drink 2	Intake 2	12	224442	1336955307	/users/cn/jespinosa/phecomp/data/CRG/20120502_FDF_CRG/20120502_FDF_CRG/20120511_FDF_CRG_c12.mtb	976	NA	WWSS	water	2	224430	1336955295	1	0.04	0.00333333333333333	3450	1
1	Food 1	Intake 3	121	224661	1336955526	/users/cn/jespinosa/phecomp/data/CRG/20120502_FDF_CRG/20120502_FDF_CRG/20120511_FDF_CRG_c12.mtb	1920	164	WWSS	food_sc	3	224540	1336955405	1	0.0600000000000005	0.000495867768595045	3451	1
1	Drink 1	Intake 1	21	224718	1336955583	/users/cn/jespinosa/phecomp/data/CRG/20120502_FDF_CRG/20120502_FDF_CRG/20120511_FDF_CRG_c12.mtb	2023	NA	WWSS	water	1	224697	1336955562	1	0.02	0.000952380952380952	3452	1
1	Food 2	Intake 4	89	224914	1336955779	/users/cn/jespinosa/phecomp/data/CRG/20120502_FDF_CRG/20120502_FDF_CRG/20120511_FDF_CRG_c12.mtb	2635	480	WWSS	food_sc	4	224825	1336955690	1	0.0200000000000005	0.000224719101123601	3453	1
1	Drink 2	Intake 2	26	224934	1336955799	/users/cn/jespinosa/phecomp/data/CRG/20120502_FDF_CRG/20120502_FDF_CRG/20120511_FDF_CRG_c12.mtb	978	NA	WWSS	water	2	224908	1336955773	1	0.0800000000000001	0.00307692307692308	3454	1
1	Drink 1	Intake 1	19	225366	1336956231	/users/cn/jespinosa/phecomp/data/CRG/20120502_FDF_CRG/20120502_FDF_CRG/20120511_FDF_CRG_c12.mtb	2025	NA	WWSS	water	1	225347	1336956212	1	0.02	0.00105263157894737	3455	1
1	Food 2	Intake 4	103	225497	1336956362	/users/cn/jespinosa/phecomp/data/CRG/20120502_FDF_CRG/20120502_FDF_CRG/20120511_FDF_CRG_c12.mtb	2638	61	WWSS	food_sc	4	225394	1336956259	1	0.0200000000000005	0.000194174757281558	3456	1
1	Drink 2	Intake 2	21	225538	1336956403	/users/cn/jespinosa/phecomp/data/CRG/20120502_FDF_CRG/20120502_FDF_CRG/20120511_FDF_CRG_c12.mtb	981	NA	WWSS	water	2	225517	1336956382	1	0.0599999999999996	0.00285714285714284	3457	1
1	Food 2	Intake 4	88	225646	1336956511	/users/cn/jespinosa/phecomp/data/CRG/20120502_FDF_CRG/20120502_FDF_CRG/20120511_FDF_CRG_c12.mtb	2639	245	WWSS	food_sc	4	225558	1336956423	1	0.04	0.000454545454545455	3458	1
1	Food 1	Intake 3	147	226038	1336956903	/users/cn/jespinosa/phecomp/data/CRG/20120502_FDF_CRG/20120502_FDF_CRG/20120511_FDF_CRG_c12.mtb	1928	645	WWSS	food_sc	3	225891	1336956756	1	0.04	0.000272108843537415	3459	1
1	Drink 1	Intake 1	17	226055	1336956920	/users/cn/jespinosa/phecomp/data/CRG/20120502_FDF_CRG/20120502_FDF_CRG/20120511_FDF_CRG_c12.mtb	2026	NA	WWSS	water	1	226038	1336956903	1	0.0399999999999998	0.00235294117647058	3460	1
1	Food 1	Intake 3	80	226763	1336957628	/users/cn/jespinosa/phecomp/data/CRG/20120502_FDF_CRG/20120502_FDF_CRG/20120511_FDF_CRG_c12.mtb	1929	145	WWSS	food_sc	3	226683	1336957548	1	0.0200000000000005	0.000250000000000006	3461	1
1	Drink 2	Intake 2	22	226883	1336957748	/users/cn/jespinosa/phecomp/data/CRG/20120502_FDF_CRG/20120502_FDF_CRG/20120511_FDF_CRG_c12.mtb	984	NA	WWSS	water	2	226861	1336957726	1	0.04	0.00181818181818182	3462	1
1	Drink 1	Intake 1	20	226889	1336957754	/users/cn/jespinosa/phecomp/data/CRG/20120502_FDF_CRG/20120502_FDF_CRG/20120511_FDF_CRG_c12.mtb	2028	NA	WWSS	water	1	226869	1336957734	1	0.02	0.001	3463	1
1	Food 1	Intake 3	68	226976	1336957841	/users/cn/jespinosa/phecomp/data/CRG/20120502_FDF_CRG/20120502_FDF_CRG/20120511_FDF_CRG_c12.mtb	1931	5390	WWSS	food_sc	3	226908	1336957773	1	0.0200000000000005	0.000294117647058831	3464	1
1	Drink 2	Intake 2	24	227002	1336957867	/users/cn/jespinosa/phecomp/data/CRG/20120502_FDF_CRG/20120502_FDF_CRG/20120511_FDF_CRG_c12.mtb	985	NA	WWSS	water	2	226978	1336957843	1	0.04	0.00166666666666667	3465	1
1	Food 1	Intake 3	28	232394	1336963259	/users/cn/jespinosa/phecomp/data/CRG/20120502_FDF_CRG/20120502_FDF_CRG/20120511_FDF_CRG_c12.mtb	1932	15	WWSS	food_sc	3	232366	1336963231	1	0.04	0.00142857142857143	3466	1
1	Food 1	Intake 3	12	232421	1336963286	/users/cn/jespinosa/phecomp/data/CRG/20120502_FDF_CRG/20120502_FDF_CRG/20120511_FDF_CRG_c12.mtb	1933	41	WWSS	food_sc	3	232409	1336963274	1	0.04	0.00333333333333333	3467	1
1	Food 1	Intake 3	9	232471	1336963336	/users/cn/jespinosa/phecomp/data/CRG/20120502_FDF_CRG/20120502_FDF_CRG/20120511_FDF_CRG_c12.mtb	1935	27	WWSS	food_sc	3	232462	1336963327	1	0.04	0.00444444444444444	3468	1
1	Food 1	Intake 3	8	232506	1336963371	/users/cn/jespinosa/phecomp/data/CRG/20120502_FDF_CRG/20120502_FDF_CRG/20120511_FDF_CRG_c12.mtb	1936	17	WWSS	food_sc	3	232498	1336963363	1	0.0200000000000005	0.00250000000000006	3469	1
1	Food 1	Intake 3	25	232548	1336963413	/users/cn/jespinosa/phecomp/data/CRG/20120502_FDF_CRG/20120502_FDF_CRG/20120511_FDF_CRG_c12.mtb	1937	2947	WWSS	food_sc	3	232523	1336963388	1	0.04	0.0016	3470	1
1	Food 1	Intake 3	24	235519	1336966384	/users/cn/jespinosa/phecomp/data/CRG/20120502_FDF_CRG/20120502_FDF_CRG/20120511_FDF_CRG_c12.mtb	1939	1712	WWSS	food_sc	3	235495	1336966360	1	0.04	0.00166666666666667	3471	1
1	Food 1	Intake 3	55	237286	1336968151	/users/cn/jespinosa/phecomp/data/CRG/20120502_FDF_CRG/20120502_FDF_CRG/20120511_FDF_CRG_c12.mtb	1941	239	WWSS	food_sc	3	237231	1336968096	1	0.0600000000000005	0.0010909090909091	3472	1
1	Food 1	Intake 3	118	237643	1336968508	/users/cn/jespinosa/phecomp/data/CRG/20120502_FDF_CRG/20120502_FDF_CRG/20120511_FDF_CRG_c12.mtb	1945	1822	WWSS	food_sc	3	237525	1336968390	1	0.04	0.000338983050847458	3473	1
1	Drink 2	Intake 2	29	237665	1336968530	/users/cn/jespinosa/phecomp/data/CRG/20120502_FDF_CRG/20120502_FDF_CRG/20120511_FDF_CRG_c12.mtb	986	NA	WWSS	water	2	237636	1336968501	1	0.0600000000000005	0.0020689655172414	3474	1
1	Drink 2	Intake 2	17	238554	1336969419	/users/cn/jespinosa/phecomp/data/CRG/20120502_FDF_CRG/20120502_FDF_CRG/20120511_FDF_CRG_c12.mtb	987	NA	WWSS	water	2	238537	1336969402	1	0.0599999999999996	0.00352941176470586	3475	1
1	Food 2	Intake 4	88	239553	1336970418	/users/cn/jespinosa/phecomp/data/CRG/20120502_FDF_CRG/20120502_FDF_CRG/20120511_FDF_CRG_c12.mtb	2651	171	WWSS	food_sc	4	239465	1336970330	1	0.0200000000000005	0.000227272727272733	3476	1
1	Food 1	Intake 3	110	239834	1336970699	/users/cn/jespinosa/phecomp/data/CRG/20120502_FDF_CRG/20120502_FDF_CRG/20120511_FDF_CRG_c12.mtb	1949	157	WWSS	food_sc	3	239724	1336970589	1	0.04	0.000363636363636364	3477	1
1	Drink 2	Intake 2	24	239999	1336970864	/users/cn/jespinosa/phecomp/data/CRG/20120502_FDF_CRG/20120502_FDF_CRG/20120511_FDF_CRG_c12.mtb	988	NA	WWSS	water	2	239975	1336970840	1	0.0800000000000001	0.00333333333333334	3478	1
1	Food 2	Intake 4	104	240095	1336970960	/users/cn/jespinosa/phecomp/data/CRG/20120502_FDF_CRG/20120502_FDF_CRG/20120511_FDF_CRG_c12.mtb	2656	323	WWSS	food_sc	4	239991	1336970856	1	0.34	0.00326923076923077	3479	1
1	Drink 2	Intake 2	30	240384	1336971249	/users/cn/jespinosa/phecomp/data/CRG/20120502_FDF_CRG/20120502_FDF_CRG/20120511_FDF_CRG_c12.mtb	989	NA	WWSS	water	2	240354	1336971219	1	0.0600000000000005	0.00200000000000002	3480	1
1	Food 1	Intake 3	55	240473	1336971338	/users/cn/jespinosa/phecomp/data/CRG/20120502_FDF_CRG/20120502_FDF_CRG/20120511_FDF_CRG_c12.mtb	1953	423	WWSS	food_sc	3	240418	1336971283	1	0.0800000000000001	0.00145454545454546	3481	1
1	Drink 2	Intake 2	23	240534	1336971399	/users/cn/jespinosa/phecomp/data/CRG/20120502_FDF_CRG/20120502_FDF_CRG/20120511_FDF_CRG_c12.mtb	990	NA	WWSS	water	2	240511	1336971376	1	0.0399999999999991	0.00173913043478257	3482	1
1	Food 2	Intake 4	47	240943	1336971808	/users/cn/jespinosa/phecomp/data/CRG/20120502_FDF_CRG/20120502_FDF_CRG/20120511_FDF_CRG_c12.mtb	2664	402	WWSS	food_sc	4	240896	1336971761	1	0.0200000000000005	0.000425531914893628	3483	1
1	Drink 2	Intake 2	25	240970	1336971835	/users/cn/jespinosa/phecomp/data/CRG/20120502_FDF_CRG/20120502_FDF_CRG/20120511_FDF_CRG_c12.mtb	991	NA	WWSS	water	2	240945	1336971810	1	0.100000000000001	0.00400000000000004	3484	1
1	Food 1	Intake 3	78	241423	1336972288	/users/cn/jespinosa/phecomp/data/CRG/20120502_FDF_CRG/20120502_FDF_CRG/20120511_FDF_CRG_c12.mtb	1957	21	WWSS	food_sc	3	241345	1336972210	1	0.04	0.000512820512820513	3485	1
1	Food 1	Intake 3	160	241604	1336972469	/users/cn/jespinosa/phecomp/data/CRG/20120502_FDF_CRG/20120502_FDF_CRG/20120511_FDF_CRG_c12.mtb	1958	513	WWSS	food_sc	3	241444	1336972309	1	0.04	0.00025	3486	1
1	Drink 2	Intake 2	18	242059	1336972924	/users/cn/jespinosa/phecomp/data/CRG/20120502_FDF_CRG/20120502_FDF_CRG/20120511_FDF_CRG_c12.mtb	992	NA	WWSS	water	2	242041	1336972906	1	0.04	0.00222222222222222	3487	1
1	Food 1	Intake 3	136	242253	1336973118	/users/cn/jespinosa/phecomp/data/CRG/20120502_FDF_CRG/20120502_FDF_CRG/20120511_FDF_CRG_c12.mtb	1961	4	WWSS	food_sc	3	242117	1336972982	1	0.04	0.000294117647058824	3488	1
1	Food 1	Intake 3	193	242450	1336973315	/users/cn/jespinosa/phecomp/data/CRG/20120502_FDF_CRG/20120502_FDF_CRG/20120511_FDF_CRG_c12.mtb	1962	27	WWSS	food_sc	3	242257	1336973122	1	0.04	0.000207253886010363	3489	1
1	Food 1	Intake 3	79	242556	1336973421	/users/cn/jespinosa/phecomp/data/CRG/20120502_FDF_CRG/20120502_FDF_CRG/20120511_FDF_CRG_c12.mtb	1963	540	WWSS	food_sc	3	242477	1336973342	1	0.0200000000000005	0.000253164556962032	3490	1
1	Drink 2	Intake 2	29	242785	1336973650	/users/cn/jespinosa/phecomp/data/CRG/20120502_FDF_CRG/20120502_FDF_CRG/20120511_FDF_CRG_c12.mtb	993	NA	WWSS	water	2	242756	1336973621	1	0.0999999999999996	0.00344827586206895	3491	1
1	Food 2	Intake 4	78	243174	1336974039	/users/cn/jespinosa/phecomp/data/CRG/20120502_FDF_CRG/20120502_FDF_CRG/20120511_FDF_CRG_c12.mtb	2681	COLL	WWSS	food_sc	4	243096	1336973961	1	0.0200000000000005	0.000256410256410263	3492	1
1	Food 1	Intake 3	59	243204	1336974069	/users/cn/jespinosa/phecomp/data/CRG/20120502_FDF_CRG/20120502_FDF_CRG/20120511_FDF_CRG_c12.mtb	1972	55	WWSS	food_sc	3	243145	1336974010	1	0.04	0.000677966101694915	3493	1
1	Food 1	Intake 3	114	243373	1336974238	/users/cn/jespinosa/phecomp/data/CRG/20120502_FDF_CRG/20120502_FDF_CRG/20120511_FDF_CRG_c12.mtb	1973	23	WWSS	food_sc	3	243259	1336974124	1	0.04	0.000350877192982456	3494	1
1	Food 1	Intake 3	48	243444	1336974309	/users/cn/jespinosa/phecomp/data/CRG/20120502_FDF_CRG/20120502_FDF_CRG/20120511_FDF_CRG_c12.mtb	1974	117	WWSS	food_sc	3	243396	1336974261	1	0.04	0.000833333333333333	3495	1
1	Food 1	Intake 3	81	243642	1336974507	/users/cn/jespinosa/phecomp/data/CRG/20120502_FDF_CRG/20120502_FDF_CRG/20120511_FDF_CRG_c12.mtb	1975	4	WWSS	food_sc	3	243561	1336974426	1	0.04	0.000493827160493827	3496	1
1	Food 1	Intake 3	167	243813	1336974678	/users/cn/jespinosa/phecomp/data/CRG/20120502_FDF_CRG/20120502_FDF_CRG/20120511_FDF_CRG_c12.mtb	1976	213	WWSS	food_sc	3	243646	1336974511	1	0.04	0.000239520958083832	3497	1
1	Drink 2	Intake 2	14	243869	1336974734	/users/cn/jespinosa/phecomp/data/CRG/20120502_FDF_CRG/20120502_FDF_CRG/20120511_FDF_CRG_c12.mtb	994	NA	WWSS	water	2	243855	1336974720	1	0.0200000000000005	0.00142857142857146	3498	1
1	Food 1	Intake 3	66	244092	1336974957	/users/cn/jespinosa/phecomp/data/CRG/20120502_FDF_CRG/20120502_FDF_CRG/20120511_FDF_CRG_c12.mtb	1979	32	WWSS	food_sc	3	244026	1336974891	1	0.44	0.00666666666666667	3499	1
1	Food 1	Intake 3	68	244192	1336975057	/users/cn/jespinosa/phecomp/data/CRG/20120502_FDF_CRG/20120502_FDF_CRG/20120511_FDF_CRG_c12.mtb	1980	102	WWSS	food_sc	3	244124	1336974989	1	0.0400000000000009	0.00058823529411766	3500	1
1	Food 2	Intake 4	150	244444	1336975309	/users/cn/jespinosa/phecomp/data/CRG/20120502_FDF_CRG/20120502_FDF_CRG/20120511_FDF_CRG_c12.mtb	2693	245	WWSS	food_sc	4	244294	1336975159	1	0.04	0.000266666666666667	3501	1
1	Drink 2	Intake 2	28	244612	1336975477	/users/cn/jespinosa/phecomp/data/CRG/20120502_FDF_CRG/20120502_FDF_CRG/20120511_FDF_CRG_c12.mtb	995	NA	WWSS	water	2	244584	1336975449	1	0.0999999999999996	0.00357142857142856	3502	1
1	Food 1	Intake 3	334	245023	1336975888	/users/cn/jespinosa/phecomp/data/CRG/20120502_FDF_CRG/20120502_FDF_CRG/20120511_FDF_CRG_c12.mtb	1983	281	WWSS	food_sc	3	244689	1336975554	1	0.0999999999999996	0.000299401197604789	3503	1
1	Drink 2	Intake 2	26	245229	1336976094	/users/cn/jespinosa/phecomp/data/CRG/20120502_FDF_CRG/20120502_FDF_CRG/20120511_FDF_CRG_c12.mtb	996	NA	WWSS	water	2	245203	1336976068	1	0.0600000000000005	0.00230769230769233	3504	1
1	Food 1	Intake 3	305	245609	1336976474	/users/cn/jespinosa/phecomp/data/CRG/20120502_FDF_CRG/20120502_FDF_CRG/20120511_FDF_CRG_c12.mtb	1985	1482	WWSS	food_sc	3	245304	1336976169	1	0.04	0.000131147540983607	3505	1
1	Drink 2	Intake 2	25	245638	1336976503	/users/cn/jespinosa/phecomp/data/CRG/20120502_FDF_CRG/20120502_FDF_CRG/20120511_FDF_CRG_c12.mtb	997	NA	WWSS	water	2	245613	1336976478	1	0.0799999999999992	0.00319999999999997	3506	1
1	Food 1	Intake 3	203	247294	1336978159	/users/cn/jespinosa/phecomp/data/CRG/20120502_FDF_CRG/20120502_FDF_CRG/20120511_FDF_CRG_c12.mtb	1989	736	WWSS	food_sc	3	247091	1336977956	1	0.0600000000000005	0.000295566502463057	3507	1
1	Food 1	Intake 3	97	248127	1336978992	/users/cn/jespinosa/phecomp/data/CRG/20120502_FDF_CRG/20120502_FDF_CRG/20120511_FDF_CRG_c12.mtb	1990	14143	WWSS	food_sc	3	248030	1336978895	1	0.04	0.000412371134020619	3508	1
1	Drink 1	Intake 1	53	248905	1336979770	/users/cn/jespinosa/phecomp/data/CRG/20120502_FDF_CRG/20120502_FDF_CRG/20120511_FDF_CRG_c12.mtb	2035	NA	WWSS	water	1	248852	1336979717	1	0.02	0.000377358490566038	3509	1
1	Drink 2	Intake 2	18	249007	1336979872	/users/cn/jespinosa/phecomp/data/CRG/20120502_FDF_CRG/20120502_FDF_CRG/20120511_FDF_CRG_c12.mtb	1000	NA	WWSS	water	2	248989	1336979854	1	0.0200000000000005	0.00111111111111114	3510	1
1	Drink 1	Intake 1	28	312	1336992485	/users/cn/jespinosa/phecomp/data/CRG/20120502_FDF_CRG/20120502_FDF_CRG/20120514_FDF_CRG_c12.mtb	2148	NA	WWSS	water	1	284	1336992457	1	0.02	0.000714285714285714	3511	1
1	Drink 1	Intake 1	35	526	1336992699	/users/cn/jespinosa/phecomp/data/CRG/20120502_FDF_CRG/20120502_FDF_CRG/20120514_FDF_CRG_c12.mtb	2150	NA	WWSS	water	1	491	1336992664	1	0.02	0.000571428571428571	3512	1
1	Drink 1	Intake 1	23	860	1336993033	/users/cn/jespinosa/phecomp/data/CRG/20120502_FDF_CRG/20120502_FDF_CRG/20120514_FDF_CRG_c12.mtb	2154	NA	WWSS	water	1	837	1336993010	1	0.02	0.000869565217391304	3513	1
1	Food 2	Intake 4	76	1038	1336993211	/users/cn/jespinosa/phecomp/data/CRG/20120502_FDF_CRG/20120502_FDF_CRG/20120514_FDF_CRG_c12.mtb	2801	25	WWSS	food_sc	4	962	1336993135	1	0.02	0.000263157894736842	3514	1
1	Food 2	Intake 4	56	1119	1336993292	/users/cn/jespinosa/phecomp/data/CRG/20120502_FDF_CRG/20120502_FDF_CRG/20120514_FDF_CRG_c12.mtb	2802	4	WWSS	food_sc	4	1063	1336993236	1	0.02	0.000357142857142857	3515	1
1	Food 2	Intake 4	75	1198	1336993371	/users/cn/jespinosa/phecomp/data/CRG/20120502_FDF_CRG/20120502_FDF_CRG/20120514_FDF_CRG_c12.mtb	2803	COLL	WWSS	food_sc	4	1123	1336993296	1	0.02	0.000266666666666667	3516	1
1	Food 1	Intake 3	51	1236	1336993409	/users/cn/jespinosa/phecomp/data/CRG/20120502_FDF_CRG/20120502_FDF_CRG/20120514_FDF_CRG_c12.mtb	2103	354	WWSS	food_sc	3	1185	1336993358	1	0.02	0.000392156862745098	3517	1
1	Drink 1	Intake 1	28	1535	1336993708	/users/cn/jespinosa/phecomp/data/CRG/20120502_FDF_CRG/20120502_FDF_CRG/20120514_FDF_CRG_c12.mtb	2159	NA	WWSS	water	1	1507	1336993680	1	0.04	0.00142857142857143	3518	1
1	Food 1	Intake 3	40	1630	1336993803	/users/cn/jespinosa/phecomp/data/CRG/20120502_FDF_CRG/20120502_FDF_CRG/20120514_FDF_CRG_c12.mtb	2105	349	WWSS	food_sc	3	1590	1336993763	1	0.02	0.0005	3519	1
1	Drink 1	Intake 1	17	1683	1336993856	/users/cn/jespinosa/phecomp/data/CRG/20120502_FDF_CRG/20120502_FDF_CRG/20120514_FDF_CRG_c12.mtb	2160	NA	WWSS	water	1	1666	1336993839	1	0.02	0.00117647058823529	3520	1
1	Drink 1	Intake 1	18	1715	1336993888	/users/cn/jespinosa/phecomp/data/CRG/20120502_FDF_CRG/20120502_FDF_CRG/20120514_FDF_CRG_c12.mtb	2161	NA	WWSS	water	1	1697	1336993870	1	0.04	0.00222222222222222	3521	1
1	Food 1	Intake 3	71	2050	1336994223	/users/cn/jespinosa/phecomp/data/CRG/20120502_FDF_CRG/20120502_FDF_CRG/20120514_FDF_CRG_c12.mtb	2108	246	WWSS	food_sc	3	1979	1336994152	1	0.02	0.00028169014084507	3522	1
1	Drink 1	Intake 1	23	2262	1336994435	/users/cn/jespinosa/phecomp/data/CRG/20120502_FDF_CRG/20120502_FDF_CRG/20120514_FDF_CRG_c12.mtb	2162	NA	WWSS	water	1	2239	1336994412	1	0.04	0.00173913043478261	3523	1
1	Food 1	Intake 3	62	2358	1336994531	/users/cn/jespinosa/phecomp/data/CRG/20120502_FDF_CRG/20120502_FDF_CRG/20120514_FDF_CRG_c12.mtb	2111	36	WWSS	food_sc	3	2296	1336994469	1	0.02	0.00032258064516129	3524	1
1	Food 1	Intake 3	36	2430	1336994603	/users/cn/jespinosa/phecomp/data/CRG/20120502_FDF_CRG/20120502_FDF_CRG/20120514_FDF_CRG_c12.mtb	2112	24010	WWSS	food_sc	3	2394	1336994567	1	0.02	0.000555555555555556	3525	1
1	Drink 2	Intake 2	22	14037	1337006210	/users/cn/jespinosa/phecomp/data/CRG/20120502_FDF_CRG/20120502_FDF_CRG/20120514_FDF_CRG_c12.mtb	1041	NA	WWSS	water	2	14015	1337006188	1	0.04	0.00181818181818182	3526	1
1	Food 2	Intake 4	74	26514	1337018687	/users/cn/jespinosa/phecomp/data/CRG/20120502_FDF_CRG/20120502_FDF_CRG/20120514_FDF_CRG_c12.mtb	2814	29	WWSS	food_sc	4	26440	1337018613	1	0.02	0.00027027027027027	3527	1
1	Food 2	Intake 4	12	26555	1337018728	/users/cn/jespinosa/phecomp/data/CRG/20120502_FDF_CRG/20120502_FDF_CRG/20120514_FDF_CRG_c12.mtb	2815	37	WWSS	food_sc	4	26543	1337018716	1	0.02	0.00166666666666667	3528	1
1	Food 2	Intake 4	49	26641	1337018814	/users/cn/jespinosa/phecomp/data/CRG/20120502_FDF_CRG/20120502_FDF_CRG/20120514_FDF_CRG_c12.mtb	2816	8	WWSS	food_sc	4	26592	1337018765	1	0.04	0.000816326530612245	3529	1
1	Food 1	Intake 3	102	26751	1337018924	/users/cn/jespinosa/phecomp/data/CRG/20120502_FDF_CRG/20120502_FDF_CRG/20120514_FDF_CRG_c12.mtb	2117	64	WWSS	food_sc	3	26649	1337018822	1	0.04	0.000392156862745098	3530	1
1	Food 1	Intake 3	137	26952	1337019125	/users/cn/jespinosa/phecomp/data/CRG/20120502_FDF_CRG/20120502_FDF_CRG/20120514_FDF_CRG_c12.mtb	2118	1424	WWSS	food_sc	3	26815	1337018988	1	0.02	0.000145985401459854	3531	1
1	Drink 1	Intake 1	30	26979	1337019152	/users/cn/jespinosa/phecomp/data/CRG/20120502_FDF_CRG/20120502_FDF_CRG/20120514_FDF_CRG_c12.mtb	2164	NA	WWSS	water	1	26949	1337019122	1	0.08	0.00266666666666667	3532	1
1	Drink 1	Intake 1	12	28327	1337020500	/users/cn/jespinosa/phecomp/data/CRG/20120502_FDF_CRG/20120502_FDF_CRG/20120514_FDF_CRG_c12.mtb	2165	NA	WWSS	water	1	28315	1337020488	1	0.04	0.00333333333333333	3533	1
1	Food 2	Intake 4	72	28448	1337020621	/users/cn/jespinosa/phecomp/data/CRG/20120502_FDF_CRG/20120502_FDF_CRG/20120514_FDF_CRG_c12.mtb	2818	4	WWSS	food_sc	4	28376	1337020549	1	0.04	0.000555555555555556	3534	1
1	Food 2	Intake 4	49	28501	1337020674	/users/cn/jespinosa/phecomp/data/CRG/20120502_FDF_CRG/20120502_FDF_CRG/20120514_FDF_CRG_c12.mtb	2819	24	WWSS	food_sc	4	28452	1337020625	1	0.02	0.000408163265306122	3535	1
1	Food 2	Intake 4	230	28755	1337020928	/users/cn/jespinosa/phecomp/data/CRG/20120502_FDF_CRG/20120502_FDF_CRG/20120514_FDF_CRG_c12.mtb	2820	418	WWSS	food_sc	4	28525	1337020698	1	0.08	0.000347826086956522	3536	1
1	Drink 2	Intake 2	13	28775	1337020948	/users/cn/jespinosa/phecomp/data/CRG/20120502_FDF_CRG/20120502_FDF_CRG/20120514_FDF_CRG_c12.mtb	1042	NA	WWSS	water	2	28762	1337020935	1	0.08	0.00615384615384615	3537	1
1	Food 2	Intake 4	186	29359	1337021532	/users/cn/jespinosa/phecomp/data/CRG/20120502_FDF_CRG/20120502_FDF_CRG/20120514_FDF_CRG_c12.mtb	2822	52	WWSS	food_sc	4	29173	1337021346	1	0.06	0.00032258064516129	3538	1
1	Drink 2	Intake 2	27	29379	1337021552	/users/cn/jespinosa/phecomp/data/CRG/20120502_FDF_CRG/20120502_FDF_CRG/20120514_FDF_CRG_c12.mtb	1043	NA	WWSS	water	2	29352	1337021525	1	0.04	0.00148148148148148	3539	1
1	Food 2	Intake 4	249	29660	1337021833	/users/cn/jespinosa/phecomp/data/CRG/20120502_FDF_CRG/20120502_FDF_CRG/20120514_FDF_CRG_c12.mtb	2823	2717	WWSS	food_sc	4	29411	1337021584	1	0.08	0.000321285140562249	3540	1
1	Drink 2	Intake 2	26	29697	1337021870	/users/cn/jespinosa/phecomp/data/CRG/20120502_FDF_CRG/20120502_FDF_CRG/20120514_FDF_CRG_c12.mtb	1044	NA	WWSS	water	2	29671	1337021844	1	0.1	0.00384615384615385	3541	1
1	Drink 1	Intake 1	28	31823	1337023996	/users/cn/jespinosa/phecomp/data/CRG/20120502_FDF_CRG/20120502_FDF_CRG/20120514_FDF_CRG_c12.mtb	2166	NA	WWSS	water	1	31795	1337023968	1	0.02	0.000714285714285714	3542	1
1	Food 2	Intake 4	171	32548	1337024721	/users/cn/jespinosa/phecomp/data/CRG/20120502_FDF_CRG/20120502_FDF_CRG/20120514_FDF_CRG_c12.mtb	2824	9	WWSS	food_sc	4	32377	1337024550	1	0.1	0.000584795321637427	3543	1
1	Food 2	Intake 4	247	32804	1337024977	/users/cn/jespinosa/phecomp/data/CRG/20120502_FDF_CRG/20120502_FDF_CRG/20120514_FDF_CRG_c12.mtb	2825	106	WWSS	food_sc	4	32557	1337024730	1	0.1	0.000404858299595142	3544	1
1	Drink 1	Intake 1	33	32911	1337025084	/users/cn/jespinosa/phecomp/data/CRG/20120502_FDF_CRG/20120502_FDF_CRG/20120514_FDF_CRG_c12.mtb	2167	NA	WWSS	water	1	32878	1337025051	1	0.1	0.00303030303030303	3545	1
1	Food 2	Intake 4	89	32999	1337025172	/users/cn/jespinosa/phecomp/data/CRG/20120502_FDF_CRG/20120502_FDF_CRG/20120514_FDF_CRG_c12.mtb	2827	1906	WWSS	food_sc	4	32910	1337025083	1	0.02	0.000224719101123596	3546	1
1	Food 2	Intake 4	157	35062	1337027235	/users/cn/jespinosa/phecomp/data/CRG/20120502_FDF_CRG/20120502_FDF_CRG/20120514_FDF_CRG_c12.mtb	2828	30	WWSS	food_sc	4	34905	1337027078	1	0.02	0.000127388535031847	3547	1
1	Food 2	Intake 4	156	35248	1337027421	/users/cn/jespinosa/phecomp/data/CRG/20120502_FDF_CRG/20120502_FDF_CRG/20120514_FDF_CRG_c12.mtb	2829	8	WWSS	food_sc	4	35092	1337027265	1	0.0599999999999999	0.000384615384615384	3548	1
1	Food 2	Intake 4	276	35532	1337027705	/users/cn/jespinosa/phecomp/data/CRG/20120502_FDF_CRG/20120502_FDF_CRG/20120514_FDF_CRG_c12.mtb	2830	243	WWSS	food_sc	4	35256	1337027429	1	0.14	0.000507246376811594	3549	1
1	Drink 1	Intake 1	25	35552	1337027725	/users/cn/jespinosa/phecomp/data/CRG/20120502_FDF_CRG/20120502_FDF_CRG/20120514_FDF_CRG_c12.mtb	2168	NA	WWSS	water	1	35527	1337027700	1	0.06	0.0024	3550	1
1	Drink 2	Intake 2	33	35802	1337027975	/users/cn/jespinosa/phecomp/data/CRG/20120502_FDF_CRG/20120502_FDF_CRG/20120514_FDF_CRG_c12.mtb	1045	NA	WWSS	water	2	35769	1337027942	1	0.02	0.000606060606060606	3551	1
1	Food 1	Intake 3	133	35908	1337028081	/users/cn/jespinosa/phecomp/data/CRG/20120502_FDF_CRG/20120502_FDF_CRG/20120514_FDF_CRG_c12.mtb	2121	135	WWSS	food_sc	3	35775	1337027948	1	0.04	0.000300751879699248	3552	1
1	Food 1	Intake 3	82	36125	1337028298	/users/cn/jespinosa/phecomp/data/CRG/20120502_FDF_CRG/20120502_FDF_CRG/20120514_FDF_CRG_c12.mtb	2122	3815	WWSS	food_sc	3	36043	1337028216	1	0.02	0.00024390243902439	3553	1
1	Drink 1	Intake 1	29	36222	1337028395	/users/cn/jespinosa/phecomp/data/CRG/20120502_FDF_CRG/20120502_FDF_CRG/20120514_FDF_CRG_c12.mtb	2169	NA	WWSS	water	1	36193	1337028366	1	0.12	0.00413793103448276	3554	1
1	Food 1	Intake 3	459	40399	1337032572	/users/cn/jespinosa/phecomp/data/CRG/20120502_FDF_CRG/20120502_FDF_CRG/20120514_FDF_CRG_c12.mtb	2123	5	WWSS	food_sc	3	39940	1337032113	1	0.16	0.000348583877995643	3555	1
1	Food 1	Intake 3	147	40551	1337032724	/users/cn/jespinosa/phecomp/data/CRG/20120502_FDF_CRG/20120502_FDF_CRG/20120514_FDF_CRG_c12.mtb	2124	44	WWSS	food_sc	3	40404	1337032577	1	0.02	0.000136054421768707	3556	1
1	Food 1	Intake 3	168	40763	1337032936	/users/cn/jespinosa/phecomp/data/CRG/20120502_FDF_CRG/20120502_FDF_CRG/20120514_FDF_CRG_c12.mtb	2125	133	WWSS	food_sc	3	40595	1337032768	1	0.08	0.000476190476190476	3557	1
1	Drink 2	Intake 2	39	40796	1337032969	/users/cn/jespinosa/phecomp/data/CRG/20120502_FDF_CRG/20120502_FDF_CRG/20120514_FDF_CRG_c12.mtb	1046	NA	WWSS	water	2	40757	1337032930	1	0.14	0.00358974358974359	3558	1
1	Food 1	Intake 3	76	40972	1337033145	/users/cn/jespinosa/phecomp/data/CRG/20120502_FDF_CRG/20120502_FDF_CRG/20120514_FDF_CRG_c12.mtb	2126	442	WWSS	food_sc	3	40896	1337033069	1	0.04	0.000526315789473684	3559	1
1	Drink 1	Intake 1	21	41156	1337033329	/users/cn/jespinosa/phecomp/data/CRG/20120502_FDF_CRG/20120502_FDF_CRG/20120514_FDF_CRG_c12.mtb	2170	NA	WWSS	water	1	41135	1337033308	1	0.02	0.000952380952380952	3560	1
1	Drink 2	Intake 2	17	41295	1337033468	/users/cn/jespinosa/phecomp/data/CRG/20120502_FDF_CRG/20120502_FDF_CRG/20120514_FDF_CRG_c12.mtb	1047	NA	WWSS	water	2	41278	1337033451	1	0.02	0.00117647058823529	3561	1
1	Food 2	Intake 4	80	41494	1337033667	/users/cn/jespinosa/phecomp/data/CRG/20120502_FDF_CRG/20120502_FDF_CRG/20120514_FDF_CRG_c12.mtb	2836	COLL	WWSS	food_sc	4	41414	1337033587	1	0.02	0.00025	3562	1
1	Food 1	Intake 3	180	41666	1337033839	/users/cn/jespinosa/phecomp/data/CRG/20120502_FDF_CRG/20120502_FDF_CRG/20120514_FDF_CRG_c12.mtb	2128	770	WWSS	food_sc	3	41486	1337033659	1	0.04	0.000222222222222222	3563	1
1	Drink 1	Intake 1	38	41773	1337033946	/users/cn/jespinosa/phecomp/data/CRG/20120502_FDF_CRG/20120502_FDF_CRG/20120514_FDF_CRG_c12.mtb	2171	NA	WWSS	water	1	41735	1337033908	1	0.14	0.00368421052631579	3564	1
1	Drink 2	Intake 2	14	42227	1337034400	/users/cn/jespinosa/phecomp/data/CRG/20120502_FDF_CRG/20120502_FDF_CRG/20120514_FDF_CRG_c12.mtb	1048	NA	WWSS	water	2	42213	1337034386	1	0.02	0.00142857142857143	3565	1
1	Food 1	Intake 3	192	42628	1337034801	/users/cn/jespinosa/phecomp/data/CRG/20120502_FDF_CRG/20120502_FDF_CRG/20120514_FDF_CRG_c12.mtb	2129	COLL	WWSS	food_sc	3	42436	1337034609	1	0.0399999999999999	0.000208333333333333	3566	1
1	Food 2	Intake 4	65	42683	1337034856	/users/cn/jespinosa/phecomp/data/CRG/20120502_FDF_CRG/20120502_FDF_CRG/20120514_FDF_CRG_c12.mtb	2839	27	WWSS	food_sc	4	42618	1337034791	1	0.02	0.000307692307692308	3567	1
1	Food 2	Intake 4	163	42873	1337035046	/users/cn/jespinosa/phecomp/data/CRG/20120502_FDF_CRG/20120502_FDF_CRG/20120514_FDF_CRG_c12.mtb	2840	5091	WWSS	food_sc	4	42710	1337034883	1	0.0599999999999999	0.000368098159509202	3568	1
1	Drink 2	Intake 2	14	42879	1337035052	/users/cn/jespinosa/phecomp/data/CRG/20120502_FDF_CRG/20120502_FDF_CRG/20120514_FDF_CRG_c12.mtb	1049	NA	WWSS	water	2	42865	1337035038	1	0.06	0.00428571428571429	3569	1
1	Drink 1	Intake 1	13	43964	1337036137	/users/cn/jespinosa/phecomp/data/CRG/20120502_FDF_CRG/20120502_FDF_CRG/20120514_FDF_CRG_c12.mtb	2172	NA	WWSS	water	1	43951	1337036124	1	0.02	0.00153846153846154	3570	1
1	Food 2	Intake 4	149	48113	1337040286	/users/cn/jespinosa/phecomp/data/CRG/20120502_FDF_CRG/20120502_FDF_CRG/20120514_FDF_CRG_c12.mtb	2841	14	WWSS	food_sc	4	47964	1337040137	1	0.0600000000000001	0.00040268456375839	3571	1
1	Food 2	Intake 4	195	48322	1337040495	/users/cn/jespinosa/phecomp/data/CRG/20120502_FDF_CRG/20120502_FDF_CRG/20120514_FDF_CRG_c12.mtb	2842	49	WWSS	food_sc	4	48127	1337040300	1	0.0800000000000001	0.000410256410256411	3572	1
1	Food 2	Intake 4	81	48452	1337040625	/users/cn/jespinosa/phecomp/data/CRG/20120502_FDF_CRG/20120502_FDF_CRG/20120514_FDF_CRG_c12.mtb	2844	282	WWSS	food_sc	4	48371	1337040544	1	0.04	0.000493827160493827	3573	1
1	Drink 2	Intake 2	8	48469	1337040642	/users/cn/jespinosa/phecomp/data/CRG/20120502_FDF_CRG/20120502_FDF_CRG/20120514_FDF_CRG_c12.mtb	1050	NA	WWSS	water	2	48461	1337040634	1	0.02	0.0025	3574	1
1	Drink 1	Intake 1	17	48722	1337040895	/users/cn/jespinosa/phecomp/data/CRG/20120502_FDF_CRG/20120502_FDF_CRG/20120514_FDF_CRG_c12.mtb	2174	NA	WWSS	water	1	48705	1337040878	1	0.0399999999999999	0.00235294117647058	3575	1
1	Food 2	Intake 4	190	48924	1337041097	/users/cn/jespinosa/phecomp/data/CRG/20120502_FDF_CRG/20120502_FDF_CRG/20120514_FDF_CRG_c12.mtb	2847	26	WWSS	food_sc	4	48734	1337040907	1	0.04	0.000210526315789474	3576	1
1	Drink 2	Intake 2	14	48930	1337041103	/users/cn/jespinosa/phecomp/data/CRG/20120502_FDF_CRG/20120502_FDF_CRG/20120514_FDF_CRG_c12.mtb	1051	NA	WWSS	water	2	48916	1337041089	1	0.02	0.00142857142857143	3577	1
1	Food 2	Intake 4	111	49061	1337041234	/users/cn/jespinosa/phecomp/data/CRG/20120502_FDF_CRG/20120502_FDF_CRG/20120514_FDF_CRG_c12.mtb	2848	23	WWSS	food_sc	4	48950	1337041123	1	0.02	0.00018018018018018	3578	1
1	Food 2	Intake 4	109	49193	1337041366	/users/cn/jespinosa/phecomp/data/CRG/20120502_FDF_CRG/20120502_FDF_CRG/20120514_FDF_CRG_c12.mtb	2849	950	WWSS	food_sc	4	49084	1337041257	1	0.04	0.00036697247706422	3579	1
1	Drink 1	Intake 1	38	49221	1337041394	/users/cn/jespinosa/phecomp/data/CRG/20120502_FDF_CRG/20120502_FDF_CRG/20120514_FDF_CRG_c12.mtb	2176	NA	WWSS	water	1	49183	1337041356	1	0.0600000000000001	0.00157894736842106	3580	1
1	Drink 1	Intake 1	17	49443	1337041616	/users/cn/jespinosa/phecomp/data/CRG/20120502_FDF_CRG/20120502_FDF_CRG/20120514_FDF_CRG_c12.mtb	2177	NA	WWSS	water	1	49426	1337041599	1	0.02	0.00117647058823529	3581	1
1	Food 1	Intake 3	109	50252	1337042425	/users/cn/jespinosa/phecomp/data/CRG/20120502_FDF_CRG/20120502_FDF_CRG/20120514_FDF_CRG_c12.mtb	2140	1218	WWSS	food_sc	3	50143	1337042316	1	0.04	0.00036697247706422	3582	1
1	Drink 2	Intake 2	39	50289	1337042462	/users/cn/jespinosa/phecomp/data/CRG/20120502_FDF_CRG/20120502_FDF_CRG/20120514_FDF_CRG_c12.mtb	1052	NA	WWSS	water	2	50250	1337042423	1	0.12	0.00307692307692308	3583	1
1	Food 2	Intake 4	52	51522	1337043695	/users/cn/jespinosa/phecomp/data/CRG/20120502_FDF_CRG/20120502_FDF_CRG/20120514_FDF_CRG_c12.mtb	2855	5068	WWSS	food_sc	4	51470	1337043643	1	0.02	0.000384615384615385	3584	1
1	Food 2	Intake 4	17	56607	1337048780	/users/cn/jespinosa/phecomp/data/CRG/20120502_FDF_CRG/20120502_FDF_CRG/20120514_FDF_CRG_c12.mtb	2856	24	WWSS	food_sc	4	56590	1337048763	1	0.02	0.00117647058823529	3585	1
1	Food 2	Intake 4	20	56651	1337048824	/users/cn/jespinosa/phecomp/data/CRG/20120502_FDF_CRG/20120502_FDF_CRG/20120514_FDF_CRG_c12.mtb	2857	30	WWSS	food_sc	4	56631	1337048804	1	0.02	0.001	3586	1
1	Food 2	Intake 4	18	56699	1337048872	/users/cn/jespinosa/phecomp/data/CRG/20120502_FDF_CRG/20120502_FDF_CRG/20120514_FDF_CRG_c12.mtb	2858	2407	WWSS	food_sc	4	56681	1337048854	1	0.02	0.00111111111111111	3587	1
1	Food 2	Intake 4	146	59252	1337051425	/users/cn/jespinosa/phecomp/data/CRG/20120502_FDF_CRG/20120502_FDF_CRG/20120514_FDF_CRG_c12.mtb	2860	4	WWSS	food_sc	4	59106	1337051279	1	0.0399999999999998	0.000273972602739725	3588	1
1	Food 2	Intake 4	218	59474	1337051647	/users/cn/jespinosa/phecomp/data/CRG/20120502_FDF_CRG/20120502_FDF_CRG/20120514_FDF_CRG_c12.mtb	2861	4063	WWSS	food_sc	4	59256	1337051429	1	0.1	0.000458715596330275	3589	1
1	Food 2	Intake 4	223	63760	1337055933	/users/cn/jespinosa/phecomp/data/CRG/20120502_FDF_CRG/20120502_FDF_CRG/20120514_FDF_CRG_c12.mtb	2862	94	WWSS	food_sc	4	63537	1337055710	1	0.0600000000000001	0.000269058295964126	3590	1
1	Food 2	Intake 4	131	63985	1337056158	/users/cn/jespinosa/phecomp/data/CRG/20120502_FDF_CRG/20120502_FDF_CRG/20120514_FDF_CRG_c12.mtb	2863	82	WWSS	food_sc	4	63854	1337056027	1	0.04	0.000305343511450382	3591	1
1	Drink 2	Intake 2	28	64004	1337056177	/users/cn/jespinosa/phecomp/data/CRG/20120502_FDF_CRG/20120502_FDF_CRG/20120514_FDF_CRG_c12.mtb	1054	NA	WWSS	water	2	63976	1337056149	1	0.12	0.00428571428571429	3592	1
1	Food 2	Intake 4	415	64482	1337056655	/users/cn/jespinosa/phecomp/data/CRG/20120502_FDF_CRG/20120502_FDF_CRG/20120514_FDF_CRG_c12.mtb	2864	231	WWSS	food_sc	4	64067	1337056240	1	0.1	0.000240963855421687	3593	1
1	Drink 2	Intake 2	38	64522	1337056695	/users/cn/jespinosa/phecomp/data/CRG/20120502_FDF_CRG/20120502_FDF_CRG/20120514_FDF_CRG_c12.mtb	1055	NA	WWSS	water	2	64484	1337056657	1	0.14	0.00368421052631579	3594	1
1	Food 2	Intake 4	88	64801	1337056974	/users/cn/jespinosa/phecomp/data/CRG/20120502_FDF_CRG/20120502_FDF_CRG/20120514_FDF_CRG_c12.mtb	2867	513	WWSS	food_sc	4	64713	1337056886	1	0.02	0.000227272727272727	3595	1
1	Drink 1	Intake 1	17	65053	1337057226	/users/cn/jespinosa/phecomp/data/CRG/20120502_FDF_CRG/20120502_FDF_CRG/20120514_FDF_CRG_c12.mtb	2180	NA	WWSS	water	1	65036	1337057209	1	0.04	0.00235294117647059	3596	1
1	Drink 1	Intake 1	27	65285	1337057458	/users/cn/jespinosa/phecomp/data/CRG/20120502_FDF_CRG/20120502_FDF_CRG/20120514_FDF_CRG_c12.mtb	2181	NA	WWSS	water	1	65258	1337057431	1	0.04	0.00148148148148148	3597	1
1	Food 2	Intake 4	79	65393	1337057566	/users/cn/jespinosa/phecomp/data/CRG/20120502_FDF_CRG/20120502_FDF_CRG/20120514_FDF_CRG_c12.mtb	2870	73	WWSS	food_sc	4	65314	1337057487	1	0.02	0.000253164556962025	3598	1
1	Food 2	Intake 4	66	65532	1337057705	/users/cn/jespinosa/phecomp/data/CRG/20120502_FDF_CRG/20120502_FDF_CRG/20120514_FDF_CRG_c12.mtb	2872	138	WWSS	food_sc	4	65466	1337057639	1	0.04	0.000606060606060606	3599	1
1	Drink 2	Intake 2	15	65660	1337057833	/users/cn/jespinosa/phecomp/data/CRG/20120502_FDF_CRG/20120502_FDF_CRG/20120514_FDF_CRG_c12.mtb	1057	NA	WWSS	water	2	65645	1337057818	1	0.0600000000000001	0.00400000000000001	3600	1
1	Food 2	Intake 4	61	65731	1337057904	/users/cn/jespinosa/phecomp/data/CRG/20120502_FDF_CRG/20120502_FDF_CRG/20120514_FDF_CRG_c12.mtb	2873	5	WWSS	food_sc	4	65670	1337057843	1	0.02	0.000327868852459016	3601	1
1	Food 2	Intake 4	74	65810	1337057983	/users/cn/jespinosa/phecomp/data/CRG/20120502_FDF_CRG/20120502_FDF_CRG/20120514_FDF_CRG_c12.mtb	2874	34	WWSS	food_sc	4	65736	1337057909	1	0.0399999999999998	0.000540540540540538	3602	1
1	Drink 1	Intake 1	21	65828	1337058001	/users/cn/jespinosa/phecomp/data/CRG/20120502_FDF_CRG/20120502_FDF_CRG/20120514_FDF_CRG_c12.mtb	2183	NA	WWSS	water	1	65807	1337057980	1	0.04	0.0019047619047619	3603	1
1	Food 2	Intake 4	79	65923	1337058096	/users/cn/jespinosa/phecomp/data/CRG/20120502_FDF_CRG/20120502_FDF_CRG/20120514_FDF_CRG_c12.mtb	2875	28	WWSS	food_sc	4	65844	1337058017	1	0.04	0.000506329113924051	3604	1
1	Food 2	Intake 4	75	66026	1337058199	/users/cn/jespinosa/phecomp/data/CRG/20120502_FDF_CRG/20120502_FDF_CRG/20120514_FDF_CRG_c12.mtb	2876	115	WWSS	food_sc	4	65951	1337058124	1	0.02	0.000266666666666667	3605	1
1	Drink 2	Intake 2	23	66085	1337058258	/users/cn/jespinosa/phecomp/data/CRG/20120502_FDF_CRG/20120502_FDF_CRG/20120514_FDF_CRG_c12.mtb	1058	NA	WWSS	water	2	66062	1337058235	1	0.04	0.00173913043478261	3606	1
1	Food 2	Intake 4	59	66200	1337058373	/users/cn/jespinosa/phecomp/data/CRG/20120502_FDF_CRG/20120502_FDF_CRG/20120514_FDF_CRG_c12.mtb	2878	358	WWSS	food_sc	4	66141	1337058314	1	0.02	0.000338983050847458	3607	1
1	Food 2	Intake 4	119	66677	1337058850	/users/cn/jespinosa/phecomp/data/CRG/20120502_FDF_CRG/20120502_FDF_CRG/20120514_FDF_CRG_c12.mtb	2880	41	WWSS	food_sc	4	66558	1337058731	1	0.04	0.000336134453781513	3608	1
1	Drink 2	Intake 2	18	66708	1337058881	/users/cn/jespinosa/phecomp/data/CRG/20120502_FDF_CRG/20120502_FDF_CRG/20120514_FDF_CRG_c12.mtb	1059	NA	WWSS	water	2	66690	1337058863	1	0.02	0.00111111111111111	3609	1
1	Food 2	Intake 4	170	66888	1337059061	/users/cn/jespinosa/phecomp/data/CRG/20120502_FDF_CRG/20120502_FDF_CRG/20120514_FDF_CRG_c12.mtb	2881	746	WWSS	food_sc	4	66718	1337058891	1	0.0600000000000001	0.000352941176470589	3610	1
1	Drink 2	Intake 2	30	66982	1337059155	/users/cn/jespinosa/phecomp/data/CRG/20120502_FDF_CRG/20120502_FDF_CRG/20120514_FDF_CRG_c12.mtb	1060	NA	WWSS	water	2	66952	1337059125	1	0.0600000000000001	0.002	3611	1
1	Drink 2	Intake 2	16	67235	1337059408	/users/cn/jespinosa/phecomp/data/CRG/20120502_FDF_CRG/20120502_FDF_CRG/20120514_FDF_CRG_c12.mtb	1061	NA	WWSS	water	2	67219	1337059392	1	0.0399999999999998	0.00249999999999999	3612	1
1	Food 2	Intake 4	81	67715	1337059888	/users/cn/jespinosa/phecomp/data/CRG/20120502_FDF_CRG/20120502_FDF_CRG/20120514_FDF_CRG_c12.mtb	2885	116	WWSS	food_sc	4	67634	1337059807	1	0.04	0.000493827160493827	3613	1
1	Drink 2	Intake 2	15	67816	1337059989	/users/cn/jespinosa/phecomp/data/CRG/20120502_FDF_CRG/20120502_FDF_CRG/20120514_FDF_CRG_c12.mtb	1062	NA	WWSS	water	2	67801	1337059974	1	0.02	0.00133333333333333	3614	1
1	Food 2	Intake 4	121	67952	1337060125	/users/cn/jespinosa/phecomp/data/CRG/20120502_FDF_CRG/20120502_FDF_CRG/20120514_FDF_CRG_c12.mtb	2887	62	WWSS	food_sc	4	67831	1337060004	1	0.02	0.000165289256198347	3615	1
1	Drink 1	Intake 1	31	67973	1337060146	/users/cn/jespinosa/phecomp/data/CRG/20120502_FDF_CRG/20120502_FDF_CRG/20120514_FDF_CRG_c12.mtb	2184	NA	WWSS	water	1	67942	1337060115	1	0.04	0.00129032258064516	3616	1
1	Food 2	Intake 4	147	68161	1337060334	/users/cn/jespinosa/phecomp/data/CRG/20120502_FDF_CRG/20120502_FDF_CRG/20120514_FDF_CRG_c12.mtb	2888	38	WWSS	food_sc	4	68014	1337060187	1	0.04	0.000272108843537415	3617	1
1	Drink 2	Intake 2	34	68189	1337060362	/users/cn/jespinosa/phecomp/data/CRG/20120502_FDF_CRG/20120502_FDF_CRG/20120514_FDF_CRG_c12.mtb	1063	NA	WWSS	water	2	68155	1337060328	1	0.0800000000000001	0.00235294117647059	3618	1
1	Food 2	Intake 4	117	68316	1337060489	/users/cn/jespinosa/phecomp/data/CRG/20120502_FDF_CRG/20120502_FDF_CRG/20120514_FDF_CRG_c12.mtb	2889	17	WWSS	food_sc	4	68199	1337060372	1	0.0600000000000001	0.000512820512820514	3619	1
1	Food 2	Intake 4	110	68443	1337060616	/users/cn/jespinosa/phecomp/data/CRG/20120502_FDF_CRG/20120502_FDF_CRG/20120514_FDF_CRG_c12.mtb	2890	86	WWSS	food_sc	4	68333	1337060506	1	0.02	0.000181818181818182	3620	1
1	Food 2	Intake 4	98	68627	1337060800	/users/cn/jespinosa/phecomp/data/CRG/20120502_FDF_CRG/20120502_FDF_CRG/20120514_FDF_CRG_c12.mtb	2892	7	WWSS	food_sc	4	68529	1337060702	1	0.02	0.000204081632653061	3621	1
1	Food 2	Intake 4	99	68733	1337060906	/users/cn/jespinosa/phecomp/data/CRG/20120502_FDF_CRG/20120502_FDF_CRG/20120514_FDF_CRG_c12.mtb	2893	300	WWSS	food_sc	4	68634	1337060807	1	0.0399999999999996	0.0004040404040404	3622	1
1	Food 2	Intake 4	159	69192	1337061365	/users/cn/jespinosa/phecomp/data/CRG/20120502_FDF_CRG/20120502_FDF_CRG/20120514_FDF_CRG_c12.mtb	2895	25	WWSS	food_sc	4	69033	1337061206	1	0.04	0.000251572327044025	3623	1
1	Drink 1	Intake 1	18	69202	1337061375	/users/cn/jespinosa/phecomp/data/CRG/20120502_FDF_CRG/20120502_FDF_CRG/20120514_FDF_CRG_c12.mtb	2185	NA	WWSS	water	1	69184	1337061357	1	0.02	0.00111111111111111	3624	1
1	Drink 2	Intake 2	15	69215	1337061388	/users/cn/jespinosa/phecomp/data/CRG/20120502_FDF_CRG/20120502_FDF_CRG/20120514_FDF_CRG_c12.mtb	1064	NA	WWSS	water	2	69200	1337061373	1	0.02	0.00133333333333333	3625	1
1	Food 2	Intake 4	92	69309	1337061482	/users/cn/jespinosa/phecomp/data/CRG/20120502_FDF_CRG/20120502_FDF_CRG/20120514_FDF_CRG_c12.mtb	2896	29	WWSS	food_sc	4	69217	1337061390	1	0.04	0.000434782608695652	3626	1
1	Food 2	Intake 4	97	69435	1337061608	/users/cn/jespinosa/phecomp/data/CRG/20120502_FDF_CRG/20120502_FDF_CRG/20120514_FDF_CRG_c12.mtb	2897	14	WWSS	food_sc	4	69338	1337061511	1	0.04	0.000412371134020619	3627	1
1	Food 2	Intake 4	26	69475	1337061648	/users/cn/jespinosa/phecomp/data/CRG/20120502_FDF_CRG/20120502_FDF_CRG/20120514_FDF_CRG_c12.mtb	2898	367	WWSS	food_sc	4	69449	1337061622	1	0.02	0.000769230769230769	3628	1
1	Drink 1	Intake 1	23	69827	1337062000	/users/cn/jespinosa/phecomp/data/CRG/20120502_FDF_CRG/20120502_FDF_CRG/20120514_FDF_CRG_c12.mtb	2186	NA	WWSS	water	1	69804	1337061977	1	0.0599999999999998	0.0026086956521739	3629	1
1	Food 2	Intake 4	216	70058	1337062231	/users/cn/jespinosa/phecomp/data/CRG/20120502_FDF_CRG/20120502_FDF_CRG/20120514_FDF_CRG_c12.mtb	2900	72	WWSS	food_sc	4	69842	1337062015	1	0.02	9.25925925925926e-05	3630	1
1	Food 2	Intake 4	100	70230	1337062403	/users/cn/jespinosa/phecomp/data/CRG/20120502_FDF_CRG/20120502_FDF_CRG/20120514_FDF_CRG_c12.mtb	2901	37	WWSS	food_sc	4	70130	1337062303	1	0.02	0.0002	3631	1
1	Food 2	Intake 4	245	70512	1337062685	/users/cn/jespinosa/phecomp/data/CRG/20120502_FDF_CRG/20120502_FDF_CRG/20120514_FDF_CRG_c12.mtb	2902	849	WWSS	food_sc	4	70267	1337062440	1	0.04	0.000163265306122449	3632	1
1	Drink 1	Intake 1	26	70541	1337062714	/users/cn/jespinosa/phecomp/data/CRG/20120502_FDF_CRG/20120502_FDF_CRG/20120514_FDF_CRG_c12.mtb	2187	NA	WWSS	water	1	70515	1337062688	1	0.1	0.00384615384615385	3633	1
1	Food 2	Intake 4	292	71653	1337063826	/users/cn/jespinosa/phecomp/data/CRG/20120502_FDF_CRG/20120502_FDF_CRG/20120514_FDF_CRG_c12.mtb	2903	4181	WWSS	food_sc	4	71361	1337063534	1	0.1	0.000342465753424658	3634	1
1	Food 2	Intake 4	166	76000	1337068173	/users/cn/jespinosa/phecomp/data/CRG/20120502_FDF_CRG/20120502_FDF_CRG/20120514_FDF_CRG_c12.mtb	2906	20	WWSS	food_sc	4	75834	1337068007	1	0.02	0.000120481927710843	3635	1
1	Food 2	Intake 4	138	76158	1337068331	/users/cn/jespinosa/phecomp/data/CRG/20120502_FDF_CRG/20120502_FDF_CRG/20120514_FDF_CRG_c12.mtb	2907	7634	WWSS	food_sc	4	76020	1337068193	1	0.04	0.000289855072463768	3636	1
1	Drink 2	Intake 2	27	76181	1337068354	/users/cn/jespinosa/phecomp/data/CRG/20120502_FDF_CRG/20120502_FDF_CRG/20120514_FDF_CRG_c12.mtb	1066	NA	WWSS	water	2	76154	1337068327	1	0.14	0.00518518518518519	3637	1
1	Food 2	Intake 4	20	83812	1337075985	/users/cn/jespinosa/phecomp/data/CRG/20120502_FDF_CRG/20120502_FDF_CRG/20120514_FDF_CRG_c12.mtb	2909	4730	WWSS	food_sc	4	83792	1337075965	1	0.02	0.001	3638	1
1	Food 2	Intake 4	18	88560	1337080733	/users/cn/jespinosa/phecomp/data/CRG/20120502_FDF_CRG/20120502_FDF_CRG/20120514_FDF_CRG_c12.mtb	2911	27	WWSS	food_sc	4	88542	1337080715	1	0.02	0.00111111111111111	3639	1
1	Food 2	Intake 4	35	88622	1337080795	/users/cn/jespinosa/phecomp/data/CRG/20120502_FDF_CRG/20120502_FDF_CRG/20120514_FDF_CRG_c12.mtb	2912	409	WWSS	food_sc	4	88587	1337080760	1	0.02	0.000571428571428571	3640	1
1	Food 2	Intake 4	76	89107	1337081280	/users/cn/jespinosa/phecomp/data/CRG/20120502_FDF_CRG/20120502_FDF_CRG/20120514_FDF_CRG_c12.mtb	2913	3628	WWSS	food_sc	4	89031	1337081204	1	0.04	0.000526315789473684	3641	1
1	Drink 1	Intake 1	15	91059	1337083232	/users/cn/jespinosa/phecomp/data/CRG/20120502_FDF_CRG/20120502_FDF_CRG/20120514_FDF_CRG_c12.mtb	2193	NA	WWSS	water	1	91044	1337083217	1	0.04	0.00266666666666667	3642	1
1	Food 2	Intake 4	28	92763	1337084936	/users/cn/jespinosa/phecomp/data/CRG/20120502_FDF_CRG/20120502_FDF_CRG/20120514_FDF_CRG_c12.mtb	2915	7	WWSS	food_sc	4	92735	1337084908	1	0.04	0.00142857142857143	3643	1
1	Food 2	Intake 4	23	92793	1337084966	/users/cn/jespinosa/phecomp/data/CRG/20120502_FDF_CRG/20120502_FDF_CRG/20120514_FDF_CRG_c12.mtb	2916	7315	WWSS	food_sc	4	92770	1337084943	1	0.0399999999999996	0.00173913043478259	3644	1
1	Food 2	Intake 4	39	100147	1337092320	/users/cn/jespinosa/phecomp/data/CRG/20120502_FDF_CRG/20120502_FDF_CRG/20120514_FDF_CRG_c12.mtb	2917	69	WWSS	food_sc	4	100108	1337092281	1	0.04	0.00102564102564103	3645	1
1	Food 2	Intake 4	8	100224	1337092397	/users/cn/jespinosa/phecomp/data/CRG/20120502_FDF_CRG/20120502_FDF_CRG/20120514_FDF_CRG_c12.mtb	2918	19	WWSS	food_sc	4	100216	1337092389	1	0.02	0.0025	3646	1
1	Food 2	Intake 4	23	100266	1337092439	/users/cn/jespinosa/phecomp/data/CRG/20120502_FDF_CRG/20120502_FDF_CRG/20120514_FDF_CRG_c12.mtb	2919	38	WWSS	food_sc	4	100243	1337092416	1	0.02	0.000869565217391304	3647	1
1	Food 2	Intake 4	47	100351	1337092524	/users/cn/jespinosa/phecomp/data/CRG/20120502_FDF_CRG/20120502_FDF_CRG/20120514_FDF_CRG_c12.mtb	2920	91	WWSS	food_sc	4	100304	1337092477	1	0.04	0.000851063829787234	3648	1
1	Food 2	Intake 4	35	100477	1337092650	/users/cn/jespinosa/phecomp/data/CRG/20120502_FDF_CRG/20120502_FDF_CRG/20120514_FDF_CRG_c12.mtb	2921	7648	WWSS	food_sc	4	100442	1337092615	1	0.02	0.000571428571428571	3649	1
1	Drink 2	Intake 2	16	101553	1337093726	/users/cn/jespinosa/phecomp/data/CRG/20120502_FDF_CRG/20120502_FDF_CRG/20120514_FDF_CRG_c12.mtb	1068	NA	WWSS	water	2	101537	1337093710	1	0.02	0.00125	3650	1
1	Food 2	Intake 4	39	108164	1337100337	/users/cn/jespinosa/phecomp/data/CRG/20120502_FDF_CRG/20120502_FDF_CRG/20120514_FDF_CRG_c12.mtb	2924	59	WWSS	food_sc	4	108125	1337100298	1	0.02	0.000512820512820513	3651	1
1	Food 2	Intake 4	161	108384	1337100557	/users/cn/jespinosa/phecomp/data/CRG/20120502_FDF_CRG/20120502_FDF_CRG/20120514_FDF_CRG_c12.mtb	2925	11	WWSS	food_sc	4	108223	1337100396	1	0.0800000000000001	0.000496894409937889	3652	1
1	Food 2	Intake 4	179	108574	1337100747	/users/cn/jespinosa/phecomp/data/CRG/20120502_FDF_CRG/20120502_FDF_CRG/20120514_FDF_CRG_c12.mtb	2926	14	WWSS	food_sc	4	108395	1337100568	1	0.0600000000000001	0.000335195530726258	3653	1
1	Food 2	Intake 4	187	108775	1337100948	/users/cn/jespinosa/phecomp/data/CRG/20120502_FDF_CRG/20120502_FDF_CRG/20120514_FDF_CRG_c12.mtb	2927	4048	WWSS	food_sc	4	108588	1337100761	1	0.0800000000000001	0.000427807486631017	3654	1
1	Drink 2	Intake 2	31	110320	1337102493	/users/cn/jespinosa/phecomp/data/CRG/20120502_FDF_CRG/20120502_FDF_CRG/20120514_FDF_CRG_c12.mtb	1069	NA	WWSS	water	2	110289	1337102462	1	0.12	0.00387096774193548	3655	1
1	Food 2	Intake 4	164	112987	1337105160	/users/cn/jespinosa/phecomp/data/CRG/20120502_FDF_CRG/20120502_FDF_CRG/20120514_FDF_CRG_c12.mtb	2928	9	WWSS	food_sc	4	112823	1337104996	1	0.0800000000000001	0.000487804878048781	3656	1
1	Food 2	Intake 4	291	113287	1337105460	/users/cn/jespinosa/phecomp/data/CRG/20120502_FDF_CRG/20120502_FDF_CRG/20120514_FDF_CRG_c12.mtb	2929	60	WWSS	food_sc	4	112996	1337105169	1	0.12	0.000412371134020619	3657	1
1	Food 2	Intake 4	127	113474	1337105647	/users/cn/jespinosa/phecomp/data/CRG/20120502_FDF_CRG/20120502_FDF_CRG/20120514_FDF_CRG_c12.mtb	2930	264	WWSS	food_sc	4	113347	1337105520	1	0.04	0.00031496062992126	3658	1
1	Drink 2	Intake 2	15	113492	1337105665	/users/cn/jespinosa/phecomp/data/CRG/20120502_FDF_CRG/20120502_FDF_CRG/20120514_FDF_CRG_c12.mtb	1070	NA	WWSS	water	2	113477	1337105650	1	0.04	0.00266666666666667	3659	1
1	Food 2	Intake 4	154	113892	1337106065	/users/cn/jespinosa/phecomp/data/CRG/20120502_FDF_CRG/20120502_FDF_CRG/20120514_FDF_CRG_c12.mtb	2932	81	WWSS	food_sc	4	113738	1337105911	1	0.0600000000000001	0.00038961038961039	3660	1
1	Drink 2	Intake 2	23	113910	1337106083	/users/cn/jespinosa/phecomp/data/CRG/20120502_FDF_CRG/20120502_FDF_CRG/20120514_FDF_CRG_c12.mtb	1072	NA	WWSS	water	2	113887	1337106060	1	0.0999999999999999	0.00434782608695652	3661	1
1	Food 2	Intake 4	178	114151	1337106324	/users/cn/jespinosa/phecomp/data/CRG/20120502_FDF_CRG/20120502_FDF_CRG/20120514_FDF_CRG_c12.mtb	2933	296	WWSS	food_sc	4	113973	1337106146	1	0.04	0.000224719101123596	3662	1
1	Drink 2	Intake 2	19	114170	1337106343	/users/cn/jespinosa/phecomp/data/CRG/20120502_FDF_CRG/20120502_FDF_CRG/20120514_FDF_CRG_c12.mtb	1073	NA	WWSS	water	2	114151	1337106324	1	0.02	0.00105263157894737	3663	1
1	Food 2	Intake 4	45	114492	1337106665	/users/cn/jespinosa/phecomp/data/CRG/20120502_FDF_CRG/20120502_FDF_CRG/20120514_FDF_CRG_c12.mtb	2935	1969	WWSS	food_sc	4	114447	1337106620	1	0.02	0.000444444444444444	3664	1
1	Drink 2	Intake 2	25	114506	1337106679	/users/cn/jespinosa/phecomp/data/CRG/20120502_FDF_CRG/20120502_FDF_CRG/20120514_FDF_CRG_c12.mtb	1074	NA	WWSS	water	2	114481	1337106654	1	0.0600000000000001	0.0024	3665	1
1	Drink 2	Intake 2	17	114914	1337107087	/users/cn/jespinosa/phecomp/data/CRG/20120502_FDF_CRG/20120502_FDF_CRG/20120514_FDF_CRG_c12.mtb	1075	NA	WWSS	water	2	114897	1337107070	1	0.0399999999999998	0.00235294117647058	3666	1
1	Food 2	Intake 4	81	116542	1337108715	/users/cn/jespinosa/phecomp/data/CRG/20120502_FDF_CRG/20120502_FDF_CRG/20120514_FDF_CRG_c12.mtb	2936	38	WWSS	food_sc	4	116461	1337108634	1	0.02	0.000246913580246914	3667	1
1	Food 2	Intake 4	53	116633	1337108806	/users/cn/jespinosa/phecomp/data/CRG/20120502_FDF_CRG/20120502_FDF_CRG/20120514_FDF_CRG_c12.mtb	2938	1555	WWSS	food_sc	4	116580	1337108753	1	0.02	0.000377358490566038	3668	1
1	Food 2	Intake 4	100	118288	1337110461	/users/cn/jespinosa/phecomp/data/CRG/20120502_FDF_CRG/20120502_FDF_CRG/20120514_FDF_CRG_c12.mtb	2939	8	WWSS	food_sc	4	118188	1337110361	1	0.04	0.0004	3669	1
1	Food 2	Intake 4	282	118578	1337110751	/users/cn/jespinosa/phecomp/data/CRG/20120502_FDF_CRG/20120502_FDF_CRG/20120514_FDF_CRG_c12.mtb	2940	160	WWSS	food_sc	4	118296	1337110469	1	0.0600000000000001	0.000212765957446809	3670	1
1	Food 2	Intake 4	96	118834	1337111007	/users/cn/jespinosa/phecomp/data/CRG/20120502_FDF_CRG/20120502_FDF_CRG/20120514_FDF_CRG_c12.mtb	2942	65	WWSS	food_sc	4	118738	1337110911	1	0.04	0.000416666666666667	3671	1
1	Drink 2	Intake 2	24	118853	1337111026	/users/cn/jespinosa/phecomp/data/CRG/20120502_FDF_CRG/20120502_FDF_CRG/20120514_FDF_CRG_c12.mtb	1076	NA	WWSS	water	2	118829	1337111002	1	0.04	0.00166666666666667	3672	1
1	Food 2	Intake 4	165	119064	1337111237	/users/cn/jespinosa/phecomp/data/CRG/20120502_FDF_CRG/20120502_FDF_CRG/20120514_FDF_CRG_c12.mtb	2943	112	WWSS	food_sc	4	118899	1337111072	1	0.0599999999999996	0.000363636363636361	3673	1
1	Drink 1	Intake 1	28	119087	1337111260	/users/cn/jespinosa/phecomp/data/CRG/20120502_FDF_CRG/20120502_FDF_CRG/20120514_FDF_CRG_c12.mtb	2194	NA	WWSS	water	1	119059	1337111232	1	0.0599999999999998	0.00214285714285714	3674	1
1	Drink 1	Intake 1	16	119183	1337111356	/users/cn/jespinosa/phecomp/data/CRG/20120502_FDF_CRG/20120502_FDF_CRG/20120514_FDF_CRG_c12.mtb	2195	NA	WWSS	water	1	119167	1337111340	1	0.02	0.00125	3675	1
1	Food 2	Intake 4	159	119335	1337111508	/users/cn/jespinosa/phecomp/data/CRG/20120502_FDF_CRG/20120502_FDF_CRG/20120514_FDF_CRG_c12.mtb	2944	405	WWSS	food_sc	4	119176	1337111349	1	0.0600000000000001	0.000377358490566038	3676	1
1	Drink 2	Intake 2	28	119366	1337111539	/users/cn/jespinosa/phecomp/data/CRG/20120502_FDF_CRG/20120502_FDF_CRG/20120514_FDF_CRG_c12.mtb	1077	NA	WWSS	water	2	119338	1337111511	1	0.0800000000000001	0.00285714285714286	3677	1
1	Food 2	Intake 4	68	119808	1337111981	/users/cn/jespinosa/phecomp/data/CRG/20120502_FDF_CRG/20120502_FDF_CRG/20120514_FDF_CRG_c12.mtb	2946	384	WWSS	food_sc	4	119740	1337111913	1	0.04	0.000588235294117647	3678	1
1	Drink 2	Intake 2	27	120121	1337112294	/users/cn/jespinosa/phecomp/data/CRG/20120502_FDF_CRG/20120502_FDF_CRG/20120514_FDF_CRG_c12.mtb	1078	NA	WWSS	water	2	120094	1337112267	1	0.1	0.0037037037037037	3679	1
1	Food 2	Intake 4	128	120320	1337112493	/users/cn/jespinosa/phecomp/data/CRG/20120502_FDF_CRG/20120502_FDF_CRG/20120514_FDF_CRG_c12.mtb	2948	12	WWSS	food_sc	4	120192	1337112365	1	0.02	0.00015625	3680	1
1	Food 2	Intake 4	71	120403	1337112576	/users/cn/jespinosa/phecomp/data/CRG/20120502_FDF_CRG/20120502_FDF_CRG/20120514_FDF_CRG_c12.mtb	2949	87	WWSS	food_sc	4	120332	1337112505	1	0.02	0.00028169014084507	3681	1
1	Food 2	Intake 4	71	120561	1337112734	/users/cn/jespinosa/phecomp/data/CRG/20120502_FDF_CRG/20120502_FDF_CRG/20120514_FDF_CRG_c12.mtb	2950	235	WWSS	food_sc	4	120490	1337112663	1	0.02	0.00028169014084507	3682	1
1	Drink 2	Intake 2	21	120573	1337112746	/users/cn/jespinosa/phecomp/data/CRG/20120502_FDF_CRG/20120502_FDF_CRG/20120514_FDF_CRG_c12.mtb	1079	NA	WWSS	water	2	120552	1337112725	1	0.04	0.0019047619047619	3683	1
1	Food 2	Intake 4	116	120912	1337113085	/users/cn/jespinosa/phecomp/data/CRG/20120502_FDF_CRG/20120502_FDF_CRG/20120514_FDF_CRG_c12.mtb	2952	12	WWSS	food_sc	4	120796	1337112969	1	0.02	0.000172413793103448	3684	1
1	Food 2	Intake 4	70	120994	1337113167	/users/cn/jespinosa/phecomp/data/CRG/20120502_FDF_CRG/20120502_FDF_CRG/20120514_FDF_CRG_c12.mtb	2953	19	WWSS	food_sc	4	120924	1337113097	1	0.0799999999999996	0.00114285714285714	3685	1
1	Food 2	Intake 4	31	121044	1337113217	/users/cn/jespinosa/phecomp/data/CRG/20120502_FDF_CRG/20120502_FDF_CRG/20120514_FDF_CRG_c12.mtb	2954	376	WWSS	food_sc	4	121013	1337113186	1	0.0200000000000005	0.000645161290322597	3686	1
1	Drink 2	Intake 2	20	121100	1337113273	/users/cn/jespinosa/phecomp/data/CRG/20120502_FDF_CRG/20120502_FDF_CRG/20120514_FDF_CRG_c12.mtb	1080	NA	WWSS	water	2	121080	1337113253	1	0.04	0.002	3687	1
1	Food 2	Intake 4	122	121542	1337113715	/users/cn/jespinosa/phecomp/data/CRG/20120502_FDF_CRG/20120502_FDF_CRG/20120514_FDF_CRG_c12.mtb	2957	34	WWSS	food_sc	4	121420	1337113593	1	0.0200000000000005	0.000163934426229512	3688	1
1	Drink 2	Intake 2	23	121576	1337113749	/users/cn/jespinosa/phecomp/data/CRG/20120502_FDF_CRG/20120502_FDF_CRG/20120514_FDF_CRG_c12.mtb	1081	NA	WWSS	water	2	121553	1337113726	1	0.1	0.00434782608695652	3689	1
1	Food 2	Intake 4	86	121662	1337113835	/users/cn/jespinosa/phecomp/data/CRG/20120502_FDF_CRG/20120502_FDF_CRG/20120514_FDF_CRG_c12.mtb	2958	2908	WWSS	food_sc	4	121576	1337113749	1	0.04	0.000465116279069767	3690	1
1	Food 2	Intake 4	437	125007	1337117180	/users/cn/jespinosa/phecomp/data/CRG/20120502_FDF_CRG/20120502_FDF_CRG/20120514_FDF_CRG_c12.mtb	2959	118	WWSS	food_sc	4	124570	1337116743	1	0.16	0.000366132723112128	3691	1
1	Drink 2	Intake 2	20	125111	1337117284	/users/cn/jespinosa/phecomp/data/CRG/20120502_FDF_CRG/20120502_FDF_CRG/20120514_FDF_CRG_c12.mtb	1082	NA	WWSS	water	2	125091	1337117264	1	0.02	0.001	3692	1
1	Food 2	Intake 4	218	125343	1337117516	/users/cn/jespinosa/phecomp/data/CRG/20120502_FDF_CRG/20120502_FDF_CRG/20120514_FDF_CRG_c12.mtb	2960	146	WWSS	food_sc	4	125125	1337117298	1	0.0999999999999996	0.000458715596330273	3693	1
1	Drink 2	Intake 2	27	125367	1337117540	/users/cn/jespinosa/phecomp/data/CRG/20120502_FDF_CRG/20120502_FDF_CRG/20120514_FDF_CRG_c12.mtb	1084	NA	WWSS	water	2	125340	1337117513	1	0.0600000000000001	0.00222222222222223	3694	1
1	Food 2	Intake 4	149	125638	1337117811	/users/cn/jespinosa/phecomp/data/CRG/20120502_FDF_CRG/20120502_FDF_CRG/20120514_FDF_CRG_c12.mtb	2961	80	WWSS	food_sc	4	125489	1337117662	1	0.04	0.000268456375838926	3695	1
1	Drink 2	Intake 2	17	125726	1337117899	/users/cn/jespinosa/phecomp/data/CRG/20120502_FDF_CRG/20120502_FDF_CRG/20120514_FDF_CRG_c12.mtb	1085	NA	WWSS	water	2	125709	1337117882	1	0.02	0.00117647058823529	3696	1
1	Food 2	Intake 4	129	125847	1337118020	/users/cn/jespinosa/phecomp/data/CRG/20120502_FDF_CRG/20120502_FDF_CRG/20120514_FDF_CRG_c12.mtb	2962	103	WWSS	food_sc	4	125718	1337117891	1	0.04	0.000310077519379845	3697	1
1	Drink 2	Intake 2	29	125871	1337118044	/users/cn/jespinosa/phecomp/data/CRG/20120502_FDF_CRG/20120502_FDF_CRG/20120514_FDF_CRG_c12.mtb	1086	NA	WWSS	water	2	125842	1337118015	1	0.0800000000000001	0.00275862068965518	3698	1
1	Food 2	Intake 4	171	126121	1337118294	/users/cn/jespinosa/phecomp/data/CRG/20120502_FDF_CRG/20120502_FDF_CRG/20120514_FDF_CRG_c12.mtb	2964	72	WWSS	food_sc	4	125950	1337118123	1	0.0600000000000005	0.000350877192982459	3699	1
1	Drink 1	Intake 1	16	126141	1337118314	/users/cn/jespinosa/phecomp/data/CRG/20120502_FDF_CRG/20120502_FDF_CRG/20120514_FDF_CRG_c12.mtb	2196	NA	WWSS	water	1	126125	1337118298	1	0.04	0.0025	3700	1
1	Food 2	Intake 4	137	126330	1337118503	/users/cn/jespinosa/phecomp/data/CRG/20120502_FDF_CRG/20120502_FDF_CRG/20120514_FDF_CRG_c12.mtb	2965	1235	WWSS	food_sc	4	126193	1337118366	1	0.0399999999999991	0.000291970802919701	3701	1
1	Drink 2	Intake 2	16	126358	1337118531	/users/cn/jespinosa/phecomp/data/CRG/20120502_FDF_CRG/20120502_FDF_CRG/20120514_FDF_CRG_c12.mtb	1088	NA	WWSS	water	2	126342	1337118515	1	0.0600000000000001	0.00375000000000001	3702	1
1	Food 2	Intake 4	118	127683	1337119856	/users/cn/jespinosa/phecomp/data/CRG/20120502_FDF_CRG/20120502_FDF_CRG/20120514_FDF_CRG_c12.mtb	2968	106	WWSS	food_sc	4	127565	1337119738	1	0.0600000000000005	0.000508474576271191	3703	1
1	Drink 2	Intake 2	30	127760	1337119933	/users/cn/jespinosa/phecomp/data/CRG/20120502_FDF_CRG/20120502_FDF_CRG/20120514_FDF_CRG_c12.mtb	1090	NA	WWSS	water	2	127730	1337119903	1	0.02	0.000666666666666667	3704	1
1	Food 2	Intake 4	86	127875	1337120048	/users/cn/jespinosa/phecomp/data/CRG/20120502_FDF_CRG/20120502_FDF_CRG/20120514_FDF_CRG_c12.mtb	2970	3420	WWSS	food_sc	4	127789	1337119962	1	0.04	0.000465116279069767	3705	1
1	Drink 2	Intake 2	26	128231	1337120404	/users/cn/jespinosa/phecomp/data/CRG/20120502_FDF_CRG/20120502_FDF_CRG/20120514_FDF_CRG_c12.mtb	1091	NA	WWSS	water	2	128205	1337120378	1	0.1	0.00384615384615385	3706	1
1	Food 2	Intake 4	77	131372	1337123545	/users/cn/jespinosa/phecomp/data/CRG/20120502_FDF_CRG/20120502_FDF_CRG/20120514_FDF_CRG_c12.mtb	2972	34	WWSS	food_sc	4	131295	1337123468	1	0.04	0.000519480519480519	3707	1
1	Food 2	Intake 4	28	131434	1337123607	/users/cn/jespinosa/phecomp/data/CRG/20120502_FDF_CRG/20120502_FDF_CRG/20120514_FDF_CRG_c12.mtb	2973	3065	WWSS	food_sc	4	131406	1337123579	1	0.0200000000000005	0.000714285714285732	3708	1
1	Food 2	Intake 4	70	134569	1337126742	/users/cn/jespinosa/phecomp/data/CRG/20120502_FDF_CRG/20120502_FDF_CRG/20120514_FDF_CRG_c12.mtb	2978	24	WWSS	food_sc	4	134499	1337126672	1	0.04	0.000571428571428571	3709	1
1	Food 2	Intake 4	139	134732	1337126905	/users/cn/jespinosa/phecomp/data/CRG/20120502_FDF_CRG/20120502_FDF_CRG/20120514_FDF_CRG_c12.mtb	2979	227	WWSS	food_sc	4	134593	1337126766	1	0.0800000000000001	0.000575539568345324	3710	1
1	Food 2	Intake 4	142	135101	1337127274	/users/cn/jespinosa/phecomp/data/CRG/20120502_FDF_CRG/20120502_FDF_CRG/20120514_FDF_CRG_c12.mtb	2983	579	WWSS	food_sc	4	134959	1337127132	1	0.0600000000000005	0.000422535211267609	3711	1
1	Drink 1	Intake 1	15	135111	1337127284	/users/cn/jespinosa/phecomp/data/CRG/20120502_FDF_CRG/20120502_FDF_CRG/20120514_FDF_CRG_c12.mtb	2198	NA	WWSS	water	1	135096	1337127269	1	0.04	0.00266666666666667	3712	1
1	Drink 2	Intake 2	13	135346	1337127519	/users/cn/jespinosa/phecomp/data/CRG/20120502_FDF_CRG/20120502_FDF_CRG/20120514_FDF_CRG_c12.mtb	1092	NA	WWSS	water	2	135333	1337127506	1	0.02	0.00153846153846154	3713	1
1	Drink 2	Intake 2	19	135617	1337127790	/users/cn/jespinosa/phecomp/data/CRG/20120502_FDF_CRG/20120502_FDF_CRG/20120514_FDF_CRG_c12.mtb	1094	NA	WWSS	water	2	135598	1337127771	1	0.04	0.00210526315789474	3714	1
1	Drink 2	Intake 2	21	135647	1337127820	/users/cn/jespinosa/phecomp/data/CRG/20120502_FDF_CRG/20120502_FDF_CRG/20120514_FDF_CRG_c12.mtb	1095	NA	WWSS	water	2	135626	1337127799	1	0.04	0.0019047619047619	3715	1
1	Food 2	Intake 4	147	135827	1337128000	/users/cn/jespinosa/phecomp/data/CRG/20120502_FDF_CRG/20120502_FDF_CRG/20120514_FDF_CRG_c12.mtb	2986	451	WWSS	food_sc	4	135680	1337127853	1	0.0200000000000005	0.000136054421768711	3716	1
1	Drink 1	Intake 1	30	135901	1337128074	/users/cn/jespinosa/phecomp/data/CRG/20120502_FDF_CRG/20120502_FDF_CRG/20120514_FDF_CRG_c12.mtb	2199	NA	WWSS	water	1	135871	1337128044	1	0.02	0.000666666666666667	3717	1
1	Drink 1	Intake 1	36	136171	1337128344	/users/cn/jespinosa/phecomp/data/CRG/20120502_FDF_CRG/20120502_FDF_CRG/20120514_FDF_CRG_c12.mtb	2201	NA	WWSS	water	1	136135	1337128308	1	0.02	0.000555555555555556	3718	1
1	Food 2	Intake 4	111	136389	1337128562	/users/cn/jespinosa/phecomp/data/CRG/20120502_FDF_CRG/20120502_FDF_CRG/20120514_FDF_CRG_c12.mtb	2989	951	WWSS	food_sc	4	136278	1337128451	1	0.0200000000000005	0.000180180180180185	3719	1
1	Food 2	Intake 4	197	137537	1337129710	/users/cn/jespinosa/phecomp/data/CRG/20120502_FDF_CRG/20120502_FDF_CRG/20120514_FDF_CRG_c12.mtb	2993	7693	WWSS	food_sc	4	137340	1337129513	1	0.04	0.000203045685279188	3720	1
1	Drink 2	Intake 2	31	137792	1337129965	/users/cn/jespinosa/phecomp/data/CRG/20120502_FDF_CRG/20120502_FDF_CRG/20120514_FDF_CRG_c12.mtb	1099	NA	WWSS	water	2	137761	1337129934	1	0.04	0.00129032258064516	3721	1
1	Food 2	Intake 4	59	145289	1337137462	/users/cn/jespinosa/phecomp/data/CRG/20120502_FDF_CRG/20120502_FDF_CRG/20120514_FDF_CRG_c12.mtb	2997	2597	WWSS	food_sc	4	145230	1337137403	1	0.0200000000000005	0.000338983050847466	3722	1
1	Food 2	Intake 4	235	148121	1337140294	/users/cn/jespinosa/phecomp/data/CRG/20120502_FDF_CRG/20120502_FDF_CRG/20120514_FDF_CRG_c12.mtb	3000	45	WWSS	food_sc	4	147886	1337140059	1	0.0600000000000005	0.000255319148936172	3723	1
1	Food 2	Intake 4	160	148326	1337140499	/users/cn/jespinosa/phecomp/data/CRG/20120502_FDF_CRG/20120502_FDF_CRG/20120514_FDF_CRG_c12.mtb	3001	2634	WWSS	food_sc	4	148166	1337140339	1	0.0599999999999996	0.000374999999999998	3724	1
1	Drink 1	Intake 1	22	148373	1337140546	/users/cn/jespinosa/phecomp/data/CRG/20120502_FDF_CRG/20120502_FDF_CRG/20120514_FDF_CRG_c12.mtb	2205	NA	WWSS	water	1	148351	1337140524	1	0.0600000000000001	0.00272727272727273	3725	1
1	Food 2	Intake 4	271	151231	1337143404	/users/cn/jespinosa/phecomp/data/CRG/20120502_FDF_CRG/20120502_FDF_CRG/20120514_FDF_CRG_c12.mtb	3004	281	WWSS	food_sc	4	150960	1337143133	1	0.100000000000001	0.000369003690036904	3726	1
1	Drink 1	Intake 1	14	151240	1337143413	/users/cn/jespinosa/phecomp/data/CRG/20120502_FDF_CRG/20120502_FDF_CRG/20120514_FDF_CRG_c12.mtb	2206	NA	WWSS	water	1	151226	1337143399	1	0.0600000000000001	0.00428571428571429	3727	1
1	Drink 1	Intake 1	10	151510	1337143683	/users/cn/jespinosa/phecomp/data/CRG/20120502_FDF_CRG/20120502_FDF_CRG/20120514_FDF_CRG_c12.mtb	2207	NA	WWSS	water	1	151500	1337143673	1	0.02	0.002	3728	1
1	Food 2	Intake 4	104	151616	1337143789	/users/cn/jespinosa/phecomp/data/CRG/20120502_FDF_CRG/20120502_FDF_CRG/20120514_FDF_CRG_c12.mtb	3008	542	WWSS	food_sc	4	151512	1337143685	1	0.04	0.000384615384615385	3729	1
1	Drink 2	Intake 2	28	151649	1337143822	/users/cn/jespinosa/phecomp/data/CRG/20120502_FDF_CRG/20120502_FDF_CRG/20120514_FDF_CRG_c12.mtb	1100	NA	WWSS	water	2	151621	1337143794	1	0.0799999999999996	0.00285714285714284	3730	1
1	Drink 2	Intake 2	27	152119	1337144292	/users/cn/jespinosa/phecomp/data/CRG/20120502_FDF_CRG/20120502_FDF_CRG/20120514_FDF_CRG_c12.mtb	1102	NA	WWSS	water	2	152092	1337144265	1	0.0800000000000001	0.00296296296296297	3731	1
1	Food 2	Intake 4	86	152244	1337144417	/users/cn/jespinosa/phecomp/data/CRG/20120502_FDF_CRG/20120502_FDF_CRG/20120514_FDF_CRG_c12.mtb	3013	337	WWSS	food_sc	4	152158	1337144331	1	0.0200000000000005	0.00023255813953489	3732	1
1	Drink 2	Intake 2	17	152391	1337144564	/users/cn/jespinosa/phecomp/data/CRG/20120502_FDF_CRG/20120502_FDF_CRG/20120514_FDF_CRG_c12.mtb	1104	NA	WWSS	water	2	152374	1337144547	1	0.02	0.00117647058823529	3733	1
1	Food 2	Intake 4	80	152661	1337144834	/users/cn/jespinosa/phecomp/data/CRG/20120502_FDF_CRG/20120502_FDF_CRG/20120514_FDF_CRG_c12.mtb	3016	518	WWSS	food_sc	4	152581	1337144754	1	0.0399999999999991	0.000499999999999989	3734	1
1	Drink 2	Intake 2	20	152797	1337144970	/users/cn/jespinosa/phecomp/data/CRG/20120502_FDF_CRG/20120502_FDF_CRG/20120514_FDF_CRG_c12.mtb	1105	NA	WWSS	water	2	152777	1337144950	1	0.04	0.002	3735	1
1	Drink 2	Intake 2	21	153046	1337145219	/users/cn/jespinosa/phecomp/data/CRG/20120502_FDF_CRG/20120502_FDF_CRG/20120514_FDF_CRG_c12.mtb	1106	NA	WWSS	water	2	153025	1337145198	1	0.1	0.00476190476190476	3736	1
1	Food 2	Intake 4	31	153210	1337145383	/users/cn/jespinosa/phecomp/data/CRG/20120502_FDF_CRG/20120502_FDF_CRG/20120514_FDF_CRG_c12.mtb	3019	392	WWSS	food_sc	4	153179	1337145352	1	0.0200000000000005	0.000645161290322597	3737	1
1	Drink 1	Intake 1	9	153381	1337145554	/users/cn/jespinosa/phecomp/data/CRG/20120502_FDF_CRG/20120502_FDF_CRG/20120514_FDF_CRG_c12.mtb	2216	NA	WWSS	water	1	153372	1337145545	1	0.02	0.00222222222222222	3738	1
1	Food 2	Intake 4	38	153640	1337145813	/users/cn/jespinosa/phecomp/data/CRG/20120502_FDF_CRG/20120502_FDF_CRG/20120514_FDF_CRG_c12.mtb	3023	COLL	WWSS	food_sc	4	153602	1337145775	1	0.0200000000000005	0.000526315789473697	3739	1
1	Food 1	Intake 3	265	153891	1337146064	/users/cn/jespinosa/phecomp/data/CRG/20120502_FDF_CRG/20120502_FDF_CRG/20120514_FDF_CRG_c12.mtb	2248	206	WWSS	food_sc	3	153626	1337145799	1	0.02	7.54716981132076e-05	3740	1
1	Drink 2	Intake 2	37	153923	1337146096	/users/cn/jespinosa/phecomp/data/CRG/20120502_FDF_CRG/20120502_FDF_CRG/20120514_FDF_CRG_c12.mtb	1107	NA	WWSS	water	2	153886	1337146059	1	0.0800000000000001	0.00216216216216216	3741	1
1	Food 1	Intake 3	92	154189	1337146362	/users/cn/jespinosa/phecomp/data/CRG/20120502_FDF_CRG/20120502_FDF_CRG/20120514_FDF_CRG_c12.mtb	2250	57	WWSS	food_sc	3	154097	1337146270	1	0.0399999999999999	0.000434782608695651	3742	1
1	Drink 2	Intake 2	20	154224	1337146397	/users/cn/jespinosa/phecomp/data/CRG/20120502_FDF_CRG/20120502_FDF_CRG/20120514_FDF_CRG_c12.mtb	1108	NA	WWSS	water	2	154204	1337146377	1	0.0800000000000001	0.00400000000000001	3743	1
1	Food 1	Intake 3	194	154440	1337146613	/users/cn/jespinosa/phecomp/data/CRG/20120502_FDF_CRG/20120502_FDF_CRG/20120514_FDF_CRG_c12.mtb	2251	14	WWSS	food_sc	3	154246	1337146419	1	0.04	0.000206185567010309	3744	1
1	Food 1	Intake 3	91	154545	1337146718	/users/cn/jespinosa/phecomp/data/CRG/20120502_FDF_CRG/20120502_FDF_CRG/20120514_FDF_CRG_c12.mtb	2252	396	WWSS	food_sc	3	154454	1337146627	1	0.02	0.00021978021978022	3745	1
1	Drink 2	Intake 2	13	154930	1337147103	/users/cn/jespinosa/phecomp/data/CRG/20120502_FDF_CRG/20120502_FDF_CRG/20120514_FDF_CRG_c12.mtb	1109	NA	WWSS	water	2	154917	1337147090	1	0.02	0.00153846153846154	3746	1
1	Food 1	Intake 3	101	155042	1337147215	/users/cn/jespinosa/phecomp/data/CRG/20120502_FDF_CRG/20120502_FDF_CRG/20120514_FDF_CRG_c12.mtb	2256	717	WWSS	food_sc	3	154941	1337147114	1	0.02	0.000198019801980198	3747	1
1	Drink 1	Intake 1	17	155381	1337147554	/users/cn/jespinosa/phecomp/data/CRG/20120502_FDF_CRG/20120502_FDF_CRG/20120514_FDF_CRG_c12.mtb	2224	NA	WWSS	water	1	155364	1337147537	1	0.02	0.00117647058823529	3748	1
1	Drink 1	Intake 1	1113	156688	1337148861	/users/cn/jespinosa/phecomp/data/CRG/20120502_FDF_CRG/20120502_FDF_CRG/20120514_FDF_CRG_c12.mtb	2225	NA	WWSS	water	1	155575	1337147748	1	0.04	3.59389038634322e-05	3749	1
1	Food 1	Intake 3	80	155839	1337148012	/users/cn/jespinosa/phecomp/data/CRG/20120502_FDF_CRG/20120502_FDF_CRG/20120514_FDF_CRG_c12.mtb	2262	20	WWSS	food_sc	3	155759	1337147932	1	0.02	0.00025	3750	1
1	Food 1	Intake 3	110	155969	1337148142	/users/cn/jespinosa/phecomp/data/CRG/20120502_FDF_CRG/20120502_FDF_CRG/20120514_FDF_CRG_c12.mtb	2263	170	WWSS	food_sc	3	155859	1337148032	1	0.0399999999999999	0.000363636363636363	3751	1
1	Food 1	Intake 3	242	156381	1337148554	/users/cn/jespinosa/phecomp/data/CRG/20120502_FDF_CRG/20120502_FDF_CRG/20120514_FDF_CRG_c12.mtb	2265	19	WWSS	food_sc	3	156139	1337148312	1	0.14	0.000578512396694215	3752	1
1	Food 1	Intake 3	105	156505	1337148678	/users/cn/jespinosa/phecomp/data/CRG/20120502_FDF_CRG/20120502_FDF_CRG/20120514_FDF_CRG_c12.mtb	2266	108	WWSS	food_sc	3	156400	1337148573	1	0.04	0.000380952380952381	3753	1
1	Drink 2	Intake 2	31	156529	1337148702	/users/cn/jespinosa/phecomp/data/CRG/20120502_FDF_CRG/20120502_FDF_CRG/20120514_FDF_CRG_c12.mtb	1110	NA	WWSS	water	2	156498	1337148671	1	0.0999999999999996	0.00322580645161289	3754	1
1	Food 1	Intake 3	248	156861	1337149034	/users/cn/jespinosa/phecomp/data/CRG/20120502_FDF_CRG/20120502_FDF_CRG/20120514_FDF_CRG_c12.mtb	2267	61	WWSS	food_sc	3	156613	1337148786	1	0.1	0.000403225806451613	3755	1
1	Drink 1	Intake 1	171	156891	1337149064	/users/cn/jespinosa/phecomp/data/CRG/20120502_FDF_CRG/20120502_FDF_CRG/20120514_FDF_CRG_c12.mtb	2226	NA	WWSS	water	1	156720	1337148893	1	0.0399999999999998	0.00023391812865497	3756	1
1	Drink 2	Intake 2	18	156878	1337149051	/users/cn/jespinosa/phecomp/data/CRG/20120502_FDF_CRG/20120502_FDF_CRG/20120514_FDF_CRG_c12.mtb	1111	NA	WWSS	water	2	156860	1337149033	1	0.0800000000000001	0.00444444444444445	3757	1
1	Food 1	Intake 3	100	157022	1337149195	/users/cn/jespinosa/phecomp/data/CRG/20120502_FDF_CRG/20120502_FDF_CRG/20120514_FDF_CRG_c12.mtb	2268	3648	WWSS	food_sc	3	156922	1337149095	1	0.0399999999999998	0.000399999999999998	3758	1
1	Drink 1	Intake 1	68	157126	1337149299	/users/cn/jespinosa/phecomp/data/CRG/20120502_FDF_CRG/20120502_FDF_CRG/20120514_FDF_CRG_c12.mtb	2228	NA	WWSS	water	1	157058	1337149231	1	0.02	0.000294117647058824	3759	1
1	Drink 1	Intake 1	167	157658	1337149831	/users/cn/jespinosa/phecomp/data/CRG/20120502_FDF_CRG/20120502_FDF_CRG/20120514_FDF_CRG_c12.mtb	2231	NA	WWSS	water	1	157491	1337149664	1	0.02	0.000119760479041916	3760	1
1	Drink 1	Intake 1	94	158264	1337150437	/users/cn/jespinosa/phecomp/data/CRG/20120502_FDF_CRG/20120502_FDF_CRG/20120514_FDF_CRG_c12.mtb	2234	NA	WWSS	water	1	158170	1337150343	1	0.02	0.000212765957446809	3761	1
1	Drink 1	Intake 1	20	158801	1337150974	/users/cn/jespinosa/phecomp/data/CRG/20120502_FDF_CRG/20120502_FDF_CRG/20120514_FDF_CRG_c12.mtb	2238	NA	WWSS	water	1	158781	1337150954	1	0.02	0.001	3762	1
1	Drink 1	Intake 1	71	159378	1337151551	/users/cn/jespinosa/phecomp/data/CRG/20120502_FDF_CRG/20120502_FDF_CRG/20120514_FDF_CRG_c12.mtb	2239	NA	WWSS	water	1	159307	1337151480	1	0.02	0.00028169014084507	3763	1
1	Drink 1	Intake 1	239	159654	1337151827	/users/cn/jespinosa/phecomp/data/CRG/20120502_FDF_CRG/20120502_FDF_CRG/20120514_FDF_CRG_c12.mtb	2240	NA	WWSS	water	1	159415	1337151588	1	0.02	8.36820083682008e-05	3764	1
1	Drink 1	Intake 1	520	160895	1337153068	/users/cn/jespinosa/phecomp/data/CRG/20120502_FDF_CRG/20120502_FDF_CRG/20120514_FDF_CRG_c12.mtb	2243	NA	WWSS	water	1	160375	1337152548	1	0.02	3.84615384615385e-05	3765	1
1	Food 2	Intake 4	39	160709	1337152882	/users/cn/jespinosa/phecomp/data/CRG/20120502_FDF_CRG/20120502_FDF_CRG/20120514_FDF_CRG_c12.mtb	3048	1780	WWSS	food_sc	4	160670	1337152843	1	0.0200000000000005	0.000512820512820526	3766	1
1	Drink 1	Intake 1	187	161086	1337153259	/users/cn/jespinosa/phecomp/data/CRG/20120502_FDF_CRG/20120502_FDF_CRG/20120514_FDF_CRG_c12.mtb	2244	NA	WWSS	water	1	160899	1337153072	1	0.02	0.000106951871657754	3767	1
1	Drink 1	Intake 1	18	161853	1337154026	/users/cn/jespinosa/phecomp/data/CRG/20120502_FDF_CRG/20120502_FDF_CRG/20120514_FDF_CRG_c12.mtb	2249	NA	WWSS	water	1	161835	1337154008	1	0.02	0.00111111111111111	3768	1
1	Drink 1	Intake 1	791	162698	1337154871	/users/cn/jespinosa/phecomp/data/CRG/20120502_FDF_CRG/20120502_FDF_CRG/20120514_FDF_CRG_c12.mtb	2250	NA	WWSS	water	1	161907	1337154080	1	0.02	2.52844500632111e-05	3769	1
1	Food 1	Intake 3	8	162497	1337154670	/users/cn/jespinosa/phecomp/data/CRG/20120502_FDF_CRG/20120502_FDF_CRG/20120514_FDF_CRG_c12.mtb	2269	207	WWSS	food_sc	3	162489	1337154662	1	0.04	0.005	3770	1
1	Food 1	Intake 3	86	162790	1337154963	/users/cn/jespinosa/phecomp/data/CRG/20120502_FDF_CRG/20120502_FDF_CRG/20120514_FDF_CRG_c12.mtb	2270	12	WWSS	food_sc	3	162704	1337154877	1	0.04	0.000465116279069767	3771	1
1	Drink 1	Intake 1	15	162788	1337154961	/users/cn/jespinosa/phecomp/data/CRG/20120502_FDF_CRG/20120502_FDF_CRG/20120514_FDF_CRG_c12.mtb	2251	NA	WWSS	water	1	162773	1337154946	1	0.02	0.00133333333333333	3772	1
1	Food 1	Intake 3	25	162827	1337155000	/users/cn/jespinosa/phecomp/data/CRG/20120502_FDF_CRG/20120502_FDF_CRG/20120514_FDF_CRG_c12.mtb	2271	22	WWSS	food_sc	3	162802	1337154975	1	0.04	0.0016	3773	1
1	Food 1	Intake 3	49	162898	1337155071	/users/cn/jespinosa/phecomp/data/CRG/20120502_FDF_CRG/20120502_FDF_CRG/20120514_FDF_CRG_c12.mtb	2272	1310	WWSS	food_sc	3	162849	1337155022	1	0.04	0.000816326530612245	3774	1
1	Drink 2	Intake 2	40	162963	1337155136	/users/cn/jespinosa/phecomp/data/CRG/20120502_FDF_CRG/20120502_FDF_CRG/20120514_FDF_CRG_c12.mtb	1113	NA	WWSS	water	2	162923	1337155096	1	0.16	0.004	3775	1
1	Drink 1	Intake 1	233	164147	1337156320	/users/cn/jespinosa/phecomp/data/CRG/20120502_FDF_CRG/20120502_FDF_CRG/20120514_FDF_CRG_c12.mtb	2254	NA	WWSS	water	1	163914	1337156087	1	0.02	8.58369098712446e-05	3776	1
1	Food 1	Intake 3	36	164244	1337156417	/users/cn/jespinosa/phecomp/data/CRG/20120502_FDF_CRG/20120502_FDF_CRG/20120514_FDF_CRG_c12.mtb	2273	10478	WWSS	food_sc	3	164208	1337156381	1	0.02	0.000555555555555556	3777	1
1	Drink 1	Intake 1	107	164560	1337156733	/users/cn/jespinosa/phecomp/data/CRG/20120502_FDF_CRG/20120502_FDF_CRG/20120514_FDF_CRG_c12.mtb	2256	NA	WWSS	water	1	164453	1337156626	1	0.02	0.000186915887850467	3778	1
1	Food 1	Intake 3	41	3657	1337166936	/users/cn/jespinosa/phecomp/data/CRG/20120502_FDF_CRG/20120502_FDF_CRG/20120516_FDF_CRG_c12.mtb	2310	3631	WWSS	food_sc	3	3616	1337166895	1	0.02	0.00048780487804878	3779	1
1	Food 1	Intake 3	15	7303	1337170582	/users/cn/jespinosa/phecomp/data/CRG/20120502_FDF_CRG/20120502_FDF_CRG/20120516_FDF_CRG_c12.mtb	2311	91	WWSS	food_sc	3	7288	1337170567	1	0.02	0.00133333333333333	3780	1
1	Food 1	Intake 3	21	7415	1337170694	/users/cn/jespinosa/phecomp/data/CRG/20120502_FDF_CRG/20120502_FDF_CRG/20120516_FDF_CRG_c12.mtb	2312	30	WWSS	food_sc	3	7394	1337170673	1	0.04	0.0019047619047619	3781	1
1	Food 1	Intake 3	88	7533	1337170812	/users/cn/jespinosa/phecomp/data/CRG/20120502_FDF_CRG/20120502_FDF_CRG/20120516_FDF_CRG_c12.mtb	2313	6386	WWSS	food_sc	3	7445	1337170724	1	0.06	0.000681818181818182	3782	1
1	Drink 2	Intake 2	19	8406	1337171685	/users/cn/jespinosa/phecomp/data/CRG/20120502_FDF_CRG/20120502_FDF_CRG/20120516_FDF_CRG_c12.mtb	1135	NA	WWSS	water	2	8387	1337171666	1	0.08	0.00421052631578947	3783	1
1	Food 1	Intake 3	17	13936	1337177215	/users/cn/jespinosa/phecomp/data/CRG/20120502_FDF_CRG/20120502_FDF_CRG/20120516_FDF_CRG_c12.mtb	2315	2563	WWSS	food_sc	3	13919	1337177198	1	0.02	0.00117647058823529	3784	1
1	Food 2	Intake 4	18	16517	1337179796	/users/cn/jespinosa/phecomp/data/CRG/20120502_FDF_CRG/20120502_FDF_CRG/20120516_FDF_CRG_c12.mtb	3109	27	WWSS	food_sc	4	16499	1337179778	1	0.02	0.00111111111111111	3785	1
1	Food 2	Intake 4	37	16581	1337179860	/users/cn/jespinosa/phecomp/data/CRG/20120502_FDF_CRG/20120502_FDF_CRG/20120516_FDF_CRG_c12.mtb	3110	55	WWSS	food_sc	4	16544	1337179823	1	0.02	0.000540540540540541	3786	1
1	Food 2	Intake 4	332	16968	1337180247	/users/cn/jespinosa/phecomp/data/CRG/20120502_FDF_CRG/20120502_FDF_CRG/20120516_FDF_CRG_c12.mtb	3111	229	WWSS	food_sc	4	16636	1337179915	1	0.14	0.000421686746987952	3787	1
1	Food 1	Intake 3	36	17233	1337180512	/users/cn/jespinosa/phecomp/data/CRG/20120502_FDF_CRG/20120502_FDF_CRG/20120516_FDF_CRG_c12.mtb	2319	475	WWSS	food_sc	3	17197	1337180476	1	0.02	0.000555555555555556	3788	1
1	Drink 2	Intake 2	25	17691	1337180970	/users/cn/jespinosa/phecomp/data/CRG/20120502_FDF_CRG/20120502_FDF_CRG/20120516_FDF_CRG_c12.mtb	1136	NA	WWSS	water	2	17666	1337180945	1	0.06	0.0024	3789	1
1	Food 1	Intake 3	17	17725	1337181004	/users/cn/jespinosa/phecomp/data/CRG/20120502_FDF_CRG/20120502_FDF_CRG/20120516_FDF_CRG_c12.mtb	2320	9	WWSS	food_sc	3	17708	1337180987	1	0.02	0.00117647058823529	3790	1
1	Food 1	Intake 3	55	17789	1337181068	/users/cn/jespinosa/phecomp/data/CRG/20120502_FDF_CRG/20120502_FDF_CRG/20120516_FDF_CRG_c12.mtb	2321	7016	WWSS	food_sc	3	17734	1337181013	1	0.02	0.000363636363636364	3791	1
1	Drink 2	Intake 2	23	18148	1337181427	/users/cn/jespinosa/phecomp/data/CRG/20120502_FDF_CRG/20120502_FDF_CRG/20120516_FDF_CRG_c12.mtb	1137	NA	WWSS	water	2	18125	1337181404	1	0.06	0.00260869565217391	3792	1
1	Drink 2	Intake 2	26	18701	1337181980	/users/cn/jespinosa/phecomp/data/CRG/20120502_FDF_CRG/20120502_FDF_CRG/20120516_FDF_CRG_c12.mtb	1138	NA	WWSS	water	2	18675	1337181954	1	0.08	0.00307692307692308	3793	1
1	Food 2	Intake 4	23	24828	1337188107	/users/cn/jespinosa/phecomp/data/CRG/20120502_FDF_CRG/20120502_FDF_CRG/20120516_FDF_CRG_c12.mtb	3115	14	WWSS	food_sc	4	24805	1337188084	1	0.02	0.000869565217391304	3794	1
1	Food 2	Intake 4	219	25061	1337188340	/users/cn/jespinosa/phecomp/data/CRG/20120502_FDF_CRG/20120502_FDF_CRG/20120516_FDF_CRG_c12.mtb	3116	5202	WWSS	food_sc	4	24842	1337188121	1	0.44	0.00200913242009132	3795	1
1	Food 2	Intake 4	36	30299	1337193578	/users/cn/jespinosa/phecomp/data/CRG/20120502_FDF_CRG/20120502_FDF_CRG/20120516_FDF_CRG_c12.mtb	3119	17	WWSS	food_sc	4	30263	1337193542	1	0.02	0.000555555555555556	3796	1
1	Food 2	Intake 4	30	30346	1337193625	/users/cn/jespinosa/phecomp/data/CRG/20120502_FDF_CRG/20120502_FDF_CRG/20120516_FDF_CRG_c12.mtb	3120	39	WWSS	food_sc	4	30316	1337193595	1	0.02	0.000666666666666667	3797	1
1	Food 1	Intake 3	44	30429	1337193708	/users/cn/jespinosa/phecomp/data/CRG/20120502_FDF_CRG/20120502_FDF_CRG/20120516_FDF_CRG_c12.mtb	2324	1083	WWSS	food_sc	3	30385	1337193664	1	0.02	0.000454545454545455	3798	1
1	Drink 2	Intake 2	16	30488	1337193767	/users/cn/jespinosa/phecomp/data/CRG/20120502_FDF_CRG/20120502_FDF_CRG/20120516_FDF_CRG_c12.mtb	1139	NA	WWSS	water	2	30472	1337193751	1	0.04	0.0025	3799	1
1	Drink 2	Intake 2	21	30968	1337194247	/users/cn/jespinosa/phecomp/data/CRG/20120502_FDF_CRG/20120502_FDF_CRG/20120516_FDF_CRG_c12.mtb	1141	NA	WWSS	water	2	30947	1337194226	1	0.04	0.0019047619047619	3800	1
1	Drink 2	Intake 2	8	30992	1337194271	/users/cn/jespinosa/phecomp/data/CRG/20120502_FDF_CRG/20120502_FDF_CRG/20120516_FDF_CRG_c12.mtb	1142	NA	WWSS	water	2	30984	1337194263	1	0.02	0.0025	3801	1
1	Drink 2	Intake 2	13	31068	1337194347	/users/cn/jespinosa/phecomp/data/CRG/20120502_FDF_CRG/20120502_FDF_CRG/20120516_FDF_CRG_c12.mtb	1143	NA	WWSS	water	2	31055	1337194334	1	0.04	0.00307692307692308	3802	1
1	Food 2	Intake 4	135	31647	1337194926	/users/cn/jespinosa/phecomp/data/CRG/20120502_FDF_CRG/20120502_FDF_CRG/20120516_FDF_CRG_c12.mtb	3127	28	WWSS	food_sc	4	31512	1337194791	1	0.04	0.000296296296296296	3803	1
1	Food 2	Intake 4	20	31695	1337194974	/users/cn/jespinosa/phecomp/data/CRG/20120502_FDF_CRG/20120502_FDF_CRG/20120516_FDF_CRG_c12.mtb	3128	56	WWSS	food_sc	4	31675	1337194954	1	0.02	0.001	3804	1
1	Food 2	Intake 4	153	31904	1337195183	/users/cn/jespinosa/phecomp/data/CRG/20120502_FDF_CRG/20120502_FDF_CRG/20120516_FDF_CRG_c12.mtb	3129	460	WWSS	food_sc	4	31751	1337195030	1	0.04	0.000261437908496732	3805	1
1	Drink 2	Intake 2	18	32217	1337195496	/users/cn/jespinosa/phecomp/data/CRG/20120502_FDF_CRG/20120502_FDF_CRG/20120516_FDF_CRG_c12.mtb	1144	NA	WWSS	water	2	32199	1337195478	1	0.08	0.00444444444444444	3806	1
1	Food 2	Intake 4	84	32448	1337195727	/users/cn/jespinosa/phecomp/data/CRG/20120502_FDF_CRG/20120502_FDF_CRG/20120516_FDF_CRG_c12.mtb	3132	259	WWSS	food_sc	4	32364	1337195643	1	0.0399999999999999	0.000476190476190475	3807	1
1	Drink 1	Intake 1	126	32524	1337195803	/users/cn/jespinosa/phecomp/data/CRG/20120502_FDF_CRG/20120502_FDF_CRG/20120516_FDF_CRG_c12.mtb	2329	NA	WWSS	water	1	32398	1337195677	1	0.02	0.000158730158730159	3808	1
1	Food 1	Intake 3	64	32771	1337196050	/users/cn/jespinosa/phecomp/data/CRG/20120502_FDF_CRG/20120502_FDF_CRG/20120516_FDF_CRG_c12.mtb	2334	72	WWSS	food_sc	3	32707	1337195986	1	0.02	0.0003125	3809	1
1	Food 1	Intake 3	38	32881	1337196160	/users/cn/jespinosa/phecomp/data/CRG/20120502_FDF_CRG/20120502_FDF_CRG/20120516_FDF_CRG_c12.mtb	2336	COLL	WWSS	food_sc	3	32843	1337196122	1	0.02	0.000526315789473684	3810	1
1	Food 2	Intake 4	97	32965	1337196244	/users/cn/jespinosa/phecomp/data/CRG/20120502_FDF_CRG/20120502_FDF_CRG/20120516_FDF_CRG_c12.mtb	3136	2400	WWSS	food_sc	4	32868	1337196147	1	0.04	0.000412371134020619	3811	1
1	Drink 2	Intake 2	20	32992	1337196271	/users/cn/jespinosa/phecomp/data/CRG/20120502_FDF_CRG/20120502_FDF_CRG/20120516_FDF_CRG_c12.mtb	1145	NA	WWSS	water	2	32972	1337196251	1	0.04	0.002	3812	1
1	Drink 1	Intake 1	428	34032	1337197311	/users/cn/jespinosa/phecomp/data/CRG/20120502_FDF_CRG/20120502_FDF_CRG/20120516_FDF_CRG_c12.mtb	2333	NA	WWSS	water	1	33604	1337196883	1	0.02	4.67289719626168e-05	3813	1
1	Food 2	Intake 4	52	35417	1337198696	/users/cn/jespinosa/phecomp/data/CRG/20120502_FDF_CRG/20120502_FDF_CRG/20120516_FDF_CRG_c12.mtb	3137	11	WWSS	food_sc	4	35365	1337198644	1	0.02	0.000384615384615385	3814	1
1	Food 2	Intake 4	43	35471	1337198750	/users/cn/jespinosa/phecomp/data/CRG/20120502_FDF_CRG/20120502_FDF_CRG/20120516_FDF_CRG_c12.mtb	3138	71	WWSS	food_sc	4	35428	1337198707	1	0.02	0.000465116279069767	3815	1
1	Food 2	Intake 4	44	35586	1337198865	/users/cn/jespinosa/phecomp/data/CRG/20120502_FDF_CRG/20120502_FDF_CRG/20120516_FDF_CRG_c12.mtb	3140	2071	WWSS	food_sc	4	35542	1337198821	1	0.02	0.000454545454545455	3816	1
1	Drink 2	Intake 2	15	35623	1337198902	/users/cn/jespinosa/phecomp/data/CRG/20120502_FDF_CRG/20120502_FDF_CRG/20120516_FDF_CRG_c12.mtb	1146	NA	WWSS	water	2	35608	1337198887	1	0.02	0.00133333333333333	3817	1
1	Food 2	Intake 4	289	37946	1337201225	/users/cn/jespinosa/phecomp/data/CRG/20120502_FDF_CRG/20120502_FDF_CRG/20120516_FDF_CRG_c12.mtb	3141	63	WWSS	food_sc	4	37657	1337200936	1	0.12	0.00041522491349481	3818	1
1	Drink 1	Intake 1	304	38043	1337201322	/users/cn/jespinosa/phecomp/data/CRG/20120502_FDF_CRG/20120502_FDF_CRG/20120516_FDF_CRG_c12.mtb	2346	NA	WWSS	water	1	37739	1337201018	1	0.02	6.57894736842105e-05	3819	1
1	Food 1	Intake 3	18	38027	1337201306	/users/cn/jespinosa/phecomp/data/CRG/20120502_FDF_CRG/20120502_FDF_CRG/20120516_FDF_CRG_c12.mtb	2339	11	WWSS	food_sc	3	38009	1337201288	1	0.02	0.00111111111111111	3820	1
1	Food 1	Intake 3	144	38182	1337201461	/users/cn/jespinosa/phecomp/data/CRG/20120502_FDF_CRG/20120502_FDF_CRG/20120516_FDF_CRG_c12.mtb	2340	COLL	WWSS	food_sc	3	38038	1337201317	1	0.04	0.000277777777777778	3821	1
1	Food 2	Intake 4	28	38103	1337201382	/users/cn/jespinosa/phecomp/data/CRG/20120502_FDF_CRG/20120502_FDF_CRG/20120516_FDF_CRG_c12.mtb	3143	106	WWSS	food_sc	4	38075	1337201354	1	0.02	0.000714285714285714	3822	1
1	Drink 2	Intake 2	17	38188	1337201467	/users/cn/jespinosa/phecomp/data/CRG/20120502_FDF_CRG/20120502_FDF_CRG/20120516_FDF_CRG_c12.mtb	1147	NA	WWSS	water	2	38171	1337201450	1	0.0399999999999999	0.00235294117647058	3823	1
1	Food 1	Intake 3	79	38288	1337201567	/users/cn/jespinosa/phecomp/data/CRG/20120502_FDF_CRG/20120502_FDF_CRG/20120516_FDF_CRG_c12.mtb	2341	COLL	WWSS	food_sc	3	38209	1337201488	1	0.02	0.000253164556962025	3824	1
1	Food 2	Intake 4	85	38346	1337201625	/users/cn/jespinosa/phecomp/data/CRG/20120502_FDF_CRG/20120502_FDF_CRG/20120516_FDF_CRG_c12.mtb	3144	10	WWSS	food_sc	4	38261	1337201540	1	0.02	0.000235294117647059	3825	1
1	Food 2	Intake 4	56	38412	1337201691	/users/cn/jespinosa/phecomp/data/CRG/20120502_FDF_CRG/20120502_FDF_CRG/20120516_FDF_CRG_c12.mtb	3145	82	WWSS	food_sc	4	38356	1337201635	1	0.02	0.000357142857142857	3826	1
1	Drink 2	Intake 2	18	38506	1337201785	/users/cn/jespinosa/phecomp/data/CRG/20120502_FDF_CRG/20120502_FDF_CRG/20120516_FDF_CRG_c12.mtb	1148	NA	WWSS	water	2	38488	1337201767	1	0.02	0.00111111111111111	3827	1
1	Food 1	Intake 3	97	38591	1337201870	/users/cn/jespinosa/phecomp/data/CRG/20120502_FDF_CRG/20120502_FDF_CRG/20120516_FDF_CRG_c12.mtb	2344	971	WWSS	food_sc	3	38494	1337201773	1	0.02	0.000206185567010309	3828	1
1	Drink 2	Intake 2	25	38744	1337202023	/users/cn/jespinosa/phecomp/data/CRG/20120502_FDF_CRG/20120502_FDF_CRG/20120516_FDF_CRG_c12.mtb	1149	NA	WWSS	water	2	38719	1337201998	1	0.04	0.0016	3829	1
1	Drink 2	Intake 2	13	38803	1337202082	/users/cn/jespinosa/phecomp/data/CRG/20120502_FDF_CRG/20120502_FDF_CRG/20120516_FDF_CRG_c12.mtb	1150	NA	WWSS	water	2	38790	1337202069	1	0.02	0.00153846153846154	3830	1
1	Drink 1	Intake 1	19	38960	1337202239	/users/cn/jespinosa/phecomp/data/CRG/20120502_FDF_CRG/20120502_FDF_CRG/20120516_FDF_CRG_c12.mtb	2351	NA	WWSS	water	1	38941	1337202220	1	0.04	0.00210526315789474	3831	1
1	Drink 1	Intake 1	14	39496	1337202775	/users/cn/jespinosa/phecomp/data/CRG/20120502_FDF_CRG/20120502_FDF_CRG/20120516_FDF_CRG_c12.mtb	2352	NA	WWSS	water	1	39482	1337202761	1	0.02	0.00142857142857143	3832	1
1	Drink 2	Intake 2	15	39499	1337202778	/users/cn/jespinosa/phecomp/data/CRG/20120502_FDF_CRG/20120502_FDF_CRG/20120516_FDF_CRG_c12.mtb	1151	NA	WWSS	water	2	39484	1337202763	1	0.0399999999999999	0.00266666666666666	3833	1
1	Food 2	Intake 4	104	39666	1337202945	/users/cn/jespinosa/phecomp/data/CRG/20120502_FDF_CRG/20120502_FDF_CRG/20120516_FDF_CRG_c12.mtb	3153	29	WWSS	food_sc	4	39562	1337202841	1	0.02	0.000192307692307692	3834	1
1	Food 2	Intake 4	32	39727	1337203006	/users/cn/jespinosa/phecomp/data/CRG/20120502_FDF_CRG/20120502_FDF_CRG/20120516_FDF_CRG_c12.mtb	3154	83	WWSS	food_sc	4	39695	1337202974	1	0.02	0.000625	3835	1
1	Food 2	Intake 4	119	39929	1337203208	/users/cn/jespinosa/phecomp/data/CRG/20120502_FDF_CRG/20120502_FDF_CRG/20120516_FDF_CRG_c12.mtb	3156	285	WWSS	food_sc	4	39810	1337203089	1	0.02	0.000168067226890756	3836	1
1	Drink 1	Intake 1	15	39978	1337203257	/users/cn/jespinosa/phecomp/data/CRG/20120502_FDF_CRG/20120502_FDF_CRG/20120516_FDF_CRG_c12.mtb	2353	NA	WWSS	water	1	39963	1337203242	1	0.02	0.00133333333333333	3837	1
1	Drink 2	Intake 2	13	40149	1337203428	/users/cn/jespinosa/phecomp/data/CRG/20120502_FDF_CRG/20120502_FDF_CRG/20120516_FDF_CRG_c12.mtb	1152	NA	WWSS	water	2	40136	1337203415	1	0.02	0.00153846153846154	3838	1
1	Drink 1	Intake 1	8	40158	1337203437	/users/cn/jespinosa/phecomp/data/CRG/20120502_FDF_CRG/20120502_FDF_CRG/20120516_FDF_CRG_c12.mtb	2355	NA	WWSS	water	1	40150	1337203429	1	0.02	0.0025	3839	1
1	Food 2	Intake 4	45	40259	1337203538	/users/cn/jespinosa/phecomp/data/CRG/20120502_FDF_CRG/20120502_FDF_CRG/20120516_FDF_CRG_c12.mtb	3157	91	WWSS	food_sc	4	40214	1337203493	1	0.02	0.000444444444444444	3840	1
1	Food 2	Intake 4	49	40399	1337203678	/users/cn/jespinosa/phecomp/data/CRG/20120502_FDF_CRG/20120502_FDF_CRG/20120516_FDF_CRG_c12.mtb	3159	79	WWSS	food_sc	4	40350	1337203629	1	0.02	0.000408163265306122	3841	1
1	Food 2	Intake 4	100	40578	1337203857	/users/cn/jespinosa/phecomp/data/CRG/20120502_FDF_CRG/20120502_FDF_CRG/20120516_FDF_CRG_c12.mtb	3161	125	WWSS	food_sc	4	40478	1337203757	1	0.02	0.0002	3842	1
1	Drink 2	Intake 2	17	40611	1337203890	/users/cn/jespinosa/phecomp/data/CRG/20120502_FDF_CRG/20120502_FDF_CRG/20120516_FDF_CRG_c12.mtb	1154	NA	WWSS	water	2	40594	1337203873	1	0.0600000000000001	0.00352941176470589	3843	1
1	Food 2	Intake 4	103	40806	1337204085	/users/cn/jespinosa/phecomp/data/CRG/20120502_FDF_CRG/20120502_FDF_CRG/20120516_FDF_CRG_c12.mtb	3162	588	WWSS	food_sc	4	40703	1337203982	1	0.04	0.000388349514563107	3844	1
1	Food 1	Intake 3	115	41509	1337204788	/users/cn/jespinosa/phecomp/data/CRG/20120502_FDF_CRG/20120502_FDF_CRG/20120516_FDF_CRG_c12.mtb	2359	31	WWSS	food_sc	3	41394	1337204673	1	0.06	0.000521739130434783	3845	1
1	Food 2	Intake 4	65	41605	1337204884	/users/cn/jespinosa/phecomp/data/CRG/20120502_FDF_CRG/20120502_FDF_CRG/20120516_FDF_CRG_c12.mtb	3168	752	WWSS	food_sc	4	41540	1337204819	1	0.0399999999999998	0.000615384615384612	3846	1
1	Drink 2	Intake 2	28	41626	1337204905	/users/cn/jespinosa/phecomp/data/CRG/20120502_FDF_CRG/20120502_FDF_CRG/20120516_FDF_CRG_c12.mtb	1155	NA	WWSS	water	2	41598	1337204877	1	0.08	0.00285714285714286	3847	1
1	Food 2	Intake 4	83	42440	1337205719	/users/cn/jespinosa/phecomp/data/CRG/20120502_FDF_CRG/20120502_FDF_CRG/20120516_FDF_CRG_c12.mtb	3171	COLL	WWSS	food_sc	4	42357	1337205636	1	0.02	0.000240963855421687	3848	1
1	Food 1	Intake 3	192	42620	1337205899	/users/cn/jespinosa/phecomp/data/CRG/20120502_FDF_CRG/20120502_FDF_CRG/20120516_FDF_CRG_c12.mtb	2366	1198	WWSS	food_sc	3	42428	1337205707	1	0.02	0.000104166666666667	3849	1
1	Drink 2	Intake 2	26	42812	1337206091	/users/cn/jespinosa/phecomp/data/CRG/20120502_FDF_CRG/20120502_FDF_CRG/20120516_FDF_CRG_c12.mtb	1156	NA	WWSS	water	2	42786	1337206065	1	0.04	0.00153846153846154	3850	1
1	Drink 2	Intake 2	18	43197	1337206476	/users/cn/jespinosa/phecomp/data/CRG/20120502_FDF_CRG/20120502_FDF_CRG/20120516_FDF_CRG_c12.mtb	1157	NA	WWSS	water	2	43179	1337206458	1	0.0399999999999999	0.00222222222222222	3851	1
1	Food 2	Intake 4	128	43946	1337207225	/users/cn/jespinosa/phecomp/data/CRG/20120502_FDF_CRG/20120502_FDF_CRG/20120516_FDF_CRG_c12.mtb	3176	12	WWSS	food_sc	4	43818	1337207097	1	0.02	0.00015625	3852	1
1	Food 2	Intake 4	17	43975	1337207254	/users/cn/jespinosa/phecomp/data/CRG/20120502_FDF_CRG/20120502_FDF_CRG/20120516_FDF_CRG_c12.mtb	3177	41	WWSS	food_sc	4	43958	1337207237	1	0.02	0.00117647058823529	3853	1
1	Food 1	Intake 3	132	44148	1337207427	/users/cn/jespinosa/phecomp/data/CRG/20120502_FDF_CRG/20120502_FDF_CRG/20120516_FDF_CRG_c12.mtb	2371	199	WWSS	food_sc	3	44016	1337207295	1	0.02	0.000151515151515152	3854	1
1	Food 1	Intake 3	48	44395	1337207674	/users/cn/jespinosa/phecomp/data/CRG/20120502_FDF_CRG/20120502_FDF_CRG/20120516_FDF_CRG_c12.mtb	2374	3657	WWSS	food_sc	3	44347	1337207626	1	0.02	0.000416666666666667	3855	1
1	Drink 2	Intake 2	23	44415	1337207694	/users/cn/jespinosa/phecomp/data/CRG/20120502_FDF_CRG/20120502_FDF_CRG/20120516_FDF_CRG_c12.mtb	1158	NA	WWSS	water	2	44392	1337207671	1	0.0600000000000001	0.00260869565217392	3856	1
1	Food 2	Intake 4	115	48167	1337211446	/users/cn/jespinosa/phecomp/data/CRG/20120502_FDF_CRG/20120502_FDF_CRG/20120516_FDF_CRG_c12.mtb	3180	12	WWSS	food_sc	4	48052	1337211331	1	0.0600000000000001	0.000521739130434784	3857	1
1	Food 2	Intake 4	30	48209	1337211488	/users/cn/jespinosa/phecomp/data/CRG/20120502_FDF_CRG/20120502_FDF_CRG/20120516_FDF_CRG_c12.mtb	3181	63	WWSS	food_sc	4	48179	1337211458	1	0.02	0.000666666666666667	3858	1
1	Food 1	Intake 3	56	48328	1337211607	/users/cn/jespinosa/phecomp/data/CRG/20120502_FDF_CRG/20120502_FDF_CRG/20120516_FDF_CRG_c12.mtb	2375	22	WWSS	food_sc	3	48272	1337211551	1	0.02	0.000357142857142857	3859	1
1	Food 1	Intake 3	21	48371	1337211650	/users/cn/jespinosa/phecomp/data/CRG/20120502_FDF_CRG/20120502_FDF_CRG/20120516_FDF_CRG_c12.mtb	2376	248	WWSS	food_sc	3	48350	1337211629	1	0.02	0.000952380952380952	3860	1
1	Food 2	Intake 4	158	48777	1337212056	/users/cn/jespinosa/phecomp/data/CRG/20120502_FDF_CRG/20120502_FDF_CRG/20120516_FDF_CRG_c12.mtb	3184	48	WWSS	food_sc	4	48619	1337211898	1	0.04	0.000253164556962025	3861	1
1	Drink 2	Intake 2	17	48807	1337212086	/users/cn/jespinosa/phecomp/data/CRG/20120502_FDF_CRG/20120502_FDF_CRG/20120516_FDF_CRG_c12.mtb	1159	NA	WWSS	water	2	48790	1337212069	1	0.02	0.00117647058823529	3862	1
1	Food 2	Intake 4	94	48919	1337212198	/users/cn/jespinosa/phecomp/data/CRG/20120502_FDF_CRG/20120502_FDF_CRG/20120516_FDF_CRG_c12.mtb	3185	16	WWSS	food_sc	4	48825	1337212104	1	0.02	0.000212765957446809	3863	1
1	Food 2	Intake 4	100	49035	1337212314	/users/cn/jespinosa/phecomp/data/CRG/20120502_FDF_CRG/20120502_FDF_CRG/20120516_FDF_CRG_c12.mtb	3186	604	WWSS	food_sc	4	48935	1337212214	1	0.04	0.0004	3864	1
1	Drink 2	Intake 2	22	49052	1337212331	/users/cn/jespinosa/phecomp/data/CRG/20120502_FDF_CRG/20120502_FDF_CRG/20120516_FDF_CRG_c12.mtb	1160	NA	WWSS	water	2	49030	1337212309	1	0.0600000000000001	0.00272727272727273	3865	1
1	Drink 2	Intake 2	25	49221	1337212500	/users/cn/jespinosa/phecomp/data/CRG/20120502_FDF_CRG/20120502_FDF_CRG/20120516_FDF_CRG_c12.mtb	1161	NA	WWSS	water	2	49196	1337212475	1	0.0599999999999998	0.00239999999999999	3866	1
1	Drink 2	Intake 2	21	49417	1337212696	/users/cn/jespinosa/phecomp/data/CRG/20120502_FDF_CRG/20120502_FDF_CRG/20120516_FDF_CRG_c12.mtb	1162	NA	WWSS	water	2	49396	1337212675	1	0.02	0.000952380952380952	3867	1
1	Food 1	Intake 3	192	49831	1337213110	/users/cn/jespinosa/phecomp/data/CRG/20120502_FDF_CRG/20120502_FDF_CRG/20120516_FDF_CRG_c12.mtb	2388	1094	WWSS	food_sc	3	49639	1337212918	1	0.02	0.000104166666666667	3868	1
1	Drink 2	Intake 2	26	49870	1337213149	/users/cn/jespinosa/phecomp/data/CRG/20120502_FDF_CRG/20120502_FDF_CRG/20120516_FDF_CRG_c12.mtb	1163	NA	WWSS	water	2	49844	1337213123	1	0.0600000000000001	0.00230769230769231	3869	1
1	Food 1	Intake 3	101	51026	1337214305	/users/cn/jespinosa/phecomp/data/CRG/20120502_FDF_CRG/20120502_FDF_CRG/20120516_FDF_CRG_c12.mtb	2393	370	WWSS	food_sc	3	50925	1337214204	1	0.0399999999999999	0.000396039603960395	3870	1
1	Drink 2	Intake 2	17	51093	1337214372	/users/cn/jespinosa/phecomp/data/CRG/20120502_FDF_CRG/20120502_FDF_CRG/20120516_FDF_CRG_c12.mtb	1165	NA	WWSS	water	2	51076	1337214355	1	0.02	0.00117647058823529	3871	1
1	Food 1	Intake 3	117	51513	1337214792	/users/cn/jespinosa/phecomp/data/CRG/20120502_FDF_CRG/20120502_FDF_CRG/20120516_FDF_CRG_c12.mtb	2394	29	WWSS	food_sc	3	51396	1337214675	1	0.44	0.00376068376068376	3872	1
1	Drink 2	Intake 2	31	51546	1337214825	/users/cn/jespinosa/phecomp/data/CRG/20120502_FDF_CRG/20120502_FDF_CRG/20120516_FDF_CRG_c12.mtb	1167	NA	WWSS	water	2	51515	1337214794	1	0.04	0.00129032258064516	3873	1
1	Food 1	Intake 3	78	51620	1337214899	/users/cn/jespinosa/phecomp/data/CRG/20120502_FDF_CRG/20120502_FDF_CRG/20120516_FDF_CRG_c12.mtb	2395	59	WWSS	food_sc	3	51542	1337214821	1	0.02	0.000256410256410256	3874	1
1	Food 1	Intake 3	64	51743	1337215022	/users/cn/jespinosa/phecomp/data/CRG/20120502_FDF_CRG/20120502_FDF_CRG/20120516_FDF_CRG_c12.mtb	2397	3224	WWSS	food_sc	3	51679	1337214958	1	0.02	0.0003125	3875	1
1	Drink 2	Intake 2	29	52178	1337215457	/users/cn/jespinosa/phecomp/data/CRG/20120502_FDF_CRG/20120502_FDF_CRG/20120516_FDF_CRG_c12.mtb	1169	NA	WWSS	water	2	52149	1337215428	1	0.02	0.000689655172413793	3876	1
1	Food 2	Intake 4	49	55016	1337218295	/users/cn/jespinosa/phecomp/data/CRG/20120502_FDF_CRG/20120502_FDF_CRG/20120516_FDF_CRG_c12.mtb	3198	3328	WWSS	food_sc	4	54967	1337218246	1	0.04	0.000816326530612245	3877	1
1	Food 2	Intake 4	99	58443	1337221722	/users/cn/jespinosa/phecomp/data/CRG/20120502_FDF_CRG/20120502_FDF_CRG/20120516_FDF_CRG_c12.mtb	3200	3080	WWSS	food_sc	4	58344	1337221623	1	0.0599999999999998	0.000606060606060604	3878	1
1	Food 1	Intake 3	16	61539	1337224818	/users/cn/jespinosa/phecomp/data/CRG/20120502_FDF_CRG/20120502_FDF_CRG/20120516_FDF_CRG_c12.mtb	2399	10	WWSS	food_sc	3	61523	1337224802	1	0.02	0.00125	3879	1
1	Food 1	Intake 3	40	61589	1337224868	/users/cn/jespinosa/phecomp/data/CRG/20120502_FDF_CRG/20120502_FDF_CRG/20120516_FDF_CRG_c12.mtb	2400	30	WWSS	food_sc	3	61549	1337224828	1	0.0599999999999998	0.00149999999999999	3880	1
1	Food 1	Intake 3	12	61631	1337224910	/users/cn/jespinosa/phecomp/data/CRG/20120502_FDF_CRG/20120502_FDF_CRG/20120516_FDF_CRG_c12.mtb	2401	2934	WWSS	food_sc	3	61619	1337224898	1	0.02	0.00166666666666667	3881	1
1	Food 1	Intake 3	101	64666	1337227945	/users/cn/jespinosa/phecomp/data/CRG/20120502_FDF_CRG/20120502_FDF_CRG/20120516_FDF_CRG_c12.mtb	2402	1988	WWSS	food_sc	3	64565	1337227844	1	0.04	0.000396039603960396	3882	1
1	Drink 2	Intake 2	31	66032	1337229311	/users/cn/jespinosa/phecomp/data/CRG/20120502_FDF_CRG/20120502_FDF_CRG/20120516_FDF_CRG_c12.mtb	1172	NA	WWSS	water	2	66001	1337229280	1	0.16	0.00516129032258065	3883	1
1	Food 2	Intake 4	31	66685	1337229964	/users/cn/jespinosa/phecomp/data/CRG/20120502_FDF_CRG/20120502_FDF_CRG/20120516_FDF_CRG_c12.mtb	3206	117	WWSS	food_sc	4	66654	1337229933	1	0.02	0.000645161290322581	3884	1
1	Food 1	Intake 3	19	66821	1337230100	/users/cn/jespinosa/phecomp/data/CRG/20120502_FDF_CRG/20120502_FDF_CRG/20120516_FDF_CRG_c12.mtb	2406	16	WWSS	food_sc	3	66802	1337230081	1	0.02	0.00105263157894737	3885	1
1	Food 1	Intake 3	41	66878	1337230157	/users/cn/jespinosa/phecomp/data/CRG/20120502_FDF_CRG/20120502_FDF_CRG/20120516_FDF_CRG_c12.mtb	2407	85	WWSS	food_sc	3	66837	1337230116	1	0.02	0.00048780487804878	3886	1
1	Food 2	Intake 4	115	67078	1337230357	/users/cn/jespinosa/phecomp/data/CRG/20120502_FDF_CRG/20120502_FDF_CRG/20120516_FDF_CRG_c12.mtb	3210	12	WWSS	food_sc	4	66963	1337230242	1	0.04	0.000347826086956522	3887	1
1	Food 2	Intake 4	83	67173	1337230452	/users/cn/jespinosa/phecomp/data/CRG/20120502_FDF_CRG/20120502_FDF_CRG/20120516_FDF_CRG_c12.mtb	3211	17	WWSS	food_sc	4	67090	1337230369	1	0.02	0.000240963855421687	3888	1
1	Food 2	Intake 4	97	67287	1337230566	/users/cn/jespinosa/phecomp/data/CRG/20120502_FDF_CRG/20120502_FDF_CRG/20120516_FDF_CRG_c12.mtb	3212	75	WWSS	food_sc	4	67190	1337230469	1	0.0399999999999998	0.000412371134020617	3889	1
1	Drink 2	Intake 2	31	67311	1337230590	/users/cn/jespinosa/phecomp/data/CRG/20120502_FDF_CRG/20120502_FDF_CRG/20120516_FDF_CRG_c12.mtb	1173	NA	WWSS	water	2	67280	1337230559	1	0.0800000000000001	0.00258064516129033	3890	1
1	Food 2	Intake 4	154	67516	1337230795	/users/cn/jespinosa/phecomp/data/CRG/20120502_FDF_CRG/20120502_FDF_CRG/20120516_FDF_CRG_c12.mtb	3213	22	WWSS	food_sc	4	67362	1337230641	1	0.02	0.00012987012987013	3891	1
1	Drink 2	Intake 2	16	67529	1337230808	/users/cn/jespinosa/phecomp/data/CRG/20120502_FDF_CRG/20120502_FDF_CRG/20120516_FDF_CRG_c12.mtb	1175	NA	WWSS	water	2	67513	1337230792	1	0.04	0.0025	3892	1
1	Food 2	Intake 4	68	67606	1337230885	/users/cn/jespinosa/phecomp/data/CRG/20120502_FDF_CRG/20120502_FDF_CRG/20120516_FDF_CRG_c12.mtb	3214	127	WWSS	food_sc	4	67538	1337230817	1	0.04	0.000588235294117647	3893	1
1	Food 2	Intake 4	31	67764	1337231043	/users/cn/jespinosa/phecomp/data/CRG/20120502_FDF_CRG/20120502_FDF_CRG/20120516_FDF_CRG_c12.mtb	3216	1363	WWSS	food_sc	4	67733	1337231012	1	0.04	0.00129032258064516	3894	1
1	Drink 2	Intake 2	23	67784	1337231063	/users/cn/jespinosa/phecomp/data/CRG/20120502_FDF_CRG/20120502_FDF_CRG/20120516_FDF_CRG_c12.mtb	1177	NA	WWSS	water	2	67761	1337231040	1	0.0800000000000001	0.00347826086956522	3895	1
1	Drink 2	Intake 2	23	68537	1337231816	/users/cn/jespinosa/phecomp/data/CRG/20120502_FDF_CRG/20120502_FDF_CRG/20120516_FDF_CRG_c12.mtb	1179	NA	WWSS	water	2	68514	1337231793	1	0.04	0.00173913043478261	3896	1
1	Drink 1	Intake 1	26	68608	1337231887	/users/cn/jespinosa/phecomp/data/CRG/20120502_FDF_CRG/20120502_FDF_CRG/20120516_FDF_CRG_c12.mtb	2364	NA	WWSS	water	1	68582	1337231861	1	0.02	0.000769230769230769	3897	1
1	Food 2	Intake 4	75	69202	1337232481	/users/cn/jespinosa/phecomp/data/CRG/20120502_FDF_CRG/20120502_FDF_CRG/20120516_FDF_CRG_c12.mtb	3220	498	WWSS	food_sc	4	69127	1337232406	1	0.02	0.000266666666666667	3898	1
1	Drink 2	Intake 2	22	69594	1337232873	/users/cn/jespinosa/phecomp/data/CRG/20120502_FDF_CRG/20120502_FDF_CRG/20120516_FDF_CRG_c12.mtb	1180	NA	WWSS	water	2	69572	1337232851	1	0.04	0.00181818181818182	3899	1
1	Food 2	Intake 4	46	69746	1337233025	/users/cn/jespinosa/phecomp/data/CRG/20120502_FDF_CRG/20120502_FDF_CRG/20120516_FDF_CRG_c12.mtb	3225	206	WWSS	food_sc	4	69700	1337232979	1	0.02	0.000434782608695652	3900	1
1	Food 2	Intake 4	32	69984	1337233263	/users/cn/jespinosa/phecomp/data/CRG/20120502_FDF_CRG/20120502_FDF_CRG/20120516_FDF_CRG_c12.mtb	3229	282	WWSS	food_sc	4	69952	1337233231	1	0.02	0.000625	3901	1
1	Drink 2	Intake 2	21	70001	1337233280	/users/cn/jespinosa/phecomp/data/CRG/20120502_FDF_CRG/20120502_FDF_CRG/20120516_FDF_CRG_c12.mtb	1182	NA	WWSS	water	2	69980	1337233259	1	0.02	0.000952380952380952	3902	1
1	Drink 2	Intake 2	25	70262	1337233541	/users/cn/jespinosa/phecomp/data/CRG/20120502_FDF_CRG/20120502_FDF_CRG/20120516_FDF_CRG_c12.mtb	1183	NA	WWSS	water	2	70237	1337233516	1	0.0399999999999998	0.00159999999999999	3903	1
1	Food 2	Intake 4	79	70345	1337233624	/users/cn/jespinosa/phecomp/data/CRG/20120502_FDF_CRG/20120502_FDF_CRG/20120516_FDF_CRG_c12.mtb	3231	252	WWSS	food_sc	4	70266	1337233545	1	0.02	0.000253164556962025	3904	1
1	Food 1	Intake 3	105	70702	1337233981	/users/cn/jespinosa/phecomp/data/CRG/20120502_FDF_CRG/20120502_FDF_CRG/20120516_FDF_CRG_c12.mtb	2427	129	WWSS	food_sc	3	70597	1337233876	1	0.04	0.000380952380952381	3905	1
1	Drink 2	Intake 2	28	70739	1337234018	/users/cn/jespinosa/phecomp/data/CRG/20120502_FDF_CRG/20120502_FDF_CRG/20120516_FDF_CRG_c12.mtb	1184	NA	WWSS	water	2	70711	1337233990	1	0.0600000000000001	0.00214285714285715	3906	1
1	Food 2	Intake 4	144	70975	1337234254	/users/cn/jespinosa/phecomp/data/CRG/20120502_FDF_CRG/20120502_FDF_CRG/20120516_FDF_CRG_c12.mtb	3236	133	WWSS	food_sc	4	70831	1337234110	1	0.02	0.000138888888888889	3907	1
1	Food 2	Intake 4	113	71221	1337234500	/users/cn/jespinosa/phecomp/data/CRG/20120502_FDF_CRG/20120502_FDF_CRG/20120516_FDF_CRG_c12.mtb	3238	287	WWSS	food_sc	4	71108	1337234387	1	0.04	0.000353982300884956	3908	1
1	Drink 2	Intake 2	17	71230	1337234509	/users/cn/jespinosa/phecomp/data/CRG/20120502_FDF_CRG/20120502_FDF_CRG/20120516_FDF_CRG_c12.mtb	1185	NA	WWSS	water	2	71213	1337234492	1	0.02	0.00117647058823529	3909	1
1	Food 1	Intake 3	59	71567	1337234846	/users/cn/jespinosa/phecomp/data/CRG/20120502_FDF_CRG/20120502_FDF_CRG/20120516_FDF_CRG_c12.mtb	2434	4	WWSS	food_sc	3	71508	1337234787	1	0.02	0.000338983050847458	3910	1
1	Food 1	Intake 3	215	71786	1337235065	/users/cn/jespinosa/phecomp/data/CRG/20120502_FDF_CRG/20120502_FDF_CRG/20120516_FDF_CRG_c12.mtb	2435	96	WWSS	food_sc	3	71571	1337234850	1	0.0399999999999998	0.000186046511627906	3911	1
1	Drink 2	Intake 2	41	71837	1337235116	/users/cn/jespinosa/phecomp/data/CRG/20120502_FDF_CRG/20120502_FDF_CRG/20120516_FDF_CRG_c12.mtb	1186	NA	WWSS	water	2	71796	1337235075	1	0.12	0.00292682926829268	3912	1
1	Food 1	Intake 3	52	71934	1337235213	/users/cn/jespinosa/phecomp/data/CRG/20120502_FDF_CRG/20120502_FDF_CRG/20120516_FDF_CRG_c12.mtb	2436	778	WWSS	food_sc	3	71882	1337235161	1	0.02	0.000384615384615385	3913	1
1	Drink 2	Intake 2	15	72138	1337235417	/users/cn/jespinosa/phecomp/data/CRG/20120502_FDF_CRG/20120502_FDF_CRG/20120516_FDF_CRG_c12.mtb	1187	NA	WWSS	water	2	72123	1337235402	1	0.04	0.00266666666666667	3914	1
1	Food 1	Intake 3	80	72792	1337236071	/users/cn/jespinosa/phecomp/data/CRG/20120502_FDF_CRG/20120502_FDF_CRG/20120516_FDF_CRG_c12.mtb	2438	4788	WWSS	food_sc	3	72712	1337235991	1	0.02	0.00025	3915	1
1	Food 1	Intake 3	42	77622	1337240901	/users/cn/jespinosa/phecomp/data/CRG/20120502_FDF_CRG/20120502_FDF_CRG/20120516_FDF_CRG_c12.mtb	2439	72	WWSS	food_sc	3	77580	1337240859	1	0.04	0.000952380952380952	3916	1
1	Food 1	Intake 3	41	77735	1337241014	/users/cn/jespinosa/phecomp/data/CRG/20120502_FDF_CRG/20120502_FDF_CRG/20120516_FDF_CRG_c12.mtb	2440	18	WWSS	food_sc	3	77694	1337240973	1	0.02	0.00048780487804878	3917	1
1	Food 1	Intake 3	35	77788	1337241067	/users/cn/jespinosa/phecomp/data/CRG/20120502_FDF_CRG/20120502_FDF_CRG/20120516_FDF_CRG_c12.mtb	2441	28	WWSS	food_sc	3	77753	1337241032	1	0.04	0.00114285714285714	3918	1
1	Food 1	Intake 3	41	77857	1337241136	/users/cn/jespinosa/phecomp/data/CRG/20120502_FDF_CRG/20120502_FDF_CRG/20120516_FDF_CRG_c12.mtb	2442	5994	WWSS	food_sc	3	77816	1337241095	1	0.04	0.000975609756097561	3919	1
1	Drink 1	Intake 1	26	77893	1337241172	/users/cn/jespinosa/phecomp/data/CRG/20120502_FDF_CRG/20120502_FDF_CRG/20120516_FDF_CRG_c12.mtb	2366	NA	WWSS	water	1	77867	1337241146	1	0.06	0.00230769230769231	3920	1
1	Drink 2	Intake 2	39	78368	1337241647	/users/cn/jespinosa/phecomp/data/CRG/20120502_FDF_CRG/20120502_FDF_CRG/20120516_FDF_CRG_c12.mtb	1188	NA	WWSS	water	2	78329	1337241608	1	0.14	0.00358974358974359	3921	1
1	Food 1	Intake 3	24	83875	1337247154	/users/cn/jespinosa/phecomp/data/CRG/20120502_FDF_CRG/20120502_FDF_CRG/20120516_FDF_CRG_c12.mtb	2444	30	WWSS	food_sc	3	83851	1337247130	1	0.02	0.000833333333333333	3922	1
1	Food 1	Intake 3	40	83945	1337247224	/users/cn/jespinosa/phecomp/data/CRG/20120502_FDF_CRG/20120502_FDF_CRG/20120516_FDF_CRG_c12.mtb	2445	12	WWSS	food_sc	3	83905	1337247184	1	0.02	0.0005	3923	1
1	Food 1	Intake 3	36	83993	1337247272	/users/cn/jespinosa/phecomp/data/CRG/20120502_FDF_CRG/20120502_FDF_CRG/20120516_FDF_CRG_c12.mtb	2446	COLL	WWSS	food_sc	3	83957	1337247236	1	0.02	0.000555555555555556	3924	1
1	Food 2	Intake 4	16	84001	1337247280	/users/cn/jespinosa/phecomp/data/CRG/20120502_FDF_CRG/20120502_FDF_CRG/20120516_FDF_CRG_c12.mtb	3245	3386	WWSS	food_sc	4	83985	1337247264	1	0.02	0.00125	3925	1
1	Drink 1	Intake 1	17	87026	1337250305	/users/cn/jespinosa/phecomp/data/CRG/20120502_FDF_CRG/20120502_FDF_CRG/20120516_FDF_CRG_c12.mtb	2369	NA	WWSS	water	1	87009	1337250288	1	0.02	0.00117647058823529	3926	1
1	Food 2	Intake 4	73	87460	1337250739	/users/cn/jespinosa/phecomp/data/CRG/20120502_FDF_CRG/20120502_FDF_CRG/20120516_FDF_CRG_c12.mtb	3249	10616	WWSS	food_sc	4	87387	1337250666	1	0.02	0.000273972602739726	3927	1
1	Drink 1	Intake 1	17	89278	1337252557	/users/cn/jespinosa/phecomp/data/CRG/20120502_FDF_CRG/20120502_FDF_CRG/20120516_FDF_CRG_c12.mtb	2378	NA	WWSS	water	1	89261	1337252540	1	0.02	0.00117647058823529	3928	1
1	Drink 1	Intake 1	545	90026	1337253305	/users/cn/jespinosa/phecomp/data/CRG/20120502_FDF_CRG/20120502_FDF_CRG/20120516_FDF_CRG_c12.mtb	2379	NA	WWSS	water	1	89481	1337252760	1	0.02	3.6697247706422e-05	3929	1
1	Drink 1	Intake 1	44	90961	1337254240	/users/cn/jespinosa/phecomp/data/CRG/20120502_FDF_CRG/20120502_FDF_CRG/20120516_FDF_CRG_c12.mtb	2383	NA	WWSS	water	1	90917	1337254196	1	0.02	0.000454545454545455	3930	1
1	Drink 1	Intake 1	80	91085	1337254364	/users/cn/jespinosa/phecomp/data/CRG/20120502_FDF_CRG/20120502_FDF_CRG/20120516_FDF_CRG_c12.mtb	2384	NA	WWSS	water	1	91005	1337254284	1	0.02	0.00025	3931	1
1	Drink 1	Intake 1	248	91592	1337254871	/users/cn/jespinosa/phecomp/data/CRG/20120502_FDF_CRG/20120502_FDF_CRG/20120516_FDF_CRG_c12.mtb	2387	NA	WWSS	water	1	91344	1337254623	1	0.04	0.000161290322580645	3932	1
1	Drink 1	Intake 1	221	91984	1337255263	/users/cn/jespinosa/phecomp/data/CRG/20120502_FDF_CRG/20120502_FDF_CRG/20120516_FDF_CRG_c12.mtb	2388	NA	WWSS	water	1	91763	1337255042	1	0.02	9.04977375565611e-05	3933	1
1	Drink 1	Intake 1	9	92996	1337256275	/users/cn/jespinosa/phecomp/data/CRG/20120502_FDF_CRG/20120502_FDF_CRG/20120516_FDF_CRG_c12.mtb	2391	NA	WWSS	water	1	92987	1337256266	1	0.02	0.00222222222222222	3934	1
1	Food 2	Intake 4	19	98095	1337261374	/users/cn/jespinosa/phecomp/data/CRG/20120502_FDF_CRG/20120502_FDF_CRG/20120516_FDF_CRG_c12.mtb	3251	13330	WWSS	food_sc	4	98076	1337261355	1	0.02	0.00105263157894737	3935	1
1	Drink 2	Intake 2	28	99879	1337263158	/users/cn/jespinosa/phecomp/data/CRG/20120502_FDF_CRG/20120502_FDF_CRG/20120516_FDF_CRG_c12.mtb	1193	NA	WWSS	water	2	99851	1337263130	1	0.0799999999999996	0.00285714285714284	3936	1
1	Food 2	Intake 4	33	111458	1337274737	/users/cn/jespinosa/phecomp/data/CRG/20120502_FDF_CRG/20120502_FDF_CRG/20120516_FDF_CRG_c12.mtb	3255	2060	WWSS	food_sc	4	111425	1337274704	1	0.02	0.000606060606060606	3937	1
1	Drink 2	Intake 2	18	111970	1337275249	/users/cn/jespinosa/phecomp/data/CRG/20120502_FDF_CRG/20120502_FDF_CRG/20120516_FDF_CRG_c12.mtb	1194	NA	WWSS	water	2	111952	1337275231	1	0.0800000000000001	0.00444444444444445	3938	1
1	Food 2	Intake 4	375	113893	1337277172	/users/cn/jespinosa/phecomp/data/CRG/20120502_FDF_CRG/20120502_FDF_CRG/20120516_FDF_CRG_c12.mtb	3256	12	WWSS	food_sc	4	113518	1337276797	1	0.16	0.000426666666666667	3939	1
1	Food 2	Intake 4	248	114153	1337277432	/users/cn/jespinosa/phecomp/data/CRG/20120502_FDF_CRG/20120502_FDF_CRG/20120516_FDF_CRG_c12.mtb	3257	2213	WWSS	food_sc	4	113905	1337277184	1	0.0800000000000001	0.000322580645161291	3940	1
1	Drink 1	Intake 1	16	114168	1337277447	/users/cn/jespinosa/phecomp/data/CRG/20120502_FDF_CRG/20120502_FDF_CRG/20120516_FDF_CRG_c12.mtb	2392	NA	WWSS	water	1	114152	1337277431	1	0.04	0.0025	3941	1
1	Drink 2	Intake 2	12	114859	1337278138	/users/cn/jespinosa/phecomp/data/CRG/20120502_FDF_CRG/20120502_FDF_CRG/20120516_FDF_CRG_c12.mtb	1195	NA	WWSS	water	2	114847	1337278126	1	0.02	0.00166666666666667	3942	1
1	Drink 1	Intake 1	15	115015	1337278294	/users/cn/jespinosa/phecomp/data/CRG/20120502_FDF_CRG/20120502_FDF_CRG/20120516_FDF_CRG_c12.mtb	2393	NA	WWSS	water	1	115000	1337278279	1	0.04	0.00266666666666667	3943	1
1	Food 2	Intake 4	120	116486	1337279765	/users/cn/jespinosa/phecomp/data/CRG/20120502_FDF_CRG/20120502_FDF_CRG/20120516_FDF_CRG_c12.mtb	3259	8	WWSS	food_sc	4	116366	1337279645	1	0.0600000000000001	0.000500000000000001	3944	1
1	Food 2	Intake 4	100	116594	1337279873	/users/cn/jespinosa/phecomp/data/CRG/20120502_FDF_CRG/20120502_FDF_CRG/20120516_FDF_CRG_c12.mtb	3260	15	WWSS	food_sc	4	116494	1337279773	1	0.04	0.0004	3945	1
1	Food 2	Intake 4	74	116683	1337279962	/users/cn/jespinosa/phecomp/data/CRG/20120502_FDF_CRG/20120502_FDF_CRG/20120516_FDF_CRG_c12.mtb	3261	7	WWSS	food_sc	4	116609	1337279888	1	0.04	0.000540540540540541	3946	1
1	Food 2	Intake 4	121	116811	1337280090	/users/cn/jespinosa/phecomp/data/CRG/20120502_FDF_CRG/20120502_FDF_CRG/20120516_FDF_CRG_c12.mtb	3262	5	WWSS	food_sc	4	116690	1337279969	1	0.0800000000000001	0.000661157024793389	3947	1
1	Food 2	Intake 4	79	116895	1337280174	/users/cn/jespinosa/phecomp/data/CRG/20120502_FDF_CRG/20120502_FDF_CRG/20120516_FDF_CRG_c12.mtb	3263	877	WWSS	food_sc	4	116816	1337280095	1	0.04	0.000506329113924051	3948	1
1	Drink 2	Intake 2	31	116923	1337280202	/users/cn/jespinosa/phecomp/data/CRG/20120502_FDF_CRG/20120502_FDF_CRG/20120516_FDF_CRG_c12.mtb	1196	NA	WWSS	water	2	116892	1337280171	1	0.0800000000000001	0.00258064516129033	3949	1
1	Drink 2	Intake 2	20	117104	1337280383	/users/cn/jespinosa/phecomp/data/CRG/20120502_FDF_CRG/20120502_FDF_CRG/20120516_FDF_CRG_c12.mtb	1197	NA	WWSS	water	2	117084	1337280363	1	0.04	0.002	3950	1
1	Food 1	Intake 3	113	117885	1337281164	/users/cn/jespinosa/phecomp/data/CRG/20120502_FDF_CRG/20120502_FDF_CRG/20120516_FDF_CRG_c12.mtb	2456	11	WWSS	food_sc	3	117772	1337281051	1	0.02	0.000176991150442478	3951	1
1	Food 1	Intake 3	165	118061	1337281340	/users/cn/jespinosa/phecomp/data/CRG/20120502_FDF_CRG/20120502_FDF_CRG/20120516_FDF_CRG_c12.mtb	2457	83	WWSS	food_sc	3	117896	1337281175	1	0.0600000000000001	0.000363636363636364	3952	1
1	Drink 2	Intake 2	63	118124	1337281403	/users/cn/jespinosa/phecomp/data/CRG/20120502_FDF_CRG/20120502_FDF_CRG/20120516_FDF_CRG_c12.mtb	1199	NA	WWSS	water	2	118061	1337281340	1	0.0600000000000001	0.000952380952380954	3953	1
1	Food 2	Intake 4	91	118235	1337281514	/users/cn/jespinosa/phecomp/data/CRG/20120502_FDF_CRG/20120502_FDF_CRG/20120516_FDF_CRG_c12.mtb	3270	25	WWSS	food_sc	4	118144	1337281423	1	0.02	0.00021978021978022	3954	1
1	Food 2	Intake 4	48	118308	1337281587	/users/cn/jespinosa/phecomp/data/CRG/20120502_FDF_CRG/20120502_FDF_CRG/20120516_FDF_CRG_c12.mtb	3271	124	WWSS	food_sc	4	118260	1337281539	1	0.02	0.000416666666666667	3955	1
1	Drink 2	Intake 2	26	118424	1337281703	/users/cn/jespinosa/phecomp/data/CRG/20120502_FDF_CRG/20120502_FDF_CRG/20120516_FDF_CRG_c12.mtb	1200	NA	WWSS	water	2	118398	1337281677	1	0.12	0.00461538461538461	3956	1
1	Food 1	Intake 3	113	118545	1337281824	/users/cn/jespinosa/phecomp/data/CRG/20120502_FDF_CRG/20120502_FDF_CRG/20120516_FDF_CRG_c12.mtb	2461	19	WWSS	food_sc	3	118432	1337281711	1	0.02	0.000176991150442478	3957	1
1	Food 1	Intake 3	190	118754	1337282033	/users/cn/jespinosa/phecomp/data/CRG/20120502_FDF_CRG/20120502_FDF_CRG/20120516_FDF_CRG_c12.mtb	2462	521	WWSS	food_sc	3	118564	1337281843	1	0.0600000000000001	0.000315789473684211	3958	1
1	Drink 2	Intake 2	13	119140	1337282419	/users/cn/jespinosa/phecomp/data/CRG/20120502_FDF_CRG/20120502_FDF_CRG/20120516_FDF_CRG_c12.mtb	1201	NA	WWSS	water	2	119127	1337282406	1	0.0599999999999996	0.00461538461538458	3959	1
1	Food 1	Intake 3	25	119300	1337282579	/users/cn/jespinosa/phecomp/data/CRG/20120502_FDF_CRG/20120502_FDF_CRG/20120516_FDF_CRG_c12.mtb	2465	209	WWSS	food_sc	3	119275	1337282554	1	0.02	0.0008	3960	1
1	Food 2	Intake 4	17	119526	1337282805	/users/cn/jespinosa/phecomp/data/CRG/20120502_FDF_CRG/20120502_FDF_CRG/20120516_FDF_CRG_c12.mtb	3278	174	WWSS	food_sc	4	119509	1337282788	1	0.02	0.00117647058823529	3961	1
1	Food 1	Intake 3	91	119791	1337283070	/users/cn/jespinosa/phecomp/data/CRG/20120502_FDF_CRG/20120502_FDF_CRG/20120516_FDF_CRG_c12.mtb	2468	251	WWSS	food_sc	3	119700	1337282979	1	0.02	0.00021978021978022	3962	1
1	Drink 2	Intake 2	18	119892	1337283171	/users/cn/jespinosa/phecomp/data/CRG/20120502_FDF_CRG/20120502_FDF_CRG/20120516_FDF_CRG_c12.mtb	1202	NA	WWSS	water	2	119874	1337283153	1	0.0200000000000005	0.00111111111111114	3963	1
1	Drink 1	Intake 1	20	119914	1337283193	/users/cn/jespinosa/phecomp/data/CRG/20120502_FDF_CRG/20120502_FDF_CRG/20120516_FDF_CRG_c12.mtb	2395	NA	WWSS	water	1	119894	1337283173	1	0.02	0.001	3964	1
1	Food 2	Intake 4	91	120133	1337283412	/users/cn/jespinosa/phecomp/data/CRG/20120502_FDF_CRG/20120502_FDF_CRG/20120516_FDF_CRG_c12.mtb	3282	36	WWSS	food_sc	4	120042	1337283321	1	0.04	0.00043956043956044	3965	1
1	Food 2	Intake 4	149	120318	1337283597	/users/cn/jespinosa/phecomp/data/CRG/20120502_FDF_CRG/20120502_FDF_CRG/20120516_FDF_CRG_c12.mtb	3283	3644	WWSS	food_sc	4	120169	1337283448	1	0.0599999999999996	0.000402684563758387	3966	1
1	Drink 1	Intake 1	20	120341	1337283620	/users/cn/jespinosa/phecomp/data/CRG/20120502_FDF_CRG/20120502_FDF_CRG/20120516_FDF_CRG_c12.mtb	2396	NA	WWSS	water	1	120321	1337283600	1	0.04	0.002	3967	1
1	Food 2	Intake 4	214	124176	1337287455	/users/cn/jespinosa/phecomp/data/CRG/20120502_FDF_CRG/20120502_FDF_CRG/20120516_FDF_CRG_c12.mtb	3285	532	WWSS	food_sc	4	123962	1337287241	1	0.1	0.000467289719626168	3968	1
1	Food 2	Intake 4	142	124850	1337288129	/users/cn/jespinosa/phecomp/data/CRG/20120502_FDF_CRG/20120502_FDF_CRG/20120516_FDF_CRG_c12.mtb	3286	6	WWSS	food_sc	4	124708	1337287987	1	0.0600000000000001	0.000422535211267606	3969	1
1	Food 2	Intake 4	160	125016	1337288295	/users/cn/jespinosa/phecomp/data/CRG/20120502_FDF_CRG/20120502_FDF_CRG/20120516_FDF_CRG_c12.mtb	3287	1557	WWSS	food_sc	4	124856	1337288135	1	0.0800000000000001	0.000500000000000001	3970	1
1	Drink 1	Intake 1	34	125054	1337288333	/users/cn/jespinosa/phecomp/data/CRG/20120502_FDF_CRG/20120502_FDF_CRG/20120516_FDF_CRG_c12.mtb	2397	NA	WWSS	water	1	125020	1337288299	1	0.0399999999999999	0.00117647058823529	3971	1
1	Drink 2	Intake 2	20	125098	1337288377	/users/cn/jespinosa/phecomp/data/CRG/20120502_FDF_CRG/20120502_FDF_CRG/20120516_FDF_CRG_c12.mtb	1204	NA	WWSS	water	2	125078	1337288357	1	0.0600000000000001	0.00300000000000001	3972	1
1	Food 2	Intake 4	34	126607	1337289886	/users/cn/jespinosa/phecomp/data/CRG/20120502_FDF_CRG/20120502_FDF_CRG/20120516_FDF_CRG_c12.mtb	3289	10	WWSS	food_sc	4	126573	1337289852	1	0.02	0.000588235294117647	3973	1
1	Food 2	Intake 4	249	126866	1337290145	/users/cn/jespinosa/phecomp/data/CRG/20120502_FDF_CRG/20120502_FDF_CRG/20120516_FDF_CRG_c12.mtb	3290	37	WWSS	food_sc	4	126617	1337289896	1	0.0800000000000001	0.000321285140562249	3974	1
1	Drink 2	Intake 2	18	126881	1337290160	/users/cn/jespinosa/phecomp/data/CRG/20120502_FDF_CRG/20120502_FDF_CRG/20120516_FDF_CRG_c12.mtb	1205	NA	WWSS	water	2	126863	1337290142	1	0.04	0.00222222222222222	3975	1
1	Food 2	Intake 4	39	126942	1337290221	/users/cn/jespinosa/phecomp/data/CRG/20120502_FDF_CRG/20120502_FDF_CRG/20120516_FDF_CRG_c12.mtb	3291	COLL	WWSS	food_sc	4	126903	1337290182	1	0.02	0.000512820512820513	3976	1
1	Food 1	Intake 3	85	127027	1337290306	/users/cn/jespinosa/phecomp/data/CRG/20120502_FDF_CRG/20120502_FDF_CRG/20120516_FDF_CRG_c12.mtb	2474	68	WWSS	food_sc	3	126942	1337290221	1	0.02	0.000235294117647059	3977	1
1	Food 1	Intake 3	62	127157	1337290436	/users/cn/jespinosa/phecomp/data/CRG/20120502_FDF_CRG/20120502_FDF_CRG/20120516_FDF_CRG_c12.mtb	2476	436	WWSS	food_sc	3	127095	1337290374	1	0.02	0.00032258064516129	3978	1
1	Drink 2	Intake 2	19	127173	1337290452	/users/cn/jespinosa/phecomp/data/CRG/20120502_FDF_CRG/20120502_FDF_CRG/20120516_FDF_CRG_c12.mtb	1206	NA	WWSS	water	2	127154	1337290433	1	0.04	0.00210526315789474	3979	1
1	Food 1	Intake 3	113	127706	1337290985	/users/cn/jespinosa/phecomp/data/CRG/20120502_FDF_CRG/20120502_FDF_CRG/20120516_FDF_CRG_c12.mtb	2482	217	WWSS	food_sc	3	127593	1337290872	1	0.04	0.000353982300884956	3980	1
1	Drink 2	Intake 2	28	127723	1337291002	/users/cn/jespinosa/phecomp/data/CRG/20120502_FDF_CRG/20120502_FDF_CRG/20120516_FDF_CRG_c12.mtb	1207	NA	WWSS	water	2	127695	1337290974	1	0.04	0.00142857142857143	3981	1
1	Food 1	Intake 3	77	128000	1337291279	/users/cn/jespinosa/phecomp/data/CRG/20120502_FDF_CRG/20120502_FDF_CRG/20120516_FDF_CRG_c12.mtb	2484	18	WWSS	food_sc	3	127923	1337291202	1	0.02	0.00025974025974026	3982	1
1	Food 1	Intake 3	90	128108	1337291387	/users/cn/jespinosa/phecomp/data/CRG/20120502_FDF_CRG/20120502_FDF_CRG/20120516_FDF_CRG_c12.mtb	2485	167	WWSS	food_sc	3	128018	1337291297	1	0.04	0.000444444444444444	3983	1
1	Food 1	Intake 3	97	128372	1337291651	/users/cn/jespinosa/phecomp/data/CRG/20120502_FDF_CRG/20120502_FDF_CRG/20120516_FDF_CRG_c12.mtb	2486	217	WWSS	food_sc	3	128275	1337291554	1	0.02	0.000206185567010309	3984	1
1	Drink 1	Intake 1	36	128416	1337291695	/users/cn/jespinosa/phecomp/data/CRG/20120502_FDF_CRG/20120502_FDF_CRG/20120516_FDF_CRG_c12.mtb	2398	NA	WWSS	water	1	128380	1337291659	1	0.1	0.00277777777777778	3985	1
1	Food 1	Intake 3	68	128657	1337291936	/users/cn/jespinosa/phecomp/data/CRG/20120502_FDF_CRG/20120502_FDF_CRG/20120516_FDF_CRG_c12.mtb	2488	COLL	WWSS	food_sc	3	128589	1337291868	1	0.02	0.000294117647058824	3986	1
1	Food 2	Intake 4	52	128680	1337291959	/users/cn/jespinosa/phecomp/data/CRG/20120502_FDF_CRG/20120502_FDF_CRG/20120516_FDF_CRG_c12.mtb	3306	94	WWSS	food_sc	4	128628	1337291907	1	0.02	0.000384615384615385	3987	1
1	Food 1	Intake 3	115	128889	1337292168	/users/cn/jespinosa/phecomp/data/CRG/20120502_FDF_CRG/20120502_FDF_CRG/20120516_FDF_CRG_c12.mtb	2490	94	WWSS	food_sc	3	128774	1337292053	1	0.02	0.000173913043478261	3988	1
1	Drink 2	Intake 2	22	128929	1337292208	/users/cn/jespinosa/phecomp/data/CRG/20120502_FDF_CRG/20120502_FDF_CRG/20120516_FDF_CRG_c12.mtb	1208	NA	WWSS	water	2	128907	1337292186	1	0.02	0.000909090909090909	3989	1
1	Food 1	Intake 3	77	129060	1337292339	/users/cn/jespinosa/phecomp/data/CRG/20120502_FDF_CRG/20120502_FDF_CRG/20120516_FDF_CRG_c12.mtb	2491	1282	WWSS	food_sc	3	128983	1337292262	1	0.02	0.00025974025974026	3990	1
1	Drink 2	Intake 2	18	129078	1337292357	/users/cn/jespinosa/phecomp/data/CRG/20120502_FDF_CRG/20120502_FDF_CRG/20120516_FDF_CRG_c12.mtb	1209	NA	WWSS	water	2	129060	1337292339	1	0.04	0.00222222222222222	3991	1
1	Food 2	Intake 4	53	130395	1337293674	/users/cn/jespinosa/phecomp/data/CRG/20120502_FDF_CRG/20120502_FDF_CRG/20120516_FDF_CRG_c12.mtb	3311	76	WWSS	food_sc	4	130342	1337293621	1	0.02	0.000377358490566038	3992	1
1	Food 1	Intake 3	105	130576	1337293855	/users/cn/jespinosa/phecomp/data/CRG/20120502_FDF_CRG/20120502_FDF_CRG/20120516_FDF_CRG_c12.mtb	2494	66	WWSS	food_sc	3	130471	1337293750	1	0.04	0.000380952380952381	3993	1
1	Drink 2	Intake 2	14	130605	1337293884	/users/cn/jespinosa/phecomp/data/CRG/20120502_FDF_CRG/20120502_FDF_CRG/20120516_FDF_CRG_c12.mtb	1210	NA	WWSS	water	2	130591	1337293870	1	0.02	0.00142857142857143	3994	1
1	Food 1	Intake 3	108	130750	1337294029	/users/cn/jespinosa/phecomp/data/CRG/20120502_FDF_CRG/20120502_FDF_CRG/20120516_FDF_CRG_c12.mtb	2495	26	WWSS	food_sc	3	130642	1337293921	1	0.02	0.000185185185185185	3995	1
1	Food 2	Intake 4	53	130829	1337294108	/users/cn/jespinosa/phecomp/data/CRG/20120502_FDF_CRG/20120502_FDF_CRG/20120516_FDF_CRG_c12.mtb	3315	77	WWSS	food_sc	4	130776	1337294055	1	0.02	0.000377358490566038	3996	1
1	Food 1	Intake 3	69	130975	1337294254	/users/cn/jespinosa/phecomp/data/CRG/20120502_FDF_CRG/20120502_FDF_CRG/20120516_FDF_CRG_c12.mtb	2498	6	WWSS	food_sc	3	130906	1337294185	1	0.02	0.000289855072463768	3997	1
1	Food 1	Intake 3	38	131019	1337294298	/users/cn/jespinosa/phecomp/data/CRG/20120502_FDF_CRG/20120502_FDF_CRG/20120516_FDF_CRG_c12.mtb	2499	20	WWSS	food_sc	3	130981	1337294260	1	0.02	0.000526315789473684	3998	1
1	Drink 2	Intake 2	16	131036	1337294315	/users/cn/jespinosa/phecomp/data/CRG/20120502_FDF_CRG/20120502_FDF_CRG/20120516_FDF_CRG_c12.mtb	1211	NA	WWSS	water	2	131020	1337294299	1	0.02	0.00125	3999	1
1	Food 1	Intake 3	180	131219	1337294498	/users/cn/jespinosa/phecomp/data/CRG/20120502_FDF_CRG/20120502_FDF_CRG/20120516_FDF_CRG_c12.mtb	2500	COLL	WWSS	food_sc	3	131039	1337294318	1	0.02	0.000111111111111111	4000	1
1	Food 2	Intake 4	20	131098	1337294377	/users/cn/jespinosa/phecomp/data/CRG/20120502_FDF_CRG/20120502_FDF_CRG/20120516_FDF_CRG_c12.mtb	3319	1799	WWSS	food_sc	4	131078	1337294357	1	0.02	0.001	4001	1
1	Drink 1	Intake 1	28	131250	1337294529	/users/cn/jespinosa/phecomp/data/CRG/20120502_FDF_CRG/20120502_FDF_CRG/20120516_FDF_CRG_c12.mtb	2401	NA	WWSS	water	1	131222	1337294501	1	0.0600000000000001	0.00214285714285715	4002	1
1	Drink 2	Intake 2	17	131487	1337294766	/users/cn/jespinosa/phecomp/data/CRG/20120502_FDF_CRG/20120502_FDF_CRG/20120516_FDF_CRG_c12.mtb	1212	NA	WWSS	water	2	131470	1337294749	1	0.02	0.00117647058823529	4003	1
1	Drink 1	Intake 1	15	132805	1337296084	/users/cn/jespinosa/phecomp/data/CRG/20120502_FDF_CRG/20120502_FDF_CRG/20120516_FDF_CRG_c12.mtb	2409	NA	WWSS	water	1	132790	1337296069	1	0.02	0.00133333333333333	4004	1
1	Food 2	Intake 4	65	132962	1337296241	/users/cn/jespinosa/phecomp/data/CRG/20120502_FDF_CRG/20120502_FDF_CRG/20120516_FDF_CRG_c12.mtb	3329	5441	WWSS	food_sc	4	132897	1337296176	1	0.04	0.000615384615384615	4005	1
1	Drink 1	Intake 1	36	133203	1337296482	/users/cn/jespinosa/phecomp/data/CRG/20120502_FDF_CRG/20120502_FDF_CRG/20120516_FDF_CRG_c12.mtb	2410	NA	WWSS	water	1	133167	1337296446	1	0.0399999999999999	0.00111111111111111	4006	1
1	Drink 2	Intake 2	20	134476	1337297755	/users/cn/jespinosa/phecomp/data/CRG/20120502_FDF_CRG/20120502_FDF_CRG/20120516_FDF_CRG_c12.mtb	1217	NA	WWSS	water	2	134456	1337297735	1	0.04	0.002	4007	1
1	Food 2	Intake 4	110	138513	1337301792	/users/cn/jespinosa/phecomp/data/CRG/20120502_FDF_CRG/20120502_FDF_CRG/20120516_FDF_CRG_c12.mtb	3335	40	WWSS	food_sc	4	138403	1337301682	1	0.04	0.000363636363636364	4008	1
1	Food 2	Intake 4	93	138646	1337301925	/users/cn/jespinosa/phecomp/data/CRG/20120502_FDF_CRG/20120502_FDF_CRG/20120516_FDF_CRG_c12.mtb	3336	COLL	WWSS	food_sc	4	138553	1337301832	1	0.02	0.00021505376344086	4009	1
1	Food 1	Intake 3	27	138587	1337301866	/users/cn/jespinosa/phecomp/data/CRG/20120502_FDF_CRG/20120502_FDF_CRG/20120516_FDF_CRG_c12.mtb	2508	67	WWSS	food_sc	3	138560	1337301839	1	0.02	0.000740740740740741	4010	1
1	Food 1	Intake 3	34	138688	1337301967	/users/cn/jespinosa/phecomp/data/CRG/20120502_FDF_CRG/20120502_FDF_CRG/20120516_FDF_CRG_c12.mtb	2509	17	WWSS	food_sc	3	138654	1337301933	1	0.02	0.000588235294117647	4011	1
1	Food 1	Intake 3	88	138793	1337302072	/users/cn/jespinosa/phecomp/data/CRG/20120502_FDF_CRG/20120502_FDF_CRG/20120516_FDF_CRG_c12.mtb	2510	1390	WWSS	food_sc	3	138705	1337301984	1	0.0600000000000001	0.000681818181818183	4012	1
1	Drink 1	Intake 1	13	139353	1337302632	/users/cn/jespinosa/phecomp/data/CRG/20120502_FDF_CRG/20120502_FDF_CRG/20120516_FDF_CRG_c12.mtb	2411	NA	WWSS	water	1	139340	1337302619	1	0.02	0.00153846153846154	4013	1
1	Food 1	Intake 3	140	140323	1337303602	/users/cn/jespinosa/phecomp/data/CRG/20120502_FDF_CRG/20120502_FDF_CRG/20120516_FDF_CRG_c12.mtb	2512	4027	WWSS	food_sc	3	140183	1337303462	1	0.02	0.000142857142857143	4014	1
1	Food 1	Intake 3	20	144370	1337307649	/users/cn/jespinosa/phecomp/data/CRG/20120502_FDF_CRG/20120502_FDF_CRG/20120516_FDF_CRG_c12.mtb	2513	2832	WWSS	food_sc	3	144350	1337307629	1	0.02	0.001	4015	1
1	Food 1	Intake 3	46	147248	1337310527	/users/cn/jespinosa/phecomp/data/CRG/20120502_FDF_CRG/20120502_FDF_CRG/20120516_FDF_CRG_c12.mtb	2515	8	WWSS	food_sc	3	147202	1337310481	1	0.04	0.000869565217391304	4016	1
1	Food 1	Intake 3	50	147306	1337310585	/users/cn/jespinosa/phecomp/data/CRG/20120502_FDF_CRG/20120502_FDF_CRG/20120516_FDF_CRG_c12.mtb	2516	91	WWSS	food_sc	3	147256	1337310535	1	0.04	0.0008	4017	1
1	Food 1	Intake 3	114	147511	1337310790	/users/cn/jespinosa/phecomp/data/CRG/20120502_FDF_CRG/20120502_FDF_CRG/20120516_FDF_CRG_c12.mtb	2518	4128	WWSS	food_sc	3	147397	1337310676	1	0.04	0.000350877192982456	4018	1
1	Food 2	Intake 4	23	151662	1337314941	/users/cn/jespinosa/phecomp/data/CRG/20120502_FDF_CRG/20120502_FDF_CRG/20120516_FDF_CRG_c12.mtb	3342	1013	WWSS	food_sc	4	151639	1337314918	1	0.02	0.000869565217391304	4019	1
1	Food 1	Intake 3	210	152885	1337316164	/users/cn/jespinosa/phecomp/data/CRG/20120502_FDF_CRG/20120502_FDF_CRG/20120516_FDF_CRG_c12.mtb	2519	43	WWSS	food_sc	3	152675	1337315954	1	0.0800000000000001	0.000380952380952381	4020	1
1	Drink 1	Intake 1	20	152905	1337316184	/users/cn/jespinosa/phecomp/data/CRG/20120502_FDF_CRG/20120502_FDF_CRG/20120516_FDF_CRG_c12.mtb	2413	NA	WWSS	water	1	152885	1337316164	1	0.0600000000000001	0.00300000000000001	4021	1
1	Food 1	Intake 3	289	153217	1337316496	/users/cn/jespinosa/phecomp/data/CRG/20120502_FDF_CRG/20120502_FDF_CRG/20120516_FDF_CRG_c12.mtb	2520	81	WWSS	food_sc	3	152928	1337316207	1	0.1	0.000346020761245675	4022	1
1	Food 1	Intake 3	38	153336	1337316615	/users/cn/jespinosa/phecomp/data/CRG/20120502_FDF_CRG/20120502_FDF_CRG/20120516_FDF_CRG_c12.mtb	2521	147	WWSS	food_sc	3	153298	1337316577	1	0.02	0.000526315789473684	4023	1
1	Drink 2	Intake 2	23	153417	1337316696	/users/cn/jespinosa/phecomp/data/CRG/20120502_FDF_CRG/20120502_FDF_CRG/20120516_FDF_CRG_c12.mtb	1219	NA	WWSS	water	2	153394	1337316673	1	0.0800000000000001	0.00347826086956522	4024	1
1	Food 1	Intake 3	141	153624	1337316903	/users/cn/jespinosa/phecomp/data/CRG/20120502_FDF_CRG/20120502_FDF_CRG/20120516_FDF_CRG_c12.mtb	2523	93	WWSS	food_sc	3	153483	1337316762	1	0.02	0.000141843971631206	4025	1
1	Drink 1	Intake 1	17	153630	1337316909	/users/cn/jespinosa/phecomp/data/CRG/20120502_FDF_CRG/20120502_FDF_CRG/20120516_FDF_CRG_c12.mtb	2414	NA	WWSS	water	1	153613	1337316892	1	0.02	0.00117647058823529	4026	1
1	Food 1	Intake 3	103	153820	1337317099	/users/cn/jespinosa/phecomp/data/CRG/20120502_FDF_CRG/20120502_FDF_CRG/20120516_FDF_CRG_c12.mtb	2524	286	WWSS	food_sc	3	153717	1337316996	1	0.02	0.000194174757281553	4027	1
1	Drink 2	Intake 2	25	153839	1337317118	/users/cn/jespinosa/phecomp/data/CRG/20120502_FDF_CRG/20120502_FDF_CRG/20120516_FDF_CRG_c12.mtb	1220	NA	WWSS	water	2	153814	1337317093	1	0.0799999999999996	0.00319999999999998	4028	1
1	Drink 2	Intake 2	21	154045	1337317324	/users/cn/jespinosa/phecomp/data/CRG/20120502_FDF_CRG/20120502_FDF_CRG/20120516_FDF_CRG_c12.mtb	1221	NA	WWSS	water	2	154024	1337317303	1	0.04	0.0019047619047619	4029	1
1	Food 1	Intake 3	85	154191	1337317470	/users/cn/jespinosa/phecomp/data/CRG/20120502_FDF_CRG/20120502_FDF_CRG/20120516_FDF_CRG_c12.mtb	2526	26	WWSS	food_sc	3	154106	1337317385	1	0.0200000000000005	0.000235294117647065	4030	1
1	Food 1	Intake 3	54	154271	1337317550	/users/cn/jespinosa/phecomp/data/CRG/20120502_FDF_CRG/20120502_FDF_CRG/20120516_FDF_CRG_c12.mtb	2527	68	WWSS	food_sc	3	154217	1337317496	1	0.04	0.000740740740740741	4031	1
1	Drink 1	Intake 1	26	154286	1337317565	/users/cn/jespinosa/phecomp/data/CRG/20120502_FDF_CRG/20120502_FDF_CRG/20120516_FDF_CRG_c12.mtb	2416	NA	WWSS	water	1	154260	1337317539	1	0.0599999999999999	0.0023076923076923	4032	1
1	Food 2	Intake 4	166	154505	1337317784	/users/cn/jespinosa/phecomp/data/CRG/20120502_FDF_CRG/20120502_FDF_CRG/20120516_FDF_CRG_c12.mtb	3350	1313	WWSS	food_sc	4	154339	1337317618	1	0.02	0.000120481927710843	4033	1
1	Drink 1	Intake 1	19	154521	1337317800	/users/cn/jespinosa/phecomp/data/CRG/20120502_FDF_CRG/20120502_FDF_CRG/20120516_FDF_CRG_c12.mtb	2417	NA	WWSS	water	1	154502	1337317781	1	0.0600000000000001	0.00315789473684211	4034	1
1	Drink 2	Intake 2	15	154944	1337318223	/users/cn/jespinosa/phecomp/data/CRG/20120502_FDF_CRG/20120502_FDF_CRG/20120516_FDF_CRG_c12.mtb	1222	NA	WWSS	water	2	154929	1337318208	1	0.02	0.00133333333333333	4035	1
1	Drink 2	Intake 2	21	155494	1337318773	/users/cn/jespinosa/phecomp/data/CRG/20120502_FDF_CRG/20120502_FDF_CRG/20120516_FDF_CRG_c12.mtb	1223	NA	WWSS	water	2	155473	1337318752	1	0.0600000000000001	0.00285714285714286	4036	1
1	Food 1	Intake 3	181	155999	1337319278	/users/cn/jespinosa/phecomp/data/CRG/20120502_FDF_CRG/20120502_FDF_CRG/20120516_FDF_CRG_c12.mtb	2532	41	WWSS	food_sc	3	155818	1337319097	1	0.02	0.000110497237569061	4037	1
1	Food 1	Intake 3	75	156115	1337319394	/users/cn/jespinosa/phecomp/data/CRG/20120502_FDF_CRG/20120502_FDF_CRG/20120516_FDF_CRG_c12.mtb	2533	20	WWSS	food_sc	3	156040	1337319319	1	0.02	0.000266666666666667	4038	1
1	Drink 1	Intake 1	24	156139	1337319418	/users/cn/jespinosa/phecomp/data/CRG/20120502_FDF_CRG/20120502_FDF_CRG/20120516_FDF_CRG_c12.mtb	2418	NA	WWSS	water	1	156115	1337319394	1	0.04	0.00166666666666667	4039	1
1	Food 1	Intake 3	147	156282	1337319561	/users/cn/jespinosa/phecomp/data/CRG/20120502_FDF_CRG/20120502_FDF_CRG/20120516_FDF_CRG_c12.mtb	2534	69	WWSS	food_sc	3	156135	1337319414	1	0.02	0.000136054421768707	4040	1
1	Food 1	Intake 3	84	156435	1337319714	/users/cn/jespinosa/phecomp/data/CRG/20120502_FDF_CRG/20120502_FDF_CRG/20120516_FDF_CRG_c12.mtb	2535	41	WWSS	food_sc	3	156351	1337319630	1	0.02	0.000238095238095238	4041	1
1	Food 1	Intake 3	177	156653	1337319932	/users/cn/jespinosa/phecomp/data/CRG/20120502_FDF_CRG/20120502_FDF_CRG/20120516_FDF_CRG_c12.mtb	2536	44	WWSS	food_sc	3	156476	1337319755	1	0.02	0.000112994350282486	4042	1
1	Drink 2	Intake 2	20	156675	1337319954	/users/cn/jespinosa/phecomp/data/CRG/20120502_FDF_CRG/20120502_FDF_CRG/20120516_FDF_CRG_c12.mtb	1224	NA	WWSS	water	2	156655	1337319934	1	0.04	0.002	4043	1
1	Food 1	Intake 3	182	156879	1337320158	/users/cn/jespinosa/phecomp/data/CRG/20120502_FDF_CRG/20120502_FDF_CRG/20120516_FDF_CRG_c12.mtb	2537	227	WWSS	food_sc	3	156697	1337319976	1	0.04	0.00021978021978022	4044	1
1	Drink 1	Intake 1	22	156889	1337320168	/users/cn/jespinosa/phecomp/data/CRG/20120502_FDF_CRG/20120502_FDF_CRG/20120516_FDF_CRG_c12.mtb	2419	NA	WWSS	water	1	156867	1337320146	1	0.04	0.00181818181818182	4045	1
1	Drink 2	Intake 2	20	156902	1337320181	/users/cn/jespinosa/phecomp/data/CRG/20120502_FDF_CRG/20120502_FDF_CRG/20120516_FDF_CRG_c12.mtb	1225	NA	WWSS	water	2	156882	1337320161	1	0.04	0.002	4046	1
1	Food 1	Intake 3	104	157210	1337320489	/users/cn/jespinosa/phecomp/data/CRG/20120502_FDF_CRG/20120502_FDF_CRG/20120516_FDF_CRG_c12.mtb	2540	31	WWSS	food_sc	3	157106	1337320385	1	0.02	0.000192307692307692	4047	1
1	Food 1	Intake 3	74	157315	1337320594	/users/cn/jespinosa/phecomp/data/CRG/20120502_FDF_CRG/20120502_FDF_CRG/20120516_FDF_CRG_c12.mtb	2541	286	WWSS	food_sc	3	157241	1337320520	1	0.02	0.00027027027027027	4048	1
1	Drink 2	Intake 2	26	157359	1337320638	/users/cn/jespinosa/phecomp/data/CRG/20120502_FDF_CRG/20120502_FDF_CRG/20120516_FDF_CRG_c12.mtb	1226	NA	WWSS	water	2	157333	1337320612	1	0.04	0.00153846153846154	4049	1
1	Food 1	Intake 3	248	157849	1337321128	/users/cn/jespinosa/phecomp/data/CRG/20120502_FDF_CRG/20120502_FDF_CRG/20120516_FDF_CRG_c12.mtb	2542	8	WWSS	food_sc	3	157601	1337320880	1	0.04	0.000161290322580645	4050	1
1	Drink 2	Intake 2	16	157855	1337321134	/users/cn/jespinosa/phecomp/data/CRG/20120502_FDF_CRG/20120502_FDF_CRG/20120516_FDF_CRG_c12.mtb	1227	NA	WWSS	water	2	157839	1337321118	1	0.02	0.00125	4051	1
1	Food 1	Intake 3	319	158176	1337321455	/users/cn/jespinosa/phecomp/data/CRG/20120502_FDF_CRG/20120502_FDF_CRG/20120516_FDF_CRG_c12.mtb	2543	231	WWSS	food_sc	3	157857	1337321136	1	0.1	0.000313479623824451	4052	1
1	Drink 2	Intake 2	15	158194	1337321473	/users/cn/jespinosa/phecomp/data/CRG/20120502_FDF_CRG/20120502_FDF_CRG/20120516_FDF_CRG_c12.mtb	1228	NA	WWSS	water	2	158179	1337321458	1	0.04	0.00266666666666667	4053	1
1	Food 1	Intake 3	86	158493	1337321772	/users/cn/jespinosa/phecomp/data/CRG/20120502_FDF_CRG/20120502_FDF_CRG/20120516_FDF_CRG_c12.mtb	2545	88	WWSS	food_sc	3	158407	1337321686	1	0.04	0.000465116279069767	4054	1
1	Drink 2	Intake 2	48	158553	1337321832	/users/cn/jespinosa/phecomp/data/CRG/20120502_FDF_CRG/20120502_FDF_CRG/20120516_FDF_CRG_c12.mtb	1229	NA	WWSS	water	2	158505	1337321784	1	0.0600000000000001	0.00125	4055	1
1	Food 1	Intake 3	194	158775	1337322054	/users/cn/jespinosa/phecomp/data/CRG/20120502_FDF_CRG/20120502_FDF_CRG/20120516_FDF_CRG_c12.mtb	2546	14133	WWSS	food_sc	3	158581	1337321860	1	0.0600000000000001	0.000309278350515464	4056	1
1	Drink 2	Intake 2	18	158792	1337322071	/users/cn/jespinosa/phecomp/data/CRG/20120502_FDF_CRG/20120502_FDF_CRG/20120516_FDF_CRG_c12.mtb	1230	NA	WWSS	water	2	158774	1337322053	1	0.02	0.00111111111111111	4057	1
1	Drink 2	Intake 2	14	2600	1337335115	/users/cn/jespinosa/phecomp/data/CRG/20120502_FDF_CRG/20120502_FDF_CRG/20120518_FDF_CRG_c12.mtb	1232	NA	WWSS	water	2	2586	1337335101	1	0.06	0.00428571428571429	4058	1
1	Drink 2	Intake 2	16	2740	1337335255	/users/cn/jespinosa/phecomp/data/CRG/20120502_FDF_CRG/20120502_FDF_CRG/20120518_FDF_CRG_c12.mtb	1234	NA	WWSS	water	2	2724	1337335239	1	0.08	0.005	4059	1
1	Food 1	Intake 3	91	3763	1337336278	/users/cn/jespinosa/phecomp/data/CRG/20120502_FDF_CRG/20120502_FDF_CRG/20120518_FDF_CRG_c12.mtb	2547	100	WWSS	food_sc	3	3672	1337336187	1	0.06	0.000659340659340659	4060	1
1	Food 1	Intake 3	68	3931	1337336446	/users/cn/jespinosa/phecomp/data/CRG/20120502_FDF_CRG/20120502_FDF_CRG/20120518_FDF_CRG_c12.mtb	2548	32	WWSS	food_sc	3	3863	1337336378	1	0.08	0.00117647058823529	4061	1
1	Food 1	Intake 3	57	4020	1337336535	/users/cn/jespinosa/phecomp/data/CRG/20120502_FDF_CRG/20120502_FDF_CRG/20120518_FDF_CRG_c12.mtb	2549	9027	WWSS	food_sc	3	3963	1337336478	1	0.04	0.000701754385964912	4062	1
1	Drink 1	Intake 1	21	4292	1337336807	/users/cn/jespinosa/phecomp/data/CRG/20120502_FDF_CRG/20120502_FDF_CRG/20120518_FDF_CRG_c12.mtb	2423	NA	WWSS	water	1	4271	1337336786	1	0.02	0.000952380952380952	4063	1
1	Food 1	Intake 3	61	13108	1337345623	/users/cn/jespinosa/phecomp/data/CRG/20120502_FDF_CRG/20120502_FDF_CRG/20120518_FDF_CRG_c12.mtb	2552	169	WWSS	food_sc	3	13047	1337345562	1	0.04	0.000655737704918033	4064	1
1	Food 1	Intake 3	83	13360	1337345875	/users/cn/jespinosa/phecomp/data/CRG/20120502_FDF_CRG/20120502_FDF_CRG/20120518_FDF_CRG_c12.mtb	2553	12	WWSS	food_sc	3	13277	1337345792	1	0.04	0.000481927710843374	4065	1
1	Food 1	Intake 3	42	13414	1337345929	/users/cn/jespinosa/phecomp/data/CRG/20120502_FDF_CRG/20120502_FDF_CRG/20120518_FDF_CRG_c12.mtb	2554	16	WWSS	food_sc	3	13372	1337345887	1	0.02	0.000476190476190476	4066	1
1	Food 1	Intake 3	25	13455	1337345970	/users/cn/jespinosa/phecomp/data/CRG/20120502_FDF_CRG/20120502_FDF_CRG/20120518_FDF_CRG_c12.mtb	2555	5	WWSS	food_sc	3	13430	1337345945	1	0.02	0.0008	4067	1
1	Food 1	Intake 3	106	13566	1337346081	/users/cn/jespinosa/phecomp/data/CRG/20120502_FDF_CRG/20120502_FDF_CRG/20120518_FDF_CRG_c12.mtb	2556	11332	WWSS	food_sc	3	13460	1337345975	1	0.06	0.000566037735849057	4068	1
1	Drink 1	Intake 1	27	14725	1337347240	/users/cn/jespinosa/phecomp/data/CRG/20120502_FDF_CRG/20120502_FDF_CRG/20120518_FDF_CRG_c12.mtb	2424	NA	WWSS	water	1	14698	1337347213	1	0.12	0.00444444444444444	4069	1
1	Food 2	Intake 4	257	25155	1337357670	/users/cn/jespinosa/phecomp/data/CRG/20120502_FDF_CRG/20120502_FDF_CRG/20120518_FDF_CRG_c12.mtb	3367	3	WWSS	food_sc	4	24898	1337357413	1	0.12	0.00046692607003891	4070	1
1	Food 2	Intake 4	257	25415	1337357930	/users/cn/jespinosa/phecomp/data/CRG/20120502_FDF_CRG/20120502_FDF_CRG/20120518_FDF_CRG_c12.mtb	3368	5070	WWSS	food_sc	4	25158	1337357673	1	0.1	0.000389105058365759	4071	1
1	Drink 2	Intake 2	20	25435	1337357950	/users/cn/jespinosa/phecomp/data/CRG/20120502_FDF_CRG/20120502_FDF_CRG/20120518_FDF_CRG_c12.mtb	1235	NA	WWSS	water	2	25415	1337357930	1	0.02	0.001	4072	1
1	Food 2	Intake 4	145	30630	1337363145	/users/cn/jespinosa/phecomp/data/CRG/20120502_FDF_CRG/20120502_FDF_CRG/20120518_FDF_CRG_c12.mtb	3369	1277	WWSS	food_sc	4	30485	1337363000	1	0.06	0.000413793103448276	4073	1
1	Food 2	Intake 4	277	32184	1337364699	/users/cn/jespinosa/phecomp/data/CRG/20120502_FDF_CRG/20120502_FDF_CRG/20120518_FDF_CRG_c12.mtb	3370	6	WWSS	food_sc	4	31907	1337364422	1	0.1	0.00036101083032491	4074	1
1	Food 2	Intake 4	87	32277	1337364792	/users/cn/jespinosa/phecomp/data/CRG/20120502_FDF_CRG/20120502_FDF_CRG/20120518_FDF_CRG_c12.mtb	3371	660	WWSS	food_sc	4	32190	1337364705	1	0.04	0.000459770114942529	4075	1
1	Drink 2	Intake 2	12	32288	1337364803	/users/cn/jespinosa/phecomp/data/CRG/20120502_FDF_CRG/20120502_FDF_CRG/20120518_FDF_CRG_c12.mtb	1236	NA	WWSS	water	2	32276	1337364791	1	0.04	0.00333333333333333	4076	1
1	Food 2	Intake 4	179	33116	1337365631	/users/cn/jespinosa/phecomp/data/CRG/20120502_FDF_CRG/20120502_FDF_CRG/20120518_FDF_CRG_c12.mtb	3372	51	WWSS	food_sc	4	32937	1337365452	1	0.08	0.000446927374301676	4077	1
1	Drink 2	Intake 2	32	33144	1337365659	/users/cn/jespinosa/phecomp/data/CRG/20120502_FDF_CRG/20120502_FDF_CRG/20120518_FDF_CRG_c12.mtb	1237	NA	WWSS	water	2	33112	1337365627	1	0.1	0.003125	4078	1
1	Food 1	Intake 3	47	33214	1337365729	/users/cn/jespinosa/phecomp/data/CRG/20120502_FDF_CRG/20120502_FDF_CRG/20120518_FDF_CRG_c12.mtb	2561	24	WWSS	food_sc	3	33167	1337365682	1	0.02	0.000425531914893617	4079	1
1	Food 1	Intake 3	143	33381	1337365896	/users/cn/jespinosa/phecomp/data/CRG/20120502_FDF_CRG/20120502_FDF_CRG/20120518_FDF_CRG_c12.mtb	2562	2393	WWSS	food_sc	3	33238	1337365753	1	0.06	0.00041958041958042	4080	1
1	Drink 2	Intake 2	19	33393	1337365908	/users/cn/jespinosa/phecomp/data/CRG/20120502_FDF_CRG/20120502_FDF_CRG/20120518_FDF_CRG_c12.mtb	1238	NA	WWSS	water	2	33374	1337365889	1	0.08	0.00421052631578947	4081	1
1	Drink 2	Intake 2	12	33801	1337366316	/users/cn/jespinosa/phecomp/data/CRG/20120502_FDF_CRG/20120502_FDF_CRG/20120518_FDF_CRG_c12.mtb	1239	NA	WWSS	water	2	33789	1337366304	1	0.04	0.00333333333333333	4082	1
1	Food 1	Intake 3	51	35825	1337368340	/users/cn/jespinosa/phecomp/data/CRG/20120502_FDF_CRG/20120502_FDF_CRG/20120518_FDF_CRG_c12.mtb	2563	20	WWSS	food_sc	3	35774	1337368289	1	0.04	0.000784313725490196	4083	1
1	Food 1	Intake 3	265	36110	1337368625	/users/cn/jespinosa/phecomp/data/CRG/20120502_FDF_CRG/20120502_FDF_CRG/20120518_FDF_CRG_c12.mtb	2564	1711	WWSS	food_sc	3	35845	1337368360	1	0.12	0.000452830188679245	4084	1
1	Drink 2	Intake 2	21	36130	1337368645	/users/cn/jespinosa/phecomp/data/CRG/20120502_FDF_CRG/20120502_FDF_CRG/20120518_FDF_CRG_c12.mtb	1240	NA	WWSS	water	2	36109	1337368624	1	0.04	0.0019047619047619	4085	1
1	Food 1	Intake 3	263	38084	1337370599	/users/cn/jespinosa/phecomp/data/CRG/20120502_FDF_CRG/20120502_FDF_CRG/20120518_FDF_CRG_c12.mtb	2565	509	WWSS	food_sc	3	37821	1337370336	1	0.12	0.000456273764258555	4086	1
1	Drink 2	Intake 2	20	38102	1337370617	/users/cn/jespinosa/phecomp/data/CRG/20120502_FDF_CRG/20120502_FDF_CRG/20120518_FDF_CRG_c12.mtb	1241	NA	WWSS	water	2	38082	1337370597	1	0.04	0.002	4087	1
1	Food 1	Intake 3	59	38652	1337371167	/users/cn/jespinosa/phecomp/data/CRG/20120502_FDF_CRG/20120502_FDF_CRG/20120518_FDF_CRG_c12.mtb	2566	35	WWSS	food_sc	3	38593	1337371108	1	0.02	0.000338983050847458	4088	1
1	Food 1	Intake 3	106	38793	1337371308	/users/cn/jespinosa/phecomp/data/CRG/20120502_FDF_CRG/20120502_FDF_CRG/20120518_FDF_CRG_c12.mtb	2567	15	WWSS	food_sc	3	38687	1337371202	1	0.02	0.000188679245283019	4089	1
1	Food 1	Intake 3	69	38877	1337371392	/users/cn/jespinosa/phecomp/data/CRG/20120502_FDF_CRG/20120502_FDF_CRG/20120518_FDF_CRG_c12.mtb	2568	52	WWSS	food_sc	3	38808	1337371323	1	0.04	0.000579710144927536	4090	1
1	Food 1	Intake 3	33	38962	1337371477	/users/cn/jespinosa/phecomp/data/CRG/20120502_FDF_CRG/20120502_FDF_CRG/20120518_FDF_CRG_c12.mtb	2570	52	WWSS	food_sc	3	38929	1337371444	1	0.0399999999999999	0.00121212121212121	4091	1
1	Drink 1	Intake 1	28	38998	1337371513	/users/cn/jespinosa/phecomp/data/CRG/20120502_FDF_CRG/20120502_FDF_CRG/20120518_FDF_CRG_c12.mtb	2425	NA	WWSS	water	1	38970	1337371485	1	0.06	0.00214285714285714	4092	1
1	Food 1	Intake 3	70	39084	1337371599	/users/cn/jespinosa/phecomp/data/CRG/20120502_FDF_CRG/20120502_FDF_CRG/20120518_FDF_CRG_c12.mtb	2571	84	WWSS	food_sc	3	39014	1337371529	1	0.02	0.000285714285714286	4093	1
1	Drink 2	Intake 2	25	39102	1337371617	/users/cn/jespinosa/phecomp/data/CRG/20120502_FDF_CRG/20120502_FDF_CRG/20120518_FDF_CRG_c12.mtb	1242	NA	WWSS	water	2	39077	1337371592	1	0.1	0.004	4094	1
1	Food 2	Intake 4	44	39212	1337371727	/users/cn/jespinosa/phecomp/data/CRG/20120502_FDF_CRG/20120502_FDF_CRG/20120518_FDF_CRG_c12.mtb	3382	161	WWSS	food_sc	4	39168	1337371683	1	0.02	0.000454545454545455	4095	1
1	Food 1	Intake 3	37	39410	1337371925	/users/cn/jespinosa/phecomp/data/CRG/20120502_FDF_CRG/20120502_FDF_CRG/20120518_FDF_CRG_c12.mtb	2575	20	WWSS	food_sc	3	39373	1337371888	1	0.02	0.000540540540540541	4096	1
1	Drink 2	Intake 2	55	39454	1337371969	/users/cn/jespinosa/phecomp/data/CRG/20120502_FDF_CRG/20120502_FDF_CRG/20120518_FDF_CRG_c12.mtb	1244	NA	WWSS	water	2	39399	1337371914	1	0.02	0.000363636363636364	4097	1
1	Food 2	Intake 4	39	39469	1337371984	/users/cn/jespinosa/phecomp/data/CRG/20120502_FDF_CRG/20120502_FDF_CRG/20120518_FDF_CRG_c12.mtb	3385	644	WWSS	food_sc	4	39430	1337371945	1	0.0599999999999999	0.00153846153846154	4098	1
1	Drink 2	Intake 2	158	39758	1337372273	/users/cn/jespinosa/phecomp/data/CRG/20120502_FDF_CRG/20120502_FDF_CRG/20120518_FDF_CRG_c12.mtb	1247	NA	WWSS	water	2	39600	1337372115	1	0.0600000000000001	0.000379746835443039	4099	1
1	Drink 2	Intake 2	602	40672	1337373187	/users/cn/jespinosa/phecomp/data/CRG/20120502_FDF_CRG/20120502_FDF_CRG/20120518_FDF_CRG_c12.mtb	1249	NA	WWSS	water	2	40070	1337372585	1	0.14	0.000232558139534884	4100	1
1	Food 2	Intake 4	61	40174	1337372689	/users/cn/jespinosa/phecomp/data/CRG/20120502_FDF_CRG/20120502_FDF_CRG/20120518_FDF_CRG_c12.mtb	3389	39	WWSS	food_sc	4	40113	1337372628	1	0.04	0.000655737704918033	4101	1
1	Food 2	Intake 4	56	40269	1337372784	/users/cn/jespinosa/phecomp/data/CRG/20120502_FDF_CRG/20120502_FDF_CRG/20120518_FDF_CRG_c12.mtb	3391	41	WWSS	food_sc	4	40213	1337372728	1	0.02	0.000357142857142857	4102	1
1	Food 1	Intake 3	36	40346	1337372861	/users/cn/jespinosa/phecomp/data/CRG/20120502_FDF_CRG/20120502_FDF_CRG/20120518_FDF_CRG_c12.mtb	2583	12	WWSS	food_sc	3	40310	1337372825	1	0.02	0.000555555555555556	4103	1
1	Food 1	Intake 3	57	40415	1337372930	/users/cn/jespinosa/phecomp/data/CRG/20120502_FDF_CRG/20120502_FDF_CRG/20120518_FDF_CRG_c12.mtb	2584	COLL	WWSS	food_sc	3	40358	1337372873	1	0.02	0.000350877192982456	4104	1
1	Food 2	Intake 4	107	40516	1337373031	/users/cn/jespinosa/phecomp/data/CRG/20120502_FDF_CRG/20120502_FDF_CRG/20120518_FDF_CRG_c12.mtb	3393	104	WWSS	food_sc	4	40409	1337372924	1	0.0599999999999999	0.000560747663551401	4105	1
1	Food 2	Intake 4	74	40694	1337373209	/users/cn/jespinosa/phecomp/data/CRG/20120502_FDF_CRG/20120502_FDF_CRG/20120518_FDF_CRG_c12.mtb	3394	11	WWSS	food_sc	4	40620	1337373135	1	0.02	0.00027027027027027	4106	1
1	Food 2	Intake 4	49	40754	1337373269	/users/cn/jespinosa/phecomp/data/CRG/20120502_FDF_CRG/20120502_FDF_CRG/20120518_FDF_CRG_c12.mtb	3395	149	WWSS	food_sc	4	40705	1337373220	1	0.04	0.000816326530612245	4107	1
1	Food 2	Intake 4	144	41047	1337373562	/users/cn/jespinosa/phecomp/data/CRG/20120502_FDF_CRG/20120502_FDF_CRG/20120518_FDF_CRG_c12.mtb	3397	150	WWSS	food_sc	4	40903	1337373418	1	0.02	0.000138888888888889	4108	1
1	Drink 2	Intake 2	57	40980	1337373495	/users/cn/jespinosa/phecomp/data/CRG/20120502_FDF_CRG/20120502_FDF_CRG/20120518_FDF_CRG_c12.mtb	1251	NA	WWSS	water	2	40923	1337373438	1	0.04	0.000701754385964912	4109	1
1	Drink 2	Intake 2	128	41168	1337373683	/users/cn/jespinosa/phecomp/data/CRG/20120502_FDF_CRG/20120502_FDF_CRG/20120518_FDF_CRG_c12.mtb	1252	NA	WWSS	water	2	41040	1337373555	1	0.04	0.0003125	4110	1
1	Food 2	Intake 4	128	41325	1337373840	/users/cn/jespinosa/phecomp/data/CRG/20120502_FDF_CRG/20120502_FDF_CRG/20120518_FDF_CRG_c12.mtb	3399	2478	WWSS	food_sc	4	41197	1337373712	1	0.02	0.00015625	4111	1
1	Drink 2	Intake 2	79	43780	1337376295	/users/cn/jespinosa/phecomp/data/CRG/20120502_FDF_CRG/20120502_FDF_CRG/20120518_FDF_CRG_c12.mtb	1263	NA	WWSS	water	2	43701	1337376216	1	0.02	0.000253164556962025	4112	1
1	Food 2	Intake 4	32	43835	1337376350	/users/cn/jespinosa/phecomp/data/CRG/20120502_FDF_CRG/20120502_FDF_CRG/20120518_FDF_CRG_c12.mtb	3401	59	WWSS	food_sc	4	43803	1337376318	1	0.04	0.00125	4113	1
1	Food 2	Intake 4	53	43947	1337376462	/users/cn/jespinosa/phecomp/data/CRG/20120502_FDF_CRG/20120502_FDF_CRG/20120518_FDF_CRG_c12.mtb	3403	85	WWSS	food_sc	4	43894	1337376409	1	0.02	0.000377358490566038	4114	1
1	Food 1	Intake 3	123	44155	1337376670	/users/cn/jespinosa/phecomp/data/CRG/20120502_FDF_CRG/20120502_FDF_CRG/20120518_FDF_CRG_c12.mtb	2594	142	WWSS	food_sc	3	44032	1337376547	1	0.04	0.00032520325203252	4115	1
1	Drink 2	Intake 2	18	44205	1337376720	/users/cn/jespinosa/phecomp/data/CRG/20120502_FDF_CRG/20120502_FDF_CRG/20120518_FDF_CRG_c12.mtb	1266	NA	WWSS	water	2	44187	1337376702	1	0.04	0.00222222222222222	4116	1
1	Drink 2	Intake 2	10	44277	1337376792	/users/cn/jespinosa/phecomp/data/CRG/20120502_FDF_CRG/20120502_FDF_CRG/20120518_FDF_CRG_c12.mtb	1267	NA	WWSS	water	2	44267	1337376782	1	0.02	0.002	4117	1
1	Food 2	Intake 4	87	44384	1337376899	/users/cn/jespinosa/phecomp/data/CRG/20120502_FDF_CRG/20120502_FDF_CRG/20120518_FDF_CRG_c12.mtb	3409	39	WWSS	food_sc	4	44297	1337376812	1	0.0599999999999999	0.000689655172413792	4118	1
1	Food 2	Intake 4	87	44510	1337377025	/users/cn/jespinosa/phecomp/data/CRG/20120502_FDF_CRG/20120502_FDF_CRG/20120518_FDF_CRG_c12.mtb	3410	454	WWSS	food_sc	4	44423	1337376938	1	0.02	0.000229885057471264	4119	1
1	Drink 1	Intake 1	17	44519	1337377034	/users/cn/jespinosa/phecomp/data/CRG/20120502_FDF_CRG/20120502_FDF_CRG/20120518_FDF_CRG_c12.mtb	2426	NA	WWSS	water	1	44502	1337377017	1	0.02	0.00117647058823529	4120	1
1	Drink 2	Intake 2	18	44569	1337377084	/users/cn/jespinosa/phecomp/data/CRG/20120502_FDF_CRG/20120502_FDF_CRG/20120518_FDF_CRG_c12.mtb	1268	NA	WWSS	water	2	44551	1337377066	1	0.02	0.00111111111111111	4121	1
1	Drink 2	Intake 2	29	44752	1337377267	/users/cn/jespinosa/phecomp/data/CRG/20120502_FDF_CRG/20120502_FDF_CRG/20120518_FDF_CRG_c12.mtb	1270	NA	WWSS	water	2	44723	1337377238	1	0.02	0.000689655172413793	4122	1
1	Drink 1	Intake 1	148	44903	1337377418	/users/cn/jespinosa/phecomp/data/CRG/20120502_FDF_CRG/20120502_FDF_CRG/20120518_FDF_CRG_c12.mtb	2428	NA	WWSS	water	1	44755	1337377270	1	0.02	0.000135135135135135	4123	1
1	Food 2	Intake 4	34	44998	1337377513	/users/cn/jespinosa/phecomp/data/CRG/20120502_FDF_CRG/20120502_FDF_CRG/20120518_FDF_CRG_c12.mtb	3411	11	WWSS	food_sc	4	44964	1337377479	1	0.02	0.000588235294117647	4124	1
1	Food 2	Intake 4	36	45045	1337377560	/users/cn/jespinosa/phecomp/data/CRG/20120502_FDF_CRG/20120502_FDF_CRG/20120518_FDF_CRG_c12.mtb	3412	641	WWSS	food_sc	4	45009	1337377524	1	0.02	0.000555555555555556	4125	1
1	Drink 1	Intake 1	20	45243	1337377758	/users/cn/jespinosa/phecomp/data/CRG/20120502_FDF_CRG/20120502_FDF_CRG/20120518_FDF_CRG_c12.mtb	2431	NA	WWSS	water	1	45223	1337377738	1	0.02	0.001	4126	1
1	Food 1	Intake 3	95	45781	1337378296	/users/cn/jespinosa/phecomp/data/CRG/20120502_FDF_CRG/20120502_FDF_CRG/20120518_FDF_CRG_c12.mtb	2600	22	WWSS	food_sc	3	45686	1337378201	1	0.02	0.000210526315789474	4127	1
1	Food 1	Intake 3	78	45881	1337378396	/users/cn/jespinosa/phecomp/data/CRG/20120502_FDF_CRG/20120502_FDF_CRG/20120518_FDF_CRG_c12.mtb	2601	384	WWSS	food_sc	3	45803	1337378318	1	0.04	0.000512820512820513	4128	1
1	Food 1	Intake 3	62	46327	1337378842	/users/cn/jespinosa/phecomp/data/CRG/20120502_FDF_CRG/20120502_FDF_CRG/20120518_FDF_CRG_c12.mtb	2603	756	WWSS	food_sc	3	46265	1337378780	1	0.02	0.00032258064516129	4129	1
1	Drink 1	Intake 1	21	46857	1337379372	/users/cn/jespinosa/phecomp/data/CRG/20120502_FDF_CRG/20120502_FDF_CRG/20120518_FDF_CRG_c12.mtb	2432	NA	WWSS	water	1	46836	1337379351	1	0.06	0.00285714285714286	4130	1
1	Food 2	Intake 4	41	47124	1337379639	/users/cn/jespinosa/phecomp/data/CRG/20120502_FDF_CRG/20120502_FDF_CRG/20120518_FDF_CRG_c12.mtb	3418	390	WWSS	food_sc	4	47083	1337379598	1	0.02	0.00048780487804878	4131	1
1	Drink 1	Intake 1	14	47173	1337379688	/users/cn/jespinosa/phecomp/data/CRG/20120502_FDF_CRG/20120502_FDF_CRG/20120518_FDF_CRG_c12.mtb	2433	NA	WWSS	water	1	47159	1337379674	1	0.02	0.00142857142857143	4132	1
1	Drink 1	Intake 1	23	47450	1337379965	/users/cn/jespinosa/phecomp/data/CRG/20120502_FDF_CRG/20120502_FDF_CRG/20120518_FDF_CRG_c12.mtb	2434	NA	WWSS	water	1	47427	1337379942	1	0.08	0.00347826086956522	4133	1
1	Food 1	Intake 3	101	47615	1337380130	/users/cn/jespinosa/phecomp/data/CRG/20120502_FDF_CRG/20120502_FDF_CRG/20120518_FDF_CRG_c12.mtb	2605	284	WWSS	food_sc	3	47514	1337380029	1	0.04	0.000396039603960396	4134	1
1	Food 2	Intake 4	109	48008	1337380523	/users/cn/jespinosa/phecomp/data/CRG/20120502_FDF_CRG/20120502_FDF_CRG/20120518_FDF_CRG_c12.mtb	3419	995	WWSS	food_sc	4	47899	1337380414	1	0.04	0.00036697247706422	4135	1
1	Food 2	Intake 4	70	49073	1337381588	/users/cn/jespinosa/phecomp/data/CRG/20120502_FDF_CRG/20120502_FDF_CRG/20120518_FDF_CRG_c12.mtb	3420	2782	WWSS	food_sc	4	49003	1337381518	1	0.02	0.000285714285714286	4136	1
1	Drink 2	Intake 2	17	49119	1337381634	/users/cn/jespinosa/phecomp/data/CRG/20120502_FDF_CRG/20120502_FDF_CRG/20120518_FDF_CRG_c12.mtb	1273	NA	WWSS	water	2	49102	1337381617	1	0.0600000000000001	0.00352941176470589	4137	1
1	Food 1	Intake 3	122	51977	1337384492	/users/cn/jespinosa/phecomp/data/CRG/20120502_FDF_CRG/20120502_FDF_CRG/20120518_FDF_CRG_c12.mtb	2608	1918	WWSS	food_sc	3	51855	1337384370	1	0.0799999999999998	0.000655737704918031	4138	1
1	Food 2	Intake 4	36	53931	1337386446	/users/cn/jespinosa/phecomp/data/CRG/20120502_FDF_CRG/20120502_FDF_CRG/20120518_FDF_CRG_c12.mtb	3421	8	WWSS	food_sc	4	53895	1337386410	1	0.02	0.000555555555555556	4139	1
1	Food 2	Intake 4	16	53955	1337386470	/users/cn/jespinosa/phecomp/data/CRG/20120502_FDF_CRG/20120502_FDF_CRG/20120518_FDF_CRG_c12.mtb	3422	47	WWSS	food_sc	4	53939	1337386454	1	0.02	0.00125	4140	1
1	Food 2	Intake 4	17	54019	1337386534	/users/cn/jespinosa/phecomp/data/CRG/20120502_FDF_CRG/20120502_FDF_CRG/20120518_FDF_CRG_c12.mtb	3423	29	WWSS	food_sc	4	54002	1337386517	1	0.0399999999999998	0.00235294117647058	4141	1
1	Food 2	Intake 4	70	54118	1337386633	/users/cn/jespinosa/phecomp/data/CRG/20120502_FDF_CRG/20120502_FDF_CRG/20120518_FDF_CRG_c12.mtb	3424	16	WWSS	food_sc	4	54048	1337386563	1	0.04	0.000571428571428571	4142	1
1	Food 2	Intake 4	62	54196	1337386711	/users/cn/jespinosa/phecomp/data/CRG/20120502_FDF_CRG/20120502_FDF_CRG/20120518_FDF_CRG_c12.mtb	3425	163	WWSS	food_sc	4	54134	1337386649	1	0.0600000000000001	0.000967741935483873	4143	1
1	Food 2	Intake 4	194	54553	1337387068	/users/cn/jespinosa/phecomp/data/CRG/20120502_FDF_CRG/20120502_FDF_CRG/20120518_FDF_CRG_c12.mtb	3426	16	WWSS	food_sc	4	54359	1337386874	1	0.04	0.000206185567010309	4144	1
1	Drink 1	Intake 1	31	54578	1337387093	/users/cn/jespinosa/phecomp/data/CRG/20120502_FDF_CRG/20120502_FDF_CRG/20120518_FDF_CRG_c12.mtb	2436	NA	WWSS	water	1	54547	1337387062	1	0.04	0.00129032258064516	4145	1
1	Food 2	Intake 4	147	54716	1337387231	/users/cn/jespinosa/phecomp/data/CRG/20120502_FDF_CRG/20120502_FDF_CRG/20120518_FDF_CRG_c12.mtb	3427	3	WWSS	food_sc	4	54569	1337387084	1	0.02	0.000136054421768707	4146	1
1	Food 1	Intake 3	40	54759	1337387274	/users/cn/jespinosa/phecomp/data/CRG/20120502_FDF_CRG/20120502_FDF_CRG/20120518_FDF_CRG_c12.mtb	2611	72	WWSS	food_sc	3	54719	1337387234	1	0.02	0.0005	4147	1
1	Drink 1	Intake 1	26	54792	1337387307	/users/cn/jespinosa/phecomp/data/CRG/20120502_FDF_CRG/20120502_FDF_CRG/20120518_FDF_CRG_c12.mtb	2437	NA	WWSS	water	1	54766	1337387281	1	0.06	0.00230769230769231	4148	1
1	Food 1	Intake 3	53	54884	1337387399	/users/cn/jespinosa/phecomp/data/CRG/20120502_FDF_CRG/20120502_FDF_CRG/20120518_FDF_CRG_c12.mtb	2612	649	WWSS	food_sc	3	54831	1337387346	1	0.04	0.000754716981132075	4149	1
1	Drink 1	Intake 1	24	55065	1337387580	/users/cn/jespinosa/phecomp/data/CRG/20120502_FDF_CRG/20120502_FDF_CRG/20120518_FDF_CRG_c12.mtb	2438	NA	WWSS	water	1	55041	1337387556	1	0.0599999999999999	0.0025	4150	1
1	Food 2	Intake 4	81	55614	1337388129	/users/cn/jespinosa/phecomp/data/CRG/20120502_FDF_CRG/20120502_FDF_CRG/20120518_FDF_CRG_c12.mtb	3430	916	WWSS	food_sc	4	55533	1337388048	1	0.02	0.000246913580246914	4151	1
1	Drink 2	Intake 2	13	55621	1337388136	/users/cn/jespinosa/phecomp/data/CRG/20120502_FDF_CRG/20120502_FDF_CRG/20120518_FDF_CRG_c12.mtb	1275	NA	WWSS	water	2	55608	1337388123	1	0.02	0.00153846153846154	4152	1
1	Drink 1	Intake 1	19	56146	1337388661	/users/cn/jespinosa/phecomp/data/CRG/20120502_FDF_CRG/20120502_FDF_CRG/20120518_FDF_CRG_c12.mtb	2440	NA	WWSS	water	1	56127	1337388642	1	0.02	0.00105263157894737	4153	1
1	Food 1	Intake 3	118	56648	1337389163	/users/cn/jespinosa/phecomp/data/CRG/20120502_FDF_CRG/20120502_FDF_CRG/20120518_FDF_CRG_c12.mtb	2617	8259	WWSS	food_sc	3	56530	1337389045	1	0.0600000000000001	0.000508474576271187	4154	1
1	Drink 2	Intake 2	23	56666	1337389181	/users/cn/jespinosa/phecomp/data/CRG/20120502_FDF_CRG/20120502_FDF_CRG/20120518_FDF_CRG_c12.mtb	1276	NA	WWSS	water	2	56643	1337389158	1	0.04	0.00173913043478261	4155	1
1	Food 2	Intake 4	370	65277	1337397792	/users/cn/jespinosa/phecomp/data/CRG/20120502_FDF_CRG/20120502_FDF_CRG/20120518_FDF_CRG_c12.mtb	3436	5431	WWSS	food_sc	4	64907	1337397422	1	0.18	0.000486486486486486	4156	1
1	Food 2	Intake 4	91	70799	1337403314	/users/cn/jespinosa/phecomp/data/CRG/20120502_FDF_CRG/20120502_FDF_CRG/20120518_FDF_CRG_c12.mtb	3437	96	WWSS	food_sc	4	70708	1337403223	1	0.04	0.00043956043956044	4157	1
1	Food 1	Intake 3	55	70950	1337403465	/users/cn/jespinosa/phecomp/data/CRG/20120502_FDF_CRG/20120502_FDF_CRG/20120518_FDF_CRG_c12.mtb	2620	20	WWSS	food_sc	3	70895	1337403410	1	0.02	0.000363636363636364	4158	1
1	Food 1	Intake 3	84	71054	1337403569	/users/cn/jespinosa/phecomp/data/CRG/20120502_FDF_CRG/20120502_FDF_CRG/20120518_FDF_CRG_c12.mtb	2621	31	WWSS	food_sc	3	70970	1337403485	1	0.0399999999999998	0.000476190476190474	4159	1
1	Drink 1	Intake 1	29	71087	1337403602	/users/cn/jespinosa/phecomp/data/CRG/20120502_FDF_CRG/20120502_FDF_CRG/20120518_FDF_CRG_c12.mtb	2442	NA	WWSS	water	1	71058	1337403573	1	0.0600000000000001	0.00206896551724138	4160	1
1	Food 1	Intake 3	97	71182	1337403697	/users/cn/jespinosa/phecomp/data/CRG/20120502_FDF_CRG/20120502_FDF_CRG/20120518_FDF_CRG_c12.mtb	2622	14	WWSS	food_sc	3	71085	1337403600	1	0.04	0.000412371134020619	4161	1
1	Drink 2	Intake 2	23	71194	1337403709	/users/cn/jespinosa/phecomp/data/CRG/20120502_FDF_CRG/20120502_FDF_CRG/20120518_FDF_CRG_c12.mtb	1277	NA	WWSS	water	2	71171	1337403686	1	0.04	0.00173913043478261	4162	1
1	Food 1	Intake 3	116	71312	1337403827	/users/cn/jespinosa/phecomp/data/CRG/20120502_FDF_CRG/20120502_FDF_CRG/20120518_FDF_CRG_c12.mtb	2623	COLL	WWSS	food_sc	3	71196	1337403711	1	0.0600000000000001	0.000517241379310346	4163	1
1	Food 2	Intake 4	53	71300	1337403815	/users/cn/jespinosa/phecomp/data/CRG/20120502_FDF_CRG/20120502_FDF_CRG/20120518_FDF_CRG_c12.mtb	3440	40	WWSS	food_sc	4	71247	1337403762	1	0.02	0.000377358490566038	4164	1
1	Drink 1	Intake 1	23	71348	1337403863	/users/cn/jespinosa/phecomp/data/CRG/20120502_FDF_CRG/20120502_FDF_CRG/20120518_FDF_CRG_c12.mtb	2443	NA	WWSS	water	1	71325	1337403840	1	0.08	0.00347826086956522	4165	1
1	Food 1	Intake 3	218	71558	1337404073	/users/cn/jespinosa/phecomp/data/CRG/20120502_FDF_CRG/20120502_FDF_CRG/20120518_FDF_CRG_c12.mtb	2624	7	WWSS	food_sc	3	71340	1337403855	1	0.0800000000000001	0.000366972477064221	4166	1
1	Drink 2	Intake 2	17	71572	1337404087	/users/cn/jespinosa/phecomp/data/CRG/20120502_FDF_CRG/20120502_FDF_CRG/20120518_FDF_CRG_c12.mtb	1278	NA	WWSS	water	2	71555	1337404070	1	0.0399999999999998	0.00235294117647058	4167	1
1	Food 1	Intake 3	101	71666	1337404181	/users/cn/jespinosa/phecomp/data/CRG/20120502_FDF_CRG/20120502_FDF_CRG/20120518_FDF_CRG_c12.mtb	2625	COLL	WWSS	food_sc	3	71565	1337404080	1	0.0600000000000001	0.000594059405940595	4168	1
1	Food 2	Intake 4	67	71720	1337404235	/users/cn/jespinosa/phecomp/data/CRG/20120502_FDF_CRG/20120502_FDF_CRG/20120518_FDF_CRG_c12.mtb	3442	397	WWSS	food_sc	4	71653	1337404168	1	0.02	0.000298507462686567	4169	1
1	Drink 1	Intake 1	21	71741	1337404256	/users/cn/jespinosa/phecomp/data/CRG/20120502_FDF_CRG/20120502_FDF_CRG/20120518_FDF_CRG_c12.mtb	2444	NA	WWSS	water	1	71720	1337404235	1	0.04	0.0019047619047619	4170	1
1	Drink 2	Intake 2	43	72114	1337404629	/users/cn/jespinosa/phecomp/data/CRG/20120502_FDF_CRG/20120502_FDF_CRG/20120518_FDF_CRG_c12.mtb	1279	NA	WWSS	water	2	72071	1337404586	1	0.02	0.000465116279069767	4171	1
1	Food 2	Intake 4	167	72284	1337404799	/users/cn/jespinosa/phecomp/data/CRG/20120502_FDF_CRG/20120502_FDF_CRG/20120518_FDF_CRG_c12.mtb	3446	23	WWSS	food_sc	4	72117	1337404632	1	0.02	0.000119760479041916	4172	1
1	Food 2	Intake 4	104	72411	1337404926	/users/cn/jespinosa/phecomp/data/CRG/20120502_FDF_CRG/20120502_FDF_CRG/20120518_FDF_CRG_c12.mtb	3447	235	WWSS	food_sc	4	72307	1337404822	1	0.0599999999999998	0.000576923076923075	4173	1
1	Drink 2	Intake 2	31	72439	1337404954	/users/cn/jespinosa/phecomp/data/CRG/20120502_FDF_CRG/20120502_FDF_CRG/20120518_FDF_CRG_c12.mtb	1280	NA	WWSS	water	2	72408	1337404923	1	0.1	0.0032258064516129	4174	1
1	Food 1	Intake 3	130	72776	1337405291	/users/cn/jespinosa/phecomp/data/CRG/20120502_FDF_CRG/20120502_FDF_CRG/20120518_FDF_CRG_c12.mtb	2631	136	WWSS	food_sc	3	72646	1337405161	1	0.04	0.000307692307692308	4175	1
1	Drink 2	Intake 2	11	72794	1337405309	/users/cn/jespinosa/phecomp/data/CRG/20120502_FDF_CRG/20120502_FDF_CRG/20120518_FDF_CRG_c12.mtb	1281	NA	WWSS	water	2	72783	1337405298	1	0.02	0.00181818181818182	4176	1
1	Food 1	Intake 3	89	73001	1337405516	/users/cn/jespinosa/phecomp/data/CRG/20120502_FDF_CRG/20120502_FDF_CRG/20120518_FDF_CRG_c12.mtb	2632	151	WWSS	food_sc	3	72912	1337405427	1	0.04	0.000449438202247191	4177	1
1	Drink 1	Intake 1	20	73020	1337405535	/users/cn/jespinosa/phecomp/data/CRG/20120502_FDF_CRG/20120502_FDF_CRG/20120518_FDF_CRG_c12.mtb	2446	NA	WWSS	water	1	73000	1337405515	1	0.0399999999999999	0.00199999999999999	4178	1
1	Food 1	Intake 3	65	73217	1337405732	/users/cn/jespinosa/phecomp/data/CRG/20120502_FDF_CRG/20120502_FDF_CRG/20120518_FDF_CRG_c12.mtb	2635	164	WWSS	food_sc	3	73152	1337405667	1	0.02	0.000307692307692308	4179	1
1	Drink 2	Intake 2	23	73286	1337405801	/users/cn/jespinosa/phecomp/data/CRG/20120502_FDF_CRG/20120502_FDF_CRG/20120518_FDF_CRG_c12.mtb	1282	NA	WWSS	water	2	73263	1337405778	1	0.0599999999999998	0.0026086956521739	4180	1
1	Food 1	Intake 3	23	73404	1337405919	/users/cn/jespinosa/phecomp/data/CRG/20120502_FDF_CRG/20120502_FDF_CRG/20120518_FDF_CRG_c12.mtb	2638	4	WWSS	food_sc	3	73381	1337405896	1	0.02	0.000869565217391304	4181	1
1	Food 1	Intake 3	52	73460	1337405975	/users/cn/jespinosa/phecomp/data/CRG/20120502_FDF_CRG/20120502_FDF_CRG/20120518_FDF_CRG_c12.mtb	2639	53	WWSS	food_sc	3	73408	1337405923	1	0.02	0.000384615384615385	4182	1
1	Drink 2	Intake 2	16	73494	1337406009	/users/cn/jespinosa/phecomp/data/CRG/20120502_FDF_CRG/20120502_FDF_CRG/20120518_FDF_CRG_c12.mtb	1283	NA	WWSS	water	2	73478	1337405993	1	0.04	0.0025	4183	1
1	Food 1	Intake 3	82	73595	1337406110	/users/cn/jespinosa/phecomp/data/CRG/20120502_FDF_CRG/20120502_FDF_CRG/20120518_FDF_CRG_c12.mtb	2640	254	WWSS	food_sc	3	73513	1337406028	1	0.04	0.00048780487804878	4184	1
1	Drink 2	Intake 2	21	73814	1337406329	/users/cn/jespinosa/phecomp/data/CRG/20120502_FDF_CRG/20120502_FDF_CRG/20120518_FDF_CRG_c12.mtb	1284	NA	WWSS	water	2	73793	1337406308	1	0.04	0.0019047619047619	4185	1
1	Food 1	Intake 3	88	73937	1337406452	/users/cn/jespinosa/phecomp/data/CRG/20120502_FDF_CRG/20120502_FDF_CRG/20120518_FDF_CRG_c12.mtb	2642	6	WWSS	food_sc	3	73849	1337406364	1	0.04	0.000454545454545455	4186	1
1	Food 1	Intake 3	52	73995	1337406510	/users/cn/jespinosa/phecomp/data/CRG/20120502_FDF_CRG/20120502_FDF_CRG/20120518_FDF_CRG_c12.mtb	2643	72	WWSS	food_sc	3	73943	1337406458	1	0.02	0.000384615384615385	4187	1
1	Food 1	Intake 3	144	74211	1337406726	/users/cn/jespinosa/phecomp/data/CRG/20120502_FDF_CRG/20120502_FDF_CRG/20120518_FDF_CRG_c12.mtb	2644	12	WWSS	food_sc	3	74067	1337406582	1	0.02	0.000138888888888889	4188	1
1	Drink 2	Intake 2	21	74225	1337406740	/users/cn/jespinosa/phecomp/data/CRG/20120502_FDF_CRG/20120502_FDF_CRG/20120518_FDF_CRG_c12.mtb	1285	NA	WWSS	water	2	74204	1337406719	1	0.04	0.0019047619047619	4189	1
1	Food 1	Intake 3	244	74467	1337406982	/users/cn/jespinosa/phecomp/data/CRG/20120502_FDF_CRG/20120502_FDF_CRG/20120518_FDF_CRG_c12.mtb	2645	446	WWSS	food_sc	3	74223	1337406738	1	0.0600000000000001	0.000245901639344263	4190	1
1	Drink 2	Intake 2	17	74797	1337407312	/users/cn/jespinosa/phecomp/data/CRG/20120502_FDF_CRG/20120502_FDF_CRG/20120518_FDF_CRG_c12.mtb	1286	NA	WWSS	water	2	74780	1337407295	1	0.04	0.00235294117647059	4191	1
1	Food 1	Intake 3	74	74987	1337407502	/users/cn/jespinosa/phecomp/data/CRG/20120502_FDF_CRG/20120502_FDF_CRG/20120518_FDF_CRG_c12.mtb	2649	8	WWSS	food_sc	3	74913	1337407428	1	0.04	0.000540540540540541	4192	1
1	Food 2	Intake 4	84	75079	1337407594	/users/cn/jespinosa/phecomp/data/CRG/20120502_FDF_CRG/20120502_FDF_CRG/20120518_FDF_CRG_c12.mtb	3470	307	WWSS	food_sc	4	74995	1337407510	1	0.02	0.000238095238095238	4193	1
1	Food 2	Intake 4	175	75561	1337408076	/users/cn/jespinosa/phecomp/data/CRG/20120502_FDF_CRG/20120502_FDF_CRG/20120518_FDF_CRG_c12.mtb	3472	COLL	WWSS	food_sc	4	75386	1337407901	1	0.04	0.000228571428571429	4194	1
1	Food 1	Intake 3	156	75660	1337408175	/users/cn/jespinosa/phecomp/data/CRG/20120502_FDF_CRG/20120502_FDF_CRG/20120518_FDF_CRG_c12.mtb	2652	9	WWSS	food_sc	3	75504	1337408019	1	0.0600000000000001	0.000384615384615385	4195	1
1	Food 1	Intake 3	117	75786	1337408301	/users/cn/jespinosa/phecomp/data/CRG/20120502_FDF_CRG/20120502_FDF_CRG/20120518_FDF_CRG_c12.mtb	2653	4217	WWSS	food_sc	3	75669	1337408184	1	0.0800000000000001	0.000683760683760685	4196	1
1	Drink 2	Intake 2	26	75806	1337408321	/users/cn/jespinosa/phecomp/data/CRG/20120502_FDF_CRG/20120502_FDF_CRG/20120518_FDF_CRG_c12.mtb	1287	NA	WWSS	water	2	75780	1337408295	1	0.0800000000000001	0.00307692307692308	4197	1
1	Drink 2	Intake 2	12	76207	1337408722	/users/cn/jespinosa/phecomp/data/CRG/20120502_FDF_CRG/20120502_FDF_CRG/20120518_FDF_CRG_c12.mtb	1288	NA	WWSS	water	2	76195	1337408710	1	0.02	0.00166666666666667	4198	1
1	Food 1	Intake 3	102	80105	1337412620	/users/cn/jespinosa/phecomp/data/CRG/20120502_FDF_CRG/20120502_FDF_CRG/20120518_FDF_CRG_c12.mtb	2658	4551	WWSS	food_sc	3	80003	1337412518	1	0.1	0.000980392156862745	4199	1
1	Food 2	Intake 4	16	84672	1337417187	/users/cn/jespinosa/phecomp/data/CRG/20120502_FDF_CRG/20120502_FDF_CRG/20120518_FDF_CRG_c12.mtb	3476	19	WWSS	food_sc	4	84656	1337417171	1	0.02	0.00125	4200	1
1	Food 2	Intake 4	17	84708	1337417223	/users/cn/jespinosa/phecomp/data/CRG/20120502_FDF_CRG/20120502_FDF_CRG/20120518_FDF_CRG_c12.mtb	3477	6627	WWSS	food_sc	4	84691	1337417206	1	0.02	0.00117647058823529	4201	1
1	Drink 1	Intake 1	15	84721	1337417236	/users/cn/jespinosa/phecomp/data/CRG/20120502_FDF_CRG/20120502_FDF_CRG/20120518_FDF_CRG_c12.mtb	2448	NA	WWSS	water	1	84706	1337417221	1	0.04	0.00266666666666667	4202	1
1	Drink 2	Intake 2	13	84856	1337417371	/users/cn/jespinosa/phecomp/data/CRG/20120502_FDF_CRG/20120502_FDF_CRG/20120518_FDF_CRG_c12.mtb	1289	NA	WWSS	water	2	84843	1337417358	1	0.04	0.00307692307692308	4203	1
1	Drink 2	Intake 2	17	85261	1337417776	/users/cn/jespinosa/phecomp/data/CRG/20120502_FDF_CRG/20120502_FDF_CRG/20120518_FDF_CRG_c12.mtb	1290	NA	WWSS	water	2	85244	1337417759	1	0.0399999999999998	0.00235294117647058	4204	1
1	Food 2	Intake 4	19	91354	1337423869	/users/cn/jespinosa/phecomp/data/CRG/20120502_FDF_CRG/20120502_FDF_CRG/20120518_FDF_CRG_c12.mtb	3479	4117	WWSS	food_sc	4	91335	1337423850	1	0.02	0.00105263157894737	4205	1
1	Food 2	Intake 4	30	95501	1337428016	/users/cn/jespinosa/phecomp/data/CRG/20120502_FDF_CRG/20120502_FDF_CRG/20120518_FDF_CRG_c12.mtb	3480	187	WWSS	food_sc	4	95471	1337427986	1	0.02	0.000666666666666667	4206	1
1	Food 2	Intake 4	25	95713	1337428228	/users/cn/jespinosa/phecomp/data/CRG/20120502_FDF_CRG/20120502_FDF_CRG/20120518_FDF_CRG_c12.mtb	3481	17	WWSS	food_sc	4	95688	1337428203	1	0.04	0.0016	4207	1
1	Food 2	Intake 4	52	95782	1337428297	/users/cn/jespinosa/phecomp/data/CRG/20120502_FDF_CRG/20120502_FDF_CRG/20120518_FDF_CRG_c12.mtb	3482	10756	WWSS	food_sc	4	95730	1337428245	1	0.02	0.000384615384615385	4208	1
1	Drink 2	Intake 2	11	95809	1337428324	/users/cn/jespinosa/phecomp/data/CRG/20120502_FDF_CRG/20120502_FDF_CRG/20120518_FDF_CRG_c12.mtb	1292	NA	WWSS	water	2	95798	1337428313	1	0.04	0.00363636363636364	4209	1
1	Drink 2	Intake 2	126	96404	1337428919	/users/cn/jespinosa/phecomp/data/CRG/20120502_FDF_CRG/20120502_FDF_CRG/20120518_FDF_CRG_c12.mtb	1293	NA	WWSS	water	2	96278	1337428793	1	0.0799999999999998	0.000634920634920633	4210	1
1	Drink 2	Intake 2	15	97487	1337430002	/users/cn/jespinosa/phecomp/data/CRG/20120502_FDF_CRG/20120502_FDF_CRG/20120518_FDF_CRG_c12.mtb	1294	NA	WWSS	water	2	97472	1337429987	1	0.04	0.00266666666666667	4211	1
1	Drink 2	Intake 2	17	102630	1337435145	/users/cn/jespinosa/phecomp/data/CRG/20120502_FDF_CRG/20120502_FDF_CRG/20120518_FDF_CRG_c12.mtb	1295	NA	WWSS	water	2	102613	1337435128	1	0.04	0.00235294117647059	4212	1
1	Food 2	Intake 4	21	106559	1337439074	/users/cn/jespinosa/phecomp/data/CRG/20120502_FDF_CRG/20120502_FDF_CRG/20120518_FDF_CRG_c12.mtb	3484	58	WWSS	food_sc	4	106538	1337439053	1	0.02	0.000952380952380952	4213	1
1	Food 2	Intake 4	39	106656	1337439171	/users/cn/jespinosa/phecomp/data/CRG/20120502_FDF_CRG/20120502_FDF_CRG/20120518_FDF_CRG_c12.mtb	3485	22	WWSS	food_sc	4	106617	1337439132	1	0.04	0.00102564102564103	4214	1
1	Food 2	Intake 4	29	106707	1337439222	/users/cn/jespinosa/phecomp/data/CRG/20120502_FDF_CRG/20120502_FDF_CRG/20120518_FDF_CRG_c12.mtb	3486	35	WWSS	food_sc	4	106678	1337439193	1	0.02	0.000689655172413793	4215	1
1	Food 2	Intake 4	60	106802	1337439317	/users/cn/jespinosa/phecomp/data/CRG/20120502_FDF_CRG/20120502_FDF_CRG/20120518_FDF_CRG_c12.mtb	3487	230	WWSS	food_sc	4	106742	1337439257	1	0.04	0.000666666666666667	4216	1
1	Food 2	Intake 4	16	107048	1337439563	/users/cn/jespinosa/phecomp/data/CRG/20120502_FDF_CRG/20120502_FDF_CRG/20120518_FDF_CRG_c12.mtb	3488	35	WWSS	food_sc	4	107032	1337439547	1	0.02	0.00125	4217	1
1	Food 2	Intake 4	17	107100	1337439615	/users/cn/jespinosa/phecomp/data/CRG/20120502_FDF_CRG/20120502_FDF_CRG/20120518_FDF_CRG_c12.mtb	3489	4614	WWSS	food_sc	4	107083	1337439598	1	0.02	0.00117647058823529	4218	1
1	Food 2	Intake 4	20	111734	1337444249	/users/cn/jespinosa/phecomp/data/CRG/20120502_FDF_CRG/20120502_FDF_CRG/20120518_FDF_CRG_c12.mtb	3491	44	WWSS	food_sc	4	111714	1337444229	1	0.02	0.001	4219	1
1	Food 2	Intake 4	39	111817	1337444332	/users/cn/jespinosa/phecomp/data/CRG/20120502_FDF_CRG/20120502_FDF_CRG/20120518_FDF_CRG_c12.mtb	3492	25	WWSS	food_sc	4	111778	1337444293	1	0.04	0.00102564102564103	4220	1
1	Food 2	Intake 4	88	111930	1337444445	/users/cn/jespinosa/phecomp/data/CRG/20120502_FDF_CRG/20120502_FDF_CRG/20120518_FDF_CRG_c12.mtb	3493	4390	WWSS	food_sc	4	111842	1337444357	1	0.0600000000000001	0.000681818181818183	4221	1
1	Drink 2	Intake 2	15	113365	1337445880	/users/cn/jespinosa/phecomp/data/CRG/20120502_FDF_CRG/20120502_FDF_CRG/20120518_FDF_CRG_c12.mtb	1296	NA	WWSS	water	2	113350	1337445865	1	0.04	0.00266666666666667	4222	1
1	Food 1	Intake 3	31	116351	1337448866	/users/cn/jespinosa/phecomp/data/CRG/20120502_FDF_CRG/20120502_FDF_CRG/20120518_FDF_CRG_c12.mtb	2660	31	WWSS	food_sc	3	116320	1337448835	1	0.0600000000000001	0.00193548387096775	4223	1
1	Food 1	Intake 3	17	116399	1337448914	/users/cn/jespinosa/phecomp/data/CRG/20120502_FDF_CRG/20120502_FDF_CRG/20120518_FDF_CRG_c12.mtb	2661	26	WWSS	food_sc	3	116382	1337448897	1	0.02	0.00117647058823529	4224	1
1	Food 1	Intake 3	32	116457	1337448972	/users/cn/jespinosa/phecomp/data/CRG/20120502_FDF_CRG/20120502_FDF_CRG/20120518_FDF_CRG_c12.mtb	2662	2074	WWSS	food_sc	3	116425	1337448940	1	0.02	0.000625	4225	1
1	Food 1	Intake 3	12	118543	1337451058	/users/cn/jespinosa/phecomp/data/CRG/20120502_FDF_CRG/20120502_FDF_CRG/20120518_FDF_CRG_c12.mtb	2663	666	WWSS	food_sc	3	118531	1337451046	1	0.02	0.00166666666666667	4226	1
1	Food 1	Intake 3	22	119231	1337451746	/users/cn/jespinosa/phecomp/data/CRG/20120502_FDF_CRG/20120502_FDF_CRG/20120518_FDF_CRG_c12.mtb	2664	47	WWSS	food_sc	3	119209	1337451724	1	0.04	0.00181818181818182	4227	1
1	Food 1	Intake 3	70	119348	1337451863	/users/cn/jespinosa/phecomp/data/CRG/20120502_FDF_CRG/20120502_FDF_CRG/20120518_FDF_CRG_c12.mtb	2666	16	WWSS	food_sc	3	119278	1337451793	1	0.04	0.000571428571428571	4228	1
1	Food 1	Intake 3	92	119456	1337451971	/users/cn/jespinosa/phecomp/data/CRG/20120502_FDF_CRG/20120502_FDF_CRG/20120518_FDF_CRG_c12.mtb	2667	90	WWSS	food_sc	3	119364	1337451879	1	0.04	0.000434782608695652	4229	1
1	Drink 2	Intake 2	14	119464	1337451979	/users/cn/jespinosa/phecomp/data/CRG/20120502_FDF_CRG/20120502_FDF_CRG/20120518_FDF_CRG_c12.mtb	1297	NA	WWSS	water	2	119450	1337451965	1	0.04	0.00285714285714286	4230	1
1	Food 2	Intake 4	208	119754	1337452269	/users/cn/jespinosa/phecomp/data/CRG/20120502_FDF_CRG/20120502_FDF_CRG/20120518_FDF_CRG_c12.mtb	3498	1582	WWSS	food_sc	4	119546	1337452061	1	0.04	0.000192307692307692	4231	1
1	Drink 2	Intake 2	26	119789	1337452304	/users/cn/jespinosa/phecomp/data/CRG/20120502_FDF_CRG/20120502_FDF_CRG/20120518_FDF_CRG_c12.mtb	1298	NA	WWSS	water	2	119763	1337452278	1	0.04	0.00153846153846154	4232	1
1	Drink 2	Intake 2	23	120450	1337452965	/users/cn/jespinosa/phecomp/data/CRG/20120502_FDF_CRG/20120502_FDF_CRG/20120518_FDF_CRG_c12.mtb	1299	NA	WWSS	water	2	120427	1337452942	1	0.04	0.00173913043478261	4233	1
1	Food 1	Intake 3	58	121394	1337453909	/users/cn/jespinosa/phecomp/data/CRG/20120502_FDF_CRG/20120502_FDF_CRG/20120518_FDF_CRG_c12.mtb	2675	1299	WWSS	food_sc	3	121336	1337453851	1	0.0600000000000001	0.00103448275862069	4234	1
1	Food 1	Intake 3	81	122774	1337455289	/users/cn/jespinosa/phecomp/data/CRG/20120502_FDF_CRG/20120502_FDF_CRG/20120518_FDF_CRG_c12.mtb	2676	14	WWSS	food_sc	3	122693	1337455208	1	0.02	0.000246913580246914	4235	1
1	Food 1	Intake 3	65	122853	1337455368	/users/cn/jespinosa/phecomp/data/CRG/20120502_FDF_CRG/20120502_FDF_CRG/20120518_FDF_CRG_c12.mtb	2677	39	WWSS	food_sc	3	122788	1337455303	1	0.0800000000000001	0.00123076923076923	4236	1
1	Food 1	Intake 3	59	122951	1337455466	/users/cn/jespinosa/phecomp/data/CRG/20120502_FDF_CRG/20120502_FDF_CRG/20120518_FDF_CRG_c12.mtb	2678	4	WWSS	food_sc	3	122892	1337455407	1	0.02	0.000338983050847458	4237	1
1	Food 1	Intake 3	78	123033	1337455548	/users/cn/jespinosa/phecomp/data/CRG/20120502_FDF_CRG/20120502_FDF_CRG/20120518_FDF_CRG_c12.mtb	2679	49	WWSS	food_sc	3	122955	1337455470	1	0.02	0.000256410256410256	4238	1
1	Drink 2	Intake 2	26	123063	1337455578	/users/cn/jespinosa/phecomp/data/CRG/20120502_FDF_CRG/20120502_FDF_CRG/20120518_FDF_CRG_c12.mtb	1301	NA	WWSS	water	2	123037	1337455552	1	0.0600000000000001	0.00230769230769231	4239	1
1	Food 1	Intake 3	80	123162	1337455677	/users/cn/jespinosa/phecomp/data/CRG/20120502_FDF_CRG/20120502_FDF_CRG/20120518_FDF_CRG_c12.mtb	2680	83	WWSS	food_sc	3	123082	1337455597	1	0.04	0.0005	4240	1
1	Food 1	Intake 3	18	123263	1337455778	/users/cn/jespinosa/phecomp/data/CRG/20120502_FDF_CRG/20120502_FDF_CRG/20120518_FDF_CRG_c12.mtb	2682	55	WWSS	food_sc	3	123245	1337455760	1	0.0200000000000005	0.00111111111111114	4241	1
1	Food 2	Intake 4	179	123497	1337456012	/users/cn/jespinosa/phecomp/data/CRG/20120502_FDF_CRG/20120502_FDF_CRG/20120518_FDF_CRG_c12.mtb	3507	234	WWSS	food_sc	4	123318	1337455833	1	0.04	0.000223463687150838	4242	1
1	Drink 2	Intake 2	20	123506	1337456021	/users/cn/jespinosa/phecomp/data/CRG/20120502_FDF_CRG/20120502_FDF_CRG/20120518_FDF_CRG_c12.mtb	1302	NA	WWSS	water	2	123486	1337456001	1	0.04	0.002	4243	1
1	Food 2	Intake 4	81	123812	1337456327	/users/cn/jespinosa/phecomp/data/CRG/20120502_FDF_CRG/20120502_FDF_CRG/20120518_FDF_CRG_c12.mtb	3509	58	WWSS	food_sc	4	123731	1337456246	1	0.02	0.000246913580246914	4244	1
1	Drink 1	Intake 1	32	123838	1337456353	/users/cn/jespinosa/phecomp/data/CRG/20120502_FDF_CRG/20120502_FDF_CRG/20120518_FDF_CRG_c12.mtb	2452	NA	WWSS	water	1	123806	1337456321	1	0.0600000000000001	0.001875	4245	1
1	Food 2	Intake 4	100	123970	1337456485	/users/cn/jespinosa/phecomp/data/CRG/20120502_FDF_CRG/20120502_FDF_CRG/20120518_FDF_CRG_c12.mtb	3510	59	WWSS	food_sc	4	123870	1337456385	1	0.02	0.0002	4246	1
1	Drink 2	Intake 2	26	124003	1337456518	/users/cn/jespinosa/phecomp/data/CRG/20120502_FDF_CRG/20120502_FDF_CRG/20120518_FDF_CRG_c12.mtb	1303	NA	WWSS	water	2	123977	1337456492	1	0.04	0.00153846153846154	4247	1
1	Food 2	Intake 4	136	124165	1337456680	/users/cn/jespinosa/phecomp/data/CRG/20120502_FDF_CRG/20120502_FDF_CRG/20120518_FDF_CRG_c12.mtb	3512	252	WWSS	food_sc	4	124029	1337456544	1	0.02	0.000147058823529412	4248	1
1	Drink 2	Intake 2	16	124204	1337456719	/users/cn/jespinosa/phecomp/data/CRG/20120502_FDF_CRG/20120502_FDF_CRG/20120518_FDF_CRG_c12.mtb	1304	NA	WWSS	water	2	124188	1337456703	1	0.02	0.00125	4249	1
1	Food 2	Intake 4	231	124648	1337457163	/users/cn/jespinosa/phecomp/data/CRG/20120502_FDF_CRG/20120502_FDF_CRG/20120518_FDF_CRG_c12.mtb	3514	6	WWSS	food_sc	4	124417	1337456932	1	0.0600000000000001	0.00025974025974026	4250	1
1	Food 2	Intake 4	48	124702	1337457217	/users/cn/jespinosa/phecomp/data/CRG/20120502_FDF_CRG/20120502_FDF_CRG/20120518_FDF_CRG_c12.mtb	3515	292	WWSS	food_sc	4	124654	1337457169	1	0.02	0.000416666666666667	4251	1
1	Drink 2	Intake 2	21	124713	1337457228	/users/cn/jespinosa/phecomp/data/CRG/20120502_FDF_CRG/20120502_FDF_CRG/20120518_FDF_CRG_c12.mtb	1305	NA	WWSS	water	2	124692	1337457207	1	0.0399999999999996	0.00190476190476189	4252	1
1	Food 2	Intake 4	89	125083	1337457598	/users/cn/jespinosa/phecomp/data/CRG/20120502_FDF_CRG/20120502_FDF_CRG/20120518_FDF_CRG_c12.mtb	3517	4	WWSS	food_sc	4	124994	1337457509	1	0.02	0.000224719101123596	4253	1
1	Food 2	Intake 4	94	125181	1337457696	/users/cn/jespinosa/phecomp/data/CRG/20120502_FDF_CRG/20120502_FDF_CRG/20120518_FDF_CRG_c12.mtb	3518	302	WWSS	food_sc	4	125087	1337457602	1	0.02	0.000212765957446809	4254	1
1	Drink 2	Intake 2	31	125207	1337457722	/users/cn/jespinosa/phecomp/data/CRG/20120502_FDF_CRG/20120502_FDF_CRG/20120518_FDF_CRG_c12.mtb	1306	NA	WWSS	water	2	125176	1337457691	1	0.0800000000000001	0.00258064516129033	4255	1
1	Food 2	Intake 4	110	125593	1337458108	/users/cn/jespinosa/phecomp/data/CRG/20120502_FDF_CRG/20120502_FDF_CRG/20120518_FDF_CRG_c12.mtb	3521	147	WWSS	food_sc	4	125483	1337457998	1	0.02	0.000181818181818182	4256	1
1	Food 2	Intake 4	138	125878	1337458393	/users/cn/jespinosa/phecomp/data/CRG/20120502_FDF_CRG/20120502_FDF_CRG/20120518_FDF_CRG_c12.mtb	3522	223	WWSS	food_sc	4	125740	1337458255	1	0.04	0.000289855072463768	4257	1
1	Drink 2	Intake 2	19	126040	1337458555	/users/cn/jespinosa/phecomp/data/CRG/20120502_FDF_CRG/20120502_FDF_CRG/20120518_FDF_CRG_c12.mtb	1307	NA	WWSS	water	2	126021	1337458536	1	0.04	0.00210526315789474	4258	1
1	Food 2	Intake 4	144	126245	1337458760	/users/cn/jespinosa/phecomp/data/CRG/20120502_FDF_CRG/20120502_FDF_CRG/20120518_FDF_CRG_c12.mtb	3524	11	WWSS	food_sc	4	126101	1337458616	1	0.04	0.000277777777777778	4259	1
1	Food 2	Intake 4	94	126350	1337458865	/users/cn/jespinosa/phecomp/data/CRG/20120502_FDF_CRG/20120502_FDF_CRG/20120518_FDF_CRG_c12.mtb	3525	54	WWSS	food_sc	4	126256	1337458771	1	0.04	0.000425531914893617	4260	1
1	Food 2	Intake 4	108	126512	1337459027	/users/cn/jespinosa/phecomp/data/CRG/20120502_FDF_CRG/20120502_FDF_CRG/20120518_FDF_CRG_c12.mtb	3526	609	WWSS	food_sc	4	126404	1337458919	1	0.04	0.00037037037037037	4261	1
1	Drink 2	Intake 2	23	126543	1337459058	/users/cn/jespinosa/phecomp/data/CRG/20120502_FDF_CRG/20120502_FDF_CRG/20120518_FDF_CRG_c12.mtb	1308	NA	WWSS	water	2	126520	1337459035	1	0.0600000000000001	0.00260869565217392	4262	1
1	Food 2	Intake 4	68	127189	1337459704	/users/cn/jespinosa/phecomp/data/CRG/20120502_FDF_CRG/20120502_FDF_CRG/20120518_FDF_CRG_c12.mtb	3530	154	WWSS	food_sc	4	127121	1337459636	1	0.04	0.000588235294117647	4263	1
1	Drink 2	Intake 2	20	127221	1337459736	/users/cn/jespinosa/phecomp/data/CRG/20120502_FDF_CRG/20120502_FDF_CRG/20120518_FDF_CRG_c12.mtb	1309	NA	WWSS	water	2	127201	1337459716	1	0.04	0.002	4264	1
1	Food 2	Intake 4	283	127626	1337460141	/users/cn/jespinosa/phecomp/data/CRG/20120502_FDF_CRG/20120502_FDF_CRG/20120518_FDF_CRG_c12.mtb	3532	43	WWSS	food_sc	4	127343	1337459858	1	0.0800000000000001	0.000282685512367492	4265	1
1	Food 2	Intake 4	137	127806	1337460321	/users/cn/jespinosa/phecomp/data/CRG/20120502_FDF_CRG/20120502_FDF_CRG/20120518_FDF_CRG_c12.mtb	3533	4	WWSS	food_sc	4	127669	1337460184	1	0.0999999999999996	0.000729927007299267	4266	1
1	Food 2	Intake 4	88	127898	1337460413	/users/cn/jespinosa/phecomp/data/CRG/20120502_FDF_CRG/20120502_FDF_CRG/20120518_FDF_CRG_c12.mtb	3534	1004	WWSS	food_sc	4	127810	1337460325	1	0.02	0.000227272727272727	4267	1
1	Drink 2	Intake 2	23	127913	1337460428	/users/cn/jespinosa/phecomp/data/CRG/20120502_FDF_CRG/20120502_FDF_CRG/20120518_FDF_CRG_c12.mtb	1310	NA	WWSS	water	2	127890	1337460405	1	0.0800000000000001	0.00347826086956522	4268	1
1	Food 2	Intake 4	15	128917	1337461432	/users/cn/jespinosa/phecomp/data/CRG/20120502_FDF_CRG/20120502_FDF_CRG/20120518_FDF_CRG_c12.mtb	3535	131	WWSS	food_sc	4	128902	1337461417	1	0.02	0.00133333333333333	4269	1
1	Food 1	Intake 3	33	129081	1337461596	/users/cn/jespinosa/phecomp/data/CRG/20120502_FDF_CRG/20120502_FDF_CRG/20120518_FDF_CRG_c12.mtb	2713	909	WWSS	food_sc	3	129048	1337461563	1	0.02	0.000606060606060606	4270	1
1	Drink 2	Intake 2	15	129959	1337462474	/users/cn/jespinosa/phecomp/data/CRG/20120502_FDF_CRG/20120502_FDF_CRG/20120518_FDF_CRG_c12.mtb	1311	NA	WWSS	water	2	129944	1337462459	1	0.02	0.00133333333333333	4271	1
1	Food 2	Intake 4	158	130148	1337462663	/users/cn/jespinosa/phecomp/data/CRG/20120502_FDF_CRG/20120502_FDF_CRG/20120518_FDF_CRG_c12.mtb	3540	84	WWSS	food_sc	4	129990	1337462505	1	0.04	0.000253164556962025	4272	1
1	Food 1	Intake 3	99	130331	1337462846	/users/cn/jespinosa/phecomp/data/CRG/20120502_FDF_CRG/20120502_FDF_CRG/20120518_FDF_CRG_c12.mtb	2717	54	WWSS	food_sc	3	130232	1337462747	1	0.02	0.000202020202020202	4273	1
1	Drink 1	Intake 1	20	130387	1337462902	/users/cn/jespinosa/phecomp/data/CRG/20120502_FDF_CRG/20120502_FDF_CRG/20120518_FDF_CRG_c12.mtb	2455	NA	WWSS	water	1	130367	1337462882	1	0.0399999999999999	0.00199999999999999	4274	1
1	Food 1	Intake 3	66	130451	1337462966	/users/cn/jespinosa/phecomp/data/CRG/20120502_FDF_CRG/20120502_FDF_CRG/20120518_FDF_CRG_c12.mtb	2718	224	WWSS	food_sc	3	130385	1337462900	1	0.04	0.000606060606060606	4275	1
1	Drink 1	Intake 1	22	130495	1337463010	/users/cn/jespinosa/phecomp/data/CRG/20120502_FDF_CRG/20120502_FDF_CRG/20120518_FDF_CRG_c12.mtb	2456	NA	WWSS	water	1	130473	1337462988	1	0.04	0.00181818181818182	4276	1
1	Food 1	Intake 3	35	130710	1337463225	/users/cn/jespinosa/phecomp/data/CRG/20120502_FDF_CRG/20120502_FDF_CRG/20120518_FDF_CRG_c12.mtb	2719	347	WWSS	food_sc	3	130675	1337463190	1	0.02	0.000571428571428571	4277	1
1	Drink 2	Intake 2	15	130896	1337463411	/users/cn/jespinosa/phecomp/data/CRG/20120502_FDF_CRG/20120502_FDF_CRG/20120518_FDF_CRG_c12.mtb	1313	NA	WWSS	water	2	130881	1337463396	1	0.02	0.00133333333333333	4278	1
1	Food 2	Intake 4	305	131362	1337463877	/users/cn/jespinosa/phecomp/data/CRG/20120502_FDF_CRG/20120502_FDF_CRG/20120518_FDF_CRG_c12.mtb	3545	44	WWSS	food_sc	4	131057	1337463572	1	0.36	0.00118032786885246	4279	1
1	Food 2	Intake 4	165	131571	1337464086	/users/cn/jespinosa/phecomp/data/CRG/20120502_FDF_CRG/20120502_FDF_CRG/20120518_FDF_CRG_c12.mtb	3546	32	WWSS	food_sc	4	131406	1337463921	1	0.04	0.000242424242424242	4280	1
1	Drink 2	Intake 2	25	131591	1337464106	/users/cn/jespinosa/phecomp/data/CRG/20120502_FDF_CRG/20120502_FDF_CRG/20120518_FDF_CRG_c12.mtb	1314	NA	WWSS	water	2	131566	1337464081	1	0.0600000000000001	0.0024	4281	1
1	Food 2	Intake 4	55	131658	1337464173	/users/cn/jespinosa/phecomp/data/CRG/20120502_FDF_CRG/20120502_FDF_CRG/20120518_FDF_CRG_c12.mtb	3547	233	WWSS	food_sc	4	131603	1337464118	1	0.02	0.000363636363636364	4282	1
1	Food 2	Intake 4	189	132080	1337464595	/users/cn/jespinosa/phecomp/data/CRG/20120502_FDF_CRG/20120502_FDF_CRG/20120518_FDF_CRG_c12.mtb	3549	44	WWSS	food_sc	4	131891	1337464406	1	0.04	0.000211640211640212	4283	1
1	Drink 2	Intake 2	25	132105	1337464620	/users/cn/jespinosa/phecomp/data/CRG/20120502_FDF_CRG/20120502_FDF_CRG/20120518_FDF_CRG_c12.mtb	1315	NA	WWSS	water	2	132080	1337464595	1	0.04	0.0016	4284	1
1	Food 2	Intake 4	150	132274	1337464789	/users/cn/jespinosa/phecomp/data/CRG/20120502_FDF_CRG/20120502_FDF_CRG/20120518_FDF_CRG_c12.mtb	3550	22	WWSS	food_sc	4	132124	1337464639	1	0.02	0.000133333333333333	4285	1
1	Food 2	Intake 4	93	132389	1337464904	/users/cn/jespinosa/phecomp/data/CRG/20120502_FDF_CRG/20120502_FDF_CRG/20120518_FDF_CRG_c12.mtb	3551	10	WWSS	food_sc	4	132296	1337464811	1	0.02	0.00021505376344086	4286	1
1	Food 2	Intake 4	244	132643	1337465158	/users/cn/jespinosa/phecomp/data/CRG/20120502_FDF_CRG/20120502_FDF_CRG/20120518_FDF_CRG_c12.mtb	3552	69	WWSS	food_sc	4	132399	1337464914	1	0.0800000000000001	0.000327868852459017	4287	1
1	Drink 2	Intake 2	22	132657	1337465172	/users/cn/jespinosa/phecomp/data/CRG/20120502_FDF_CRG/20120502_FDF_CRG/20120518_FDF_CRG_c12.mtb	1316	NA	WWSS	water	2	132635	1337465150	1	0.04	0.00181818181818182	4288	1
1	Food 2	Intake 4	232	132944	1337465459	/users/cn/jespinosa/phecomp/data/CRG/20120502_FDF_CRG/20120502_FDF_CRG/20120518_FDF_CRG_c12.mtb	3553	392	WWSS	food_sc	4	132712	1337465227	1	0.0600000000000001	0.000258620689655173	4289	1
1	Drink 2	Intake 2	17	132958	1337465473	/users/cn/jespinosa/phecomp/data/CRG/20120502_FDF_CRG/20120502_FDF_CRG/20120518_FDF_CRG_c12.mtb	1318	NA	WWSS	water	2	132941	1337465456	1	0.0599999999999996	0.00352941176470586	4290	1
1	Food 2	Intake 4	57	133393	1337465908	/users/cn/jespinosa/phecomp/data/CRG/20120502_FDF_CRG/20120502_FDF_CRG/20120518_FDF_CRG_c12.mtb	3555	56	WWSS	food_sc	4	133336	1337465851	1	0.04	0.000701754385964912	4291	1
1	Food 1	Intake 3	47	133496	1337466011	/users/cn/jespinosa/phecomp/data/CRG/20120502_FDF_CRG/20120502_FDF_CRG/20120518_FDF_CRG_c12.mtb	2733	COLL	WWSS	food_sc	3	133449	1337465964	1	0.02	0.000425531914893617	4292	1
1	Food 2	Intake 4	182	133665	1337466180	/users/cn/jespinosa/phecomp/data/CRG/20120502_FDF_CRG/20120502_FDF_CRG/20120518_FDF_CRG_c12.mtb	3557	80	WWSS	food_sc	4	133483	1337465998	1	0.04	0.00021978021978022	4293	1
1	Drink 2	Intake 2	26	133701	1337466216	/users/cn/jespinosa/phecomp/data/CRG/20120502_FDF_CRG/20120502_FDF_CRG/20120518_FDF_CRG_c12.mtb	1319	NA	WWSS	water	2	133675	1337466190	1	0.04	0.00153846153846154	4294	1
1	Food 2	Intake 4	128	133873	1337466388	/users/cn/jespinosa/phecomp/data/CRG/20120502_FDF_CRG/20120502_FDF_CRG/20120518_FDF_CRG_c12.mtb	3559	324	WWSS	food_sc	4	133745	1337466260	1	0.0600000000000001	0.000468750000000001	4295	1
1	Food 1	Intake 3	46	134243	1337466758	/users/cn/jespinosa/phecomp/data/CRG/20120502_FDF_CRG/20120502_FDF_CRG/20120518_FDF_CRG_c12.mtb	2735	COLL	WWSS	food_sc	3	134197	1337466712	1	0.02	0.000434782608695652	4296	1
1	Food 2	Intake 4	77	134310	1337466825	/users/cn/jespinosa/phecomp/data/CRG/20120502_FDF_CRG/20120502_FDF_CRG/20120518_FDF_CRG_c12.mtb	3562	224	WWSS	food_sc	4	134233	1337466748	1	0.0200000000000005	0.000259740259740266	4297	1
1	Food 2	Intake 4	25	134559	1337467074	/users/cn/jespinosa/phecomp/data/CRG/20120502_FDF_CRG/20120502_FDF_CRG/20120518_FDF_CRG_c12.mtb	3565	719	WWSS	food_sc	4	134534	1337467049	1	0.02	0.0008	4298	1
1	Drink 2	Intake 2	13	134624	1337467139	/users/cn/jespinosa/phecomp/data/CRG/20120502_FDF_CRG/20120502_FDF_CRG/20120518_FDF_CRG_c12.mtb	1320	NA	WWSS	water	2	134611	1337467126	1	0.02	0.00153846153846154	4299	1
1	Drink 2	Intake 2	35	135102	1337467617	/users/cn/jespinosa/phecomp/data/CRG/20120502_FDF_CRG/20120502_FDF_CRG/20120518_FDF_CRG_c12.mtb	1321	NA	WWSS	water	2	135067	1337467582	1	0.1	0.00285714285714286	4300	1
1	Food 1	Intake 3	30	135308	1337467823	/users/cn/jespinosa/phecomp/data/CRG/20120502_FDF_CRG/20120502_FDF_CRG/20120518_FDF_CRG_c12.mtb	2741	1147	WWSS	food_sc	3	135278	1337467793	1	0.02	0.000666666666666667	4301	1
1	Drink 2	Intake 2	17	136071	1337468586	/users/cn/jespinosa/phecomp/data/CRG/20120502_FDF_CRG/20120502_FDF_CRG/20120518_FDF_CRG_c12.mtb	1323	NA	WWSS	water	2	136054	1337468569	1	0.02	0.00117647058823529	4302	1
1	Food 2	Intake 4	138	136593	1337469108	/users/cn/jespinosa/phecomp/data/CRG/20120502_FDF_CRG/20120502_FDF_CRG/20120518_FDF_CRG_c12.mtb	3574	25	WWSS	food_sc	4	136455	1337468970	1	0.0600000000000001	0.000434782608695653	4303	1
1	Drink 2	Intake 2	15	136611	1337469126	/users/cn/jespinosa/phecomp/data/CRG/20120502_FDF_CRG/20120502_FDF_CRG/20120518_FDF_CRG_c12.mtb	1324	NA	WWSS	water	2	136596	1337469111	1	0.02	0.00133333333333333	4304	1
1	Food 2	Intake 4	81	136699	1337469214	/users/cn/jespinosa/phecomp/data/CRG/20120502_FDF_CRG/20120502_FDF_CRG/20120518_FDF_CRG_c12.mtb	3575	550	WWSS	food_sc	4	136618	1337469133	1	0.04	0.000493827160493827	4305	1
1	Drink 2	Intake 2	18	136716	1337469231	/users/cn/jespinosa/phecomp/data/CRG/20120502_FDF_CRG/20120502_FDF_CRG/20120518_FDF_CRG_c12.mtb	1325	NA	WWSS	water	2	136698	1337469213	1	0.02	0.00111111111111111	4306	1
1	Food 2	Intake 4	86	137335	1337469850	/users/cn/jespinosa/phecomp/data/CRG/20120502_FDF_CRG/20120502_FDF_CRG/20120518_FDF_CRG_c12.mtb	3580	71	WWSS	food_sc	4	137249	1337469764	1	0.0600000000000001	0.000697674418604652	4307	1
1	Food 2	Intake 4	141	137547	1337470062	/users/cn/jespinosa/phecomp/data/CRG/20120502_FDF_CRG/20120502_FDF_CRG/20120518_FDF_CRG_c12.mtb	3582	360	WWSS	food_sc	4	137406	1337469921	1	0.0399999999999996	0.000283687943262409	4308	1
1	Drink 2	Intake 2	20	137622	1337470137	/users/cn/jespinosa/phecomp/data/CRG/20120502_FDF_CRG/20120502_FDF_CRG/20120518_FDF_CRG_c12.mtb	1327	NA	WWSS	water	2	137602	1337470117	1	0.04	0.002	4309	1
1	Drink 1	Intake 1	44	137731	1337470246	/users/cn/jespinosa/phecomp/data/CRG/20120502_FDF_CRG/20120502_FDF_CRG/20120518_FDF_CRG_c12.mtb	2461	NA	WWSS	water	1	137687	1337470202	1	0.02	0.000454545454545455	4310	1
1	Food 2	Intake 4	23	137930	1337470445	/users/cn/jespinosa/phecomp/data/CRG/20120502_FDF_CRG/20120502_FDF_CRG/20120518_FDF_CRG_c12.mtb	3585	126	WWSS	food_sc	4	137907	1337470422	1	0.02	0.000869565217391304	4311	1
1	Food 1	Intake 3	189	138245	1337470760	/users/cn/jespinosa/phecomp/data/CRG/20120502_FDF_CRG/20120502_FDF_CRG/20120518_FDF_CRG_c12.mtb	2761	COLL	WWSS	food_sc	3	138056	1337470571	1	0.1	0.000529100529100529	4312	1
1	Food 2	Intake 4	15	138125	1337470640	/users/cn/jespinosa/phecomp/data/CRG/20120502_FDF_CRG/20120502_FDF_CRG/20120518_FDF_CRG_c12.mtb	3588	246	WWSS	food_sc	4	138110	1337470625	1	0.0800000000000001	0.00533333333333334	4313	1
1	Drink 1	Intake 1	14	138254	1337470769	/users/cn/jespinosa/phecomp/data/CRG/20120502_FDF_CRG/20120502_FDF_CRG/20120518_FDF_CRG_c12.mtb	2464	NA	WWSS	water	1	138240	1337470755	1	0.02	0.00142857142857143	4314	1
1	Food 2	Intake 4	65	138436	1337470951	/users/cn/jespinosa/phecomp/data/CRG/20120502_FDF_CRG/20120502_FDF_CRG/20120518_FDF_CRG_c12.mtb	3591	COLL	WWSS	food_sc	4	138371	1337470886	1	0.04	0.000615384615384615	4315	1
1	Food 1	Intake 3	66	138489	1337471004	/users/cn/jespinosa/phecomp/data/CRG/20120502_FDF_CRG/20120502_FDF_CRG/20120518_FDF_CRG_c12.mtb	2763	878	WWSS	food_sc	3	138423	1337470938	1	0.02	0.000303030303030303	4316	1
1	Food 1	Intake 3	63	139430	1337471945	/users/cn/jespinosa/phecomp/data/CRG/20120502_FDF_CRG/20120502_FDF_CRG/20120518_FDF_CRG_c12.mtb	2764	6667	WWSS	food_sc	3	139367	1337471882	1	0.02	0.000317460317460317	4317	1
1	Drink 2	Intake 2	22	139623	1337472138	/users/cn/jespinosa/phecomp/data/CRG/20120502_FDF_CRG/20120502_FDF_CRG/20120518_FDF_CRG_c12.mtb	1329	NA	WWSS	water	2	139601	1337472116	1	0.0800000000000001	0.00363636363636364	4318	1
1	Food 2	Intake 4	16	146113	1337478628	/users/cn/jespinosa/phecomp/data/CRG/20120502_FDF_CRG/20120502_FDF_CRG/20120518_FDF_CRG_c12.mtb	3594	75	WWSS	food_sc	4	146097	1337478612	1	0.0200000000000005	0.00125000000000003	4319	1
1	Food 2	Intake 4	9	146197	1337478712	/users/cn/jespinosa/phecomp/data/CRG/20120502_FDF_CRG/20120502_FDF_CRG/20120518_FDF_CRG_c12.mtb	3596	5496	WWSS	food_sc	4	146188	1337478703	1	0.0200000000000005	0.00222222222222228	4320	1
1	Food 2	Intake 4	33	151726	1337484241	/users/cn/jespinosa/phecomp/data/CRG/20120502_FDF_CRG/20120502_FDF_CRG/20120518_FDF_CRG_c12.mtb	3598	119	WWSS	food_sc	4	151693	1337484208	1	0.04	0.00121212121212121	4321	1
1	Food 2	Intake 4	28	151873	1337484388	/users/cn/jespinosa/phecomp/data/CRG/20120502_FDF_CRG/20120502_FDF_CRG/20120518_FDF_CRG_c12.mtb	3599	2774	WWSS	food_sc	4	151845	1337484360	1	0.0200000000000005	0.000714285714285732	4322	1
1	Food 2	Intake 4	60	154707	1337487222	/users/cn/jespinosa/phecomp/data/CRG/20120502_FDF_CRG/20120502_FDF_CRG/20120518_FDF_CRG_c12.mtb	3603	1673	WWSS	food_sc	4	154647	1337487162	1	0.04	0.000666666666666667	4323	1
1	Food 2	Intake 4	48	156428	1337488943	/users/cn/jespinosa/phecomp/data/CRG/20120502_FDF_CRG/20120502_FDF_CRG/20120518_FDF_CRG_c12.mtb	3606	4	WWSS	food_sc	4	156380	1337488895	1	0.04	0.000833333333333333	4324	1
1	Food 2	Intake 4	58	156490	1337489005	/users/cn/jespinosa/phecomp/data/CRG/20120502_FDF_CRG/20120502_FDF_CRG/20120518_FDF_CRG_c12.mtb	3607	22	WWSS	food_sc	4	156432	1337488947	1	0.04	0.000689655172413793	4325	1
1	Food 2	Intake 4	118	156630	1337489145	/users/cn/jespinosa/phecomp/data/CRG/20120502_FDF_CRG/20120502_FDF_CRG/20120518_FDF_CRG_c12.mtb	3608	36	WWSS	food_sc	4	156512	1337489027	1	0.04	0.000338983050847458	4326	1
1	Drink 1	Intake 1	16	156640	1337489155	/users/cn/jespinosa/phecomp/data/CRG/20120502_FDF_CRG/20120502_FDF_CRG/20120518_FDF_CRG_c12.mtb	2465	NA	WWSS	water	1	156624	1337489139	1	0.1	0.00625	4327	1
1	Food 2	Intake 4	93	156759	1337489274	/users/cn/jespinosa/phecomp/data/CRG/20120502_FDF_CRG/20120502_FDF_CRG/20120518_FDF_CRG_c12.mtb	3609	347	WWSS	food_sc	4	156666	1337489181	1	0.0200000000000005	0.000215053763440866	4328	1
1	Drink 1	Intake 1	20	156768	1337489283	/users/cn/jespinosa/phecomp/data/CRG/20120502_FDF_CRG/20120502_FDF_CRG/20120518_FDF_CRG_c12.mtb	2466	NA	WWSS	water	1	156748	1337489263	1	0.0399999999999998	0.00199999999999999	4329	1
1	Drink 2	Intake 2	21	156953	1337489468	/users/cn/jespinosa/phecomp/data/CRG/20120502_FDF_CRG/20120502_FDF_CRG/20120518_FDF_CRG_c12.mtb	1331	NA	WWSS	water	2	156932	1337489447	1	0.04	0.0019047619047619	4330	1
1	Food 2	Intake 4	53	157159	1337489674	/users/cn/jespinosa/phecomp/data/CRG/20120502_FDF_CRG/20120502_FDF_CRG/20120518_FDF_CRG_c12.mtb	3613	103	WWSS	food_sc	4	157106	1337489621	1	0.0200000000000005	0.000377358490566047	4331	1
1	Food 1	Intake 3	51	157313	1337489828	/users/cn/jespinosa/phecomp/data/CRG/20120502_FDF_CRG/20120502_FDF_CRG/20120518_FDF_CRG_c12.mtb	2773	550	WWSS	food_sc	3	157262	1337489777	1	0.02	0.000392156862745098	4332	1
1	Drink 2	Intake 2	25	157362	1337489877	/users/cn/jespinosa/phecomp/data/CRG/20120502_FDF_CRG/20120502_FDF_CRG/20120518_FDF_CRG_c12.mtb	1332	NA	WWSS	water	2	157337	1337489852	1	0.0799999999999996	0.00319999999999998	4333	1
1	Drink 2	Intake 2	16	157584	1337490099	/users/cn/jespinosa/phecomp/data/CRG/20120502_FDF_CRG/20120502_FDF_CRG/20120518_FDF_CRG_c12.mtb	1333	NA	WWSS	water	2	157568	1337490083	1	0.0200000000000005	0.00125000000000003	4334	1
1	Drink 2	Intake 2	22	157818	1337490333	/users/cn/jespinosa/phecomp/data/CRG/20120502_FDF_CRG/20120502_FDF_CRG/20120518_FDF_CRG_c12.mtb	1334	NA	WWSS	water	2	157796	1337490311	1	0.0399999999999996	0.0018181818181818	4335	1
1	Food 2	Intake 4	139	158002	1337490517	/users/cn/jespinosa/phecomp/data/CRG/20120502_FDF_CRG/20120502_FDF_CRG/20120518_FDF_CRG_c12.mtb	3619	157	WWSS	food_sc	4	157863	1337490378	1	0.0200000000000005	0.000143884892086335	4336	1
1	Food 1	Intake 3	44	158203	1337490718	/users/cn/jespinosa/phecomp/data/CRG/20120502_FDF_CRG/20120502_FDF_CRG/20120518_FDF_CRG_c12.mtb	2777	755	WWSS	food_sc	3	158159	1337490674	1	0.02	0.000454545454545455	4337	1
1	Drink 2	Intake 2	12	158343	1337490858	/users/cn/jespinosa/phecomp/data/CRG/20120502_FDF_CRG/20120502_FDF_CRG/20120518_FDF_CRG_c12.mtb	1335	NA	WWSS	water	2	158331	1337490846	1	0.02	0.00166666666666667	4338	1
1	Drink 2	Intake 2	21	158447	1337490962	/users/cn/jespinosa/phecomp/data/CRG/20120502_FDF_CRG/20120502_FDF_CRG/20120518_FDF_CRG_c12.mtb	1336	NA	WWSS	water	2	158426	1337490941	1	0.04	0.0019047619047619	4339	1
1	Food 2	Intake 4	160	159118	1337491633	/users/cn/jespinosa/phecomp/data/CRG/20120502_FDF_CRG/20120502_FDF_CRG/20120518_FDF_CRG_c12.mtb	3625	75	WWSS	food_sc	4	158958	1337491473	1	0.0400000000000009	0.000250000000000006	4340	1
1	Drink 2	Intake 2	20	159137	1337491652	/users/cn/jespinosa/phecomp/data/CRG/20120502_FDF_CRG/20120502_FDF_CRG/20120518_FDF_CRG_c12.mtb	1338	NA	WWSS	water	2	159117	1337491632	1	0.04	0.002	4341	1
1	Food 2	Intake 4	175	159368	1337491883	/users/cn/jespinosa/phecomp/data/CRG/20120502_FDF_CRG/20120502_FDF_CRG/20120518_FDF_CRG_c12.mtb	3627	10	WWSS	food_sc	4	159193	1337491708	1	0.0399999999999991	0.000228571428571423	4342	1
1	Drink 2	Intake 2	12	159375	1337491890	/users/cn/jespinosa/phecomp/data/CRG/20120502_FDF_CRG/20120502_FDF_CRG/20120518_FDF_CRG_c12.mtb	1339	NA	WWSS	water	2	159363	1337491878	1	0.02	0.00166666666666667	4343	1
1	Food 2	Intake 4	101	159479	1337491994	/users/cn/jespinosa/phecomp/data/CRG/20120502_FDF_CRG/20120502_FDF_CRG/20120518_FDF_CRG_c12.mtb	3628	48	WWSS	food_sc	4	159378	1337491893	1	0.04	0.000396039603960396	4344	1
1	Food 2	Intake 4	148	159675	1337492190	/users/cn/jespinosa/phecomp/data/CRG/20120502_FDF_CRG/20120502_FDF_CRG/20120518_FDF_CRG_c12.mtb	3629	56	WWSS	food_sc	4	159527	1337492042	1	0.0800000000000001	0.000540540540540541	4345	1
1	Drink 2	Intake 2	40	159707	1337492222	/users/cn/jespinosa/phecomp/data/CRG/20120502_FDF_CRG/20120502_FDF_CRG/20120518_FDF_CRG_c12.mtb	1341	NA	WWSS	water	2	159667	1337492182	1	0.02	0.0005	4346	1
1	Food 2	Intake 4	133	159864	1337492379	/users/cn/jespinosa/phecomp/data/CRG/20120502_FDF_CRG/20120502_FDF_CRG/20120518_FDF_CRG_c12.mtb	3630	113	WWSS	food_sc	4	159731	1337492246	1	0.04	0.000300751879699248	4347	1
1	Drink 2	Intake 2	22	159889	1337492404	/users/cn/jespinosa/phecomp/data/CRG/20120502_FDF_CRG/20120502_FDF_CRG/20120518_FDF_CRG_c12.mtb	1342	NA	WWSS	water	2	159867	1337492382	1	0.04	0.00181818181818182	4348	1
1	Food 2	Intake 4	133	160110	1337492625	/users/cn/jespinosa/phecomp/data/CRG/20120502_FDF_CRG/20120502_FDF_CRG/20120518_FDF_CRG_c12.mtb	3632	9	WWSS	food_sc	4	159977	1337492492	1	0.04	0.000300751879699248	4349	1
1	Food 2	Intake 4	193	160312	1337492827	/users/cn/jespinosa/phecomp/data/CRG/20120502_FDF_CRG/20120502_FDF_CRG/20120518_FDF_CRG_c12.mtb	3633	260	WWSS	food_sc	4	160119	1337492634	1	0.04	0.000207253886010363	4350	1
1	Drink 2	Intake 2	16	160501	1337493016	/users/cn/jespinosa/phecomp/data/CRG/20120502_FDF_CRG/20120502_FDF_CRG/20120518_FDF_CRG_c12.mtb	1343	NA	WWSS	water	2	160485	1337493000	1	0.04	0.0025	4351	1
1	Food 2	Intake 4	76	160648	1337493163	/users/cn/jespinosa/phecomp/data/CRG/20120502_FDF_CRG/20120502_FDF_CRG/20120518_FDF_CRG_c12.mtb	3636	74	WWSS	food_sc	4	160572	1337493087	1	0.0200000000000005	0.000263157894736849	4352	1
1	Food 2	Intake 4	164	160886	1337493401	/users/cn/jespinosa/phecomp/data/CRG/20120502_FDF_CRG/20120502_FDF_CRG/20120518_FDF_CRG_c12.mtb	3637	1464	WWSS	food_sc	4	160722	1337493237	1	0.04	0.00024390243902439	4353	1
1	Drink 2	Intake 2	19	160894	1337493409	/users/cn/jespinosa/phecomp/data/CRG/20120502_FDF_CRG/20120502_FDF_CRG/20120518_FDF_CRG_c12.mtb	1344	NA	WWSS	water	2	160875	1337493390	1	0.04	0.00210526315789474	4354	1
1	Drink 1	Intake 1	18	162156	1337494671	/users/cn/jespinosa/phecomp/data/CRG/20120502_FDF_CRG/20120502_FDF_CRG/20120518_FDF_CRG_c12.mtb	2470	NA	WWSS	water	1	162138	1337494653	1	0.02	0.00111111111111111	4355	1
1	Food 2	Intake 4	41	162391	1337494906	/users/cn/jespinosa/phecomp/data/CRG/20120502_FDF_CRG/20120502_FDF_CRG/20120518_FDF_CRG_c12.mtb	3646	4516	WWSS	food_sc	4	162350	1337494865	1	0.0600000000000005	0.00146341463414635	4356	1
1	Food 2	Intake 4	49	166956	1337499471	/users/cn/jespinosa/phecomp/data/CRG/20120502_FDF_CRG/20120502_FDF_CRG/20120518_FDF_CRG_c12.mtb	3649	37	WWSS	food_sc	4	166907	1337499422	1	0.0600000000000005	0.00122448979591838	4357	1
1	Food 2	Intake 4	42	167035	1337499550	/users/cn/jespinosa/phecomp/data/CRG/20120502_FDF_CRG/20120502_FDF_CRG/20120518_FDF_CRG_c12.mtb	3651	5943	WWSS	food_sc	4	166993	1337499508	1	0.04	0.000952380952380952	4358	1
1	Drink 2	Intake 2	20	167065	1337499580	/users/cn/jespinosa/phecomp/data/CRG/20120502_FDF_CRG/20120502_FDF_CRG/20120518_FDF_CRG_c12.mtb	1346	NA	WWSS	water	2	167045	1337499560	1	0.04	0.002	4359	1
1	Drink 2	Intake 2	21	167206	1337499721	/users/cn/jespinosa/phecomp/data/CRG/20120502_FDF_CRG/20120502_FDF_CRG/20120518_FDF_CRG_c12.mtb	1347	NA	WWSS	water	2	167185	1337499700	1	0.0800000000000001	0.00380952380952381	4360	1
1	Drink 1	Intake 1	12	168057	1337500572	/users/cn/jespinosa/phecomp/data/CRG/20120502_FDF_CRG/20120502_FDF_CRG/20120518_FDF_CRG_c12.mtb	2471	NA	WWSS	water	1	168045	1337500560	1	0.04	0.00333333333333333	4361	1
1	Food 2	Intake 4	18	172996	1337505511	/users/cn/jespinosa/phecomp/data/CRG/20120502_FDF_CRG/20120502_FDF_CRG/20120518_FDF_CRG_c12.mtb	3654	2167	WWSS	food_sc	4	172978	1337505493	1	0.0200000000000005	0.00111111111111114	4362	1
1	Food 2	Intake 4	155	175318	1337507833	/users/cn/jespinosa/phecomp/data/CRG/20120502_FDF_CRG/20120502_FDF_CRG/20120518_FDF_CRG_c12.mtb	3656	9	WWSS	food_sc	4	175163	1337507678	1	0.16	0.00103225806451613	4363	1
1	Food 2	Intake 4	69	175396	1337507911	/users/cn/jespinosa/phecomp/data/CRG/20120502_FDF_CRG/20120502_FDF_CRG/20120518_FDF_CRG_c12.mtb	3657	54	WWSS	food_sc	4	175327	1337507842	1	0.04	0.000579710144927536	4364	1
1	Food 2	Intake 4	18	175468	1337507983	/users/cn/jespinosa/phecomp/data/CRG/20120502_FDF_CRG/20120502_FDF_CRG/20120518_FDF_CRG_c12.mtb	3658	4830	WWSS	food_sc	4	175450	1337507965	1	0.0200000000000005	0.00111111111111114	4365	1
1	Food 2	Intake 4	39	180337	1337512852	/users/cn/jespinosa/phecomp/data/CRG/20120502_FDF_CRG/20120502_FDF_CRG/20120518_FDF_CRG_c12.mtb	3660	6	WWSS	food_sc	4	180298	1337512813	1	0.04	0.00102564102564103	4366	1
1	Food 2	Intake 4	30	180373	1337512888	/users/cn/jespinosa/phecomp/data/CRG/20120502_FDF_CRG/20120502_FDF_CRG/20120518_FDF_CRG_c12.mtb	3661	9107	WWSS	food_sc	4	180343	1337512858	1	0.04	0.00133333333333333	4367	1
1	Drink 2	Intake 2	14	180889	1337513404	/users/cn/jespinosa/phecomp/data/CRG/20120502_FDF_CRG/20120502_FDF_CRG/20120518_FDF_CRG_c12.mtb	1351	NA	WWSS	water	2	180875	1337513390	1	0.04	0.00285714285714286	4368	1
1	Drink 1	Intake 1	15	181977	1337514492	/users/cn/jespinosa/phecomp/data/CRG/20120502_FDF_CRG/20120502_FDF_CRG/20120518_FDF_CRG_c12.mtb	2472	NA	WWSS	water	1	181962	1337514477	1	0.02	0.00133333333333333	4369	1
1	Food 2	Intake 4	123	189603	1337522118	/users/cn/jespinosa/phecomp/data/CRG/20120502_FDF_CRG/20120502_FDF_CRG/20120518_FDF_CRG_c12.mtb	3665	15	WWSS	food_sc	4	189480	1337521995	1	0.0800000000000001	0.000650406504065041	4370	1
1	Food 2	Intake 4	119	189737	1337522252	/users/cn/jespinosa/phecomp/data/CRG/20120502_FDF_CRG/20120502_FDF_CRG/20120518_FDF_CRG_c12.mtb	3666	3681	WWSS	food_sc	4	189618	1337522133	1	0.0799999999999992	0.000672268907563019	4371	1
1	Food 2	Intake 4	95	193513	1337526028	/users/cn/jespinosa/phecomp/data/CRG/20120502_FDF_CRG/20120502_FDF_CRG/20120518_FDF_CRG_c12.mtb	3669	3636	WWSS	food_sc	4	193418	1337525933	1	0.04	0.000421052631578947	4372	1
1	Food 2	Intake 4	57	197206	1337529721	/users/cn/jespinosa/phecomp/data/CRG/20120502_FDF_CRG/20120502_FDF_CRG/20120518_FDF_CRG_c12.mtb	3670	4145	WWSS	food_sc	4	197149	1337529664	1	0.4	0.00701754385964912	4373	1
1	Food 2	Intake 4	51	201402	1337533917	/users/cn/jespinosa/phecomp/data/CRG/20120502_FDF_CRG/20120502_FDF_CRG/20120518_FDF_CRG_c12.mtb	3674	27	WWSS	food_sc	4	201351	1337533866	1	0.0200000000000005	0.000392156862745108	4374	1
1	Food 2	Intake 4	61	201490	1337534005	/users/cn/jespinosa/phecomp/data/CRG/20120502_FDF_CRG/20120502_FDF_CRG/20120518_FDF_CRG_c12.mtb	3675	4104	WWSS	food_sc	4	201429	1337533944	1	0.0599999999999996	0.000983606557377043	4375	1
1	Drink 2	Intake 2	45	204732	1337537247	/users/cn/jespinosa/phecomp/data/CRG/20120502_FDF_CRG/20120502_FDF_CRG/20120518_FDF_CRG_c12.mtb	1353	NA	WWSS	water	2	204687	1337537202	1	0.0200000000000005	0.000444444444444456	4376	1
1	Food 2	Intake 4	31	205625	1337538140	/users/cn/jespinosa/phecomp/data/CRG/20120502_FDF_CRG/20120502_FDF_CRG/20120518_FDF_CRG_c12.mtb	3679	40	WWSS	food_sc	4	205594	1337538109	1	0.0200000000000005	0.000645161290322597	4377	1
1	Food 2	Intake 4	118	205783	1337538298	/users/cn/jespinosa/phecomp/data/CRG/20120502_FDF_CRG/20120502_FDF_CRG/20120518_FDF_CRG_c12.mtb	3680	123	WWSS	food_sc	4	205665	1337538180	1	0.0599999999999996	0.000508474576271183	4378	1
1	Drink 2	Intake 2	26	205806	1337538321	/users/cn/jespinosa/phecomp/data/CRG/20120502_FDF_CRG/20120502_FDF_CRG/20120518_FDF_CRG_c12.mtb	1354	NA	WWSS	water	2	205780	1337538295	1	0.0399999999999996	0.00153846153846152	4379	1
1	Food 2	Intake 4	96	206002	1337538517	/users/cn/jespinosa/phecomp/data/CRG/20120502_FDF_CRG/20120502_FDF_CRG/20120518_FDF_CRG_c12.mtb	3682	517	WWSS	food_sc	4	205906	1337538421	1	0.0200000000000005	0.000208333333333339	4380	1
1	Drink 2	Intake 2	18	206015	1337538530	/users/cn/jespinosa/phecomp/data/CRG/20120502_FDF_CRG/20120502_FDF_CRG/20120518_FDF_CRG_c12.mtb	1355	NA	WWSS	water	2	205997	1337538512	1	0.02	0.00111111111111111	4381	1
1	Drink 2	Intake 2	31	206331	1337538846	/users/cn/jespinosa/phecomp/data/CRG/20120502_FDF_CRG/20120502_FDF_CRG/20120518_FDF_CRG_c12.mtb	1356	NA	WWSS	water	2	206300	1337538815	1	0.1	0.0032258064516129	4382	1
1	Food 1	Intake 3	101	206620	1337539135	/users/cn/jespinosa/phecomp/data/CRG/20120502_FDF_CRG/20120502_FDF_CRG/20120518_FDF_CRG_c12.mtb	2813	251	WWSS	food_sc	3	206519	1337539034	1	0.02	0.000198019801980198	4383	1
1	Drink 2	Intake 2	14	206853	1337539368	/users/cn/jespinosa/phecomp/data/CRG/20120502_FDF_CRG/20120502_FDF_CRG/20120518_FDF_CRG_c12.mtb	1358	NA	WWSS	water	2	206839	1337539354	1	0.02	0.00142857142857143	4384	1
1	Food 2	Intake 4	262	207133	1337539648	/users/cn/jespinosa/phecomp/data/CRG/20120502_FDF_CRG/20120502_FDF_CRG/20120518_FDF_CRG_c12.mtb	3693	247	WWSS	food_sc	4	206871	1337539386	1	0.04	0.000152671755725191	4385	1
1	Drink 1	Intake 1	54	207294	1337539809	/users/cn/jespinosa/phecomp/data/CRG/20120502_FDF_CRG/20120502_FDF_CRG/20120518_FDF_CRG_c12.mtb	2476	NA	WWSS	water	1	207240	1337539755	1	0.0999999999999999	0.00185185185185185	4386	1
1	Drink 2	Intake 2	41	207331	1337539846	/users/cn/jespinosa/phecomp/data/CRG/20120502_FDF_CRG/20120502_FDF_CRG/20120518_FDF_CRG_c12.mtb	1359	NA	WWSS	water	2	207290	1337539805	1	0.02	0.00048780487804878	4387	1
1	Food 2	Intake 4	81	207461	1337539976	/users/cn/jespinosa/phecomp/data/CRG/20120502_FDF_CRG/20120502_FDF_CRG/20120518_FDF_CRG_c12.mtb	3695	265	WWSS	food_sc	4	207380	1337539895	1	0.0200000000000005	0.00024691358024692	4388	1
1	Drink 1	Intake 1	25	207563	1337540078	/users/cn/jespinosa/phecomp/data/CRG/20120502_FDF_CRG/20120502_FDF_CRG/20120518_FDF_CRG_c12.mtb	2477	NA	WWSS	water	1	207538	1337540053	1	0.04	0.0016	4389	1
1	Drink 1	Intake 1	16	207609	1337540124	/users/cn/jespinosa/phecomp/data/CRG/20120502_FDF_CRG/20120502_FDF_CRG/20120518_FDF_CRG_c12.mtb	2478	NA	WWSS	water	1	207593	1337540108	1	0.02	0.00125	4390	1
1	Food 2	Intake 4	41	207767	1337540282	/users/cn/jespinosa/phecomp/data/CRG/20120502_FDF_CRG/20120502_FDF_CRG/20120518_FDF_CRG_c12.mtb	3699	667	WWSS	food_sc	4	207726	1337540241	1	0.0200000000000005	0.000487804878048793	4391	1
1	Food 1	Intake 3	47	208481	1337540996	/users/cn/jespinosa/phecomp/data/CRG/20120502_FDF_CRG/20120502_FDF_CRG/20120518_FDF_CRG_c12.mtb	2821	6	WWSS	food_sc	3	208434	1337540949	1	0.02	0.000425531914893617	4392	1
1	Food 1	Intake 3	39	208526	1337541041	/users/cn/jespinosa/phecomp/data/CRG/20120502_FDF_CRG/20120502_FDF_CRG/20120518_FDF_CRG_c12.mtb	2822	3573	WWSS	food_sc	3	208487	1337541002	1	0.04	0.00102564102564103	4393	1
1	Drink 2	Intake 2	22	210358	1337542873	/users/cn/jespinosa/phecomp/data/CRG/20120502_FDF_CRG/20120502_FDF_CRG/20120518_FDF_CRG_c12.mtb	1360	NA	WWSS	water	2	210336	1337542851	1	0.0399999999999996	0.0018181818181818	4394	1
1	Food 1	Intake 3	17	212116	1337544631	/users/cn/jespinosa/phecomp/data/CRG/20120502_FDF_CRG/20120502_FDF_CRG/20120518_FDF_CRG_c12.mtb	2823	75	WWSS	food_sc	3	212099	1337544614	1	0.02	0.00117647058823529	4395	1
1	Food 1	Intake 3	29	212220	1337544735	/users/cn/jespinosa/phecomp/data/CRG/20120502_FDF_CRG/20120502_FDF_CRG/20120518_FDF_CRG_c12.mtb	2825	53	WWSS	food_sc	3	212191	1337544706	1	0.0200000000000005	0.00068965517241381	4396	1
1	Drink 2	Intake 2	28	212283	1337544798	/users/cn/jespinosa/phecomp/data/CRG/20120502_FDF_CRG/20120502_FDF_CRG/20120518_FDF_CRG_c12.mtb	1361	NA	WWSS	water	2	212255	1337544770	1	0.0200000000000005	0.000714285714285732	4397	1
1	Food 1	Intake 3	89	212362	1337544877	/users/cn/jespinosa/phecomp/data/CRG/20120502_FDF_CRG/20120502_FDF_CRG/20120518_FDF_CRG_c12.mtb	2826	1497	WWSS	food_sc	3	212273	1337544788	1	0.0399999999999996	0.000449438202247186	4398	1
1	Drink 2	Intake 2	23	212379	1337544894	/users/cn/jespinosa/phecomp/data/CRG/20120502_FDF_CRG/20120502_FDF_CRG/20120518_FDF_CRG_c12.mtb	1362	NA	WWSS	water	2	212356	1337544871	1	0.04	0.00173913043478261	4399	1
1	Food 2	Intake 4	390	214249	1337546764	/users/cn/jespinosa/phecomp/data/CRG/20120502_FDF_CRG/20120502_FDF_CRG/20120518_FDF_CRG_c12.mtb	3707	234	WWSS	food_sc	4	213859	1337546374	1	0.18	0.000461538461538462	4400	1
1	Drink 2	Intake 2	42	214494	1337547009	/users/cn/jespinosa/phecomp/data/CRG/20120502_FDF_CRG/20120502_FDF_CRG/20120518_FDF_CRG_c12.mtb	1363	NA	WWSS	water	2	214452	1337546967	1	0.0599999999999996	0.00142857142857142	4401	1
1	Food 2	Intake 4	123	214606	1337547121	/users/cn/jespinosa/phecomp/data/CRG/20120502_FDF_CRG/20120502_FDF_CRG/20120518_FDF_CRG_c12.mtb	3710	151	WWSS	food_sc	4	214483	1337546998	1	0.04	0.00032520325203252	4402	1
1	Drink 1	Intake 1	18	214618	1337547133	/users/cn/jespinosa/phecomp/data/CRG/20120502_FDF_CRG/20120502_FDF_CRG/20120518_FDF_CRG_c12.mtb	2481	NA	WWSS	water	1	214600	1337547115	1	0.04	0.00222222222222222	4403	1
1	Food 2	Intake 4	116	214873	1337547388	/users/cn/jespinosa/phecomp/data/CRG/20120502_FDF_CRG/20120502_FDF_CRG/20120518_FDF_CRG_c12.mtb	3711	164	WWSS	food_sc	4	214757	1337547272	1	0.0200000000000005	0.000172413793103453	4404	1
1	Food 1	Intake 3	94	215131	1337547646	/users/cn/jespinosa/phecomp/data/CRG/20120502_FDF_CRG/20120502_FDF_CRG/20120518_FDF_CRG_c12.mtb	2829	COLL	WWSS	food_sc	3	215037	1337547552	1	0.02	0.000212765957446809	4405	1
1	Food 2	Intake 4	96	215202	1337547717	/users/cn/jespinosa/phecomp/data/CRG/20120502_FDF_CRG/20120502_FDF_CRG/20120518_FDF_CRG_c12.mtb	3713	215	WWSS	food_sc	4	215106	1337547621	1	0.04	0.000416666666666667	4406	1
1	Drink 2	Intake 2	27	215223	1337547738	/users/cn/jespinosa/phecomp/data/CRG/20120502_FDF_CRG/20120502_FDF_CRG/20120518_FDF_CRG_c12.mtb	1364	NA	WWSS	water	2	215196	1337547711	1	0.0600000000000005	0.00222222222222224	4407	1
1	Food 2	Intake 4	86	215503	1337548018	/users/cn/jespinosa/phecomp/data/CRG/20120502_FDF_CRG/20120502_FDF_CRG/20120518_FDF_CRG_c12.mtb	3715	884	WWSS	food_sc	4	215417	1337547932	1	0.0200000000000005	0.00023255813953489	4408	1
1	Drink 1	Intake 1	16	215514	1337548029	/users/cn/jespinosa/phecomp/data/CRG/20120502_FDF_CRG/20120502_FDF_CRG/20120518_FDF_CRG_c12.mtb	2482	NA	WWSS	water	1	215498	1337548013	1	0.02	0.00125	4409	1
1	Drink 1	Intake 1	24	215584	1337548099	/users/cn/jespinosa/phecomp/data/CRG/20120502_FDF_CRG/20120502_FDF_CRG/20120518_FDF_CRG_c12.mtb	2484	NA	WWSS	water	1	215560	1337548075	1	0.02	0.000833333333333333	4410	1
1	Drink 2	Intake 2	23	215909	1337548424	/users/cn/jespinosa/phecomp/data/CRG/20120502_FDF_CRG/20120502_FDF_CRG/20120518_FDF_CRG_c12.mtb	1366	NA	WWSS	water	2	215886	1337548401	1	0.0599999999999996	0.0026086956521739	4411	1
1	Food 2	Intake 4	96	216483	1337548998	/users/cn/jespinosa/phecomp/data/CRG/20120502_FDF_CRG/20120502_FDF_CRG/20120518_FDF_CRG_c12.mtb	3721	40	WWSS	food_sc	4	216387	1337548902	1	0.04	0.000416666666666667	4412	1
1	Food 2	Intake 4	156	216679	1337549194	/users/cn/jespinosa/phecomp/data/CRG/20120502_FDF_CRG/20120502_FDF_CRG/20120518_FDF_CRG_c12.mtb	3722	138	WWSS	food_sc	4	216523	1337549038	1	0.0200000000000005	0.000128205128205131	4413	1
1	Food 2	Intake 4	100	216917	1337549432	/users/cn/jespinosa/phecomp/data/CRG/20120502_FDF_CRG/20120502_FDF_CRG/20120518_FDF_CRG_c12.mtb	3724	343	WWSS	food_sc	4	216817	1337549332	1	0.04	0.0004	4414	1
1	Drink 2	Intake 2	17	217023	1337549538	/users/cn/jespinosa/phecomp/data/CRG/20120502_FDF_CRG/20120502_FDF_CRG/20120518_FDF_CRG_c12.mtb	1369	NA	WWSS	water	2	217006	1337549521	1	0.0200000000000005	0.00117647058823532	4415	1
1	Drink 1	Intake 1	18	217146	1337549661	/users/cn/jespinosa/phecomp/data/CRG/20120502_FDF_CRG/20120502_FDF_CRG/20120518_FDF_CRG_c12.mtb	2486	NA	WWSS	water	1	217128	1337549643	1	0.0600000000000001	0.00333333333333334	4416	1
1	Food 2	Intake 4	42	217302	1337549817	/users/cn/jespinosa/phecomp/data/CRG/20120502_FDF_CRG/20120502_FDF_CRG/20120518_FDF_CRG_c12.mtb	3727	4	WWSS	food_sc	4	217260	1337549775	1	0.0200000000000005	0.000476190476190488	4417	1
1	Food 2	Intake 4	145	217451	1337549966	/users/cn/jespinosa/phecomp/data/CRG/20120502_FDF_CRG/20120502_FDF_CRG/20120518_FDF_CRG_c12.mtb	3728	322	WWSS	food_sc	4	217306	1337549821	1	0.0399999999999991	0.000275862068965511	4418	1
1	Food 2	Intake 4	92	217865	1337550380	/users/cn/jespinosa/phecomp/data/CRG/20120502_FDF_CRG/20120502_FDF_CRG/20120518_FDF_CRG_c12.mtb	3731	32	WWSS	food_sc	4	217773	1337550288	1	0.0200000000000005	0.000217391304347832	4419	1
1	Food 2	Intake 4	126	218023	1337550538	/users/cn/jespinosa/phecomp/data/CRG/20120502_FDF_CRG/20120502_FDF_CRG/20120518_FDF_CRG_c12.mtb	3732	600	WWSS	food_sc	4	217897	1337550412	1	0.0599999999999996	0.000476190476190473	4420	1
1	Drink 2	Intake 2	28	218043	1337550558	/users/cn/jespinosa/phecomp/data/CRG/20120502_FDF_CRG/20120502_FDF_CRG/20120518_FDF_CRG_c12.mtb	1370	NA	WWSS	water	2	218015	1337550530	1	0.0599999999999996	0.00214285714285713	4421	1
1	Food 1	Intake 3	94	218717	1337551232	/users/cn/jespinosa/phecomp/data/CRG/20120502_FDF_CRG/20120502_FDF_CRG/20120518_FDF_CRG_c12.mtb	2840	41	WWSS	food_sc	3	218623	1337551138	1	0.02	0.000212765957446809	4422	1
1	Drink 2	Intake 2	19	218736	1337551251	/users/cn/jespinosa/phecomp/data/CRG/20120502_FDF_CRG/20120502_FDF_CRG/20120518_FDF_CRG_c12.mtb	1372	NA	WWSS	water	2	218717	1337551232	1	0.0200000000000005	0.00105263157894739	4423	1
1	Food 2	Intake 4	56	218814	1337551329	/users/cn/jespinosa/phecomp/data/CRG/20120502_FDF_CRG/20120502_FDF_CRG/20120518_FDF_CRG_c12.mtb	3736	28	WWSS	food_sc	4	218758	1337551273	1	0.04	0.000714285714285714	4424	1
1	Food 2	Intake 4	121	218963	1337551478	/users/cn/jespinosa/phecomp/data/CRG/20120502_FDF_CRG/20120502_FDF_CRG/20120518_FDF_CRG_c12.mtb	3737	299	WWSS	food_sc	4	218842	1337551357	1	0.0200000000000005	0.000165289256198351	4425	1
1	Drink 2	Intake 2	25	218980	1337551495	/users/cn/jespinosa/phecomp/data/CRG/20120502_FDF_CRG/20120502_FDF_CRG/20120518_FDF_CRG_c12.mtb	1373	NA	WWSS	water	2	218955	1337551470	1	0.0599999999999996	0.00239999999999998	4426	1
1	Drink 2	Intake 2	18	219241	1337551756	/users/cn/jespinosa/phecomp/data/CRG/20120502_FDF_CRG/20120502_FDF_CRG/20120518_FDF_CRG_c12.mtb	1374	NA	WWSS	water	2	219223	1337551738	1	0.0200000000000005	0.00111111111111114	4427	1
1	Food 2	Intake 4	120	219382	1337551897	/users/cn/jespinosa/phecomp/data/CRG/20120502_FDF_CRG/20120502_FDF_CRG/20120518_FDF_CRG_c12.mtb	3739	1775	WWSS	food_sc	4	219262	1337551777	1	0.0200000000000005	0.000166666666666671	4428	1
1	Drink 2	Intake 2	44	219883	1337552398	/users/cn/jespinosa/phecomp/data/CRG/20120502_FDF_CRG/20120502_FDF_CRG/20120518_FDF_CRG_c12.mtb	1375	NA	WWSS	water	2	219839	1337552354	1	0.12	0.00272727272727273	4429	1
1	Food 2	Intake 4	64	221221	1337553736	/users/cn/jespinosa/phecomp/data/CRG/20120502_FDF_CRG/20120502_FDF_CRG/20120518_FDF_CRG_c12.mtb	3748	263	WWSS	food_sc	4	221157	1337553672	1	0.04	0.000625	4430	1
1	Food 2	Intake 4	57	221541	1337554056	/users/cn/jespinosa/phecomp/data/CRG/20120502_FDF_CRG/20120502_FDF_CRG/20120518_FDF_CRG_c12.mtb	3751	86	WWSS	food_sc	4	221484	1337553999	1	0.04	0.000701754385964912	4431	1
1	Food 1	Intake 3	143	221770	1337554285	/users/cn/jespinosa/phecomp/data/CRG/20120502_FDF_CRG/20120502_FDF_CRG/20120518_FDF_CRG_c12.mtb	2853	11	WWSS	food_sc	3	221627	1337554142	1	0.04	0.00027972027972028	4432	1
1	Food 1	Intake 3	64	221845	1337554360	/users/cn/jespinosa/phecomp/data/CRG/20120502_FDF_CRG/20120502_FDF_CRG/20120518_FDF_CRG_c12.mtb	2854	81	WWSS	food_sc	3	221781	1337554296	1	0.02	0.0003125	4433	1
1	Drink 1	Intake 1	13	221855	1337554370	/users/cn/jespinosa/phecomp/data/CRG/20120502_FDF_CRG/20120502_FDF_CRG/20120518_FDF_CRG_c12.mtb	2492	NA	WWSS	water	1	221842	1337554357	1	0.04	0.00307692307692308	4434	1
1	Food 1	Intake 3	85	222011	1337554526	/users/cn/jespinosa/phecomp/data/CRG/20120502_FDF_CRG/20120502_FDF_CRG/20120518_FDF_CRG_c12.mtb	2855	270	WWSS	food_sc	3	221926	1337554441	1	0.04	0.000470588235294118	4435	1
1	Drink 2	Intake 2	34	222047	1337554562	/users/cn/jespinosa/phecomp/data/CRG/20120502_FDF_CRG/20120502_FDF_CRG/20120518_FDF_CRG_c12.mtb	1379	NA	WWSS	water	2	222013	1337554528	1	0.0800000000000001	0.00235294117647059	4436	1
1	Food 1	Intake 3	92	222373	1337554888	/users/cn/jespinosa/phecomp/data/CRG/20120502_FDF_CRG/20120502_FDF_CRG/20120518_FDF_CRG_c12.mtb	2856	143	WWSS	food_sc	3	222281	1337554796	1	0.02	0.000217391304347826	4437	1
1	Food 1	Intake 3	108	222624	1337555139	/users/cn/jespinosa/phecomp/data/CRG/20120502_FDF_CRG/20120502_FDF_CRG/20120518_FDF_CRG_c12.mtb	2858	556	WWSS	food_sc	3	222516	1337555031	1	0.02	0.000185185185185185	4438	1
1	Food 1	Intake 3	86	223266	1337555781	/users/cn/jespinosa/phecomp/data/CRG/20120502_FDF_CRG/20120502_FDF_CRG/20120518_FDF_CRG_c12.mtb	2859	1006	WWSS	food_sc	3	223180	1337555695	1	0.04	0.000465116279069767	4439	1
1	Food 1	Intake 3	58	224330	1337556845	/users/cn/jespinosa/phecomp/data/CRG/20120502_FDF_CRG/20120502_FDF_CRG/20120518_FDF_CRG_c12.mtb	2868	6164	WWSS	food_sc	3	224272	1337556787	1	0.0600000000000001	0.00103448275862069	4440	1
1	Drink 1	Intake 1	26	224434	1337556949	/users/cn/jespinosa/phecomp/data/CRG/20120502_FDF_CRG/20120502_FDF_CRG/20120518_FDF_CRG_c12.mtb	2495	NA	WWSS	water	1	224408	1337556923	1	0.0999999999999999	0.00384615384615384	4441	1
1	Food 2	Intake 4	37	230531	1337563046	/users/cn/jespinosa/phecomp/data/CRG/20120502_FDF_CRG/20120502_FDF_CRG/20120518_FDF_CRG_c12.mtb	3770	133	WWSS	food_sc	4	230494	1337563009	1	0.0200000000000005	0.000540540540540554	4442	1
1	Food 2	Intake 4	89	230753	1337563268	/users/cn/jespinosa/phecomp/data/CRG/20120502_FDF_CRG/20120502_FDF_CRG/20120518_FDF_CRG_c12.mtb	3772	74	WWSS	food_sc	4	230664	1337563179	1	0.0200000000000005	0.000224719101123601	4443	1
1	Food 2	Intake 4	231	231058	1337563573	/users/cn/jespinosa/phecomp/data/CRG/20120502_FDF_CRG/20120502_FDF_CRG/20120518_FDF_CRG_c12.mtb	3773	220	WWSS	food_sc	4	230827	1337563342	1	0.0800000000000001	0.000346320346320347	4444	1
1	Drink 2	Intake 2	26	231079	1337563594	/users/cn/jespinosa/phecomp/data/CRG/20120502_FDF_CRG/20120502_FDF_CRG/20120518_FDF_CRG_c12.mtb	1383	NA	WWSS	water	2	231053	1337563568	1	0.0600000000000005	0.00230769230769233	4445	1
1	Food 1	Intake 3	110	231388	1337563903	/users/cn/jespinosa/phecomp/data/CRG/20120502_FDF_CRG/20120502_FDF_CRG/20120518_FDF_CRG_c12.mtb	2878	11	WWSS	food_sc	3	231278	1337563793	1	0.02	0.000181818181818182	4446	1
1	Food 1	Intake 3	79	231478	1337563993	/users/cn/jespinosa/phecomp/data/CRG/20120502_FDF_CRG/20120502_FDF_CRG/20120518_FDF_CRG_c12.mtb	2879	130	WWSS	food_sc	3	231399	1337563914	1	0.02	0.000253164556962025	4447	1
1	Food 1	Intake 3	87	231695	1337564210	/users/cn/jespinosa/phecomp/data/CRG/20120502_FDF_CRG/20120502_FDF_CRG/20120518_FDF_CRG_c12.mtb	2880	278	WWSS	food_sc	3	231608	1337564123	1	0.04	0.000459770114942529	4448	1
1	Drink 2	Intake 2	16	231706	1337564221	/users/cn/jespinosa/phecomp/data/CRG/20120502_FDF_CRG/20120502_FDF_CRG/20120518_FDF_CRG_c12.mtb	1385	NA	WWSS	water	2	231690	1337564205	1	0.0599999999999996	0.00374999999999998	4449	1
1	Drink 1	Intake 1	20	231772	1337564287	/users/cn/jespinosa/phecomp/data/CRG/20120502_FDF_CRG/20120502_FDF_CRG/20120518_FDF_CRG_c12.mtb	2498	NA	WWSS	water	1	231752	1337564267	1	0.02	0.001	4450	1
1	Drink 2	Intake 2	17	231922	1337564437	/users/cn/jespinosa/phecomp/data/CRG/20120502_FDF_CRG/20120502_FDF_CRG/20120518_FDF_CRG_c12.mtb	1387	NA	WWSS	water	2	231905	1337564420	1	0.0200000000000005	0.00117647058823532	4451	1
1	Food 1	Intake 3	18	231991	1337564506	/users/cn/jespinosa/phecomp/data/CRG/20120502_FDF_CRG/20120502_FDF_CRG/20120518_FDF_CRG_c12.mtb	2882	1328	WWSS	food_sc	3	231973	1337564488	1	0.02	0.00111111111111111	4452	1
1	Drink 2	Intake 2	33	232421	1337564936	/users/cn/jespinosa/phecomp/data/CRG/20120502_FDF_CRG/20120502_FDF_CRG/20120518_FDF_CRG_c12.mtb	1388	NA	WWSS	water	2	232388	1337564903	1	0.0999999999999996	0.00303030303030302	4453	1
1	Food 2	Intake 4	16	233335	1337565850	/users/cn/jespinosa/phecomp/data/CRG/20120502_FDF_CRG/20120502_FDF_CRG/20120518_FDF_CRG_c12.mtb	3779	9782	WWSS	food_sc	4	233319	1337565834	1	0.0200000000000005	0.00125000000000003	4454	1
1	Food 1	Intake 3	63	243180	1337575695	/users/cn/jespinosa/phecomp/data/CRG/20120502_FDF_CRG/20120502_FDF_CRG/20120518_FDF_CRG_c12.mtb	2888	277	WWSS	food_sc	3	243117	1337575632	1	0.04	0.000634920634920635	4455	1
1	Food 2	Intake 4	169	243626	1337576141	/users/cn/jespinosa/phecomp/data/CRG/20120502_FDF_CRG/20120502_FDF_CRG/20120518_FDF_CRG_c12.mtb	3784	224	WWSS	food_sc	4	243457	1337575972	1	0.0800000000000001	0.000473372781065089	4456	1
1	Drink 2	Intake 2	24	243650	1337576165	/users/cn/jespinosa/phecomp/data/CRG/20120502_FDF_CRG/20120502_FDF_CRG/20120518_FDF_CRG_c12.mtb	1389	NA	WWSS	water	2	243626	1337576141	1	0.0600000000000005	0.00250000000000002	4457	1
1	Food 2	Intake 4	112	243962	1337576477	/users/cn/jespinosa/phecomp/data/CRG/20120502_FDF_CRG/20120502_FDF_CRG/20120518_FDF_CRG_c12.mtb	3787	148	WWSS	food_sc	4	243850	1337576365	1	0.04	0.000357142857142857	4458	1
1	Drink 1	Intake 1	25	244001	1337576516	/users/cn/jespinosa/phecomp/data/CRG/20120502_FDF_CRG/20120502_FDF_CRG/20120518_FDF_CRG_c12.mtb	2503	NA	WWSS	water	1	243976	1337576491	1	0.0600000000000001	0.0024	4459	1
1	Food 1	Intake 3	156	244266	1337576781	/users/cn/jespinosa/phecomp/data/CRG/20120502_FDF_CRG/20120502_FDF_CRG/20120518_FDF_CRG_c12.mtb	2896	46	WWSS	food_sc	3	244110	1337576625	1	0.04	0.000256410256410256	4460	1
1	Drink 1	Intake 1	18	244281	1337576796	/users/cn/jespinosa/phecomp/data/CRG/20120502_FDF_CRG/20120502_FDF_CRG/20120518_FDF_CRG_c12.mtb	2504	NA	WWSS	water	1	244263	1337576778	1	0.0399999999999998	0.00222222222222221	4461	1
1	Food 1	Intake 3	155	244467	1337576982	/users/cn/jespinosa/phecomp/data/CRG/20120502_FDF_CRG/20120502_FDF_CRG/20120518_FDF_CRG_c12.mtb	2897	14	WWSS	food_sc	3	244312	1337576827	1	0.02	0.000129032258064516	4462	1
1	Food 1	Intake 3	63	244544	1337577059	/users/cn/jespinosa/phecomp/data/CRG/20120502_FDF_CRG/20120502_FDF_CRG/20120518_FDF_CRG_c12.mtb	2898	25	WWSS	food_sc	3	244481	1337576996	1	0.04	0.000634920634920635	4463	1
1	Drink 1	Intake 1	20	244563	1337577078	/users/cn/jespinosa/phecomp/data/CRG/20120502_FDF_CRG/20120502_FDF_CRG/20120518_FDF_CRG_c12.mtb	2505	NA	WWSS	water	1	244543	1337577058	1	0.02	0.001	4464	1
1	Food 1	Intake 3	120	244689	1337577204	/users/cn/jespinosa/phecomp/data/CRG/20120502_FDF_CRG/20120502_FDF_CRG/20120518_FDF_CRG_c12.mtb	2899	166	WWSS	food_sc	3	244569	1337577084	1	0.02	0.000166666666666667	4465	1
1	Drink 2	Intake 2	17	244768	1337577283	/users/cn/jespinosa/phecomp/data/CRG/20120502_FDF_CRG/20120502_FDF_CRG/20120518_FDF_CRG_c12.mtb	1392	NA	WWSS	water	2	244751	1337577266	1	0.0200000000000005	0.00117647058823532	4466	1
1	Food 2	Intake 4	34	244889	1337577404	/users/cn/jespinosa/phecomp/data/CRG/20120502_FDF_CRG/20120502_FDF_CRG/20120518_FDF_CRG_c12.mtb	3792	81	WWSS	food_sc	4	244855	1337577370	1	0.0200000000000005	0.000588235294117662	4467	1
1	Food 1	Intake 3	92	245062	1337577577	/users/cn/jespinosa/phecomp/data/CRG/20120502_FDF_CRG/20120502_FDF_CRG/20120518_FDF_CRG_c12.mtb	2904	203	WWSS	food_sc	3	244970	1337577485	1	0.04	0.000434782608695652	4468	1
1	Drink 2	Intake 2	36	245096	1337577611	/users/cn/jespinosa/phecomp/data/CRG/20120502_FDF_CRG/20120502_FDF_CRG/20120518_FDF_CRG_c12.mtb	1393	NA	WWSS	water	2	245060	1337577575	1	0.0999999999999996	0.00277777777777777	4469	1
1	Food 1	Intake 3	170	245435	1337577950	/users/cn/jespinosa/phecomp/data/CRG/20120502_FDF_CRG/20120502_FDF_CRG/20120518_FDF_CRG_c12.mtb	2905	13	WWSS	food_sc	3	245265	1337577780	1	0.02	0.000117647058823529	4470	1
1	Food 1	Intake 3	135	245583	1337578098	/users/cn/jespinosa/phecomp/data/CRG/20120502_FDF_CRG/20120502_FDF_CRG/20120518_FDF_CRG_c12.mtb	2906	28	WWSS	food_sc	3	245448	1337577963	1	0.04	0.000296296296296296	4471	1
1	Food 1	Intake 3	55	245666	1337578181	/users/cn/jespinosa/phecomp/data/CRG/20120502_FDF_CRG/20120502_FDF_CRG/20120518_FDF_CRG_c12.mtb	2907	50	WWSS	food_sc	3	245611	1337578126	1	0.02	0.000363636363636364	4472	1
1	Drink 2	Intake 2	11	245685	1337578200	/users/cn/jespinosa/phecomp/data/CRG/20120502_FDF_CRG/20120502_FDF_CRG/20120518_FDF_CRG_c12.mtb	1394	NA	WWSS	water	2	245674	1337578189	1	0.04	0.00363636363636364	4473	1
1	Food 1	Intake 3	113	245829	1337578344	/users/cn/jespinosa/phecomp/data/CRG/20120502_FDF_CRG/20120502_FDF_CRG/20120518_FDF_CRG_c12.mtb	2908	66	WWSS	food_sc	3	245716	1337578231	1	0.04	0.000353982300884956	4474	1
1	Drink 2	Intake 2	22	245882	1337578397	/users/cn/jespinosa/phecomp/data/CRG/20120502_FDF_CRG/20120502_FDF_CRG/20120518_FDF_CRG_c12.mtb	1395	NA	WWSS	water	2	245860	1337578375	1	0.0200000000000005	0.000909090909090932	4475	1
1	Food 1	Intake 3	57	245952	1337578467	/users/cn/jespinosa/phecomp/data/CRG/20120502_FDF_CRG/20120502_FDF_CRG/20120518_FDF_CRG_c12.mtb	2909	583	WWSS	food_sc	3	245895	1337578410	1	0.38	0.00666666666666667	4476	1
1	Drink 2	Intake 2	12	245958	1337578473	/users/cn/jespinosa/phecomp/data/CRG/20120502_FDF_CRG/20120502_FDF_CRG/20120518_FDF_CRG_c12.mtb	1396	NA	WWSS	water	2	245946	1337578461	1	0.04	0.00333333333333333	4477	1
1	Drink 1	Intake 1	19	246314	1337578829	/users/cn/jespinosa/phecomp/data/CRG/20120502_FDF_CRG/20120502_FDF_CRG/20120518_FDF_CRG_c12.mtb	2506	NA	WWSS	water	1	246295	1337578810	1	0.02	0.00105263157894737	4478	1
1	Food 1	Intake 3	35	246570	1337579085	/users/cn/jespinosa/phecomp/data/CRG/20120502_FDF_CRG/20120502_FDF_CRG/20120518_FDF_CRG_c12.mtb	2915	1311	WWSS	food_sc	3	246535	1337579050	1	0.0200000000000005	0.000571428571428586	4479	1
1	Drink 2	Intake 2	15	246974	1337579489	/users/cn/jespinosa/phecomp/data/CRG/20120502_FDF_CRG/20120502_FDF_CRG/20120518_FDF_CRG_c12.mtb	1398	NA	WWSS	water	2	246959	1337579474	1	0.04	0.00266666666666667	4480	1
1	Drink 2	Intake 2	18	247240	1337579755	/users/cn/jespinosa/phecomp/data/CRG/20120502_FDF_CRG/20120502_FDF_CRG/20120518_FDF_CRG_c12.mtb	1399	NA	WWSS	water	2	247222	1337579737	1	0.04	0.00222222222222222	4481	1
1	Food 2	Intake 4	125	248006	1337580521	/users/cn/jespinosa/phecomp/data/CRG/20120502_FDF_CRG/20120502_FDF_CRG/20120518_FDF_CRG_c12.mtb	3813	469	WWSS	food_sc	4	247881	1337580396	1	0.0200000000000005	0.000160000000000004	4482	1
1	Drink 1	Intake 1	36	248422	1337580937	/users/cn/jespinosa/phecomp/data/CRG/20120502_FDF_CRG/20120502_FDF_CRG/20120518_FDF_CRG_c12.mtb	2507	NA	WWSS	water	1	248386	1337580901	1	0.12	0.00333333333333333	4483	1
1	Food 1	Intake 3	236	248711	1337581226	/users/cn/jespinosa/phecomp/data/CRG/20120502_FDF_CRG/20120502_FDF_CRG/20120518_FDF_CRG_c12.mtb	2927	3564	WWSS	food_sc	3	248475	1337580990	1	0.04	0.000169491525423729	4484	1
1	Drink 1	Intake 1	83	249883	1337582398	/users/cn/jespinosa/phecomp/data/CRG/20120502_FDF_CRG/20120502_FDF_CRG/20120518_FDF_CRG_c12.mtb	2508	NA	WWSS	water	1	249800	1337582315	1	0.02	0.000240963855421687	4485	1
1	Food 2	Intake 4	76	252351	1337584866	/users/cn/jespinosa/phecomp/data/CRG/20120502_FDF_CRG/20120502_FDF_CRG/20120518_FDF_CRG_c12.mtb	3819	20976	WWSS	food_sc	4	252275	1337584790	1	0.04	0.000526315789473684	4486	1
1	Drink 1	Intake 1	91	261723	1337594238	/users/cn/jespinosa/phecomp/data/CRG/20120502_FDF_CRG/20120502_FDF_CRG/20120518_FDF_CRG_c12.mtb	2514	NA	WWSS	water	1	261632	1337594147	1	0.02	0.00021978021978022	4487	1
1	Drink 2	Intake 2	59	261851	1337594366	/users/cn/jespinosa/phecomp/data/CRG/20120502_FDF_CRG/20120502_FDF_CRG/20120518_FDF_CRG_c12.mtb	1403	NA	WWSS	water	2	261792	1337594307	1	0.04	0.000677966101694915	4488	1
1	Food 1	Intake 3	108	4006	1337605950	/users/cn/jespinosa/phecomp/data/CRG/20120502_FDF_CRG/20120502_FDF_CRG/20120521_FDF_CRG_c12.mtb	3206	80	WWSS	food_sc	3	3898	1337605842	1	0.08	0.000740740740740741	4489	1
1	Food 1	Intake 3	47	4133	1337606077	/users/cn/jespinosa/phecomp/data/CRG/20120502_FDF_CRG/20120502_FDF_CRG/20120521_FDF_CRG_c12.mtb	3207	7719	WWSS	food_sc	3	4086	1337606030	1	0.04	0.000851063829787234	4490	1
1	Food 2	Intake 4	37	11889	1337613833	/users/cn/jespinosa/phecomp/data/CRG/20120502_FDF_CRG/20120502_FDF_CRG/20120521_FDF_CRG_c12.mtb	4187	5	WWSS	food_sc	4	11852	1337613796	1	0.02	0.000540540540540541	4491	1
1	Food 2	Intake 4	155	12049	1337613993	/users/cn/jespinosa/phecomp/data/CRG/20120502_FDF_CRG/20120502_FDF_CRG/20120521_FDF_CRG_c12.mtb	4188	COLL	WWSS	food_sc	4	11894	1337613838	1	0.08	0.000516129032258065	4492	1
1	Food 1	Intake 3	174	12214	1337614158	/users/cn/jespinosa/phecomp/data/CRG/20120502_FDF_CRG/20120502_FDF_CRG/20120521_FDF_CRG_c12.mtb	3209	3748	WWSS	food_sc	3	12040	1337613984	1	0.14	0.000804597701149425	4493	1
1	Food 2	Intake 4	122	16084	1337618028	/users/cn/jespinosa/phecomp/data/CRG/20120502_FDF_CRG/20120502_FDF_CRG/20120521_FDF_CRG_c12.mtb	4190	49	WWSS	food_sc	4	15962	1337617906	1	0.1	0.000819672131147541	4494	1
1	Food 2	Intake 4	89	16222	1337618166	/users/cn/jespinosa/phecomp/data/CRG/20120502_FDF_CRG/20120502_FDF_CRG/20120521_FDF_CRG_c12.mtb	4191	15	WWSS	food_sc	4	16133	1337618077	1	0.06	0.000674157303370786	4495	1
1	Food 2	Intake 4	85	16322	1337618266	/users/cn/jespinosa/phecomp/data/CRG/20120502_FDF_CRG/20120502_FDF_CRG/20120521_FDF_CRG_c12.mtb	4192	4158	WWSS	food_sc	4	16237	1337618181	1	0.08	0.000941176470588235	4496	1
1	Drink 2	Intake 2	20	17569	1337619513	/users/cn/jespinosa/phecomp/data/CRG/20120502_FDF_CRG/20120502_FDF_CRG/20120521_FDF_CRG_c12.mtb	1476	NA	WWSS	water	2	17549	1337619493	1	0.08	0.004	4497	1
1	Food 2	Intake 4	332	20812	1337622756	/users/cn/jespinosa/phecomp/data/CRG/20120502_FDF_CRG/20120502_FDF_CRG/20120521_FDF_CRG_c12.mtb	4194	2446	WWSS	food_sc	4	20480	1337622424	1	0.12	0.00036144578313253	4498	1
1	Food 1	Intake 3	192	23450	1337625394	/users/cn/jespinosa/phecomp/data/CRG/20120502_FDF_CRG/20120502_FDF_CRG/20120521_FDF_CRG_c12.mtb	3213	77	WWSS	food_sc	3	23258	1337625202	1	0.08	0.000416666666666667	4499	1
1	Drink 2	Intake 2	20	23475	1337625419	/users/cn/jespinosa/phecomp/data/CRG/20120502_FDF_CRG/20120502_FDF_CRG/20120521_FDF_CRG_c12.mtb	1477	NA	WWSS	water	2	23455	1337625399	1	0.06	0.003	4500	1
1	Food 1	Intake 3	68	23595	1337625539	/users/cn/jespinosa/phecomp/data/CRG/20120502_FDF_CRG/20120502_FDF_CRG/20120521_FDF_CRG_c12.mtb	3214	1403	WWSS	food_sc	3	23527	1337625471	1	0.02	0.000294117647058824	4501	1
1	Drink 2	Intake 2	21	23606	1337625550	/users/cn/jespinosa/phecomp/data/CRG/20120502_FDF_CRG/20120502_FDF_CRG/20120521_FDF_CRG_c12.mtb	1478	NA	WWSS	water	2	23585	1337625529	1	0.02	0.000952380952380952	4502	1
1	Drink 2	Intake 2	13	23665	1337625609	/users/cn/jespinosa/phecomp/data/CRG/20120502_FDF_CRG/20120502_FDF_CRG/20120521_FDF_CRG_c12.mtb	1479	NA	WWSS	water	2	23652	1337625596	1	0.04	0.00307692307692308	4503	1
1	Food 1	Intake 3	229	25227	1337627171	/users/cn/jespinosa/phecomp/data/CRG/20120502_FDF_CRG/20120502_FDF_CRG/20120521_FDF_CRG_c12.mtb	3215	7	WWSS	food_sc	3	24998	1337626942	1	0.1	0.000436681222707424	4504	1
1	Food 1	Intake 3	108	25342	1337627286	/users/cn/jespinosa/phecomp/data/CRG/20120502_FDF_CRG/20120502_FDF_CRG/20120521_FDF_CRG_c12.mtb	3216	2098	WWSS	food_sc	3	25234	1337627178	1	0.04	0.00037037037037037	4505	1
1	Drink 1	Intake 1	26	25403	1337627347	/users/cn/jespinosa/phecomp/data/CRG/20120502_FDF_CRG/20120502_FDF_CRG/20120521_FDF_CRG_c12.mtb	2782	NA	WWSS	water	1	25377	1337627321	1	0.04	0.00153846153846154	4506	1
1	Food 1	Intake 3	124	27564	1337629508	/users/cn/jespinosa/phecomp/data/CRG/20120502_FDF_CRG/20120502_FDF_CRG/20120521_FDF_CRG_c12.mtb	3217	112	WWSS	food_sc	3	27440	1337629384	1	0.34	0.00274193548387097	4507	1
1	Food 1	Intake 3	207	27883	1337629827	/users/cn/jespinosa/phecomp/data/CRG/20120502_FDF_CRG/20120502_FDF_CRG/20120521_FDF_CRG_c12.mtb	3218	2089	WWSS	food_sc	3	27676	1337629620	1	0.0800000000000001	0.000386473429951691	4508	1
1	Drink 2	Intake 2	31	27916	1337629860	/users/cn/jespinosa/phecomp/data/CRG/20120502_FDF_CRG/20120502_FDF_CRG/20120521_FDF_CRG_c12.mtb	1480	NA	WWSS	water	2	27885	1337629829	1	0.1	0.0032258064516129	4509	1
1	Drink 1	Intake 1	15	28626	1337630570	/users/cn/jespinosa/phecomp/data/CRG/20120502_FDF_CRG/20120502_FDF_CRG/20120521_FDF_CRG_c12.mtb	2783	NA	WWSS	water	1	28611	1337630555	1	0.04	0.00266666666666667	4510	1
1	Food 2	Intake 4	26	29998	1337631942	/users/cn/jespinosa/phecomp/data/CRG/20120502_FDF_CRG/20120502_FDF_CRG/20120521_FDF_CRG_c12.mtb	4197	89	WWSS	food_sc	4	29972	1337631916	1	0.02	0.000769230769230769	4511	1
1	Food 1	Intake 3	95	30182	1337632126	/users/cn/jespinosa/phecomp/data/CRG/20120502_FDF_CRG/20120502_FDF_CRG/20120521_FDF_CRG_c12.mtb	3221	24	WWSS	food_sc	3	30087	1337632031	1	0.04	0.000421052631578947	4512	1
1	Food 1	Intake 3	122	30328	1337632272	/users/cn/jespinosa/phecomp/data/CRG/20120502_FDF_CRG/20120502_FDF_CRG/20120521_FDF_CRG_c12.mtb	3222	7	WWSS	food_sc	3	30206	1337632150	1	0.0600000000000001	0.000491803278688525	4513	1
1	Food 1	Intake 3	71	30406	1337632350	/users/cn/jespinosa/phecomp/data/CRG/20120502_FDF_CRG/20120502_FDF_CRG/20120521_FDF_CRG_c12.mtb	3223	129	WWSS	food_sc	3	30335	1337632279	1	0.02	0.00028169014084507	4514	1
1	Drink 1	Intake 1	16	30415	1337632359	/users/cn/jespinosa/phecomp/data/CRG/20120502_FDF_CRG/20120502_FDF_CRG/20120521_FDF_CRG_c12.mtb	2784	NA	WWSS	water	1	30399	1337632343	1	0.04	0.0025	4515	1
1	Drink 1	Intake 1	19	30496	1337632440	/users/cn/jespinosa/phecomp/data/CRG/20120502_FDF_CRG/20120502_FDF_CRG/20120521_FDF_CRG_c12.mtb	2785	NA	WWSS	water	1	30477	1337632421	1	0.02	0.00105263157894737	4516	1
1	Food 1	Intake 3	61	30596	1337632540	/users/cn/jespinosa/phecomp/data/CRG/20120502_FDF_CRG/20120502_FDF_CRG/20120521_FDF_CRG_c12.mtb	3224	133	WWSS	food_sc	3	30535	1337632479	1	0.0600000000000001	0.000983606557377051	4517	1
1	Drink 1	Intake 1	12	30702	1337632646	/users/cn/jespinosa/phecomp/data/CRG/20120502_FDF_CRG/20120502_FDF_CRG/20120521_FDF_CRG_c12.mtb	2786	NA	WWSS	water	1	30690	1337632634	1	0.02	0.00166666666666667	4518	1
1	Food 1	Intake 3	41	30770	1337632714	/users/cn/jespinosa/phecomp/data/CRG/20120502_FDF_CRG/20120502_FDF_CRG/20120521_FDF_CRG_c12.mtb	3225	3	WWSS	food_sc	3	30729	1337632673	1	0.02	0.00048780487804878	4519	1
1	Food 2	Intake 4	96	30869	1337632813	/users/cn/jespinosa/phecomp/data/CRG/20120502_FDF_CRG/20120502_FDF_CRG/20120521_FDF_CRG_c12.mtb	4199	223	WWSS	food_sc	4	30773	1337632717	1	0.02	0.000208333333333333	4520	1
1	Drink 1	Intake 1	15	30948	1337632892	/users/cn/jespinosa/phecomp/data/CRG/20120502_FDF_CRG/20120502_FDF_CRG/20120521_FDF_CRG_c12.mtb	2787	NA	WWSS	water	1	30933	1337632877	1	0.02	0.00133333333333333	4521	1
1	Food 2	Intake 4	53	31145	1337633089	/users/cn/jespinosa/phecomp/data/CRG/20120502_FDF_CRG/20120502_FDF_CRG/20120521_FDF_CRG_c12.mtb	4202	48	WWSS	food_sc	4	31092	1337633036	1	0.02	0.000377358490566038	4522	1
1	Drink 2	Intake 2	17	31174	1337633118	/users/cn/jespinosa/phecomp/data/CRG/20120502_FDF_CRG/20120502_FDF_CRG/20120521_FDF_CRG_c12.mtb	1482	NA	WWSS	water	2	31157	1337633101	1	0.02	0.00117647058823529	4523	1
1	Food 1	Intake 3	57	31250	1337633194	/users/cn/jespinosa/phecomp/data/CRG/20120502_FDF_CRG/20120502_FDF_CRG/20120521_FDF_CRG_c12.mtb	3230	536	WWSS	food_sc	3	31193	1337633137	1	0.0600000000000001	0.00105263157894737	4524	1
1	Drink 1	Intake 1	19	31694	1337633638	/users/cn/jespinosa/phecomp/data/CRG/20120502_FDF_CRG/20120502_FDF_CRG/20120521_FDF_CRG_c12.mtb	2788	NA	WWSS	water	1	31675	1337633619	1	0.06	0.00315789473684211	4525	1
1	Food 1	Intake 3	40	31826	1337633770	/users/cn/jespinosa/phecomp/data/CRG/20120502_FDF_CRG/20120502_FDF_CRG/20120521_FDF_CRG_c12.mtb	3236	12	WWSS	food_sc	3	31786	1337633730	1	0.02	0.0005	4526	1
1	Food 2	Intake 4	96	31934	1337633878	/users/cn/jespinosa/phecomp/data/CRG/20120502_FDF_CRG/20120502_FDF_CRG/20120521_FDF_CRG_c12.mtb	4208	99	WWSS	food_sc	4	31838	1337633782	1	0.02	0.000208333333333333	4527	1
1	Drink 2	Intake 2	17	31975	1337633919	/users/cn/jespinosa/phecomp/data/CRG/20120502_FDF_CRG/20120502_FDF_CRG/20120521_FDF_CRG_c12.mtb	1483	NA	WWSS	water	2	31958	1337633902	1	0.02	0.00117647058823529	4528	1
1	Food 1	Intake 3	16	32049	1337633993	/users/cn/jespinosa/phecomp/data/CRG/20120502_FDF_CRG/20120502_FDF_CRG/20120521_FDF_CRG_c12.mtb	3238	2925	WWSS	food_sc	3	32033	1337633977	1	0.02	0.00125	4529	1
1	Drink 1	Intake 1	19	32352	1337634296	/users/cn/jespinosa/phecomp/data/CRG/20120502_FDF_CRG/20120502_FDF_CRG/20120521_FDF_CRG_c12.mtb	2790	NA	WWSS	water	1	32333	1337634277	1	0.02	0.00105263157894737	4530	1
1	Food 2	Intake 4	25	34999	1337636943	/users/cn/jespinosa/phecomp/data/CRG/20120502_FDF_CRG/20120502_FDF_CRG/20120521_FDF_CRG_c12.mtb	4212	168	WWSS	food_sc	4	34974	1337636918	1	0.02	0.0008	4531	1
1	Food 1	Intake 3	89	35256	1337637200	/users/cn/jespinosa/phecomp/data/CRG/20120502_FDF_CRG/20120502_FDF_CRG/20120521_FDF_CRG_c12.mtb	3241	72	WWSS	food_sc	3	35167	1337637111	1	0.02	0.000224719101123596	4532	1
1	Food 2	Intake 4	228	35556	1337637500	/users/cn/jespinosa/phecomp/data/CRG/20120502_FDF_CRG/20120502_FDF_CRG/20120521_FDF_CRG_c12.mtb	4215	6	WWSS	food_sc	4	35328	1337637272	1	0.04	0.000175438596491228	4533	1
1	Drink 1	Intake 1	14	35562	1337637506	/users/cn/jespinosa/phecomp/data/CRG/20120502_FDF_CRG/20120502_FDF_CRG/20120521_FDF_CRG_c12.mtb	2791	NA	WWSS	water	1	35548	1337637492	1	0.02	0.00142857142857143	4534	1
1	Food 2	Intake 4	69	35631	1337637575	/users/cn/jespinosa/phecomp/data/CRG/20120502_FDF_CRG/20120502_FDF_CRG/20120521_FDF_CRG_c12.mtb	4216	125	WWSS	food_sc	4	35562	1337637506	1	0.04	0.000579710144927536	4535	1
1	Drink 1	Intake 1	35	35653	1337637597	/users/cn/jespinosa/phecomp/data/CRG/20120502_FDF_CRG/20120502_FDF_CRG/20120521_FDF_CRG_c12.mtb	2792	NA	WWSS	water	1	35618	1337637562	1	0.04	0.00114285714285714	4536	1
1	Drink 2	Intake 2	43	35737	1337637681	/users/cn/jespinosa/phecomp/data/CRG/20120502_FDF_CRG/20120502_FDF_CRG/20120521_FDF_CRG_c12.mtb	1484	NA	WWSS	water	2	35694	1337637638	1	0.04	0.000930232558139535	4537	1
1	Food 1	Intake 3	31	35787	1337637731	/users/cn/jespinosa/phecomp/data/CRG/20120502_FDF_CRG/20120502_FDF_CRG/20120521_FDF_CRG_c12.mtb	3245	COLL	WWSS	food_sc	3	35756	1337637700	1	0.02	0.000645161290322581	4538	1
1	Food 2	Intake 4	102	35876	1337637820	/users/cn/jespinosa/phecomp/data/CRG/20120502_FDF_CRG/20120502_FDF_CRG/20120521_FDF_CRG_c12.mtb	4217	794	WWSS	food_sc	4	35774	1337637718	1	0.02	0.000196078431372549	4539	1
1	Drink 1	Intake 1	17	35885	1337637829	/users/cn/jespinosa/phecomp/data/CRG/20120502_FDF_CRG/20120502_FDF_CRG/20120521_FDF_CRG_c12.mtb	2793	NA	WWSS	water	1	35868	1337637812	1	0.02	0.00117647058823529	4540	1
1	Drink 1	Intake 1	23	36028	1337637972	/users/cn/jespinosa/phecomp/data/CRG/20120502_FDF_CRG/20120502_FDF_CRG/20120521_FDF_CRG_c12.mtb	2794	NA	WWSS	water	1	36005	1337637949	1	0.04	0.00173913043478261	4541	1
1	Drink 1	Intake 1	11	36142	1337638086	/users/cn/jespinosa/phecomp/data/CRG/20120502_FDF_CRG/20120502_FDF_CRG/20120521_FDF_CRG_c12.mtb	2795	NA	WWSS	water	1	36131	1337638075	1	0.02	0.00181818181818182	4542	1
1	Drink 2	Intake 2	18	36451	1337638395	/users/cn/jespinosa/phecomp/data/CRG/20120502_FDF_CRG/20120502_FDF_CRG/20120521_FDF_CRG_c12.mtb	1486	NA	WWSS	water	2	36433	1337638377	1	0.04	0.00222222222222222	4543	1
1	Food 1	Intake 3	18	36688	1337638632	/users/cn/jespinosa/phecomp/data/CRG/20120502_FDF_CRG/20120502_FDF_CRG/20120521_FDF_CRG_c12.mtb	3252	27	WWSS	food_sc	3	36670	1337638614	1	0.02	0.00111111111111111	4544	1
1	Food 1	Intake 3	116	36831	1337638775	/users/cn/jespinosa/phecomp/data/CRG/20120502_FDF_CRG/20120502_FDF_CRG/20120521_FDF_CRG_c12.mtb	3253	23	WWSS	food_sc	3	36715	1337638659	1	0.0599999999999998	0.000517241379310343	4545	1
1	Drink 2	Intake 2	24	36847	1337638791	/users/cn/jespinosa/phecomp/data/CRG/20120502_FDF_CRG/20120502_FDF_CRG/20120521_FDF_CRG_c12.mtb	1488	NA	WWSS	water	2	36823	1337638767	1	0.06	0.0025	4546	1
1	Food 1	Intake 3	140	36994	1337638938	/users/cn/jespinosa/phecomp/data/CRG/20120502_FDF_CRG/20120502_FDF_CRG/20120521_FDF_CRG_c12.mtb	3254	257	WWSS	food_sc	3	36854	1337638798	1	0.02	0.000142857142857143	4547	1
1	Food 1	Intake 3	60	37311	1337639255	/users/cn/jespinosa/phecomp/data/CRG/20120502_FDF_CRG/20120502_FDF_CRG/20120521_FDF_CRG_c12.mtb	3256	248	WWSS	food_sc	3	37251	1337639195	1	0.02	0.000333333333333333	4548	1
1	Food 2	Intake 4	55	37614	1337639558	/users/cn/jespinosa/phecomp/data/CRG/20120502_FDF_CRG/20120502_FDF_CRG/20120521_FDF_CRG_c12.mtb	4227	542	WWSS	food_sc	4	37559	1337639503	1	0.02	0.000363636363636364	4549	1
1	Drink 1	Intake 1	17	37620	1337639564	/users/cn/jespinosa/phecomp/data/CRG/20120502_FDF_CRG/20120502_FDF_CRG/20120521_FDF_CRG_c12.mtb	2798	NA	WWSS	water	1	37603	1337639547	1	0.04	0.00235294117647059	4550	1
1	Drink 1	Intake 1	26	37845	1337639789	/users/cn/jespinosa/phecomp/data/CRG/20120502_FDF_CRG/20120502_FDF_CRG/20120521_FDF_CRG_c12.mtb	2799	NA	WWSS	water	1	37819	1337639763	1	0.02	0.000769230769230769	4551	1
1	Food 2	Intake 4	62	38218	1337640162	/users/cn/jespinosa/phecomp/data/CRG/20120502_FDF_CRG/20120502_FDF_CRG/20120521_FDF_CRG_c12.mtb	4231	70	WWSS	food_sc	4	38156	1337640100	1	0.02	0.00032258064516129	4552	1
1	Food 1	Intake 3	102	38390	1337640334	/users/cn/jespinosa/phecomp/data/CRG/20120502_FDF_CRG/20120502_FDF_CRG/20120521_FDF_CRG_c12.mtb	3259	201	WWSS	food_sc	3	38288	1337640232	1	0.02	0.000196078431372549	4553	1
1	Drink 1	Intake 1	16	38397	1337640341	/users/cn/jespinosa/phecomp/data/CRG/20120502_FDF_CRG/20120502_FDF_CRG/20120521_FDF_CRG_c12.mtb	2800	NA	WWSS	water	1	38381	1337640325	1	0.02	0.00125	4554	1
1	Food 2	Intake 4	84	38675	1337640619	/users/cn/jespinosa/phecomp/data/CRG/20120502_FDF_CRG/20120502_FDF_CRG/20120521_FDF_CRG_c12.mtb	4234	196	WWSS	food_sc	4	38591	1337640535	1	0.0600000000000001	0.000714285714285715	4555	1
1	Drink 2	Intake 2	19	38696	1337640640	/users/cn/jespinosa/phecomp/data/CRG/20120502_FDF_CRG/20120502_FDF_CRG/20120521_FDF_CRG_c12.mtb	1490	NA	WWSS	water	2	38677	1337640621	1	0.04	0.00210526315789474	4556	1
1	Food 2	Intake 4	96	38967	1337640911	/users/cn/jespinosa/phecomp/data/CRG/20120502_FDF_CRG/20120502_FDF_CRG/20120521_FDF_CRG_c12.mtb	4237	85	WWSS	food_sc	4	38871	1337640815	1	0.02	0.000208333333333333	4557	1
1	Drink 1	Intake 1	30	39010	1337640954	/users/cn/jespinosa/phecomp/data/CRG/20120502_FDF_CRG/20120502_FDF_CRG/20120521_FDF_CRG_c12.mtb	2801	NA	WWSS	water	1	38980	1337640924	1	0.0600000000000001	0.002	4558	1
1	Food 2	Intake 4	224	39276	1337641220	/users/cn/jespinosa/phecomp/data/CRG/20120502_FDF_CRG/20120502_FDF_CRG/20120521_FDF_CRG_c12.mtb	4238	40	WWSS	food_sc	4	39052	1337640996	1	0.02	8.92857142857143e-05	4559	1
1	Food 2	Intake 4	44	39360	1337641304	/users/cn/jespinosa/phecomp/data/CRG/20120502_FDF_CRG/20120502_FDF_CRG/20120521_FDF_CRG_c12.mtb	4239	26	WWSS	food_sc	4	39316	1337641260	1	0.02	0.000454545454545455	4560	1
1	Food 2	Intake 4	104	39490	1337641434	/users/cn/jespinosa/phecomp/data/CRG/20120502_FDF_CRG/20120502_FDF_CRG/20120521_FDF_CRG_c12.mtb	4240	72	WWSS	food_sc	4	39386	1337641330	1	0.02	0.000192307692307692	4561	1
1	Drink 2	Intake 2	24	39505	1337641449	/users/cn/jespinosa/phecomp/data/CRG/20120502_FDF_CRG/20120502_FDF_CRG/20120521_FDF_CRG_c12.mtb	1491	NA	WWSS	water	2	39481	1337641425	1	0.02	0.000833333333333333	4562	1
1	Food 2	Intake 4	25	39587	1337641531	/users/cn/jespinosa/phecomp/data/CRG/20120502_FDF_CRG/20120502_FDF_CRG/20120521_FDF_CRG_c12.mtb	4241	152	WWSS	food_sc	4	39562	1337641506	1	0.02	0.0008	4563	1
1	Drink 2	Intake 2	16	39740	1337641684	/users/cn/jespinosa/phecomp/data/CRG/20120502_FDF_CRG/20120502_FDF_CRG/20120521_FDF_CRG_c12.mtb	1492	NA	WWSS	water	2	39724	1337641668	1	0.0399999999999999	0.00249999999999999	4564	1
1	Food 2	Intake 4	115	39854	1337641798	/users/cn/jespinosa/phecomp/data/CRG/20120502_FDF_CRG/20120502_FDF_CRG/20120521_FDF_CRG_c12.mtb	4243	204	WWSS	food_sc	4	39739	1337641683	1	0.0399999999999999	0.000347826086956521	4565	1
1	Drink 2	Intake 2	18	39877	1337641821	/users/cn/jespinosa/phecomp/data/CRG/20120502_FDF_CRG/20120502_FDF_CRG/20120521_FDF_CRG_c12.mtb	1493	NA	WWSS	water	2	39859	1337641803	1	0.02	0.00111111111111111	4566	1
1	Drink 1	Intake 1	22	40009	1337641953	/users/cn/jespinosa/phecomp/data/CRG/20120502_FDF_CRG/20120502_FDF_CRG/20120521_FDF_CRG_c12.mtb	2803	NA	WWSS	water	1	39987	1337641931	1	0.0399999999999999	0.00181818181818181	4567	1
1	Food 2	Intake 4	155	40213	1337642157	/users/cn/jespinosa/phecomp/data/CRG/20120502_FDF_CRG/20120502_FDF_CRG/20120521_FDF_CRG_c12.mtb	4247	20	WWSS	food_sc	4	40058	1337642002	1	0.02	0.000129032258064516	4568	1
1	Food 2	Intake 4	150	40383	1337642327	/users/cn/jespinosa/phecomp/data/CRG/20120502_FDF_CRG/20120502_FDF_CRG/20120521_FDF_CRG_c12.mtb	4248	540	WWSS	food_sc	4	40233	1337642177	1	0.04	0.000266666666666667	4569	1
1	Drink 2	Intake 2	27	40713	1337642657	/users/cn/jespinosa/phecomp/data/CRG/20120502_FDF_CRG/20120502_FDF_CRG/20120521_FDF_CRG_c12.mtb	1494	NA	WWSS	water	2	40686	1337642630	1	0.04	0.00148148148148148	4570	1
1	Food 1	Intake 3	104	41027	1337642971	/users/cn/jespinosa/phecomp/data/CRG/20120502_FDF_CRG/20120502_FDF_CRG/20120521_FDF_CRG_c12.mtb	3272	1796	WWSS	food_sc	3	40923	1337642867	1	0.02	0.000192307692307692	4571	1
1	Drink 2	Intake 2	25	41077	1337643021	/users/cn/jespinosa/phecomp/data/CRG/20120502_FDF_CRG/20120502_FDF_CRG/20120521_FDF_CRG_c12.mtb	1495	NA	WWSS	water	2	41052	1337642996	1	0.0599999999999999	0.0024	4572	1
1	Drink 2	Intake 2	17	42139	1337644083	/users/cn/jespinosa/phecomp/data/CRG/20120502_FDF_CRG/20120502_FDF_CRG/20120521_FDF_CRG_c12.mtb	1496	NA	WWSS	water	2	42122	1337644066	1	0.04	0.00235294117647059	4573	1
1	Food 1	Intake 3	49	42872	1337644816	/users/cn/jespinosa/phecomp/data/CRG/20120502_FDF_CRG/20120502_FDF_CRG/20120521_FDF_CRG_c12.mtb	3277	168	WWSS	food_sc	3	42823	1337644767	1	0.02	0.000408163265306122	4574	1
1	Food 2	Intake 4	67	43107	1337645051	/users/cn/jespinosa/phecomp/data/CRG/20120502_FDF_CRG/20120502_FDF_CRG/20120521_FDF_CRG_c12.mtb	4256	4966	WWSS	food_sc	4	43040	1337644984	1	0.02	0.000298507462686567	4575	1
1	Food 1	Intake 3	42	48115	1337650059	/users/cn/jespinosa/phecomp/data/CRG/20120502_FDF_CRG/20120502_FDF_CRG/20120521_FDF_CRG_c12.mtb	3280	80	WWSS	food_sc	3	48073	1337650017	1	0.04	0.000952380952380952	4576	1
1	Food 1	Intake 3	34	48229	1337650173	/users/cn/jespinosa/phecomp/data/CRG/20120502_FDF_CRG/20120502_FDF_CRG/20120521_FDF_CRG_c12.mtb	3281	11	WWSS	food_sc	3	48195	1337650139	1	0.02	0.000588235294117647	4577	1
1	Food 1	Intake 3	52	48292	1337650236	/users/cn/jespinosa/phecomp/data/CRG/20120502_FDF_CRG/20120502_FDF_CRG/20120521_FDF_CRG_c12.mtb	3282	7	WWSS	food_sc	3	48240	1337650184	1	0.0600000000000001	0.00115384615384616	4578	1
1	Food 1	Intake 3	39	48338	1337650282	/users/cn/jespinosa/phecomp/data/CRG/20120502_FDF_CRG/20120502_FDF_CRG/20120521_FDF_CRG_c12.mtb	3283	15	WWSS	food_sc	3	48299	1337650243	1	0.04	0.00102564102564103	4579	1
1	Food 1	Intake 3	58	48411	1337650355	/users/cn/jespinosa/phecomp/data/CRG/20120502_FDF_CRG/20120502_FDF_CRG/20120521_FDF_CRG_c12.mtb	3284	379	WWSS	food_sc	3	48353	1337650297	1	0.04	0.000689655172413793	4580	1
1	Drink 1	Intake 1	17	48763	1337650707	/users/cn/jespinosa/phecomp/data/CRG/20120502_FDF_CRG/20120502_FDF_CRG/20120521_FDF_CRG_c12.mtb	2804	NA	WWSS	water	1	48746	1337650690	1	0.04	0.00235294117647059	4581	1
1	Food 1	Intake 3	141	48931	1337650875	/users/cn/jespinosa/phecomp/data/CRG/20120502_FDF_CRG/20120502_FDF_CRG/20120521_FDF_CRG_c12.mtb	3286	5077	WWSS	food_sc	3	48790	1337650734	1	0.0399999999999998	0.00028368794326241	4582	1
1	Drink 2	Intake 2	16	48948	1337650892	/users/cn/jespinosa/phecomp/data/CRG/20120502_FDF_CRG/20120502_FDF_CRG/20120521_FDF_CRG_c12.mtb	1498	NA	WWSS	water	2	48932	1337650876	1	0.02	0.00125	4583	1
1	Drink 2	Intake 2	17	50308	1337652252	/users/cn/jespinosa/phecomp/data/CRG/20120502_FDF_CRG/20120502_FDF_CRG/20120521_FDF_CRG_c12.mtb	1499	NA	WWSS	water	2	50291	1337652235	1	0.02	0.00117647058823529	4584	1
1	Food 2	Intake 4	15	54023	1337655967	/users/cn/jespinosa/phecomp/data/CRG/20120502_FDF_CRG/20120502_FDF_CRG/20120521_FDF_CRG_c12.mtb	4262	69	WWSS	food_sc	4	54008	1337655952	1	0.02	0.00133333333333333	4585	1
1	Food 2	Intake 4	65	54157	1337656101	/users/cn/jespinosa/phecomp/data/CRG/20120502_FDF_CRG/20120502_FDF_CRG/20120521_FDF_CRG_c12.mtb	4263	4930	WWSS	food_sc	4	54092	1337656036	1	0.04	0.000615384615384615	4586	1
1	Drink 1	Intake 1	31	54646	1337656590	/users/cn/jespinosa/phecomp/data/CRG/20120502_FDF_CRG/20120502_FDF_CRG/20120521_FDF_CRG_c12.mtb	2805	NA	WWSS	water	1	54615	1337656559	1	0.04	0.00129032258064516	4587	1
1	Food 2	Intake 4	20	59107	1337661051	/users/cn/jespinosa/phecomp/data/CRG/20120502_FDF_CRG/20120502_FDF_CRG/20120521_FDF_CRG_c12.mtb	4265	83	WWSS	food_sc	4	59087	1337661031	1	0.02	0.001	4588	1
1	Food 2	Intake 4	32	59222	1337661166	/users/cn/jespinosa/phecomp/data/CRG/20120502_FDF_CRG/20120502_FDF_CRG/20120521_FDF_CRG_c12.mtb	4266	1625	WWSS	food_sc	4	59190	1337661134	1	0.0599999999999998	0.00187499999999999	4589	1
1	Food 1	Intake 3	89	60936	1337662880	/users/cn/jespinosa/phecomp/data/CRG/20120502_FDF_CRG/20120502_FDF_CRG/20120521_FDF_CRG_c12.mtb	3287	43	WWSS	food_sc	3	60847	1337662791	1	0.02	0.000224719101123596	4590	1
1	Drink 1	Intake 1	17	60947	1337662891	/users/cn/jespinosa/phecomp/data/CRG/20120502_FDF_CRG/20120502_FDF_CRG/20120521_FDF_CRG_c12.mtb	2806	NA	WWSS	water	1	60930	1337662874	1	0.0599999999999999	0.00352941176470588	4591	1
1	Food 1	Intake 3	233	61212	1337663156	/users/cn/jespinosa/phecomp/data/CRG/20120502_FDF_CRG/20120502_FDF_CRG/20120521_FDF_CRG_c12.mtb	3288	152	WWSS	food_sc	3	60979	1337662923	1	0.0999999999999999	0.000429184549356223	4592	1
1	Drink 2	Intake 2	20	61366	1337663310	/users/cn/jespinosa/phecomp/data/CRG/20120502_FDF_CRG/20120502_FDF_CRG/20120521_FDF_CRG_c12.mtb	1501	NA	WWSS	water	2	61346	1337663290	1	0.02	0.001	4593	1
1	Food 1	Intake 3	57	61421	1337663365	/users/cn/jespinosa/phecomp/data/CRG/20120502_FDF_CRG/20120502_FDF_CRG/20120521_FDF_CRG_c12.mtb	3289	185	WWSS	food_sc	3	61364	1337663308	1	0.02	0.000350877192982456	4594	1
1	Drink 1	Intake 1	21	61431	1337663375	/users/cn/jespinosa/phecomp/data/CRG/20120502_FDF_CRG/20120502_FDF_CRG/20120521_FDF_CRG_c12.mtb	2807	NA	WWSS	water	1	61410	1337663354	1	0.04	0.0019047619047619	4595	1
1	Food 1	Intake 3	27	61633	1337663577	/users/cn/jespinosa/phecomp/data/CRG/20120502_FDF_CRG/20120502_FDF_CRG/20120521_FDF_CRG_c12.mtb	3291	66	WWSS	food_sc	3	61606	1337663550	1	0.04	0.00148148148148148	4596	1
1	Drink 2	Intake 2	21	61685	1337663629	/users/cn/jespinosa/phecomp/data/CRG/20120502_FDF_CRG/20120502_FDF_CRG/20120521_FDF_CRG_c12.mtb	1502	NA	WWSS	water	2	61664	1337663608	1	0.0599999999999999	0.00285714285714285	4597	1
1	Food 1	Intake 3	16	61715	1337663659	/users/cn/jespinosa/phecomp/data/CRG/20120502_FDF_CRG/20120502_FDF_CRG/20120521_FDF_CRG_c12.mtb	3292	85	WWSS	food_sc	3	61699	1337663643	1	0.02	0.00125	4598	1
1	Drink 1	Intake 1	22	61792	1337663736	/users/cn/jespinosa/phecomp/data/CRG/20120502_FDF_CRG/20120502_FDF_CRG/20120521_FDF_CRG_c12.mtb	2808	NA	WWSS	water	1	61770	1337663714	1	0.04	0.00181818181818182	4599	1
1	Food 2	Intake 4	202	62002	1337663946	/users/cn/jespinosa/phecomp/data/CRG/20120502_FDF_CRG/20120502_FDF_CRG/20120521_FDF_CRG_c12.mtb	4270	38	WWSS	food_sc	4	61800	1337663744	1	0.02	9.9009900990099e-05	4600	1
1	Food 2	Intake 4	95	62135	1337664079	/users/cn/jespinosa/phecomp/data/CRG/20120502_FDF_CRG/20120502_FDF_CRG/20120521_FDF_CRG_c12.mtb	4271	COLL	WWSS	food_sc	4	62040	1337663984	1	0.02	0.000210526315789474	4601	1
1	Food 1	Intake 3	23	62069	1337664013	/users/cn/jespinosa/phecomp/data/CRG/20120502_FDF_CRG/20120502_FDF_CRG/20120521_FDF_CRG_c12.mtb	3295	145	WWSS	food_sc	3	62046	1337663990	1	0.02	0.000869565217391304	4602	1
1	Drink 1	Intake 1	16	62173	1337664117	/users/cn/jespinosa/phecomp/data/CRG/20120502_FDF_CRG/20120502_FDF_CRG/20120521_FDF_CRG_c12.mtb	2809	NA	WWSS	water	1	62157	1337664101	1	0.0599999999999999	0.00374999999999999	4603	1
1	Food 2	Intake 4	80	62294	1337664238	/users/cn/jespinosa/phecomp/data/CRG/20120502_FDF_CRG/20120502_FDF_CRG/20120521_FDF_CRG_c12.mtb	4274	83	WWSS	food_sc	4	62214	1337664158	1	0.02	0.00025	4604	1
1	Drink 1	Intake 1	38	62328	1337664272	/users/cn/jespinosa/phecomp/data/CRG/20120502_FDF_CRG/20120502_FDF_CRG/20120521_FDF_CRG_c12.mtb	2810	NA	WWSS	water	1	62290	1337664234	1	0.12	0.00315789473684211	4605	1
1	Food 2	Intake 4	68	62445	1337664389	/users/cn/jespinosa/phecomp/data/CRG/20120502_FDF_CRG/20120502_FDF_CRG/20120521_FDF_CRG_c12.mtb	4275	COLL	WWSS	food_sc	4	62377	1337664321	1	0.02	0.000294117647058824	4606	1
1	Food 1	Intake 3	84	62517	1337664461	/users/cn/jespinosa/phecomp/data/CRG/20120502_FDF_CRG/20120502_FDF_CRG/20120521_FDF_CRG_c12.mtb	3298	191	WWSS	food_sc	3	62433	1337664377	1	0.02	0.000238095238095238	4607	1
1	Drink 2	Intake 2	14	62530	1337664474	/users/cn/jespinosa/phecomp/data/CRG/20120502_FDF_CRG/20120502_FDF_CRG/20120521_FDF_CRG_c12.mtb	1503	NA	WWSS	water	2	62516	1337664460	1	0.02	0.00142857142857143	4608	1
1	Food 1	Intake 3	105	62813	1337664757	/users/cn/jespinosa/phecomp/data/CRG/20120502_FDF_CRG/20120502_FDF_CRG/20120521_FDF_CRG_c12.mtb	3299	11	WWSS	food_sc	3	62708	1337664652	1	0.02	0.00019047619047619	4609	1
1	Food 1	Intake 3	81	62905	1337664849	/users/cn/jespinosa/phecomp/data/CRG/20120502_FDF_CRG/20120502_FDF_CRG/20120521_FDF_CRG_c12.mtb	3300	132	WWSS	food_sc	3	62824	1337664768	1	0.02	0.000246913580246914	4610	1
1	Food 2	Intake 4	144	63181	1337665125	/users/cn/jespinosa/phecomp/data/CRG/20120502_FDF_CRG/20120502_FDF_CRG/20120521_FDF_CRG_c12.mtb	4277	9	WWSS	food_sc	4	63037	1337664981	1	0.02	0.000138888888888889	4611	1
1	Food 2	Intake 4	163	63353	1337665297	/users/cn/jespinosa/phecomp/data/CRG/20120502_FDF_CRG/20120502_FDF_CRG/20120521_FDF_CRG_c12.mtb	4278	338	WWSS	food_sc	4	63190	1337665134	1	0.04	0.000245398773006135	4612	1
1	Drink 2	Intake 2	23	63373	1337665317	/users/cn/jespinosa/phecomp/data/CRG/20120502_FDF_CRG/20120502_FDF_CRG/20120521_FDF_CRG_c12.mtb	1504	NA	WWSS	water	2	63350	1337665294	1	0.1	0.00434782608695652	4613	1
1	Food 2	Intake 4	68	63759	1337665703	/users/cn/jespinosa/phecomp/data/CRG/20120502_FDF_CRG/20120502_FDF_CRG/20120521_FDF_CRG_c12.mtb	4281	548	WWSS	food_sc	4	63691	1337665635	1	0.02	0.000294117647058824	4614	1
1	Drink 2	Intake 2	24	63779	1337665723	/users/cn/jespinosa/phecomp/data/CRG/20120502_FDF_CRG/20120502_FDF_CRG/20120521_FDF_CRG_c12.mtb	1505	NA	WWSS	water	2	63755	1337665699	1	0.0600000000000001	0.0025	4615	1
1	Food 1	Intake 3	91	64398	1337666342	/users/cn/jespinosa/phecomp/data/CRG/20120502_FDF_CRG/20120502_FDF_CRG/20120521_FDF_CRG_c12.mtb	3303	6	WWSS	food_sc	3	64307	1337666251	1	0.02	0.00021978021978022	4616	1
1	Food 1	Intake 3	126	64530	1337666474	/users/cn/jespinosa/phecomp/data/CRG/20120502_FDF_CRG/20120502_FDF_CRG/20120521_FDF_CRG_c12.mtb	3304	787	WWSS	food_sc	3	64404	1337666348	1	0.04	0.000317460317460317	4617	1
1	Drink 2	Intake 2	18	64814	1337666758	/users/cn/jespinosa/phecomp/data/CRG/20120502_FDF_CRG/20120502_FDF_CRG/20120521_FDF_CRG_c12.mtb	1506	NA	WWSS	water	2	64796	1337666740	1	0.04	0.00222222222222222	4618	1
1	Food 1	Intake 3	107	65424	1337667368	/users/cn/jespinosa/phecomp/data/CRG/20120502_FDF_CRG/20120502_FDF_CRG/20120521_FDF_CRG_c12.mtb	3311	343	WWSS	food_sc	3	65317	1337667261	1	0.04	0.000373831775700935	4619	1
1	Drink 1	Intake 1	17	65436	1337667380	/users/cn/jespinosa/phecomp/data/CRG/20120502_FDF_CRG/20120502_FDF_CRG/20120521_FDF_CRG_c12.mtb	2811	NA	WWSS	water	1	65419	1337667363	1	0.04	0.00235294117647059	4620	1
1	Drink 2	Intake 2	18	65602	1337667546	/users/cn/jespinosa/phecomp/data/CRG/20120502_FDF_CRG/20120502_FDF_CRG/20120521_FDF_CRG_c12.mtb	1507	NA	WWSS	water	2	65584	1337667528	1	0.02	0.00111111111111111	4621	1
1	Food 2	Intake 4	31	65798	1337667742	/users/cn/jespinosa/phecomp/data/CRG/20120502_FDF_CRG/20120502_FDF_CRG/20120521_FDF_CRG_c12.mtb	4296	67	WWSS	food_sc	4	65767	1337667711	1	0.02	0.000645161290322581	4622	1
1	Food 2	Intake 4	128	65993	1337667937	/users/cn/jespinosa/phecomp/data/CRG/20120502_FDF_CRG/20120502_FDF_CRG/20120521_FDF_CRG_c12.mtb	4297	COLL	WWSS	food_sc	4	65865	1337667809	1	0.04	0.0003125	4623	1
1	Food 1	Intake 3	36	66018	1337667962	/users/cn/jespinosa/phecomp/data/CRG/20120502_FDF_CRG/20120502_FDF_CRG/20120521_FDF_CRG_c12.mtb	3317	724	WWSS	food_sc	3	65982	1337667926	1	0.02	0.000555555555555556	4624	1
1	Drink 2	Intake 2	32	66137	1337668081	/users/cn/jespinosa/phecomp/data/CRG/20120502_FDF_CRG/20120502_FDF_CRG/20120521_FDF_CRG_c12.mtb	1508	NA	WWSS	water	2	66105	1337668049	1	0.0999999999999999	0.003125	4625	1
1	Food 2	Intake 4	18	66760	1337668704	/users/cn/jespinosa/phecomp/data/CRG/20120502_FDF_CRG/20120502_FDF_CRG/20120521_FDF_CRG_c12.mtb	4299	3994	WWSS	food_sc	4	66742	1337668686	1	0.02	0.00111111111111111	4626	1
1	Drink 1	Intake 1	17	66812	1337668756	/users/cn/jespinosa/phecomp/data/CRG/20120502_FDF_CRG/20120502_FDF_CRG/20120521_FDF_CRG_c12.mtb	2812	NA	WWSS	water	1	66795	1337668739	1	0.02	0.00117647058823529	4627	1
1	Food 2	Intake 4	77	70831	1337672775	/users/cn/jespinosa/phecomp/data/CRG/20120502_FDF_CRG/20120502_FDF_CRG/20120521_FDF_CRG_c12.mtb	4300	9	WWSS	food_sc	4	70754	1337672698	1	0.04	0.000519480519480519	4628	1
1	Food 2	Intake 4	36	70876	1337672820	/users/cn/jespinosa/phecomp/data/CRG/20120502_FDF_CRG/20120502_FDF_CRG/20120521_FDF_CRG_c12.mtb	4301	3130	WWSS	food_sc	4	70840	1337672784	1	0.04	0.00111111111111111	4629	1
1	Food 1	Intake 3	40	74046	1337675990	/users/cn/jespinosa/phecomp/data/CRG/20120502_FDF_CRG/20120502_FDF_CRG/20120521_FDF_CRG_c12.mtb	3319	47	WWSS	food_sc	3	74006	1337675950	1	0.02	0.0005	4630	1
1	Food 1	Intake 3	37	74130	1337676074	/users/cn/jespinosa/phecomp/data/CRG/20120502_FDF_CRG/20120502_FDF_CRG/20120521_FDF_CRG_c12.mtb	3320	194	WWSS	food_sc	3	74093	1337676037	1	0.02	0.000540540540540541	4631	1
1	Food 1	Intake 3	131	74455	1337676399	/users/cn/jespinosa/phecomp/data/CRG/20120502_FDF_CRG/20120502_FDF_CRG/20120521_FDF_CRG_c12.mtb	3321	19	WWSS	food_sc	3	74324	1337676268	1	0.0600000000000001	0.000458015267175573	4632	1
1	Food 1	Intake 3	39	74513	1337676457	/users/cn/jespinosa/phecomp/data/CRG/20120502_FDF_CRG/20120502_FDF_CRG/20120521_FDF_CRG_c12.mtb	3322	7556	WWSS	food_sc	3	74474	1337676418	1	0.0399999999999996	0.00102564102564102	4633	1
1	Drink 2	Intake 2	37	74752	1337676696	/users/cn/jespinosa/phecomp/data/CRG/20120502_FDF_CRG/20120502_FDF_CRG/20120521_FDF_CRG_c12.mtb	1509	NA	WWSS	water	2	74715	1337676659	1	0.12	0.00324324324324324	4634	1
1	Food 2	Intake 4	49	82118	1337684062	/users/cn/jespinosa/phecomp/data/CRG/20120502_FDF_CRG/20120502_FDF_CRG/20120521_FDF_CRG_c12.mtb	4304	11310	WWSS	food_sc	4	82069	1337684013	1	0.04	0.000816326530612245	4635	1
1	Food 1	Intake 3	141	93569	1337695513	/users/cn/jespinosa/phecomp/data/CRG/20120502_FDF_CRG/20120502_FDF_CRG/20120521_FDF_CRG_c12.mtb	3326	37	WWSS	food_sc	3	93428	1337695372	1	0.0800000000000001	0.000567375886524823	4636	1
1	Food 2	Intake 4	52	93658	1337695602	/users/cn/jespinosa/phecomp/data/CRG/20120502_FDF_CRG/20120502_FDF_CRG/20120521_FDF_CRG_c12.mtb	4306	126	WWSS	food_sc	4	93606	1337695550	1	0.02	0.000384615384615385	4637	1
1	Food 2	Intake 4	22	93806	1337695750	/users/cn/jespinosa/phecomp/data/CRG/20120502_FDF_CRG/20120502_FDF_CRG/20120521_FDF_CRG_c12.mtb	4307	8071	WWSS	food_sc	4	93784	1337695728	1	0.02	0.000909090909090909	4638	1
1	Food 1	Intake 3	52	101929	1337703873	/users/cn/jespinosa/phecomp/data/CRG/20120502_FDF_CRG/20120502_FDF_CRG/20120521_FDF_CRG_c12.mtb	3327	12	WWSS	food_sc	3	101877	1337703821	1	0.04	0.000769230769230769	4639	1
1	Food 1	Intake 3	41	101982	1337703926	/users/cn/jespinosa/phecomp/data/CRG/20120502_FDF_CRG/20120502_FDF_CRG/20120521_FDF_CRG_c12.mtb	3328	262	WWSS	food_sc	3	101941	1337703885	1	0.02	0.00048780487804878	4640	1
1	Food 2	Intake 4	31	102275	1337704219	/users/cn/jespinosa/phecomp/data/CRG/20120502_FDF_CRG/20120502_FDF_CRG/20120521_FDF_CRG_c12.mtb	4309	3103	WWSS	food_sc	4	102244	1337704188	1	0.02	0.000645161290322581	4641	1
1	Food 1	Intake 3	227	105605	1337707549	/users/cn/jespinosa/phecomp/data/CRG/20120502_FDF_CRG/20120502_FDF_CRG/20120521_FDF_CRG_c12.mtb	3329	2461	WWSS	food_sc	3	105378	1337707322	1	0.0800000000000001	0.000352422907488987	4642	1
1	Food 1	Intake 3	155	108221	1337710165	/users/cn/jespinosa/phecomp/data/CRG/20120502_FDF_CRG/20120502_FDF_CRG/20120521_FDF_CRG_c12.mtb	3331	32	WWSS	food_sc	3	108066	1337710010	1	0.04	0.000258064516129032	4643	1
1	Food 1	Intake 3	36	108289	1337710233	/users/cn/jespinosa/phecomp/data/CRG/20120502_FDF_CRG/20120502_FDF_CRG/20120521_FDF_CRG_c12.mtb	3332	1227	WWSS	food_sc	3	108253	1337710197	1	0.02	0.000555555555555556	4644	1
1	Food 1	Intake 3	339	109855	1337711799	/users/cn/jespinosa/phecomp/data/CRG/20120502_FDF_CRG/20120502_FDF_CRG/20120521_FDF_CRG_c12.mtb	3333	4	WWSS	food_sc	3	109516	1337711460	1	0.12	0.000353982300884956	4645	1
1	Food 1	Intake 3	104	109963	1337711907	/users/cn/jespinosa/phecomp/data/CRG/20120502_FDF_CRG/20120502_FDF_CRG/20120521_FDF_CRG_c12.mtb	3334	350	WWSS	food_sc	3	109859	1337711803	1	0.04	0.000384615384615385	4646	1
1	Drink 2	Intake 2	34	109996	1337711940	/users/cn/jespinosa/phecomp/data/CRG/20120502_FDF_CRG/20120502_FDF_CRG/20120521_FDF_CRG_c12.mtb	1512	NA	WWSS	water	2	109962	1337711906	1	0.0999999999999999	0.00294117647058823	4647	1
1	Drink 2	Intake 2	25	110318	1337712262	/users/cn/jespinosa/phecomp/data/CRG/20120502_FDF_CRG/20120502_FDF_CRG/20120521_FDF_CRG_c12.mtb	1513	NA	WWSS	water	2	110293	1337712237	1	0.04	0.0016	4648	1
1	Food 2	Intake 4	91	110404	1337712348	/users/cn/jespinosa/phecomp/data/CRG/20120502_FDF_CRG/20120502_FDF_CRG/20120521_FDF_CRG_c12.mtb	4313	135	WWSS	food_sc	4	110313	1337712257	1	0.02	0.00021978021978022	4649	1
1	Food 2	Intake 4	107	110646	1337712590	/users/cn/jespinosa/phecomp/data/CRG/20120502_FDF_CRG/20120502_FDF_CRG/20120521_FDF_CRG_c12.mtb	4315	336	WWSS	food_sc	4	110539	1337712483	1	0.04	0.000373831775700935	4650	1
1	Drink 2	Intake 2	15	110638	1337712582	/users/cn/jespinosa/phecomp/data/CRG/20120502_FDF_CRG/20120502_FDF_CRG/20120521_FDF_CRG_c12.mtb	1514	NA	WWSS	water	2	110623	1337712567	1	0.02	0.00133333333333333	4651	1
1	Drink 1	Intake 1	20	110746	1337712690	/users/cn/jespinosa/phecomp/data/CRG/20120502_FDF_CRG/20120502_FDF_CRG/20120521_FDF_CRG_c12.mtb	2813	NA	WWSS	water	1	110726	1337712670	1	0.04	0.002	4652	1
1	Drink 1	Intake 1	27	110859	1337712803	/users/cn/jespinosa/phecomp/data/CRG/20120502_FDF_CRG/20120502_FDF_CRG/20120521_FDF_CRG_c12.mtb	2814	NA	WWSS	water	1	110832	1337712776	1	0.04	0.00148148148148148	4653	1
1	Food 2	Intake 4	66	111048	1337712992	/users/cn/jespinosa/phecomp/data/CRG/20120502_FDF_CRG/20120502_FDF_CRG/20120521_FDF_CRG_c12.mtb	4319	69	WWSS	food_sc	4	110982	1337712926	1	0.02	0.000303030303030303	4654	1
1	Drink 1	Intake 1	15	111058	1337713002	/users/cn/jespinosa/phecomp/data/CRG/20120502_FDF_CRG/20120502_FDF_CRG/20120521_FDF_CRG_c12.mtb	2815	NA	WWSS	water	1	111043	1337712987	1	0.0399999999999998	0.00266666666666665	4655	1
1	Drink 2	Intake 2	9	111064	1337713008	/users/cn/jespinosa/phecomp/data/CRG/20120502_FDF_CRG/20120502_FDF_CRG/20120521_FDF_CRG_c12.mtb	1515	NA	WWSS	water	2	111055	1337712999	1	0.02	0.00222222222222222	4656	1
1	Food 2	Intake 4	76	111193	1337713137	/users/cn/jespinosa/phecomp/data/CRG/20120502_FDF_CRG/20120502_FDF_CRG/20120521_FDF_CRG_c12.mtb	4320	331	WWSS	food_sc	4	111117	1337713061	1	0.02	0.000263157894736842	4657	1
1	Drink 2	Intake 2	21	111210	1337713154	/users/cn/jespinosa/phecomp/data/CRG/20120502_FDF_CRG/20120502_FDF_CRG/20120521_FDF_CRG_c12.mtb	1516	NA	WWSS	water	2	111189	1337713133	1	0.02	0.000952380952380952	4658	1
1	Drink 1	Intake 1	64	111426	1337713370	/users/cn/jespinosa/phecomp/data/CRG/20120502_FDF_CRG/20120502_FDF_CRG/20120521_FDF_CRG_c12.mtb	2816	NA	WWSS	water	1	111362	1337713306	1	0.02	0.0003125	4659	1
1	Drink 1	Intake 1	17	111498	1337713442	/users/cn/jespinosa/phecomp/data/CRG/20120502_FDF_CRG/20120502_FDF_CRG/20120521_FDF_CRG_c12.mtb	2817	NA	WWSS	water	1	111481	1337713425	1	0.02	0.00117647058823529	4660	1
1	Food 1	Intake 3	78	111602	1337713546	/users/cn/jespinosa/phecomp/data/CRG/20120502_FDF_CRG/20120502_FDF_CRG/20120521_FDF_CRG_c12.mtb	3341	2005	WWSS	food_sc	3	111524	1337713468	1	0.0200000000000005	0.000256410256410263	4661	1
1	Drink 2	Intake 2	19	111816	1337713760	/users/cn/jespinosa/phecomp/data/CRG/20120502_FDF_CRG/20120502_FDF_CRG/20120521_FDF_CRG_c12.mtb	1517	NA	WWSS	water	2	111797	1337713741	1	0.04	0.00210526315789474	4662	1
1	Food 1	Intake 3	49	113656	1337715600	/users/cn/jespinosa/phecomp/data/CRG/20120502_FDF_CRG/20120502_FDF_CRG/20120521_FDF_CRG_c12.mtb	3342	8	WWSS	food_sc	3	113607	1337715551	1	0.04	0.000816326530612245	4663	1
1	Food 1	Intake 3	129	113793	1337715737	/users/cn/jespinosa/phecomp/data/CRG/20120502_FDF_CRG/20120502_FDF_CRG/20120521_FDF_CRG_c12.mtb	3343	1867	WWSS	food_sc	3	113664	1337715608	1	0.0399999999999996	0.000310077519379842	4664	1
1	Food 2	Intake 4	20	115680	1337717624	/users/cn/jespinosa/phecomp/data/CRG/20120502_FDF_CRG/20120502_FDF_CRG/20120521_FDF_CRG_c12.mtb	4323	56	WWSS	food_sc	4	115660	1337717604	1	0.02	0.001	4665	1
1	Food 2	Intake 4	117	115853	1337717797	/users/cn/jespinosa/phecomp/data/CRG/20120502_FDF_CRG/20120502_FDF_CRG/20120521_FDF_CRG_c12.mtb	4325	42	WWSS	food_sc	4	115736	1337717680	1	0.04	0.000341880341880342	4666	1
1	Food 1	Intake 3	70	115965	1337717909	/users/cn/jespinosa/phecomp/data/CRG/20120502_FDF_CRG/20120502_FDF_CRG/20120521_FDF_CRG_c12.mtb	3345	1533	WWSS	food_sc	3	115895	1337717839	1	0.02	0.000285714285714286	4667	1
1	Drink 1	Intake 1	38	115993	1337717937	/users/cn/jespinosa/phecomp/data/CRG/20120502_FDF_CRG/20120502_FDF_CRG/20120521_FDF_CRG_c12.mtb	2818	NA	WWSS	water	1	115955	1337717899	1	0.0600000000000001	0.00157894736842106	4668	1
1	Food 2	Intake 4	289	117787	1337719731	/users/cn/jespinosa/phecomp/data/CRG/20120502_FDF_CRG/20120502_FDF_CRG/20120521_FDF_CRG_c12.mtb	4328	4	WWSS	food_sc	4	117498	1337719442	1	0.1	0.000346020761245675	4669	1
1	Food 2	Intake 4	151	117942	1337719886	/users/cn/jespinosa/phecomp/data/CRG/20120502_FDF_CRG/20120502_FDF_CRG/20120521_FDF_CRG_c12.mtb	4329	168	WWSS	food_sc	4	117791	1337719735	1	0.0800000000000001	0.000529801324503312	4670	1
1	Drink 1	Intake 1	20	117965	1337719909	/users/cn/jespinosa/phecomp/data/CRG/20120502_FDF_CRG/20120502_FDF_CRG/20120521_FDF_CRG_c12.mtb	2819	NA	WWSS	water	1	117945	1337719889	1	0.0800000000000001	0.00400000000000001	4671	1
1	Food 2	Intake 4	33	118143	1337720087	/users/cn/jespinosa/phecomp/data/CRG/20120502_FDF_CRG/20120502_FDF_CRG/20120521_FDF_CRG_c12.mtb	4331	6	WWSS	food_sc	4	118110	1337720054	1	0.02	0.000606060606060606	4672	1
1	Food 2	Intake 4	124	118273	1337720217	/users/cn/jespinosa/phecomp/data/CRG/20120502_FDF_CRG/20120502_FDF_CRG/20120521_FDF_CRG_c12.mtb	4332	8	WWSS	food_sc	4	118149	1337720093	1	0.04	0.00032258064516129	4673	1
1	Food 2	Intake 4	32	118313	1337720257	/users/cn/jespinosa/phecomp/data/CRG/20120502_FDF_CRG/20120502_FDF_CRG/20120521_FDF_CRG_c12.mtb	4333	48	WWSS	food_sc	4	118281	1337720225	1	0.02	0.000625	4674	1
1	Drink 1	Intake 1	25	118330	1337720274	/users/cn/jespinosa/phecomp/data/CRG/20120502_FDF_CRG/20120502_FDF_CRG/20120521_FDF_CRG_c12.mtb	2820	NA	WWSS	water	1	118305	1337720249	1	0.0799999999999998	0.00319999999999999	4675	1
1	Food 2	Intake 4	108	118469	1337720413	/users/cn/jespinosa/phecomp/data/CRG/20120502_FDF_CRG/20120502_FDF_CRG/20120521_FDF_CRG_c12.mtb	4334	220	WWSS	food_sc	4	118361	1337720305	1	0.02	0.000185185185185185	4676	1
1	Drink 2	Intake 2	14	118603	1337720547	/users/cn/jespinosa/phecomp/data/CRG/20120502_FDF_CRG/20120502_FDF_CRG/20120521_FDF_CRG_c12.mtb	1519	NA	WWSS	water	2	118589	1337720533	1	0.02	0.00142857142857143	4677	1
1	Food 2	Intake 4	91	118780	1337720724	/users/cn/jespinosa/phecomp/data/CRG/20120502_FDF_CRG/20120502_FDF_CRG/20120521_FDF_CRG_c12.mtb	4337	30	WWSS	food_sc	4	118689	1337720633	1	0.02	0.00021978021978022	4678	1
1	Drink 1	Intake 1	16	118785	1337720729	/users/cn/jespinosa/phecomp/data/CRG/20120502_FDF_CRG/20120502_FDF_CRG/20120521_FDF_CRG_c12.mtb	2823	NA	WWSS	water	1	118769	1337720713	1	0.02	0.00125	4679	1
1	Drink 1	Intake 1	19	118810	1337720754	/users/cn/jespinosa/phecomp/data/CRG/20120502_FDF_CRG/20120502_FDF_CRG/20120521_FDF_CRG_c12.mtb	2824	NA	WWSS	water	1	118791	1337720735	1	0.02	0.00105263157894737	4680	1
1	Food 2	Intake 4	17	118827	1337720771	/users/cn/jespinosa/phecomp/data/CRG/20120502_FDF_CRG/20120502_FDF_CRG/20120521_FDF_CRG_c12.mtb	4338	9	WWSS	food_sc	4	118810	1337720754	1	0.02	0.00117647058823529	4681	1
1	Food 2	Intake 4	99	118935	1337720879	/users/cn/jespinosa/phecomp/data/CRG/20120502_FDF_CRG/20120502_FDF_CRG/20120521_FDF_CRG_c12.mtb	4339	110	WWSS	food_sc	4	118836	1337720780	1	0.02	0.000202020202020202	4682	1
1	Drink 1	Intake 1	31	118964	1337720908	/users/cn/jespinosa/phecomp/data/CRG/20120502_FDF_CRG/20120502_FDF_CRG/20120521_FDF_CRG_c12.mtb	2825	NA	WWSS	water	1	118933	1337720877	1	0.0800000000000001	0.00258064516129033	4683	1
1	Food 2	Intake 4	70	119115	1337721059	/users/cn/jespinosa/phecomp/data/CRG/20120502_FDF_CRG/20120502_FDF_CRG/20120521_FDF_CRG_c12.mtb	4340	128	WWSS	food_sc	4	119045	1337720989	1	0.0800000000000001	0.00114285714285714	4684	1
1	Food 2	Intake 4	102	119345	1337721289	/users/cn/jespinosa/phecomp/data/CRG/20120502_FDF_CRG/20120502_FDF_CRG/20120521_FDF_CRG_c12.mtb	4342	672	WWSS	food_sc	4	119243	1337721187	1	0.04	0.000392156862745098	4685	1
1	Drink 1	Intake 1	8	119358	1337721302	/users/cn/jespinosa/phecomp/data/CRG/20120502_FDF_CRG/20120502_FDF_CRG/20120521_FDF_CRG_c12.mtb	2826	NA	WWSS	water	1	119350	1337721294	1	0.02	0.0025	4686	1
1	Food 2	Intake 4	131	120148	1337722092	/users/cn/jespinosa/phecomp/data/CRG/20120502_FDF_CRG/20120502_FDF_CRG/20120521_FDF_CRG_c12.mtb	4345	74	WWSS	food_sc	4	120017	1337721961	1	0.04	0.000305343511450382	4687	1
1	Drink 1	Intake 1	17	120157	1337722101	/users/cn/jespinosa/phecomp/data/CRG/20120502_FDF_CRG/20120502_FDF_CRG/20120521_FDF_CRG_c12.mtb	2828	NA	WWSS	water	1	120140	1337722084	1	0.02	0.00117647058823529	4688	1
1	Food 2	Intake 4	108	120330	1337722274	/users/cn/jespinosa/phecomp/data/CRG/20120502_FDF_CRG/20120502_FDF_CRG/20120521_FDF_CRG_c12.mtb	4346	2982	WWSS	food_sc	4	120222	1337722166	1	0.0600000000000001	0.000555555555555557	4689	1
1	Drink 1	Intake 1	40	120360	1337722304	/users/cn/jespinosa/phecomp/data/CRG/20120502_FDF_CRG/20120502_FDF_CRG/20120521_FDF_CRG_c12.mtb	2829	NA	WWSS	water	1	120320	1337722264	1	0.1	0.0025	4690	1
1	Food 2	Intake 4	9	123321	1337725265	/users/cn/jespinosa/phecomp/data/CRG/20120502_FDF_CRG/20120502_FDF_CRG/20120521_FDF_CRG_c12.mtb	4348	82	WWSS	food_sc	4	123312	1337725256	1	0.04	0.00444444444444444	4691	1
1	Food 2	Intake 4	116	123519	1337725463	/users/cn/jespinosa/phecomp/data/CRG/20120502_FDF_CRG/20120502_FDF_CRG/20120521_FDF_CRG_c12.mtb	4350	138	WWSS	food_sc	4	123403	1337725347	1	0.0600000000000001	0.000517241379310346	4692	1
1	Food 2	Intake 4	70	123727	1337725671	/users/cn/jespinosa/phecomp/data/CRG/20120502_FDF_CRG/20120502_FDF_CRG/20120521_FDF_CRG_c12.mtb	4353	152	WWSS	food_sc	4	123657	1337725601	1	0.02	0.000285714285714286	4693	1
1	Food 2	Intake 4	80	123959	1337725903	/users/cn/jespinosa/phecomp/data/CRG/20120502_FDF_CRG/20120502_FDF_CRG/20120521_FDF_CRG_c12.mtb	4355	57	WWSS	food_sc	4	123879	1337725823	1	0.04	0.0005	4694	1
1	Food 2	Intake 4	81	124097	1337726041	/users/cn/jespinosa/phecomp/data/CRG/20120502_FDF_CRG/20120502_FDF_CRG/20120521_FDF_CRG_c12.mtb	4356	404	WWSS	food_sc	4	124016	1337725960	1	0.02	0.000246913580246914	4695	1
1	Drink 1	Intake 1	18	124104	1337726048	/users/cn/jespinosa/phecomp/data/CRG/20120502_FDF_CRG/20120502_FDF_CRG/20120521_FDF_CRG_c12.mtb	2830	NA	WWSS	water	1	124086	1337726030	1	0.0399999999999998	0.00222222222222221	4696	1
1	Food 2	Intake 4	23	124524	1337726468	/users/cn/jespinosa/phecomp/data/CRG/20120502_FDF_CRG/20120502_FDF_CRG/20120521_FDF_CRG_c12.mtb	4358	173	WWSS	food_sc	4	124501	1337726445	1	0.02	0.000869565217391304	4697	1
1	Drink 1	Intake 1	23	124674	1337726618	/users/cn/jespinosa/phecomp/data/CRG/20120502_FDF_CRG/20120502_FDF_CRG/20120521_FDF_CRG_c12.mtb	2831	NA	WWSS	water	1	124651	1337726595	1	0.02	0.000869565217391304	4698	1
1	Food 2	Intake 4	113	124810	1337726754	/users/cn/jespinosa/phecomp/data/CRG/20120502_FDF_CRG/20120502_FDF_CRG/20120521_FDF_CRG_c12.mtb	4360	61	WWSS	food_sc	4	124697	1337726641	1	0.02	0.000176991150442478	4699	1
1	Drink 2	Intake 2	15	124866	1337726810	/users/cn/jespinosa/phecomp/data/CRG/20120502_FDF_CRG/20120502_FDF_CRG/20120521_FDF_CRG_c12.mtb	1524	NA	WWSS	water	2	124851	1337726795	1	0.02	0.00133333333333333	4700	1
1	Food 2	Intake 4	89	124960	1337726904	/users/cn/jespinosa/phecomp/data/CRG/20120502_FDF_CRG/20120502_FDF_CRG/20120521_FDF_CRG_c12.mtb	4361	75	WWSS	food_sc	4	124871	1337726815	1	0.02	0.000224719101123596	4701	1
1	Food 2	Intake 4	110	125145	1337727089	/users/cn/jespinosa/phecomp/data/CRG/20120502_FDF_CRG/20120502_FDF_CRG/20120521_FDF_CRG_c12.mtb	4362	216	WWSS	food_sc	4	125035	1337726979	1	0.02	0.000181818181818182	4702	1
1	Drink 2	Intake 2	17	125315	1337727259	/users/cn/jespinosa/phecomp/data/CRG/20120502_FDF_CRG/20120502_FDF_CRG/20120521_FDF_CRG_c12.mtb	1525	NA	WWSS	water	2	125298	1337727242	1	0.0600000000000001	0.00352941176470589	4703	1
1	Drink 2	Intake 2	14	125346	1337727290	/users/cn/jespinosa/phecomp/data/CRG/20120502_FDF_CRG/20120502_FDF_CRG/20120521_FDF_CRG_c12.mtb	1526	NA	WWSS	water	2	125332	1337727276	1	0.02	0.00142857142857143	4704	1
1	Food 2	Intake 4	121	125482	1337727426	/users/cn/jespinosa/phecomp/data/CRG/20120502_FDF_CRG/20120502_FDF_CRG/20120521_FDF_CRG_c12.mtb	4364	46	WWSS	food_sc	4	125361	1337727305	1	0.02	0.000165289256198347	4705	1
1	Food 2	Intake 4	123	125651	1337727595	/users/cn/jespinosa/phecomp/data/CRG/20120502_FDF_CRG/20120502_FDF_CRG/20120521_FDF_CRG_c12.mtb	4365	361	WWSS	food_sc	4	125528	1337727472	1	0.02	0.00016260162601626	4706	1
1	Drink 2	Intake 2	24	125957	1337727901	/users/cn/jespinosa/phecomp/data/CRG/20120502_FDF_CRG/20120502_FDF_CRG/20120521_FDF_CRG_c12.mtb	1527	NA	WWSS	water	2	125933	1337727877	1	0.0599999999999998	0.00249999999999999	4707	1
1	Food 2	Intake 4	118	126130	1337728074	/users/cn/jespinosa/phecomp/data/CRG/20120502_FDF_CRG/20120502_FDF_CRG/20120521_FDF_CRG_c12.mtb	4367	249	WWSS	food_sc	4	126012	1337727956	1	0.04	0.000338983050847458	4708	1
1	Food 2	Intake 4	76	126455	1337728399	/users/cn/jespinosa/phecomp/data/CRG/20120502_FDF_CRG/20120502_FDF_CRG/20120521_FDF_CRG_c12.mtb	4369	37	WWSS	food_sc	4	126379	1337728323	1	0.0200000000000005	0.000263157894736849	4709	1
1	Food 2	Intake 4	107	126599	1337728543	/users/cn/jespinosa/phecomp/data/CRG/20120502_FDF_CRG/20120502_FDF_CRG/20120521_FDF_CRG_c12.mtb	4370	67	WWSS	food_sc	4	126492	1337728436	1	0.0399999999999996	0.000373831775700931	4710	1
1	Drink 2	Intake 2	16	126677	1337728621	/users/cn/jespinosa/phecomp/data/CRG/20120502_FDF_CRG/20120502_FDF_CRG/20120521_FDF_CRG_c12.mtb	1529	NA	WWSS	water	2	126661	1337728605	1	0.04	0.0025	4711	1
1	Food 2	Intake 4	82	126748	1337728692	/users/cn/jespinosa/phecomp/data/CRG/20120502_FDF_CRG/20120502_FDF_CRG/20120521_FDF_CRG_c12.mtb	4372	254	WWSS	food_sc	4	126666	1337728610	1	0.02	0.00024390243902439	4712	1
1	Food 2	Intake 4	73	127075	1337729019	/users/cn/jespinosa/phecomp/data/CRG/20120502_FDF_CRG/20120502_FDF_CRG/20120521_FDF_CRG_c12.mtb	4374	4	WWSS	food_sc	4	127002	1337728946	1	0.02	0.000273972602739726	4713	1
1	Food 2	Intake 4	62	127141	1337729085	/users/cn/jespinosa/phecomp/data/CRG/20120502_FDF_CRG/20120502_FDF_CRG/20120521_FDF_CRG_c12.mtb	4375	COLL	WWSS	food_sc	4	127079	1337729023	1	0.02	0.00032258064516129	4714	1
1	Food 1	Intake 3	112	127243	1337729187	/users/cn/jespinosa/phecomp/data/CRG/20120502_FDF_CRG/20120502_FDF_CRG/20120521_FDF_CRG_c12.mtb	3369	138	WWSS	food_sc	3	127131	1337729075	1	0.02	0.000178571428571429	4715	1
1	Drink 2	Intake 2	23	127266	1337729210	/users/cn/jespinosa/phecomp/data/CRG/20120502_FDF_CRG/20120502_FDF_CRG/20120521_FDF_CRG_c12.mtb	1530	NA	WWSS	water	2	127243	1337729187	1	0.02	0.000869565217391304	4716	1
1	Food 1	Intake 3	82	127463	1337729407	/users/cn/jespinosa/phecomp/data/CRG/20120502_FDF_CRG/20120502_FDF_CRG/20120521_FDF_CRG_c12.mtb	3371	106	WWSS	food_sc	3	127381	1337729325	1	0.04	0.00048780487804878	4717	1
1	Food 2	Intake 4	92	127661	1337729605	/users/cn/jespinosa/phecomp/data/CRG/20120502_FDF_CRG/20120502_FDF_CRG/20120521_FDF_CRG_c12.mtb	4377	689	WWSS	food_sc	4	127569	1337729513	1	0.02	0.000217391304347826	4718	1
1	Drink 2	Intake 2	25	127677	1337729621	/users/cn/jespinosa/phecomp/data/CRG/20120502_FDF_CRG/20120502_FDF_CRG/20120521_FDF_CRG_c12.mtb	1531	NA	WWSS	water	2	127652	1337729596	1	0.0599999999999998	0.00239999999999999	4719	1
1	Drink 2	Intake 2	31	128045	1337729989	/users/cn/jespinosa/phecomp/data/CRG/20120502_FDF_CRG/20120502_FDF_CRG/20120521_FDF_CRG_c12.mtb	1532	NA	WWSS	water	2	128014	1337729958	1	0.0800000000000001	0.00258064516129033	4720	1
1	Food 2	Intake 4	179	128529	1337730473	/users/cn/jespinosa/phecomp/data/CRG/20120502_FDF_CRG/20120502_FDF_CRG/20120521_FDF_CRG_c12.mtb	4380	335	WWSS	food_sc	4	128350	1337730294	1	0.04	0.000223463687150838	4721	1
1	Drink 1	Intake 1	16	128830	1337730774	/users/cn/jespinosa/phecomp/data/CRG/20120502_FDF_CRG/20120502_FDF_CRG/20120521_FDF_CRG_c12.mtb	2832	NA	WWSS	water	1	128814	1337730758	1	0.02	0.00125	4722	1
1	Food 1	Intake 3	32	128896	1337730840	/users/cn/jespinosa/phecomp/data/CRG/20120502_FDF_CRG/20120502_FDF_CRG/20120521_FDF_CRG_c12.mtb	3376	52	WWSS	food_sc	3	128864	1337730808	1	0.02	0.000625	4723	1
1	Food 2	Intake 4	141	129089	1337731033	/users/cn/jespinosa/phecomp/data/CRG/20120502_FDF_CRG/20120502_FDF_CRG/20120521_FDF_CRG_c12.mtb	4381	96	WWSS	food_sc	4	128948	1337730892	1	0.04	0.000283687943262411	4724	1
1	Food 2	Intake 4	176	129361	1337731305	/users/cn/jespinosa/phecomp/data/CRG/20120502_FDF_CRG/20120502_FDF_CRG/20120521_FDF_CRG_c12.mtb	4382	209	WWSS	food_sc	4	129185	1337731129	1	0.02	0.000113636363636364	4725	1
1	Food 2	Intake 4	129	129699	1337731643	/users/cn/jespinosa/phecomp/data/CRG/20120502_FDF_CRG/20120502_FDF_CRG/20120521_FDF_CRG_c12.mtb	4383	17	WWSS	food_sc	4	129570	1337731514	1	0.02	0.000155038759689922	4726	1
1	Drink 2	Intake 2	17	129713	1337731657	/users/cn/jespinosa/phecomp/data/CRG/20120502_FDF_CRG/20120502_FDF_CRG/20120521_FDF_CRG_c12.mtb	1533	NA	WWSS	water	2	129696	1337731640	1	0.02	0.00117647058823529	4727	1
1	Food 2	Intake 4	184	129900	1337731844	/users/cn/jespinosa/phecomp/data/CRG/20120502_FDF_CRG/20120502_FDF_CRG/20120521_FDF_CRG_c12.mtb	4384	83	WWSS	food_sc	4	129716	1337731660	1	0.04	0.000217391304347826	4728	1
1	Drink 1	Intake 1	13	129919	1337731863	/users/cn/jespinosa/phecomp/data/CRG/20120502_FDF_CRG/20120502_FDF_CRG/20120521_FDF_CRG_c12.mtb	2833	NA	WWSS	water	1	129906	1337731850	1	0.02	0.00153846153846154	4729	1
1	Food 1	Intake 3	36	130019	1337731963	/users/cn/jespinosa/phecomp/data/CRG/20120502_FDF_CRG/20120502_FDF_CRG/20120521_FDF_CRG_c12.mtb	3378	COLL	WWSS	food_sc	3	129983	1337731927	1	0.02	0.000555555555555556	4730	1
1	Food 2	Intake 4	193	130200	1337732144	/users/cn/jespinosa/phecomp/data/CRG/20120502_FDF_CRG/20120502_FDF_CRG/20120521_FDF_CRG_c12.mtb	4385	469	WWSS	food_sc	4	130007	1337731951	1	0.04	0.000207253886010363	4731	1
1	Food 2	Intake 4	171	130840	1337732784	/users/cn/jespinosa/phecomp/data/CRG/20120502_FDF_CRG/20120502_FDF_CRG/20120521_FDF_CRG_c12.mtb	4389	10	WWSS	food_sc	4	130669	1337732613	1	0.04	0.000233918128654971	4732	1
1	Food 2	Intake 4	90	130940	1337732884	/users/cn/jespinosa/phecomp/data/CRG/20120502_FDF_CRG/20120502_FDF_CRG/20120521_FDF_CRG_c12.mtb	4390	236	WWSS	food_sc	4	130850	1337732794	1	0.02	0.000222222222222222	4733	1
1	Drink 1	Intake 1	38	131008	1337732952	/users/cn/jespinosa/phecomp/data/CRG/20120502_FDF_CRG/20120502_FDF_CRG/20120521_FDF_CRG_c12.mtb	2834	NA	WWSS	water	1	130970	1337732914	1	0.02	0.000526315789473684	4734	1
1	Food 2	Intake 4	43	131219	1337733163	/users/cn/jespinosa/phecomp/data/CRG/20120502_FDF_CRG/20120502_FDF_CRG/20120521_FDF_CRG_c12.mtb	4393	3	WWSS	food_sc	4	131176	1337733120	1	0.36	0.00837209302325581	4735	1
1	Food 2	Intake 4	225	131447	1337733391	/users/cn/jespinosa/phecomp/data/CRG/20120502_FDF_CRG/20120502_FDF_CRG/20120521_FDF_CRG_c12.mtb	4394	5731	WWSS	food_sc	4	131222	1337733166	1	0.04	0.000177777777777778	4736	1
1	Drink 2	Intake 2	20	131472	1337733416	/users/cn/jespinosa/phecomp/data/CRG/20120502_FDF_CRG/20120502_FDF_CRG/20120521_FDF_CRG_c12.mtb	1535	NA	WWSS	water	2	131452	1337733396	1	0.02	0.001	4737	1
1	Drink 2	Intake 2	42	131560	1337733504	/users/cn/jespinosa/phecomp/data/CRG/20120502_FDF_CRG/20120502_FDF_CRG/20120521_FDF_CRG_c12.mtb	1536	NA	WWSS	water	2	131518	1337733462	1	0.1	0.00238095238095238	4738	1
1	Food 2	Intake 4	50	137228	1337739172	/users/cn/jespinosa/phecomp/data/CRG/20120502_FDF_CRG/20120502_FDF_CRG/20120521_FDF_CRG_c12.mtb	4395	24	WWSS	food_sc	4	137178	1337739122	1	0.04	0.0008	4739	1
1	Food 2	Intake 4	9	137261	1337739205	/users/cn/jespinosa/phecomp/data/CRG/20120502_FDF_CRG/20120502_FDF_CRG/20120521_FDF_CRG_c12.mtb	4396	20	WWSS	food_sc	4	137252	1337739196	1	0.02	0.00222222222222222	4740	1
1	Food 2	Intake 4	17	137298	1337739242	/users/cn/jespinosa/phecomp/data/CRG/20120502_FDF_CRG/20120502_FDF_CRG/20120521_FDF_CRG_c12.mtb	4397	6199	WWSS	food_sc	4	137281	1337739225	1	0.02	0.00117647058823529	4741	1
1	Food 2	Intake 4	73	143570	1337745514	/users/cn/jespinosa/phecomp/data/CRG/20120502_FDF_CRG/20120502_FDF_CRG/20120521_FDF_CRG_c12.mtb	4399	1777	WWSS	food_sc	4	143497	1337745441	1	0.0600000000000001	0.000821917808219179	4742	1
1	Food 2	Intake 4	43	145390	1337747334	/users/cn/jespinosa/phecomp/data/CRG/20120502_FDF_CRG/20120502_FDF_CRG/20120521_FDF_CRG_c12.mtb	4401	339	WWSS	food_sc	4	145347	1337747291	1	0.0200000000000005	0.000465116279069779	4743	1
1	Drink 1	Intake 1	20	145698	1337747642	/users/cn/jespinosa/phecomp/data/CRG/20120502_FDF_CRG/20120502_FDF_CRG/20120521_FDF_CRG_c12.mtb	2835	NA	WWSS	water	1	145678	1337747622	1	0.0799999999999998	0.00399999999999999	4744	1
1	Food 2	Intake 4	100	145829	1337747773	/users/cn/jespinosa/phecomp/data/CRG/20120502_FDF_CRG/20120502_FDF_CRG/20120521_FDF_CRG_c12.mtb	4403	16	WWSS	food_sc	4	145729	1337747673	1	0.0600000000000001	0.000600000000000001	4745	1
1	Drink 1	Intake 1	29	145857	1337747801	/users/cn/jespinosa/phecomp/data/CRG/20120502_FDF_CRG/20120502_FDF_CRG/20120521_FDF_CRG_c12.mtb	2836	NA	WWSS	water	1	145828	1337747772	1	0.02	0.000689655172413793	4746	1
1	Food 2	Intake 4	54	145899	1337747843	/users/cn/jespinosa/phecomp/data/CRG/20120502_FDF_CRG/20120502_FDF_CRG/20120521_FDF_CRG_c12.mtb	4404	5	WWSS	food_sc	4	145845	1337747789	1	0.02	0.00037037037037037	4747	1
1	Food 2	Intake 4	88	145992	1337747936	/users/cn/jespinosa/phecomp/data/CRG/20120502_FDF_CRG/20120502_FDF_CRG/20120521_FDF_CRG_c12.mtb	4405	210	WWSS	food_sc	4	145904	1337747848	1	0.02	0.000227272727272727	4748	1
1	Drink 2	Intake 2	26	146007	1337747951	/users/cn/jespinosa/phecomp/data/CRG/20120502_FDF_CRG/20120502_FDF_CRG/20120521_FDF_CRG_c12.mtb	1537	NA	WWSS	water	2	145981	1337747925	1	0.0600000000000001	0.00230769230769231	4749	1
1	Food 1	Intake 3	33	146235	1337748179	/users/cn/jespinosa/phecomp/data/CRG/20120502_FDF_CRG/20120502_FDF_CRG/20120521_FDF_CRG_c12.mtb	3389	158	WWSS	food_sc	3	146202	1337748146	1	0.02	0.000606060606060606	4750	1
1	Drink 2	Intake 2	8	146277	1337748221	/users/cn/jespinosa/phecomp/data/CRG/20120502_FDF_CRG/20120502_FDF_CRG/20120521_FDF_CRG_c12.mtb	1539	NA	WWSS	water	2	146269	1337748213	1	0.04	0.005	4751	1
1	Food 1	Intake 3	41	146434	1337748378	/users/cn/jespinosa/phecomp/data/CRG/20120502_FDF_CRG/20120502_FDF_CRG/20120521_FDF_CRG_c12.mtb	3390	833	WWSS	food_sc	3	146393	1337748337	1	0.02	0.00048780487804878	4752	1
1	Drink 1	Intake 1	23	146509	1337748453	/users/cn/jespinosa/phecomp/data/CRG/20120502_FDF_CRG/20120502_FDF_CRG/20120521_FDF_CRG_c12.mtb	2838	NA	WWSS	water	1	146486	1337748430	1	0.02	0.000869565217391304	4753	1
1	Drink 1	Intake 1	23	146837	1337748781	/users/cn/jespinosa/phecomp/data/CRG/20120502_FDF_CRG/20120502_FDF_CRG/20120521_FDF_CRG_c12.mtb	2839	NA	WWSS	water	1	146814	1337748758	1	0.0600000000000001	0.00260869565217392	4754	1
1	Food 2	Intake 4	35	147302	1337749246	/users/cn/jespinosa/phecomp/data/CRG/20120502_FDF_CRG/20120502_FDF_CRG/20120521_FDF_CRG_c12.mtb	4410	COLL	WWSS	food_sc	4	147267	1337749211	1	0.02	0.000571428571428571	4755	1
1	Food 1	Intake 3	96	147384	1337749328	/users/cn/jespinosa/phecomp/data/CRG/20120502_FDF_CRG/20120502_FDF_CRG/20120521_FDF_CRG_c12.mtb	3392	562	WWSS	food_sc	3	147288	1337749232	1	0.04	0.000416666666666667	4756	1
1	Food 1	Intake 3	33	147979	1337749923	/users/cn/jespinosa/phecomp/data/CRG/20120502_FDF_CRG/20120502_FDF_CRG/20120521_FDF_CRG_c12.mtb	3393	47	WWSS	food_sc	3	147946	1337749890	1	0.02	0.000606060606060606	4757	1
1	Food 1	Intake 3	76	148102	1337750046	/users/cn/jespinosa/phecomp/data/CRG/20120502_FDF_CRG/20120502_FDF_CRG/20120521_FDF_CRG_c12.mtb	3394	609	WWSS	food_sc	3	148026	1337749970	1	0.0600000000000001	0.000789473684210528	4758	1
1	Drink 1	Intake 1	17	148138	1337750082	/users/cn/jespinosa/phecomp/data/CRG/20120502_FDF_CRG/20120502_FDF_CRG/20120521_FDF_CRG_c12.mtb	2840	NA	WWSS	water	1	148121	1337750065	1	0.04	0.00235294117647059	4759	1
1	Drink 1	Intake 1	41	148325	1337750269	/users/cn/jespinosa/phecomp/data/CRG/20120502_FDF_CRG/20120502_FDF_CRG/20120521_FDF_CRG_c12.mtb	2841	NA	WWSS	water	1	148284	1337750228	1	0.04	0.000975609756097561	4760	1
1	Drink 2	Intake 2	13	148439	1337750383	/users/cn/jespinosa/phecomp/data/CRG/20120502_FDF_CRG/20120502_FDF_CRG/20120521_FDF_CRG_c12.mtb	1542	NA	WWSS	water	2	148426	1337750370	1	0.02	0.00153846153846154	4761	1
1	Food 1	Intake 3	48	148759	1337750703	/users/cn/jespinosa/phecomp/data/CRG/20120502_FDF_CRG/20120502_FDF_CRG/20120521_FDF_CRG_c12.mtb	3398	87	WWSS	food_sc	3	148711	1337750655	1	0.02	0.000416666666666667	4762	1
1	Drink 1	Intake 1	19	148768	1337750712	/users/cn/jespinosa/phecomp/data/CRG/20120502_FDF_CRG/20120502_FDF_CRG/20120521_FDF_CRG_c12.mtb	2843	NA	WWSS	water	1	148749	1337750693	1	0.02	0.00105263157894737	4763	1
1	Food 1	Intake 3	40	148886	1337750830	/users/cn/jespinosa/phecomp/data/CRG/20120502_FDF_CRG/20120502_FDF_CRG/20120521_FDF_CRG_c12.mtb	3400	204	WWSS	food_sc	3	148846	1337750790	1	0.02	0.0005	4764	1
1	Drink 2	Intake 2	44	148935	1337750879	/users/cn/jespinosa/phecomp/data/CRG/20120502_FDF_CRG/20120502_FDF_CRG/20120521_FDF_CRG_c12.mtb	1543	NA	WWSS	water	2	148891	1337750835	1	0.18	0.00409090909090909	4765	1
1	Food 1	Intake 3	25	149115	1337751059	/users/cn/jespinosa/phecomp/data/CRG/20120502_FDF_CRG/20120502_FDF_CRG/20120521_FDF_CRG_c12.mtb	3402	44	WWSS	food_sc	3	149090	1337751034	1	0.02	0.0008	4766	1
1	Food 1	Intake 3	39	149198	1337751142	/users/cn/jespinosa/phecomp/data/CRG/20120502_FDF_CRG/20120502_FDF_CRG/20120521_FDF_CRG_c12.mtb	3404	72	WWSS	food_sc	3	149159	1337751103	1	0.02	0.000512820512820513	4767	1
1	Food 1	Intake 3	55	149325	1337751269	/users/cn/jespinosa/phecomp/data/CRG/20120502_FDF_CRG/20120502_FDF_CRG/20120521_FDF_CRG_c12.mtb	3406	257	WWSS	food_sc	3	149270	1337751214	1	0.04	0.000727272727272727	4768	1
1	Drink 2	Intake 2	17	149346	1337751290	/users/cn/jespinosa/phecomp/data/CRG/20120502_FDF_CRG/20120502_FDF_CRG/20120521_FDF_CRG_c12.mtb	1544	NA	WWSS	water	2	149329	1337751273	1	0.02	0.00117647058823529	4769	1
1	Food 1	Intake 3	120	149702	1337751646	/users/cn/jespinosa/phecomp/data/CRG/20120502_FDF_CRG/20120502_FDF_CRG/20120521_FDF_CRG_c12.mtb	3408	62	WWSS	food_sc	3	149582	1337751526	1	0.0399999999999996	0.00033333333333333	4770	1
1	Food 1	Intake 3	40	149804	1337751748	/users/cn/jespinosa/phecomp/data/CRG/20120502_FDF_CRG/20120502_FDF_CRG/20120521_FDF_CRG_c12.mtb	3410	608	WWSS	food_sc	3	149764	1337751708	1	0.0200000000000005	0.000500000000000012	4771	1
1	Drink 2	Intake 2	17	150314	1337752258	/users/cn/jespinosa/phecomp/data/CRG/20120502_FDF_CRG/20120502_FDF_CRG/20120521_FDF_CRG_c12.mtb	1547	NA	WWSS	water	2	150297	1337752241	1	0.02	0.00117647058823529	4772	1
1	Food 1	Intake 3	203	150615	1337752559	/users/cn/jespinosa/phecomp/data/CRG/20120502_FDF_CRG/20120502_FDF_CRG/20120521_FDF_CRG_c12.mtb	3411	156	WWSS	food_sc	3	150412	1337752356	1	0.0399999999999996	0.000197044334975367	4773	1
1	Food 1	Intake 3	92	150863	1337752807	/users/cn/jespinosa/phecomp/data/CRG/20120502_FDF_CRG/20120502_FDF_CRG/20120521_FDF_CRG_c12.mtb	3413	8	WWSS	food_sc	3	150771	1337752715	1	0.02	0.000217391304347826	4774	1
1	Food 1	Intake 3	187	151058	1337753002	/users/cn/jespinosa/phecomp/data/CRG/20120502_FDF_CRG/20120502_FDF_CRG/20120521_FDF_CRG_c12.mtb	3414	14	WWSS	food_sc	3	150871	1337752815	1	0.12	0.000641711229946524	4775	1
1	Food 1	Intake 3	271	151343	1337753287	/users/cn/jespinosa/phecomp/data/CRG/20120502_FDF_CRG/20120502_FDF_CRG/20120521_FDF_CRG_c12.mtb	3415	42	WWSS	food_sc	3	151072	1337753016	1	0.92	0.00339483394833948	4776	1
1	Drink 2	Intake 2	23	151367	1337753311	/users/cn/jespinosa/phecomp/data/CRG/20120502_FDF_CRG/20120502_FDF_CRG/20120521_FDF_CRG_c12.mtb	1550	NA	WWSS	water	2	151344	1337753288	1	0.0800000000000001	0.00347826086956522	4777	1
1	Food 1	Intake 3	77	151462	1337753406	/users/cn/jespinosa/phecomp/data/CRG/20120502_FDF_CRG/20120502_FDF_CRG/20120521_FDF_CRG_c12.mtb	3416	45	WWSS	food_sc	3	151385	1337753329	1	0.0200000000000005	0.000259740259740266	4778	1
1	Food 2	Intake 4	15	151522	1337753466	/users/cn/jespinosa/phecomp/data/CRG/20120502_FDF_CRG/20120502_FDF_CRG/20120521_FDF_CRG_c12.mtb	4438	17	WWSS	food_sc	4	151507	1337753451	1	0.02	0.00133333333333333	4779	1
1	Food 2	Intake 4	28	151567	1337753511	/users/cn/jespinosa/phecomp/data/CRG/20120502_FDF_CRG/20120502_FDF_CRG/20120521_FDF_CRG_c12.mtb	4439	35	WWSS	food_sc	4	151539	1337753483	1	0.02	0.000714285714285714	4780	1
1	Food 1	Intake 3	148	151750	1337753694	/users/cn/jespinosa/phecomp/data/CRG/20120502_FDF_CRG/20120502_FDF_CRG/20120521_FDF_CRG_c12.mtb	3419	COLL	WWSS	food_sc	3	151602	1337753546	1	0.0800000000000001	0.000540540540540541	4781	1
1	Food 2	Intake 4	15	151747	1337753691	/users/cn/jespinosa/phecomp/data/CRG/20120502_FDF_CRG/20120502_FDF_CRG/20120521_FDF_CRG_c12.mtb	4442	6738	WWSS	food_sc	4	151732	1337753676	1	0.02	0.00133333333333333	4782	1
1	Drink 2	Intake 2	9	151792	1337753736	/users/cn/jespinosa/phecomp/data/CRG/20120502_FDF_CRG/20120502_FDF_CRG/20120521_FDF_CRG_c12.mtb	1551	NA	WWSS	water	2	151783	1337753727	1	0.02	0.00222222222222222	4783	1
1	Drink 1	Intake 1	28	151944	1337753888	/users/cn/jespinosa/phecomp/data/CRG/20120502_FDF_CRG/20120502_FDF_CRG/20120521_FDF_CRG_c12.mtb	2845	NA	WWSS	water	1	151916	1337753860	1	0.0600000000000001	0.00214285714285715	4784	1
1	Drink 2	Intake 2	13	152368	1337754312	/users/cn/jespinosa/phecomp/data/CRG/20120502_FDF_CRG/20120502_FDF_CRG/20120521_FDF_CRG_c12.mtb	1552	NA	WWSS	water	2	152355	1337754299	1	0.02	0.00153846153846154	4785	1
1	Food 2	Intake 4	59	158544	1337760488	/users/cn/jespinosa/phecomp/data/CRG/20120502_FDF_CRG/20120502_FDF_CRG/20120521_FDF_CRG_c12.mtb	4447	5368	WWSS	food_sc	4	158485	1337760429	1	0.0600000000000001	0.00101694915254237	4786	1
1	Drink 1	Intake 1	22	163846	1337765790	/users/cn/jespinosa/phecomp/data/CRG/20120502_FDF_CRG/20120502_FDF_CRG/20120521_FDF_CRG_c12.mtb	2846	NA	WWSS	water	1	163824	1337765768	1	0.02	0.000909090909090909	4787	1
1	Food 2	Intake 4	48	163960	1337765904	/users/cn/jespinosa/phecomp/data/CRG/20120502_FDF_CRG/20120502_FDF_CRG/20120521_FDF_CRG_c12.mtb	4450	LAST	WWSS	food_sc	4	163912	1337765856	1	0.02	0.000416666666666667	4788	1
1	Drink 2	Intake 2	54	164101	1337766045	/users/cn/jespinosa/phecomp/data/CRG/20120502_FDF_CRG/20120502_FDF_CRG/20120521_FDF_CRG_c12.mtb	1555	LAST	WWSS	water	2	164047	1337765991	1	0.02	0.00037037037037037	4789	1
