CAGE	Caption	Channel	Duration	EndL	EndT	File	Index	InterTime	Name	Nature	SlotI	StartL	StartT	Type	Value	Velocity	linen	period
3	Drink 1	Intake 1	23	1840	1335959848	/users/cn/jespinosa/phecomp/data/CRG/20120502_FDF_CRG/20120502_FDF_CRG/20120502_FDF_CRG_c12.mtb	50	NA	WWSS	water	1	1817	1335959825	1	0.02	0.000869565217391304	6783	1
3	Food 1	Intake 3	68	2168	1335960176	/users/cn/jespinosa/phecomp/data/CRG/20120502_FDF_CRG/20120502_FDF_CRG/20120502_FDF_CRG_c12.mtb	87	16871	WWSS	food_sc	3	2100	1335960108	1	0.02	0.000294117647058824	6784	1
3	Drink 2	Intake 2	22	2778	1335960786	/users/cn/jespinosa/phecomp/data/CRG/20120502_FDF_CRG/20120502_FDF_CRG/20120502_FDF_CRG_c12.mtb	450	NA	WWSS	water	2	2756	1335960764	1	0.02	0.000909090909090909	6785	1
3	Drink 2	Intake 2	46	12232	1335970240	/users/cn/jespinosa/phecomp/data/CRG/20120502_FDF_CRG/20120502_FDF_CRG/20120502_FDF_CRG_c12.mtb	478	NA	WWSS	water	2	12186	1335970194	1	0.02	0.000434782608695652	6786	1
3	Food 2	Intake 4	329	19368	1335977376	/users/cn/jespinosa/phecomp/data/CRG/20120502_FDF_CRG/20120502_FDF_CRG/20120502_FDF_CRG_c12.mtb	333	112	WWSS	food_sc	4	19039	1335977047	1	0.04	0.000121580547112462	6787	1
3	Food 2	Intake 4	44	19524	1335977532	/users/cn/jespinosa/phecomp/data/CRG/20120502_FDF_CRG/20120502_FDF_CRG/20120502_FDF_CRG_c12.mtb	334	15	WWSS	food_sc	4	19480	1335977488	1	0.04	0.000909090909090909	6788	1
3	Food 2	Intake 4	49	19588	1335977596	/users/cn/jespinosa/phecomp/data/CRG/20120502_FDF_CRG/20120502_FDF_CRG/20120502_FDF_CRG_c12.mtb	335	32	WWSS	food_sc	4	19539	1335977547	1	0.04	0.000816326530612245	6789	1
3	Food 2	Intake 4	192	19812	1335977820	/users/cn/jespinosa/phecomp/data/CRG/20120502_FDF_CRG/20120502_FDF_CRG/20120502_FDF_CRG_c12.mtb	336	4207	WWSS	food_sc	4	19620	1335977628	1	0.06	0.0003125	6790	1
3	Drink 1	Intake 1	28	19929	1335977937	/users/cn/jespinosa/phecomp/data/CRG/20120502_FDF_CRG/20120502_FDF_CRG/20120502_FDF_CRG_c12.mtb	61	NA	WWSS	water	1	19901	1335977909	1	0.04	0.00142857142857143	6791	1
3	Drink 1	Intake 1	37	19986	1335977994	/users/cn/jespinosa/phecomp/data/CRG/20120502_FDF_CRG/20120502_FDF_CRG/20120502_FDF_CRG_c12.mtb	62	NA	WWSS	water	1	19949	1335977957	1	0.02	0.000540540540540541	6792	1
3	Drink 2	Intake 2	24	20854	1335978862	/users/cn/jespinosa/phecomp/data/CRG/20120502_FDF_CRG/20120502_FDF_CRG/20120502_FDF_CRG_c12.mtb	486	NA	WWSS	water	2	20830	1335978838	1	0.02	0.000833333333333333	6793	1
3	Drink 2	Intake 2	44	20925	1335978933	/users/cn/jespinosa/phecomp/data/CRG/20120502_FDF_CRG/20120502_FDF_CRG/20120502_FDF_CRG_c12.mtb	487	NA	WWSS	water	2	20881	1335978889	1	0.04	0.000909090909090909	6794	1
3	Drink 2	Intake 2	30	21864	1335979872	/users/cn/jespinosa/phecomp/data/CRG/20120502_FDF_CRG/20120502_FDF_CRG/20120502_FDF_CRG_c12.mtb	488	NA	WWSS	water	2	21834	1335979842	1	0.02	0.000666666666666667	6795	1
3	Drink 2	Intake 2	27	21980	1335979988	/users/cn/jespinosa/phecomp/data/CRG/20120502_FDF_CRG/20120502_FDF_CRG/20120502_FDF_CRG_c12.mtb	490	NA	WWSS	water	2	21953	1335979961	1	0.02	0.000740740740740741	6796	1
3	Food 2	Intake 4	348	24367	1335982375	/users/cn/jespinosa/phecomp/data/CRG/20120502_FDF_CRG/20120502_FDF_CRG/20120502_FDF_CRG_c12.mtb	339	1246	WWSS	food_sc	4	24019	1335982027	1	0.06	0.000172413793103448	6797	1
3	Drink 1	Intake 1	18	24509	1335982517	/users/cn/jespinosa/phecomp/data/CRG/20120502_FDF_CRG/20120502_FDF_CRG/20120502_FDF_CRG_c12.mtb	64	NA	WWSS	water	1	24491	1335982499	1	0.04	0.00222222222222222	6798	1
3	Food 2	Intake 4	368	25981	1335983989	/users/cn/jespinosa/phecomp/data/CRG/20120502_FDF_CRG/20120502_FDF_CRG/20120502_FDF_CRG_c12.mtb	340	530	WWSS	food_sc	4	25613	1335983621	1	0.12	0.000326086956521739	6799	1
3	Drink 2	Intake 2	22	26051	1335984059	/users/cn/jespinosa/phecomp/data/CRG/20120502_FDF_CRG/20120502_FDF_CRG/20120502_FDF_CRG_c12.mtb	494	NA	WWSS	water	2	26029	1335984037	1	0.08	0.00363636363636364	6800	1
3	Drink 2	Intake 2	57	26144	1335984152	/users/cn/jespinosa/phecomp/data/CRG/20120502_FDF_CRG/20120502_FDF_CRG/20120502_FDF_CRG_c12.mtb	495	NA	WWSS	water	2	26087	1335984095	1	0.04	0.000701754385964912	6801	1
3	Food 2	Intake 4	141	26652	1335984660	/users/cn/jespinosa/phecomp/data/CRG/20120502_FDF_CRG/20120502_FDF_CRG/20120502_FDF_CRG_c12.mtb	344	281	WWSS	food_sc	4	26511	1335984519	1	0.04	0.000283687943262411	6802	1
3	Drink 2	Intake 2	22	26701	1335984709	/users/cn/jespinosa/phecomp/data/CRG/20120502_FDF_CRG/20120502_FDF_CRG/20120502_FDF_CRG_c12.mtb	499	NA	WWSS	water	2	26679	1335984687	1	0.08	0.00363636363636364	6803	1
3	Food 2	Intake 4	89	27022	1335985030	/users/cn/jespinosa/phecomp/data/CRG/20120502_FDF_CRG/20120502_FDF_CRG/20120502_FDF_CRG_c12.mtb	345	4	WWSS	food_sc	4	26933	1335984941	1	0.06	0.000674157303370786	6804	1
3	Food 2	Intake 4	223	27249	1335985257	/users/cn/jespinosa/phecomp/data/CRG/20120502_FDF_CRG/20120502_FDF_CRG/20120502_FDF_CRG_c12.mtb	346	827	WWSS	food_sc	4	27026	1335985034	1	0.08	0.000358744394618834	6805	1
3	Drink 2	Intake 2	28	27526	1335985534	/users/cn/jespinosa/phecomp/data/CRG/20120502_FDF_CRG/20120502_FDF_CRG/20120502_FDF_CRG_c12.mtb	501	NA	WWSS	water	2	27498	1335985506	1	0.08	0.00285714285714286	6806	1
3	Food 2	Intake 4	169	28245	1335986253	/users/cn/jespinosa/phecomp/data/CRG/20120502_FDF_CRG/20120502_FDF_CRG/20120502_FDF_CRG_c12.mtb	349	1188	WWSS	food_sc	4	28076	1335986084	1	0.0399999999999999	0.000236686390532544	6807	1
3	Drink 2	Intake 2	36	28304	1335986312	/users/cn/jespinosa/phecomp/data/CRG/20120502_FDF_CRG/20120502_FDF_CRG/20120502_FDF_CRG_c12.mtb	503	NA	WWSS	water	2	28268	1335986276	1	0.1	0.00277777777777778	6808	1
3	Drink 2	Intake 2	27	28743	1335986751	/users/cn/jespinosa/phecomp/data/CRG/20120502_FDF_CRG/20120502_FDF_CRG/20120502_FDF_CRG_c12.mtb	506	NA	WWSS	water	2	28716	1335986724	1	0.04	0.00148148148148148	6809	1
3	Food 2	Intake 4	358	29791	1335987799	/users/cn/jespinosa/phecomp/data/CRG/20120502_FDF_CRG/20120502_FDF_CRG/20120502_FDF_CRG_c12.mtb	350	5	WWSS	food_sc	4	29433	1335987441	1	0.0600000000000001	0.000167597765363129	6810	1
3	Food 2	Intake 4	45	29841	1335987849	/users/cn/jespinosa/phecomp/data/CRG/20120502_FDF_CRG/20120502_FDF_CRG/20120502_FDF_CRG_c12.mtb	351	516	WWSS	food_sc	4	29796	1335987804	1	0.02	0.000444444444444444	6811	1
3	Drink 2	Intake 2	63	29900	1335987908	/users/cn/jespinosa/phecomp/data/CRG/20120502_FDF_CRG/20120502_FDF_CRG/20120502_FDF_CRG_c12.mtb	507	NA	WWSS	water	2	29837	1335987845	1	0.12	0.0019047619047619	6812	1
3	Food 1	Intake 3	371	30728	1335988736	/users/cn/jespinosa/phecomp/data/CRG/20120502_FDF_CRG/20120502_FDF_CRG/20120502_FDF_CRG_c12.mtb	103	1347	WWSS	food_sc	3	30357	1335988365	1	0.06	0.000161725067385445	6813	1
3	Drink 2	Intake 2	12	30822	1335988830	/users/cn/jespinosa/phecomp/data/CRG/20120502_FDF_CRG/20120502_FDF_CRG/20120502_FDF_CRG_c12.mtb	511	NA	WWSS	water	2	30810	1335988818	1	0.0599999999999999	0.00499999999999999	6814	1
3	Drink 2	Intake 2	94	31202	1335989210	/users/cn/jespinosa/phecomp/data/CRG/20120502_FDF_CRG/20120502_FDF_CRG/20120502_FDF_CRG_c12.mtb	514	NA	WWSS	water	2	31108	1335989116	1	0.02	0.000212765957446809	6815	1
3	Drink 2	Intake 2	20	31809	1335989817	/users/cn/jespinosa/phecomp/data/CRG/20120502_FDF_CRG/20120502_FDF_CRG/20120502_FDF_CRG_c12.mtb	519	NA	WWSS	water	2	31789	1335989797	1	0.02	0.001	6816	1
3	Food 2	Intake 4	644	32719	1335990727	/users/cn/jespinosa/phecomp/data/CRG/20120502_FDF_CRG/20120502_FDF_CRG/20120502_FDF_CRG_c12.mtb	358	2796	WWSS	food_sc	4	32075	1335990083	1	0.26	0.000403726708074534	6817	1
3	Drink 2	Intake 2	55	32773	1335990781	/users/cn/jespinosa/phecomp/data/CRG/20120502_FDF_CRG/20120502_FDF_CRG/20120502_FDF_CRG_c12.mtb	521	NA	WWSS	water	2	32718	1335990726	1	0.12	0.00218181818181818	6818	1
3	Drink 2	Intake 2	20	33019	1335991027	/users/cn/jespinosa/phecomp/data/CRG/20120502_FDF_CRG/20120502_FDF_CRG/20120502_FDF_CRG_c12.mtb	524	NA	WWSS	water	2	32999	1335991007	1	0.02	0.001	6819	1
3	Drink 2	Intake 2	31	33085	1335991093	/users/cn/jespinosa/phecomp/data/CRG/20120502_FDF_CRG/20120502_FDF_CRG/20120502_FDF_CRG_c12.mtb	525	NA	WWSS	water	2	33054	1335991062	1	0.0399999999999999	0.00129032258064516	6820	1
3	Drink 2	Intake 2	38	33649	1335991657	/users/cn/jespinosa/phecomp/data/CRG/20120502_FDF_CRG/20120502_FDF_CRG/20120502_FDF_CRG_c12.mtb	530	NA	WWSS	water	2	33611	1335991619	1	0.0600000000000001	0.00157894736842106	6821	1
3	Food 2	Intake 4	170	35685	1335993693	/users/cn/jespinosa/phecomp/data/CRG/20120502_FDF_CRG/20120502_FDF_CRG/20120502_FDF_CRG_c12.mtb	363	871	WWSS	food_sc	4	35515	1335993523	1	0.02	0.000117647058823529	6822	1
3	Drink 2	Intake 2	20	35994	1335994002	/users/cn/jespinosa/phecomp/data/CRG/20120502_FDF_CRG/20120502_FDF_CRG/20120502_FDF_CRG_c12.mtb	535	NA	WWSS	water	2	35974	1335993982	1	0.04	0.002	6823	1
3	Food 2	Intake 4	683	37239	1335995247	/users/cn/jespinosa/phecomp/data/CRG/20120502_FDF_CRG/20120502_FDF_CRG/20120502_FDF_CRG_c12.mtb	366	601	WWSS	food_sc	4	36556	1335994564	1	0.22	0.000322108345534407	6824	1
3	Drink 2	Intake 2	19	37252	1335995260	/users/cn/jespinosa/phecomp/data/CRG/20120502_FDF_CRG/20120502_FDF_CRG/20120502_FDF_CRG_c12.mtb	536	NA	WWSS	water	2	37233	1335995241	1	0.02	0.00105263157894737	6825	1
3	Drink 1	Intake 1	17	37400	1335995408	/users/cn/jespinosa/phecomp/data/CRG/20120502_FDF_CRG/20120502_FDF_CRG/20120502_FDF_CRG_c12.mtb	66	NA	WWSS	water	1	37383	1335995391	1	0.02	0.00117647058823529	6826	1
3	Drink 2	Intake 2	25	37423	1335995431	/users/cn/jespinosa/phecomp/data/CRG/20120502_FDF_CRG/20120502_FDF_CRG/20120502_FDF_CRG_c12.mtb	537	NA	WWSS	water	2	37398	1335995406	1	0.02	0.0008	6827	1
3	Drink 2	Intake 2	28	37731	1335995739	/users/cn/jespinosa/phecomp/data/CRG/20120502_FDF_CRG/20120502_FDF_CRG/20120502_FDF_CRG_c12.mtb	539	NA	WWSS	water	2	37703	1335995711	1	0.0599999999999998	0.00214285714285714	6828	1
3	Food 2	Intake 4	121	37961	1335995969	/users/cn/jespinosa/phecomp/data/CRG/20120502_FDF_CRG/20120502_FDF_CRG/20120502_FDF_CRG_c12.mtb	369	147	WWSS	food_sc	4	37840	1335995848	1	0.04	0.000330578512396694	6829	1
3	Drink 2	Intake 2	12	38112	1335996120	/users/cn/jespinosa/phecomp/data/CRG/20120502_FDF_CRG/20120502_FDF_CRG/20120502_FDF_CRG_c12.mtb	541	NA	WWSS	water	2	38100	1335996108	1	0.02	0.00166666666666667	6830	1
3	Food 1	Intake 3	157	38265	1335996273	/users/cn/jespinosa/phecomp/data/CRG/20120502_FDF_CRG/20120502_FDF_CRG/20120502_FDF_CRG_c12.mtb	108	320	WWSS	food_sc	3	38108	1335996116	1	0.02	0.000127388535031847	6831	1
3	Drink 2	Intake 2	36	38302	1335996310	/users/cn/jespinosa/phecomp/data/CRG/20120502_FDF_CRG/20120502_FDF_CRG/20120502_FDF_CRG_c12.mtb	542	NA	WWSS	water	2	38266	1335996274	1	0.1	0.00277777777777778	6832	1
3	Drink 2	Intake 2	36	38585	1335996593	/users/cn/jespinosa/phecomp/data/CRG/20120502_FDF_CRG/20120502_FDF_CRG/20120502_FDF_CRG_c12.mtb	545	NA	WWSS	water	2	38549	1335996557	1	0.0999999999999999	0.00277777777777777	6833	1
3	Food 2	Intake 4	178	38763	1335996771	/users/cn/jespinosa/phecomp/data/CRG/20120502_FDF_CRG/20120502_FDF_CRG/20120502_FDF_CRG_c12.mtb	372	392	WWSS	food_sc	4	38585	1335996593	1	0.02	0.000112359550561798	6834	1
3	Food 1	Intake 3	96	39251	1335997259	/users/cn/jespinosa/phecomp/data/CRG/20120502_FDF_CRG/20120502_FDF_CRG/20120502_FDF_CRG_c12.mtb	110	177	WWSS	food_sc	3	39155	1335997163	1	0.04	0.000416666666666667	6835	1
3	Drink 1	Intake 1	17	39277	1335997285	/users/cn/jespinosa/phecomp/data/CRG/20120502_FDF_CRG/20120502_FDF_CRG/20120502_FDF_CRG_c12.mtb	68	NA	WWSS	water	1	39260	1335997268	1	0.02	0.00117647058823529	6836	1
3	Food 1	Intake 3	163	39591	1335997599	/users/cn/jespinosa/phecomp/data/CRG/20120502_FDF_CRG/20120502_FDF_CRG/20120502_FDF_CRG_c12.mtb	111	278	WWSS	food_sc	3	39428	1335997436	1	0.06	0.000368098159509202	6837	1
3	Drink 2	Intake 2	24	39636	1335997644	/users/cn/jespinosa/phecomp/data/CRG/20120502_FDF_CRG/20120502_FDF_CRG/20120502_FDF_CRG_c12.mtb	552	NA	WWSS	water	2	39612	1335997620	1	0.0800000000000001	0.00333333333333334	6838	1
3	Food 2	Intake 4	189	40058	1335998066	/users/cn/jespinosa/phecomp/data/CRG/20120502_FDF_CRG/20120502_FDF_CRG/20120502_FDF_CRG_c12.mtb	376	17	WWSS	food_sc	4	39869	1335997877	1	0.04	0.000211640211640212	6839	1
3	Food 2	Intake 4	101	40176	1335998184	/users/cn/jespinosa/phecomp/data/CRG/20120502_FDF_CRG/20120502_FDF_CRG/20120502_FDF_CRG_c12.mtb	377	868	WWSS	food_sc	4	40075	1335998083	1	0.04	0.000396039603960396	6840	1
3	Drink 2	Intake 2	58	40231	1335998239	/users/cn/jespinosa/phecomp/data/CRG/20120502_FDF_CRG/20120502_FDF_CRG/20120502_FDF_CRG_c12.mtb	554	NA	WWSS	water	2	40173	1335998181	1	0.12	0.00206896551724138	6841	1
3	Food 2	Intake 4	316	41360	1335999368	/users/cn/jespinosa/phecomp/data/CRG/20120502_FDF_CRG/20120502_FDF_CRG/20120502_FDF_CRG_c12.mtb	379	64	WWSS	food_sc	4	41044	1335999052	1	0.0399999999999998	0.000126582278481012	6842	1
3	Food 2	Intake 4	122	41546	1335999554	/users/cn/jespinosa/phecomp/data/CRG/20120502_FDF_CRG/20120502_FDF_CRG/20120502_FDF_CRG_c12.mtb	380	351	WWSS	food_sc	4	41424	1335999432	1	0.02	0.000163934426229508	6843	1
3	Drink 2	Intake 2	35	41619	1335999627	/users/cn/jespinosa/phecomp/data/CRG/20120502_FDF_CRG/20120502_FDF_CRG/20120502_FDF_CRG_c12.mtb	562	NA	WWSS	water	2	41584	1335999592	1	0.1	0.00285714285714286	6844	1
3	Food 1	Intake 3	94	41991	1335999999	/users/cn/jespinosa/phecomp/data/CRG/20120502_FDF_CRG/20120502_FDF_CRG/20120502_FDF_CRG_c12.mtb	112	13	WWSS	food_sc	3	41897	1335999905	1	0.02	0.000212765957446809	6845	1
3	Food 2	Intake 4	100	42104	1336000112	/users/cn/jespinosa/phecomp/data/CRG/20120502_FDF_CRG/20120502_FDF_CRG/20120502_FDF_CRG_c12.mtb	382	379	WWSS	food_sc	4	42004	1336000012	1	0.02	0.0002	6846	1
3	Food 1	Intake 3	92	42575	1336000583	/users/cn/jespinosa/phecomp/data/CRG/20120502_FDF_CRG/20120502_FDF_CRG/20120502_FDF_CRG_c12.mtb	113	136	WWSS	food_sc	3	42483	1336000491	1	0.02	0.000217391304347826	6847	1
3	Food 2	Intake 4	120	42831	1336000839	/users/cn/jespinosa/phecomp/data/CRG/20120502_FDF_CRG/20120502_FDF_CRG/20120502_FDF_CRG_c12.mtb	385	1505	WWSS	food_sc	4	42711	1336000719	1	0.02	0.000166666666666667	6848	1
3	Drink 2	Intake 2	31	42945	1336000953	/users/cn/jespinosa/phecomp/data/CRG/20120502_FDF_CRG/20120502_FDF_CRG/20120502_FDF_CRG_c12.mtb	568	NA	WWSS	water	2	42914	1336000922	1	0.1	0.0032258064516129	6849	1
3	Food 1	Intake 3	200	44536	1336002544	/users/cn/jespinosa/phecomp/data/CRG/20120502_FDF_CRG/20120502_FDF_CRG/20120502_FDF_CRG_c12.mtb	114	1010	WWSS	food_sc	3	44336	1336002344	1	0.02	0.0001	6850	1
3	Drink 2	Intake 2	13	44957	1336002965	/users/cn/jespinosa/phecomp/data/CRG/20120502_FDF_CRG/20120502_FDF_CRG/20120502_FDF_CRG_c12.mtb	580	NA	WWSS	water	2	44944	1336002952	1	0.02	0.00153846153846154	6851	1
3	Food 2	Intake 4	64	45610	1336003618	/users/cn/jespinosa/phecomp/data/CRG/20120502_FDF_CRG/20120502_FDF_CRG/20120502_FDF_CRG_c12.mtb	390	4007	WWSS	food_sc	4	45546	1336003554	1	0.02	0.0003125	6852	1
3	Food 2	Intake 4	118	49735	1336007743	/users/cn/jespinosa/phecomp/data/CRG/20120502_FDF_CRG/20120502_FDF_CRG/20120502_FDF_CRG_c12.mtb	391	COLL	WWSS	food_sc	4	49617	1336007625	1	0.02	0.000169491525423729	6853	1
3	Food 1	Intake 3	36	49760	1336007768	/users/cn/jespinosa/phecomp/data/CRG/20120502_FDF_CRG/20120502_FDF_CRG/20120502_FDF_CRG_c12.mtb	115	28	WWSS	food_sc	3	49724	1336007732	1	0.02	0.000555555555555556	6854	1
3	Food 2	Intake 4	14	49802	1336007810	/users/cn/jespinosa/phecomp/data/CRG/20120502_FDF_CRG/20120502_FDF_CRG/20120502_FDF_CRG_c12.mtb	393	6732	WWSS	food_sc	4	49788	1336007796	1	0.02	0.00142857142857143	6855	1
3	Drink 2	Intake 2	25	49917	1336007925	/users/cn/jespinosa/phecomp/data/CRG/20120502_FDF_CRG/20120502_FDF_CRG/20120502_FDF_CRG_c12.mtb	583	NA	WWSS	water	2	49892	1336007900	1	0.0600000000000001	0.0024	6856	1
3	Drink 2	Intake 2	24	49973	1336007981	/users/cn/jespinosa/phecomp/data/CRG/20120502_FDF_CRG/20120502_FDF_CRG/20120502_FDF_CRG_c12.mtb	584	NA	WWSS	water	2	49949	1336007957	1	0.04	0.00166666666666667	6857	1
3	Drink 2	Intake 2	15	50096	1336008104	/users/cn/jespinosa/phecomp/data/CRG/20120502_FDF_CRG/20120502_FDF_CRG/20120502_FDF_CRG_c12.mtb	586	NA	WWSS	water	2	50081	1336008089	1	0.02	0.00133333333333333	6858	1
3	Food 1	Intake 3	151	56685	1336014693	/users/cn/jespinosa/phecomp/data/CRG/20120502_FDF_CRG/20120502_FDF_CRG/20120502_FDF_CRG_c12.mtb	118	25	WWSS	food_sc	3	56534	1336014542	1	0.04	0.000264900662251656	6859	1
3	Food 1	Intake 3	106	56816	1336014824	/users/cn/jespinosa/phecomp/data/CRG/20120502_FDF_CRG/20120502_FDF_CRG/20120502_FDF_CRG_c12.mtb	119	342	WWSS	food_sc	3	56710	1336014718	1	0.02	0.000188679245283019	6860	1
3	Drink 2	Intake 2	25	56955	1336014963	/users/cn/jespinosa/phecomp/data/CRG/20120502_FDF_CRG/20120502_FDF_CRG/20120502_FDF_CRG_c12.mtb	587	NA	WWSS	water	2	56930	1336014938	1	0.02	0.0008	6861	1
3	Drink 2	Intake 2	44	57087	1336015095	/users/cn/jespinosa/phecomp/data/CRG/20120502_FDF_CRG/20120502_FDF_CRG/20120502_FDF_CRG_c12.mtb	588	NA	WWSS	water	2	57043	1336015051	1	0.12	0.00272727272727273	6862	1
3	Food 1	Intake 3	86	57244	1336015252	/users/cn/jespinosa/phecomp/data/CRG/20120502_FDF_CRG/20120502_FDF_CRG/20120502_FDF_CRG_c12.mtb	121	3498	WWSS	food_sc	3	57158	1336015166	1	0.02	0.000232558139534884	6863	1
3	Drink 2	Intake 2	18	57568	1336015576	/users/cn/jespinosa/phecomp/data/CRG/20120502_FDF_CRG/20120502_FDF_CRG/20120502_FDF_CRG_c12.mtb	590	NA	WWSS	water	2	57550	1336015558	1	0.02	0.00111111111111111	6864	1
3	Food 1	Intake 3	89	60831	1336018839	/users/cn/jespinosa/phecomp/data/CRG/20120502_FDF_CRG/20120502_FDF_CRG/20120502_FDF_CRG_c12.mtb	123	9	WWSS	food_sc	3	60742	1336018750	1	0.02	0.000224719101123596	6865	1
3	Food 1	Intake 3	205	61045	1336019053	/users/cn/jespinosa/phecomp/data/CRG/20120502_FDF_CRG/20120502_FDF_CRG/20120502_FDF_CRG_c12.mtb	124	14	WWSS	food_sc	3	60840	1336018848	1	0.1	0.000487804878048781	6866	1
3	Food 1	Intake 3	24	61083	1336019091	/users/cn/jespinosa/phecomp/data/CRG/20120502_FDF_CRG/20120502_FDF_CRG/20120502_FDF_CRG_c12.mtb	125	6	WWSS	food_sc	3	61059	1336019067	1	0.02	0.000833333333333333	6867	1
3	Food 1	Intake 3	44	61133	1336019141	/users/cn/jespinosa/phecomp/data/CRG/20120502_FDF_CRG/20120502_FDF_CRG/20120502_FDF_CRG_c12.mtb	126	2854	WWSS	food_sc	3	61089	1336019097	1	0.04	0.000909090909090909	6868	1
3	Drink 1	Intake 1	18	61293	1336019301	/users/cn/jespinosa/phecomp/data/CRG/20120502_FDF_CRG/20120502_FDF_CRG/20120502_FDF_CRG_c12.mtb	75	NA	WWSS	water	1	61275	1336019283	1	0.06	0.00333333333333333	6869	1
3	Drink 1	Intake 1	28	61421	1336019429	/users/cn/jespinosa/phecomp/data/CRG/20120502_FDF_CRG/20120502_FDF_CRG/20120502_FDF_CRG_c12.mtb	76	NA	WWSS	water	1	61393	1336019401	1	0.08	0.00285714285714286	6870	1
3	Drink 1	Intake 1	19	61903	1336019911	/users/cn/jespinosa/phecomp/data/CRG/20120502_FDF_CRG/20120502_FDF_CRG/20120502_FDF_CRG_c12.mtb	77	NA	WWSS	water	1	61884	1336019892	1	0.08	0.00421052631578947	6871	1
3	Drink 1	Intake 1	15	63443	1336021451	/users/cn/jespinosa/phecomp/data/CRG/20120502_FDF_CRG/20120502_FDF_CRG/20120502_FDF_CRG_c12.mtb	78	NA	WWSS	water	1	63428	1336021436	1	0.04	0.00266666666666667	6872	1
3	Food 1	Intake 3	127	64114	1336022122	/users/cn/jespinosa/phecomp/data/CRG/20120502_FDF_CRG/20120502_FDF_CRG/20120502_FDF_CRG_c12.mtb	130	4	WWSS	food_sc	3	63987	1336021995	1	0.0399999999999999	0.000314960629921259	6873	1
3	Food 1	Intake 3	274	64392	1336022400	/users/cn/jespinosa/phecomp/data/CRG/20120502_FDF_CRG/20120502_FDF_CRG/20120502_FDF_CRG_c12.mtb	131	401	WWSS	food_sc	3	64118	1336022126	1	0.0600000000000001	0.000218978102189781	6874	1
3	Drink 2	Intake 2	25	64490	1336022498	/users/cn/jespinosa/phecomp/data/CRG/20120502_FDF_CRG/20120502_FDF_CRG/20120502_FDF_CRG_c12.mtb	592	NA	WWSS	water	2	64465	1336022473	1	0.0600000000000001	0.0024	6875	1
3	Food 1	Intake 3	27	64820	1336022828	/users/cn/jespinosa/phecomp/data/CRG/20120502_FDF_CRG/20120502_FDF_CRG/20120502_FDF_CRG_c12.mtb	133	26	WWSS	food_sc	3	64793	1336022801	1	0.02	0.000740740740740741	6876	1
3	Food 1	Intake 3	73	64919	1336022927	/users/cn/jespinosa/phecomp/data/CRG/20120502_FDF_CRG/20120502_FDF_CRG/20120502_FDF_CRG_c12.mtb	134	965	WWSS	food_sc	3	64846	1336022854	1	0.0399999999999999	0.000547945205479451	6877	1
3	Drink 2	Intake 2	17	64964	1336022972	/users/cn/jespinosa/phecomp/data/CRG/20120502_FDF_CRG/20120502_FDF_CRG/20120502_FDF_CRG_c12.mtb	595	NA	WWSS	water	2	64947	1336022955	1	0.02	0.00117647058823529	6878	1
3	Drink 2	Intake 2	29	65057	1336023065	/users/cn/jespinosa/phecomp/data/CRG/20120502_FDF_CRG/20120502_FDF_CRG/20120502_FDF_CRG_c12.mtb	596	NA	WWSS	water	2	65028	1336023036	1	0.0599999999999996	0.00206896551724137	6879	1
3	Drink 2	Intake 2	15	65133	1336023141	/users/cn/jespinosa/phecomp/data/CRG/20120502_FDF_CRG/20120502_FDF_CRG/20120502_FDF_CRG_c12.mtb	597	NA	WWSS	water	2	65118	1336023126	1	0.0200000000000005	0.00133333333333337	6880	1
3	Drink 2	Intake 2	26	65665	1336023673	/users/cn/jespinosa/phecomp/data/CRG/20120502_FDF_CRG/20120502_FDF_CRG/20120502_FDF_CRG_c12.mtb	598	NA	WWSS	water	2	65639	1336023647	1	0.0999999999999996	0.00384615384615383	6881	1
3	Food 1	Intake 3	57	65941	1336023949	/users/cn/jespinosa/phecomp/data/CRG/20120502_FDF_CRG/20120502_FDF_CRG/20120502_FDF_CRG_c12.mtb	138	9	WWSS	food_sc	3	65884	1336023892	1	0.02	0.000350877192982456	6882	1
3	Food 1	Intake 3	195	66145	1336024153	/users/cn/jespinosa/phecomp/data/CRG/20120502_FDF_CRG/20120502_FDF_CRG/20120502_FDF_CRG_c12.mtb	139	812	WWSS	food_sc	3	65950	1336023958	1	0.0600000000000001	0.000307692307692308	6883	1
3	Drink 2	Intake 2	20	66175	1336024183	/users/cn/jespinosa/phecomp/data/CRG/20120502_FDF_CRG/20120502_FDF_CRG/20120502_FDF_CRG_c12.mtb	599	NA	WWSS	water	2	66155	1336024163	1	0.04	0.002	6884	1
3	Drink 2	Intake 2	87	66411	1336024419	/users/cn/jespinosa/phecomp/data/CRG/20120502_FDF_CRG/20120502_FDF_CRG/20120502_FDF_CRG_c12.mtb	601	NA	WWSS	water	2	66324	1336024332	1	0.02	0.000229885057471264	6885	1
3	Drink 2	Intake 2	57	66475	1336024483	/users/cn/jespinosa/phecomp/data/CRG/20120502_FDF_CRG/20120502_FDF_CRG/20120502_FDF_CRG_c12.mtb	602	NA	WWSS	water	2	66418	1336024426	1	0.02	0.000350877192982456	6886	1
3	Drink 2	Intake 2	143	66652	1336024660	/users/cn/jespinosa/phecomp/data/CRG/20120502_FDF_CRG/20120502_FDF_CRG/20120502_FDF_CRG_c12.mtb	603	NA	WWSS	water	2	66509	1336024517	1	0.02	0.00013986013986014	6887	1
3	Drink 1	Intake 1	17	66719	1336024727	/users/cn/jespinosa/phecomp/data/CRG/20120502_FDF_CRG/20120502_FDF_CRG/20120502_FDF_CRG_c12.mtb	80	NA	WWSS	water	1	66702	1336024710	1	0.02	0.00117647058823529	6888	1
3	Food 1	Intake 3	260	67217	1336025225	/users/cn/jespinosa/phecomp/data/CRG/20120502_FDF_CRG/20120502_FDF_CRG/20120502_FDF_CRG_c12.mtb	141	99	WWSS	food_sc	3	66957	1336024965	1	0.0599999999999999	0.00023076923076923	6889	1
3	Food 1	Intake 3	139	67455	1336025463	/users/cn/jespinosa/phecomp/data/CRG/20120502_FDF_CRG/20120502_FDF_CRG/20120502_FDF_CRG_c12.mtb	142	313	WWSS	food_sc	3	67316	1336025324	1	0.02	0.000143884892086331	6890	1
3	Drink 2	Intake 2	23	67551	1336025559	/users/cn/jespinosa/phecomp/data/CRG/20120502_FDF_CRG/20120502_FDF_CRG/20120502_FDF_CRG_c12.mtb	609	NA	WWSS	water	2	67528	1336025536	1	0.02	0.000869565217391304	6891	1
3	Drink 2	Intake 2	31	67636	1336025644	/users/cn/jespinosa/phecomp/data/CRG/20120502_FDF_CRG/20120502_FDF_CRG/20120502_FDF_CRG_c12.mtb	610	NA	WWSS	water	2	67605	1336025613	1	0.1	0.0032258064516129	6892	1
3	Food 1	Intake 3	174	67942	1336025950	/users/cn/jespinosa/phecomp/data/CRG/20120502_FDF_CRG/20120502_FDF_CRG/20120502_FDF_CRG_c12.mtb	143	6289	WWSS	food_sc	3	67768	1336025776	1	0.04	0.000229885057471264	6893	1
3	Drink 1	Intake 1	13	68128	1336026136	/users/cn/jespinosa/phecomp/data/CRG/20120502_FDF_CRG/20120502_FDF_CRG/20120502_FDF_CRG_c12.mtb	81	NA	WWSS	water	1	68115	1336026123	1	0.02	0.00153846153846154	6894	1
3	Drink 2	Intake 2	16	68643	1336026651	/users/cn/jespinosa/phecomp/data/CRG/20120502_FDF_CRG/20120502_FDF_CRG/20120502_FDF_CRG_c12.mtb	615	NA	WWSS	water	2	68627	1336026635	1	0.02	0.00125	6895	1
3	Drink 2	Intake 2	21	74186	1336032194	/users/cn/jespinosa/phecomp/data/CRG/20120502_FDF_CRG/20120502_FDF_CRG/20120502_FDF_CRG_c12.mtb	617	NA	WWSS	water	2	74165	1336032173	1	0.02	0.000952380952380952	6896	1
3	Food 1	Intake 3	94	74325	1336032333	/users/cn/jespinosa/phecomp/data/CRG/20120502_FDF_CRG/20120502_FDF_CRG/20120502_FDF_CRG_c12.mtb	148	29842	WWSS	food_sc	3	74231	1336032239	1	0.02	0.000212765957446809	6897	1
3	Drink 2	Intake 2	16	74938	1336032946	/users/cn/jespinosa/phecomp/data/CRG/20120502_FDF_CRG/20120502_FDF_CRG/20120502_FDF_CRG_c12.mtb	618	NA	WWSS	water	2	74922	1336032930	1	0.04	0.0025	6898	1
3	Drink 2	Intake 2	42	75259	1336033267	/users/cn/jespinosa/phecomp/data/CRG/20120502_FDF_CRG/20120502_FDF_CRG/20120502_FDF_CRG_c12.mtb	620	NA	WWSS	water	2	75217	1336033225	1	0.1	0.00238095238095238	6899	1
3	Drink 2	Intake 2	47	80193	1336038201	/users/cn/jespinosa/phecomp/data/CRG/20120502_FDF_CRG/20120502_FDF_CRG/20120502_FDF_CRG_c12.mtb	628	NA	WWSS	water	2	80146	1336038154	1	0.02	0.000425531914893617	6900	1
3	Drink 2	Intake 2	17	81571	1336039579	/users/cn/jespinosa/phecomp/data/CRG/20120502_FDF_CRG/20120502_FDF_CRG/20120502_FDF_CRG_c12.mtb	633	NA	WWSS	water	2	81554	1336039562	1	0.02	0.00117647058823529	6901	1
3	Food 1	Intake 3	232	104399	1336062407	/users/cn/jespinosa/phecomp/data/CRG/20120502_FDF_CRG/20120502_FDF_CRG/20120502_FDF_CRG_c12.mtb	155	1551	WWSS	food_sc	3	104167	1336062175	1	0.02	8.62068965517241e-05	6902	1
3	Drink 2	Intake 2	20	104781	1336062789	/users/cn/jespinosa/phecomp/data/CRG/20120502_FDF_CRG/20120502_FDF_CRG/20120502_FDF_CRG_c12.mtb	645	NA	WWSS	water	2	104761	1336062769	1	0.02	0.001	6903	1
3	Drink 2	Intake 2	14	105296	1336063304	/users/cn/jespinosa/phecomp/data/CRG/20120502_FDF_CRG/20120502_FDF_CRG/20120502_FDF_CRG_c12.mtb	646	NA	WWSS	water	2	105282	1336063290	1	0.02	0.00142857142857143	6904	1
3	Drink 2	Intake 2	14	105467	1336063475	/users/cn/jespinosa/phecomp/data/CRG/20120502_FDF_CRG/20120502_FDF_CRG/20120502_FDF_CRG_c12.mtb	647	NA	WWSS	water	2	105453	1336063461	1	0.02	0.00142857142857143	6905	1
3	Drink 2	Intake 2	13	105707	1336063715	/users/cn/jespinosa/phecomp/data/CRG/20120502_FDF_CRG/20120502_FDF_CRG/20120502_FDF_CRG_c12.mtb	650	NA	WWSS	water	2	105694	1336063702	1	0.02	0.00153846153846154	6906	1
3	Food 1	Intake 3	140	106090	1336064098	/users/cn/jespinosa/phecomp/data/CRG/20120502_FDF_CRG/20120502_FDF_CRG/20120502_FDF_CRG_c12.mtb	161	4218	WWSS	food_sc	3	105950	1336063958	1	0.02	0.000142857142857143	6907	1
3	Food 1	Intake 3	679	110987	1336068995	/users/cn/jespinosa/phecomp/data/CRG/20120502_FDF_CRG/20120502_FDF_CRG/20120502_FDF_CRG_c12.mtb	163	1620	WWSS	food_sc	3	110308	1336068316	1	0.14	0.000206185567010309	6908	1
3	Drink 2	Intake 2	23	111030	1336069038	/users/cn/jespinosa/phecomp/data/CRG/20120502_FDF_CRG/20120502_FDF_CRG/20120502_FDF_CRG_c12.mtb	652	NA	WWSS	water	2	111007	1336069015	1	0.0800000000000001	0.00347826086956522	6909	1
3	Drink 2	Intake 2	84	111265	1336069273	/users/cn/jespinosa/phecomp/data/CRG/20120502_FDF_CRG/20120502_FDF_CRG/20120502_FDF_CRG_c12.mtb	653	NA	WWSS	water	2	111181	1336069189	1	0.02	0.000238095238095238	6910	1
3	Drink 2	Intake 2	13	111392	1336069400	/users/cn/jespinosa/phecomp/data/CRG/20120502_FDF_CRG/20120502_FDF_CRG/20120502_FDF_CRG_c12.mtb	655	NA	WWSS	water	2	111379	1336069387	1	0.02	0.00153846153846154	6911	1
3	Drink 1	Intake 1	11	112447	1336070455	/users/cn/jespinosa/phecomp/data/CRG/20120502_FDF_CRG/20120502_FDF_CRG/20120502_FDF_CRG_c12.mtb	89	NA	WWSS	water	1	112436	1336070444	1	0.02	0.00181818181818182	6912	1
3	Food 1	Intake 3	339	112946	1336070954	/users/cn/jespinosa/phecomp/data/CRG/20120502_FDF_CRG/20120502_FDF_CRG/20120502_FDF_CRG_c12.mtb	166	224	WWSS	food_sc	3	112607	1336070615	1	0.0599999999999998	0.000176991150442477	6913	1
3	Drink 2	Intake 2	18	112964	1336070972	/users/cn/jespinosa/phecomp/data/CRG/20120502_FDF_CRG/20120502_FDF_CRG/20120502_FDF_CRG_c12.mtb	659	NA	WWSS	water	2	112946	1336070954	1	0.0600000000000001	0.00333333333333334	6914	1
3	Drink 2	Intake 2	20	113061	1336071069	/users/cn/jespinosa/phecomp/data/CRG/20120502_FDF_CRG/20120502_FDF_CRG/20120502_FDF_CRG_c12.mtb	660	NA	WWSS	water	2	113041	1336071049	1	0.04	0.002	6915	1
3	Food 1	Intake 3	618	113788	1336071796	/users/cn/jespinosa/phecomp/data/CRG/20120502_FDF_CRG/20120502_FDF_CRG/20120502_FDF_CRG_c12.mtb	168	444	WWSS	food_sc	3	113170	1336071178	1	0.2	0.000323624595469256	6916	1
3	Drink 2	Intake 2	26	113828	1336071836	/users/cn/jespinosa/phecomp/data/CRG/20120502_FDF_CRG/20120502_FDF_CRG/20120502_FDF_CRG_c12.mtb	661	NA	WWSS	water	2	113802	1336071810	1	0.0800000000000001	0.00307692307692308	6917	1
3	Drink 2	Intake 2	26	114095	1336072103	/users/cn/jespinosa/phecomp/data/CRG/20120502_FDF_CRG/20120502_FDF_CRG/20120502_FDF_CRG_c12.mtb	663	NA	WWSS	water	2	114069	1336072077	1	0.0399999999999996	0.00153846153846152	6918	1
3	Drink 1	Intake 1	15	114100	1336072108	/users/cn/jespinosa/phecomp/data/CRG/20120502_FDF_CRG/20120502_FDF_CRG/20120502_FDF_CRG_c12.mtb	90	NA	WWSS	water	1	114085	1336072093	1	0.02	0.00133333333333333	6919	1
3	Food 1	Intake 3	326	114558	1336072566	/users/cn/jespinosa/phecomp/data/CRG/20120502_FDF_CRG/20120502_FDF_CRG/20120502_FDF_CRG_c12.mtb	169	47	WWSS	food_sc	3	114232	1336072240	1	0.0800000000000001	0.000245398773006135	6920	1
3	Food 1	Intake 3	88	114693	1336072701	/users/cn/jespinosa/phecomp/data/CRG/20120502_FDF_CRG/20120502_FDF_CRG/20120502_FDF_CRG_c12.mtb	170	258	WWSS	food_sc	3	114605	1336072613	1	0.02	0.000227272727272727	6921	1
3	Drink 2	Intake 2	15	114705	1336072713	/users/cn/jespinosa/phecomp/data/CRG/20120502_FDF_CRG/20120502_FDF_CRG/20120502_FDF_CRG_c12.mtb	665	NA	WWSS	water	2	114690	1336072698	1	0.0600000000000001	0.00400000000000001	6922	1
3	Food 1	Intake 3	229	115180	1336073188	/users/cn/jespinosa/phecomp/data/CRG/20120502_FDF_CRG/20120502_FDF_CRG/20120502_FDF_CRG_c12.mtb	172	2500	WWSS	food_sc	3	114951	1336072959	1	0.04	0.000174672489082969	6923	1
3	Drink 2	Intake 2	18	115194	1336073202	/users/cn/jespinosa/phecomp/data/CRG/20120502_FDF_CRG/20120502_FDF_CRG/20120502_FDF_CRG_c12.mtb	667	NA	WWSS	water	2	115176	1336073184	1	0.0600000000000001	0.00333333333333334	6924	1
3	Drink 2	Intake 2	14	115521	1336073529	/users/cn/jespinosa/phecomp/data/CRG/20120502_FDF_CRG/20120502_FDF_CRG/20120502_FDF_CRG_c12.mtb	668	NA	WWSS	water	2	115507	1336073515	1	0.02	0.00142857142857143	6925	1
3	Drink 1	Intake 1	16	116701	1336074709	/users/cn/jespinosa/phecomp/data/CRG/20120502_FDF_CRG/20120502_FDF_CRG/20120502_FDF_CRG_c12.mtb	92	NA	WWSS	water	1	116685	1336074693	1	0.02	0.00125	6926	1
3	Food 1	Intake 3	520	118200	1336076208	/users/cn/jespinosa/phecomp/data/CRG/20120502_FDF_CRG/20120502_FDF_CRG/20120502_FDF_CRG_c12.mtb	175	1919	WWSS	food_sc	3	117680	1336075688	1	0.16	0.000307692307692308	6927	1
3	Drink 2	Intake 2	25	118219	1336076227	/users/cn/jespinosa/phecomp/data/CRG/20120502_FDF_CRG/20120502_FDF_CRG/20120502_FDF_CRG_c12.mtb	669	NA	WWSS	water	2	118194	1336076202	1	0.1	0.004	6928	1
3	Drink 2	Intake 2	19	118292	1336076300	/users/cn/jespinosa/phecomp/data/CRG/20120502_FDF_CRG/20120502_FDF_CRG/20120502_FDF_CRG_c12.mtb	670	NA	WWSS	water	2	118273	1336076281	1	0.04	0.00210526315789474	6929	1
3	Drink 2	Intake 2	13	118616	1336076624	/users/cn/jespinosa/phecomp/data/CRG/20120502_FDF_CRG/20120502_FDF_CRG/20120502_FDF_CRG_c12.mtb	671	NA	WWSS	water	2	118603	1336076611	1	0.0600000000000001	0.00461538461538462	6930	1
3	Drink 2	Intake 2	25	119189	1336077197	/users/cn/jespinosa/phecomp/data/CRG/20120502_FDF_CRG/20120502_FDF_CRG/20120502_FDF_CRG_c12.mtb	674	NA	WWSS	water	2	119164	1336077172	1	0.1	0.004	6931	1
3	Food 1	Intake 3	413	120532	1336078540	/users/cn/jespinosa/phecomp/data/CRG/20120502_FDF_CRG/20120502_FDF_CRG/20120502_FDF_CRG_c12.mtb	183	1170	WWSS	food_sc	3	120119	1336078127	1	0.16	0.000387409200968523	6932	1
3	Drink 2	Intake 2	33	120570	1336078578	/users/cn/jespinosa/phecomp/data/CRG/20120502_FDF_CRG/20120502_FDF_CRG/20120502_FDF_CRG_c12.mtb	677	NA	WWSS	water	2	120537	1336078545	1	0.0599999999999996	0.00181818181818181	6933	1
3	Drink 2	Intake 2	23	120653	1336078661	/users/cn/jespinosa/phecomp/data/CRG/20120502_FDF_CRG/20120502_FDF_CRG/20120502_FDF_CRG_c12.mtb	678	NA	WWSS	water	2	120630	1336078638	1	0.0600000000000001	0.00260869565217392	6934	1
3	Drink 1	Intake 1	32	120779	1336078787	/users/cn/jespinosa/phecomp/data/CRG/20120502_FDF_CRG/20120502_FDF_CRG/20120502_FDF_CRG_c12.mtb	97	NA	WWSS	water	1	120747	1336078755	1	0.02	0.000625	6935	1
3	Food 1	Intake 3	196	121898	1336079906	/users/cn/jespinosa/phecomp/data/CRG/20120502_FDF_CRG/20120502_FDF_CRG/20120502_FDF_CRG_c12.mtb	187	676	WWSS	food_sc	3	121702	1336079710	1	0.04	0.000204081632653061	6936	1
3	Drink 2	Intake 2	28	122153	1336080161	/users/cn/jespinosa/phecomp/data/CRG/20120502_FDF_CRG/20120502_FDF_CRG/20120502_FDF_CRG_c12.mtb	683	NA	WWSS	water	2	122125	1336080133	1	0.1	0.00357142857142857	6937	1
3	Food 2	Intake 4	116	122690	1336080698	/users/cn/jespinosa/phecomp/data/CRG/20120502_FDF_CRG/20120502_FDF_CRG/20120502_FDF_CRG_c12.mtb	447	14	WWSS	food_sc	4	122574	1336080582	1	0.02	0.000172413793103448	6938	1
3	Food 2	Intake 4	118	122822	1336080830	/users/cn/jespinosa/phecomp/data/CRG/20120502_FDF_CRG/20120502_FDF_CRG/20120502_FDF_CRG_c12.mtb	448	19	WWSS	food_sc	4	122704	1336080712	1	0.04	0.000338983050847458	6939	1
3	Food 1	Intake 3	264	123105	1336081113	/users/cn/jespinosa/phecomp/data/CRG/20120502_FDF_CRG/20120502_FDF_CRG/20120502_FDF_CRG_c12.mtb	190	3716	WWSS	food_sc	3	122841	1336080849	1	0.02	7.57575757575758e-05	6940	1
3	Drink 2	Intake 2	18	123159	1336081167	/users/cn/jespinosa/phecomp/data/CRG/20120502_FDF_CRG/20120502_FDF_CRG/20120502_FDF_CRG_c12.mtb	684	NA	WWSS	water	2	123141	1336081149	1	0.04	0.00222222222222222	6941	1
3	Drink 1	Intake 1	9	123915	1336081923	/users/cn/jespinosa/phecomp/data/CRG/20120502_FDF_CRG/20120502_FDF_CRG/20120502_FDF_CRG_c12.mtb	99	NA	WWSS	water	1	123906	1336081914	1	0.02	0.00222222222222222	6942	1
3	Drink 2	Intake 2	20	124199	1336082207	/users/cn/jespinosa/phecomp/data/CRG/20120502_FDF_CRG/20120502_FDF_CRG/20120502_FDF_CRG_c12.mtb	687	NA	WWSS	water	2	124179	1336082187	1	0.02	0.001	6943	1
3	Food 1	Intake 3	388	127209	1336085217	/users/cn/jespinosa/phecomp/data/CRG/20120502_FDF_CRG/20120502_FDF_CRG/20120502_FDF_CRG_c12.mtb	191	184	WWSS	food_sc	3	126821	1336084829	1	0.04	0.000103092783505155	6944	1
3	Food 1	Intake 3	296	127689	1336085697	/users/cn/jespinosa/phecomp/data/CRG/20120502_FDF_CRG/20120502_FDF_CRG/20120502_FDF_CRG_c12.mtb	192	193	WWSS	food_sc	3	127393	1336085401	1	0.1	0.000337837837837838	6945	1
3	Drink 2	Intake 2	39	127724	1336085732	/users/cn/jespinosa/phecomp/data/CRG/20120502_FDF_CRG/20120502_FDF_CRG/20120502_FDF_CRG_c12.mtb	688	NA	WWSS	water	2	127685	1336085693	1	0.1	0.00256410256410256	6946	1
3	Drink 2	Intake 2	10	127880	1336085888	/users/cn/jespinosa/phecomp/data/CRG/20120502_FDF_CRG/20120502_FDF_CRG/20120502_FDF_CRG_c12.mtb	689	NA	WWSS	water	2	127870	1336085878	1	0.04	0.004	6947	1
3	Food 2	Intake 4	171	128053	1336086061	/users/cn/jespinosa/phecomp/data/CRG/20120502_FDF_CRG/20120502_FDF_CRG/20120502_FDF_CRG_c12.mtb	455	175	WWSS	food_sc	4	127882	1336085890	1	0.0600000000000001	0.000350877192982457	6948	1
3	Drink 2	Intake 2	25	128196	1336086204	/users/cn/jespinosa/phecomp/data/CRG/20120502_FDF_CRG/20120502_FDF_CRG/20120502_FDF_CRG_c12.mtb	690	NA	WWSS	water	2	128171	1336086179	1	0.04	0.0016	6949	1
3	Food 1	Intake 3	105	128333	1336086341	/users/cn/jespinosa/phecomp/data/CRG/20120502_FDF_CRG/20120502_FDF_CRG/20120502_FDF_CRG_c12.mtb	194	114	WWSS	food_sc	3	128228	1336086236	1	0.02	0.00019047619047619	6950	1
3	Food 2	Intake 4	232	128679	1336086687	/users/cn/jespinosa/phecomp/data/CRG/20120502_FDF_CRG/20120502_FDF_CRG/20120502_FDF_CRG_c12.mtb	457	496	WWSS	food_sc	4	128447	1336086455	1	0.0800000000000001	0.000344827586206897	6951	1
3	Drink 2	Intake 2	32	128708	1336086716	/users/cn/jespinosa/phecomp/data/CRG/20120502_FDF_CRG/20120502_FDF_CRG/20120502_FDF_CRG_c12.mtb	691	NA	WWSS	water	2	128676	1336086684	1	0.0800000000000001	0.0025	6952	1
3	Food 1	Intake 3	143	129318	1336087326	/users/cn/jespinosa/phecomp/data/CRG/20120502_FDF_CRG/20120502_FDF_CRG/20120502_FDF_CRG_c12.mtb	195	1375	WWSS	food_sc	3	129175	1336087183	1	0.0600000000000001	0.00041958041958042	6953	1
3	Drink 2	Intake 2	18	129343	1336087351	/users/cn/jespinosa/phecomp/data/CRG/20120502_FDF_CRG/20120502_FDF_CRG/20120502_FDF_CRG_c12.mtb	693	NA	WWSS	water	2	129325	1336087333	1	0.0200000000000005	0.00111111111111114	6954	1
3	Drink 1	Intake 1	24	129504	1336087512	/users/cn/jespinosa/phecomp/data/CRG/20120502_FDF_CRG/20120502_FDF_CRG/20120502_FDF_CRG_c12.mtb	101	NA	WWSS	water	1	129480	1336087488	1	0.04	0.00166666666666667	6955	1
3	Drink 2	Intake 2	19	129818	1336087826	/users/cn/jespinosa/phecomp/data/CRG/20120502_FDF_CRG/20120502_FDF_CRG/20120502_FDF_CRG_c12.mtb	695	NA	WWSS	water	2	129799	1336087807	1	0.0200000000000005	0.00105263157894739	6956	1
3	Food 2	Intake 4	160	130853	1336088861	/users/cn/jespinosa/phecomp/data/CRG/20120502_FDF_CRG/20120502_FDF_CRG/20120502_FDF_CRG_c12.mtb	462	6	WWSS	food_sc	4	130693	1336088701	1	0.0399999999999998	0.000249999999999999	6957	1
3	Food 2	Intake 4	285	131144	1336089152	/users/cn/jespinosa/phecomp/data/CRG/20120502_FDF_CRG/20120502_FDF_CRG/20120502_FDF_CRG_c12.mtb	463	93	WWSS	food_sc	4	130859	1336088867	1	0.0999999999999999	0.000350877192982456	6958	1
3	Drink 2	Intake 2	29	131185	1336089193	/users/cn/jespinosa/phecomp/data/CRG/20120502_FDF_CRG/20120502_FDF_CRG/20120502_FDF_CRG_c12.mtb	699	NA	WWSS	water	2	131156	1336089164	1	0.04	0.00137931034482759	6959	1
3	Food 2	Intake 4	102	131339	1336089347	/users/cn/jespinosa/phecomp/data/CRG/20120502_FDF_CRG/20120502_FDF_CRG/20120502_FDF_CRG_c12.mtb	464	7031	WWSS	food_sc	4	131237	1336089245	1	0.02	0.000196078431372549	6960	1
3	Drink 2	Intake 2	16	131919	1336089927	/users/cn/jespinosa/phecomp/data/CRG/20120502_FDF_CRG/20120502_FDF_CRG/20120502_FDF_CRG_c12.mtb	701	NA	WWSS	water	2	131903	1336089911	1	0.04	0.0025	6961	1
3	Drink 2	Intake 2	29	132212	1336090220	/users/cn/jespinosa/phecomp/data/CRG/20120502_FDF_CRG/20120502_FDF_CRG/20120502_FDF_CRG_c12.mtb	702	NA	WWSS	water	2	132183	1336090191	1	0.04	0.00137931034482759	6962	1
3	Drink 1	Intake 1	16	132757	1336090765	/users/cn/jespinosa/phecomp/data/CRG/20120502_FDF_CRG/20120502_FDF_CRG/20120502_FDF_CRG_c12.mtb	104	NA	WWSS	water	1	132741	1336090749	1	0.02	0.00125	6963	1
3	Food 1	Intake 3	166	138536	1336096544	/users/cn/jespinosa/phecomp/data/CRG/20120502_FDF_CRG/20120502_FDF_CRG/20120502_FDF_CRG_c12.mtb	198	20	WWSS	food_sc	3	138370	1336096378	1	0.0600000000000001	0.000361445783132531	6964	1
3	Food 1	Intake 3	23	138579	1336096587	/users/cn/jespinosa/phecomp/data/CRG/20120502_FDF_CRG/20120502_FDF_CRG/20120502_FDF_CRG_c12.mtb	199	5	WWSS	food_sc	3	138556	1336096564	1	0.02	0.000869565217391304	6965	1
3	Food 1	Intake 3	145	138729	1336096737	/users/cn/jespinosa/phecomp/data/CRG/20120502_FDF_CRG/20120502_FDF_CRG/20120502_FDF_CRG_c12.mtb	200	217	WWSS	food_sc	3	138584	1336096592	1	0.0399999999999996	0.000275862068965514	6966	1
3	Drink 1	Intake 1	32	138938	1336096946	/users/cn/jespinosa/phecomp/data/CRG/20120502_FDF_CRG/20120502_FDF_CRG/20120502_FDF_CRG_c12.mtb	106	NA	WWSS	water	1	138906	1336096914	1	0.0599999999999999	0.001875	6967	1
3	Food 1	Intake 3	55	139001	1336097009	/users/cn/jespinosa/phecomp/data/CRG/20120502_FDF_CRG/20120502_FDF_CRG/20120502_FDF_CRG_c12.mtb	202	14	WWSS	food_sc	3	138946	1336096954	1	0.04	0.000727272727272727	6968	1
3	Food 1	Intake 3	105	139120	1336097128	/users/cn/jespinosa/phecomp/data/CRG/20120502_FDF_CRG/20120502_FDF_CRG/20120502_FDF_CRG_c12.mtb	203	21	WWSS	food_sc	3	139015	1336097023	1	0.0600000000000001	0.000571428571428572	6969	1
3	Food 1	Intake 3	53	139194	1336097202	/users/cn/jespinosa/phecomp/data/CRG/20120502_FDF_CRG/20120502_FDF_CRG/20120502_FDF_CRG_c12.mtb	204	117	WWSS	food_sc	3	139141	1336097149	1	0.02	0.000377358490566038	6970	1
3	Drink 2	Intake 2	32	139232	1336097240	/users/cn/jespinosa/phecomp/data/CRG/20120502_FDF_CRG/20120502_FDF_CRG/20120502_FDF_CRG_c12.mtb	704	NA	WWSS	water	2	139200	1336097208	1	0.0800000000000001	0.0025	6971	1
3	Drink 2	Intake 2	16	139266	1336097274	/users/cn/jespinosa/phecomp/data/CRG/20120502_FDF_CRG/20120502_FDF_CRG/20120502_FDF_CRG_c12.mtb	705	NA	WWSS	water	2	139250	1336097258	1	0.0200000000000005	0.00125000000000003	6972	1
3	Food 1	Intake 3	134	139445	1336097453	/users/cn/jespinosa/phecomp/data/CRG/20120502_FDF_CRG/20120502_FDF_CRG/20120502_FDF_CRG_c12.mtb	205	9234	WWSS	food_sc	3	139311	1336097319	1	0.02	0.000149253731343284	6973	1
3	Drink 2	Intake 2	21	139466	1336097474	/users/cn/jespinosa/phecomp/data/CRG/20120502_FDF_CRG/20120502_FDF_CRG/20120502_FDF_CRG_c12.mtb	706	NA	WWSS	water	2	139445	1336097453	1	0.0799999999999992	0.00380952380952377	6974	1
3	Drink 2	Intake 2	20	139719	1336097727	/users/cn/jespinosa/phecomp/data/CRG/20120502_FDF_CRG/20120502_FDF_CRG/20120502_FDF_CRG_c12.mtb	707	NA	WWSS	water	2	139699	1336097707	1	0.04	0.002	6975	1
3	Drink 2	Intake 2	19	140068	1336098076	/users/cn/jespinosa/phecomp/data/CRG/20120502_FDF_CRG/20120502_FDF_CRG/20120502_FDF_CRG_c12.mtb	709	NA	WWSS	water	2	140049	1336098057	1	0.04	0.00210526315789474	6976	1
3	Drink 2	Intake 2	38	140707	1336098715	/users/cn/jespinosa/phecomp/data/CRG/20120502_FDF_CRG/20120502_FDF_CRG/20120502_FDF_CRG_c12.mtb	710	NA	WWSS	water	2	140669	1336098677	1	0.0600000000000005	0.00157894736842107	6977	1
3	Food 1	Intake 3	28	148707	1336106715	/users/cn/jespinosa/phecomp/data/CRG/20120502_FDF_CRG/20120502_FDF_CRG/20120502_FDF_CRG_c12.mtb	212	8	WWSS	food_sc	3	148679	1336106687	1	0.02	0.000714285714285714	6978	1
3	Food 1	Intake 3	124	148839	1336106847	/users/cn/jespinosa/phecomp/data/CRG/20120502_FDF_CRG/20120502_FDF_CRG/20120502_FDF_CRG_c12.mtb	213	23	WWSS	food_sc	3	148715	1336106723	1	0.02	0.000161290322580645	6979	1
3	Food 2	Intake 4	124	148986	1336106994	/users/cn/jespinosa/phecomp/data/CRG/20120502_FDF_CRG/20120502_FDF_CRG/20120502_FDF_CRG_c12.mtb	474	23	WWSS	food_sc	4	148862	1336106870	1	0.02	0.000161290322580645	6980	1
3	Food 1	Intake 3	100	149109	1336107117	/users/cn/jespinosa/phecomp/data/CRG/20120502_FDF_CRG/20120502_FDF_CRG/20120502_FDF_CRG_c12.mtb	214	438	WWSS	food_sc	3	149009	1336107017	1	0.02	0.0002	6981	1
3	Drink 2	Intake 2	28	149202	1336107210	/users/cn/jespinosa/phecomp/data/CRG/20120502_FDF_CRG/20120502_FDF_CRG/20120502_FDF_CRG_c12.mtb	711	NA	WWSS	water	2	149174	1336107182	1	0.0599999999999996	0.00214285714285713	6982	1
3	Drink 2	Intake 2	49	149273	1336107281	/users/cn/jespinosa/phecomp/data/CRG/20120502_FDF_CRG/20120502_FDF_CRG/20120502_FDF_CRG_c12.mtb	712	NA	WWSS	water	2	149224	1336107232	1	0.0200000000000005	0.000408163265306133	6983	1
3	Food 1	Intake 3	137	149684	1336107692	/users/cn/jespinosa/phecomp/data/CRG/20120502_FDF_CRG/20120502_FDF_CRG/20120502_FDF_CRG_c12.mtb	218	174	WWSS	food_sc	3	149547	1336107555	1	0.02	0.000145985401459854	6984	1
3	Drink 2	Intake 2	17	149698	1336107706	/users/cn/jespinosa/phecomp/data/CRG/20120502_FDF_CRG/20120502_FDF_CRG/20120502_FDF_CRG_c12.mtb	714	NA	WWSS	water	2	149681	1336107689	1	0.04	0.00235294117647059	6985	1
3	Food 2	Intake 4	84	149942	1336107950	/users/cn/jespinosa/phecomp/data/CRG/20120502_FDF_CRG/20120502_FDF_CRG/20120502_FDF_CRG_c12.mtb	479	390	WWSS	food_sc	4	149858	1336107866	1	0.02	0.000238095238095238	6986	1
3	Drink 2	Intake 2	25	150001	1336108009	/users/cn/jespinosa/phecomp/data/CRG/20120502_FDF_CRG/20120502_FDF_CRG/20120502_FDF_CRG_c12.mtb	715	NA	WWSS	water	2	149976	1336107984	1	0.0800000000000001	0.0032	6987	1
3	Food 1	Intake 3	282	150614	1336108622	/users/cn/jespinosa/phecomp/data/CRG/20120502_FDF_CRG/20120502_FDF_CRG/20120502_FDF_CRG_c12.mtb	220	13	WWSS	food_sc	3	150332	1336108340	1	0.0600000000000001	0.000212765957446809	6988	1
3	Food 1	Intake 3	73	150700	1336108708	/users/cn/jespinosa/phecomp/data/CRG/20120502_FDF_CRG/20120502_FDF_CRG/20120502_FDF_CRG_c12.mtb	221	147	WWSS	food_sc	3	150627	1336108635	1	0.02	0.000273972602739726	6989	1
3	Drink 2	Intake 2	23	150736	1336108744	/users/cn/jespinosa/phecomp/data/CRG/20120502_FDF_CRG/20120502_FDF_CRG/20120502_FDF_CRG_c12.mtb	717	NA	WWSS	water	2	150713	1336108721	1	0.0599999999999996	0.0026086956521739	6990	1
3	Food 2	Intake 4	312	151159	1336109167	/users/cn/jespinosa/phecomp/data/CRG/20120502_FDF_CRG/20120502_FDF_CRG/20120502_FDF_CRG_c12.mtb	482	366	WWSS	food_sc	4	150847	1336108855	1	0.04	0.000128205128205128	6991	1
3	Drink 2	Intake 2	35	151220	1336109228	/users/cn/jespinosa/phecomp/data/CRG/20120502_FDF_CRG/20120502_FDF_CRG/20120502_FDF_CRG_c12.mtb	718	NA	WWSS	water	2	151185	1336109193	1	0.0999999999999996	0.00285714285714285	6992	1
3	Drink 2	Intake 2	25	151329	1336109337	/users/cn/jespinosa/phecomp/data/CRG/20120502_FDF_CRG/20120502_FDF_CRG/20120502_FDF_CRG_c12.mtb	719	NA	WWSS	water	2	151304	1336109312	1	0.0800000000000001	0.0032	6993	1
3	Food 2	Intake 4	165	151690	1336109698	/users/cn/jespinosa/phecomp/data/CRG/20120502_FDF_CRG/20120502_FDF_CRG/20120502_FDF_CRG_c12.mtb	486	471	WWSS	food_sc	4	151525	1336109533	1	0.02	0.000121212121212121	6994	1
3	Food 1	Intake 3	653	152814	1336110822	/users/cn/jespinosa/phecomp/data/CRG/20120502_FDF_CRG/20120502_FDF_CRG/20120502_FDF_CRG_c12.mtb	228	618	WWSS	food_sc	3	152161	1336110169	1	0.28	0.000428790199081164	6995	1
3	Drink 2	Intake 2	24	152861	1336110869	/users/cn/jespinosa/phecomp/data/CRG/20120502_FDF_CRG/20120502_FDF_CRG/20120502_FDF_CRG_c12.mtb	720	NA	WWSS	water	2	152837	1336110845	1	0.04	0.00166666666666667	6996	1
3	Drink 1	Intake 1	20	152933	1336110941	/users/cn/jespinosa/phecomp/data/CRG/20120502_FDF_CRG/20120502_FDF_CRG/20120502_FDF_CRG_c12.mtb	109	NA	WWSS	water	1	152913	1336110921	1	0.0600000000000001	0.00300000000000001	6997	1
3	Drink 2	Intake 2	23	153375	1336111383	/users/cn/jespinosa/phecomp/data/CRG/20120502_FDF_CRG/20120502_FDF_CRG/20120502_FDF_CRG_c12.mtb	724	NA	WWSS	water	2	153352	1336111360	1	0.04	0.00173913043478261	6998	1
3	Food 1	Intake 3	192	153624	1336111632	/users/cn/jespinosa/phecomp/data/CRG/20120502_FDF_CRG/20120502_FDF_CRG/20120502_FDF_CRG_c12.mtb	229	96	WWSS	food_sc	3	153432	1336111440	1	0.0800000000000001	0.000416666666666667	6999	1
3	Food 2	Intake 4	86	153806	1336111814	/users/cn/jespinosa/phecomp/data/CRG/20120502_FDF_CRG/20120502_FDF_CRG/20120502_FDF_CRG_c12.mtb	492	5950	WWSS	food_sc	4	153720	1336111728	1	0.02	0.000232558139534884	7000	1
3	Drink 2	Intake 2	43	153844	1336111852	/users/cn/jespinosa/phecomp/data/CRG/20120502_FDF_CRG/20120502_FDF_CRG/20120502_FDF_CRG_c12.mtb	725	NA	WWSS	water	2	153801	1336111809	1	0.0800000000000001	0.00186046511627907	7001	1
3	Drink 2	Intake 2	24	153927	1336111935	/users/cn/jespinosa/phecomp/data/CRG/20120502_FDF_CRG/20120502_FDF_CRG/20120502_FDF_CRG_c12.mtb	726	NA	WWSS	water	2	153903	1336111911	1	0.0600000000000005	0.00250000000000002	7002	1
3	Drink 2	Intake 2	23	154976	1336112984	/users/cn/jespinosa/phecomp/data/CRG/20120502_FDF_CRG/20120502_FDF_CRG/20120502_FDF_CRG_c12.mtb	736	NA	WWSS	water	2	154953	1336112961	1	0.0200000000000005	0.000869565217391326	7003	1
3	Drink 2	Intake 2	21	159595	1336117603	/users/cn/jespinosa/phecomp/data/CRG/20120502_FDF_CRG/20120502_FDF_CRG/20120502_FDF_CRG_c12.mtb	744	NA	WWSS	water	2	159574	1336117582	1	0.04	0.0019047619047619	7004	1
3	Food 1	Intake 3	191	159947	1336117955	/users/cn/jespinosa/phecomp/data/CRG/20120502_FDF_CRG/20120502_FDF_CRG/20120502_FDF_CRG_c12.mtb	233	11	WWSS	food_sc	3	159756	1336117764	1	0.0600000000000001	0.000314136125654451	7005	1
3	Food 1	Intake 3	115	160073	1336118081	/users/cn/jespinosa/phecomp/data/CRG/20120502_FDF_CRG/20120502_FDF_CRG/20120502_FDF_CRG_c12.mtb	234	32658	WWSS	food_sc	3	159958	1336117966	1	0.02	0.000173913043478261	7006	1
3	Food 1	Intake 3	24	28577	1336150763	/users/cn/jespinosa/phecomp/data/CRG/20120502_FDF_CRG/20120502_FDF_CRG/20120504_FDF_CRG_c12.mtb	579	656	WWSS	food_sc	3	28553	1336150739	1	0.02	0.000833333333333333	7007	1
3	Food 1	Intake 3	338	29571	1336151757	/users/cn/jespinosa/phecomp/data/CRG/20120502_FDF_CRG/20120502_FDF_CRG/20120504_FDF_CRG_c12.mtb	581	2443	WWSS	food_sc	3	29233	1336151419	1	0.04	0.000118343195266272	7008	1
3	Drink 2	Intake 2	33	29616	1336151802	/users/cn/jespinosa/phecomp/data/CRG/20120502_FDF_CRG/20120502_FDF_CRG/20120504_FDF_CRG_c12.mtb	1093	NA	WWSS	water	2	29583	1336151769	1	0.02	0.000606060606060606	7009	1
3	Food 1	Intake 3	172	32186	1336154372	/users/cn/jespinosa/phecomp/data/CRG/20120502_FDF_CRG/20120502_FDF_CRG/20120504_FDF_CRG_c12.mtb	582	390	WWSS	food_sc	3	32014	1336154200	1	0.02	0.000116279069767442	7010	1
3	Food 1	Intake 3	101	32677	1336154863	/users/cn/jespinosa/phecomp/data/CRG/20120502_FDF_CRG/20120502_FDF_CRG/20120504_FDF_CRG_c12.mtb	583	252	WWSS	food_sc	3	32576	1336154762	1	0.02	0.000198019801980198	7011	1
3	Food 2	Intake 4	1004	33933	1336156119	/users/cn/jespinosa/phecomp/data/CRG/20120502_FDF_CRG/20120502_FDF_CRG/20120504_FDF_CRG_c12.mtb	845	440	WWSS	food_sc	4	32929	1336155115	1	0.22	0.000219123505976096	7012	1
3	Drink 2	Intake 2	30	33960	1336156146	/users/cn/jespinosa/phecomp/data/CRG/20120502_FDF_CRG/20120502_FDF_CRG/20120504_FDF_CRG_c12.mtb	1095	NA	WWSS	water	2	33930	1336156116	1	0.16	0.00533333333333333	7013	1
3	Food 2	Intake 4	263	34636	1336156822	/users/cn/jespinosa/phecomp/data/CRG/20120502_FDF_CRG/20120502_FDF_CRG/20120504_FDF_CRG_c12.mtb	847	2220	WWSS	food_sc	4	34373	1336156559	1	0.06	0.000228136882129278	7014	1
3	Drink 2	Intake 2	22	34658	1336156844	/users/cn/jespinosa/phecomp/data/CRG/20120502_FDF_CRG/20120502_FDF_CRG/20120504_FDF_CRG_c12.mtb	1096	NA	WWSS	water	2	34636	1336156822	1	0.08	0.00363636363636364	7015	1
3	Drink 2	Intake 2	17	34840	1336157026	/users/cn/jespinosa/phecomp/data/CRG/20120502_FDF_CRG/20120502_FDF_CRG/20120504_FDF_CRG_c12.mtb	1097	NA	WWSS	water	2	34823	1336157009	1	0.02	0.00117647058823529	7016	1
3	Food 2	Intake 4	112	36968	1336159154	/users/cn/jespinosa/phecomp/data/CRG/20120502_FDF_CRG/20120502_FDF_CRG/20120504_FDF_CRG_c12.mtb	850	59	WWSS	food_sc	4	36856	1336159042	1	0.02	0.000178571428571429	7017	1
3	Food 2	Intake 4	806	37833	1336160019	/users/cn/jespinosa/phecomp/data/CRG/20120502_FDF_CRG/20120502_FDF_CRG/20120504_FDF_CRG_c12.mtb	851	505	WWSS	food_sc	4	37027	1336159213	1	0.2	0.000248138957816377	7018	1
3	Drink 2	Intake 2	33	37857	1336160043	/users/cn/jespinosa/phecomp/data/CRG/20120502_FDF_CRG/20120502_FDF_CRG/20120504_FDF_CRG_c12.mtb	1098	NA	WWSS	water	2	37824	1336160010	1	0.12	0.00363636363636364	7019	1
3	Drink 2	Intake 2	18	37992	1336160178	/users/cn/jespinosa/phecomp/data/CRG/20120502_FDF_CRG/20120502_FDF_CRG/20120504_FDF_CRG_c12.mtb	1100	NA	WWSS	water	2	37974	1336160160	1	0.02	0.00111111111111111	7020	1
3	Drink 2	Intake 2	27	38245	1336160431	/users/cn/jespinosa/phecomp/data/CRG/20120502_FDF_CRG/20120502_FDF_CRG/20120504_FDF_CRG_c12.mtb	1103	NA	WWSS	water	2	38218	1336160404	1	0.06	0.00222222222222222	7021	1
3	Food 2	Intake 4	458	38796	1336160982	/users/cn/jespinosa/phecomp/data/CRG/20120502_FDF_CRG/20120502_FDF_CRG/20120504_FDF_CRG_c12.mtb	856	38	WWSS	food_sc	4	38338	1336160524	1	0.14	0.000305676855895197	7022	1
3	Food 2	Intake 4	185	39019	1336161205	/users/cn/jespinosa/phecomp/data/CRG/20120502_FDF_CRG/20120502_FDF_CRG/20120504_FDF_CRG_c12.mtb	857	721	WWSS	food_sc	4	38834	1336161020	1	0.0599999999999999	0.000324324324324324	7023	1
3	Drink 2	Intake 2	31	39049	1336161235	/users/cn/jespinosa/phecomp/data/CRG/20120502_FDF_CRG/20120502_FDF_CRG/20120504_FDF_CRG_c12.mtb	1104	NA	WWSS	water	2	39018	1336161204	1	0.12	0.00387096774193548	7024	1
3	Drink 2	Intake 2	18	39123	1336161309	/users/cn/jespinosa/phecomp/data/CRG/20120502_FDF_CRG/20120502_FDF_CRG/20120504_FDF_CRG_c12.mtb	1105	NA	WWSS	water	2	39105	1336161291	1	0.02	0.00111111111111111	7025	1
3	Drink 2	Intake 2	21	39239	1336161425	/users/cn/jespinosa/phecomp/data/CRG/20120502_FDF_CRG/20120502_FDF_CRG/20120504_FDF_CRG_c12.mtb	1106	NA	WWSS	water	2	39218	1336161404	1	0.02	0.000952380952380952	7026	1
3	Drink 2	Intake 2	20	39294	1336161480	/users/cn/jespinosa/phecomp/data/CRG/20120502_FDF_CRG/20120502_FDF_CRG/20120504_FDF_CRG_c12.mtb	1107	NA	WWSS	water	2	39274	1336161460	1	0.04	0.002	7027	1
3	Food 2	Intake 4	173	39913	1336162099	/users/cn/jespinosa/phecomp/data/CRG/20120502_FDF_CRG/20120502_FDF_CRG/20120504_FDF_CRG_c12.mtb	860	2715	WWSS	food_sc	4	39740	1336161926	1	0.02	0.000115606936416185	7028	1
3	Food 2	Intake 4	124	42752	1336164938	/users/cn/jespinosa/phecomp/data/CRG/20120502_FDF_CRG/20120502_FDF_CRG/20120504_FDF_CRG_c12.mtb	861	COLL	WWSS	food_sc	4	42628	1336164814	1	0.02	0.000161290322580645	7029	1
3	Food 1	Intake 3	549	43289	1336165475	/users/cn/jespinosa/phecomp/data/CRG/20120502_FDF_CRG/20120502_FDF_CRG/20120504_FDF_CRG_c12.mtb	591	139	WWSS	food_sc	3	42740	1336164926	1	0.18	0.000327868852459016	7030	1
3	Drink 2	Intake 2	20	43303	1336165489	/users/cn/jespinosa/phecomp/data/CRG/20120502_FDF_CRG/20120502_FDF_CRG/20120504_FDF_CRG_c12.mtb	1109	NA	WWSS	water	2	43283	1336165469	1	0.0800000000000001	0.00400000000000001	7031	1
3	Food 1	Intake 3	81	43509	1336165695	/users/cn/jespinosa/phecomp/data/CRG/20120502_FDF_CRG/20120502_FDF_CRG/20120504_FDF_CRG_c12.mtb	592	903	WWSS	food_sc	3	43428	1336165614	1	0.04	0.000493827160493827	7032	1
3	Drink 2	Intake 2	22	43532	1336165718	/users/cn/jespinosa/phecomp/data/CRG/20120502_FDF_CRG/20120502_FDF_CRG/20120504_FDF_CRG_c12.mtb	1112	NA	WWSS	water	2	43510	1336165696	1	0.0599999999999999	0.00272727272727272	7033	1
3	Drink 1	Intake 1	12	43726	1336165912	/users/cn/jespinosa/phecomp/data/CRG/20120502_FDF_CRG/20120502_FDF_CRG/20120504_FDF_CRG_c12.mtb	243	NA	WWSS	water	1	43714	1336165900	1	0.02	0.00166666666666667	7034	1
3	Drink 2	Intake 2	27	43942	1336166128	/users/cn/jespinosa/phecomp/data/CRG/20120502_FDF_CRG/20120502_FDF_CRG/20120504_FDF_CRG_c12.mtb	1114	NA	WWSS	water	2	43915	1336166101	1	0.02	0.000740740740740741	7035	1
3	Drink 1	Intake 1	32	44301	1336166487	/users/cn/jespinosa/phecomp/data/CRG/20120502_FDF_CRG/20120502_FDF_CRG/20120504_FDF_CRG_c12.mtb	244	NA	WWSS	water	1	44269	1336166455	1	0.1	0.003125	7036	1
3	Drink 2	Intake 2	15	44342	1336166528	/users/cn/jespinosa/phecomp/data/CRG/20120502_FDF_CRG/20120502_FDF_CRG/20120504_FDF_CRG_c12.mtb	1116	NA	WWSS	water	2	44327	1336166513	1	0.02	0.00133333333333333	7037	1
3	Food 1	Intake 3	632	45044	1336167230	/users/cn/jespinosa/phecomp/data/CRG/20120502_FDF_CRG/20120502_FDF_CRG/20120504_FDF_CRG_c12.mtb	599	3389	WWSS	food_sc	3	44412	1336166598	1	0.24	0.000379746835443038	7038	1
3	Drink 2	Intake 2	24	45066	1336167252	/users/cn/jespinosa/phecomp/data/CRG/20120502_FDF_CRG/20120502_FDF_CRG/20120504_FDF_CRG_c12.mtb	1117	NA	WWSS	water	2	45042	1336167228	1	0.0599999999999999	0.0025	7039	1
3	Drink 2	Intake 2	9	45098	1336167284	/users/cn/jespinosa/phecomp/data/CRG/20120502_FDF_CRG/20120502_FDF_CRG/20120504_FDF_CRG_c12.mtb	1118	NA	WWSS	water	2	45089	1336167275	1	0.02	0.00222222222222222	7040	1
3	Drink 2	Intake 2	18	45172	1336167358	/users/cn/jespinosa/phecomp/data/CRG/20120502_FDF_CRG/20120502_FDF_CRG/20120504_FDF_CRG_c12.mtb	1119	NA	WWSS	water	2	45154	1336167340	1	0.04	0.00222222222222222	7041	1
3	Drink 2	Intake 2	16	45251	1336167437	/users/cn/jespinosa/phecomp/data/CRG/20120502_FDF_CRG/20120502_FDF_CRG/20120504_FDF_CRG_c12.mtb	1120	NA	WWSS	water	2	45235	1336167421	1	0.02	0.00125	7042	1
3	Drink 1	Intake 1	12	45722	1336167908	/users/cn/jespinosa/phecomp/data/CRG/20120502_FDF_CRG/20120502_FDF_CRG/20120504_FDF_CRG_c12.mtb	246	NA	WWSS	water	1	45710	1336167896	1	0.04	0.00333333333333333	7043	1
3	Food 1	Intake 3	453	48886	1336171072	/users/cn/jespinosa/phecomp/data/CRG/20120502_FDF_CRG/20120502_FDF_CRG/20120504_FDF_CRG_c12.mtb	603	80	WWSS	food_sc	3	48433	1336170619	1	0.1	0.00022075055187638	7044	1
3	Drink 2	Intake 2	17	48902	1336171088	/users/cn/jespinosa/phecomp/data/CRG/20120502_FDF_CRG/20120502_FDF_CRG/20120504_FDF_CRG_c12.mtb	1123	NA	WWSS	water	2	48885	1336171071	1	0.04	0.00235294117647059	7045	1
3	Drink 2	Intake 2	25	48955	1336171141	/users/cn/jespinosa/phecomp/data/CRG/20120502_FDF_CRG/20120502_FDF_CRG/20120504_FDF_CRG_c12.mtb	1124	NA	WWSS	water	2	48930	1336171116	1	0.02	0.0008	7046	1
3	Food 1	Intake 3	284	49250	1336171436	/users/cn/jespinosa/phecomp/data/CRG/20120502_FDF_CRG/20120502_FDF_CRG/20120504_FDF_CRG_c12.mtb	604	464	WWSS	food_sc	3	48966	1336171152	1	0.0399999999999999	0.000140845070422535	7047	1
3	Drink 1	Intake 1	15	49421	1336171607	/users/cn/jespinosa/phecomp/data/CRG/20120502_FDF_CRG/20120502_FDF_CRG/20120504_FDF_CRG_c12.mtb	247	NA	WWSS	water	1	49406	1336171592	1	0.02	0.00133333333333333	7048	1
3	Drink 2	Intake 2	25	49521	1336171707	/users/cn/jespinosa/phecomp/data/CRG/20120502_FDF_CRG/20120502_FDF_CRG/20120504_FDF_CRG_c12.mtb	1126	NA	WWSS	water	2	49496	1336171682	1	0.02	0.0008	7049	1
3	Drink 2	Intake 2	15	49655	1336171841	/users/cn/jespinosa/phecomp/data/CRG/20120502_FDF_CRG/20120502_FDF_CRG/20120504_FDF_CRG_c12.mtb	1127	NA	WWSS	water	2	49640	1336171826	1	0.04	0.00266666666666667	7050	1
3	Food 1	Intake 3	490	50204	1336172390	/users/cn/jespinosa/phecomp/data/CRG/20120502_FDF_CRG/20120502_FDF_CRG/20120504_FDF_CRG_c12.mtb	608	200	WWSS	food_sc	3	49714	1336171900	1	0.16	0.000326530612244898	7051	1
3	Drink 1	Intake 1	20	50229	1336172415	/users/cn/jespinosa/phecomp/data/CRG/20120502_FDF_CRG/20120502_FDF_CRG/20120504_FDF_CRG_c12.mtb	249	NA	WWSS	water	1	50209	1336172395	1	0.06	0.003	7052	1
3	Drink 2	Intake 2	33	50377	1336172563	/users/cn/jespinosa/phecomp/data/CRG/20120502_FDF_CRG/20120502_FDF_CRG/20120504_FDF_CRG_c12.mtb	1128	NA	WWSS	water	2	50344	1336172530	1	0.0999999999999999	0.00303030303030303	7053	1
3	Food 1	Intake 3	217	50621	1336172807	/users/cn/jespinosa/phecomp/data/CRG/20120502_FDF_CRG/20120502_FDF_CRG/20120504_FDF_CRG_c12.mtb	609	5445	WWSS	food_sc	3	50404	1336172590	1	0.04	0.000184331797235023	7054	1
3	Drink 2	Intake 2	18	50715	1336172901	/users/cn/jespinosa/phecomp/data/CRG/20120502_FDF_CRG/20120502_FDF_CRG/20120504_FDF_CRG_c12.mtb	1129	NA	WWSS	water	2	50697	1336172883	1	0.02	0.00111111111111111	7055	1
3	Food 1	Intake 3	233	56299	1336178485	/users/cn/jespinosa/phecomp/data/CRG/20120502_FDF_CRG/20120502_FDF_CRG/20120504_FDF_CRG_c12.mtb	612	115	WWSS	food_sc	3	56066	1336178252	1	0.02	8.58369098712446e-05	7056	1
3	Food 1	Intake 3	121	56535	1336178721	/users/cn/jespinosa/phecomp/data/CRG/20120502_FDF_CRG/20120502_FDF_CRG/20120504_FDF_CRG_c12.mtb	614	139	WWSS	food_sc	3	56414	1336178600	1	0.0399999999999999	0.000330578512396693	7057	1
3	Drink 2	Intake 2	25	56647	1336178833	/users/cn/jespinosa/phecomp/data/CRG/20120502_FDF_CRG/20120502_FDF_CRG/20120504_FDF_CRG_c12.mtb	1131	NA	WWSS	water	2	56622	1336178808	1	0.0800000000000001	0.0032	7058	1
3	Food 1	Intake 3	323	56997	1336179183	/users/cn/jespinosa/phecomp/data/CRG/20120502_FDF_CRG/20120502_FDF_CRG/20120504_FDF_CRG_c12.mtb	617	115	WWSS	food_sc	3	56674	1336178860	1	0.0600000000000001	0.000185758513931889	7059	1
3	Drink 2	Intake 2	25	57033	1336179219	/users/cn/jespinosa/phecomp/data/CRG/20120502_FDF_CRG/20120502_FDF_CRG/20120504_FDF_CRG_c12.mtb	1132	NA	WWSS	water	2	57008	1336179194	1	0.0799999999999998	0.00319999999999999	7060	1
3	Food 1	Intake 3	523	57635	1336179821	/users/cn/jespinosa/phecomp/data/CRG/20120502_FDF_CRG/20120502_FDF_CRG/20120504_FDF_CRG_c12.mtb	618	1375	WWSS	food_sc	3	57112	1336179298	1	0.16	0.000305927342256214	7061	1
3	Drink 1	Intake 1	20	57654	1336179840	/users/cn/jespinosa/phecomp/data/CRG/20120502_FDF_CRG/20120502_FDF_CRG/20120504_FDF_CRG_c12.mtb	250	NA	WWSS	water	1	57634	1336179820	1	0.1	0.005	7062	1
3	Drink 1	Intake 1	22	57681	1336179867	/users/cn/jespinosa/phecomp/data/CRG/20120502_FDF_CRG/20120502_FDF_CRG/20120504_FDF_CRG_c12.mtb	251	NA	WWSS	water	1	57659	1336179845	1	0.04	0.00181818181818182	7063	1
3	Drink 2	Intake 2	15	57709	1336179895	/users/cn/jespinosa/phecomp/data/CRG/20120502_FDF_CRG/20120502_FDF_CRG/20120504_FDF_CRG_c12.mtb	1133	NA	WWSS	water	2	57694	1336179880	1	0.02	0.00133333333333333	7064	1
3	Drink 1	Intake 1	17	58495	1336180681	/users/cn/jespinosa/phecomp/data/CRG/20120502_FDF_CRG/20120502_FDF_CRG/20120504_FDF_CRG_c12.mtb	252	NA	WWSS	water	1	58478	1336180664	1	0.02	0.00117647058823529	7065	1
3	Food 1	Intake 3	60	59070	1336181256	/users/cn/jespinosa/phecomp/data/CRG/20120502_FDF_CRG/20120502_FDF_CRG/20120504_FDF_CRG_c12.mtb	621	585	WWSS	food_sc	3	59010	1336181196	1	0.02	0.000333333333333333	7066	1
3	Food 1	Intake 3	300	59955	1336182141	/users/cn/jespinosa/phecomp/data/CRG/20120502_FDF_CRG/20120502_FDF_CRG/20120504_FDF_CRG_c12.mtb	622	152	WWSS	food_sc	3	59655	1336181841	1	0.02	6.66666666666667e-05	7067	1
3	Drink 1	Intake 1	15	59972	1336182158	/users/cn/jespinosa/phecomp/data/CRG/20120502_FDF_CRG/20120502_FDF_CRG/20120504_FDF_CRG_c12.mtb	253	NA	WWSS	water	1	59957	1336182143	1	0.02	0.00133333333333333	7068	1
3	Drink 1	Intake 1	15	60015	1336182201	/users/cn/jespinosa/phecomp/data/CRG/20120502_FDF_CRG/20120502_FDF_CRG/20120504_FDF_CRG_c12.mtb	254	NA	WWSS	water	1	60000	1336182186	1	0.02	0.00133333333333333	7069	1
3	Drink 2	Intake 2	15	60064	1336182250	/users/cn/jespinosa/phecomp/data/CRG/20120502_FDF_CRG/20120502_FDF_CRG/20120504_FDF_CRG_c12.mtb	1137	NA	WWSS	water	2	60049	1336182235	1	0.02	0.00133333333333333	7070	1
3	Food 1	Intake 3	68	60175	1336182361	/users/cn/jespinosa/phecomp/data/CRG/20120502_FDF_CRG/20120502_FDF_CRG/20120504_FDF_CRG_c12.mtb	623	40	WWSS	food_sc	3	60107	1336182293	1	0.02	0.000294117647058824	7071	1
3	Food 1	Intake 3	272	60487	1336182673	/users/cn/jespinosa/phecomp/data/CRG/20120502_FDF_CRG/20120502_FDF_CRG/20120504_FDF_CRG_c12.mtb	624	10881	WWSS	food_sc	3	60215	1336182401	1	0.0600000000000001	0.000220588235294118	7072	1
3	Drink 2	Intake 2	17	61193	1336183379	/users/cn/jespinosa/phecomp/data/CRG/20120502_FDF_CRG/20120502_FDF_CRG/20120504_FDF_CRG_c12.mtb	1138	NA	WWSS	water	2	61176	1336183362	1	0.02	0.00117647058823529	7073	1
3	Drink 1	Intake 1	15	61426	1336183612	/users/cn/jespinosa/phecomp/data/CRG/20120502_FDF_CRG/20120502_FDF_CRG/20120504_FDF_CRG_c12.mtb	255	NA	WWSS	water	1	61411	1336183597	1	0.04	0.00266666666666667	7074	1
3	Drink 2	Intake 2	28	71191	1336193377	/users/cn/jespinosa/phecomp/data/CRG/20120502_FDF_CRG/20120502_FDF_CRG/20120504_FDF_CRG_c12.mtb	1139	NA	WWSS	water	2	71163	1336193349	1	0.1	0.00357142857142857	7075	1
3	Food 1	Intake 3	57	71425	1336193611	/users/cn/jespinosa/phecomp/data/CRG/20120502_FDF_CRG/20120502_FDF_CRG/20120504_FDF_CRG_c12.mtb	631	1885	WWSS	food_sc	3	71368	1336193554	1	0.02	0.000350877192982456	7076	1
3	Drink 2	Intake 2	10	72836	1336195022	/users/cn/jespinosa/phecomp/data/CRG/20120502_FDF_CRG/20120502_FDF_CRG/20120504_FDF_CRG_c12.mtb	1153	NA	WWSS	water	2	72826	1336195012	1	0.02	0.002	7077	1
3	Drink 2	Intake 2	58	73122	1336195308	/users/cn/jespinosa/phecomp/data/CRG/20120502_FDF_CRG/20120502_FDF_CRG/20120504_FDF_CRG_c12.mtb	1154	NA	WWSS	water	2	73064	1336195250	1	0.0600000000000001	0.00103448275862069	7078	1
3	Drink 2	Intake 2	17	73177	1336195363	/users/cn/jespinosa/phecomp/data/CRG/20120502_FDF_CRG/20120502_FDF_CRG/20120504_FDF_CRG_c12.mtb	1155	NA	WWSS	water	2	73160	1336195346	1	0.02	0.00117647058823529	7079	1
3	Food 1	Intake 3	59	73369	1336195555	/users/cn/jespinosa/phecomp/data/CRG/20120502_FDF_CRG/20120502_FDF_CRG/20120504_FDF_CRG_c12.mtb	642	994	WWSS	food_sc	3	73310	1336195496	1	0.02	0.000338983050847458	7080	1
3	Drink 2	Intake 2	27	73776	1336195962	/users/cn/jespinosa/phecomp/data/CRG/20120502_FDF_CRG/20120502_FDF_CRG/20120504_FDF_CRG_c12.mtb	1157	NA	WWSS	water	2	73749	1336195935	1	0.0599999999999998	0.00222222222222221	7081	1
3	Drink 1	Intake 1	22	73832	1336196018	/users/cn/jespinosa/phecomp/data/CRG/20120502_FDF_CRG/20120502_FDF_CRG/20120504_FDF_CRG_c12.mtb	257	NA	WWSS	water	1	73810	1336195996	1	0.02	0.000909090909090909	7082	1
3	Drink 2	Intake 2	16	74361	1336196547	/users/cn/jespinosa/phecomp/data/CRG/20120502_FDF_CRG/20120502_FDF_CRG/20120504_FDF_CRG_c12.mtb	1158	NA	WWSS	water	2	74345	1336196531	1	0.02	0.00125	7083	1
3	Food 2	Intake 4	42	74405	1336196591	/users/cn/jespinosa/phecomp/data/CRG/20120502_FDF_CRG/20120502_FDF_CRG/20120504_FDF_CRG_c12.mtb	898	COLL	WWSS	food_sc	4	74363	1336196549	1	0.02	0.000476190476190476	7084	1
3	Food 1	Intake 3	159	74552	1336196738	/users/cn/jespinosa/phecomp/data/CRG/20120502_FDF_CRG/20120502_FDF_CRG/20120504_FDF_CRG_c12.mtb	647	506	WWSS	food_sc	3	74393	1336196579	1	0.02	0.000125786163522013	7085	1
3	Drink 2	Intake 2	15	74643	1336196829	/users/cn/jespinosa/phecomp/data/CRG/20120502_FDF_CRG/20120502_FDF_CRG/20120504_FDF_CRG_c12.mtb	1159	NA	WWSS	water	2	74628	1336196814	1	0.0599999999999998	0.00399999999999999	7086	1
3	Drink 2	Intake 2	15	75061	1336197247	/users/cn/jespinosa/phecomp/data/CRG/20120502_FDF_CRG/20120502_FDF_CRG/20120504_FDF_CRG_c12.mtb	1161	NA	WWSS	water	2	75046	1336197232	1	0.02	0.00133333333333333	7087	1
3	Food 1	Intake 3	82	75140	1336197326	/users/cn/jespinosa/phecomp/data/CRG/20120502_FDF_CRG/20120502_FDF_CRG/20120504_FDF_CRG_c12.mtb	651	6915	WWSS	food_sc	3	75058	1336197244	1	0.02	0.00024390243902439	7088	1
3	Drink 2	Intake 2	16	75645	1336197831	/users/cn/jespinosa/phecomp/data/CRG/20120502_FDF_CRG/20120502_FDF_CRG/20120504_FDF_CRG_c12.mtb	1163	NA	WWSS	water	2	75629	1336197815	1	0.02	0.00125	7089	1
3	Drink 2	Intake 2	16	75937	1336198123	/users/cn/jespinosa/phecomp/data/CRG/20120502_FDF_CRG/20120502_FDF_CRG/20120504_FDF_CRG_c12.mtb	1164	NA	WWSS	water	2	75921	1336198107	1	0.02	0.00125	7090	1
3	Drink 2	Intake 2	23	81548	1336203734	/users/cn/jespinosa/phecomp/data/CRG/20120502_FDF_CRG/20120502_FDF_CRG/20120504_FDF_CRG_c12.mtb	1167	NA	WWSS	water	2	81525	1336203711	1	0.02	0.000869565217391304	7091	1
3	Food 2	Intake 4	123	82178	1336204364	/users/cn/jespinosa/phecomp/data/CRG/20120502_FDF_CRG/20120502_FDF_CRG/20120504_FDF_CRG_c12.mtb	907	25	WWSS	food_sc	4	82055	1336204241	1	0.04	0.00032520325203252	7092	1
3	Food 2	Intake 4	189	82392	1336204578	/users/cn/jespinosa/phecomp/data/CRG/20120502_FDF_CRG/20120502_FDF_CRG/20120504_FDF_CRG_c12.mtb	908	10	WWSS	food_sc	4	82203	1336204389	1	0.0599999999999999	0.000317460317460317	7093	1
3	Food 2	Intake 4	472	82874	1336205060	/users/cn/jespinosa/phecomp/data/CRG/20120502_FDF_CRG/20120502_FDF_CRG/20120504_FDF_CRG_c12.mtb	909	286	WWSS	food_sc	4	82402	1336204588	1	0.12	0.000254237288135593	7094	1
3	Drink 2	Intake 2	75	82951	1336205137	/users/cn/jespinosa/phecomp/data/CRG/20120502_FDF_CRG/20120502_FDF_CRG/20120504_FDF_CRG_c12.mtb	1169	NA	WWSS	water	2	82876	1336205062	1	0.0600000000000001	0.000800000000000001	7095	1
3	Drink 2	Intake 2	43	83025	1336205211	/users/cn/jespinosa/phecomp/data/CRG/20120502_FDF_CRG/20120502_FDF_CRG/20120504_FDF_CRG_c12.mtb	1170	NA	WWSS	water	2	82982	1336205168	1	0.04	0.000930232558139535	7096	1
3	Drink 2	Intake 2	36	83157	1336205343	/users/cn/jespinosa/phecomp/data/CRG/20120502_FDF_CRG/20120502_FDF_CRG/20120504_FDF_CRG_c12.mtb	1172	NA	WWSS	water	2	83121	1336205307	1	0.02	0.000555555555555556	7097	1
3	Food 2	Intake 4	514	83674	1336205860	/users/cn/jespinosa/phecomp/data/CRG/20120502_FDF_CRG/20120502_FDF_CRG/20120504_FDF_CRG_c12.mtb	910	876	WWSS	food_sc	4	83160	1336205346	1	0.18	0.000350194552529183	7098	1
3	Drink 2	Intake 2	44	83740	1336205926	/users/cn/jespinosa/phecomp/data/CRG/20120502_FDF_CRG/20120502_FDF_CRG/20120504_FDF_CRG_c12.mtb	1173	NA	WWSS	water	2	83696	1336205882	1	0.18	0.00409090909090909	7099	1
3	Drink 2	Intake 2	13	83906	1336206092	/users/cn/jespinosa/phecomp/data/CRG/20120502_FDF_CRG/20120502_FDF_CRG/20120504_FDF_CRG_c12.mtb	1174	NA	WWSS	water	2	83893	1336206079	1	0.02	0.00153846153846154	7100	1
3	Drink 1	Intake 1	15	83948	1336206134	/users/cn/jespinosa/phecomp/data/CRG/20120502_FDF_CRG/20120502_FDF_CRG/20120504_FDF_CRG_c12.mtb	259	NA	WWSS	water	1	83933	1336206119	1	0.0600000000000001	0.00400000000000001	7101	1
3	Drink 2	Intake 2	17	84011	1336206197	/users/cn/jespinosa/phecomp/data/CRG/20120502_FDF_CRG/20120502_FDF_CRG/20120504_FDF_CRG_c12.mtb	1175	NA	WWSS	water	2	83994	1336206180	1	0.0399999999999996	0.00235294117647056	7102	1
3	Drink 2	Intake 2	18	84139	1336206325	/users/cn/jespinosa/phecomp/data/CRG/20120502_FDF_CRG/20120502_FDF_CRG/20120504_FDF_CRG_c12.mtb	1176	NA	WWSS	water	2	84121	1336206307	1	0.0200000000000005	0.00111111111111114	7103	1
3	Drink 2	Intake 2	18	84323	1336206509	/users/cn/jespinosa/phecomp/data/CRG/20120502_FDF_CRG/20120502_FDF_CRG/20120504_FDF_CRG_c12.mtb	1179	NA	WWSS	water	2	84305	1336206491	1	0.02	0.00111111111111111	7104	1
3	Food 2	Intake 4	78	84628	1336206814	/users/cn/jespinosa/phecomp/data/CRG/20120502_FDF_CRG/20120502_FDF_CRG/20120504_FDF_CRG_c12.mtb	915	8962	WWSS	food_sc	4	84550	1336206736	1	0.02	0.000256410256410256	7105	1
3	Drink 2	Intake 2	38	84856	1336207042	/users/cn/jespinosa/phecomp/data/CRG/20120502_FDF_CRG/20120502_FDF_CRG/20120504_FDF_CRG_c12.mtb	1185	NA	WWSS	water	2	84818	1336207004	1	0.0600000000000001	0.00157894736842106	7106	1
3	Drink 2	Intake 2	20	84974	1336207160	/users/cn/jespinosa/phecomp/data/CRG/20120502_FDF_CRG/20120502_FDF_CRG/20120504_FDF_CRG_c12.mtb	1187	NA	WWSS	water	2	84954	1336207140	1	0.04	0.002	7107	1
3	Food 2	Intake 4	455	94045	1336216231	/users/cn/jespinosa/phecomp/data/CRG/20120502_FDF_CRG/20120502_FDF_CRG/20120504_FDF_CRG_c12.mtb	920	31	WWSS	food_sc	4	93590	1336215776	1	0.0600000000000001	0.000131868131868132	7108	1
3	Food 2	Intake 4	142	94218	1336216404	/users/cn/jespinosa/phecomp/data/CRG/20120502_FDF_CRG/20120502_FDF_CRG/20120504_FDF_CRG_c12.mtb	921	1076	WWSS	food_sc	4	94076	1336216262	1	0.02	0.000140845070422535	7109	1
3	Drink 2	Intake 2	22	94364	1336216550	/users/cn/jespinosa/phecomp/data/CRG/20120502_FDF_CRG/20120502_FDF_CRG/20120504_FDF_CRG_c12.mtb	1191	NA	WWSS	water	2	94342	1336216528	1	0.02	0.000909090909090909	7110	1
3	Drink 2	Intake 2	16	94534	1336216720	/users/cn/jespinosa/phecomp/data/CRG/20120502_FDF_CRG/20120502_FDF_CRG/20120504_FDF_CRG_c12.mtb	1192	NA	WWSS	water	2	94518	1336216704	1	0.04	0.0025	7111	1
3	Drink 2	Intake 2	17	94723	1336216909	/users/cn/jespinosa/phecomp/data/CRG/20120502_FDF_CRG/20120502_FDF_CRG/20120504_FDF_CRG_c12.mtb	1194	NA	WWSS	water	2	94706	1336216892	1	0.02	0.00117647058823529	7112	1
3	Drink 2	Intake 2	39	95047	1336217233	/users/cn/jespinosa/phecomp/data/CRG/20120502_FDF_CRG/20120502_FDF_CRG/20120504_FDF_CRG_c12.mtb	1196	NA	WWSS	water	2	95008	1336217194	1	0.02	0.000512820512820513	7113	1
3	Food 2	Intake 4	278	95572	1336217758	/users/cn/jespinosa/phecomp/data/CRG/20120502_FDF_CRG/20120502_FDF_CRG/20120504_FDF_CRG_c12.mtb	924	21721	WWSS	food_sc	4	95294	1336217480	1	0.02	7.19424460431655e-05	7114	1
3	Food 2	Intake 4	354	117647	1336239833	/users/cn/jespinosa/phecomp/data/CRG/20120502_FDF_CRG/20120502_FDF_CRG/20120504_FDF_CRG_c12.mtb	931	19	WWSS	food_sc	4	117293	1336239479	1	0.04	0.000112994350282486	7115	1
3	Food 2	Intake 4	152	117818	1336240004	/users/cn/jespinosa/phecomp/data/CRG/20120502_FDF_CRG/20120502_FDF_CRG/20120504_FDF_CRG_c12.mtb	932	331	WWSS	food_sc	4	117666	1336239852	1	0.02	0.000131578947368421	7116	1
3	Food 2	Intake 4	483	118632	1336240818	/users/cn/jespinosa/phecomp/data/CRG/20120502_FDF_CRG/20120502_FDF_CRG/20120504_FDF_CRG_c12.mtb	934	977	WWSS	food_sc	4	118149	1336240335	1	0.0599999999999998	0.000124223602484472	7117	1
3	Drink 2	Intake 2	21	118650	1336240836	/users/cn/jespinosa/phecomp/data/CRG/20120502_FDF_CRG/20120502_FDF_CRG/20120504_FDF_CRG_c12.mtb	1198	NA	WWSS	water	2	118629	1336240815	1	0.02	0.000952380952380952	7118	1
3	Drink 2	Intake 2	18	118869	1336241055	/users/cn/jespinosa/phecomp/data/CRG/20120502_FDF_CRG/20120502_FDF_CRG/20120504_FDF_CRG_c12.mtb	1199	NA	WWSS	water	2	118851	1336241037	1	0.04	0.00222222222222222	7119	1
3	Food 1	Intake 3	411	120020	1336242206	/users/cn/jespinosa/phecomp/data/CRG/20120502_FDF_CRG/20120502_FDF_CRG/20120504_FDF_CRG_c12.mtb	665	248	WWSS	food_sc	3	119609	1336241795	1	0.02	4.8661800486618e-05	7120	1
3	Drink 1	Intake 1	15	120239	1336242425	/users/cn/jespinosa/phecomp/data/CRG/20120502_FDF_CRG/20120502_FDF_CRG/20120504_FDF_CRG_c12.mtb	261	NA	WWSS	water	1	120224	1336242410	1	0.0399999999999999	0.00266666666666666	7121	1
3	Drink 2	Intake 2	19	120253	1336242439	/users/cn/jespinosa/phecomp/data/CRG/20120502_FDF_CRG/20120502_FDF_CRG/20120504_FDF_CRG_c12.mtb	1200	NA	WWSS	water	2	120234	1336242420	1	0.04	0.00210526315789474	7122	1
3	Food 1	Intake 3	235	120503	1336242689	/users/cn/jespinosa/phecomp/data/CRG/20120502_FDF_CRG/20120502_FDF_CRG/20120504_FDF_CRG_c12.mtb	667	7	WWSS	food_sc	3	120268	1336242454	1	0.0800000000000001	0.000340425531914894	7123	1
3	Food 1	Intake 3	531	121041	1336243227	/users/cn/jespinosa/phecomp/data/CRG/20120502_FDF_CRG/20120502_FDF_CRG/20120504_FDF_CRG_c12.mtb	668	8	WWSS	food_sc	3	120510	1336242696	1	0.22	0.000414312617702448	7124	1
3	Food 1	Intake 3	160	121209	1336243395	/users/cn/jespinosa/phecomp/data/CRG/20120502_FDF_CRG/20120502_FDF_CRG/20120504_FDF_CRG_c12.mtb	669	6939	WWSS	food_sc	3	121049	1336243235	1	0.36	0.00225	7125	1
3	Drink 1	Intake 1	32	121446	1336243632	/users/cn/jespinosa/phecomp/data/CRG/20120502_FDF_CRG/20120502_FDF_CRG/20120504_FDF_CRG_c12.mtb	262	NA	WWSS	water	1	121414	1336243600	1	0.14	0.004375	7126	1
3	Drink 2	Intake 2	20	121477	1336243663	/users/cn/jespinosa/phecomp/data/CRG/20120502_FDF_CRG/20120502_FDF_CRG/20120504_FDF_CRG_c12.mtb	1201	NA	WWSS	water	2	121457	1336243643	1	0.04	0.002	7127	1
3	Drink 2	Intake 2	28	121559	1336243745	/users/cn/jespinosa/phecomp/data/CRG/20120502_FDF_CRG/20120502_FDF_CRG/20120504_FDF_CRG_c12.mtb	1202	NA	WWSS	water	2	121531	1336243717	1	0.02	0.000714285714285714	7128	1
3	Drink 2	Intake 2	10	121607	1336243793	/users/cn/jespinosa/phecomp/data/CRG/20120502_FDF_CRG/20120502_FDF_CRG/20120504_FDF_CRG_c12.mtb	1203	NA	WWSS	water	2	121597	1336243783	1	0.02	0.002	7129	1
3	Drink 2	Intake 2	21	122157	1336244343	/users/cn/jespinosa/phecomp/data/CRG/20120502_FDF_CRG/20120502_FDF_CRG/20120504_FDF_CRG_c12.mtb	1206	NA	WWSS	water	2	122136	1336244322	1	0.0600000000000005	0.00285714285714288	7130	1
3	Drink 1	Intake 1	10	122411	1336244597	/users/cn/jespinosa/phecomp/data/CRG/20120502_FDF_CRG/20120502_FDF_CRG/20120504_FDF_CRG_c12.mtb	263	NA	WWSS	water	1	122401	1336244587	1	0.02	0.002	7131	1
3	Drink 2	Intake 2	18	122581	1336244767	/users/cn/jespinosa/phecomp/data/CRG/20120502_FDF_CRG/20120502_FDF_CRG/20120504_FDF_CRG_c12.mtb	1208	NA	WWSS	water	2	122563	1336244749	1	0.02	0.00111111111111111	7132	1
3	Drink 2	Intake 2	20	123047	1336245233	/users/cn/jespinosa/phecomp/data/CRG/20120502_FDF_CRG/20120502_FDF_CRG/20120504_FDF_CRG_c12.mtb	1209	NA	WWSS	water	2	123027	1336245213	1	0.04	0.002	7133	1
3	Drink 2	Intake 2	20	123697	1336245883	/users/cn/jespinosa/phecomp/data/CRG/20120502_FDF_CRG/20120502_FDF_CRG/20120504_FDF_CRG_c12.mtb	1210	NA	WWSS	water	2	123677	1336245863	1	0.04	0.002	7134	1
3	Drink 2	Intake 2	13	127509	1336249695	/users/cn/jespinosa/phecomp/data/CRG/20120502_FDF_CRG/20120502_FDF_CRG/20120504_FDF_CRG_c12.mtb	1211	NA	WWSS	water	2	127496	1336249682	1	0.04	0.00307692307692308	7135	1
3	Food 2	Intake 4	1327	129475	1336251661	/users/cn/jespinosa/phecomp/data/CRG/20120502_FDF_CRG/20120502_FDF_CRG/20120504_FDF_CRG_c12.mtb	944	430	WWSS	food_sc	4	128148	1336250334	1	0.0600000000000001	4.52147701582518e-05	7136	1
3	Drink 2	Intake 2	35	129510	1336251696	/users/cn/jespinosa/phecomp/data/CRG/20120502_FDF_CRG/20120502_FDF_CRG/20120504_FDF_CRG_c12.mtb	1212	NA	WWSS	water	2	129475	1336251661	1	0.1	0.00285714285714286	7137	1
3	Food 2	Intake 4	635	130540	1336252726	/users/cn/jespinosa/phecomp/data/CRG/20120502_FDF_CRG/20120502_FDF_CRG/20120504_FDF_CRG_c12.mtb	946	1296	WWSS	food_sc	4	129905	1336252091	1	0.0600000000000001	9.44881889763781e-05	7138	1
3	Drink 2	Intake 2	24	130560	1336252746	/users/cn/jespinosa/phecomp/data/CRG/20120502_FDF_CRG/20120502_FDF_CRG/20120504_FDF_CRG_c12.mtb	1213	NA	WWSS	water	2	130536	1336252722	1	0.1	0.00416666666666667	7139	1
3	Drink 2	Intake 2	15	131302	1336253488	/users/cn/jespinosa/phecomp/data/CRG/20120502_FDF_CRG/20120502_FDF_CRG/20120504_FDF_CRG_c12.mtb	1214	NA	WWSS	water	2	131287	1336253473	1	0.02	0.00133333333333333	7140	1
3	Food 1	Intake 3	1288	133124	1336255310	/users/cn/jespinosa/phecomp/data/CRG/20120502_FDF_CRG/20120502_FDF_CRG/20120504_FDF_CRG_c12.mtb	685	9	WWSS	food_sc	3	131836	1336254022	1	0.02	1.5527950310559e-05	7141	1
3	Food 1	Intake 3	685	133818	1336256004	/users/cn/jespinosa/phecomp/data/CRG/20120502_FDF_CRG/20120502_FDF_CRG/20120504_FDF_CRG_c12.mtb	686	17	WWSS	food_sc	3	133133	1336255319	1	0.14	0.000204379562043796	7142	1
3	Food 1	Intake 3	161	133996	1336256182	/users/cn/jespinosa/phecomp/data/CRG/20120502_FDF_CRG/20120502_FDF_CRG/20120504_FDF_CRG_c12.mtb	687	91	WWSS	food_sc	3	133835	1336256021	1	0.04	0.000248447204968944	7143	1
3	Drink 2	Intake 2	36	134028	1336256214	/users/cn/jespinosa/phecomp/data/CRG/20120502_FDF_CRG/20120502_FDF_CRG/20120504_FDF_CRG_c12.mtb	1216	NA	WWSS	water	2	133992	1336256178	1	0.24	0.00666666666666667	7144	1
3	Drink 2	Intake 2	33	134088	1336256274	/users/cn/jespinosa/phecomp/data/CRG/20120502_FDF_CRG/20120502_FDF_CRG/20120504_FDF_CRG_c12.mtb	1217	NA	WWSS	water	2	134055	1336256241	1	0.0800000000000001	0.00242424242424243	7145	1
3	Food 1	Intake 3	427	134514	1336256700	/users/cn/jespinosa/phecomp/data/CRG/20120502_FDF_CRG/20120502_FDF_CRG/20120504_FDF_CRG_c12.mtb	688	96	WWSS	food_sc	3	134087	1336256273	1	0.0399999999999996	9.36768149882895e-05	7146	1
3	Drink 2	Intake 2	25	134535	1336256721	/users/cn/jespinosa/phecomp/data/CRG/20120502_FDF_CRG/20120502_FDF_CRG/20120504_FDF_CRG_c12.mtb	1218	NA	WWSS	water	2	134510	1336256696	1	0.0600000000000001	0.0024	7147	1
3	Food 1	Intake 3	512	135122	1336257308	/users/cn/jespinosa/phecomp/data/CRG/20120502_FDF_CRG/20120502_FDF_CRG/20120504_FDF_CRG_c12.mtb	689	19	WWSS	food_sc	3	134610	1336256796	1	0.04	7.8125e-05	7148	1
3	Drink 2	Intake 2	20	135148	1336257334	/users/cn/jespinosa/phecomp/data/CRG/20120502_FDF_CRG/20120502_FDF_CRG/20120504_FDF_CRG_c12.mtb	1219	NA	WWSS	water	2	135128	1336257314	1	0.04	0.002	7149	1
3	Food 1	Intake 3	720	135861	1336258047	/users/cn/jespinosa/phecomp/data/CRG/20120502_FDF_CRG/20120502_FDF_CRG/20120504_FDF_CRG_c12.mtb	690	223	WWSS	food_sc	3	135141	1336257327	1	0.1	0.000138888888888889	7150	1
3	Drink 2	Intake 2	28	135892	1336258078	/users/cn/jespinosa/phecomp/data/CRG/20120502_FDF_CRG/20120502_FDF_CRG/20120504_FDF_CRG_c12.mtb	1220	NA	WWSS	water	2	135864	1336258050	1	0.12	0.00428571428571429	7151	1
3	Food 1	Intake 3	571	136655	1336258841	/users/cn/jespinosa/phecomp/data/CRG/20120502_FDF_CRG/20120502_FDF_CRG/20120504_FDF_CRG_c12.mtb	691	257	WWSS	food_sc	3	136084	1336258270	1	0.0600000000000001	0.00010507880910683	7152	1
3	Drink 2	Intake 2	25	136678	1336258864	/users/cn/jespinosa/phecomp/data/CRG/20120502_FDF_CRG/20120502_FDF_CRG/20120504_FDF_CRG_c12.mtb	1223	NA	WWSS	water	2	136653	1336258839	1	0.12	0.0048	7153	1
3	Food 1	Intake 3	628	137540	1336259726	/users/cn/jespinosa/phecomp/data/CRG/20120502_FDF_CRG/20120502_FDF_CRG/20120504_FDF_CRG_c12.mtb	692	3349	WWSS	food_sc	3	136912	1336259098	1	0.0800000000000001	0.000127388535031847	7154	1
3	Drink 2	Intake 2	24	137559	1336259745	/users/cn/jespinosa/phecomp/data/CRG/20120502_FDF_CRG/20120502_FDF_CRG/20120504_FDF_CRG_c12.mtb	1224	NA	WWSS	water	2	137535	1336259721	1	0.0600000000000001	0.0025	7155	1
3	Food 1	Intake 3	733	141622	1336263808	/users/cn/jespinosa/phecomp/data/CRG/20120502_FDF_CRG/20120502_FDF_CRG/20120504_FDF_CRG_c12.mtb	695	458	WWSS	food_sc	3	140889	1336263075	1	0.14	0.000190995907230559	7156	1
3	Drink 2	Intake 2	15	141634	1336263820	/users/cn/jespinosa/phecomp/data/CRG/20120502_FDF_CRG/20120502_FDF_CRG/20120504_FDF_CRG_c12.mtb	1226	NA	WWSS	water	2	141619	1336263805	1	0.02	0.00133333333333333	7157	1
3	Drink 2	Intake 2	24	141974	1336264160	/users/cn/jespinosa/phecomp/data/CRG/20120502_FDF_CRG/20120502_FDF_CRG/20120504_FDF_CRG_c12.mtb	1227	NA	WWSS	water	2	141950	1336264136	1	0.0800000000000001	0.00333333333333334	7158	1
3	Food 1	Intake 3	485	142565	1336264751	/users/cn/jespinosa/phecomp/data/CRG/20120502_FDF_CRG/20120502_FDF_CRG/20120504_FDF_CRG_c12.mtb	698	5	WWSS	food_sc	3	142080	1336264266	1	0.16	0.000329896907216495	7159	1
3	Food 1	Intake 3	182	142752	1336264938	/users/cn/jespinosa/phecomp/data/CRG/20120502_FDF_CRG/20120502_FDF_CRG/20120504_FDF_CRG_c12.mtb	699	58	WWSS	food_sc	3	142570	1336264756	1	0.1	0.000549450549450549	7160	1
3	Food 1	Intake 3	259	143069	1336265255	/users/cn/jespinosa/phecomp/data/CRG/20120502_FDF_CRG/20120502_FDF_CRG/20120504_FDF_CRG_c12.mtb	700	166	WWSS	food_sc	3	142810	1336264996	1	0.0800000000000001	0.000308880308880309	7161	1
3	Drink 2	Intake 2	35	143101	1336265287	/users/cn/jespinosa/phecomp/data/CRG/20120502_FDF_CRG/20120502_FDF_CRG/20120504_FDF_CRG_c12.mtb	1228	NA	WWSS	water	2	143066	1336265252	1	0.24	0.00685714285714286	7162	1
3	Drink 2	Intake 2	17	143133	1336265319	/users/cn/jespinosa/phecomp/data/CRG/20120502_FDF_CRG/20120502_FDF_CRG/20120504_FDF_CRG_c12.mtb	1229	NA	WWSS	water	2	143116	1336265302	1	0.0599999999999996	0.00352941176470586	7163	1
3	Food 1	Intake 3	515	143750	1336265936	/users/cn/jespinosa/phecomp/data/CRG/20120502_FDF_CRG/20120502_FDF_CRG/20120504_FDF_CRG_c12.mtb	702	955	WWSS	food_sc	3	143235	1336265421	1	0.24	0.000466019417475728	7164	1
3	Drink 2	Intake 2	30	143782	1336265968	/users/cn/jespinosa/phecomp/data/CRG/20120502_FDF_CRG/20120502_FDF_CRG/20120504_FDF_CRG_c12.mtb	1230	NA	WWSS	water	2	143752	1336265938	1	0.140000000000001	0.0046666666666667	7165	1
3	Drink 2	Intake 2	32	144388	1336266574	/users/cn/jespinosa/phecomp/data/CRG/20120502_FDF_CRG/20120502_FDF_CRG/20120504_FDF_CRG_c12.mtb	1233	NA	WWSS	water	2	144356	1336266542	1	0.04	0.00125	7166	1
3	Food 1	Intake 3	157	144862	1336267048	/users/cn/jespinosa/phecomp/data/CRG/20120502_FDF_CRG/20120502_FDF_CRG/20120504_FDF_CRG_c12.mtb	704	11916	WWSS	food_sc	3	144705	1336266891	1	0.02	0.000127388535031847	7167	1
3	Drink 2	Intake 2	14	145611	1336267797	/users/cn/jespinosa/phecomp/data/CRG/20120502_FDF_CRG/20120502_FDF_CRG/20120504_FDF_CRG_c12.mtb	1241	NA	WWSS	water	2	145597	1336267783	1	0.0400000000000009	0.00285714285714292	7168	1
3	Food 1	Intake 3	1006	157784	1336279970	/users/cn/jespinosa/phecomp/data/CRG/20120502_FDF_CRG/20120502_FDF_CRG/20120504_FDF_CRG_c12.mtb	713	522	WWSS	food_sc	3	156778	1336278964	1	0.12	0.000119284294234592	7169	1
3	Drink 2	Intake 2	28	157809	1336279995	/users/cn/jespinosa/phecomp/data/CRG/20120502_FDF_CRG/20120502_FDF_CRG/20120504_FDF_CRG_c12.mtb	1255	NA	WWSS	water	2	157781	1336279967	1	0.0999999999999996	0.00357142857142856	7170	1
3	Drink 1	Intake 1	23	158195	1336280381	/users/cn/jespinosa/phecomp/data/CRG/20120502_FDF_CRG/20120502_FDF_CRG/20120504_FDF_CRG_c12.mtb	264	NA	WWSS	water	1	158172	1336280358	1	0.02	0.000869565217391304	7171	1
3	Drink 2	Intake 2	15	158244	1336280430	/users/cn/jespinosa/phecomp/data/CRG/20120502_FDF_CRG/20120502_FDF_CRG/20120504_FDF_CRG_c12.mtb	1256	NA	WWSS	water	2	158229	1336280415	1	0.0200000000000005	0.00133333333333337	7172	1
3	Food 1	Intake 3	614	158920	1336281106	/users/cn/jespinosa/phecomp/data/CRG/20120502_FDF_CRG/20120502_FDF_CRG/20120504_FDF_CRG_c12.mtb	717	6	WWSS	food_sc	3	158306	1336280492	1	0.1	0.000162866449511401	7173	1
3	Food 1	Intake 3	398	159324	1336281510	/users/cn/jespinosa/phecomp/data/CRG/20120502_FDF_CRG/20120502_FDF_CRG/20120504_FDF_CRG_c12.mtb	718	210	WWSS	food_sc	3	158926	1336281112	1	0.0800000000000001	0.000201005025125628	7174	1
3	Drink 2	Intake 2	28	159365	1336281551	/users/cn/jespinosa/phecomp/data/CRG/20120502_FDF_CRG/20120502_FDF_CRG/20120504_FDF_CRG_c12.mtb	1257	NA	WWSS	water	2	159337	1336281523	1	0.0999999999999996	0.00357142857142856	7175	1
3	Drink 1	Intake 1	17	159468	1336281654	/users/cn/jespinosa/phecomp/data/CRG/20120502_FDF_CRG/20120502_FDF_CRG/20120504_FDF_CRG_c12.mtb	265	NA	WWSS	water	1	159451	1336281637	1	0.0399999999999999	0.00235294117647058	7176	1
3	Drink 1	Intake 1	16	159527	1336281713	/users/cn/jespinosa/phecomp/data/CRG/20120502_FDF_CRG/20120502_FDF_CRG/20120504_FDF_CRG_c12.mtb	266	NA	WWSS	water	1	159511	1336281697	1	0.02	0.00125	7177	1
3	Food 1	Intake 3	1563	161097	1336283283	/users/cn/jespinosa/phecomp/data/CRG/20120502_FDF_CRG/20120502_FDF_CRG/20120504_FDF_CRG_c12.mtb	719	450	WWSS	food_sc	3	159534	1336281720	1	0.14	8.95713371721049e-05	7178	1
3	Drink 2	Intake 2	19	161116	1336283302	/users/cn/jespinosa/phecomp/data/CRG/20120502_FDF_CRG/20120502_FDF_CRG/20120504_FDF_CRG_c12.mtb	1258	NA	WWSS	water	2	161097	1336283283	1	0.04	0.00210526315789474	7179	1
3	Drink 1	Intake 1	17	161178	1336283364	/users/cn/jespinosa/phecomp/data/CRG/20120502_FDF_CRG/20120502_FDF_CRG/20120504_FDF_CRG_c12.mtb	267	NA	WWSS	water	1	161161	1336283347	1	0.04	0.00235294117647059	7180	1
3	Food 1	Intake 3	290	161837	1336284023	/users/cn/jespinosa/phecomp/data/CRG/20120502_FDF_CRG/20120502_FDF_CRG/20120504_FDF_CRG_c12.mtb	723	59	WWSS	food_sc	3	161547	1336283733	1	0.02	6.89655172413793e-05	7181	1
3	Food 1	Intake 3	542	162438	1336284624	/users/cn/jespinosa/phecomp/data/CRG/20120502_FDF_CRG/20120502_FDF_CRG/20120504_FDF_CRG_c12.mtb	724	40134	WWSS	food_sc	3	161896	1336284082	1	0.0600000000000001	0.00011070110701107	7182	1
3	Drink 2	Intake 2	29	162462	1336284648	/users/cn/jespinosa/phecomp/data/CRG/20120502_FDF_CRG/20120502_FDF_CRG/20120504_FDF_CRG_c12.mtb	1259	NA	WWSS	water	2	162433	1336284619	1	0.0999999999999996	0.00344827586206895	7183	1
3	Food 1	Intake 3	123	202695	1336324881	/users/cn/jespinosa/phecomp/data/CRG/20120502_FDF_CRG/20120502_FDF_CRG/20120504_FDF_CRG_c12.mtb	732	162	WWSS	food_sc	3	202572	1336324758	1	0.02	0.00016260162601626	7184	1
3	Food 2	Intake 4	1040	203897	1336326083	/users/cn/jespinosa/phecomp/data/CRG/20120502_FDF_CRG/20120502_FDF_CRG/20120504_FDF_CRG_c12.mtb	963	143	WWSS	food_sc	4	202857	1336325043	1	0.16	0.000153846153846154	7185	1
3	Drink 2	Intake 2	26	203920	1336326106	/users/cn/jespinosa/phecomp/data/CRG/20120502_FDF_CRG/20120502_FDF_CRG/20120504_FDF_CRG_c12.mtb	1266	NA	WWSS	water	2	203894	1336326080	1	0.0600000000000005	0.00230769230769233	7186	1
3	Drink 2	Intake 2	20	203966	1336326152	/users/cn/jespinosa/phecomp/data/CRG/20120502_FDF_CRG/20120502_FDF_CRG/20120504_FDF_CRG_c12.mtb	1267	NA	WWSS	water	2	203946	1336326132	1	0.0599999999999996	0.00299999999999998	7187	1
3	Food 2	Intake 4	285	204325	1336326511	/users/cn/jespinosa/phecomp/data/CRG/20120502_FDF_CRG/20120502_FDF_CRG/20120504_FDF_CRG_c12.mtb	965	1773	WWSS	food_sc	4	204040	1336326226	1	0.0399999999999998	0.000140350877192982	7188	1
3	Drink 2	Intake 2	14	204331	1336326517	/users/cn/jespinosa/phecomp/data/CRG/20120502_FDF_CRG/20120502_FDF_CRG/20120504_FDF_CRG_c12.mtb	1268	NA	WWSS	water	2	204317	1336326503	1	0.0600000000000005	0.00428571428571432	7189	1
3	Food 2	Intake 4	542	206640	1336328826	/users/cn/jespinosa/phecomp/data/CRG/20120502_FDF_CRG/20120502_FDF_CRG/20120504_FDF_CRG_c12.mtb	968	10	WWSS	food_sc	4	206098	1336328284	1	0.0999999999999999	0.00018450184501845	7190	1
3	Food 2	Intake 4	601	207251	1336329437	/users/cn/jespinosa/phecomp/data/CRG/20120502_FDF_CRG/20120502_FDF_CRG/20120504_FDF_CRG_c12.mtb	969	61	WWSS	food_sc	4	206650	1336328836	1	0.16	0.000266222961730449	7191	1
3	Drink 2	Intake 2	28	207271	1336329457	/users/cn/jespinosa/phecomp/data/CRG/20120502_FDF_CRG/20120502_FDF_CRG/20120504_FDF_CRG_c12.mtb	1269	NA	WWSS	water	2	207243	1336329429	1	0.12	0.00428571428571429	7192	1
3	Food 2	Intake 4	626	207938	1336330124	/users/cn/jespinosa/phecomp/data/CRG/20120502_FDF_CRG/20120502_FDF_CRG/20120504_FDF_CRG_c12.mtb	970	255	WWSS	food_sc	4	207312	1336329498	1	0.12	0.000191693290734824	7193	1
3	Drink 2	Intake 2	34	207966	1336330152	/users/cn/jespinosa/phecomp/data/CRG/20120502_FDF_CRG/20120502_FDF_CRG/20120504_FDF_CRG_c12.mtb	1270	NA	WWSS	water	2	207932	1336330118	1	0.16	0.00470588235294118	7194	1
3	Food 2	Intake 4	625	208818	1336331004	/users/cn/jespinosa/phecomp/data/CRG/20120502_FDF_CRG/20120502_FDF_CRG/20120504_FDF_CRG_c12.mtb	971	4	WWSS	food_sc	4	208193	1336330379	1	0.0800000000000001	0.000128	7195	1
3	Food 2	Intake 4	231	209053	1336331239	/users/cn/jespinosa/phecomp/data/CRG/20120502_FDF_CRG/20120502_FDF_CRG/20120504_FDF_CRG_c12.mtb	972	437	WWSS	food_sc	4	208822	1336331008	1	0.04	0.000173160173160173	7196	1
3	Drink 2	Intake 2	28	209076	1336331262	/users/cn/jespinosa/phecomp/data/CRG/20120502_FDF_CRG/20120502_FDF_CRG/20120504_FDF_CRG_c12.mtb	1272	NA	WWSS	water	2	209048	1336331234	1	0.12	0.00428571428571429	7197	1
3	Food 2	Intake 4	1048	210538	1336332724	/users/cn/jespinosa/phecomp/data/CRG/20120502_FDF_CRG/20120502_FDF_CRG/20120504_FDF_CRG_c12.mtb	973	44	WWSS	food_sc	4	209490	1336331676	1	0.0999999999999996	9.54198473282439e-05	7198	1
3	Drink 2	Intake 2	29	210556	1336332742	/users/cn/jespinosa/phecomp/data/CRG/20120502_FDF_CRG/20120502_FDF_CRG/20120504_FDF_CRG_c12.mtb	1273	NA	WWSS	water	2	210527	1336332713	1	0.14	0.00482758620689655	7199	1
3	Food 2	Intake 4	916	211498	1336333684	/users/cn/jespinosa/phecomp/data/CRG/20120502_FDF_CRG/20120502_FDF_CRG/20120504_FDF_CRG_c12.mtb	974	6	WWSS	food_sc	4	210582	1336332768	1	0.26	0.000283842794759825	7200	1
3	Food 2	Intake 4	49	211553	1336333739	/users/cn/jespinosa/phecomp/data/CRG/20120502_FDF_CRG/20120502_FDF_CRG/20120504_FDF_CRG_c12.mtb	975	48	WWSS	food_sc	4	211504	1336333690	1	0.02	0.000408163265306122	7201	1
3	Drink 2	Intake 2	26	211577	1336333763	/users/cn/jespinosa/phecomp/data/CRG/20120502_FDF_CRG/20120502_FDF_CRG/20120504_FDF_CRG_c12.mtb	1274	NA	WWSS	water	2	211551	1336333737	1	0.180000000000001	0.00692307692307696	7202	1
3	Food 2	Intake 4	171	211772	1336333958	/users/cn/jespinosa/phecomp/data/CRG/20120502_FDF_CRG/20120502_FDF_CRG/20120504_FDF_CRG_c12.mtb	976	2250	WWSS	food_sc	4	211601	1336333787	1	0.04	0.000233918128654971	7203	1
3	Drink 2	Intake 2	33	212275	1336334461	/users/cn/jespinosa/phecomp/data/CRG/20120502_FDF_CRG/20120502_FDF_CRG/20120504_FDF_CRG_c12.mtb	1278	NA	WWSS	water	2	212242	1336334428	1	0.0200000000000005	0.000606060606060621	7204	1
3	Drink 2	Intake 2	18	214015	1336336201	/users/cn/jespinosa/phecomp/data/CRG/20120502_FDF_CRG/20120502_FDF_CRG/20120504_FDF_CRG_c12.mtb	1288	NA	WWSS	water	2	213997	1336336183	1	0.04	0.00222222222222222	7205	1
3	Food 2	Intake 4	1042	215064	1336337250	/users/cn/jespinosa/phecomp/data/CRG/20120502_FDF_CRG/20120502_FDF_CRG/20120504_FDF_CRG_c12.mtb	985	706	WWSS	food_sc	4	214022	1336336208	1	0.12	0.000115163147792706	7206	1
3	Drink 2	Intake 2	25	215087	1336337273	/users/cn/jespinosa/phecomp/data/CRG/20120502_FDF_CRG/20120502_FDF_CRG/20120504_FDF_CRG_c12.mtb	1289	NA	WWSS	water	2	215062	1336337248	1	0.0599999999999996	0.00239999999999998	7207	1
3	Drink 2	Intake 2	17	215390	1336337576	/users/cn/jespinosa/phecomp/data/CRG/20120502_FDF_CRG/20120502_FDF_CRG/20120504_FDF_CRG_c12.mtb	1290	NA	WWSS	water	2	215373	1336337559	1	0.0200000000000005	0.00117647058823532	7208	1
3	Food 2	Intake 4	888	216658	1336338844	/users/cn/jespinosa/phecomp/data/CRG/20120502_FDF_CRG/20120502_FDF_CRG/20120504_FDF_CRG_c12.mtb	990	93	WWSS	food_sc	4	215770	1336337956	1	0.14	0.000157657657657658	7209	1
3	Drink 2	Intake 2	30	216679	1336338865	/users/cn/jespinosa/phecomp/data/CRG/20120502_FDF_CRG/20120502_FDF_CRG/20120504_FDF_CRG_c12.mtb	1294	NA	WWSS	water	2	216649	1336338835	1	0.16	0.00533333333333333	7210	1
3	Food 2	Intake 4	693	217444	1336339630	/users/cn/jespinosa/phecomp/data/CRG/20120502_FDF_CRG/20120502_FDF_CRG/20120504_FDF_CRG_c12.mtb	991	31	WWSS	food_sc	4	216751	1336338937	1	0.14	0.000202020202020202	7211	1
3	Food 2	Intake 4	514	217989	1336340175	/users/cn/jespinosa/phecomp/data/CRG/20120502_FDF_CRG/20120502_FDF_CRG/20120504_FDF_CRG_c12.mtb	992	83	WWSS	food_sc	4	217475	1336339661	1	0.18	0.000350194552529183	7212	1
3	Drink 2	Intake 2	30	218013	1336340199	/users/cn/jespinosa/phecomp/data/CRG/20120502_FDF_CRG/20120502_FDF_CRG/20120504_FDF_CRG_c12.mtb	1295	NA	WWSS	water	2	217983	1336340169	1	0.180000000000001	0.00600000000000003	7213	1
3	Food 2	Intake 4	233	218305	1336340491	/users/cn/jespinosa/phecomp/data/CRG/20120502_FDF_CRG/20120502_FDF_CRG/20120504_FDF_CRG_c12.mtb	993	38	WWSS	food_sc	4	218072	1336340258	1	0.0600000000000001	0.000257510729613734	7214	1
3	Food 2	Intake 4	61	218404	1336340590	/users/cn/jespinosa/phecomp/data/CRG/20120502_FDF_CRG/20120502_FDF_CRG/20120504_FDF_CRG_c12.mtb	995	6	WWSS	food_sc	4	218343	1336340529	1	0.02	0.000327868852459016	7215	1
3	Food 2	Intake 4	366	218776	1336340962	/users/cn/jespinosa/phecomp/data/CRG/20120502_FDF_CRG/20120502_FDF_CRG/20120504_FDF_CRG_c12.mtb	996	770	WWSS	food_sc	4	218410	1336340596	1	0.14	0.000382513661202186	7216	1
3	Drink 2	Intake 2	28	218794	1336340980	/users/cn/jespinosa/phecomp/data/CRG/20120502_FDF_CRG/20120502_FDF_CRG/20120504_FDF_CRG_c12.mtb	1297	NA	WWSS	water	2	218766	1336340952	1	0.16	0.00571428571428571	7217	1
3	Drink 2	Intake 2	52	219094	1336341280	/users/cn/jespinosa/phecomp/data/CRG/20120502_FDF_CRG/20120502_FDF_CRG/20120504_FDF_CRG_c12.mtb	1298	NA	WWSS	water	2	219042	1336341228	1	0.04	0.000769230769230769	7218	1
3	Food 2	Intake 4	541	220087	1336342273	/users/cn/jespinosa/phecomp/data/CRG/20120502_FDF_CRG/20120502_FDF_CRG/20120504_FDF_CRG_c12.mtb	998	5241	WWSS	food_sc	4	219546	1336341732	1	0.14	0.000258780036968577	7219	1
3	Drink 2	Intake 2	21	220097	1336342283	/users/cn/jespinosa/phecomp/data/CRG/20120502_FDF_CRG/20120502_FDF_CRG/20120504_FDF_CRG_c12.mtb	1301	NA	WWSS	water	2	220076	1336342262	1	0.0999999999999996	0.00476190476190474	7220	1
3	Drink 2	Intake 2	18	220120	1336342306	/users/cn/jespinosa/phecomp/data/CRG/20120502_FDF_CRG/20120502_FDF_CRG/20120504_FDF_CRG_c12.mtb	1302	NA	WWSS	water	2	220102	1336342288	1	0.0200000000000005	0.00111111111111114	7221	1
3	Food 2	Intake 4	439	225767	1336347953	/users/cn/jespinosa/phecomp/data/CRG/20120502_FDF_CRG/20120502_FDF_CRG/20120504_FDF_CRG_c12.mtb	1000	3650	WWSS	food_sc	4	225328	1336347514	1	0.46	0.00104783599088838	7222	1
3	Drink 2	Intake 2	65	226257	1336348443	/users/cn/jespinosa/phecomp/data/CRG/20120502_FDF_CRG/20120502_FDF_CRG/20120504_FDF_CRG_c12.mtb	1306	NA	WWSS	water	2	226192	1336348378	1	0.18	0.00276923076923077	7223	1
3	Drink 1	Intake 1	18	226318	1336348504	/users/cn/jespinosa/phecomp/data/CRG/20120502_FDF_CRG/20120502_FDF_CRG/20120504_FDF_CRG_c12.mtb	271	NA	WWSS	water	1	226300	1336348486	1	0.04	0.00222222222222222	7224	1
3	Drink 2	Intake 2	21	226542	1336348728	/users/cn/jespinosa/phecomp/data/CRG/20120502_FDF_CRG/20120502_FDF_CRG/20120504_FDF_CRG_c12.mtb	1307	NA	WWSS	water	2	226521	1336348707	1	0.04	0.0019047619047619	7225	1
3	Drink 2	Intake 2	15	226933	1336349119	/users/cn/jespinosa/phecomp/data/CRG/20120502_FDF_CRG/20120502_FDF_CRG/20120504_FDF_CRG_c12.mtb	1312	NA	WWSS	water	2	226918	1336349104	1	0.0200000000000005	0.00133333333333337	7226	1
3	Drink 2	Intake 2	35	227066	1336349252	/users/cn/jespinosa/phecomp/data/CRG/20120502_FDF_CRG/20120502_FDF_CRG/20120504_FDF_CRG_c12.mtb	1313	NA	WWSS	water	2	227031	1336349217	1	0.0399999999999991	0.00114285714285712	7227	1
3	Drink 2	Intake 2	17	227572	1336349758	/users/cn/jespinosa/phecomp/data/CRG/20120502_FDF_CRG/20120502_FDF_CRG/20120504_FDF_CRG_c12.mtb	1316	NA	WWSS	water	2	227555	1336349741	1	0.0200000000000005	0.00117647058823532	7228	1
3	Drink 2	Intake 2	20	228381	1336350567	/users/cn/jespinosa/phecomp/data/CRG/20120502_FDF_CRG/20120502_FDF_CRG/20120504_FDF_CRG_c12.mtb	1317	NA	WWSS	water	2	228361	1336350547	1	0.04	0.002	7229	1
3	Drink 2	Intake 2	12	228514	1336350700	/users/cn/jespinosa/phecomp/data/CRG/20120502_FDF_CRG/20120502_FDF_CRG/20120504_FDF_CRG_c12.mtb	1318	NA	WWSS	water	2	228502	1336350688	1	0.04	0.00333333333333333	7230	1
3	Drink 2	Intake 2	15	229190	1336351376	/users/cn/jespinosa/phecomp/data/CRG/20120502_FDF_CRG/20120502_FDF_CRG/20120504_FDF_CRG_c12.mtb	1320	NA	WWSS	water	2	229175	1336351361	1	0.0200000000000005	0.00133333333333337	7231	1
3	Food 2	Intake 4	76	229493	1336351679	/users/cn/jespinosa/phecomp/data/CRG/20120502_FDF_CRG/20120502_FDF_CRG/20120504_FDF_CRG_c12.mtb	1011	545	WWSS	food_sc	4	229417	1336351603	1	0.0200000000000005	0.000263157894736849	7232	1
3	Food 2	Intake 4	898	230936	1336353122	/users/cn/jespinosa/phecomp/data/CRG/20120502_FDF_CRG/20120502_FDF_CRG/20120504_FDF_CRG_c12.mtb	1014	4407	WWSS	food_sc	4	230038	1336352224	1	0.12	0.000133630289532294	7233	1
3	Drink 2	Intake 2	20	230959	1336353145	/users/cn/jespinosa/phecomp/data/CRG/20120502_FDF_CRG/20120502_FDF_CRG/20120504_FDF_CRG_c12.mtb	1322	NA	WWSS	water	2	230939	1336353125	1	0.0800000000000001	0.00400000000000001	7234	1
3	Drink 1	Intake 1	19	235072	1336357258	/users/cn/jespinosa/phecomp/data/CRG/20120502_FDF_CRG/20120502_FDF_CRG/20120504_FDF_CRG_c12.mtb	275	NA	WWSS	water	1	235053	1336357239	1	0.02	0.00105263157894737	7235	1
3	Food 2	Intake 4	856	236199	1336358385	/users/cn/jespinosa/phecomp/data/CRG/20120502_FDF_CRG/20120502_FDF_CRG/20120504_FDF_CRG_c12.mtb	1018	1346	WWSS	food_sc	4	235343	1336357529	1	0.14	0.000163551401869159	7236	1
3	Drink 2	Intake 2	25	236231	1336358417	/users/cn/jespinosa/phecomp/data/CRG/20120502_FDF_CRG/20120502_FDF_CRG/20120504_FDF_CRG_c12.mtb	1323	NA	WWSS	water	2	236206	1336358392	1	0.0800000000000001	0.0032	7237	1
3	Drink 2	Intake 2	13	236446	1336358632	/users/cn/jespinosa/phecomp/data/CRG/20120502_FDF_CRG/20120502_FDF_CRG/20120504_FDF_CRG_c12.mtb	1325	NA	WWSS	water	2	236433	1336358619	1	0.0800000000000001	0.00615384615384616	7238	1
3	Drink 1	Intake 1	24	237261	1336359447	/users/cn/jespinosa/phecomp/data/CRG/20120502_FDF_CRG/20120502_FDF_CRG/20120504_FDF_CRG_c12.mtb	277	NA	WWSS	water	1	237237	1336359423	1	0.02	0.000833333333333333	7239	1
3	Food 2	Intake 4	295	237840	1336360026	/users/cn/jespinosa/phecomp/data/CRG/20120502_FDF_CRG/20120502_FDF_CRG/20120504_FDF_CRG_c12.mtb	1024	51	WWSS	food_sc	4	237545	1336359731	1	0.0600000000000005	0.000203389830508476	7240	1
3	Food 2	Intake 4	524	238415	1336360601	/users/cn/jespinosa/phecomp/data/CRG/20120502_FDF_CRG/20120502_FDF_CRG/20120504_FDF_CRG_c12.mtb	1025	7753	WWSS	food_sc	4	237891	1336360077	1	0.119999999999999	0.000229007633587784	7241	1
3	Drink 2	Intake 2	26	238468	1336360654	/users/cn/jespinosa/phecomp/data/CRG/20120502_FDF_CRG/20120502_FDF_CRG/20120504_FDF_CRG_c12.mtb	1328	NA	WWSS	water	2	238442	1336360628	1	0.0800000000000001	0.00307692307692308	7242	1
3	Food 1	Intake 3	620	246788	1336368974	/users/cn/jespinosa/phecomp/data/CRG/20120502_FDF_CRG/20120502_FDF_CRG/20120504_FDF_CRG_c12.mtb	758	4	WWSS	food_sc	3	246168	1336368354	1	0.14	0.000225806451612903	7243	1
3	Food 1	Intake 3	292	247084	1336369270	/users/cn/jespinosa/phecomp/data/CRG/20120502_FDF_CRG/20120502_FDF_CRG/20120504_FDF_CRG_c12.mtb	759	714	WWSS	food_sc	3	246792	1336368978	1	0.12	0.000410958904109589	7244	1
3	Drink 2	Intake 2	30	247108	1336369294	/users/cn/jespinosa/phecomp/data/CRG/20120502_FDF_CRG/20120502_FDF_CRG/20120504_FDF_CRG_c12.mtb	1334	NA	WWSS	water	2	247078	1336369264	1	0.16	0.00533333333333333	7245	1
3	Drink 2	Intake 2	18	247154	1336369340	/users/cn/jespinosa/phecomp/data/CRG/20120502_FDF_CRG/20120502_FDF_CRG/20120504_FDF_CRG_c12.mtb	1335	NA	WWSS	water	2	247136	1336369322	1	0.0599999999999996	0.00333333333333331	7246	1
3	Drink 2	Intake 2	72	247800	1336369986	/users/cn/jespinosa/phecomp/data/CRG/20120502_FDF_CRG/20120502_FDF_CRG/20120504_FDF_CRG_c12.mtb	1337	NA	WWSS	water	2	247728	1336369914	1	0.0200000000000005	0.000277777777777785	7247	1
3	Food 1	Intake 3	401	248199	1336370385	/users/cn/jespinosa/phecomp/data/CRG/20120502_FDF_CRG/20120502_FDF_CRG/20120504_FDF_CRG_c12.mtb	762	1825	WWSS	food_sc	3	247798	1336369984	1	0.12	0.00029925187032419	7248	1
3	Drink 2	Intake 2	18	248271	1336370457	/users/cn/jespinosa/phecomp/data/CRG/20120502_FDF_CRG/20120502_FDF_CRG/20120504_FDF_CRG_c12.mtb	1338	NA	WWSS	water	2	248253	1336370439	1	0.0800000000000001	0.00444444444444445	7249	1
3	Drink 2	Intake 2	33	248577	1336370763	/users/cn/jespinosa/phecomp/data/CRG/20120502_FDF_CRG/20120502_FDF_CRG/20120504_FDF_CRG_c12.mtb	1339	NA	WWSS	water	2	248544	1336370730	1	0.0599999999999996	0.00181818181818181	7250	1
3	Drink 2	Intake 2	109	249772	1336371958	/users/cn/jespinosa/phecomp/data/CRG/20120502_FDF_CRG/20120502_FDF_CRG/20120504_FDF_CRG_c12.mtb	1342	NA	WWSS	water	2	249663	1336371849	1	0.0200000000000005	0.000183486238532115	7251	1
3	Food 1	Intake 3	446	250470	1336372656	/users/cn/jespinosa/phecomp/data/CRG/20120502_FDF_CRG/20120502_FDF_CRG/20120504_FDF_CRG_c12.mtb	764	14372	WWSS	food_sc	3	250024	1336372210	1	0.0999999999999996	0.00022421524663677	7252	1
3	Drink 1	Intake 1	11	307	1336382818	/users/cn/jespinosa/phecomp/data/CRG/20120502_FDF_CRG/20120502_FDF_CRG/20120507_FDF_CRG_c12.mtb	348	NA	WWSS	water	1	296	1336382807	1	0.04	0.00363636363636364	7253	1
3	Drink 2	Intake 2	13	1705	1336384216	/users/cn/jespinosa/phecomp/data/CRG/20120502_FDF_CRG/20120502_FDF_CRG/20120507_FDF_CRG_c12.mtb	1512	NA	WWSS	water	2	1692	1336384203	1	0.06	0.00461538461538461	7254	1
3	Drink 2	Intake 2	17	4370	1336386881	/users/cn/jespinosa/phecomp/data/CRG/20120502_FDF_CRG/20120502_FDF_CRG/20120507_FDF_CRG_c12.mtb	1514	NA	WWSS	water	2	4353	1336386864	1	0.02	0.00117647058823529	7255	1
3	Food 2	Intake 4	484	5001	1336387512	/users/cn/jespinosa/phecomp/data/CRG/20120502_FDF_CRG/20120502_FDF_CRG/20120507_FDF_CRG_c12.mtb	1397	17999	WWSS	food_sc	4	4517	1336387028	1	0.04	8.26446280991736e-05	7256	1
3	Drink 1	Intake 1	14	5126	1336387637	/users/cn/jespinosa/phecomp/data/CRG/20120502_FDF_CRG/20120502_FDF_CRG/20120507_FDF_CRG_c12.mtb	349	NA	WWSS	water	1	5112	1336387623	1	0.04	0.00285714285714286	7257	1
3	Drink 2	Intake 2	9	22831	1336405342	/users/cn/jespinosa/phecomp/data/CRG/20120502_FDF_CRG/20120502_FDF_CRG/20120507_FDF_CRG_c12.mtb	1521	NA	WWSS	water	2	22822	1336405333	1	0.02	0.00222222222222222	7258	1
3	Food 1	Intake 3	411	23411	1336405922	/users/cn/jespinosa/phecomp/data/CRG/20120502_FDF_CRG/20120502_FDF_CRG/20120507_FDF_CRG_c12.mtb	912	6015	WWSS	food_sc	3	23000	1336405511	1	0.06	0.000145985401459854	7259	1
3	Food 1	Intake 3	521	29947	1336412458	/users/cn/jespinosa/phecomp/data/CRG/20120502_FDF_CRG/20120502_FDF_CRG/20120507_FDF_CRG_c12.mtb	914	COLL	WWSS	food_sc	3	29426	1336411937	1	0.04	7.67754318618042e-05	7260	1
3	Food 2	Intake 4	375	30313	1336412824	/users/cn/jespinosa/phecomp/data/CRG/20120502_FDF_CRG/20120502_FDF_CRG/20120507_FDF_CRG_c12.mtb	1402	1742	WWSS	food_sc	4	29938	1336412449	1	0.04	0.000106666666666667	7261	1
3	Drink 1	Intake 1	13	31290	1336413801	/users/cn/jespinosa/phecomp/data/CRG/20120502_FDF_CRG/20120502_FDF_CRG/20120507_FDF_CRG_c12.mtb	352	NA	WWSS	water	1	31277	1336413788	1	0.04	0.00307692307692308	7262	1
3	Food 2	Intake 4	57	32112	1336414623	/users/cn/jespinosa/phecomp/data/CRG/20120502_FDF_CRG/20120502_FDF_CRG/20120507_FDF_CRG_c12.mtb	1404	30	WWSS	food_sc	4	32055	1336414566	1	0.02	0.000350877192982456	7263	1
3	Food 2	Intake 4	237	32379	1336414890	/users/cn/jespinosa/phecomp/data/CRG/20120502_FDF_CRG/20120502_FDF_CRG/20120507_FDF_CRG_c12.mtb	1405	8	WWSS	food_sc	4	32142	1336414653	1	0.02	8.43881856540084e-05	7264	1
3	Food 1	Intake 3	731	33118	1336415629	/users/cn/jespinosa/phecomp/data/CRG/20120502_FDF_CRG/20120502_FDF_CRG/20120507_FDF_CRG_c12.mtb	919	740	WWSS	food_sc	3	32387	1336414898	1	0.18	0.000246238030095759	7265	1
3	Drink 2	Intake 2	12	33126	1336415637	/users/cn/jespinosa/phecomp/data/CRG/20120502_FDF_CRG/20120502_FDF_CRG/20120507_FDF_CRG_c12.mtb	1523	NA	WWSS	water	2	33114	1336415625	1	0.04	0.00333333333333333	7266	1
3	Drink 2	Intake 2	18	33234	1336415745	/users/cn/jespinosa/phecomp/data/CRG/20120502_FDF_CRG/20120502_FDF_CRG/20120507_FDF_CRG_c12.mtb	1524	NA	WWSS	water	2	33216	1336415727	1	0.02	0.00111111111111111	7267	1
3	Drink 2	Intake 2	21	33851	1336416362	/users/cn/jespinosa/phecomp/data/CRG/20120502_FDF_CRG/20120502_FDF_CRG/20120507_FDF_CRG_c12.mtb	1525	NA	WWSS	water	2	33830	1336416341	1	0.08	0.00380952380952381	7268	1
3	Food 1	Intake 3	760	34618	1336417129	/users/cn/jespinosa/phecomp/data/CRG/20120502_FDF_CRG/20120502_FDF_CRG/20120507_FDF_CRG_c12.mtb	920	958	WWSS	food_sc	3	33858	1336416369	1	0.22	0.000289473684210526	7269	1
3	Drink 2	Intake 2	125	34748	1336417259	/users/cn/jespinosa/phecomp/data/CRG/20120502_FDF_CRG/20120502_FDF_CRG/20120507_FDF_CRG_c12.mtb	1526	NA	WWSS	water	2	34623	1336417134	1	0.08	0.00064	7270	1
3	Drink 2	Intake 2	103	34873	1336417384	/users/cn/jespinosa/phecomp/data/CRG/20120502_FDF_CRG/20120502_FDF_CRG/20120507_FDF_CRG_c12.mtb	1527	NA	WWSS	water	2	34770	1336417281	1	0.02	0.000194174757281553	7271	1
3	Drink 2	Intake 2	21	34917	1336417428	/users/cn/jespinosa/phecomp/data/CRG/20120502_FDF_CRG/20120502_FDF_CRG/20120507_FDF_CRG_c12.mtb	1528	NA	WWSS	water	2	34896	1336417407	1	0.02	0.000952380952380952	7272	1
3	Drink 1	Intake 1	25	35568	1336418079	/users/cn/jespinosa/phecomp/data/CRG/20120502_FDF_CRG/20120502_FDF_CRG/20120507_FDF_CRG_c12.mtb	353	NA	WWSS	water	1	35543	1336418054	1	0.08	0.0032	7273	1
3	Food 1	Intake 3	811	36387	1336418898	/users/cn/jespinosa/phecomp/data/CRG/20120502_FDF_CRG/20120502_FDF_CRG/20120507_FDF_CRG_c12.mtb	921	1351	WWSS	food_sc	3	35576	1336418087	1	0.26	0.00032059186189889	7274	1
3	Drink 1	Intake 1	37	36420	1336418931	/users/cn/jespinosa/phecomp/data/CRG/20120502_FDF_CRG/20120502_FDF_CRG/20120507_FDF_CRG_c12.mtb	354	NA	WWSS	water	1	36383	1336418894	1	0.14	0.00378378378378378	7275	1
3	Food 1	Intake 3	162	37900	1336420411	/users/cn/jespinosa/phecomp/data/CRG/20120502_FDF_CRG/20120502_FDF_CRG/20120507_FDF_CRG_c12.mtb	922	9	WWSS	food_sc	3	37738	1336420249	1	0.0599999999999999	0.00037037037037037	7276	1
3	Food 1	Intake 3	407	38316	1336420827	/users/cn/jespinosa/phecomp/data/CRG/20120502_FDF_CRG/20120502_FDF_CRG/20120507_FDF_CRG_c12.mtb	923	778	WWSS	food_sc	3	37909	1336420420	1	0.2	0.000491400491400491	7277	1
3	Drink 2	Intake 2	33	38342	1336420853	/users/cn/jespinosa/phecomp/data/CRG/20120502_FDF_CRG/20120502_FDF_CRG/20120507_FDF_CRG_c12.mtb	1529	NA	WWSS	water	2	38309	1336420820	1	0.16	0.00484848484848485	7278	1
3	Drink 2	Intake 2	15	38416	1336420927	/users/cn/jespinosa/phecomp/data/CRG/20120502_FDF_CRG/20120502_FDF_CRG/20120507_FDF_CRG_c12.mtb	1530	NA	WWSS	water	2	38401	1336420912	1	0.02	0.00133333333333333	7279	1
3	Drink 2	Intake 2	15	38570	1336421081	/users/cn/jespinosa/phecomp/data/CRG/20120502_FDF_CRG/20120502_FDF_CRG/20120507_FDF_CRG_c12.mtb	1533	NA	WWSS	water	2	38555	1336421066	1	0.0399999999999999	0.00266666666666666	7280	1
3	Drink 2	Intake 2	66	39046	1336421557	/users/cn/jespinosa/phecomp/data/CRG/20120502_FDF_CRG/20120502_FDF_CRG/20120507_FDF_CRG_c12.mtb	1538	NA	WWSS	water	2	38980	1336421491	1	0.02	0.000303030303030303	7281	1
3	Food 1	Intake 3	40	39134	1336421645	/users/cn/jespinosa/phecomp/data/CRG/20120502_FDF_CRG/20120502_FDF_CRG/20120507_FDF_CRG_c12.mtb	925	25	WWSS	food_sc	3	39094	1336421605	1	0.04	0.001	7282	1
3	Food 1	Intake 3	23	39182	1336421693	/users/cn/jespinosa/phecomp/data/CRG/20120502_FDF_CRG/20120502_FDF_CRG/20120507_FDF_CRG_c12.mtb	926	23	WWSS	food_sc	3	39159	1336421670	1	0.02	0.000869565217391304	7283	1
3	Food 1	Intake 3	326	39531	1336422042	/users/cn/jespinosa/phecomp/data/CRG/20120502_FDF_CRG/20120502_FDF_CRG/20120507_FDF_CRG_c12.mtb	927	5757	WWSS	food_sc	3	39205	1336421716	1	0.36	0.00110429447852761	7284	1
3	Drink 1	Intake 1	26	39757	1336422268	/users/cn/jespinosa/phecomp/data/CRG/20120502_FDF_CRG/20120502_FDF_CRG/20120507_FDF_CRG_c12.mtb	355	NA	WWSS	water	1	39731	1336422242	1	0.14	0.00538461538461539	7285	1
3	Drink 2	Intake 2	23	39822	1336422333	/users/cn/jespinosa/phecomp/data/CRG/20120502_FDF_CRG/20120502_FDF_CRG/20120507_FDF_CRG_c12.mtb	1540	NA	WWSS	water	2	39799	1336422310	1	0.02	0.000869565217391304	7286	1
3	Drink 2	Intake 2	14	40233	1336422744	/users/cn/jespinosa/phecomp/data/CRG/20120502_FDF_CRG/20120502_FDF_CRG/20120507_FDF_CRG_c12.mtb	1541	NA	WWSS	water	2	40219	1336422730	1	0.04	0.00285714285714286	7287	1
3	Drink 2	Intake 2	135	43563	1336426074	/users/cn/jespinosa/phecomp/data/CRG/20120502_FDF_CRG/20120502_FDF_CRG/20120507_FDF_CRG_c12.mtb	1544	NA	WWSS	water	2	43428	1336425939	1	0.02	0.000148148148148148	7288	1
3	Food 1	Intake 3	173	45461	1336427972	/users/cn/jespinosa/phecomp/data/CRG/20120502_FDF_CRG/20120502_FDF_CRG/20120507_FDF_CRG_c12.mtb	932	16	WWSS	food_sc	3	45288	1336427799	1	0.0800000000000001	0.00046242774566474	7289	1
3	Food 1	Intake 3	254	45731	1336428242	/users/cn/jespinosa/phecomp/data/CRG/20120502_FDF_CRG/20120502_FDF_CRG/20120507_FDF_CRG_c12.mtb	933	1490	WWSS	food_sc	3	45477	1336427988	1	0.28	0.00110236220472441	7290	1
3	Drink 2	Intake 2	17	45997	1336428508	/users/cn/jespinosa/phecomp/data/CRG/20120502_FDF_CRG/20120502_FDF_CRG/20120507_FDF_CRG_c12.mtb	1549	NA	WWSS	water	2	45980	1336428491	1	0.1	0.00588235294117647	7291	1
3	Drink 1	Intake 1	16	46049	1336428560	/users/cn/jespinosa/phecomp/data/CRG/20120502_FDF_CRG/20120502_FDF_CRG/20120507_FDF_CRG_c12.mtb	356	NA	WWSS	water	1	46033	1336428544	1	0.04	0.0025	7292	1
3	Drink 2	Intake 2	16	46286	1336428797	/users/cn/jespinosa/phecomp/data/CRG/20120502_FDF_CRG/20120502_FDF_CRG/20120507_FDF_CRG_c12.mtb	1551	NA	WWSS	water	2	46270	1336428781	1	0.0399999999999999	0.00249999999999999	7293	1
3	Drink 2	Intake 2	15	46381	1336428892	/users/cn/jespinosa/phecomp/data/CRG/20120502_FDF_CRG/20120502_FDF_CRG/20120507_FDF_CRG_c12.mtb	1552	NA	WWSS	water	2	46366	1336428877	1	0.02	0.00133333333333333	7294	1
3	Drink 2	Intake 2	23	46859	1336429370	/users/cn/jespinosa/phecomp/data/CRG/20120502_FDF_CRG/20120502_FDF_CRG/20120507_FDF_CRG_c12.mtb	1554	NA	WWSS	water	2	46836	1336429347	1	0.02	0.000869565217391304	7295	1
3	Drink 2	Intake 2	19	46978	1336429489	/users/cn/jespinosa/phecomp/data/CRG/20120502_FDF_CRG/20120502_FDF_CRG/20120507_FDF_CRG_c12.mtb	1555	NA	WWSS	water	2	46959	1336429470	1	0.04	0.00210526315789474	7296	1
3	Food 1	Intake 3	155	47376	1336429887	/users/cn/jespinosa/phecomp/data/CRG/20120502_FDF_CRG/20120502_FDF_CRG/20120507_FDF_CRG_c12.mtb	936	1568	WWSS	food_sc	3	47221	1336429732	1	0.0599999999999998	0.000387096774193547	7297	1
3	Drink 2	Intake 2	25	47415	1336429926	/users/cn/jespinosa/phecomp/data/CRG/20120502_FDF_CRG/20120502_FDF_CRG/20120507_FDF_CRG_c12.mtb	1556	NA	WWSS	water	2	47390	1336429901	1	0.0399999999999999	0.0016	7298	1
3	Food 1	Intake 3	452	49396	1336431907	/users/cn/jespinosa/phecomp/data/CRG/20120502_FDF_CRG/20120502_FDF_CRG/20120507_FDF_CRG_c12.mtb	937	886	WWSS	food_sc	3	48944	1336431455	1	0.14	0.000309734513274336	7299	1
3	Drink 2	Intake 2	23	49410	1336431921	/users/cn/jespinosa/phecomp/data/CRG/20120502_FDF_CRG/20120502_FDF_CRG/20120507_FDF_CRG_c12.mtb	1558	NA	WWSS	water	2	49387	1336431898	1	0.0600000000000001	0.00260869565217392	7300	1
3	Drink 2	Intake 2	18	49568	1336432079	/users/cn/jespinosa/phecomp/data/CRG/20120502_FDF_CRG/20120502_FDF_CRG/20120507_FDF_CRG_c12.mtb	1559	NA	WWSS	water	2	49550	1336432061	1	0.02	0.00111111111111111	7301	1
3	Drink 1	Intake 1	12	50063	1336432574	/users/cn/jespinosa/phecomp/data/CRG/20120502_FDF_CRG/20120502_FDF_CRG/20120507_FDF_CRG_c12.mtb	357	NA	WWSS	water	1	50051	1336432562	1	0.02	0.00166666666666667	7302	1
3	Food 1	Intake 3	59	50341	1336432852	/users/cn/jespinosa/phecomp/data/CRG/20120502_FDF_CRG/20120502_FDF_CRG/20120507_FDF_CRG_c12.mtb	940	3085	WWSS	food_sc	3	50282	1336432793	1	0.26	0.00440677966101695	7303	1
3	Drink 2	Intake 2	22	50661	1336433172	/users/cn/jespinosa/phecomp/data/CRG/20120502_FDF_CRG/20120502_FDF_CRG/20120507_FDF_CRG_c12.mtb	1563	NA	WWSS	water	2	50639	1336433150	1	0.0800000000000001	0.00363636363636364	7304	1
3	Drink 2	Intake 2	20	50702	1336433213	/users/cn/jespinosa/phecomp/data/CRG/20120502_FDF_CRG/20120502_FDF_CRG/20120507_FDF_CRG_c12.mtb	1564	NA	WWSS	water	2	50682	1336433193	1	0.02	0.001	7305	1
3	Drink 2	Intake 2	75	50949	1336433460	/users/cn/jespinosa/phecomp/data/CRG/20120502_FDF_CRG/20120502_FDF_CRG/20120507_FDF_CRG_c12.mtb	1566	NA	WWSS	water	2	50874	1336433385	1	0.0399999999999998	0.000533333333333331	7306	1
3	Drink 2	Intake 2	28	51193	1336433704	/users/cn/jespinosa/phecomp/data/CRG/20120502_FDF_CRG/20120502_FDF_CRG/20120507_FDF_CRG_c12.mtb	1571	NA	WWSS	water	2	51165	1336433676	1	0.02	0.000714285714285714	7307	1
3	Food 1	Intake 3	137	53563	1336436074	/users/cn/jespinosa/phecomp/data/CRG/20120502_FDF_CRG/20120502_FDF_CRG/20120507_FDF_CRG_c12.mtb	943	238	WWSS	food_sc	3	53426	1336435937	1	0.04	0.000291970802919708	7308	1
3	Food 1	Intake 3	533	54334	1336436845	/users/cn/jespinosa/phecomp/data/CRG/20120502_FDF_CRG/20120502_FDF_CRG/20120507_FDF_CRG_c12.mtb	945	469	WWSS	food_sc	3	53801	1336436312	1	0.1	0.000187617260787992	7309	1
3	Drink 1	Intake 1	19	54348	1336436859	/users/cn/jespinosa/phecomp/data/CRG/20120502_FDF_CRG/20120502_FDF_CRG/20120507_FDF_CRG_c12.mtb	358	NA	WWSS	water	1	54329	1336436840	1	0.0399999999999999	0.00210526315789473	7310	1
3	Drink 2	Intake 2	32	54382	1336436893	/users/cn/jespinosa/phecomp/data/CRG/20120502_FDF_CRG/20120502_FDF_CRG/20120507_FDF_CRG_c12.mtb	1577	NA	WWSS	water	2	54350	1336436861	1	0.02	0.000625	7311	1
3	Drink 2	Intake 2	27	54506	1336437017	/users/cn/jespinosa/phecomp/data/CRG/20120502_FDF_CRG/20120502_FDF_CRG/20120507_FDF_CRG_c12.mtb	1578	NA	WWSS	water	2	54479	1336436990	1	0.02	0.000740740740740741	7312	1
3	Drink 1	Intake 1	17	54626	1336437137	/users/cn/jespinosa/phecomp/data/CRG/20120502_FDF_CRG/20120502_FDF_CRG/20120507_FDF_CRG_c12.mtb	359	NA	WWSS	water	1	54609	1336437120	1	0.04	0.00235294117647059	7313	1
3	Food 1	Intake 3	124	54927	1336437438	/users/cn/jespinosa/phecomp/data/CRG/20120502_FDF_CRG/20120502_FDF_CRG/20120507_FDF_CRG_c12.mtb	950	1119	WWSS	food_sc	3	54803	1336437314	1	0.02	0.000161290322580645	7314	1
3	Drink 2	Intake 2	16	54942	1336437453	/users/cn/jespinosa/phecomp/data/CRG/20120502_FDF_CRG/20120502_FDF_CRG/20120507_FDF_CRG_c12.mtb	1582	NA	WWSS	water	2	54926	1336437437	1	0.04	0.0025	7315	1
3	Drink 2	Intake 2	15	55225	1336437736	/users/cn/jespinosa/phecomp/data/CRG/20120502_FDF_CRG/20120502_FDF_CRG/20120507_FDF_CRG_c12.mtb	1583	NA	WWSS	water	2	55210	1336437721	1	0.02	0.00133333333333333	7316	1
3	Drink 2	Intake 2	17	55381	1336437892	/users/cn/jespinosa/phecomp/data/CRG/20120502_FDF_CRG/20120502_FDF_CRG/20120507_FDF_CRG_c12.mtb	1584	NA	WWSS	water	2	55364	1336437875	1	0.02	0.00117647058823529	7317	1
3	Food 1	Intake 3	188	56234	1336438745	/users/cn/jespinosa/phecomp/data/CRG/20120502_FDF_CRG/20120502_FDF_CRG/20120507_FDF_CRG_c12.mtb	952	17	WWSS	food_sc	3	56046	1336438557	1	0.02	0.000106382978723404	7318	1
3	Drink 2	Intake 2	24	56253	1336438764	/users/cn/jespinosa/phecomp/data/CRG/20120502_FDF_CRG/20120502_FDF_CRG/20120507_FDF_CRG_c12.mtb	1586	NA	WWSS	water	2	56229	1336438740	1	0.02	0.000833333333333333	7319	1
3	Food 1	Intake 3	353	56604	1336439115	/users/cn/jespinosa/phecomp/data/CRG/20120502_FDF_CRG/20120502_FDF_CRG/20120507_FDF_CRG_c12.mtb	953	38	WWSS	food_sc	3	56251	1336438762	1	0.0800000000000001	0.000226628895184136	7320	1
3	Drink 2	Intake 2	23	56631	1336439142	/users/cn/jespinosa/phecomp/data/CRG/20120502_FDF_CRG/20120502_FDF_CRG/20120507_FDF_CRG_c12.mtb	1587	NA	WWSS	water	2	56608	1336439119	1	0.0599999999999998	0.0026086956521739	7321	1
3	Food 1	Intake 3	144	56786	1336439297	/users/cn/jespinosa/phecomp/data/CRG/20120502_FDF_CRG/20120502_FDF_CRG/20120507_FDF_CRG_c12.mtb	954	99	WWSS	food_sc	3	56642	1336439153	1	0.02	0.000138888888888889	7322	1
3	Food 2	Intake 4	509	57394	1336439905	/users/cn/jespinosa/phecomp/data/CRG/20120502_FDF_CRG/20120502_FDF_CRG/20120507_FDF_CRG_c12.mtb	1421	4298	WWSS	food_sc	4	56885	1336439396	1	0.18	0.000353634577603143	7323	1
3	Drink 2	Intake 2	30	57419	1336439930	/users/cn/jespinosa/phecomp/data/CRG/20120502_FDF_CRG/20120502_FDF_CRG/20120507_FDF_CRG_c12.mtb	1588	NA	WWSS	water	2	57389	1336439900	1	0.12	0.004	7324	1
3	Drink 1	Intake 1	20	57494	1336440005	/users/cn/jespinosa/phecomp/data/CRG/20120502_FDF_CRG/20120502_FDF_CRG/20120507_FDF_CRG_c12.mtb	360	NA	WWSS	water	1	57474	1336439985	1	0.0600000000000001	0.00300000000000001	7325	1
3	Drink 2	Intake 2	17	57873	1336440384	/users/cn/jespinosa/phecomp/data/CRG/20120502_FDF_CRG/20120502_FDF_CRG/20120507_FDF_CRG_c12.mtb	1589	NA	WWSS	water	2	57856	1336440367	1	0.02	0.00117647058823529	7326	1
3	Food 2	Intake 4	743	62435	1336444946	/users/cn/jespinosa/phecomp/data/CRG/20120502_FDF_CRG/20120502_FDF_CRG/20120507_FDF_CRG_c12.mtb	1424	687	WWSS	food_sc	4	61692	1336444203	1	0.24	0.000323014804845222	7327	1
3	Drink 2	Intake 2	26	62458	1336444969	/users/cn/jespinosa/phecomp/data/CRG/20120502_FDF_CRG/20120502_FDF_CRG/20120507_FDF_CRG_c12.mtb	1592	NA	WWSS	water	2	62432	1336444943	1	0.02	0.000769230769230769	7328	1
3	Drink 1	Intake 1	23	62481	1336444992	/users/cn/jespinosa/phecomp/data/CRG/20120502_FDF_CRG/20120502_FDF_CRG/20120507_FDF_CRG_c12.mtb	361	NA	WWSS	water	1	62458	1336444969	1	0.0399999999999999	0.0017391304347826	7329	1
3	Drink 1	Intake 1	12	62576	1336445087	/users/cn/jespinosa/phecomp/data/CRG/20120502_FDF_CRG/20120502_FDF_CRG/20120507_FDF_CRG_c12.mtb	362	NA	WWSS	water	1	62564	1336445075	1	0.04	0.00333333333333333	7330	1
3	Drink 2	Intake 2	13	62901	1336445412	/users/cn/jespinosa/phecomp/data/CRG/20120502_FDF_CRG/20120502_FDF_CRG/20120507_FDF_CRG_c12.mtb	1593	NA	WWSS	water	2	62888	1336445399	1	0.04	0.00307692307692308	7331	1
3	Food 2	Intake 4	332	63454	1336445965	/users/cn/jespinosa/phecomp/data/CRG/20120502_FDF_CRG/20120502_FDF_CRG/20120507_FDF_CRG_c12.mtb	1426	6253	WWSS	food_sc	4	63122	1336445633	1	0.12	0.00036144578313253	7332	1
3	Drink 2	Intake 2	36	63487	1336445998	/users/cn/jespinosa/phecomp/data/CRG/20120502_FDF_CRG/20120502_FDF_CRG/20120507_FDF_CRG_c12.mtb	1594	NA	WWSS	water	2	63451	1336445962	1	0.0800000000000001	0.00222222222222222	7333	1
3	Drink 1	Intake 1	22	63509	1336446020	/users/cn/jespinosa/phecomp/data/CRG/20120502_FDF_CRG/20120502_FDF_CRG/20120507_FDF_CRG_c12.mtb	363	NA	WWSS	water	1	63487	1336445998	1	0.0599999999999999	0.00272727272727272	7334	1
3	Drink 2	Intake 2	20	64130	1336446641	/users/cn/jespinosa/phecomp/data/CRG/20120502_FDF_CRG/20120502_FDF_CRG/20120507_FDF_CRG_c12.mtb	1595	NA	WWSS	water	2	64110	1336446621	1	0.0399999999999998	0.00199999999999999	7335	1
3	Drink 1	Intake 1	18	64546	1336447057	/users/cn/jespinosa/phecomp/data/CRG/20120502_FDF_CRG/20120502_FDF_CRG/20120507_FDF_CRG_c12.mtb	364	NA	WWSS	water	1	64528	1336447039	1	0.04	0.00222222222222222	7336	1
3	Food 2	Intake 4	65	69772	1336452283	/users/cn/jespinosa/phecomp/data/CRG/20120502_FDF_CRG/20120502_FDF_CRG/20120507_FDF_CRG_c12.mtb	1429	47108	WWSS	food_sc	4	69707	1336452218	1	0.34	0.00523076923076923	7337	1
3	Drink 1	Intake 1	28	70242	1336452753	/users/cn/jespinosa/phecomp/data/CRG/20120502_FDF_CRG/20120502_FDF_CRG/20120507_FDF_CRG_c12.mtb	365	NA	WWSS	water	1	70214	1336452725	1	0.1	0.00357142857142857	7338	1
3	Drink 2	Intake 2	37	70599	1336453110	/users/cn/jespinosa/phecomp/data/CRG/20120502_FDF_CRG/20120502_FDF_CRG/20120507_FDF_CRG_c12.mtb	1597	NA	WWSS	water	2	70562	1336453073	1	0.02	0.000540540540540541	7339	1
3	Drink 2	Intake 2	35	70675	1336453186	/users/cn/jespinosa/phecomp/data/CRG/20120502_FDF_CRG/20120502_FDF_CRG/20120507_FDF_CRG_c12.mtb	1598	NA	WWSS	water	2	70640	1336453151	1	0.02	0.000571428571428571	7340	1
3	Drink 1	Intake 1	14	70982	1336453493	/users/cn/jespinosa/phecomp/data/CRG/20120502_FDF_CRG/20120502_FDF_CRG/20120507_FDF_CRG_c12.mtb	367	NA	WWSS	water	1	70968	1336453479	1	0.04	0.00285714285714286	7341	1
3	Drink 2	Intake 2	16	71070	1336453581	/users/cn/jespinosa/phecomp/data/CRG/20120502_FDF_CRG/20120502_FDF_CRG/20120507_FDF_CRG_c12.mtb	1600	NA	WWSS	water	2	71054	1336453565	1	0.02	0.00125	7342	1
3	Drink 2	Intake 2	12	72485	1336454996	/users/cn/jespinosa/phecomp/data/CRG/20120502_FDF_CRG/20120502_FDF_CRG/20120507_FDF_CRG_c12.mtb	1602	NA	WWSS	water	2	72473	1336454984	1	0.04	0.00333333333333333	7343	1
3	Food 1	Intake 3	110	116990	1336499501	/users/cn/jespinosa/phecomp/data/CRG/20120502_FDF_CRG/20120502_FDF_CRG/20120507_FDF_CRG_c12.mtb	963	1425	WWSS	food_sc	3	116880	1336499391	1	0.02	0.000181818181818182	7344	1
3	Food 2	Intake 4	84	118499	1336501010	/users/cn/jespinosa/phecomp/data/CRG/20120502_FDF_CRG/20120502_FDF_CRG/20120507_FDF_CRG_c12.mtb	1447	13	WWSS	food_sc	4	118415	1336500926	1	0.02	0.000238095238095238	7345	1
3	Food 2	Intake 4	551	119063	1336501574	/users/cn/jespinosa/phecomp/data/CRG/20120502_FDF_CRG/20120502_FDF_CRG/20120507_FDF_CRG_c12.mtb	1448	128	WWSS	food_sc	4	118512	1336501023	1	0.12	0.000217785843920145	7346	1
3	Food 1	Intake 3	166	119357	1336501868	/users/cn/jespinosa/phecomp/data/CRG/20120502_FDF_CRG/20120502_FDF_CRG/20120507_FDF_CRG_c12.mtb	966	386	WWSS	food_sc	3	119191	1336501702	1	0.02	0.000120481927710843	7347	1
3	Drink 2	Intake 2	18	119379	1336501890	/users/cn/jespinosa/phecomp/data/CRG/20120502_FDF_CRG/20120502_FDF_CRG/20120507_FDF_CRG_c12.mtb	1608	NA	WWSS	water	2	119361	1336501872	1	0.04	0.00222222222222222	7348	1
3	Drink 2	Intake 2	12	119434	1336501945	/users/cn/jespinosa/phecomp/data/CRG/20120502_FDF_CRG/20120502_FDF_CRG/20120507_FDF_CRG_c12.mtb	1609	NA	WWSS	water	2	119422	1336501933	1	0.02	0.00166666666666667	7349	1
3	Food 2	Intake 4	681	120424	1336502935	/users/cn/jespinosa/phecomp/data/CRG/20120502_FDF_CRG/20120502_FDF_CRG/20120507_FDF_CRG_c12.mtb	1452	913	WWSS	food_sc	4	119743	1336502254	1	0.2	0.000293685756240822	7350	1
3	Drink 2	Intake 2	34	120457	1336502968	/users/cn/jespinosa/phecomp/data/CRG/20120502_FDF_CRG/20120502_FDF_CRG/20120507_FDF_CRG_c12.mtb	1611	NA	WWSS	water	2	120423	1336502934	1	0.18	0.00529411764705882	7351	1
3	Drink 1	Intake 1	20	120890	1336503401	/users/cn/jespinosa/phecomp/data/CRG/20120502_FDF_CRG/20120502_FDF_CRG/20120507_FDF_CRG_c12.mtb	371	NA	WWSS	water	1	120870	1336503381	1	0.04	0.002	7352	1
3	Drink 1	Intake 1	36	121326	1336503837	/users/cn/jespinosa/phecomp/data/CRG/20120502_FDF_CRG/20120502_FDF_CRG/20120507_FDF_CRG_c12.mtb	372	NA	WWSS	water	1	121290	1336503801	1	0.14	0.00388888888888889	7353	1
3	Food 2	Intake 4	593	121930	1336504441	/users/cn/jespinosa/phecomp/data/CRG/20120502_FDF_CRG/20120502_FDF_CRG/20120507_FDF_CRG_c12.mtb	1453	168	WWSS	food_sc	4	121337	1336503848	1	0.14	0.000236087689713322	7354	1
3	Drink 2	Intake 2	16	121943	1336504454	/users/cn/jespinosa/phecomp/data/CRG/20120502_FDF_CRG/20120502_FDF_CRG/20120507_FDF_CRG_c12.mtb	1612	NA	WWSS	water	2	121927	1336504438	1	0.02	0.00125	7355	1
3	Food 2	Intake 4	152	122250	1336504761	/users/cn/jespinosa/phecomp/data/CRG/20120502_FDF_CRG/20120502_FDF_CRG/20120507_FDF_CRG_c12.mtb	1456	991	WWSS	food_sc	4	122098	1336504609	1	0.04	0.000263157894736842	7356	1
3	Drink 2	Intake 2	12	122258	1336504769	/users/cn/jespinosa/phecomp/data/CRG/20120502_FDF_CRG/20120502_FDF_CRG/20120507_FDF_CRG_c12.mtb	1613	NA	WWSS	water	2	122246	1336504757	1	0.04	0.00333333333333333	7357	1
3	Drink 1	Intake 1	26	123076	1336505587	/users/cn/jespinosa/phecomp/data/CRG/20120502_FDF_CRG/20120502_FDF_CRG/20120507_FDF_CRG_c12.mtb	373	NA	WWSS	water	1	123050	1336505561	1	0.0600000000000001	0.00230769230769231	7358	1
3	Drink 2	Intake 2	25	123117	1336505628	/users/cn/jespinosa/phecomp/data/CRG/20120502_FDF_CRG/20120502_FDF_CRG/20120507_FDF_CRG_c12.mtb	1616	NA	WWSS	water	2	123092	1336505603	1	0.02	0.0008	7359	1
3	Food 2	Intake 4	803	124044	1336506555	/users/cn/jespinosa/phecomp/data/CRG/20120502_FDF_CRG/20120502_FDF_CRG/20120507_FDF_CRG_c12.mtb	1458	185	WWSS	food_sc	4	123241	1336505752	1	0.22	0.000273972602739726	7360	1
3	Drink 2	Intake 2	21	124061	1336506572	/users/cn/jespinosa/phecomp/data/CRG/20120502_FDF_CRG/20120502_FDF_CRG/20120507_FDF_CRG_c12.mtb	1618	NA	WWSS	water	2	124040	1336506551	1	0.0800000000000001	0.00380952380952381	7361	1
3	Drink 1	Intake 1	23	124109	1336506620	/users/cn/jespinosa/phecomp/data/CRG/20120502_FDF_CRG/20120502_FDF_CRG/20120507_FDF_CRG_c12.mtb	374	NA	WWSS	water	1	124086	1336506597	1	0.02	0.000869565217391304	7362	1
3	Drink 2	Intake 2	12	124135	1336506646	/users/cn/jespinosa/phecomp/data/CRG/20120502_FDF_CRG/20120502_FDF_CRG/20120507_FDF_CRG_c12.mtb	1619	NA	WWSS	water	2	124123	1336506634	1	0.0399999999999996	0.0033333333333333	7363	1
3	Food 2	Intake 4	443	124672	1336507183	/users/cn/jespinosa/phecomp/data/CRG/20120502_FDF_CRG/20120502_FDF_CRG/20120507_FDF_CRG_c12.mtb	1460	1754	WWSS	food_sc	4	124229	1336506740	1	0.16	0.00036117381489842	7364	1
3	Drink 2	Intake 2	33	124703	1336507214	/users/cn/jespinosa/phecomp/data/CRG/20120502_FDF_CRG/20120502_FDF_CRG/20120507_FDF_CRG_c12.mtb	1620	NA	WWSS	water	2	124670	1336507181	1	0.12	0.00363636363636364	7365	1
3	Food 2	Intake 4	95	126521	1336509032	/users/cn/jespinosa/phecomp/data/CRG/20120502_FDF_CRG/20120502_FDF_CRG/20120507_FDF_CRG_c12.mtb	1461	47	WWSS	food_sc	4	126426	1336508937	1	0.02	0.000210526315789474	7366	1
3	Food 2	Intake 4	168	126736	1336509247	/users/cn/jespinosa/phecomp/data/CRG/20120502_FDF_CRG/20120502_FDF_CRG/20120507_FDF_CRG_c12.mtb	1462	19	WWSS	food_sc	4	126568	1336509079	1	0.0600000000000001	0.000357142857142858	7367	1
3	Food 2	Intake 4	358	127113	1336509624	/users/cn/jespinosa/phecomp/data/CRG/20120502_FDF_CRG/20120502_FDF_CRG/20120507_FDF_CRG_c12.mtb	1463	1602	WWSS	food_sc	4	126755	1336509266	1	0.18	0.000502793296089386	7368	1
3	Drink 2	Intake 2	33	127138	1336509649	/users/cn/jespinosa/phecomp/data/CRG/20120502_FDF_CRG/20120502_FDF_CRG/20120507_FDF_CRG_c12.mtb	1622	NA	WWSS	water	2	127105	1336509616	1	0.14	0.00424242424242424	7369	1
3	Drink 1	Intake 1	16	127218	1336509729	/users/cn/jespinosa/phecomp/data/CRG/20120502_FDF_CRG/20120502_FDF_CRG/20120507_FDF_CRG_c12.mtb	375	NA	WWSS	water	1	127202	1336509713	1	0.02	0.00125	7370	1
3	Drink 1	Intake 1	13	127243	1336509754	/users/cn/jespinosa/phecomp/data/CRG/20120502_FDF_CRG/20120502_FDF_CRG/20120507_FDF_CRG_c12.mtb	376	NA	WWSS	water	1	127230	1336509741	1	0.04	0.00307692307692308	7371	1
3	Drink 2	Intake 2	27	127653	1336510164	/users/cn/jespinosa/phecomp/data/CRG/20120502_FDF_CRG/20120502_FDF_CRG/20120507_FDF_CRG_c12.mtb	1624	NA	WWSS	water	2	127626	1336510137	1	0.0800000000000001	0.00296296296296297	7372	1
3	Food 2	Intake 4	445	129160	1336511671	/users/cn/jespinosa/phecomp/data/CRG/20120502_FDF_CRG/20120502_FDF_CRG/20120507_FDF_CRG_c12.mtb	1466	10	WWSS	food_sc	4	128715	1336511226	1	0.14	0.000314606741573034	7373	1
3	Food 2	Intake 4	170	129340	1336511851	/users/cn/jespinosa/phecomp/data/CRG/20120502_FDF_CRG/20120502_FDF_CRG/20120507_FDF_CRG_c12.mtb	1467	659	WWSS	food_sc	4	129170	1336511681	1	0.0800000000000001	0.000470588235294118	7374	1
3	Drink 2	Intake 2	27	129365	1336511876	/users/cn/jespinosa/phecomp/data/CRG/20120502_FDF_CRG/20120502_FDF_CRG/20120507_FDF_CRG_c12.mtb	1626	NA	WWSS	water	2	129338	1336511849	1	0.0600000000000001	0.00222222222222223	7375	1
3	Drink 2	Intake 2	14	129711	1336512222	/users/cn/jespinosa/phecomp/data/CRG/20120502_FDF_CRG/20120502_FDF_CRG/20120507_FDF_CRG_c12.mtb	1628	NA	WWSS	water	2	129697	1336512208	1	0.02	0.00142857142857143	7376	1
3	Drink 2	Intake 2	15	129788	1336512299	/users/cn/jespinosa/phecomp/data/CRG/20120502_FDF_CRG/20120502_FDF_CRG/20120507_FDF_CRG_c12.mtb	1629	NA	WWSS	water	2	129773	1336512284	1	0.0399999999999996	0.00266666666666664	7377	1
3	Drink 2	Intake 2	12	129983	1336512494	/users/cn/jespinosa/phecomp/data/CRG/20120502_FDF_CRG/20120502_FDF_CRG/20120507_FDF_CRG_c12.mtb	1630	NA	WWSS	water	2	129971	1336512482	1	0.0200000000000005	0.00166666666666671	7378	1
3	Food 2	Intake 4	152	130151	1336512662	/users/cn/jespinosa/phecomp/data/CRG/20120502_FDF_CRG/20120502_FDF_CRG/20120507_FDF_CRG_c12.mtb	1470	94	WWSS	food_sc	4	129999	1336512510	1	0.14	0.000921052631578947	7379	1
3	Food 2	Intake 4	17	130262	1336512773	/users/cn/jespinosa/phecomp/data/CRG/20120502_FDF_CRG/20120502_FDF_CRG/20120507_FDF_CRG_c12.mtb	1471	474	WWSS	food_sc	4	130245	1336512756	1	0.2	0.0117647058823529	7380	1
3	Drink 2	Intake 2	38	130665	1336513176	/users/cn/jespinosa/phecomp/data/CRG/20120502_FDF_CRG/20120502_FDF_CRG/20120507_FDF_CRG_c12.mtb	1632	NA	WWSS	water	2	130627	1336513138	1	0.0600000000000001	0.00157894736842106	7381	1
3	Drink 2	Intake 2	17	130712	1336513223	/users/cn/jespinosa/phecomp/data/CRG/20120502_FDF_CRG/20120502_FDF_CRG/20120507_FDF_CRG_c12.mtb	1633	NA	WWSS	water	2	130695	1336513206	1	0.02	0.00117647058823529	7382	1
3	Food 1	Intake 3	47	130783	1336513294	/users/cn/jespinosa/phecomp/data/CRG/20120502_FDF_CRG/20120502_FDF_CRG/20120507_FDF_CRG_c12.mtb	971	1825	WWSS	food_sc	3	130736	1336513247	1	0.02	0.000425531914893617	7383	1
3	Drink 2	Intake 2	27	131033	1336513544	/users/cn/jespinosa/phecomp/data/CRG/20120502_FDF_CRG/20120502_FDF_CRG/20120507_FDF_CRG_c12.mtb	1635	NA	WWSS	water	2	131006	1336513517	1	0.0600000000000001	0.00222222222222223	7384	1
3	Drink 2	Intake 2	20	131478	1336513989	/users/cn/jespinosa/phecomp/data/CRG/20120502_FDF_CRG/20120502_FDF_CRG/20120507_FDF_CRG_c12.mtb	1637	NA	WWSS	water	2	131458	1336513969	1	0.04	0.002	7385	1
3	Drink 1	Intake 1	22	132502	1336515013	/users/cn/jespinosa/phecomp/data/CRG/20120502_FDF_CRG/20120502_FDF_CRG/20120507_FDF_CRG_c12.mtb	381	NA	WWSS	water	1	132480	1336514991	1	0.0599999999999998	0.00272727272727272	7386	1
3	Food 2	Intake 4	87	132695	1336515206	/users/cn/jespinosa/phecomp/data/CRG/20120502_FDF_CRG/20120502_FDF_CRG/20120507_FDF_CRG_c12.mtb	1478	2310	WWSS	food_sc	4	132608	1336515119	1	0.0200000000000005	0.00022988505747127	7387	1
3	Drink 2	Intake 2	17	132859	1336515370	/users/cn/jespinosa/phecomp/data/CRG/20120502_FDF_CRG/20120502_FDF_CRG/20120507_FDF_CRG_c12.mtb	1639	NA	WWSS	water	2	132842	1336515353	1	0.02	0.00117647058823529	7388	1
3	Food 1	Intake 3	240	135245	1336517756	/users/cn/jespinosa/phecomp/data/CRG/20120502_FDF_CRG/20120502_FDF_CRG/20120507_FDF_CRG_c12.mtb	975	6	WWSS	food_sc	3	135005	1336517516	1	0.0800000000000001	0.000333333333333334	7389	1
3	Food 1	Intake 3	221	135472	1336517983	/users/cn/jespinosa/phecomp/data/CRG/20120502_FDF_CRG/20120502_FDF_CRG/20120507_FDF_CRG_c12.mtb	976	267	WWSS	food_sc	3	135251	1336517762	1	0.0799999999999996	0.000361990950226243	7390	1
3	Drink 2	Intake 2	17	135493	1336518004	/users/cn/jespinosa/phecomp/data/CRG/20120502_FDF_CRG/20120502_FDF_CRG/20120507_FDF_CRG_c12.mtb	1640	NA	WWSS	water	2	135476	1336517987	1	0.02	0.00117647058823529	7391	1
3	Drink 2	Intake 2	13	135618	1336518129	/users/cn/jespinosa/phecomp/data/CRG/20120502_FDF_CRG/20120502_FDF_CRG/20120507_FDF_CRG_c12.mtb	1643	NA	WWSS	water	2	135605	1336518116	1	0.04	0.00307692307692308	7392	1
3	Drink 2	Intake 2	40	135716	1336518227	/users/cn/jespinosa/phecomp/data/CRG/20120502_FDF_CRG/20120502_FDF_CRG/20120507_FDF_CRG_c12.mtb	1644	NA	WWSS	water	2	135676	1336518187	1	0.02	0.0005	7393	1
3	Food 1	Intake 3	81	135820	1336518331	/users/cn/jespinosa/phecomp/data/CRG/20120502_FDF_CRG/20120502_FDF_CRG/20120507_FDF_CRG_c12.mtb	978	335	WWSS	food_sc	3	135739	1336518250	1	0.0200000000000005	0.00024691358024692	7394	1
3	Drink 1	Intake 1	17	135940	1336518451	/users/cn/jespinosa/phecomp/data/CRG/20120502_FDF_CRG/20120502_FDF_CRG/20120507_FDF_CRG_c12.mtb	383	NA	WWSS	water	1	135923	1336518434	1	0.02	0.00117647058823529	7395	1
3	Drink 2	Intake 2	27	136077	1336518588	/users/cn/jespinosa/phecomp/data/CRG/20120502_FDF_CRG/20120502_FDF_CRG/20120507_FDF_CRG_c12.mtb	1646	NA	WWSS	water	2	136050	1336518561	1	0.0600000000000001	0.00222222222222223	7396	1
3	Food 1	Intake 3	468	136623	1336519134	/users/cn/jespinosa/phecomp/data/CRG/20120502_FDF_CRG/20120502_FDF_CRG/20120507_FDF_CRG_c12.mtb	979	99	WWSS	food_sc	3	136155	1336518666	1	0.18	0.000384615384615385	7397	1
3	Drink 2	Intake 2	39	136664	1336519175	/users/cn/jespinosa/phecomp/data/CRG/20120502_FDF_CRG/20120502_FDF_CRG/20120507_FDF_CRG_c12.mtb	1647	NA	WWSS	water	2	136625	1336519136	1	0.0600000000000001	0.00153846153846154	7398	1
3	Food 1	Intake 3	121	136843	1336519354	/users/cn/jespinosa/phecomp/data/CRG/20120502_FDF_CRG/20120502_FDF_CRG/20120507_FDF_CRG_c12.mtb	980	3283	WWSS	food_sc	3	136722	1336519233	1	0.04	0.000330578512396694	7399	1
3	Drink 2	Intake 2	25	136901	1336519412	/users/cn/jespinosa/phecomp/data/CRG/20120502_FDF_CRG/20120502_FDF_CRG/20120507_FDF_CRG_c12.mtb	1648	NA	WWSS	water	2	136876	1336519387	1	0.0999999999999996	0.00399999999999998	7400	1
3	Food 1	Intake 3	324	140450	1336522961	/users/cn/jespinosa/phecomp/data/CRG/20120502_FDF_CRG/20120502_FDF_CRG/20120507_FDF_CRG_c12.mtb	983	48	WWSS	food_sc	3	140126	1336522637	1	0.04	0.000123456790123457	7401	1
3	Food 1	Intake 3	359	140857	1336523368	/users/cn/jespinosa/phecomp/data/CRG/20120502_FDF_CRG/20120502_FDF_CRG/20120507_FDF_CRG_c12.mtb	984	1010	WWSS	food_sc	3	140498	1336523009	1	0.0800000000000001	0.000222841225626741	7402	1
3	Drink 2	Intake 2	13	140879	1336523390	/users/cn/jespinosa/phecomp/data/CRG/20120502_FDF_CRG/20120502_FDF_CRG/20120507_FDF_CRG_c12.mtb	1649	NA	WWSS	water	2	140866	1336523377	1	0.0200000000000005	0.00153846153846158	7403	1
3	Drink 2	Intake 2	45	141166	1336523677	/users/cn/jespinosa/phecomp/data/CRG/20120502_FDF_CRG/20120502_FDF_CRG/20120507_FDF_CRG_c12.mtb	1651	NA	WWSS	water	2	141121	1336523632	1	0.0600000000000001	0.00133333333333334	7404	1
3	Drink 1	Intake 1	17	141706	1336524217	/users/cn/jespinosa/phecomp/data/CRG/20120502_FDF_CRG/20120502_FDF_CRG/20120507_FDF_CRG_c12.mtb	385	NA	WWSS	water	1	141689	1336524200	1	0.02	0.00117647058823529	7405	1
3	Drink 2	Intake 2	23	141806	1336524317	/users/cn/jespinosa/phecomp/data/CRG/20120502_FDF_CRG/20120502_FDF_CRG/20120507_FDF_CRG_c12.mtb	1652	NA	WWSS	water	2	141783	1336524294	1	0.04	0.00173913043478261	7406	1
3	Food 1	Intake 3	510	142377	1336524888	/users/cn/jespinosa/phecomp/data/CRG/20120502_FDF_CRG/20120502_FDF_CRG/20120507_FDF_CRG_c12.mtb	987	914	WWSS	food_sc	3	141867	1336524378	1	0.16	0.000313725490196078	7407	1
3	Drink 2	Intake 2	27	142416	1336524927	/users/cn/jespinosa/phecomp/data/CRG/20120502_FDF_CRG/20120502_FDF_CRG/20120507_FDF_CRG_c12.mtb	1653	NA	WWSS	water	2	142389	1336524900	1	0.0800000000000001	0.00296296296296297	7408	1
3	Drink 2	Intake 2	16	142919	1336525430	/users/cn/jespinosa/phecomp/data/CRG/20120502_FDF_CRG/20120502_FDF_CRG/20120507_FDF_CRG_c12.mtb	1654	NA	WWSS	water	2	142903	1336525414	1	0.02	0.00125	7409	1
3	Drink 2	Intake 2	20	143101	1336525612	/users/cn/jespinosa/phecomp/data/CRG/20120502_FDF_CRG/20120502_FDF_CRG/20120507_FDF_CRG_c12.mtb	1655	NA	WWSS	water	2	143081	1336525592	1	0.02	0.001	7410	1
3	Food 1	Intake 3	407	143698	1336526209	/users/cn/jespinosa/phecomp/data/CRG/20120502_FDF_CRG/20120502_FDF_CRG/20120507_FDF_CRG_c12.mtb	991	903	WWSS	food_sc	3	143291	1336525802	1	0.12	0.000294840294840295	7411	1
3	Drink 2	Intake 2	25	143722	1336526233	/users/cn/jespinosa/phecomp/data/CRG/20120502_FDF_CRG/20120502_FDF_CRG/20120507_FDF_CRG_c12.mtb	1656	NA	WWSS	water	2	143697	1336526208	1	0.0800000000000001	0.0032	7412	1
3	Drink 2	Intake 2	17	144163	1336526674	/users/cn/jespinosa/phecomp/data/CRG/20120502_FDF_CRG/20120502_FDF_CRG/20120507_FDF_CRG_c12.mtb	1657	NA	WWSS	water	2	144146	1336526657	1	0.02	0.00117647058823529	7413	1
3	Food 2	Intake 4	201	144802	1336527313	/users/cn/jespinosa/phecomp/data/CRG/20120502_FDF_CRG/20120502_FDF_CRG/20120507_FDF_CRG_c12.mtb	1498	6344	WWSS	food_sc	4	144601	1336527112	1	0.04	0.000199004975124378	7414	1
3	Drink 2	Intake 2	23	145741	1336528252	/users/cn/jespinosa/phecomp/data/CRG/20120502_FDF_CRG/20120502_FDF_CRG/20120507_FDF_CRG_c12.mtb	1658	NA	WWSS	water	2	145718	1336528229	1	0.02	0.000869565217391304	7415	1
3	Food 1	Intake 3	652	151798	1336534309	/users/cn/jespinosa/phecomp/data/CRG/20120502_FDF_CRG/20120502_FDF_CRG/20120507_FDF_CRG_c12.mtb	997	333	WWSS	food_sc	3	151146	1336533657	1	0.24	0.000368098159509202	7416	1
3	Drink 2	Intake 2	38	151843	1336534354	/users/cn/jespinosa/phecomp/data/CRG/20120502_FDF_CRG/20120502_FDF_CRG/20120507_FDF_CRG_c12.mtb	1660	NA	WWSS	water	2	151805	1336534316	1	0.0600000000000001	0.00157894736842106	7417	1
3	Drink 2	Intake 2	21	151870	1336534381	/users/cn/jespinosa/phecomp/data/CRG/20120502_FDF_CRG/20120502_FDF_CRG/20120507_FDF_CRG_c12.mtb	1661	NA	WWSS	water	2	151849	1336534360	1	0.0599999999999996	0.00285714285714284	7418	1
3	Food 1	Intake 3	160	152291	1336534802	/users/cn/jespinosa/phecomp/data/CRG/20120502_FDF_CRG/20120502_FDF_CRG/20120507_FDF_CRG_c12.mtb	999	2978	WWSS	food_sc	3	152131	1336534642	1	0.0600000000000001	0.000375000000000001	7419	1
3	Drink 2	Intake 2	30	152321	1336534832	/users/cn/jespinosa/phecomp/data/CRG/20120502_FDF_CRG/20120502_FDF_CRG/20120507_FDF_CRG_c12.mtb	1662	NA	WWSS	water	2	152291	1336534802	1	0.1	0.00333333333333333	7420	1
3	Drink 1	Intake 1	11	153404	1336535915	/users/cn/jespinosa/phecomp/data/CRG/20120502_FDF_CRG/20120502_FDF_CRG/20120507_FDF_CRG_c12.mtb	391	NA	WWSS	water	1	153393	1336535904	1	0.02	0.00181818181818182	7421	1
3	Food 1	Intake 3	177	155446	1336537957	/users/cn/jespinosa/phecomp/data/CRG/20120502_FDF_CRG/20120502_FDF_CRG/20120507_FDF_CRG_c12.mtb	1001	497	WWSS	food_sc	3	155269	1336537780	1	0.0999999999999996	0.000564971751412427	7422	1
3	Drink 2	Intake 2	11	155570	1336538081	/users/cn/jespinosa/phecomp/data/CRG/20120502_FDF_CRG/20120502_FDF_CRG/20120507_FDF_CRG_c12.mtb	1663	NA	WWSS	water	2	155559	1336538070	1	0.02	0.00181818181818182	7423	1
3	Food 1	Intake 3	274	156217	1336538728	/users/cn/jespinosa/phecomp/data/CRG/20120502_FDF_CRG/20120502_FDF_CRG/20120507_FDF_CRG_c12.mtb	1004	1644	WWSS	food_sc	3	155943	1336538454	1	0.12	0.000437956204379562	7424	1
3	Drink 2	Intake 2	21	156306	1336538817	/users/cn/jespinosa/phecomp/data/CRG/20120502_FDF_CRG/20120502_FDF_CRG/20120507_FDF_CRG_c12.mtb	1664	NA	WWSS	water	2	156285	1336538796	1	0.0800000000000001	0.00380952380952381	7425	1
3	Drink 1	Intake 1	10	157458	1336539969	/users/cn/jespinosa/phecomp/data/CRG/20120502_FDF_CRG/20120502_FDF_CRG/20120507_FDF_CRG_c12.mtb	393	NA	WWSS	water	1	157448	1336539959	1	0.04	0.004	7426	1
3	Food 1	Intake 3	32	157893	1336540404	/users/cn/jespinosa/phecomp/data/CRG/20120502_FDF_CRG/20120502_FDF_CRG/20120507_FDF_CRG_c12.mtb	1006	88	WWSS	food_sc	3	157861	1336540372	1	0.02	0.000625	7427	1
3	Food 1	Intake 3	318	158299	1336540810	/users/cn/jespinosa/phecomp/data/CRG/20120502_FDF_CRG/20120502_FDF_CRG/20120507_FDF_CRG_c12.mtb	1008	1500	WWSS	food_sc	3	157981	1336540492	1	0.16	0.00050314465408805	7428	1
3	Drink 2	Intake 2	20	158358	1336540869	/users/cn/jespinosa/phecomp/data/CRG/20120502_FDF_CRG/20120502_FDF_CRG/20120507_FDF_CRG_c12.mtb	1665	NA	WWSS	water	2	158338	1336540849	1	0.02	0.001	7429	1
3	Drink 2	Intake 2	17	158512	1336541023	/users/cn/jespinosa/phecomp/data/CRG/20120502_FDF_CRG/20120502_FDF_CRG/20120507_FDF_CRG_c12.mtb	1666	NA	WWSS	water	2	158495	1336541006	1	0.0600000000000001	0.00352941176470589	7430	1
3	Drink 2	Intake 2	16	158983	1336541494	/users/cn/jespinosa/phecomp/data/CRG/20120502_FDF_CRG/20120502_FDF_CRG/20120507_FDF_CRG_c12.mtb	1667	NA	WWSS	water	2	158967	1336541478	1	0.0599999999999996	0.00374999999999998	7431	1
3	Food 1	Intake 3	58	159857	1336542368	/users/cn/jespinosa/phecomp/data/CRG/20120502_FDF_CRG/20120502_FDF_CRG/20120507_FDF_CRG_c12.mtb	1009	11860	WWSS	food_sc	3	159799	1336542310	1	0.300000000000001	0.00517241379310347	7432	1
3	Drink 2	Intake 2	22	160279	1336542790	/users/cn/jespinosa/phecomp/data/CRG/20120502_FDF_CRG/20120502_FDF_CRG/20120507_FDF_CRG_c12.mtb	1669	NA	WWSS	water	2	160257	1336542768	1	0.100000000000001	0.00454545454545459	7433	1
3	Drink 2	Intake 2	25	160980	1336543491	/users/cn/jespinosa/phecomp/data/CRG/20120502_FDF_CRG/20120502_FDF_CRG/20120507_FDF_CRG_c12.mtb	1672	NA	WWSS	water	2	160955	1336543466	1	0.0800000000000001	0.0032	7434	1
3	Food 1	Intake 3	135	675	1336554363	/users/cn/jespinosa/phecomp/data/CRG/20120502_FDF_CRG/20120502_FDF_CRG/20120509_FDF_CRG_c12.mtb	1260	209	WWSS	food_sc	3	540	1336554228	1	0.04	0.000296296296296296	7435	1
3	Food 2	Intake 4	99	983	1336554671	/users/cn/jespinosa/phecomp/data/CRG/20120502_FDF_CRG/20120502_FDF_CRG/20120509_FDF_CRG_c12.mtb	1832	3346	WWSS	food_sc	4	884	1336554572	1	0.02	0.000202020202020202	7436	1
3	Drink 1	Intake 1	21	1175	1336554863	/users/cn/jespinosa/phecomp/data/CRG/20120502_FDF_CRG/20120502_FDF_CRG/20120509_FDF_CRG_c12.mtb	518	NA	WWSS	water	1	1154	1336554842	1	0.04	0.0019047619047619	7437	1
3	Food 1	Intake 3	150	4479	1336558167	/users/cn/jespinosa/phecomp/data/CRG/20120502_FDF_CRG/20120502_FDF_CRG/20120509_FDF_CRG_c12.mtb	1264	14	WWSS	food_sc	3	4329	1336558017	1	0.08	0.000533333333333333	7438	1
3	Food 1	Intake 3	65	4558	1336558246	/users/cn/jespinosa/phecomp/data/CRG/20120502_FDF_CRG/20120502_FDF_CRG/20120509_FDF_CRG_c12.mtb	1265	3221	WWSS	food_sc	3	4493	1336558181	1	0.02	0.000307692307692308	7439	1
3	Drink 2	Intake 2	17	5695	1336559383	/users/cn/jespinosa/phecomp/data/CRG/20120502_FDF_CRG/20120502_FDF_CRG/20120509_FDF_CRG_c12.mtb	1787	NA	WWSS	water	2	5678	1336559366	1	0.02	0.00117647058823529	7440	1
3	Drink 1	Intake 1	22	5738	1336559426	/users/cn/jespinosa/phecomp/data/CRG/20120502_FDF_CRG/20120502_FDF_CRG/20120509_FDF_CRG_c12.mtb	520	NA	WWSS	water	1	5716	1336559404	1	0.06	0.00272727272727273	7441	1
3	Food 1	Intake 3	77	7856	1336561544	/users/cn/jespinosa/phecomp/data/CRG/20120502_FDF_CRG/20120502_FDF_CRG/20120509_FDF_CRG_c12.mtb	1267	13	WWSS	food_sc	3	7779	1336561467	1	0.04	0.000519480519480519	7442	1
3	Food 1	Intake 3	63	7932	1336561620	/users/cn/jespinosa/phecomp/data/CRG/20120502_FDF_CRG/20120502_FDF_CRG/20120509_FDF_CRG_c12.mtb	1268	44	WWSS	food_sc	3	7869	1336561557	1	0.06	0.000952380952380952	7443	1
3	Food 1	Intake 3	96	8072	1336561760	/users/cn/jespinosa/phecomp/data/CRG/20120502_FDF_CRG/20120502_FDF_CRG/20120509_FDF_CRG_c12.mtb	1269	COLL	WWSS	food_sc	3	7976	1336561664	1	0.02	0.000208333333333333	7444	1
3	Food 2	Intake 4	70	8135	1336561823	/users/cn/jespinosa/phecomp/data/CRG/20120502_FDF_CRG/20120502_FDF_CRG/20120509_FDF_CRG_c12.mtb	1833	11041	WWSS	food_sc	4	8065	1336561753	1	0.04	0.000571428571428571	7445	1
3	Food 1	Intake 3	197	19373	1336573061	/users/cn/jespinosa/phecomp/data/CRG/20120502_FDF_CRG/20120502_FDF_CRG/20120509_FDF_CRG_c12.mtb	1271	9992	WWSS	food_sc	3	19176	1336572864	1	0.02	0.000101522842639594	7446	1
3	Food 1	Intake 3	324	29689	1336583377	/users/cn/jespinosa/phecomp/data/CRG/20120502_FDF_CRG/20120502_FDF_CRG/20120509_FDF_CRG_c12.mtb	1273	3032	WWSS	food_sc	3	29365	1336583053	1	0.08	0.000246913580246914	7447	1
3	Food 1	Intake 3	295	33016	1336586704	/users/cn/jespinosa/phecomp/data/CRG/20120502_FDF_CRG/20120502_FDF_CRG/20120509_FDF_CRG_c12.mtb	1274	7	WWSS	food_sc	3	32721	1336586409	1	0.06	0.000203389830508475	7448	1
3	Food 1	Intake 3	118	33141	1336586829	/users/cn/jespinosa/phecomp/data/CRG/20120502_FDF_CRG/20120502_FDF_CRG/20120509_FDF_CRG_c12.mtb	1275	1576	WWSS	food_sc	3	33023	1336586711	1	0.06	0.000508474576271186	7449	1
3	Drink 1	Intake 1	14	33818	1336587506	/users/cn/jespinosa/phecomp/data/CRG/20120502_FDF_CRG/20120502_FDF_CRG/20120509_FDF_CRG_c12.mtb	522	NA	WWSS	water	1	33804	1336587492	1	0.08	0.00571428571428571	7450	1
3	Food 1	Intake 3	293	35010	1336588698	/users/cn/jespinosa/phecomp/data/CRG/20120502_FDF_CRG/20120502_FDF_CRG/20120509_FDF_CRG_c12.mtb	1276	1035	WWSS	food_sc	3	34717	1336588405	1	0.1	0.000341296928327645	7451	1
3	Food 2	Intake 4	232	36277	1336589965	/users/cn/jespinosa/phecomp/data/CRG/20120502_FDF_CRG/20120502_FDF_CRG/20120509_FDF_CRG_c12.mtb	1840	1224	WWSS	food_sc	4	36045	1336589733	1	0.14	0.000603448275862069	7452	1
3	Drink 2	Intake 2	28	36312	1336590000	/users/cn/jespinosa/phecomp/data/CRG/20120502_FDF_CRG/20120502_FDF_CRG/20120509_FDF_CRG_c12.mtb	1793	NA	WWSS	water	2	36284	1336589972	1	0.06	0.00214285714285714	7453	1
3	Drink 2	Intake 2	17	36376	1336590064	/users/cn/jespinosa/phecomp/data/CRG/20120502_FDF_CRG/20120502_FDF_CRG/20120509_FDF_CRG_c12.mtb	1794	NA	WWSS	water	2	36359	1336590047	1	0.02	0.00117647058823529	7454	1
3	Drink 1	Intake 1	19	37044	1336590732	/users/cn/jespinosa/phecomp/data/CRG/20120502_FDF_CRG/20120502_FDF_CRG/20120509_FDF_CRG_c12.mtb	524	NA	WWSS	water	1	37025	1336590713	1	0.06	0.00315789473684211	7455	1
3	Food 2	Intake 4	184	37685	1336591373	/users/cn/jespinosa/phecomp/data/CRG/20120502_FDF_CRG/20120502_FDF_CRG/20120509_FDF_CRG_c12.mtb	1841	97	WWSS	food_sc	4	37501	1336591189	1	0.06	0.000326086956521739	7456	1
3	Drink 1	Intake 1	15	37778	1336591466	/users/cn/jespinosa/phecomp/data/CRG/20120502_FDF_CRG/20120502_FDF_CRG/20120509_FDF_CRG_c12.mtb	525	NA	WWSS	water	1	37763	1336591451	1	0.02	0.00133333333333333	7457	1
3	Food 2	Intake 4	92	37874	1336591562	/users/cn/jespinosa/phecomp/data/CRG/20120502_FDF_CRG/20120502_FDF_CRG/20120509_FDF_CRG_c12.mtb	1842	27	WWSS	food_sc	4	37782	1336591470	1	0.04	0.000434782608695652	7458	1
3	Food 1	Intake 3	79	37980	1336591668	/users/cn/jespinosa/phecomp/data/CRG/20120502_FDF_CRG/20120502_FDF_CRG/20120509_FDF_CRG_c12.mtb	1277	1379	WWSS	food_sc	3	37901	1336591589	1	0.02	0.000253164556962025	7459	1
3	Drink 2	Intake 2	17	38815	1336592503	/users/cn/jespinosa/phecomp/data/CRG/20120502_FDF_CRG/20120502_FDF_CRG/20120509_FDF_CRG_c12.mtb	1799	NA	WWSS	water	2	38798	1336592486	1	0.08	0.00470588235294118	7460	1
3	Food 2	Intake 4	300	39659	1336593347	/users/cn/jespinosa/phecomp/data/CRG/20120502_FDF_CRG/20120502_FDF_CRG/20120509_FDF_CRG_c12.mtb	1845	1121	WWSS	food_sc	4	39359	1336593047	1	0.14	0.000466666666666667	7461	1
3	Drink 2	Intake 2	13	39693	1336593381	/users/cn/jespinosa/phecomp/data/CRG/20120502_FDF_CRG/20120502_FDF_CRG/20120509_FDF_CRG_c12.mtb	1800	NA	WWSS	water	2	39680	1336593368	1	0.04	0.00307692307692308	7462	1
3	Food 2	Intake 4	215	40995	1336594683	/users/cn/jespinosa/phecomp/data/CRG/20120502_FDF_CRG/20120502_FDF_CRG/20120509_FDF_CRG_c12.mtb	1848	1013	WWSS	food_sc	4	40780	1336594468	1	0.08	0.000372093023255814	7463	1
3	Drink 2	Intake 2	14	41033	1336594721	/users/cn/jespinosa/phecomp/data/CRG/20120502_FDF_CRG/20120502_FDF_CRG/20120509_FDF_CRG_c12.mtb	1810	NA	WWSS	water	2	41019	1336594707	1	0.04	0.00285714285714286	7464	1
3	Drink 1	Intake 1	25	41608	1336595296	/users/cn/jespinosa/phecomp/data/CRG/20120502_FDF_CRG/20120502_FDF_CRG/20120509_FDF_CRG_c12.mtb	527	NA	WWSS	water	1	41583	1336595271	1	0.08	0.0032	7465	1
3	Food 2	Intake 4	67	42075	1336595763	/users/cn/jespinosa/phecomp/data/CRG/20120502_FDF_CRG/20120502_FDF_CRG/20120509_FDF_CRG_c12.mtb	1849	4	WWSS	food_sc	4	42008	1336595696	1	0.04	0.000597014925373134	7466	1
3	Food 2	Intake 4	231	42310	1336595998	/users/cn/jespinosa/phecomp/data/CRG/20120502_FDF_CRG/20120502_FDF_CRG/20120509_FDF_CRG_c12.mtb	1850	604	WWSS	food_sc	4	42079	1336595767	1	0.12	0.000519480519480519	7467	1
3	Drink 2	Intake 2	25	42375	1336596063	/users/cn/jespinosa/phecomp/data/CRG/20120502_FDF_CRG/20120502_FDF_CRG/20120509_FDF_CRG_c12.mtb	1811	NA	WWSS	water	2	42350	1336596038	1	0.06	0.0024	7468	1
3	Food 2	Intake 4	207	43121	1336596809	/users/cn/jespinosa/phecomp/data/CRG/20120502_FDF_CRG/20120502_FDF_CRG/20120509_FDF_CRG_c12.mtb	1851	373	WWSS	food_sc	4	42914	1336596602	1	0.12	0.000579710144927536	7469	1
3	Drink 2	Intake 2	31	43223	1336596911	/users/cn/jespinosa/phecomp/data/CRG/20120502_FDF_CRG/20120502_FDF_CRG/20120509_FDF_CRG_c12.mtb	1814	NA	WWSS	water	2	43192	1336596880	1	0.08	0.00258064516129032	7470	1
3	Drink 2	Intake 2	23	43339	1336597027	/users/cn/jespinosa/phecomp/data/CRG/20120502_FDF_CRG/20120502_FDF_CRG/20120509_FDF_CRG_c12.mtb	1815	NA	WWSS	water	2	43316	1336597004	1	0.04	0.00173913043478261	7471	1
3	Food 2	Intake 4	130	43624	1336597312	/users/cn/jespinosa/phecomp/data/CRG/20120502_FDF_CRG/20120502_FDF_CRG/20120509_FDF_CRG_c12.mtb	1853	600	WWSS	food_sc	4	43494	1336597182	1	0.0399999999999999	0.000307692307692307	7472	1
3	Drink 1	Intake 1	16	43729	1336597417	/users/cn/jespinosa/phecomp/data/CRG/20120502_FDF_CRG/20120502_FDF_CRG/20120509_FDF_CRG_c12.mtb	530	NA	WWSS	water	1	43713	1336597401	1	0.02	0.00125	7473	1
3	Drink 2	Intake 2	22	43970	1336597658	/users/cn/jespinosa/phecomp/data/CRG/20120502_FDF_CRG/20120502_FDF_CRG/20120509_FDF_CRG_c12.mtb	1817	NA	WWSS	water	2	43948	1336597636	1	0.02	0.000909090909090909	7474	1
3	Drink 2	Intake 2	19	44114	1336597802	/users/cn/jespinosa/phecomp/data/CRG/20120502_FDF_CRG/20120502_FDF_CRG/20120509_FDF_CRG_c12.mtb	1818	NA	WWSS	water	2	44095	1336597783	1	0.04	0.00210526315789474	7475	1
3	Food 2	Intake 4	154	44378	1336598066	/users/cn/jespinosa/phecomp/data/CRG/20120502_FDF_CRG/20120502_FDF_CRG/20120509_FDF_CRG_c12.mtb	1854	547	WWSS	food_sc	4	44224	1336597912	1	0.02	0.00012987012987013	7476	1
3	Drink 1	Intake 1	20	44565	1336598253	/users/cn/jespinosa/phecomp/data/CRG/20120502_FDF_CRG/20120502_FDF_CRG/20120509_FDF_CRG_c12.mtb	532	NA	WWSS	water	1	44545	1336598233	1	0.06	0.003	7477	1
3	Food 2	Intake 4	262	45187	1336598875	/users/cn/jespinosa/phecomp/data/CRG/20120502_FDF_CRG/20120502_FDF_CRG/20120509_FDF_CRG_c12.mtb	1858	678	WWSS	food_sc	4	44925	1336598613	1	0.16	0.000610687022900763	7478	1
3	Drink 2	Intake 2	21	45251	1336598939	/users/cn/jespinosa/phecomp/data/CRG/20120502_FDF_CRG/20120502_FDF_CRG/20120509_FDF_CRG_c12.mtb	1819	NA	WWSS	water	2	45230	1336598918	1	0.04	0.0019047619047619	7479	1
3	Food 2	Intake 4	35	45900	1336599588	/users/cn/jespinosa/phecomp/data/CRG/20120502_FDF_CRG/20120502_FDF_CRG/20120509_FDF_CRG_c12.mtb	1860	741	WWSS	food_sc	4	45865	1336599553	1	0.02	0.000571428571428571	7480	1
3	Drink 2	Intake 2	13	46090	1336599778	/users/cn/jespinosa/phecomp/data/CRG/20120502_FDF_CRG/20120502_FDF_CRG/20120509_FDF_CRG_c12.mtb	1821	NA	WWSS	water	2	46077	1336599765	1	0.0399999999999999	0.00307692307692307	7481	1
3	Food 2	Intake 4	23	46664	1336600352	/users/cn/jespinosa/phecomp/data/CRG/20120502_FDF_CRG/20120502_FDF_CRG/20120509_FDF_CRG_c12.mtb	1861	3483	WWSS	food_sc	4	46641	1336600329	1	0.28	0.0121739130434783	7482	1
3	Drink 2	Intake 2	22	47074	1336600762	/users/cn/jespinosa/phecomp/data/CRG/20120502_FDF_CRG/20120502_FDF_CRG/20120509_FDF_CRG_c12.mtb	1825	NA	WWSS	water	2	47052	1336600740	1	0.04	0.00181818181818182	7483	1
3	Drink 2	Intake 2	18	47276	1336600964	/users/cn/jespinosa/phecomp/data/CRG/20120502_FDF_CRG/20120502_FDF_CRG/20120509_FDF_CRG_c12.mtb	1826	NA	WWSS	water	2	47258	1336600946	1	0.02	0.00111111111111111	7484	1
3	Drink 1	Intake 1	15	47334	1336601022	/users/cn/jespinosa/phecomp/data/CRG/20120502_FDF_CRG/20120502_FDF_CRG/20120509_FDF_CRG_c12.mtb	533	NA	WWSS	water	1	47319	1336601007	1	0.02	0.00133333333333333	7485	1
3	Drink 2	Intake 2	20	48815	1336602503	/users/cn/jespinosa/phecomp/data/CRG/20120502_FDF_CRG/20120502_FDF_CRG/20120509_FDF_CRG_c12.mtb	1827	NA	WWSS	water	2	48795	1336602483	1	0.02	0.001	7486	1
3	Food 2	Intake 4	15	50162	1336603850	/users/cn/jespinosa/phecomp/data/CRG/20120502_FDF_CRG/20120502_FDF_CRG/20120509_FDF_CRG_c12.mtb	1863	793	WWSS	food_sc	4	50147	1336603835	1	0.02	0.00133333333333333	7487	1
3	Food 1	Intake 3	32	50987	1336604675	/users/cn/jespinosa/phecomp/data/CRG/20120502_FDF_CRG/20120502_FDF_CRG/20120509_FDF_CRG_c12.mtb	1284	1662	WWSS	food_sc	3	50955	1336604643	1	0.02	0.000625	7488	1
3	Drink 1	Intake 1	18	51397	1336605085	/users/cn/jespinosa/phecomp/data/CRG/20120502_FDF_CRG/20120502_FDF_CRG/20120509_FDF_CRG_c12.mtb	534	NA	WWSS	water	1	51379	1336605067	1	0.04	0.00222222222222222	7489	1
3	Drink 1	Intake 1	15	52165	1336605853	/users/cn/jespinosa/phecomp/data/CRG/20120502_FDF_CRG/20120502_FDF_CRG/20120509_FDF_CRG_c12.mtb	536	NA	WWSS	water	1	52150	1336605838	1	0.0600000000000001	0.00400000000000001	7490	1
3	Food 2	Intake 4	82	52731	1336606419	/users/cn/jespinosa/phecomp/data/CRG/20120502_FDF_CRG/20120502_FDF_CRG/20120509_FDF_CRG_c12.mtb	1875	2008	WWSS	food_sc	4	52649	1336606337	1	0.02	0.00024390243902439	7491	1
3	Drink 2	Intake 2	28	54414	1336608102	/users/cn/jespinosa/phecomp/data/CRG/20120502_FDF_CRG/20120502_FDF_CRG/20120509_FDF_CRG_c12.mtb	1833	NA	WWSS	water	2	54386	1336608074	1	0.02	0.000714285714285714	7492	1
3	Food 2	Intake 4	106	54845	1336608533	/users/cn/jespinosa/phecomp/data/CRG/20120502_FDF_CRG/20120502_FDF_CRG/20120509_FDF_CRG_c12.mtb	1882	1339	WWSS	food_sc	4	54739	1336608427	1	0.02	0.000188679245283019	7493	1
3	Food 2	Intake 4	321	56505	1336610193	/users/cn/jespinosa/phecomp/data/CRG/20120502_FDF_CRG/20120502_FDF_CRG/20120509_FDF_CRG_c12.mtb	1892	1425	WWSS	food_sc	4	56184	1336609872	1	0.02	6.23052959501558e-05	7494	1
3	Food 2	Intake 4	417	58347	1336612035	/users/cn/jespinosa/phecomp/data/CRG/20120502_FDF_CRG/20120502_FDF_CRG/20120509_FDF_CRG_c12.mtb	1898	25	WWSS	food_sc	4	57930	1336611618	1	0.12	0.000287769784172662	7495	1
3	Food 2	Intake 4	81	58453	1336612141	/users/cn/jespinosa/phecomp/data/CRG/20120502_FDF_CRG/20120502_FDF_CRG/20120509_FDF_CRG_c12.mtb	1899	5436	WWSS	food_sc	4	58372	1336612060	1	0.04	0.000493827160493827	7496	1
3	Drink 2	Intake 2	33	58488	1336612176	/users/cn/jespinosa/phecomp/data/CRG/20120502_FDF_CRG/20120502_FDF_CRG/20120509_FDF_CRG_c12.mtb	1848	NA	WWSS	water	2	58455	1336612143	1	0.14	0.00424242424242424	7497	1
3	Drink 1	Intake 1	15	58539	1336612227	/users/cn/jespinosa/phecomp/data/CRG/20120502_FDF_CRG/20120502_FDF_CRG/20120509_FDF_CRG_c12.mtb	540	NA	WWSS	water	1	58524	1336612212	1	0.02	0.00133333333333333	7498	1
3	Drink 2	Intake 2	33	58713	1336612401	/users/cn/jespinosa/phecomp/data/CRG/20120502_FDF_CRG/20120502_FDF_CRG/20120509_FDF_CRG_c12.mtb	1849	NA	WWSS	water	2	58680	1336612368	1	0.02	0.000606060606060606	7499	1
3	Food 2	Intake 4	339	64228	1336617916	/users/cn/jespinosa/phecomp/data/CRG/20120502_FDF_CRG/20120502_FDF_CRG/20120509_FDF_CRG_c12.mtb	1906	223	WWSS	food_sc	4	63889	1336617577	1	0.14	0.000412979351032448	7500	1
3	Drink 2	Intake 2	16	64397	1336618085	/users/cn/jespinosa/phecomp/data/CRG/20120502_FDF_CRG/20120502_FDF_CRG/20120509_FDF_CRG_c12.mtb	1850	NA	WWSS	water	2	64381	1336618069	1	0.04	0.0025	7501	1
3	Food 2	Intake 4	66	64517	1336618205	/users/cn/jespinosa/phecomp/data/CRG/20120502_FDF_CRG/20120502_FDF_CRG/20120509_FDF_CRG_c12.mtb	1908	2332	WWSS	food_sc	4	64451	1336618139	1	0.02	0.000303030303030303	7502	1
3	Drink 2	Intake 2	38	64687	1336618375	/users/cn/jespinosa/phecomp/data/CRG/20120502_FDF_CRG/20120502_FDF_CRG/20120509_FDF_CRG_c12.mtb	1851	NA	WWSS	water	2	64649	1336618337	1	0.0599999999999999	0.00157894736842105	7503	1
3	Drink 2	Intake 2	18	65007	1336618695	/users/cn/jespinosa/phecomp/data/CRG/20120502_FDF_CRG/20120502_FDF_CRG/20120509_FDF_CRG_c12.mtb	1852	NA	WWSS	water	2	64989	1336618677	1	0.04	0.00222222222222222	7504	1
3	Drink 1	Intake 1	13	65809	1336619497	/users/cn/jespinosa/phecomp/data/CRG/20120502_FDF_CRG/20120502_FDF_CRG/20120509_FDF_CRG_c12.mtb	544	NA	WWSS	water	1	65796	1336619484	1	0.1	0.00769230769230769	7505	1
3	Food 2	Intake 4	47	66896	1336620584	/users/cn/jespinosa/phecomp/data/CRG/20120502_FDF_CRG/20120502_FDF_CRG/20120509_FDF_CRG_c12.mtb	1911	256	WWSS	food_sc	4	66849	1336620537	1	0.02	0.000425531914893617	7506	1
3	Food 2	Intake 4	196	67348	1336621036	/users/cn/jespinosa/phecomp/data/CRG/20120502_FDF_CRG/20120502_FDF_CRG/20120509_FDF_CRG_c12.mtb	1913	9	WWSS	food_sc	4	67152	1336620840	1	0.0999999999999999	0.000510204081632653	7507	1
3	Food 2	Intake 4	132	67489	1336621177	/users/cn/jespinosa/phecomp/data/CRG/20120502_FDF_CRG/20120502_FDF_CRG/20120509_FDF_CRG_c12.mtb	1914	1665	WWSS	food_sc	4	67357	1336621045	1	0.04	0.000303030303030303	7508	1
3	Drink 2	Intake 2	19	67508	1336621196	/users/cn/jespinosa/phecomp/data/CRG/20120502_FDF_CRG/20120502_FDF_CRG/20120509_FDF_CRG_c12.mtb	1853	NA	WWSS	water	2	67489	1336621177	1	0.04	0.00210526315789474	7509	1
3	Drink 2	Intake 2	14	67576	1336621264	/users/cn/jespinosa/phecomp/data/CRG/20120502_FDF_CRG/20120502_FDF_CRG/20120509_FDF_CRG_c12.mtb	1854	NA	WWSS	water	2	67562	1336621250	1	0.02	0.00142857142857143	7510	1
3	Drink 2	Intake 2	20	68174	1336621862	/users/cn/jespinosa/phecomp/data/CRG/20120502_FDF_CRG/20120502_FDF_CRG/20120509_FDF_CRG_c12.mtb	1855	NA	WWSS	water	2	68154	1336621842	1	0.02	0.001	7511	1
3	Drink 2	Intake 2	25	68649	1336622337	/users/cn/jespinosa/phecomp/data/CRG/20120502_FDF_CRG/20120502_FDF_CRG/20120509_FDF_CRG_c12.mtb	1856	NA	WWSS	water	2	68624	1336622312	1	0.02	0.0008	7512	1
3	Food 2	Intake 4	165	69319	1336623007	/users/cn/jespinosa/phecomp/data/CRG/20120502_FDF_CRG/20120502_FDF_CRG/20120509_FDF_CRG_c12.mtb	1916	2156	WWSS	food_sc	4	69154	1336622842	1	0.04	0.000242424242424242	7513	1
3	Drink 2	Intake 2	18	69413	1336623101	/users/cn/jespinosa/phecomp/data/CRG/20120502_FDF_CRG/20120502_FDF_CRG/20120509_FDF_CRG_c12.mtb	1863	NA	WWSS	water	2	69395	1336623083	1	0.02	0.00111111111111111	7514	1
3	Food 2	Intake 4	344	71819	1336625507	/users/cn/jespinosa/phecomp/data/CRG/20120502_FDF_CRG/20120502_FDF_CRG/20120509_FDF_CRG_c12.mtb	1919	22	WWSS	food_sc	4	71475	1336625163	1	0.04	0.000116279069767442	7515	1
3	Food 2	Intake 4	45	71886	1336625574	/users/cn/jespinosa/phecomp/data/CRG/20120502_FDF_CRG/20120502_FDF_CRG/20120509_FDF_CRG_c12.mtb	1920	4	WWSS	food_sc	4	71841	1336625529	1	0.04	0.000888888888888889	7516	1
3	Food 2	Intake 4	86	71976	1336625664	/users/cn/jespinosa/phecomp/data/CRG/20120502_FDF_CRG/20120502_FDF_CRG/20120509_FDF_CRG_c12.mtb	1921	145	WWSS	food_sc	4	71890	1336625578	1	0.02	0.000232558139534884	7517	1
3	Drink 2	Intake 2	26	71996	1336625684	/users/cn/jespinosa/phecomp/data/CRG/20120502_FDF_CRG/20120502_FDF_CRG/20120509_FDF_CRG_c12.mtb	1866	NA	WWSS	water	2	71970	1336625658	1	0.0799999999999998	0.00307692307692307	7518	1
3	Food 2	Intake 4	82	72203	1336625891	/users/cn/jespinosa/phecomp/data/CRG/20120502_FDF_CRG/20120502_FDF_CRG/20120509_FDF_CRG_c12.mtb	1923	265	WWSS	food_sc	4	72121	1336625809	1	0.02	0.00024390243902439	7519	1
3	Food 2	Intake 4	75	72543	1336626231	/users/cn/jespinosa/phecomp/data/CRG/20120502_FDF_CRG/20120502_FDF_CRG/20120509_FDF_CRG_c12.mtb	1926	126	WWSS	food_sc	4	72468	1336626156	1	0.02	0.000266666666666667	7520	1
3	Drink 2	Intake 2	24	72560	1336626248	/users/cn/jespinosa/phecomp/data/CRG/20120502_FDF_CRG/20120502_FDF_CRG/20120509_FDF_CRG_c12.mtb	1867	NA	WWSS	water	2	72536	1336626224	1	0.1	0.00416666666666667	7521	1
3	Food 2	Intake 4	101	72770	1336626458	/users/cn/jespinosa/phecomp/data/CRG/20120502_FDF_CRG/20120502_FDF_CRG/20120509_FDF_CRG_c12.mtb	1927	3568	WWSS	food_sc	4	72669	1336626357	1	0.02	0.000198019801980198	7522	1
3	Drink 2	Intake 2	16	73018	1336626706	/users/cn/jespinosa/phecomp/data/CRG/20120502_FDF_CRG/20120502_FDF_CRG/20120509_FDF_CRG_c12.mtb	1869	NA	WWSS	water	2	73002	1336626690	1	0.02	0.00125	7523	1
3	Food 2	Intake 4	79	76417	1336630105	/users/cn/jespinosa/phecomp/data/CRG/20120502_FDF_CRG/20120502_FDF_CRG/20120509_FDF_CRG_c12.mtb	1929	1140	WWSS	food_sc	4	76338	1336630026	1	0.02	0.000253164556962025	7524	1
3	Food 2	Intake 4	300	77857	1336631545	/users/cn/jespinosa/phecomp/data/CRG/20120502_FDF_CRG/20120502_FDF_CRG/20120509_FDF_CRG_c12.mtb	1931	8461	WWSS	food_sc	4	77557	1336631245	1	0.04	0.000133333333333333	7525	1
3	Food 2	Intake 4	230	86548	1336640236	/users/cn/jespinosa/phecomp/data/CRG/20120502_FDF_CRG/20120502_FDF_CRG/20120509_FDF_CRG_c12.mtb	1934	14605	WWSS	food_sc	4	86318	1336640006	1	0.02	8.69565217391304e-05	7526	1
3	Drink 1	Intake 1	20	86574	1336640262	/users/cn/jespinosa/phecomp/data/CRG/20120502_FDF_CRG/20120502_FDF_CRG/20120509_FDF_CRG_c12.mtb	550	NA	WWSS	water	1	86554	1336640242	1	0.0399999999999999	0.00199999999999999	7527	1
3	Drink 2	Intake 2	28	86982	1336640670	/users/cn/jespinosa/phecomp/data/CRG/20120502_FDF_CRG/20120502_FDF_CRG/20120509_FDF_CRG_c12.mtb	1874	NA	WWSS	water	2	86954	1336640642	1	0.0399999999999998	0.00142857142857142	7528	1
3	Food 2	Intake 4	30	101183	1336654871	/users/cn/jespinosa/phecomp/data/CRG/20120502_FDF_CRG/20120502_FDF_CRG/20120509_FDF_CRG_c12.mtb	1939	18611	WWSS	food_sc	4	101153	1336654841	1	0.02	0.000666666666666667	7529	1
3	Food 1	Intake 3	75	119869	1336673557	/users/cn/jespinosa/phecomp/data/CRG/20120502_FDF_CRG/20120502_FDF_CRG/20120509_FDF_CRG_c12.mtb	1310	13	WWSS	food_sc	3	119794	1336673482	1	0.02	0.000266666666666667	7530	1
3	Food 1	Intake 3	78	119960	1336673648	/users/cn/jespinosa/phecomp/data/CRG/20120502_FDF_CRG/20120502_FDF_CRG/20120509_FDF_CRG_c12.mtb	1311	544	WWSS	food_sc	3	119882	1336673570	1	0.02	0.000256410256410256	7531	1
3	Food 2	Intake 4	320	120824	1336674512	/users/cn/jespinosa/phecomp/data/CRG/20120502_FDF_CRG/20120502_FDF_CRG/20120509_FDF_CRG_c12.mtb	1946	4522	WWSS	food_sc	4	120504	1336674192	1	0.02	6.25e-05	7532	1
3	Drink 2	Intake 2	18	120959	1336674647	/users/cn/jespinosa/phecomp/data/CRG/20120502_FDF_CRG/20120502_FDF_CRG/20120509_FDF_CRG_c12.mtb	1878	NA	WWSS	water	2	120941	1336674629	1	0.04	0.00222222222222222	7533	1
3	Food 2	Intake 4	532	125878	1336679566	/users/cn/jespinosa/phecomp/data/CRG/20120502_FDF_CRG/20120502_FDF_CRG/20120509_FDF_CRG_c12.mtb	1949	712	WWSS	food_sc	4	125346	1336679034	1	0.0799999999999996	0.000150375939849623	7534	1
3	Drink 1	Intake 1	14	125980	1336679668	/users/cn/jespinosa/phecomp/data/CRG/20120502_FDF_CRG/20120502_FDF_CRG/20120509_FDF_CRG_c12.mtb	553	NA	WWSS	water	1	125966	1336679654	1	0.0800000000000001	0.00571428571428572	7535	1
3	Food 2	Intake 4	391	126981	1336680669	/users/cn/jespinosa/phecomp/data/CRG/20120502_FDF_CRG/20120502_FDF_CRG/20120509_FDF_CRG_c12.mtb	1951	1395	WWSS	food_sc	4	126590	1336680278	1	0.12	0.00030690537084399	7536	1
3	Drink 2	Intake 2	18	127003	1336680691	/users/cn/jespinosa/phecomp/data/CRG/20120502_FDF_CRG/20120502_FDF_CRG/20120509_FDF_CRG_c12.mtb	1880	NA	WWSS	water	2	126985	1336680673	1	0.0600000000000001	0.00333333333333334	7537	1
3	Drink 1	Intake 1	21	127121	1336680809	/users/cn/jespinosa/phecomp/data/CRG/20120502_FDF_CRG/20120502_FDF_CRG/20120509_FDF_CRG_c12.mtb	554	NA	WWSS	water	1	127100	1336680788	1	0.0399999999999999	0.0019047619047619	7538	1
3	Drink 1	Intake 1	12	128068	1336681756	/users/cn/jespinosa/phecomp/data/CRG/20120502_FDF_CRG/20120502_FDF_CRG/20120509_FDF_CRG_c12.mtb	555	NA	WWSS	water	1	128056	1336681744	1	0.04	0.00333333333333333	7539	1
3	Food 2	Intake 4	147	128523	1336682211	/users/cn/jespinosa/phecomp/data/CRG/20120502_FDF_CRG/20120502_FDF_CRG/20120509_FDF_CRG_c12.mtb	1954	908	WWSS	food_sc	4	128376	1336682064	1	0.02	0.000136054421768707	7540	1
3	Drink 2	Intake 2	13	128551	1336682239	/users/cn/jespinosa/phecomp/data/CRG/20120502_FDF_CRG/20120502_FDF_CRG/20120509_FDF_CRG_c12.mtb	1884	NA	WWSS	water	2	128538	1336682226	1	0.02	0.00153846153846154	7541	1
3	Food 2	Intake 4	541	129972	1336683660	/users/cn/jespinosa/phecomp/data/CRG/20120502_FDF_CRG/20120502_FDF_CRG/20120509_FDF_CRG_c12.mtb	1957	88	WWSS	food_sc	4	129431	1336683119	1	0.14	0.000258780036968577	7542	1
3	Food 2	Intake 4	160	130220	1336683908	/users/cn/jespinosa/phecomp/data/CRG/20120502_FDF_CRG/20120502_FDF_CRG/20120509_FDF_CRG_c12.mtb	1959	523	WWSS	food_sc	4	130060	1336683748	1	0.04	0.00025	7543	1
3	Drink 2	Intake 2	24	130236	1336683924	/users/cn/jespinosa/phecomp/data/CRG/20120502_FDF_CRG/20120502_FDF_CRG/20120509_FDF_CRG_c12.mtb	1885	NA	WWSS	water	2	130212	1336683900	1	0.0800000000000001	0.00333333333333334	7544	1
3	Drink 2	Intake 2	19	130310	1336683998	/users/cn/jespinosa/phecomp/data/CRG/20120502_FDF_CRG/20120502_FDF_CRG/20120509_FDF_CRG_c12.mtb	1886	NA	WWSS	water	2	130291	1336683979	1	0.04	0.00210526315789474	7545	1
3	Food 1	Intake 3	17	130760	1336684448	/users/cn/jespinosa/phecomp/data/CRG/20120502_FDF_CRG/20120502_FDF_CRG/20120509_FDF_CRG_c12.mtb	1321	1552	WWSS	food_sc	3	130743	1336684431	1	0.02	0.00117647058823529	7546	1
3	Drink 2	Intake 2	18	130973	1336684661	/users/cn/jespinosa/phecomp/data/CRG/20120502_FDF_CRG/20120502_FDF_CRG/20120509_FDF_CRG_c12.mtb	1888	NA	WWSS	water	2	130955	1336684643	1	0.04	0.00222222222222222	7547	1
3	Food 2	Intake 4	238	132550	1336686238	/users/cn/jespinosa/phecomp/data/CRG/20120502_FDF_CRG/20120502_FDF_CRG/20120509_FDF_CRG_c12.mtb	1964	26	WWSS	food_sc	4	132312	1336686000	1	0.02	8.40336134453782e-05	7548	1
3	Food 1	Intake 3	607	133183	1336686871	/users/cn/jespinosa/phecomp/data/CRG/20120502_FDF_CRG/20120502_FDF_CRG/20120509_FDF_CRG_c12.mtb	1322	646	WWSS	food_sc	3	132576	1336686264	1	0.14	0.000230642504118616	7549	1
3	Drink 2	Intake 2	17	133250	1336686938	/users/cn/jespinosa/phecomp/data/CRG/20120502_FDF_CRG/20120502_FDF_CRG/20120509_FDF_CRG_c12.mtb	1889	NA	WWSS	water	2	133233	1336686921	1	0.04	0.00235294117647059	7550	1
3	Drink 2	Intake 2	17	133419	1336687107	/users/cn/jespinosa/phecomp/data/CRG/20120502_FDF_CRG/20120502_FDF_CRG/20120509_FDF_CRG_c12.mtb	1890	NA	WWSS	water	2	133402	1336687090	1	0.0399999999999998	0.00235294117647058	7551	1
3	Food 1	Intake 3	86	133915	1336687603	/users/cn/jespinosa/phecomp/data/CRG/20120502_FDF_CRG/20120502_FDF_CRG/20120509_FDF_CRG_c12.mtb	1323	4	WWSS	food_sc	3	133829	1336687517	1	0.04	0.000465116279069767	7552	1
3	Food 1	Intake 3	160	134079	1336687767	/users/cn/jespinosa/phecomp/data/CRG/20120502_FDF_CRG/20120502_FDF_CRG/20120509_FDF_CRG_c12.mtb	1324	2217	WWSS	food_sc	3	133919	1336687607	1	0.02	0.000125	7553	1
3	Drink 2	Intake 2	20	134130	1336687818	/users/cn/jespinosa/phecomp/data/CRG/20120502_FDF_CRG/20120502_FDF_CRG/20120509_FDF_CRG_c12.mtb	1891	NA	WWSS	water	2	134110	1336687798	1	0.0600000000000001	0.00300000000000001	7554	1
3	Food 1	Intake 3	358	136654	1336690342	/users/cn/jespinosa/phecomp/data/CRG/20120502_FDF_CRG/20120502_FDF_CRG/20120509_FDF_CRG_c12.mtb	1327	22	WWSS	food_sc	3	136296	1336689984	1	0.1	0.000279329608938548	7555	1
3	Food 1	Intake 3	108	136784	1336690472	/users/cn/jespinosa/phecomp/data/CRG/20120502_FDF_CRG/20120502_FDF_CRG/20120509_FDF_CRG_c12.mtb	1328	386	WWSS	food_sc	3	136676	1336690364	1	0.04	0.00037037037037037	7556	1
3	Drink 2	Intake 2	16	136807	1336690495	/users/cn/jespinosa/phecomp/data/CRG/20120502_FDF_CRG/20120502_FDF_CRG/20120509_FDF_CRG_c12.mtb	1892	NA	WWSS	water	2	136791	1336690479	1	0.02	0.00125	7557	1
3	Drink 2	Intake 2	26	136970	1336690658	/users/cn/jespinosa/phecomp/data/CRG/20120502_FDF_CRG/20120502_FDF_CRG/20120509_FDF_CRG_c12.mtb	1893	NA	WWSS	water	2	136944	1336690632	1	0.0599999999999998	0.0023076923076923	7558	1
3	Food 1	Intake 3	78	137248	1336690936	/users/cn/jespinosa/phecomp/data/CRG/20120502_FDF_CRG/20120502_FDF_CRG/20120509_FDF_CRG_c12.mtb	1330	414	WWSS	food_sc	3	137170	1336690858	1	0.02	0.000256410256410256	7559	1
3	Drink 2	Intake 2	35	137341	1336691029	/users/cn/jespinosa/phecomp/data/CRG/20120502_FDF_CRG/20120502_FDF_CRG/20120509_FDF_CRG_c12.mtb	1894	NA	WWSS	water	2	137306	1336690994	1	0.0600000000000001	0.00171428571428572	7560	1
3	Drink 1	Intake 1	18	137572	1336691260	/users/cn/jespinosa/phecomp/data/CRG/20120502_FDF_CRG/20120502_FDF_CRG/20120509_FDF_CRG_c12.mtb	559	NA	WWSS	water	1	137554	1336691242	1	0.04	0.00222222222222222	7561	1
3	Food 1	Intake 3	406	138068	1336691756	/users/cn/jespinosa/phecomp/data/CRG/20120502_FDF_CRG/20120502_FDF_CRG/20120509_FDF_CRG_c12.mtb	1332	470	WWSS	food_sc	3	137662	1336691350	1	0.0800000000000001	0.00019704433497537	7562	1
3	Drink 2	Intake 2	19	138082	1336691770	/users/cn/jespinosa/phecomp/data/CRG/20120502_FDF_CRG/20120502_FDF_CRG/20120509_FDF_CRG_c12.mtb	1895	NA	WWSS	water	2	138063	1336691751	1	0.02	0.00105263157894737	7563	1
3	Drink 2	Intake 2	25	138187	1336691875	/users/cn/jespinosa/phecomp/data/CRG/20120502_FDF_CRG/20120502_FDF_CRG/20120509_FDF_CRG_c12.mtb	1896	NA	WWSS	water	2	138162	1336691850	1	0.02	0.0008	7564	1
3	Drink 2	Intake 2	18	138224	1336691912	/users/cn/jespinosa/phecomp/data/CRG/20120502_FDF_CRG/20120502_FDF_CRG/20120509_FDF_CRG_c12.mtb	1897	NA	WWSS	water	2	138206	1336691894	1	0.02	0.00111111111111111	7565	1
3	Food 2	Intake 4	290	138828	1336692516	/users/cn/jespinosa/phecomp/data/CRG/20120502_FDF_CRG/20120502_FDF_CRG/20120509_FDF_CRG_c12.mtb	1980	1606	WWSS	food_sc	4	138538	1336692226	1	0.02	6.89655172413793e-05	7566	1
3	Drink 2	Intake 2	25	138847	1336692535	/users/cn/jespinosa/phecomp/data/CRG/20120502_FDF_CRG/20120502_FDF_CRG/20120509_FDF_CRG_c12.mtb	1898	NA	WWSS	water	2	138822	1336692510	1	0.0600000000000001	0.0024	7567	1
3	Food 1	Intake 3	305	140739	1336694427	/users/cn/jespinosa/phecomp/data/CRG/20120502_FDF_CRG/20120502_FDF_CRG/20120509_FDF_CRG_c12.mtb	1335	43	WWSS	food_sc	3	140434	1336694122	1	0.0399999999999998	0.000131147540983606	7568	1
3	Food 2	Intake 4	54	140836	1336694524	/users/cn/jespinosa/phecomp/data/CRG/20120502_FDF_CRG/20120502_FDF_CRG/20120509_FDF_CRG_c12.mtb	1982	905	WWSS	food_sc	4	140782	1336694470	1	0.02	0.00037037037037037	7569	1
3	Drink 2	Intake 2	29	140916	1336694604	/users/cn/jespinosa/phecomp/data/CRG/20120502_FDF_CRG/20120502_FDF_CRG/20120509_FDF_CRG_c12.mtb	1899	NA	WWSS	water	2	140887	1336694575	1	0.04	0.00137931034482759	7570	1
3	Food 2	Intake 4	89	141830	1336695518	/users/cn/jespinosa/phecomp/data/CRG/20120502_FDF_CRG/20120502_FDF_CRG/20120509_FDF_CRG_c12.mtb	1985	879	WWSS	food_sc	4	141741	1336695429	1	0.02	0.000224719101123596	7571	1
3	Food 1	Intake 3	101	142810	1336696498	/users/cn/jespinosa/phecomp/data/CRG/20120502_FDF_CRG/20120502_FDF_CRG/20120509_FDF_CRG_c12.mtb	1342	COLL	WWSS	food_sc	3	142709	1336696397	1	0.02	0.000198019801980198	7572	1
3	Food 2	Intake 4	435	143233	1336696921	/users/cn/jespinosa/phecomp/data/CRG/20120502_FDF_CRG/20120502_FDF_CRG/20120509_FDF_CRG_c12.mtb	1989	1995	WWSS	food_sc	4	142798	1336696486	1	0.0999999999999996	0.000229885057471263	7573	1
3	Drink 1	Intake 1	18	144107	1336697795	/users/cn/jespinosa/phecomp/data/CRG/20120502_FDF_CRG/20120502_FDF_CRG/20120509_FDF_CRG_c12.mtb	562	NA	WWSS	water	1	144089	1336697777	1	0.08	0.00444444444444444	7574	1
3	Food 2	Intake 4	616	145844	1336699532	/users/cn/jespinosa/phecomp/data/CRG/20120502_FDF_CRG/20120502_FDF_CRG/20120509_FDF_CRG_c12.mtb	1992	32	WWSS	food_sc	4	145228	1336698916	1	0.14	0.000227272727272727	7575	1
3	Food 2	Intake 4	68	145944	1336699632	/users/cn/jespinosa/phecomp/data/CRG/20120502_FDF_CRG/20120502_FDF_CRG/20120509_FDF_CRG_c12.mtb	1993	1329	WWSS	food_sc	4	145876	1336699564	1	0.02	0.000294117647058824	7576	1
3	Drink 2	Intake 2	13	145954	1336699642	/users/cn/jespinosa/phecomp/data/CRG/20120502_FDF_CRG/20120502_FDF_CRG/20120509_FDF_CRG_c12.mtb	1902	NA	WWSS	water	2	145941	1336699629	1	0.02	0.00153846153846154	7577	1
3	Drink 2	Intake 2	21	146017	1336699705	/users/cn/jespinosa/phecomp/data/CRG/20120502_FDF_CRG/20120502_FDF_CRG/20120509_FDF_CRG_c12.mtb	1903	NA	WWSS	water	2	145996	1336699684	1	0.0600000000000001	0.00285714285714286	7578	1
3	Drink 2	Intake 2	16	146400	1336700088	/users/cn/jespinosa/phecomp/data/CRG/20120502_FDF_CRG/20120502_FDF_CRG/20120509_FDF_CRG_c12.mtb	1904	NA	WWSS	water	2	146384	1336700072	1	0.04	0.0025	7579	1
3	Drink 1	Intake 1	26	146651	1336700339	/users/cn/jespinosa/phecomp/data/CRG/20120502_FDF_CRG/20120502_FDF_CRG/20120509_FDF_CRG_c12.mtb	563	NA	WWSS	water	1	146625	1336700313	1	0.1	0.00384615384615385	7580	1
3	Food 2	Intake 4	552	147825	1336701513	/users/cn/jespinosa/phecomp/data/CRG/20120502_FDF_CRG/20120502_FDF_CRG/20120509_FDF_CRG_c12.mtb	1996	2647	WWSS	food_sc	4	147273	1336700961	1	0.12	0.000217391304347826	7581	1
3	Drink 2	Intake 2	15	148474	1336702162	/users/cn/jespinosa/phecomp/data/CRG/20120502_FDF_CRG/20120502_FDF_CRG/20120509_FDF_CRG_c12.mtb	1905	NA	WWSS	water	2	148459	1336702147	1	0.02	0.00133333333333333	7582	1
3	Drink 2	Intake 2	10	149014	1336702702	/users/cn/jespinosa/phecomp/data/CRG/20120502_FDF_CRG/20120502_FDF_CRG/20120509_FDF_CRG_c12.mtb	1906	NA	WWSS	water	2	149004	1336702692	1	0.0399999999999996	0.00399999999999996	7583	1
3	Food 2	Intake 4	303	150775	1336704463	/users/cn/jespinosa/phecomp/data/CRG/20120502_FDF_CRG/20120502_FDF_CRG/20120509_FDF_CRG_c12.mtb	2000	38	WWSS	food_sc	4	150472	1336704160	1	0.0800000000000001	0.000264026402640264	7584	1
3	Food 2	Intake 4	243	151056	1336704744	/users/cn/jespinosa/phecomp/data/CRG/20120502_FDF_CRG/20120502_FDF_CRG/20120509_FDF_CRG_c12.mtb	2001	187	WWSS	food_sc	4	150813	1336704501	1	0.0600000000000001	0.000246913580246914	7585	1
3	Drink 2	Intake 2	15	151078	1336704766	/users/cn/jespinosa/phecomp/data/CRG/20120502_FDF_CRG/20120502_FDF_CRG/20120509_FDF_CRG_c12.mtb	1907	NA	WWSS	water	2	151063	1336704751	1	0.04	0.00266666666666667	7586	1
3	Drink 2	Intake 2	18	151118	1336704806	/users/cn/jespinosa/phecomp/data/CRG/20120502_FDF_CRG/20120502_FDF_CRG/20120509_FDF_CRG_c12.mtb	1908	NA	WWSS	water	2	151100	1336704788	1	0.02	0.00111111111111111	7587	1
3	Food 2	Intake 4	105	151348	1336705036	/users/cn/jespinosa/phecomp/data/CRG/20120502_FDF_CRG/20120502_FDF_CRG/20120509_FDF_CRG_c12.mtb	2003	1027	WWSS	food_sc	4	151243	1336704931	1	0.02	0.00019047619047619	7588	1
3	Drink 2	Intake 2	24	151513	1336705201	/users/cn/jespinosa/phecomp/data/CRG/20120502_FDF_CRG/20120502_FDF_CRG/20120509_FDF_CRG_c12.mtb	1909	NA	WWSS	water	2	151489	1336705177	1	0.0600000000000001	0.0025	7589	1
3	Drink 2	Intake 2	36	152224	1336705912	/users/cn/jespinosa/phecomp/data/CRG/20120502_FDF_CRG/20120502_FDF_CRG/20120509_FDF_CRG_c12.mtb	1910	NA	WWSS	water	2	152188	1336705876	1	0.0800000000000001	0.00222222222222222	7590	1
3	Food 1	Intake 3	82	152457	1336706145	/users/cn/jespinosa/phecomp/data/CRG/20120502_FDF_CRG/20120502_FDF_CRG/20120509_FDF_CRG_c12.mtb	1347	1487	WWSS	food_sc	3	152375	1336706063	1	0.02	0.00024390243902439	7591	1
3	Food 2	Intake 4	172	154116	1336707804	/users/cn/jespinosa/phecomp/data/CRG/20120502_FDF_CRG/20120502_FDF_CRG/20120509_FDF_CRG_c12.mtb	2009	1379	WWSS	food_sc	4	153944	1336707632	1	0.0200000000000005	0.000116279069767445	7592	1
3	Food 2	Intake 4	323	155818	1336709506	/users/cn/jespinosa/phecomp/data/CRG/20120502_FDF_CRG/20120502_FDF_CRG/20120509_FDF_CRG_c12.mtb	2013	24	WWSS	food_sc	4	155495	1336709183	1	0.0600000000000001	0.000185758513931889	7593	1
3	Food 2	Intake 4	235	156077	1336709765	/users/cn/jespinosa/phecomp/data/CRG/20120502_FDF_CRG/20120502_FDF_CRG/20120509_FDF_CRG_c12.mtb	2014	2957	WWSS	food_sc	4	155842	1336709530	1	0.0600000000000001	0.000255319148936171	7594	1
3	Drink 2	Intake 2	23	156102	1336709790	/users/cn/jespinosa/phecomp/data/CRG/20120502_FDF_CRG/20120502_FDF_CRG/20120509_FDF_CRG_c12.mtb	1912	NA	WWSS	water	2	156079	1336709767	1	0.0600000000000001	0.00260869565217392	7595	1
3	Drink 2	Intake 2	16	156439	1336710127	/users/cn/jespinosa/phecomp/data/CRG/20120502_FDF_CRG/20120502_FDF_CRG/20120509_FDF_CRG_c12.mtb	1913	NA	WWSS	water	2	156423	1336710111	1	0.02	0.00125	7596	1
3	Drink 2	Intake 2	30	157042	1336710730	/users/cn/jespinosa/phecomp/data/CRG/20120502_FDF_CRG/20120502_FDF_CRG/20120509_FDF_CRG_c12.mtb	1914	NA	WWSS	water	2	157012	1336710700	1	0.0800000000000001	0.00266666666666667	7597	1
3	Food 2	Intake 4	101	159135	1336712823	/users/cn/jespinosa/phecomp/data/CRG/20120502_FDF_CRG/20120502_FDF_CRG/20120509_FDF_CRG_c12.mtb	2022	42	WWSS	food_sc	4	159034	1336712722	1	0.02	0.000198019801980198	7598	1
3	Food 2	Intake 4	215	159392	1336713080	/users/cn/jespinosa/phecomp/data/CRG/20120502_FDF_CRG/20120502_FDF_CRG/20120509_FDF_CRG_c12.mtb	2023	96	WWSS	food_sc	4	159177	1336712865	1	0.0600000000000001	0.000279069767441861	7599	1
3	Food 2	Intake 4	134	159622	1336713310	/users/cn/jespinosa/phecomp/data/CRG/20120502_FDF_CRG/20120502_FDF_CRG/20120509_FDF_CRG_c12.mtb	2024	146	WWSS	food_sc	4	159488	1336713176	1	0.02	0.000149253731343284	7600	1
3	Drink 2	Intake 2	23	159641	1336713329	/users/cn/jespinosa/phecomp/data/CRG/20120502_FDF_CRG/20120502_FDF_CRG/20120509_FDF_CRG_c12.mtb	1915	NA	WWSS	water	2	159618	1336713306	1	0.04	0.00173913043478261	7601	1
3	Food 2	Intake 4	152	159920	1336713608	/users/cn/jespinosa/phecomp/data/CRG/20120502_FDF_CRG/20120502_FDF_CRG/20120509_FDF_CRG_c12.mtb	2026	870	WWSS	food_sc	4	159768	1336713456	1	0.02	0.000131578947368421	7602	1
3	Drink 2	Intake 2	20	159940	1336713628	/users/cn/jespinosa/phecomp/data/CRG/20120502_FDF_CRG/20120502_FDF_CRG/20120509_FDF_CRG_c12.mtb	1916	NA	WWSS	water	2	159920	1336713608	1	0.0599999999999996	0.00299999999999998	7603	1
3	Drink 2	Intake 2	16	160204	1336713892	/users/cn/jespinosa/phecomp/data/CRG/20120502_FDF_CRG/20120502_FDF_CRG/20120509_FDF_CRG_c12.mtb	1917	NA	WWSS	water	2	160188	1336713876	1	0.0200000000000005	0.00125000000000003	7604	1
3	Drink 2	Intake 2	19	160723	1336714411	/users/cn/jespinosa/phecomp/data/CRG/20120502_FDF_CRG/20120502_FDF_CRG/20120509_FDF_CRG_c12.mtb	1918	NA	WWSS	water	2	160704	1336714392	1	0.04	0.00210526315789474	7605	1
3	Food 1	Intake 3	226	161016	1336714704	/users/cn/jespinosa/phecomp/data/CRG/20120502_FDF_CRG/20120502_FDF_CRG/20120509_FDF_CRG_c12.mtb	1356	5789	WWSS	food_sc	3	160790	1336714478	1	0.02	8.84955752212389e-05	7606	1
3	Drink 2	Intake 2	15	161415	1336715103	/users/cn/jespinosa/phecomp/data/CRG/20120502_FDF_CRG/20120502_FDF_CRG/20120509_FDF_CRG_c12.mtb	1919	NA	WWSS	water	2	161400	1336715088	1	0.0399999999999996	0.00266666666666664	7607	1
3	Food 2	Intake 4	311	167116	1336720804	/users/cn/jespinosa/phecomp/data/CRG/20120502_FDF_CRG/20120502_FDF_CRG/20120509_FDF_CRG_c12.mtb	2033	12838	WWSS	food_sc	4	166805	1336720493	1	0.02	6.43086816720257e-05	7608	1
3	Drink 2	Intake 2	46	169012	1336722700	/users/cn/jespinosa/phecomp/data/CRG/20120502_FDF_CRG/20120502_FDF_CRG/20120509_FDF_CRG_c12.mtb	1923	NA	WWSS	water	2	168966	1336722654	1	0.02	0.000434782608695652	7609	1
3	Food 2	Intake 4	274	3051	1336733916	/users/cn/jespinosa/phecomp/data/CRG/20120502_FDF_CRG/20120502_FDF_CRG/20120511_FDF_CRG_c12.mtb	2434	3561	WWSS	food_sc	4	2777	1336733642	1	0.02	7.2992700729927e-05	7610	1
3	Food 2	Intake 4	255	6867	1336737732	/users/cn/jespinosa/phecomp/data/CRG/20120502_FDF_CRG/20120502_FDF_CRG/20120511_FDF_CRG_c12.mtb	2435	23060	WWSS	food_sc	4	6612	1336737477	1	0.06	0.000235294117647059	7611	1
3	Drink 2	Intake 2	15	7065	1336737930	/users/cn/jespinosa/phecomp/data/CRG/20120502_FDF_CRG/20120502_FDF_CRG/20120511_FDF_CRG_c12.mtb	2107	NA	WWSS	water	2	7050	1336737915	1	0.02	0.00133333333333333	7612	1
3	Food 2	Intake 4	336	30263	1336761128	/users/cn/jespinosa/phecomp/data/CRG/20120502_FDF_CRG/20120502_FDF_CRG/20120511_FDF_CRG_c12.mtb	2444	23	WWSS	food_sc	4	29927	1336760792	1	0.02	5.95238095238095e-05	7613	1
3	Food 1	Intake 3	377	30663	1336761528	/users/cn/jespinosa/phecomp/data/CRG/20120502_FDF_CRG/20120502_FDF_CRG/20120511_FDF_CRG_c12.mtb	1573	1595	WWSS	food_sc	3	30286	1336761151	1	0.08	0.000212201591511936	7614	1
3	Drink 1	Intake 1	14	31597	1336762462	/users/cn/jespinosa/phecomp/data/CRG/20120502_FDF_CRG/20120502_FDF_CRG/20120511_FDF_CRG_c12.mtb	759	NA	WWSS	water	1	31583	1336762448	1	0.06	0.00428571428571429	7615	1
3	Drink 2	Intake 2	11	31984	1336762849	/users/cn/jespinosa/phecomp/data/CRG/20120502_FDF_CRG/20120502_FDF_CRG/20120511_FDF_CRG_c12.mtb	2109	NA	WWSS	water	2	31973	1336762838	1	0.02	0.00181818181818182	7616	1
3	Food 1	Intake 3	698	32956	1336763821	/users/cn/jespinosa/phecomp/data/CRG/20120502_FDF_CRG/20120502_FDF_CRG/20120511_FDF_CRG_c12.mtb	1575	64	WWSS	food_sc	3	32258	1336763123	1	0.08	0.000114613180515759	7617	1
3	Food 2	Intake 4	359	33379	1336764244	/users/cn/jespinosa/phecomp/data/CRG/20120502_FDF_CRG/20120502_FDF_CRG/20120511_FDF_CRG_c12.mtb	2448	1121	WWSS	food_sc	4	33020	1336763885	1	0.08	0.000222841225626741	7618	1
3	Drink 1	Intake 1	26	33400	1336764265	/users/cn/jespinosa/phecomp/data/CRG/20120502_FDF_CRG/20120502_FDF_CRG/20120511_FDF_CRG_c12.mtb	760	NA	WWSS	water	1	33374	1336764239	1	0.1	0.00384615384615385	7619	1
3	Drink 1	Intake 1	15	34010	1336764875	/users/cn/jespinosa/phecomp/data/CRG/20120502_FDF_CRG/20120502_FDF_CRG/20120511_FDF_CRG_c12.mtb	761	NA	WWSS	water	1	33995	1336764860	1	0.02	0.00133333333333333	7620	1
3	Food 1	Intake 3	90	34590	1336765455	/users/cn/jespinosa/phecomp/data/CRG/20120502_FDF_CRG/20120502_FDF_CRG/20120511_FDF_CRG_c12.mtb	1577	COLL	WWSS	food_sc	3	34500	1336765365	1	0.02	0.000222222222222222	7621	1
3	Food 2	Intake 4	631	35210	1336766075	/users/cn/jespinosa/phecomp/data/CRG/20120502_FDF_CRG/20120502_FDF_CRG/20120511_FDF_CRG_c12.mtb	2449	41	WWSS	food_sc	4	34579	1336765444	1	0.16	0.000253565768621236	7622	1
3	Drink 2	Intake 2	25	35230	1336766095	/users/cn/jespinosa/phecomp/data/CRG/20120502_FDF_CRG/20120502_FDF_CRG/20120511_FDF_CRG_c12.mtb	2111	NA	WWSS	water	2	35205	1336766070	1	0.1	0.004	7623	1
3	Food 2	Intake 4	56	35307	1336766172	/users/cn/jespinosa/phecomp/data/CRG/20120502_FDF_CRG/20120502_FDF_CRG/20120511_FDF_CRG_c12.mtb	2450	912	WWSS	food_sc	4	35251	1336766116	1	0.02	0.000357142857142857	7624	1
3	Drink 2	Intake 2	31	35391	1336766256	/users/cn/jespinosa/phecomp/data/CRG/20120502_FDF_CRG/20120502_FDF_CRG/20120511_FDF_CRG_c12.mtb	2112	NA	WWSS	water	2	35360	1336766225	1	0.08	0.00258064516129032	7625	1
3	Food 2	Intake 4	102	36321	1336767186	/users/cn/jespinosa/phecomp/data/CRG/20120502_FDF_CRG/20120502_FDF_CRG/20120511_FDF_CRG_c12.mtb	2452	39	WWSS	food_sc	4	36219	1336767084	1	0.02	0.000196078431372549	7626	1
3	Food 2	Intake 4	615	36975	1336767840	/users/cn/jespinosa/phecomp/data/CRG/20120502_FDF_CRG/20120502_FDF_CRG/20120511_FDF_CRG_c12.mtb	2453	1321	WWSS	food_sc	4	36360	1336767225	1	0.18	0.000292682926829268	7627	1
3	Drink 2	Intake 2	20	36991	1336767856	/users/cn/jespinosa/phecomp/data/CRG/20120502_FDF_CRG/20120502_FDF_CRG/20120511_FDF_CRG_c12.mtb	2113	NA	WWSS	water	2	36971	1336767836	1	0.12	0.006	7628	1
3	Drink 2	Intake 2	17	37057	1336767922	/users/cn/jespinosa/phecomp/data/CRG/20120502_FDF_CRG/20120502_FDF_CRG/20120511_FDF_CRG_c12.mtb	2114	NA	WWSS	water	2	37040	1336767905	1	0.04	0.00235294117647059	7629	1
3	Food 2	Intake 4	288	38584	1336769449	/users/cn/jespinosa/phecomp/data/CRG/20120502_FDF_CRG/20120502_FDF_CRG/20120511_FDF_CRG_c12.mtb	2456	15	WWSS	food_sc	4	38296	1336769161	1	0.0399999999999999	0.000138888888888889	7630	1
3	Food 1	Intake 3	233	38832	1336769697	/users/cn/jespinosa/phecomp/data/CRG/20120502_FDF_CRG/20120502_FDF_CRG/20120511_FDF_CRG_c12.mtb	1578	1066	WWSS	food_sc	3	38599	1336769464	1	0.04	0.000171673819742489	7631	1
3	Drink 2	Intake 2	22	38878	1336769743	/users/cn/jespinosa/phecomp/data/CRG/20120502_FDF_CRG/20120502_FDF_CRG/20120511_FDF_CRG_c12.mtb	2115	NA	WWSS	water	2	38856	1336769721	1	0.1	0.00454545454545455	7632	1
3	Food 2	Intake 4	333	40231	1336771096	/users/cn/jespinosa/phecomp/data/CRG/20120502_FDF_CRG/20120502_FDF_CRG/20120511_FDF_CRG_c12.mtb	2458	280	WWSS	food_sc	4	39898	1336770763	1	0.02	6.00600600600601e-05	7633	1
3	Drink 2	Intake 2	17	40241	1336771106	/users/cn/jespinosa/phecomp/data/CRG/20120502_FDF_CRG/20120502_FDF_CRG/20120511_FDF_CRG_c12.mtb	2116	NA	WWSS	water	2	40224	1336771089	1	0.02	0.00117647058823529	7634	1
3	Drink 1	Intake 1	16	40396	1336771261	/users/cn/jespinosa/phecomp/data/CRG/20120502_FDF_CRG/20120502_FDF_CRG/20120511_FDF_CRG_c12.mtb	763	NA	WWSS	water	1	40380	1336771245	1	0.02	0.00125	7635	1
3	Food 1	Intake 3	560	41071	1336771936	/users/cn/jespinosa/phecomp/data/CRG/20120502_FDF_CRG/20120502_FDF_CRG/20120511_FDF_CRG_c12.mtb	1580	1370	WWSS	food_sc	3	40511	1336771376	1	0.14	0.00025	7636	1
3	Drink 2	Intake 2	18	41101	1336771966	/users/cn/jespinosa/phecomp/data/CRG/20120502_FDF_CRG/20120502_FDF_CRG/20120511_FDF_CRG_c12.mtb	2117	NA	WWSS	water	2	41083	1336771948	1	0.04	0.00222222222222222	7637	1
3	Drink 2	Intake 2	15	41265	1336772130	/users/cn/jespinosa/phecomp/data/CRG/20120502_FDF_CRG/20120502_FDF_CRG/20120511_FDF_CRG_c12.mtb	2118	NA	WWSS	water	2	41250	1336772115	1	0.0399999999999999	0.00266666666666666	7638	1
3	Drink 2	Intake 2	16	41348	1336772213	/users/cn/jespinosa/phecomp/data/CRG/20120502_FDF_CRG/20120502_FDF_CRG/20120511_FDF_CRG_c12.mtb	2119	NA	WWSS	water	2	41332	1336772197	1	0.02	0.00125	7639	1
3	Drink 2	Intake 2	23	41471	1336772336	/users/cn/jespinosa/phecomp/data/CRG/20120502_FDF_CRG/20120502_FDF_CRG/20120511_FDF_CRG_c12.mtb	2120	NA	WWSS	water	2	41448	1336772313	1	0.02	0.000869565217391304	7640	1
3	Food 1	Intake 3	403	42844	1336773709	/users/cn/jespinosa/phecomp/data/CRG/20120502_FDF_CRG/20120502_FDF_CRG/20120511_FDF_CRG_c12.mtb	1584	40	WWSS	food_sc	3	42441	1336773306	1	0.12	0.000297766749379653	7641	1
3	Food 1	Intake 3	374	43258	1336774123	/users/cn/jespinosa/phecomp/data/CRG/20120502_FDF_CRG/20120502_FDF_CRG/20120511_FDF_CRG_c12.mtb	1585	197	WWSS	food_sc	3	42884	1336773749	1	0.12	0.000320855614973262	7642	1
3	Drink 2	Intake 2	23	43270	1336774135	/users/cn/jespinosa/phecomp/data/CRG/20120502_FDF_CRG/20120502_FDF_CRG/20120511_FDF_CRG_c12.mtb	2121	NA	WWSS	water	2	43247	1336774112	1	0.1	0.00434782608695652	7643	1
3	Food 1	Intake 3	190	43645	1336774510	/users/cn/jespinosa/phecomp/data/CRG/20120502_FDF_CRG/20120502_FDF_CRG/20120511_FDF_CRG_c12.mtb	1587	1692	WWSS	food_sc	3	43455	1336774320	1	0.04	0.000210526315789474	7644	1
3	Drink 2	Intake 2	22	43679	1336774544	/users/cn/jespinosa/phecomp/data/CRG/20120502_FDF_CRG/20120502_FDF_CRG/20120511_FDF_CRG_c12.mtb	2122	NA	WWSS	water	2	43657	1336774522	1	0.0600000000000001	0.00272727272727273	7645	1
3	Drink 2	Intake 2	21	45321	1336776186	/users/cn/jespinosa/phecomp/data/CRG/20120502_FDF_CRG/20120502_FDF_CRG/20120511_FDF_CRG_c12.mtb	2123	NA	WWSS	water	2	45300	1336776165	1	0.0399999999999999	0.0019047619047619	7646	1
3	Food 1	Intake 3	797	46134	1336776999	/users/cn/jespinosa/phecomp/data/CRG/20120502_FDF_CRG/20120502_FDF_CRG/20120511_FDF_CRG_c12.mtb	1589	1202	WWSS	food_sc	3	45337	1336776202	1	0.3	0.000376411543287327	7647	1
3	Drink 2	Intake 2	31	46157	1336777022	/users/cn/jespinosa/phecomp/data/CRG/20120502_FDF_CRG/20120502_FDF_CRG/20120511_FDF_CRG_c12.mtb	2124	NA	WWSS	water	2	46126	1336776991	1	0.12	0.00387096774193548	7648	1
3	Drink 2	Intake 2	19	46223	1336777088	/users/cn/jespinosa/phecomp/data/CRG/20120502_FDF_CRG/20120502_FDF_CRG/20120511_FDF_CRG_c12.mtb	2125	NA	WWSS	water	2	46204	1336777069	1	0.04	0.00210526315789474	7649	1
3	Drink 1	Intake 1	24	46497	1336777362	/users/cn/jespinosa/phecomp/data/CRG/20120502_FDF_CRG/20120502_FDF_CRG/20120511_FDF_CRG_c12.mtb	764	NA	WWSS	water	1	46473	1336777338	1	0.04	0.00166666666666667	7650	1
3	Drink 2	Intake 2	15	46500	1336777365	/users/cn/jespinosa/phecomp/data/CRG/20120502_FDF_CRG/20120502_FDF_CRG/20120511_FDF_CRG_c12.mtb	2126	NA	WWSS	water	2	46485	1336777350	1	0.04	0.00266666666666667	7651	1
3	Drink 2	Intake 2	44	46984	1336777849	/users/cn/jespinosa/phecomp/data/CRG/20120502_FDF_CRG/20120502_FDF_CRG/20120511_FDF_CRG_c12.mtb	2132	NA	WWSS	water	2	46940	1336777805	1	0.02	0.000454545454545455	7652	1
3	Drink 1	Intake 1	13	47327	1336778192	/users/cn/jespinosa/phecomp/data/CRG/20120502_FDF_CRG/20120502_FDF_CRG/20120511_FDF_CRG_c12.mtb	766	NA	WWSS	water	1	47314	1336778179	1	0.04	0.00307692307692308	7653	1
3	Food 2	Intake 4	86	47422	1336778287	/users/cn/jespinosa/phecomp/data/CRG/20120502_FDF_CRG/20120502_FDF_CRG/20120511_FDF_CRG_c12.mtb	2468	40	WWSS	food_sc	4	47336	1336778201	1	0.02	0.000232558139534884	7654	1
3	Food 1	Intake 3	293	47755	1336778620	/users/cn/jespinosa/phecomp/data/CRG/20120502_FDF_CRG/20120502_FDF_CRG/20120511_FDF_CRG_c12.mtb	1592	2668	WWSS	food_sc	3	47462	1336778327	1	0.16	0.000546075085324232	7655	1
3	Drink 2	Intake 2	26	47783	1336778648	/users/cn/jespinosa/phecomp/data/CRG/20120502_FDF_CRG/20120502_FDF_CRG/20120511_FDF_CRG_c12.mtb	2138	NA	WWSS	water	2	47757	1336778622	1	0.0800000000000001	0.00307692307692308	7656	1
3	Drink 1	Intake 1	27	47836	1336778701	/users/cn/jespinosa/phecomp/data/CRG/20120502_FDF_CRG/20120502_FDF_CRG/20120511_FDF_CRG_c12.mtb	767	NA	WWSS	water	1	47809	1336778674	1	0.04	0.00148148148148148	7657	1
3	Drink 2	Intake 2	19	48706	1336779571	/users/cn/jespinosa/phecomp/data/CRG/20120502_FDF_CRG/20120502_FDF_CRG/20120511_FDF_CRG_c12.mtb	2140	NA	WWSS	water	2	48687	1336779552	1	0.0399999999999998	0.00210526315789473	7658	1
3	Drink 1	Intake 1	14	50067	1336780932	/users/cn/jespinosa/phecomp/data/CRG/20120502_FDF_CRG/20120502_FDF_CRG/20120511_FDF_CRG_c12.mtb	768	NA	WWSS	water	1	50053	1336780918	1	0.04	0.00285714285714286	7659	1
3	Food 1	Intake 3	369	50792	1336781657	/users/cn/jespinosa/phecomp/data/CRG/20120502_FDF_CRG/20120502_FDF_CRG/20120511_FDF_CRG_c12.mtb	1593	1172	WWSS	food_sc	3	50423	1336781288	1	0.22	0.000596205962059621	7660	1
3	Drink 2	Intake 2	13	50809	1336781674	/users/cn/jespinosa/phecomp/data/CRG/20120502_FDF_CRG/20120502_FDF_CRG/20120511_FDF_CRG_c12.mtb	2142	NA	WWSS	water	2	50796	1336781661	1	0.0600000000000001	0.00461538461538462	7661	1
3	Drink 2	Intake 2	13	51168	1336782033	/users/cn/jespinosa/phecomp/data/CRG/20120502_FDF_CRG/20120502_FDF_CRG/20120511_FDF_CRG_c12.mtb	2143	NA	WWSS	water	2	51155	1336782020	1	0.0600000000000001	0.00461538461538462	7662	1
3	Drink 2	Intake 2	88	51494	1336782359	/users/cn/jespinosa/phecomp/data/CRG/20120502_FDF_CRG/20120502_FDF_CRG/20120511_FDF_CRG_c12.mtb	2144	NA	WWSS	water	2	51406	1336782271	1	0.02	0.000227272727272727	7663	1
3	Food 2	Intake 4	76	52040	1336782905	/users/cn/jespinosa/phecomp/data/CRG/20120502_FDF_CRG/20120502_FDF_CRG/20120511_FDF_CRG_c12.mtb	2473	1425	WWSS	food_sc	4	51964	1336782829	1	0.02	0.000263157894736842	7664	1
3	Drink 2	Intake 2	19	52173	1336783038	/users/cn/jespinosa/phecomp/data/CRG/20120502_FDF_CRG/20120502_FDF_CRG/20120511_FDF_CRG_c12.mtb	2147	NA	WWSS	water	2	52154	1336783019	1	0.0399999999999998	0.00210526315789473	7665	1
3	Drink 2	Intake 2	15	52374	1336783239	/users/cn/jespinosa/phecomp/data/CRG/20120502_FDF_CRG/20120502_FDF_CRG/20120511_FDF_CRG_c12.mtb	2148	NA	WWSS	water	2	52359	1336783224	1	0.04	0.00266666666666667	7666	1
3	Drink 1	Intake 1	42	52714	1336783579	/users/cn/jespinosa/phecomp/data/CRG/20120502_FDF_CRG/20120502_FDF_CRG/20120511_FDF_CRG_c12.mtb	772	NA	WWSS	water	1	52672	1336783537	1	0.02	0.000476190476190476	7667	1
3	Drink 2	Intake 2	28	52774	1336783639	/users/cn/jespinosa/phecomp/data/CRG/20120502_FDF_CRG/20120502_FDF_CRG/20120511_FDF_CRG_c12.mtb	2150	NA	WWSS	water	2	52746	1336783611	1	0.02	0.000714285714285714	7668	1
3	Food 1	Intake 3	85	53550	1336784415	/users/cn/jespinosa/phecomp/data/CRG/20120502_FDF_CRG/20120502_FDF_CRG/20120511_FDF_CRG_c12.mtb	1596	6830	WWSS	food_sc	3	53465	1336784330	1	0.22	0.00258823529411765	7669	1
3	Drink 2	Intake 2	28	53848	1336784713	/users/cn/jespinosa/phecomp/data/CRG/20120502_FDF_CRG/20120502_FDF_CRG/20120511_FDF_CRG_c12.mtb	2153	NA	WWSS	water	2	53820	1336784685	1	0.0800000000000001	0.00285714285714286	7670	1
3	Drink 2	Intake 2	15	54094	1336784959	/users/cn/jespinosa/phecomp/data/CRG/20120502_FDF_CRG/20120502_FDF_CRG/20120511_FDF_CRG_c12.mtb	2154	NA	WWSS	water	2	54079	1336784944	1	0.04	0.00266666666666667	7671	1
3	Drink 2	Intake 2	47	54476	1336785341	/users/cn/jespinosa/phecomp/data/CRG/20120502_FDF_CRG/20120502_FDF_CRG/20120511_FDF_CRG_c12.mtb	2156	NA	WWSS	water	2	54429	1336785294	1	0.04	0.000851063829787234	7672	1
3	Drink 1	Intake 1	18	55076	1336785941	/users/cn/jespinosa/phecomp/data/CRG/20120502_FDF_CRG/20120502_FDF_CRG/20120511_FDF_CRG_c12.mtb	777	NA	WWSS	water	1	55058	1336785923	1	0.02	0.00111111111111111	7673	1
3	Drink 2	Intake 2	29	55094	1336785959	/users/cn/jespinosa/phecomp/data/CRG/20120502_FDF_CRG/20120502_FDF_CRG/20120511_FDF_CRG_c12.mtb	2157	NA	WWSS	water	2	55065	1336785930	1	0.04	0.00137931034482759	7674	1
3	Drink 2	Intake 2	15	56005	1336786870	/users/cn/jespinosa/phecomp/data/CRG/20120502_FDF_CRG/20120502_FDF_CRG/20120511_FDF_CRG_c12.mtb	2159	NA	WWSS	water	2	55990	1336786855	1	0.02	0.00133333333333333	7675	1
3	Drink 2	Intake 2	16	59595	1336790460	/users/cn/jespinosa/phecomp/data/CRG/20120502_FDF_CRG/20120502_FDF_CRG/20120511_FDF_CRG_c12.mtb	2160	NA	WWSS	water	2	59579	1336790444	1	0.04	0.0025	7676	1
3	Food 2	Intake 4	110	60490	1336791355	/users/cn/jespinosa/phecomp/data/CRG/20120502_FDF_CRG/20120502_FDF_CRG/20120511_FDF_CRG_c12.mtb	2489	9	WWSS	food_sc	4	60380	1336791245	1	0.02	0.000181818181818182	7677	1
3	Food 1	Intake 3	71	60570	1336791435	/users/cn/jespinosa/phecomp/data/CRG/20120502_FDF_CRG/20120502_FDF_CRG/20120511_FDF_CRG_c12.mtb	1603	3353	WWSS	food_sc	3	60499	1336791364	1	0.04	0.000563380281690141	7678	1
3	Drink 1	Intake 1	15	60936	1336791801	/users/cn/jespinosa/phecomp/data/CRG/20120502_FDF_CRG/20120502_FDF_CRG/20120511_FDF_CRG_c12.mtb	779	NA	WWSS	water	1	60921	1336791786	1	0.02	0.00133333333333333	7679	1
3	Drink 2	Intake 2	25	61228	1336792093	/users/cn/jespinosa/phecomp/data/CRG/20120502_FDF_CRG/20120502_FDF_CRG/20120511_FDF_CRG_c12.mtb	2161	NA	WWSS	water	2	61203	1336792068	1	0.0399999999999998	0.00159999999999999	7680	1
3	Drink 2	Intake 2	20	61342	1336792207	/users/cn/jespinosa/phecomp/data/CRG/20120502_FDF_CRG/20120502_FDF_CRG/20120511_FDF_CRG_c12.mtb	2162	NA	WWSS	water	2	61322	1336792187	1	0.04	0.002	7681	1
3	Food 2	Intake 4	356	64279	1336795144	/users/cn/jespinosa/phecomp/data/CRG/20120502_FDF_CRG/20120502_FDF_CRG/20120511_FDF_CRG_c12.mtb	2494	25	WWSS	food_sc	4	63923	1336794788	1	0.0600000000000001	0.000168539325842697	7682	1
3	Food 2	Intake 4	103	64407	1336795272	/users/cn/jespinosa/phecomp/data/CRG/20120502_FDF_CRG/20120502_FDF_CRG/20120511_FDF_CRG_c12.mtb	2495	2137	WWSS	food_sc	4	64304	1336795169	1	0.02	0.000194174757281553	7683	1
3	Drink 2	Intake 2	18	64427	1336795292	/users/cn/jespinosa/phecomp/data/CRG/20120502_FDF_CRG/20120502_FDF_CRG/20120511_FDF_CRG_c12.mtb	2163	NA	WWSS	water	2	64409	1336795274	1	0.04	0.00222222222222222	7684	1
3	Drink 1	Intake 1	19	64564	1336795429	/users/cn/jespinosa/phecomp/data/CRG/20120502_FDF_CRG/20120502_FDF_CRG/20120511_FDF_CRG_c12.mtb	781	NA	WWSS	water	1	64545	1336795410	1	0.08	0.00421052631578947	7685	1
3	Food 2	Intake 4	477	67021	1336797886	/users/cn/jespinosa/phecomp/data/CRG/20120502_FDF_CRG/20120502_FDF_CRG/20120511_FDF_CRG_c12.mtb	2498	545	WWSS	food_sc	4	66544	1336797409	1	0.16	0.000335429769392034	7686	1
3	Drink 2	Intake 2	23	67056	1336797921	/users/cn/jespinosa/phecomp/data/CRG/20120502_FDF_CRG/20120502_FDF_CRG/20120511_FDF_CRG_c12.mtb	2164	NA	WWSS	water	2	67033	1336797898	1	0.0599999999999998	0.0026086956521739	7687	1
3	Drink 2	Intake 2	31	67326	1336798191	/users/cn/jespinosa/phecomp/data/CRG/20120502_FDF_CRG/20120502_FDF_CRG/20120511_FDF_CRG_c12.mtb	2165	NA	WWSS	water	2	67295	1336798160	1	0.1	0.0032258064516129	7688	1
3	Food 2	Intake 4	397	67963	1336798828	/users/cn/jespinosa/phecomp/data/CRG/20120502_FDF_CRG/20120502_FDF_CRG/20120511_FDF_CRG_c12.mtb	2503	1969	WWSS	food_sc	4	67566	1336798431	1	0.04	0.000100755667506297	7689	1
3	Drink 2	Intake 2	18	68005	1336798870	/users/cn/jespinosa/phecomp/data/CRG/20120502_FDF_CRG/20120502_FDF_CRG/20120511_FDF_CRG_c12.mtb	2166	NA	WWSS	water	2	67987	1336798852	1	0.0600000000000001	0.00333333333333334	7690	1
3	Drink 1	Intake 1	15	69091	1336799956	/users/cn/jespinosa/phecomp/data/CRG/20120502_FDF_CRG/20120502_FDF_CRG/20120511_FDF_CRG_c12.mtb	782	NA	WWSS	water	1	69076	1336799941	1	0.02	0.00133333333333333	7691	1
3	Food 2	Intake 4	121	70053	1336800918	/users/cn/jespinosa/phecomp/data/CRG/20120502_FDF_CRG/20120502_FDF_CRG/20120511_FDF_CRG_c12.mtb	2507	421	WWSS	food_sc	4	69932	1336800797	1	0.02	0.000165289256198347	7692	1
3	Food 2	Intake 4	403	70877	1336801742	/users/cn/jespinosa/phecomp/data/CRG/20120502_FDF_CRG/20120502_FDF_CRG/20120511_FDF_CRG_c12.mtb	2510	12	WWSS	food_sc	4	70474	1336801339	1	0.12	0.000297766749379653	7693	1
3	Food 2	Intake 4	103	70992	1336801857	/users/cn/jespinosa/phecomp/data/CRG/20120502_FDF_CRG/20120502_FDF_CRG/20120511_FDF_CRG_c12.mtb	2511	640	WWSS	food_sc	4	70889	1336801754	1	0.02	0.000194174757281553	7694	1
3	Drink 2	Intake 2	23	71066	1336801931	/users/cn/jespinosa/phecomp/data/CRG/20120502_FDF_CRG/20120502_FDF_CRG/20120511_FDF_CRG_c12.mtb	2167	NA	WWSS	water	2	71043	1336801908	1	0.0800000000000001	0.00347826086956522	7695	1
3	Drink 2	Intake 2	16	71404	1336802269	/users/cn/jespinosa/phecomp/data/CRG/20120502_FDF_CRG/20120502_FDF_CRG/20120511_FDF_CRG_c12.mtb	2169	NA	WWSS	water	2	71388	1336802253	1	0.02	0.00125	7696	1
3	Food 2	Intake 4	166	71798	1336802663	/users/cn/jespinosa/phecomp/data/CRG/20120502_FDF_CRG/20120502_FDF_CRG/20120511_FDF_CRG_c12.mtb	2516	42141	WWSS	food_sc	4	71632	1336802497	1	0.02	0.000120481927710843	7697	1
3	Drink 1	Intake 1	16	71898	1336802763	/users/cn/jespinosa/phecomp/data/CRG/20120502_FDF_CRG/20120502_FDF_CRG/20120511_FDF_CRG_c12.mtb	785	NA	WWSS	water	1	71882	1336802747	1	0.02	0.00125	7698	1
3	Drink 1	Intake 1	19	72017	1336802882	/users/cn/jespinosa/phecomp/data/CRG/20120502_FDF_CRG/20120502_FDF_CRG/20120511_FDF_CRG_c12.mtb	786	NA	WWSS	water	1	71998	1336802863	1	0.02	0.00105263157894737	7699	1
3	Drink 2	Intake 2	17	83446	1336814311	/users/cn/jespinosa/phecomp/data/CRG/20120502_FDF_CRG/20120502_FDF_CRG/20120511_FDF_CRG_c12.mtb	2174	NA	WWSS	water	2	83429	1336814294	1	0.02	0.00117647058823529	7700	1
3	Food 1	Intake 3	49	113988	1336844853	/users/cn/jespinosa/phecomp/data/CRG/20120502_FDF_CRG/20120502_FDF_CRG/20120511_FDF_CRG_c12.mtb	1623	47	WWSS	food_sc	3	113939	1336844804	1	0.02	0.000408163265306122	7701	1
3	Food 2	Intake 4	938	114973	1336845838	/users/cn/jespinosa/phecomp/data/CRG/20120502_FDF_CRG/20120502_FDF_CRG/20120511_FDF_CRG_c12.mtb	2524	1942	WWSS	food_sc	4	114035	1336844900	1	0.18	0.000191897654584222	7702	1
3	Drink 2	Intake 2	14	114989	1336845854	/users/cn/jespinosa/phecomp/data/CRG/20120502_FDF_CRG/20120502_FDF_CRG/20120511_FDF_CRG_c12.mtb	2177	NA	WWSS	water	2	114975	1336845840	1	0.02	0.00142857142857143	7703	1
3	Drink 1	Intake 1	22	115097	1336845962	/users/cn/jespinosa/phecomp/data/CRG/20120502_FDF_CRG/20120502_FDF_CRG/20120511_FDF_CRG_c12.mtb	789	NA	WWSS	water	1	115075	1336845940	1	0.0599999999999999	0.00272727272727272	7704	1
3	Drink 1	Intake 1	18	115486	1336846351	/users/cn/jespinosa/phecomp/data/CRG/20120502_FDF_CRG/20120502_FDF_CRG/20120511_FDF_CRG_c12.mtb	790	NA	WWSS	water	1	115468	1336846333	1	0.0600000000000001	0.00333333333333334	7705	1
3	Drink 1	Intake 1	17	116421	1336847286	/users/cn/jespinosa/phecomp/data/CRG/20120502_FDF_CRG/20120502_FDF_CRG/20120511_FDF_CRG_c12.mtb	791	NA	WWSS	water	1	116404	1336847269	1	0.0399999999999999	0.00235294117647058	7706	1
3	Food 2	Intake 4	628	117543	1336848408	/users/cn/jespinosa/phecomp/data/CRG/20120502_FDF_CRG/20120502_FDF_CRG/20120511_FDF_CRG_c12.mtb	2528	1467	WWSS	food_sc	4	116915	1336847780	1	0.26	0.000414012738853503	7707	1
3	Drink 1	Intake 1	15	117553	1336848418	/users/cn/jespinosa/phecomp/data/CRG/20120502_FDF_CRG/20120502_FDF_CRG/20120511_FDF_CRG_c12.mtb	792	NA	WWSS	water	1	117538	1336848403	1	0.0600000000000001	0.00400000000000001	7708	1
3	Drink 2	Intake 2	9	117643	1336848508	/users/cn/jespinosa/phecomp/data/CRG/20120502_FDF_CRG/20120502_FDF_CRG/20120511_FDF_CRG_c12.mtb	2179	NA	WWSS	water	2	117634	1336848499	1	0.04	0.00444444444444444	7709	1
3	Drink 2	Intake 2	33	118244	1336849109	/users/cn/jespinosa/phecomp/data/CRG/20120502_FDF_CRG/20120502_FDF_CRG/20120511_FDF_CRG_c12.mtb	2183	NA	WWSS	water	2	118211	1336849076	1	0.02	0.000606060606060606	7710	1
3	Drink 1	Intake 1	14	118973	1336849838	/users/cn/jespinosa/phecomp/data/CRG/20120502_FDF_CRG/20120502_FDF_CRG/20120511_FDF_CRG_c12.mtb	793	NA	WWSS	water	1	118959	1336849824	1	0.02	0.00142857142857143	7711	1
3	Food 2	Intake 4	379	119389	1336850254	/users/cn/jespinosa/phecomp/data/CRG/20120502_FDF_CRG/20120502_FDF_CRG/20120511_FDF_CRG_c12.mtb	2535	1100	WWSS	food_sc	4	119010	1336849875	1	0.16	0.000422163588390501	7712	1
3	Drink 2	Intake 2	20	119401	1336850266	/users/cn/jespinosa/phecomp/data/CRG/20120502_FDF_CRG/20120502_FDF_CRG/20120511_FDF_CRG_c12.mtb	2185	NA	WWSS	water	2	119381	1336850246	1	0.0799999999999996	0.00399999999999998	7713	1
3	Food 2	Intake 4	206	120695	1336851560	/users/cn/jespinosa/phecomp/data/CRG/20120502_FDF_CRG/20120502_FDF_CRG/20120511_FDF_CRG_c12.mtb	2537	676	WWSS	food_sc	4	120489	1336851354	1	0.0599999999999998	0.000291262135922329	7714	1
3	Drink 2	Intake 2	20	120718	1336851583	/users/cn/jespinosa/phecomp/data/CRG/20120502_FDF_CRG/20120502_FDF_CRG/20120511_FDF_CRG_c12.mtb	2187	NA	WWSS	water	2	120698	1336851563	1	0.02	0.001	7715	1
3	Food 1	Intake 3	122	121493	1336852358	/users/cn/jespinosa/phecomp/data/CRG/20120502_FDF_CRG/20120502_FDF_CRG/20120511_FDF_CRG_c12.mtb	1626	88	WWSS	food_sc	3	121371	1336852236	1	0.02	0.000163934426229508	7716	1
3	Drink 2	Intake 2	18	121524	1336852389	/users/cn/jespinosa/phecomp/data/CRG/20120502_FDF_CRG/20120502_FDF_CRG/20120511_FDF_CRG_c12.mtb	2188	NA	WWSS	water	2	121506	1336852371	1	0.0600000000000001	0.00333333333333334	7717	1
3	Food 2	Intake 4	205	121786	1336852651	/users/cn/jespinosa/phecomp/data/CRG/20120502_FDF_CRG/20120502_FDF_CRG/20120511_FDF_CRG_c12.mtb	2541	731	WWSS	food_sc	4	121581	1336852446	1	0.0800000000000001	0.000390243902439025	7718	1
3	Drink 2	Intake 2	12	121800	1336852665	/users/cn/jespinosa/phecomp/data/CRG/20120502_FDF_CRG/20120502_FDF_CRG/20120511_FDF_CRG_c12.mtb	2189	NA	WWSS	water	2	121788	1336852653	1	0.04	0.00333333333333333	7719	1
3	Food 2	Intake 4	180	122697	1336853562	/users/cn/jespinosa/phecomp/data/CRG/20120502_FDF_CRG/20120502_FDF_CRG/20120511_FDF_CRG_c12.mtb	2542	960	WWSS	food_sc	4	122517	1336853382	1	0.0600000000000001	0.000333333333333334	7720	1
3	Drink 2	Intake 2	29	122726	1336853591	/users/cn/jespinosa/phecomp/data/CRG/20120502_FDF_CRG/20120502_FDF_CRG/20120511_FDF_CRG_c12.mtb	2190	NA	WWSS	water	2	122697	1336853562	1	0.04	0.00137931034482759	7721	1
3	Drink 2	Intake 2	49	123331	1336854196	/users/cn/jespinosa/phecomp/data/CRG/20120502_FDF_CRG/20120502_FDF_CRG/20120511_FDF_CRG_c12.mtb	2191	NA	WWSS	water	2	123282	1336854147	1	0.04	0.000816326530612245	7722	1
3	Drink 2	Intake 2	12	123454	1336854319	/users/cn/jespinosa/phecomp/data/CRG/20120502_FDF_CRG/20120502_FDF_CRG/20120511_FDF_CRG_c12.mtb	2194	NA	WWSS	water	2	123442	1336854307	1	0.02	0.00166666666666667	7723	1
3	Food 2	Intake 4	458	124115	1336854980	/users/cn/jespinosa/phecomp/data/CRG/20120502_FDF_CRG/20120502_FDF_CRG/20120511_FDF_CRG_c12.mtb	2547	6	WWSS	food_sc	4	123657	1336854522	1	0.26	0.000567685589519651	7724	1
3	Food 2	Intake 4	24	124145	1336855010	/users/cn/jespinosa/phecomp/data/CRG/20120502_FDF_CRG/20120502_FDF_CRG/20120511_FDF_CRG_c12.mtb	2548	5970	WWSS	food_sc	4	124121	1336854986	1	0.24	0.01	7725	1
3	Drink 2	Intake 2	25	124307	1336855172	/users/cn/jespinosa/phecomp/data/CRG/20120502_FDF_CRG/20120502_FDF_CRG/20120511_FDF_CRG_c12.mtb	2195	NA	WWSS	water	2	124282	1336855147	1	0.0600000000000001	0.0024	7726	1
3	Drink 2	Intake 2	43	124391	1336855256	/users/cn/jespinosa/phecomp/data/CRG/20120502_FDF_CRG/20120502_FDF_CRG/20120511_FDF_CRG_c12.mtb	2196	NA	WWSS	water	2	124348	1336855213	1	0.0600000000000001	0.0013953488372093	7727	1
3	Drink 2	Intake 2	14	124608	1336855473	/users/cn/jespinosa/phecomp/data/CRG/20120502_FDF_CRG/20120502_FDF_CRG/20120511_FDF_CRG_c12.mtb	2198	NA	WWSS	water	2	124594	1336855459	1	0.02	0.00142857142857143	7728	1
3	Drink 2	Intake 2	11	124919	1336855784	/users/cn/jespinosa/phecomp/data/CRG/20120502_FDF_CRG/20120502_FDF_CRG/20120511_FDF_CRG_c12.mtb	2201	NA	WWSS	water	2	124908	1336855773	1	0.02	0.00181818181818182	7729	1
3	Drink 1	Intake 1	12	125603	1336856468	/users/cn/jespinosa/phecomp/data/CRG/20120502_FDF_CRG/20120502_FDF_CRG/20120511_FDF_CRG_c12.mtb	798	NA	WWSS	water	1	125591	1336856456	1	0.0600000000000001	0.00500000000000001	7730	1
3	Drink 2	Intake 2	14	126365	1336857230	/users/cn/jespinosa/phecomp/data/CRG/20120502_FDF_CRG/20120502_FDF_CRG/20120511_FDF_CRG_c12.mtb	2203	NA	WWSS	water	2	126351	1336857216	1	0.0399999999999996	0.00285714285714283	7731	1
3	Food 2	Intake 4	253	130368	1336861233	/users/cn/jespinosa/phecomp/data/CRG/20120502_FDF_CRG/20120502_FDF_CRG/20120511_FDF_CRG_c12.mtb	2559	918	WWSS	food_sc	4	130115	1336860980	1	0.12	0.000474308300395257	7732	1
3	Drink 2	Intake 2	20	130387	1336861252	/users/cn/jespinosa/phecomp/data/CRG/20120502_FDF_CRG/20120502_FDF_CRG/20120511_FDF_CRG_c12.mtb	2205	NA	WWSS	water	2	130367	1336861232	1	0.04	0.002	7733	1
3	Drink 2	Intake 2	40	130482	1336861347	/users/cn/jespinosa/phecomp/data/CRG/20120502_FDF_CRG/20120502_FDF_CRG/20120511_FDF_CRG_c12.mtb	2206	NA	WWSS	water	2	130442	1336861307	1	0.04	0.001	7734	1
3	Drink 2	Intake 2	21	130980	1336861845	/users/cn/jespinosa/phecomp/data/CRG/20120502_FDF_CRG/20120502_FDF_CRG/20120511_FDF_CRG_c12.mtb	2209	NA	WWSS	water	2	130959	1336861824	1	0.0600000000000001	0.00285714285714286	7735	1
3	Food 2	Intake 4	117	131403	1336862268	/users/cn/jespinosa/phecomp/data/CRG/20120502_FDF_CRG/20120502_FDF_CRG/20120511_FDF_CRG_c12.mtb	2568	12	WWSS	food_sc	4	131286	1336862151	1	0.02	0.000170940170940171	7736	1
3	Food 2	Intake 4	240	131655	1336862520	/users/cn/jespinosa/phecomp/data/CRG/20120502_FDF_CRG/20120502_FDF_CRG/20120511_FDF_CRG_c12.mtb	2569	209	WWSS	food_sc	4	131415	1336862280	1	0.0800000000000001	0.000333333333333334	7737	1
3	Drink 2	Intake 2	18	131669	1336862534	/users/cn/jespinosa/phecomp/data/CRG/20120502_FDF_CRG/20120502_FDF_CRG/20120511_FDF_CRG_c12.mtb	2210	NA	WWSS	water	2	131651	1336862516	1	0.0600000000000001	0.00333333333333334	7738	1
3	Drink 2	Intake 2	44	131795	1336862660	/users/cn/jespinosa/phecomp/data/CRG/20120502_FDF_CRG/20120502_FDF_CRG/20120511_FDF_CRG_c12.mtb	2211	NA	WWSS	water	2	131751	1336862616	1	0.1	0.00227272727272727	7739	1
3	Food 2	Intake 4	290	132154	1336863019	/users/cn/jespinosa/phecomp/data/CRG/20120502_FDF_CRG/20120502_FDF_CRG/20120511_FDF_CRG_c12.mtb	2571	1270	WWSS	food_sc	4	131864	1336862729	1	0.0600000000000005	0.00020689655172414	7740	1
3	Drink 2	Intake 2	17	132419	1336863284	/users/cn/jespinosa/phecomp/data/CRG/20120502_FDF_CRG/20120502_FDF_CRG/20120511_FDF_CRG_c12.mtb	2213	NA	WWSS	water	2	132402	1336863267	1	0.04	0.00235294117647059	7741	1
3	Drink 2	Intake 2	40	133160	1336864025	/users/cn/jespinosa/phecomp/data/CRG/20120502_FDF_CRG/20120502_FDF_CRG/20120511_FDF_CRG_c12.mtb	2214	NA	WWSS	water	2	133120	1336863985	1	0.04	0.001	7742	1
3	Food 2	Intake 4	430	133854	1336864719	/users/cn/jespinosa/phecomp/data/CRG/20120502_FDF_CRG/20120502_FDF_CRG/20120511_FDF_CRG_c12.mtb	2576	764	WWSS	food_sc	4	133424	1336864289	1	0.2	0.000465116279069767	7743	1
3	Drink 2	Intake 2	26	133873	1336864738	/users/cn/jespinosa/phecomp/data/CRG/20120502_FDF_CRG/20120502_FDF_CRG/20120511_FDF_CRG_c12.mtb	2215	NA	WWSS	water	2	133847	1336864712	1	0.0800000000000001	0.00307692307692308	7744	1
3	Food 2	Intake 4	269	134887	1336865752	/users/cn/jespinosa/phecomp/data/CRG/20120502_FDF_CRG/20120502_FDF_CRG/20120511_FDF_CRG_c12.mtb	2580	1662	WWSS	food_sc	4	134618	1336865483	1	0.04	0.000148698884758364	7745	1
3	Drink 2	Intake 2	19	134911	1336865776	/users/cn/jespinosa/phecomp/data/CRG/20120502_FDF_CRG/20120502_FDF_CRG/20120511_FDF_CRG_c12.mtb	2216	NA	WWSS	water	2	134892	1336865757	1	0.02	0.00105263157894737	7746	1
3	Drink 1	Intake 1	17	135453	1336866318	/users/cn/jespinosa/phecomp/data/CRG/20120502_FDF_CRG/20120502_FDF_CRG/20120511_FDF_CRG_c12.mtb	803	NA	WWSS	water	1	135436	1336866301	1	0.0599999999999999	0.00352941176470588	7747	1
3	Food 1	Intake 3	553	137102	1336867967	/users/cn/jespinosa/phecomp/data/CRG/20120502_FDF_CRG/20120502_FDF_CRG/20120511_FDF_CRG_c12.mtb	1636	5	WWSS	food_sc	3	136549	1336867414	1	0.2	0.000361663652802893	7748	1
3	Food 1	Intake 3	194	137301	1336868166	/users/cn/jespinosa/phecomp/data/CRG/20120502_FDF_CRG/20120502_FDF_CRG/20120511_FDF_CRG_c12.mtb	1637	159	WWSS	food_sc	3	137107	1336867972	1	0.0800000000000001	0.000412371134020619	7749	1
3	Drink 2	Intake 2	13	137318	1336868183	/users/cn/jespinosa/phecomp/data/CRG/20120502_FDF_CRG/20120502_FDF_CRG/20120511_FDF_CRG_c12.mtb	2221	NA	WWSS	water	2	137305	1336868170	1	0.0599999999999996	0.00461538461538458	7750	1
3	Drink 2	Intake 2	31	137360	1336868225	/users/cn/jespinosa/phecomp/data/CRG/20120502_FDF_CRG/20120502_FDF_CRG/20120511_FDF_CRG_c12.mtb	2222	NA	WWSS	water	2	137329	1336868194	1	0.0200000000000005	0.000645161290322597	7751	1
3	Food 1	Intake 3	49	137509	1336868374	/users/cn/jespinosa/phecomp/data/CRG/20120502_FDF_CRG/20120502_FDF_CRG/20120511_FDF_CRG_c12.mtb	1638	493	WWSS	food_sc	3	137460	1336868325	1	0.02	0.000408163265306122	7752	1
3	Drink 2	Intake 2	27	137718	1336868583	/users/cn/jespinosa/phecomp/data/CRG/20120502_FDF_CRG/20120502_FDF_CRG/20120511_FDF_CRG_c12.mtb	2223	NA	WWSS	water	2	137691	1336868556	1	0.0399999999999996	0.00148148148148147	7753	1
3	Food 1	Intake 3	188	138190	1336869055	/users/cn/jespinosa/phecomp/data/CRG/20120502_FDF_CRG/20120502_FDF_CRG/20120511_FDF_CRG_c12.mtb	1639	849	WWSS	food_sc	3	138002	1336868867	1	0.0600000000000001	0.000319148936170213	7754	1
3	Drink 2	Intake 2	18	138205	1336869070	/users/cn/jespinosa/phecomp/data/CRG/20120502_FDF_CRG/20120502_FDF_CRG/20120511_FDF_CRG_c12.mtb	2225	NA	WWSS	water	2	138187	1336869052	1	0.04	0.00222222222222222	7755	1
3	Drink 1	Intake 1	15	138351	1336869216	/users/cn/jespinosa/phecomp/data/CRG/20120502_FDF_CRG/20120502_FDF_CRG/20120511_FDF_CRG_c12.mtb	806	NA	WWSS	water	1	138336	1336869201	1	0.02	0.00133333333333333	7756	1
3	Food 2	Intake 4	52	139091	1336869956	/users/cn/jespinosa/phecomp/data/CRG/20120502_FDF_CRG/20120502_FDF_CRG/20120511_FDF_CRG_c12.mtb	2589	6443	WWSS	food_sc	4	139039	1336869904	1	0.02	0.000384615384615385	7757	1
3	Food 1	Intake 3	214	145748	1336876613	/users/cn/jespinosa/phecomp/data/CRG/20120502_FDF_CRG/20120502_FDF_CRG/20120511_FDF_CRG_c12.mtb	1644	19	WWSS	food_sc	3	145534	1336876399	1	0.1	0.000467289719626168	7758	1
3	Food 1	Intake 3	149	145916	1336876781	/users/cn/jespinosa/phecomp/data/CRG/20120502_FDF_CRG/20120502_FDF_CRG/20120511_FDF_CRG_c12.mtb	1645	609	WWSS	food_sc	3	145767	1336876632	1	0.0600000000000001	0.00040268456375839	7759	1
3	Drink 2	Intake 2	20	146266	1336877131	/users/cn/jespinosa/phecomp/data/CRG/20120502_FDF_CRG/20120502_FDF_CRG/20120511_FDF_CRG_c12.mtb	2235	NA	WWSS	water	2	146246	1336877111	1	0.0800000000000001	0.00400000000000001	7760	1
3	Drink 2	Intake 2	14	146366	1336877231	/users/cn/jespinosa/phecomp/data/CRG/20120502_FDF_CRG/20120502_FDF_CRG/20120511_FDF_CRG_c12.mtb	2236	NA	WWSS	water	2	146352	1336877217	1	0.02	0.00142857142857143	7761	1
3	Food 1	Intake 3	267	146792	1336877657	/users/cn/jespinosa/phecomp/data/CRG/20120502_FDF_CRG/20120502_FDF_CRG/20120511_FDF_CRG_c12.mtb	1647	2741	WWSS	food_sc	3	146525	1336877390	1	0.1	0.000374531835205993	7762	1
3	Drink 2	Intake 2	14	146817	1336877682	/users/cn/jespinosa/phecomp/data/CRG/20120502_FDF_CRG/20120502_FDF_CRG/20120511_FDF_CRG_c12.mtb	2237	NA	WWSS	water	2	146803	1336877668	1	0.04	0.00285714285714286	7763	1
3	Drink 2	Intake 2	16	146945	1336877810	/users/cn/jespinosa/phecomp/data/CRG/20120502_FDF_CRG/20120502_FDF_CRG/20120511_FDF_CRG_c12.mtb	2238	NA	WWSS	water	2	146929	1336877794	1	0.02	0.00125	7764	1
3	Drink 1	Intake 1	17	147063	1336877928	/users/cn/jespinosa/phecomp/data/CRG/20120502_FDF_CRG/20120502_FDF_CRG/20120511_FDF_CRG_c12.mtb	809	NA	WWSS	water	1	147046	1336877911	1	0.0800000000000001	0.00470588235294118	7765	1
3	Food 1	Intake 3	155	149688	1336880553	/users/cn/jespinosa/phecomp/data/CRG/20120502_FDF_CRG/20120502_FDF_CRG/20120511_FDF_CRG_c12.mtb	1649	619	WWSS	food_sc	3	149533	1336880398	1	0.04	0.000258064516129032	7766	1
3	Drink 2	Intake 2	26	149824	1336880689	/users/cn/jespinosa/phecomp/data/CRG/20120502_FDF_CRG/20120502_FDF_CRG/20120511_FDF_CRG_c12.mtb	2240	NA	WWSS	water	2	149798	1336880663	1	0.02	0.000769230769230769	7767	1
3	Food 2	Intake 4	448	150755	1336881620	/users/cn/jespinosa/phecomp/data/CRG/20120502_FDF_CRG/20120502_FDF_CRG/20120511_FDF_CRG_c12.mtb	2599	109	WWSS	food_sc	4	150307	1336881172	1	0.16	0.000357142857142857	7768	1
3	Drink 2	Intake 2	39	150785	1336881650	/users/cn/jespinosa/phecomp/data/CRG/20120502_FDF_CRG/20120502_FDF_CRG/20120511_FDF_CRG_c12.mtb	2246	NA	WWSS	water	2	150746	1336881611	1	0.0600000000000001	0.00153846153846154	7769	1
3	Drink 2	Intake 2	18	150835	1336881700	/users/cn/jespinosa/phecomp/data/CRG/20120502_FDF_CRG/20120502_FDF_CRG/20120511_FDF_CRG_c12.mtb	2247	NA	WWSS	water	2	150817	1336881682	1	0.04	0.00222222222222222	7770	1
3	Food 2	Intake 4	34	150898	1336881763	/users/cn/jespinosa/phecomp/data/CRG/20120502_FDF_CRG/20120502_FDF_CRG/20120511_FDF_CRG_c12.mtb	2600	182	WWSS	food_sc	4	150864	1336881729	1	0.02	0.000588235294117647	7771	1
3	Food 2	Intake 4	121	151201	1336882066	/users/cn/jespinosa/phecomp/data/CRG/20120502_FDF_CRG/20120502_FDF_CRG/20120511_FDF_CRG_c12.mtb	2602	423	WWSS	food_sc	4	151080	1336881945	1	0.02	0.000165289256198347	7772	1
3	Drink 2	Intake 2	41	151236	1336882101	/users/cn/jespinosa/phecomp/data/CRG/20120502_FDF_CRG/20120502_FDF_CRG/20120511_FDF_CRG_c12.mtb	2249	NA	WWSS	water	2	151195	1336882060	1	0.0600000000000001	0.00146341463414634	7773	1
3	Food 2	Intake 4	126	151750	1336882615	/users/cn/jespinosa/phecomp/data/CRG/20120502_FDF_CRG/20120502_FDF_CRG/20120511_FDF_CRG_c12.mtb	2603	3365	WWSS	food_sc	4	151624	1336882489	1	0.0599999999999996	0.000476190476190473	7774	1
3	Drink 2	Intake 2	21	151763	1336882628	/users/cn/jespinosa/phecomp/data/CRG/20120502_FDF_CRG/20120502_FDF_CRG/20120511_FDF_CRG_c12.mtb	2251	NA	WWSS	water	2	151742	1336882607	1	0.04	0.0019047619047619	7775	1
3	Drink 2	Intake 2	31	152138	1336883003	/users/cn/jespinosa/phecomp/data/CRG/20120502_FDF_CRG/20120502_FDF_CRG/20120511_FDF_CRG_c12.mtb	2252	NA	WWSS	water	2	152107	1336882972	1	0.0600000000000001	0.00193548387096775	7776	1
3	Drink 1	Intake 1	16	154442	1336885307	/users/cn/jespinosa/phecomp/data/CRG/20120502_FDF_CRG/20120502_FDF_CRG/20120511_FDF_CRG_c12.mtb	811	NA	WWSS	water	1	154426	1336885291	1	0.02	0.00125	7777	1
3	Food 1	Intake 3	117	155232	1336886097	/users/cn/jespinosa/phecomp/data/CRG/20120502_FDF_CRG/20120502_FDF_CRG/20120511_FDF_CRG_c12.mtb	1652	9	WWSS	food_sc	3	155115	1336885980	1	0.04	0.000341880341880342	7778	1
3	Food 1	Intake 3	160	155401	1336886266	/users/cn/jespinosa/phecomp/data/CRG/20120502_FDF_CRG/20120502_FDF_CRG/20120511_FDF_CRG_c12.mtb	1653	579	WWSS	food_sc	3	155241	1336886106	1	0.04	0.00025	7779	1
3	Drink 2	Intake 2	22	155623	1336886488	/users/cn/jespinosa/phecomp/data/CRG/20120502_FDF_CRG/20120502_FDF_CRG/20120511_FDF_CRG_c12.mtb	2256	NA	WWSS	water	2	155601	1336886466	1	0.02	0.000909090909090909	7780	1
3	Food 1	Intake 3	63	156043	1336886908	/users/cn/jespinosa/phecomp/data/CRG/20120502_FDF_CRG/20120502_FDF_CRG/20120511_FDF_CRG_c12.mtb	1656	198	WWSS	food_sc	3	155980	1336886845	1	0.02	0.000317460317460317	7781	1
3	Food 1	Intake 3	321	156562	1336887427	/users/cn/jespinosa/phecomp/data/CRG/20120502_FDF_CRG/20120502_FDF_CRG/20120511_FDF_CRG_c12.mtb	1657	1401	WWSS	food_sc	3	156241	1336887106	1	0.14	0.00043613707165109	7782	1
3	Drink 2	Intake 2	29	156588	1336887453	/users/cn/jespinosa/phecomp/data/CRG/20120502_FDF_CRG/20120502_FDF_CRG/20120511_FDF_CRG_c12.mtb	2260	NA	WWSS	water	2	156559	1336887424	1	0.1	0.00344827586206897	7783	1
3	Drink 2	Intake 2	17	156803	1336887668	/users/cn/jespinosa/phecomp/data/CRG/20120502_FDF_CRG/20120502_FDF_CRG/20120511_FDF_CRG_c12.mtb	2261	NA	WWSS	water	2	156786	1336887651	1	0.02	0.00117647058823529	7784	1
3	Drink 2	Intake 2	22	157614	1336888479	/users/cn/jespinosa/phecomp/data/CRG/20120502_FDF_CRG/20120502_FDF_CRG/20120511_FDF_CRG_c12.mtb	2264	NA	WWSS	water	2	157592	1336888457	1	0.0800000000000001	0.00363636363636364	7785	1
3	Food 1	Intake 3	71	158034	1336888899	/users/cn/jespinosa/phecomp/data/CRG/20120502_FDF_CRG/20120502_FDF_CRG/20120511_FDF_CRG_c12.mtb	1663	COLL	WWSS	food_sc	3	157963	1336888828	1	0.02	0.00028169014084507	7786	1
3	Food 2	Intake 4	386	158412	1336889277	/users/cn/jespinosa/phecomp/data/CRG/20120502_FDF_CRG/20120502_FDF_CRG/20120511_FDF_CRG_c12.mtb	2616	9	WWSS	food_sc	4	158026	1336888891	1	0.22	0.000569948186528497	7787	1
3	Food 2	Intake 4	98	158519	1336889384	/users/cn/jespinosa/phecomp/data/CRG/20120502_FDF_CRG/20120502_FDF_CRG/20120511_FDF_CRG_c12.mtb	2617	7649	WWSS	food_sc	4	158421	1336889286	1	0.04	0.000408163265306122	7788	1
3	Drink 2	Intake 2	28	158541	1336889406	/users/cn/jespinosa/phecomp/data/CRG/20120502_FDF_CRG/20120502_FDF_CRG/20120511_FDF_CRG_c12.mtb	2265	NA	WWSS	water	2	158513	1336889378	1	0.0599999999999996	0.00214285714285713	7789	1
3	Drink 2	Intake 2	25	158604	1336889469	/users/cn/jespinosa/phecomp/data/CRG/20120502_FDF_CRG/20120502_FDF_CRG/20120511_FDF_CRG_c12.mtb	2266	NA	WWSS	water	2	158579	1336889444	1	0.100000000000001	0.00400000000000004	7790	1
3	Food 2	Intake 4	118	166286	1336897151	/users/cn/jespinosa/phecomp/data/CRG/20120502_FDF_CRG/20120502_FDF_CRG/20120511_FDF_CRG_c12.mtb	2621	13272	WWSS	food_sc	4	166168	1336897033	1	0.02	0.000169491525423729	7791	1
3	Food 2	Intake 4	152	179710	1336910575	/users/cn/jespinosa/phecomp/data/CRG/20120502_FDF_CRG/20120502_FDF_CRG/20120511_FDF_CRG_c12.mtb	2624	20934	WWSS	food_sc	4	179558	1336910423	1	0.04	0.000263157894736842	7792	1
3	Food 1	Intake 3	383	201027	1336931892	/users/cn/jespinosa/phecomp/data/CRG/20120502_FDF_CRG/20120502_FDF_CRG/20120511_FDF_CRG_c12.mtb	1669	1327	WWSS	food_sc	3	200644	1336931509	1	0.1	0.000261096605744125	7793	1
3	Food 2	Intake 4	20	202374	1336933239	/users/cn/jespinosa/phecomp/data/CRG/20120502_FDF_CRG/20120502_FDF_CRG/20120511_FDF_CRG_c12.mtb	2627	COLL	WWSS	food_sc	4	202354	1336933219	1	0.02	0.001	7794	1
3	Food 1	Intake 3	234	202607	1336933472	/users/cn/jespinosa/phecomp/data/CRG/20120502_FDF_CRG/20120502_FDF_CRG/20120511_FDF_CRG_c12.mtb	1671	60	WWSS	food_sc	3	202373	1336933238	1	0.02	8.54700854700855e-05	7795	1
3	Drink 1	Intake 1	20	202640	1336933505	/users/cn/jespinosa/phecomp/data/CRG/20120502_FDF_CRG/20120502_FDF_CRG/20120511_FDF_CRG_c12.mtb	821	NA	WWSS	water	1	202620	1336933485	1	0.04	0.002	7796	1
3	Food 2	Intake 4	427	203094	1336933959	/users/cn/jespinosa/phecomp/data/CRG/20120502_FDF_CRG/20120502_FDF_CRG/20120511_FDF_CRG_c12.mtb	2628	905	WWSS	food_sc	4	202667	1336933532	1	0.14	0.000327868852459016	7797	1
3	Drink 2	Intake 2	17	203172	1336934037	/users/cn/jespinosa/phecomp/data/CRG/20120502_FDF_CRG/20120502_FDF_CRG/20120511_FDF_CRG_c12.mtb	2276	NA	WWSS	water	2	203155	1336934020	1	0.0200000000000005	0.00117647058823532	7798	1
3	Drink 1	Intake 1	25	203326	1336934191	/users/cn/jespinosa/phecomp/data/CRG/20120502_FDF_CRG/20120502_FDF_CRG/20120511_FDF_CRG_c12.mtb	823	NA	WWSS	water	1	203301	1336934166	1	0.0599999999999998	0.00239999999999999	7799	1
3	Drink 2	Intake 2	17	203965	1336934830	/users/cn/jespinosa/phecomp/data/CRG/20120502_FDF_CRG/20120502_FDF_CRG/20120511_FDF_CRG_c12.mtb	2278	NA	WWSS	water	2	203948	1336934813	1	0.04	0.00235294117647059	7800	1
3	Food 2	Intake 4	312	204311	1336935176	/users/cn/jespinosa/phecomp/data/CRG/20120502_FDF_CRG/20120502_FDF_CRG/20120511_FDF_CRG_c12.mtb	2630	1217	WWSS	food_sc	4	203999	1336934864	1	0.14	0.000448717948717949	7801	1
3	Drink 1	Intake 1	12	204415	1336935280	/users/cn/jespinosa/phecomp/data/CRG/20120502_FDF_CRG/20120502_FDF_CRG/20120511_FDF_CRG_c12.mtb	824	NA	WWSS	water	1	204403	1336935268	1	0.04	0.00333333333333333	7802	1
3	Drink 1	Intake 1	16	205517	1336936382	/users/cn/jespinosa/phecomp/data/CRG/20120502_FDF_CRG/20120502_FDF_CRG/20120511_FDF_CRG_c12.mtb	825	NA	WWSS	water	1	205501	1336936366	1	0.02	0.00125	7803	1
3	Food 2	Intake 4	227	205755	1336936620	/users/cn/jespinosa/phecomp/data/CRG/20120502_FDF_CRG/20120502_FDF_CRG/20120511_FDF_CRG_c12.mtb	2632	788	WWSS	food_sc	4	205528	1336936393	1	0.0800000000000001	0.000352422907488987	7804	1
3	Drink 2	Intake 2	66	205928	1336936793	/users/cn/jespinosa/phecomp/data/CRG/20120502_FDF_CRG/20120502_FDF_CRG/20120511_FDF_CRG_c12.mtb	2280	NA	WWSS	water	2	205862	1336936727	1	0.0200000000000005	0.000303030303030311	7805	1
3	Food 2	Intake 4	96	206639	1336937504	/users/cn/jespinosa/phecomp/data/CRG/20120502_FDF_CRG/20120502_FDF_CRG/20120511_FDF_CRG_c12.mtb	2633	4	WWSS	food_sc	4	206543	1336937408	1	0.0599999999999996	0.000624999999999996	7806	1
3	Food 2	Intake 4	137	206780	1336937645	/users/cn/jespinosa/phecomp/data/CRG/20120502_FDF_CRG/20120502_FDF_CRG/20120511_FDF_CRG_c12.mtb	2634	1176	WWSS	food_sc	4	206643	1336937508	1	0.0600000000000005	0.000437956204379566	7807	1
3	Drink 2	Intake 2	25	206801	1336937666	/users/cn/jespinosa/phecomp/data/CRG/20120502_FDF_CRG/20120502_FDF_CRG/20120511_FDF_CRG_c12.mtb	2285	NA	WWSS	water	2	206776	1336937641	1	0.04	0.0016	7808	1
3	Drink 2	Intake 2	17	207032	1336937897	/users/cn/jespinosa/phecomp/data/CRG/20120502_FDF_CRG/20120502_FDF_CRG/20120511_FDF_CRG_c12.mtb	2286	NA	WWSS	water	2	207015	1336937880	1	0.0200000000000005	0.00117647058823532	7809	1
3	Food 2	Intake 4	395	208351	1336939216	/users/cn/jespinosa/phecomp/data/CRG/20120502_FDF_CRG/20120502_FDF_CRG/20120511_FDF_CRG_c12.mtb	2635	228	WWSS	food_sc	4	207956	1336938821	1	0.44	0.00111392405063291	7810	1
3	Drink 2	Intake 2	29	208493	1336939358	/users/cn/jespinosa/phecomp/data/CRG/20120502_FDF_CRG/20120502_FDF_CRG/20120511_FDF_CRG_c12.mtb	2288	NA	WWSS	water	2	208464	1336939329	1	0.0800000000000001	0.00275862068965518	7811	1
3	Food 1	Intake 3	71	208650	1336939515	/users/cn/jespinosa/phecomp/data/CRG/20120502_FDF_CRG/20120502_FDF_CRG/20120511_FDF_CRG_c12.mtb	1673	5478	WWSS	food_sc	3	208579	1336939444	1	0.02	0.00028169014084507	7812	1
3	Drink 1	Intake 1	20	208999	1336939864	/users/cn/jespinosa/phecomp/data/CRG/20120502_FDF_CRG/20120502_FDF_CRG/20120511_FDF_CRG_c12.mtb	826	NA	WWSS	water	1	208979	1336939844	1	0.0600000000000001	0.00300000000000001	7813	1
3	Drink 2	Intake 2	22	209999	1336940864	/users/cn/jespinosa/phecomp/data/CRG/20120502_FDF_CRG/20120502_FDF_CRG/20120511_FDF_CRG_c12.mtb	2291	NA	WWSS	water	2	209977	1336940842	1	0.0800000000000001	0.00363636363636364	7814	1
3	Drink 1	Intake 1	15	211450	1336942315	/users/cn/jespinosa/phecomp/data/CRG/20120502_FDF_CRG/20120502_FDF_CRG/20120511_FDF_CRG_c12.mtb	827	NA	WWSS	water	1	211435	1336942300	1	0.04	0.00266666666666667	7815	1
3	Food 1	Intake 3	385	214513	1336945378	/users/cn/jespinosa/phecomp/data/CRG/20120502_FDF_CRG/20120502_FDF_CRG/20120511_FDF_CRG_c12.mtb	1680	231	WWSS	food_sc	3	214128	1336944993	1	0.0800000000000001	0.000207792207792208	7816	1
3	Food 1	Intake 3	369	215113	1336945978	/users/cn/jespinosa/phecomp/data/CRG/20120502_FDF_CRG/20120502_FDF_CRG/20120511_FDF_CRG_c12.mtb	1683	543	WWSS	food_sc	3	214744	1336945609	1	0.16	0.00043360433604336	7817	1
3	Drink 2	Intake 2	23	215143	1336946008	/users/cn/jespinosa/phecomp/data/CRG/20120502_FDF_CRG/20120502_FDF_CRG/20120511_FDF_CRG_c12.mtb	2295	NA	WWSS	water	2	215120	1336945985	1	0.12	0.00521739130434783	7818	1
3	Drink 2	Intake 2	20	215266	1336946131	/users/cn/jespinosa/phecomp/data/CRG/20120502_FDF_CRG/20120502_FDF_CRG/20120511_FDF_CRG_c12.mtb	2297	NA	WWSS	water	2	215246	1336946111	1	0.0200000000000005	0.00100000000000002	7819	1
3	Drink 1	Intake 1	20	215288	1336946153	/users/cn/jespinosa/phecomp/data/CRG/20120502_FDF_CRG/20120502_FDF_CRG/20120511_FDF_CRG_c12.mtb	830	NA	WWSS	water	1	215268	1336946133	1	0.02	0.001	7820	1
3	Drink 2	Intake 2	14	215446	1336946311	/users/cn/jespinosa/phecomp/data/CRG/20120502_FDF_CRG/20120502_FDF_CRG/20120511_FDF_CRG_c12.mtb	2298	NA	WWSS	water	2	215432	1336946297	1	0.04	0.00285714285714286	7821	1
3	Food 1	Intake 3	167	215823	1336946688	/users/cn/jespinosa/phecomp/data/CRG/20120502_FDF_CRG/20120502_FDF_CRG/20120511_FDF_CRG_c12.mtb	1686	1524	WWSS	food_sc	3	215656	1336946521	1	0.04	0.000239520958083832	7822	1
3	Drink 2	Intake 2	15	216427	1336947292	/users/cn/jespinosa/phecomp/data/CRG/20120502_FDF_CRG/20120502_FDF_CRG/20120511_FDF_CRG_c12.mtb	2299	NA	WWSS	water	2	216412	1336947277	1	0.04	0.00266666666666667	7823	1
3	Food 1	Intake 3	64	217411	1336948276	/users/cn/jespinosa/phecomp/data/CRG/20120502_FDF_CRG/20120502_FDF_CRG/20120511_FDF_CRG_c12.mtb	1690	344	WWSS	food_sc	3	217347	1336948212	1	0.02	0.0003125	7824	1
3	Food 2	Intake 4	289	218044	1336948909	/users/cn/jespinosa/phecomp/data/CRG/20120502_FDF_CRG/20120502_FDF_CRG/20120511_FDF_CRG_c12.mtb	2656	1753	WWSS	food_sc	4	217755	1336948620	1	0.04	0.00013840830449827	7825	1
3	Drink 2	Intake 2	18	218347	1336949212	/users/cn/jespinosa/phecomp/data/CRG/20120502_FDF_CRG/20120502_FDF_CRG/20120511_FDF_CRG_c12.mtb	2302	NA	WWSS	water	2	218329	1336949194	1	0.0200000000000005	0.00111111111111114	7826	1
3	Food 1	Intake 3	799	220596	1336951461	/users/cn/jespinosa/phecomp/data/CRG/20120502_FDF_CRG/20120502_FDF_CRG/20120511_FDF_CRG_c12.mtb	1695	855	WWSS	food_sc	3	219797	1336950662	1	0.3	0.000375469336670839	7827	1
3	Drink 1	Intake 1	21	220609	1336951474	/users/cn/jespinosa/phecomp/data/CRG/20120502_FDF_CRG/20120502_FDF_CRG/20120511_FDF_CRG_c12.mtb	834	NA	WWSS	water	1	220588	1336951453	1	0.04	0.0019047619047619	7828	1
3	Drink 1	Intake 1	18	220653	1336951518	/users/cn/jespinosa/phecomp/data/CRG/20120502_FDF_CRG/20120502_FDF_CRG/20120511_FDF_CRG_c12.mtb	835	NA	WWSS	water	1	220635	1336951500	1	0.0800000000000001	0.00444444444444445	7829	1
3	Drink 2	Intake 2	17	220705	1336951570	/users/cn/jespinosa/phecomp/data/CRG/20120502_FDF_CRG/20120502_FDF_CRG/20120511_FDF_CRG_c12.mtb	2304	NA	WWSS	water	2	220688	1336951553	1	0.0599999999999996	0.00352941176470586	7830	1
3	Food 1	Intake 3	255	221706	1336952571	/users/cn/jespinosa/phecomp/data/CRG/20120502_FDF_CRG/20120502_FDF_CRG/20120511_FDF_CRG_c12.mtb	1696	2709	WWSS	food_sc	3	221451	1336952316	1	0.18	0.000705882352941176	7831	1
3	Drink 1	Intake 1	17	221726	1336952591	/users/cn/jespinosa/phecomp/data/CRG/20120502_FDF_CRG/20120502_FDF_CRG/20120511_FDF_CRG_c12.mtb	836	NA	WWSS	water	1	221709	1336952574	1	0.04	0.00235294117647059	7832	1
3	Drink 2	Intake 2	19	222068	1336952933	/users/cn/jespinosa/phecomp/data/CRG/20120502_FDF_CRG/20120502_FDF_CRG/20120511_FDF_CRG_c12.mtb	2307	NA	WWSS	water	2	222049	1336952914	1	0.0400000000000009	0.00210526315789478	7833	1
3	Food 1	Intake 3	191	224606	1336955471	/users/cn/jespinosa/phecomp/data/CRG/20120502_FDF_CRG/20120502_FDF_CRG/20120511_FDF_CRG_c12.mtb	1698	1503	WWSS	food_sc	3	224415	1336955280	1	0.32	0.00167539267015707	7834	1
3	Drink 1	Intake 1	22	224811	1336955676	/users/cn/jespinosa/phecomp/data/CRG/20120502_FDF_CRG/20120502_FDF_CRG/20120511_FDF_CRG_c12.mtb	837	NA	WWSS	water	1	224789	1336955654	1	0.04	0.00181818181818182	7835	1
3	Drink 1	Intake 1	18	224985	1336955850	/users/cn/jespinosa/phecomp/data/CRG/20120502_FDF_CRG/20120502_FDF_CRG/20120511_FDF_CRG_c12.mtb	838	NA	WWSS	water	1	224967	1336955832	1	0.02	0.00111111111111111	7836	1
3	Drink 2	Intake 2	16	225183	1336956048	/users/cn/jespinosa/phecomp/data/CRG/20120502_FDF_CRG/20120502_FDF_CRG/20120511_FDF_CRG_c12.mtb	2312	NA	WWSS	water	2	225167	1336956032	1	0.04	0.0025	7837	1
3	Drink 2	Intake 2	22	225501	1336956366	/users/cn/jespinosa/phecomp/data/CRG/20120502_FDF_CRG/20120502_FDF_CRG/20120511_FDF_CRG_c12.mtb	2313	NA	WWSS	water	2	225479	1336956344	1	0.0200000000000005	0.000909090909090932	7838	1
3	Drink 2	Intake 2	18	225750	1336956615	/users/cn/jespinosa/phecomp/data/CRG/20120502_FDF_CRG/20120502_FDF_CRG/20120511_FDF_CRG_c12.mtb	2314	NA	WWSS	water	2	225732	1336956597	1	0.0599999999999996	0.00333333333333331	7839	1
3	Drink 2	Intake 2	17	225898	1336956763	/users/cn/jespinosa/phecomp/data/CRG/20120502_FDF_CRG/20120502_FDF_CRG/20120511_FDF_CRG_c12.mtb	2315	NA	WWSS	water	2	225881	1336956746	1	0.04	0.00235294117647059	7840	1
3	Food 1	Intake 3	94	226203	1336957068	/users/cn/jespinosa/phecomp/data/CRG/20120502_FDF_CRG/20120502_FDF_CRG/20120511_FDF_CRG_c12.mtb	1700	9009	WWSS	food_sc	3	226109	1336956974	1	0.02	0.000212765957446809	7841	1
3	Drink 1	Intake 1	17	226516	1336957381	/users/cn/jespinosa/phecomp/data/CRG/20120502_FDF_CRG/20120502_FDF_CRG/20120511_FDF_CRG_c12.mtb	841	NA	WWSS	water	1	226499	1336957364	1	0.04	0.00235294117647059	7842	1
3	Food 2	Intake 4	652	235864	1336966729	/users/cn/jespinosa/phecomp/data/CRG/20120502_FDF_CRG/20120502_FDF_CRG/20120511_FDF_CRG_c12.mtb	2679	4	WWSS	food_sc	4	235212	1336966077	1	0.16	0.000245398773006135	7843	1
3	Food 2	Intake 4	122	235990	1336966855	/users/cn/jespinosa/phecomp/data/CRG/20120502_FDF_CRG/20120502_FDF_CRG/20120511_FDF_CRG_c12.mtb	2680	200	WWSS	food_sc	4	235868	1336966733	1	0.0800000000000001	0.000655737704918034	7844	1
3	Drink 2	Intake 2	18	236008	1336966873	/users/cn/jespinosa/phecomp/data/CRG/20120502_FDF_CRG/20120502_FDF_CRG/20120511_FDF_CRG_c12.mtb	2321	NA	WWSS	water	2	235990	1336966855	1	0.12	0.00666666666666667	7845	1
3	Drink 2	Intake 2	20	236047	1336966912	/users/cn/jespinosa/phecomp/data/CRG/20120502_FDF_CRG/20120502_FDF_CRG/20120511_FDF_CRG_c12.mtb	2322	NA	WWSS	water	2	236027	1336966892	1	0.0600000000000005	0.00300000000000002	7846	1
3	Food 2	Intake 4	141	236331	1336967196	/users/cn/jespinosa/phecomp/data/CRG/20120502_FDF_CRG/20120502_FDF_CRG/20120511_FDF_CRG_c12.mtb	2682	4208	WWSS	food_sc	4	236190	1336967055	1	0.04	0.000283687943262411	7847	1
3	Drink 1	Intake 1	18	236342	1336967207	/users/cn/jespinosa/phecomp/data/CRG/20120502_FDF_CRG/20120502_FDF_CRG/20120511_FDF_CRG_c12.mtb	844	NA	WWSS	water	1	236324	1336967189	1	0.02	0.00111111111111111	7848	1
3	Drink 2	Intake 2	18	236386	1336967251	/users/cn/jespinosa/phecomp/data/CRG/20120502_FDF_CRG/20120502_FDF_CRG/20120511_FDF_CRG_c12.mtb	2323	NA	WWSS	water	2	236368	1336967233	1	0.0599999999999996	0.00333333333333331	7849	1
3	Drink 2	Intake 2	15	236656	1336967521	/users/cn/jespinosa/phecomp/data/CRG/20120502_FDF_CRG/20120502_FDF_CRG/20120511_FDF_CRG_c12.mtb	2324	NA	WWSS	water	2	236641	1336967506	1	0.0200000000000005	0.00133333333333337	7850	1
3	Food 1	Intake 3	449	240988	1336971853	/users/cn/jespinosa/phecomp/data/CRG/20120502_FDF_CRG/20120502_FDF_CRG/20120511_FDF_CRG_c12.mtb	1706	1127	WWSS	food_sc	3	240539	1336971404	1	0.1	0.00022271714922049	7851	1
3	Drink 2	Intake 2	27	241043	1336971908	/users/cn/jespinosa/phecomp/data/CRG/20120502_FDF_CRG/20120502_FDF_CRG/20120511_FDF_CRG_c12.mtb	2326	NA	WWSS	water	2	241016	1336971881	1	0.04	0.00148148148148148	7852	1
3	Drink 2	Intake 2	19	241713	1336972578	/users/cn/jespinosa/phecomp/data/CRG/20120502_FDF_CRG/20120502_FDF_CRG/20120511_FDF_CRG_c12.mtb	2328	NA	WWSS	water	2	241694	1336972559	1	0.0399999999999991	0.00210526315789469	7853	1
3	Food 2	Intake 4	215	242330	1336973195	/users/cn/jespinosa/phecomp/data/CRG/20120502_FDF_CRG/20120502_FDF_CRG/20120511_FDF_CRG_c12.mtb	2697	33	WWSS	food_sc	4	242115	1336972980	1	0.12	0.000558139534883721	7854	1
3	Food 2	Intake 4	268	242631	1336973496	/users/cn/jespinosa/phecomp/data/CRG/20120502_FDF_CRG/20120502_FDF_CRG/20120511_FDF_CRG_c12.mtb	2698	279	WWSS	food_sc	4	242363	1336973228	1	0.0800000000000001	0.000298507462686568	7855	1
3	Drink 1	Intake 1	23	242652	1336973517	/users/cn/jespinosa/phecomp/data/CRG/20120502_FDF_CRG/20120502_FDF_CRG/20120511_FDF_CRG_c12.mtb	847	NA	WWSS	water	1	242629	1336973494	1	0.0799999999999998	0.00347826086956521	7856	1
3	Drink 2	Intake 2	16	242694	1336973559	/users/cn/jespinosa/phecomp/data/CRG/20120502_FDF_CRG/20120502_FDF_CRG/20120511_FDF_CRG_c12.mtb	2329	NA	WWSS	water	2	242678	1336973543	1	0.0400000000000009	0.00250000000000006	7857	1
3	Food 2	Intake 4	163	243073	1336973938	/users/cn/jespinosa/phecomp/data/CRG/20120502_FDF_CRG/20120502_FDF_CRG/20120511_FDF_CRG_c12.mtb	2700	439	WWSS	food_sc	4	242910	1336973775	1	0.0200000000000005	0.000122699386503071	7858	1
3	Drink 2	Intake 2	15	243187	1336974052	/users/cn/jespinosa/phecomp/data/CRG/20120502_FDF_CRG/20120502_FDF_CRG/20120511_FDF_CRG_c12.mtb	2332	NA	WWSS	water	2	243172	1336974037	1	0.0200000000000005	0.00133333333333337	7859	1
3	Food 2	Intake 4	225	243737	1336974602	/users/cn/jespinosa/phecomp/data/CRG/20120502_FDF_CRG/20120502_FDF_CRG/20120511_FDF_CRG_c12.mtb	2702	18358	WWSS	food_sc	4	243512	1336974377	1	0.04	0.000177777777777778	7860	1
3	Drink 2	Intake 2	47	248634	1336979499	/users/cn/jespinosa/phecomp/data/CRG/20120502_FDF_CRG/20120502_FDF_CRG/20120511_FDF_CRG_c12.mtb	2334	NA	WWSS	water	2	248587	1336979452	1	0.0200000000000005	0.000425531914893628	7861	1
3	Food 1	Intake 3	448	1235	1336993408	/users/cn/jespinosa/phecomp/data/CRG/20120502_FDF_CRG/20120502_FDF_CRG/20120514_FDF_CRG_c12.mtb	1845	6261	WWSS	food_sc	3	787	1336992960	1	0.18	0.000401785714285714	7862	1
3	Drink 1	Intake 1	10	1279	1336993452	/users/cn/jespinosa/phecomp/data/CRG/20120502_FDF_CRG/20120502_FDF_CRG/20120514_FDF_CRG_c12.mtb	937	NA	WWSS	water	1	1269	1336993442	1	0.04	0.004	7863	1
3	Drink 1	Intake 1	12	1466	1336993639	/users/cn/jespinosa/phecomp/data/CRG/20120502_FDF_CRG/20120502_FDF_CRG/20120514_FDF_CRG_c12.mtb	938	NA	WWSS	water	1	1454	1336993627	1	0.04	0.00333333333333333	7864	1
3	Food 1	Intake 3	325	7821	1336999994	/users/cn/jespinosa/phecomp/data/CRG/20120502_FDF_CRG/20120502_FDF_CRG/20120514_FDF_CRG_c12.mtb	1847	6527	WWSS	food_sc	3	7496	1336999669	1	0.12	0.000369230769230769	7865	1
3	Drink 2	Intake 2	10	7928	1337000101	/users/cn/jespinosa/phecomp/data/CRG/20120502_FDF_CRG/20120502_FDF_CRG/20120514_FDF_CRG_c12.mtb	2424	NA	WWSS	water	2	7918	1337000091	1	0.02	0.002	7866	1
3	Drink 1	Intake 1	13	7947	1337000120	/users/cn/jespinosa/phecomp/data/CRG/20120502_FDF_CRG/20120502_FDF_CRG/20120514_FDF_CRG_c12.mtb	939	NA	WWSS	water	1	7934	1337000107	1	0.06	0.00461538461538461	7867	1
3	Drink 1	Intake 1	17	8293	1337000466	/users/cn/jespinosa/phecomp/data/CRG/20120502_FDF_CRG/20120502_FDF_CRG/20120514_FDF_CRG_c12.mtb	940	NA	WWSS	water	1	8276	1337000449	1	0.04	0.00235294117647059	7868	1
3	Food 1	Intake 3	19	14367	1337006540	/users/cn/jespinosa/phecomp/data/CRG/20120502_FDF_CRG/20120502_FDF_CRG/20120514_FDF_CRG_c12.mtb	1851	9204	WWSS	food_sc	3	14348	1337006521	1	0.02	0.00105263157894737	7869	1
3	Food 1	Intake 3	533	24104	1337016277	/users/cn/jespinosa/phecomp/data/CRG/20120502_FDF_CRG/20120502_FDF_CRG/20120514_FDF_CRG_c12.mtb	1853	2957	WWSS	food_sc	3	23571	1337015744	1	0.14	0.000262664165103189	7870	1
3	Drink 1	Intake 1	17	24433	1337016606	/users/cn/jespinosa/phecomp/data/CRG/20120502_FDF_CRG/20120502_FDF_CRG/20120514_FDF_CRG_c12.mtb	941	NA	WWSS	water	1	24416	1337016589	1	0.04	0.00235294117647059	7871	1
3	Drink 1	Intake 1	15	25295	1337017468	/users/cn/jespinosa/phecomp/data/CRG/20120502_FDF_CRG/20120502_FDF_CRG/20120514_FDF_CRG_c12.mtb	942	NA	WWSS	water	1	25280	1337017453	1	0.04	0.00266666666666667	7872	1
3	Food 1	Intake 3	459	27520	1337019693	/users/cn/jespinosa/phecomp/data/CRG/20120502_FDF_CRG/20120502_FDF_CRG/20120514_FDF_CRG_c12.mtb	1855	28	WWSS	food_sc	3	27061	1337019234	1	0.14	0.000305010893246187	7873	1
3	Drink 1	Intake 1	11	27526	1337019699	/users/cn/jespinosa/phecomp/data/CRG/20120502_FDF_CRG/20120502_FDF_CRG/20120514_FDF_CRG_c12.mtb	943	NA	WWSS	water	1	27515	1337019688	1	0.02	0.00181818181818182	7874	1
3	Food 1	Intake 3	165	27713	1337019886	/users/cn/jespinosa/phecomp/data/CRG/20120502_FDF_CRG/20120502_FDF_CRG/20120514_FDF_CRG_c12.mtb	1856	1927	WWSS	food_sc	3	27548	1337019721	1	0.0800000000000001	0.000484848484848485	7875	1
3	Drink 2	Intake 2	21	27733	1337019906	/users/cn/jespinosa/phecomp/data/CRG/20120502_FDF_CRG/20120502_FDF_CRG/20120514_FDF_CRG_c12.mtb	2427	NA	WWSS	water	2	27712	1337019885	1	0.06	0.00285714285714286	7876	1
3	Drink 1	Intake 1	15	28097	1337020270	/users/cn/jespinosa/phecomp/data/CRG/20120502_FDF_CRG/20120502_FDF_CRG/20120514_FDF_CRG_c12.mtb	944	NA	WWSS	water	1	28082	1337020255	1	0.02	0.00133333333333333	7877	1
3	Drink 1	Intake 1	22	28509	1337020682	/users/cn/jespinosa/phecomp/data/CRG/20120502_FDF_CRG/20120502_FDF_CRG/20120514_FDF_CRG_c12.mtb	945	NA	WWSS	water	1	28487	1337020660	1	0.04	0.00181818181818182	7878	1
3	Drink 2	Intake 2	10	28752	1337020925	/users/cn/jespinosa/phecomp/data/CRG/20120502_FDF_CRG/20120502_FDF_CRG/20120514_FDF_CRG_c12.mtb	2428	NA	WWSS	water	2	28742	1337020915	1	0.02	0.002	7879	1
3	Drink 1	Intake 1	16	28819	1337020992	/users/cn/jespinosa/phecomp/data/CRG/20120502_FDF_CRG/20120502_FDF_CRG/20120514_FDF_CRG_c12.mtb	946	NA	WWSS	water	1	28803	1337020976	1	0.06	0.00375	7880	1
3	Food 1	Intake 3	491	30131	1337022304	/users/cn/jespinosa/phecomp/data/CRG/20120502_FDF_CRG/20120502_FDF_CRG/20120514_FDF_CRG_c12.mtb	1858	136	WWSS	food_sc	3	29640	1337021813	1	0.18	0.000366598778004073	7881	1
3	Drink 2	Intake 2	22	30161	1337022334	/users/cn/jespinosa/phecomp/data/CRG/20120502_FDF_CRG/20120502_FDF_CRG/20120514_FDF_CRG_c12.mtb	2430	NA	WWSS	water	2	30139	1337022312	1	0.06	0.00272727272727273	7882	1
3	Drink 1	Intake 1	16	30235	1337022408	/users/cn/jespinosa/phecomp/data/CRG/20120502_FDF_CRG/20120502_FDF_CRG/20120514_FDF_CRG_c12.mtb	947	NA	WWSS	water	1	30219	1337022392	1	0.02	0.00125	7883	1
3	Food 2	Intake 4	223	30490	1337022663	/users/cn/jespinosa/phecomp/data/CRG/20120502_FDF_CRG/20120502_FDF_CRG/20120514_FDF_CRG_c12.mtb	2991	2005	WWSS	food_sc	4	30267	1337022440	1	0.1	0.000448430493273543	7884	1
3	Drink 2	Intake 2	15	30504	1337022677	/users/cn/jespinosa/phecomp/data/CRG/20120502_FDF_CRG/20120502_FDF_CRG/20120514_FDF_CRG_c12.mtb	2431	NA	WWSS	water	2	30489	1337022662	1	0.04	0.00266666666666667	7885	1
3	Drink 2	Intake 2	16	30537	1337022710	/users/cn/jespinosa/phecomp/data/CRG/20120502_FDF_CRG/20120502_FDF_CRG/20120514_FDF_CRG_c12.mtb	2432	NA	WWSS	water	2	30521	1337022694	1	0.02	0.00125	7886	1
3	Drink 1	Intake 1	15	30590	1337022763	/users/cn/jespinosa/phecomp/data/CRG/20120502_FDF_CRG/20120502_FDF_CRG/20120514_FDF_CRG_c12.mtb	948	NA	WWSS	water	1	30575	1337022748	1	0.04	0.00266666666666667	7887	1
3	Drink 1	Intake 1	8	31423	1337023596	/users/cn/jespinosa/phecomp/data/CRG/20120502_FDF_CRG/20120502_FDF_CRG/20120514_FDF_CRG_c12.mtb	949	NA	WWSS	water	1	31415	1337023588	1	0.04	0.005	7888	1
3	Food 2	Intake 4	325	32820	1337024993	/users/cn/jespinosa/phecomp/data/CRG/20120502_FDF_CRG/20120502_FDF_CRG/20120514_FDF_CRG_c12.mtb	2995	2050	WWSS	food_sc	4	32495	1337024668	1	0.12	0.000369230769230769	7889	1
3	Drink 2	Intake 2	24	32885	1337025058	/users/cn/jespinosa/phecomp/data/CRG/20120502_FDF_CRG/20120502_FDF_CRG/20120514_FDF_CRG_c12.mtb	2436	NA	WWSS	water	2	32861	1337025034	1	0.06	0.0025	7890	1
3	Food 2	Intake 4	557	35427	1337027600	/users/cn/jespinosa/phecomp/data/CRG/20120502_FDF_CRG/20120502_FDF_CRG/20120514_FDF_CRG_c12.mtb	2999	313	WWSS	food_sc	4	34870	1337027043	1	0.28	0.000502692998204668	7891	1
3	Drink 2	Intake 2	23	35442	1337027615	/users/cn/jespinosa/phecomp/data/CRG/20120502_FDF_CRG/20120502_FDF_CRG/20120514_FDF_CRG_c12.mtb	2437	NA	WWSS	water	2	35419	1337027592	1	0.08	0.00347826086956522	7892	1
3	Drink 2	Intake 2	16	35510	1337027683	/users/cn/jespinosa/phecomp/data/CRG/20120502_FDF_CRG/20120502_FDF_CRG/20120514_FDF_CRG_c12.mtb	2438	NA	WWSS	water	2	35494	1337027667	1	0.04	0.0025	7893	1
3	Drink 1	Intake 1	19	35685	1337027858	/users/cn/jespinosa/phecomp/data/CRG/20120502_FDF_CRG/20120502_FDF_CRG/20120514_FDF_CRG_c12.mtb	950	NA	WWSS	water	1	35666	1337027839	1	0.04	0.00210526315789474	7894	1
3	Food 2	Intake 4	108	35848	1337028021	/users/cn/jespinosa/phecomp/data/CRG/20120502_FDF_CRG/20120502_FDF_CRG/20120514_FDF_CRG_c12.mtb	3002	2441	WWSS	food_sc	4	35740	1337027913	1	0.04	0.00037037037037037	7895	1
3	Drink 1	Intake 1	23	35977	1337028150	/users/cn/jespinosa/phecomp/data/CRG/20120502_FDF_CRG/20120502_FDF_CRG/20120514_FDF_CRG_c12.mtb	951	NA	WWSS	water	1	35954	1337028127	1	0.02	0.000869565217391304	7896	1
3	Drink 2	Intake 2	17	35981	1337028154	/users/cn/jespinosa/phecomp/data/CRG/20120502_FDF_CRG/20120502_FDF_CRG/20120514_FDF_CRG_c12.mtb	2439	NA	WWSS	water	2	35964	1337028137	1	0.02	0.00117647058823529	7897	1
3	Food 2	Intake 4	139	38428	1337030601	/users/cn/jespinosa/phecomp/data/CRG/20120502_FDF_CRG/20120502_FDF_CRG/20120514_FDF_CRG_c12.mtb	3003	18	WWSS	food_sc	4	38289	1337030462	1	0.0399999999999999	0.000287769784172661	7898	1
3	Food 2	Intake 4	199	38645	1337030818	/users/cn/jespinosa/phecomp/data/CRG/20120502_FDF_CRG/20120502_FDF_CRG/20120514_FDF_CRG_c12.mtb	3004	1120	WWSS	food_sc	4	38446	1337030619	1	0.0800000000000001	0.000402010050251257	7899	1
3	Drink 1	Intake 1	21	38660	1337030833	/users/cn/jespinosa/phecomp/data/CRG/20120502_FDF_CRG/20120502_FDF_CRG/20120514_FDF_CRG_c12.mtb	952	NA	WWSS	water	1	38639	1337030812	1	0.1	0.00476190476190476	7900	1
3	Food 1	Intake 3	473	40238	1337032411	/users/cn/jespinosa/phecomp/data/CRG/20120502_FDF_CRG/20120502_FDF_CRG/20120514_FDF_CRG_c12.mtb	1863	1341	WWSS	food_sc	3	39765	1337031938	1	0.18	0.000380549682875264	7901	1
3	Drink 2	Intake 2	23	40260	1337032433	/users/cn/jespinosa/phecomp/data/CRG/20120502_FDF_CRG/20120502_FDF_CRG/20120514_FDF_CRG_c12.mtb	2440	NA	WWSS	water	2	40237	1337032410	1	0.06	0.00260869565217391	7902	1
3	Drink 2	Intake 2	14	40365	1337032538	/users/cn/jespinosa/phecomp/data/CRG/20120502_FDF_CRG/20120502_FDF_CRG/20120514_FDF_CRG_c12.mtb	2441	NA	WWSS	water	2	40351	1337032524	1	0.04	0.00285714285714286	7903	1
3	Food 1	Intake 3	58	41637	1337033810	/users/cn/jespinosa/phecomp/data/CRG/20120502_FDF_CRG/20120502_FDF_CRG/20120514_FDF_CRG_c12.mtb	1865	77	WWSS	food_sc	3	41579	1337033752	1	0.02	0.000344827586206897	7904	1
3	Food 1	Intake 3	57	41771	1337033944	/users/cn/jespinosa/phecomp/data/CRG/20120502_FDF_CRG/20120502_FDF_CRG/20120514_FDF_CRG_c12.mtb	1866	1418	WWSS	food_sc	3	41714	1337033887	1	0.02	0.000350877192982456	7905	1
3	Drink 2	Intake 2	17	42993	1337035166	/users/cn/jespinosa/phecomp/data/CRG/20120502_FDF_CRG/20120502_FDF_CRG/20120514_FDF_CRG_c12.mtb	2443	NA	WWSS	water	2	42976	1337035149	1	0.02	0.00117647058823529	7906	1
3	Food 2	Intake 4	149	43338	1337035511	/users/cn/jespinosa/phecomp/data/CRG/20120502_FDF_CRG/20120502_FDF_CRG/20120514_FDF_CRG_c12.mtb	3014	242	WWSS	food_sc	4	43189	1337035362	1	0.02	0.000134228187919463	7907	1
3	Drink 1	Intake 1	16	43415	1337035588	/users/cn/jespinosa/phecomp/data/CRG/20120502_FDF_CRG/20120502_FDF_CRG/20120514_FDF_CRG_c12.mtb	954	NA	WWSS	water	1	43399	1337035572	1	0.0399999999999999	0.00249999999999999	7908	1
3	Food 2	Intake 4	366	43946	1337036119	/users/cn/jespinosa/phecomp/data/CRG/20120502_FDF_CRG/20120502_FDF_CRG/20120514_FDF_CRG_c12.mtb	3015	2268	WWSS	food_sc	4	43580	1337035753	1	0.1	0.000273224043715847	7909	1
3	Drink 2	Intake 2	23	44004	1337036177	/users/cn/jespinosa/phecomp/data/CRG/20120502_FDF_CRG/20120502_FDF_CRG/20120514_FDF_CRG_c12.mtb	2444	NA	WWSS	water	2	43981	1337036154	1	0.0399999999999999	0.0017391304347826	7910	1
3	Food 2	Intake 4	471	46685	1337038858	/users/cn/jespinosa/phecomp/data/CRG/20120502_FDF_CRG/20120502_FDF_CRG/20120514_FDF_CRG_c12.mtb	3019	1165	WWSS	food_sc	4	46214	1337038387	1	0.14	0.00029723991507431	7911	1
3	Drink 2	Intake 2	23	46698	1337038871	/users/cn/jespinosa/phecomp/data/CRG/20120502_FDF_CRG/20120502_FDF_CRG/20120514_FDF_CRG_c12.mtb	2446	NA	WWSS	water	2	46675	1337038848	1	0.04	0.00173913043478261	7912	1
3	Drink 2	Intake 2	23	47070	1337039243	/users/cn/jespinosa/phecomp/data/CRG/20120502_FDF_CRG/20120502_FDF_CRG/20120514_FDF_CRG_c12.mtb	2447	NA	WWSS	water	2	47047	1337039220	1	0.08	0.00347826086956522	7913	1
3	Drink 1	Intake 1	12	47258	1337039431	/users/cn/jespinosa/phecomp/data/CRG/20120502_FDF_CRG/20120502_FDF_CRG/20120514_FDF_CRG_c12.mtb	956	NA	WWSS	water	1	47246	1337039419	1	0.02	0.00166666666666667	7914	1
3	Drink 1	Intake 1	21	47378	1337039551	/users/cn/jespinosa/phecomp/data/CRG/20120502_FDF_CRG/20120502_FDF_CRG/20120514_FDF_CRG_c12.mtb	957	NA	WWSS	water	1	47357	1337039530	1	0.04	0.0019047619047619	7915	1
3	Drink 1	Intake 1	12	47451	1337039624	/users/cn/jespinosa/phecomp/data/CRG/20120502_FDF_CRG/20120502_FDF_CRG/20120514_FDF_CRG_c12.mtb	958	NA	WWSS	water	1	47439	1337039612	1	0.02	0.00166666666666667	7916	1
3	Food 2	Intake 4	413	48263	1337040436	/users/cn/jespinosa/phecomp/data/CRG/20120502_FDF_CRG/20120502_FDF_CRG/20120514_FDF_CRG_c12.mtb	3023	207	WWSS	food_sc	4	47850	1337040023	1	0.14	0.000338983050847458	7917	1
3	Drink 2	Intake 2	24	48289	1337040462	/users/cn/jespinosa/phecomp/data/CRG/20120502_FDF_CRG/20120502_FDF_CRG/20120514_FDF_CRG_c12.mtb	2450	NA	WWSS	water	2	48265	1337040438	1	0.0800000000000001	0.00333333333333334	7918	1
3	Food 2	Intake 4	76	48546	1337040719	/users/cn/jespinosa/phecomp/data/CRG/20120502_FDF_CRG/20120502_FDF_CRG/20120514_FDF_CRG_c12.mtb	3024	2200	WWSS	food_sc	4	48470	1337040643	1	0.02	0.000263157894736842	7919	1
3	Drink 2	Intake 2	14	48805	1337040978	/users/cn/jespinosa/phecomp/data/CRG/20120502_FDF_CRG/20120502_FDF_CRG/20120514_FDF_CRG_c12.mtb	2451	NA	WWSS	water	2	48791	1337040964	1	0.02	0.00142857142857143	7920	1
3	Drink 1	Intake 1	31	49751	1337041924	/users/cn/jespinosa/phecomp/data/CRG/20120502_FDF_CRG/20120502_FDF_CRG/20120514_FDF_CRG_c12.mtb	961	NA	WWSS	water	1	49720	1337041893	1	0.0399999999999999	0.00129032258064516	7921	1
3	Food 2	Intake 4	94	50840	1337043013	/users/cn/jespinosa/phecomp/data/CRG/20120502_FDF_CRG/20120502_FDF_CRG/20120514_FDF_CRG_c12.mtb	3028	5076	WWSS	food_sc	4	50746	1337042919	1	0.02	0.000212765957446809	7922	1
3	Food 2	Intake 4	248	56164	1337048337	/users/cn/jespinosa/phecomp/data/CRG/20120502_FDF_CRG/20120502_FDF_CRG/20120514_FDF_CRG_c12.mtb	3032	263	WWSS	food_sc	4	55916	1337048089	1	0.04	0.000161290322580645	7923	1
3	Food 2	Intake 4	163	56590	1337048763	/users/cn/jespinosa/phecomp/data/CRG/20120502_FDF_CRG/20120502_FDF_CRG/20120514_FDF_CRG_c12.mtb	3034	64	WWSS	food_sc	4	56427	1337048600	1	0.02	0.000122699386503067	7924	1
3	Food 2	Intake 4	155	56809	1337048982	/users/cn/jespinosa/phecomp/data/CRG/20120502_FDF_CRG/20120502_FDF_CRG/20120514_FDF_CRG_c12.mtb	3035	3741	WWSS	food_sc	4	56654	1337048827	1	0.04	0.000258064516129032	7925	1
3	Drink 2	Intake 2	14	56892	1337049065	/users/cn/jespinosa/phecomp/data/CRG/20120502_FDF_CRG/20120502_FDF_CRG/20120514_FDF_CRG_c12.mtb	2454	NA	WWSS	water	2	56878	1337049051	1	0.0600000000000001	0.00428571428571429	7926	1
3	Drink 2	Intake 2	10	57406	1337049579	/users/cn/jespinosa/phecomp/data/CRG/20120502_FDF_CRG/20120502_FDF_CRG/20120514_FDF_CRG_c12.mtb	2455	NA	WWSS	water	2	57396	1337049569	1	0.04	0.004	7927	1
3	Food 2	Intake 4	335	60885	1337053058	/users/cn/jespinosa/phecomp/data/CRG/20120502_FDF_CRG/20120502_FDF_CRG/20120514_FDF_CRG_c12.mtb	3039	2460	WWSS	food_sc	4	60550	1337052723	1	0.1	0.000298507462686567	7928	1
3	Food 2	Intake 4	68	63413	1337055586	/users/cn/jespinosa/phecomp/data/CRG/20120502_FDF_CRG/20120502_FDF_CRG/20120514_FDF_CRG_c12.mtb	3041	857	WWSS	food_sc	4	63345	1337055518	1	0.02	0.000294117647058824	7929	1
3	Drink 2	Intake 2	17	63583	1337055756	/users/cn/jespinosa/phecomp/data/CRG/20120502_FDF_CRG/20120502_FDF_CRG/20120514_FDF_CRG_c12.mtb	2457	NA	WWSS	water	2	63566	1337055739	1	0.0399999999999999	0.00235294117647058	7930	1
3	Drink 2	Intake 2	15	63697	1337055870	/users/cn/jespinosa/phecomp/data/CRG/20120502_FDF_CRG/20120502_FDF_CRG/20120514_FDF_CRG_c12.mtb	2458	NA	WWSS	water	2	63682	1337055855	1	0.02	0.00133333333333333	7931	1
3	Food 2	Intake 4	233	64503	1337056676	/users/cn/jespinosa/phecomp/data/CRG/20120502_FDF_CRG/20120502_FDF_CRG/20120514_FDF_CRG_c12.mtb	3044	108	WWSS	food_sc	4	64270	1337056443	1	0.0399999999999998	0.000171673819742488	7932	1
3	Drink 1	Intake 1	17	64558	1337056731	/users/cn/jespinosa/phecomp/data/CRG/20120502_FDF_CRG/20120502_FDF_CRG/20120514_FDF_CRG_c12.mtb	964	NA	WWSS	water	1	64541	1337056714	1	0.02	0.00117647058823529	7933	1
3	Drink 2	Intake 2	17	64595	1337056768	/users/cn/jespinosa/phecomp/data/CRG/20120502_FDF_CRG/20120502_FDF_CRG/20120514_FDF_CRG_c12.mtb	2459	NA	WWSS	water	2	64578	1337056751	1	0.02	0.00117647058823529	7934	1
3	Food 2	Intake 4	398	65009	1337057182	/users/cn/jespinosa/phecomp/data/CRG/20120502_FDF_CRG/20120502_FDF_CRG/20120514_FDF_CRG_c12.mtb	3045	2053	WWSS	food_sc	4	64611	1337056784	1	0.1	0.000251256281407035	7935	1
3	Drink 1	Intake 1	15	65029	1337057202	/users/cn/jespinosa/phecomp/data/CRG/20120502_FDF_CRG/20120502_FDF_CRG/20120514_FDF_CRG_c12.mtb	965	NA	WWSS	water	1	65014	1337057187	1	0.0800000000000001	0.00533333333333334	7936	1
3	Drink 2	Intake 2	17	65202	1337057375	/users/cn/jespinosa/phecomp/data/CRG/20120502_FDF_CRG/20120502_FDF_CRG/20120514_FDF_CRG_c12.mtb	2460	NA	WWSS	water	2	65185	1337057358	1	0.04	0.00235294117647059	7937	1
3	Drink 1	Intake 1	15	66090	1337058263	/users/cn/jespinosa/phecomp/data/CRG/20120502_FDF_CRG/20120502_FDF_CRG/20120514_FDF_CRG_c12.mtb	966	NA	WWSS	water	1	66075	1337058248	1	0.0599999999999999	0.00399999999999999	7938	1
3	Food 2	Intake 4	368	67430	1337059603	/users/cn/jespinosa/phecomp/data/CRG/20120502_FDF_CRG/20120502_FDF_CRG/20120514_FDF_CRG_c12.mtb	3048	10156	WWSS	food_sc	4	67062	1337059235	1	0.1	0.000271739130434783	7939	1
3	Drink 2	Intake 2	20	67464	1337059637	/users/cn/jespinosa/phecomp/data/CRG/20120502_FDF_CRG/20120502_FDF_CRG/20120514_FDF_CRG_c12.mtb	2462	NA	WWSS	water	2	67444	1337059617	1	0.04	0.002	7940	1
3	Drink 2	Intake 2	37	67728	1337059901	/users/cn/jespinosa/phecomp/data/CRG/20120502_FDF_CRG/20120502_FDF_CRG/20120514_FDF_CRG_c12.mtb	2463	NA	WWSS	water	2	67691	1337059864	1	0.04	0.00108108108108108	7941	1
3	Food 2	Intake 4	75	77661	1337069834	/users/cn/jespinosa/phecomp/data/CRG/20120502_FDF_CRG/20120502_FDF_CRG/20120514_FDF_CRG_c12.mtb	3060	36196	WWSS	food_sc	4	77586	1337069759	1	0.04	0.000533333333333333	7942	1
3	Drink 1	Intake 1	13	78071	1337070244	/users/cn/jespinosa/phecomp/data/CRG/20120502_FDF_CRG/20120502_FDF_CRG/20120514_FDF_CRG_c12.mtb	970	NA	WWSS	water	1	78058	1337070231	1	0.04	0.00307692307692308	7943	1
3	Food 1	Intake 3	171	114028	1337106201	/users/cn/jespinosa/phecomp/data/CRG/20120502_FDF_CRG/20120502_FDF_CRG/20120514_FDF_CRG_c12.mtb	1887	89	WWSS	food_sc	3	113857	1337106030	1	0.04	0.000233918128654971	7944	1
3	Food 1	Intake 3	125	114242	1337106415	/users/cn/jespinosa/phecomp/data/CRG/20120502_FDF_CRG/20120502_FDF_CRG/20120514_FDF_CRG_c12.mtb	1888	272	WWSS	food_sc	3	114117	1337106290	1	0.02	0.00016	7945	1
3	Drink 1	Intake 1	18	114445	1337106618	/users/cn/jespinosa/phecomp/data/CRG/20120502_FDF_CRG/20120502_FDF_CRG/20120514_FDF_CRG_c12.mtb	974	NA	WWSS	water	1	114427	1337106600	1	0.04	0.00222222222222222	7946	1
3	Food 2	Intake 4	208	114722	1337106895	/users/cn/jespinosa/phecomp/data/CRG/20120502_FDF_CRG/20120502_FDF_CRG/20120514_FDF_CRG_c12.mtb	3073	30	WWSS	food_sc	4	114514	1337106687	1	0.02	9.61538461538462e-05	7947	1
3	Food 2	Intake 4	266	115018	1337107191	/users/cn/jespinosa/phecomp/data/CRG/20120502_FDF_CRG/20120502_FDF_CRG/20120514_FDF_CRG_c12.mtb	3074	674	WWSS	food_sc	4	114752	1337106925	1	0.0799999999999998	0.000300751879699247	7948	1
3	Drink 2	Intake 2	24	115041	1337107214	/users/cn/jespinosa/phecomp/data/CRG/20120502_FDF_CRG/20120502_FDF_CRG/20120514_FDF_CRG_c12.mtb	2466	NA	WWSS	water	2	115017	1337107190	1	0.0399999999999998	0.00166666666666666	7949	1
3	Drink 2	Intake 2	17	115080	1337107253	/users/cn/jespinosa/phecomp/data/CRG/20120502_FDF_CRG/20120502_FDF_CRG/20120514_FDF_CRG_c12.mtb	2467	NA	WWSS	water	2	115063	1337107236	1	0.02	0.00117647058823529	7950	1
3	Drink 2	Intake 2	28	115262	1337107435	/users/cn/jespinosa/phecomp/data/CRG/20120502_FDF_CRG/20120502_FDF_CRG/20120514_FDF_CRG_c12.mtb	2468	NA	WWSS	water	2	115234	1337107407	1	0.0800000000000001	0.00285714285714286	7951	1
3	Drink 2	Intake 2	16	115518	1337107691	/users/cn/jespinosa/phecomp/data/CRG/20120502_FDF_CRG/20120502_FDF_CRG/20120514_FDF_CRG_c12.mtb	2469	NA	WWSS	water	2	115502	1337107675	1	0.02	0.00125	7952	1
3	Drink 1	Intake 1	47	115623	1337107796	/users/cn/jespinosa/phecomp/data/CRG/20120502_FDF_CRG/20120502_FDF_CRG/20120514_FDF_CRG_c12.mtb	976	NA	WWSS	water	1	115576	1337107749	1	0.04	0.000851063829787234	7953	1
3	Food 2	Intake 4	237	115929	1337108102	/users/cn/jespinosa/phecomp/data/CRG/20120502_FDF_CRG/20120502_FDF_CRG/20120514_FDF_CRG_c12.mtb	3080	10	WWSS	food_sc	4	115692	1337107865	1	0.04	0.000168776371308017	7954	1
3	Food 2	Intake 4	348	116287	1337108460	/users/cn/jespinosa/phecomp/data/CRG/20120502_FDF_CRG/20120502_FDF_CRG/20120514_FDF_CRG_c12.mtb	3081	1155	WWSS	food_sc	4	115939	1337108112	1	0.0999999999999999	0.00028735632183908	7955	1
3	Drink 2	Intake 2	29	116320	1337108493	/users/cn/jespinosa/phecomp/data/CRG/20120502_FDF_CRG/20120502_FDF_CRG/20120514_FDF_CRG_c12.mtb	2471	NA	WWSS	water	2	116291	1337108464	1	0.0999999999999999	0.00344827586206896	7956	1
3	Drink 2	Intake 2	30	116382	1337108555	/users/cn/jespinosa/phecomp/data/CRG/20120502_FDF_CRG/20120502_FDF_CRG/20120514_FDF_CRG_c12.mtb	2472	NA	WWSS	water	2	116352	1337108525	1	0.02	0.000666666666666667	7957	1
3	Drink 2	Intake 2	15	117007	1337109180	/users/cn/jespinosa/phecomp/data/CRG/20120502_FDF_CRG/20120502_FDF_CRG/20120514_FDF_CRG_c12.mtb	2473	NA	WWSS	water	2	116992	1337109165	1	0.02	0.00133333333333333	7958	1
3	Food 2	Intake 4	458	117900	1337110073	/users/cn/jespinosa/phecomp/data/CRG/20120502_FDF_CRG/20120502_FDF_CRG/20120514_FDF_CRG_c12.mtb	3083	13	WWSS	food_sc	4	117442	1337109615	1	0.18	0.000393013100436681	7959	1
3	Food 2	Intake 4	94	118007	1337110180	/users/cn/jespinosa/phecomp/data/CRG/20120502_FDF_CRG/20120502_FDF_CRG/20120514_FDF_CRG_c12.mtb	3084	1731	WWSS	food_sc	4	117913	1337110086	1	0.04	0.000425531914893617	7960	1
3	Drink 2	Intake 2	26	118026	1337110199	/users/cn/jespinosa/phecomp/data/CRG/20120502_FDF_CRG/20120502_FDF_CRG/20120514_FDF_CRG_c12.mtb	2474	NA	WWSS	water	2	118000	1337110173	1	0.0800000000000001	0.00307692307692308	7961	1
3	Drink 1	Intake 1	17	118066	1337110239	/users/cn/jespinosa/phecomp/data/CRG/20120502_FDF_CRG/20120502_FDF_CRG/20120514_FDF_CRG_c12.mtb	977	NA	WWSS	water	1	118049	1337110222	1	0.04	0.00235294117647059	7962	1
3	Drink 1	Intake 1	23	118239	1337110412	/users/cn/jespinosa/phecomp/data/CRG/20120502_FDF_CRG/20120502_FDF_CRG/20120514_FDF_CRG_c12.mtb	978	NA	WWSS	water	1	118216	1337110389	1	0.0599999999999998	0.0026086956521739	7963	1
3	Drink 2	Intake 2	16	119192	1337111365	/users/cn/jespinosa/phecomp/data/CRG/20120502_FDF_CRG/20120502_FDF_CRG/20120514_FDF_CRG_c12.mtb	2475	NA	WWSS	water	2	119176	1337111349	1	0.04	0.0025	7964	1
3	Food 2	Intake 4	259	119997	1337112170	/users/cn/jespinosa/phecomp/data/CRG/20120502_FDF_CRG/20120502_FDF_CRG/20120514_FDF_CRG_c12.mtb	3086	1853	WWSS	food_sc	4	119738	1337111911	1	0.12	0.000463320463320463	7965	1
3	Drink 2	Intake 2	15	120021	1337112194	/users/cn/jespinosa/phecomp/data/CRG/20120502_FDF_CRG/20120502_FDF_CRG/20120514_FDF_CRG_c12.mtb	2476	NA	WWSS	water	2	120006	1337112179	1	0.02	0.00133333333333333	7966	1
3	Drink 2	Intake 2	23	120568	1337112741	/users/cn/jespinosa/phecomp/data/CRG/20120502_FDF_CRG/20120502_FDF_CRG/20120514_FDF_CRG_c12.mtb	2477	NA	WWSS	water	2	120545	1337112718	1	0.0600000000000001	0.00260869565217392	7967	1
3	Food 2	Intake 4	266	122116	1337114289	/users/cn/jespinosa/phecomp/data/CRG/20120502_FDF_CRG/20120502_FDF_CRG/20120514_FDF_CRG_c12.mtb	3089	1840	WWSS	food_sc	4	121850	1337114023	1	0.16	0.000601503759398496	7968	1
3	Drink 2	Intake 2	17	122336	1337114509	/users/cn/jespinosa/phecomp/data/CRG/20120502_FDF_CRG/20120502_FDF_CRG/20120514_FDF_CRG_c12.mtb	2478	NA	WWSS	water	2	122319	1337114492	1	0.02	0.00117647058823529	7969	1
3	Drink 1	Intake 1	13	122390	1337114563	/users/cn/jespinosa/phecomp/data/CRG/20120502_FDF_CRG/20120502_FDF_CRG/20120514_FDF_CRG_c12.mtb	979	NA	WWSS	water	1	122377	1337114550	1	0.0600000000000001	0.00461538461538462	7970	1
3	Food 2	Intake 4	139	124095	1337116268	/users/cn/jespinosa/phecomp/data/CRG/20120502_FDF_CRG/20120502_FDF_CRG/20120514_FDF_CRG_c12.mtb	3090	5	WWSS	food_sc	4	123956	1337116129	1	0.0800000000000001	0.000575539568345324	7971	1
3	Food 2	Intake 4	24	124124	1337116297	/users/cn/jespinosa/phecomp/data/CRG/20120502_FDF_CRG/20120502_FDF_CRG/20120514_FDF_CRG_c12.mtb	3091	1234	WWSS	food_sc	4	124100	1337116273	1	0.28	0.0116666666666667	7972	1
3	Drink 1	Intake 1	19	124603	1337116776	/users/cn/jespinosa/phecomp/data/CRG/20120502_FDF_CRG/20120502_FDF_CRG/20120514_FDF_CRG_c12.mtb	980	NA	WWSS	water	1	124584	1337116757	1	0.04	0.00210526315789474	7973	1
3	Drink 2	Intake 2	36	124822	1337116995	/users/cn/jespinosa/phecomp/data/CRG/20120502_FDF_CRG/20120502_FDF_CRG/20120514_FDF_CRG_c12.mtb	2479	NA	WWSS	water	2	124786	1337116959	1	0.04	0.00111111111111111	7974	1
3	Drink 2	Intake 2	19	125107	1337117280	/users/cn/jespinosa/phecomp/data/CRG/20120502_FDF_CRG/20120502_FDF_CRG/20120514_FDF_CRG_c12.mtb	2480	NA	WWSS	water	2	125088	1337117261	1	0.0399999999999998	0.00210526315789473	7975	1
3	Food 2	Intake 4	150	125508	1337117681	/users/cn/jespinosa/phecomp/data/CRG/20120502_FDF_CRG/20120502_FDF_CRG/20120514_FDF_CRG_c12.mtb	3098	8	WWSS	food_sc	4	125358	1337117531	1	0.04	0.000266666666666667	7976	1
3	Food 2	Intake 4	237	125753	1337117926	/users/cn/jespinosa/phecomp/data/CRG/20120502_FDF_CRG/20120502_FDF_CRG/20120514_FDF_CRG_c12.mtb	3099	2473	WWSS	food_sc	4	125516	1337117689	1	0.12	0.000506329113924051	7977	1
3	Drink 2	Intake 2	44	125789	1337117962	/users/cn/jespinosa/phecomp/data/CRG/20120502_FDF_CRG/20120502_FDF_CRG/20120514_FDF_CRG_c12.mtb	2481	NA	WWSS	water	2	125745	1337117918	1	0.0800000000000001	0.00181818181818182	7978	1
3	Drink 2	Intake 2	23	125996	1337118169	/users/cn/jespinosa/phecomp/data/CRG/20120502_FDF_CRG/20120502_FDF_CRG/20120514_FDF_CRG_c12.mtb	2482	NA	WWSS	water	2	125973	1337118146	1	0.0799999999999998	0.00347826086956521	7979	1
3	Drink 2	Intake 2	18	126725	1337118898	/users/cn/jespinosa/phecomp/data/CRG/20120502_FDF_CRG/20120502_FDF_CRG/20120514_FDF_CRG_c12.mtb	2483	NA	WWSS	water	2	126707	1337118880	1	0.0600000000000001	0.00333333333333334	7980	1
3	Drink 1	Intake 1	39	127194	1337119367	/users/cn/jespinosa/phecomp/data/CRG/20120502_FDF_CRG/20120502_FDF_CRG/20120514_FDF_CRG_c12.mtb	981	NA	WWSS	water	1	127155	1337119328	1	0.02	0.000512820512820513	7981	1
3	Drink 2	Intake 2	16	127200	1337119373	/users/cn/jespinosa/phecomp/data/CRG/20120502_FDF_CRG/20120502_FDF_CRG/20120514_FDF_CRG_c12.mtb	2484	NA	WWSS	water	2	127184	1337119357	1	0.04	0.0025	7982	1
3	Food 1	Intake 3	188	128414	1337120587	/users/cn/jespinosa/phecomp/data/CRG/20120502_FDF_CRG/20120502_FDF_CRG/20120514_FDF_CRG_c12.mtb	1898	1089	WWSS	food_sc	3	128226	1337120399	1	0.0399999999999998	0.000212765957446807	7983	1
3	Drink 1	Intake 1	14	128420	1337120593	/users/cn/jespinosa/phecomp/data/CRG/20120502_FDF_CRG/20120502_FDF_CRG/20120514_FDF_CRG_c12.mtb	983	NA	WWSS	water	1	128406	1337120579	1	0.02	0.00142857142857143	7984	1
3	Drink 1	Intake 1	20	129054	1337121227	/users/cn/jespinosa/phecomp/data/CRG/20120502_FDF_CRG/20120502_FDF_CRG/20120514_FDF_CRG_c12.mtb	984	NA	WWSS	water	1	129034	1337121207	1	0.0599999999999998	0.00299999999999999	7985	1
3	Food 2	Intake 4	89	129592	1337121765	/users/cn/jespinosa/phecomp/data/CRG/20120502_FDF_CRG/20120502_FDF_CRG/20120514_FDF_CRG_c12.mtb	3109	22	WWSS	food_sc	4	129503	1337121676	1	0.02	0.000224719101123596	7986	1
3	Food 2	Intake 4	118	129732	1337121905	/users/cn/jespinosa/phecomp/data/CRG/20120502_FDF_CRG/20120502_FDF_CRG/20120514_FDF_CRG_c12.mtb	3110	6	WWSS	food_sc	4	129614	1337121787	1	0.02	0.000169491525423729	7987	1
3	Food 2	Intake 4	111	129849	1337122022	/users/cn/jespinosa/phecomp/data/CRG/20120502_FDF_CRG/20120502_FDF_CRG/20120514_FDF_CRG_c12.mtb	3111	2223	WWSS	food_sc	4	129738	1337121911	1	0.04	0.00036036036036036	7988	1
3	Drink 2	Intake 2	19	129890	1337122063	/users/cn/jespinosa/phecomp/data/CRG/20120502_FDF_CRG/20120502_FDF_CRG/20120514_FDF_CRG_c12.mtb	2487	NA	WWSS	water	2	129871	1337122044	1	0.04	0.00210526315789474	7989	1
3	Food 1	Intake 3	203	132275	1337124448	/users/cn/jespinosa/phecomp/data/CRG/20120502_FDF_CRG/20120502_FDF_CRG/20120514_FDF_CRG_c12.mtb	1900	164	WWSS	food_sc	3	132072	1337124245	1	0.0600000000000001	0.000295566502463055	7990	1
3	Food 2	Intake 4	149	132588	1337124761	/users/cn/jespinosa/phecomp/data/CRG/20120502_FDF_CRG/20120502_FDF_CRG/20120514_FDF_CRG_c12.mtb	3115	638	WWSS	food_sc	4	132439	1337124612	1	0.04	0.000268456375838926	7991	1
3	Drink 2	Intake 2	23	132608	1337124781	/users/cn/jespinosa/phecomp/data/CRG/20120502_FDF_CRG/20120502_FDF_CRG/20120514_FDF_CRG_c12.mtb	2490	NA	WWSS	water	2	132585	1337124758	1	0.0600000000000001	0.00260869565217392	7992	1
3	Drink 2	Intake 2	18	133064	1337125237	/users/cn/jespinosa/phecomp/data/CRG/20120502_FDF_CRG/20120502_FDF_CRG/20120514_FDF_CRG_c12.mtb	2492	NA	WWSS	water	2	133046	1337125219	1	0.04	0.00222222222222222	7993	1
3	Food 2	Intake 4	270	133496	1337125669	/users/cn/jespinosa/phecomp/data/CRG/20120502_FDF_CRG/20120502_FDF_CRG/20120514_FDF_CRG_c12.mtb	3120	1483	WWSS	food_sc	4	133226	1337125399	1	0.1	0.00037037037037037	7994	1
3	Drink 2	Intake 2	28	133516	1337125689	/users/cn/jespinosa/phecomp/data/CRG/20120502_FDF_CRG/20120502_FDF_CRG/20120514_FDF_CRG_c12.mtb	2493	NA	WWSS	water	2	133488	1337125661	1	0.0800000000000001	0.00285714285714286	7995	1
3	Drink 1	Intake 1	23	133744	1337125917	/users/cn/jespinosa/phecomp/data/CRG/20120502_FDF_CRG/20120502_FDF_CRG/20120514_FDF_CRG_c12.mtb	987	NA	WWSS	water	1	133721	1337125894	1	0.0800000000000001	0.00347826086956522	7996	1
3	Drink 1	Intake 1	84	134185	1337126358	/users/cn/jespinosa/phecomp/data/CRG/20120502_FDF_CRG/20120502_FDF_CRG/20120514_FDF_CRG_c12.mtb	988	NA	WWSS	water	1	134101	1337126274	1	0.02	0.000238095238095238	7997	1
3	Food 2	Intake 4	321	135300	1337127473	/users/cn/jespinosa/phecomp/data/CRG/20120502_FDF_CRG/20120502_FDF_CRG/20120514_FDF_CRG_c12.mtb	3121	5040	WWSS	food_sc	4	134979	1337127152	1	0.1	0.000311526479750779	7998	1
3	Drink 2	Intake 2	20	135384	1337127557	/users/cn/jespinosa/phecomp/data/CRG/20120502_FDF_CRG/20120502_FDF_CRG/20120514_FDF_CRG_c12.mtb	2495	NA	WWSS	water	2	135364	1337127537	1	0.0599999999999996	0.00299999999999998	7999	1
3	Drink 1	Intake 1	17	135456	1337127629	/users/cn/jespinosa/phecomp/data/CRG/20120502_FDF_CRG/20120502_FDF_CRG/20120514_FDF_CRG_c12.mtb	990	NA	WWSS	water	1	135439	1337127612	1	0.02	0.00117647058823529	8000	1
3	Food 2	Intake 4	301	140641	1337132814	/users/cn/jespinosa/phecomp/data/CRG/20120502_FDF_CRG/20120502_FDF_CRG/20120514_FDF_CRG_c12.mtb	3124	185	WWSS	food_sc	4	140340	1337132513	1	0.12	0.000398671096345515	8001	1
3	Food 2	Intake 4	165	140991	1337133164	/users/cn/jespinosa/phecomp/data/CRG/20120502_FDF_CRG/20120502_FDF_CRG/20120514_FDF_CRG_c12.mtb	3126	1643	WWSS	food_sc	4	140826	1337132999	1	0.04	0.000242424242424242	8002	1
3	Drink 1	Intake 1	23	141026	1337133199	/users/cn/jespinosa/phecomp/data/CRG/20120502_FDF_CRG/20120502_FDF_CRG/20120514_FDF_CRG_c12.mtb	991	NA	WWSS	water	1	141003	1337133176	1	0.0600000000000001	0.00260869565217392	8003	1
3	Drink 2	Intake 2	22	141054	1337133227	/users/cn/jespinosa/phecomp/data/CRG/20120502_FDF_CRG/20120502_FDF_CRG/20120514_FDF_CRG_c12.mtb	2497	NA	WWSS	water	2	141032	1337133205	1	0.04	0.00181818181818182	8004	1
3	Drink 1	Intake 1	15	141401	1337133574	/users/cn/jespinosa/phecomp/data/CRG/20120502_FDF_CRG/20120502_FDF_CRG/20120514_FDF_CRG_c12.mtb	993	NA	WWSS	water	1	141386	1337133559	1	0.0600000000000001	0.00400000000000001	8005	1
3	Food 2	Intake 4	216	142850	1337135023	/users/cn/jespinosa/phecomp/data/CRG/20120502_FDF_CRG/20120502_FDF_CRG/20120514_FDF_CRG_c12.mtb	3129	149	WWSS	food_sc	4	142634	1337134807	1	0.0800000000000001	0.000370370370370371	8006	1
3	Food 2	Intake 4	97	143096	1337135269	/users/cn/jespinosa/phecomp/data/CRG/20120502_FDF_CRG/20120502_FDF_CRG/20120514_FDF_CRG_c12.mtb	3130	6756	WWSS	food_sc	4	142999	1337135172	1	0.02	0.000206185567010309	8007	1
3	Drink 1	Intake 1	16	143112	1337135285	/users/cn/jespinosa/phecomp/data/CRG/20120502_FDF_CRG/20120502_FDF_CRG/20120514_FDF_CRG_c12.mtb	994	NA	WWSS	water	1	143096	1337135269	1	0.02	0.00125	8008	1
3	Food 2	Intake 4	340	150192	1337142365	/users/cn/jespinosa/phecomp/data/CRG/20120502_FDF_CRG/20120502_FDF_CRG/20120514_FDF_CRG_c12.mtb	3135	85	WWSS	food_sc	4	149852	1337142025	1	0.0600000000000001	0.000176470588235294	8009	1
3	Food 2	Intake 4	329	150606	1337142779	/users/cn/jespinosa/phecomp/data/CRG/20120502_FDF_CRG/20120502_FDF_CRG/20120514_FDF_CRG_c12.mtb	3137	4507	WWSS	food_sc	4	150277	1337142450	1	0.0800000000000001	0.000243161094224924	8010	1
3	Drink 1	Intake 1	17	150616	1337142789	/users/cn/jespinosa/phecomp/data/CRG/20120502_FDF_CRG/20120502_FDF_CRG/20120514_FDF_CRG_c12.mtb	995	NA	WWSS	water	1	150599	1337142772	1	0.0799999999999998	0.00470588235294116	8011	1
3	Drink 1	Intake 1	20	150680	1337142853	/users/cn/jespinosa/phecomp/data/CRG/20120502_FDF_CRG/20120502_FDF_CRG/20120514_FDF_CRG_c12.mtb	996	NA	WWSS	water	1	150660	1337142833	1	0.02	0.001	8012	1
3	Drink 1	Intake 1	15	151098	1337143271	/users/cn/jespinosa/phecomp/data/CRG/20120502_FDF_CRG/20120502_FDF_CRG/20120514_FDF_CRG_c12.mtb	997	NA	WWSS	water	1	151083	1337143256	1	0.0599999999999998	0.00399999999999999	8013	1
3	Drink 1	Intake 1	12	151145	1337143318	/users/cn/jespinosa/phecomp/data/CRG/20120502_FDF_CRG/20120502_FDF_CRG/20120514_FDF_CRG_c12.mtb	998	NA	WWSS	water	1	151133	1337143306	1	0.02	0.00166666666666667	8014	1
3	Drink 1	Intake 1	123	152035	1337144208	/users/cn/jespinosa/phecomp/data/CRG/20120502_FDF_CRG/20120502_FDF_CRG/20120514_FDF_CRG_c12.mtb	999	NA	WWSS	water	1	151912	1337144085	1	0.04	0.00032520325203252	8015	1
3	Food 1	Intake 3	385	155498	1337147671	/users/cn/jespinosa/phecomp/data/CRG/20120502_FDF_CRG/20120502_FDF_CRG/20120514_FDF_CRG_c12.mtb	1913	43	WWSS	food_sc	3	155113	1337147286	1	0.04	0.000103896103896104	8016	1
3	Drink 2	Intake 2	24	155536	1337147709	/users/cn/jespinosa/phecomp/data/CRG/20120502_FDF_CRG/20120502_FDF_CRG/20120514_FDF_CRG_c12.mtb	2502	NA	WWSS	water	2	155512	1337147685	1	0.0600000000000001	0.0025	8017	1
3	Food 1	Intake 3	182	155723	1337147896	/users/cn/jespinosa/phecomp/data/CRG/20120502_FDF_CRG/20120502_FDF_CRG/20120514_FDF_CRG_c12.mtb	1914	40	WWSS	food_sc	3	155541	1337147714	1	0.04	0.00021978021978022	8018	1
3	Food 1	Intake 3	141	155904	1337148077	/users/cn/jespinosa/phecomp/data/CRG/20120502_FDF_CRG/20120502_FDF_CRG/20120514_FDF_CRG_c12.mtb	1915	16129	WWSS	food_sc	3	155763	1337147936	1	0.02	0.000141843971631206	8019	1
3	Drink 2	Intake 2	25	155921	1337148094	/users/cn/jespinosa/phecomp/data/CRG/20120502_FDF_CRG/20120502_FDF_CRG/20120514_FDF_CRG_c12.mtb	2503	NA	WWSS	water	2	155896	1337148069	1	0.04	0.0016	8020	1
3	Drink 2	Intake 2	29	156088	1337148261	/users/cn/jespinosa/phecomp/data/CRG/20120502_FDF_CRG/20120502_FDF_CRG/20120514_FDF_CRG_c12.mtb	2504	NA	WWSS	water	2	156059	1337148232	1	0.02	0.000689655172413793	8021	1
3	Drink 2	Intake 2	16	156241	1337148414	/users/cn/jespinosa/phecomp/data/CRG/20120502_FDF_CRG/20120502_FDF_CRG/20120514_FDF_CRG_c12.mtb	2505	NA	WWSS	water	2	156225	1337148398	1	0.02	0.00125	8022	1
3	Drink 1	Intake 1	13	156527	1337148700	/users/cn/jespinosa/phecomp/data/CRG/20120502_FDF_CRG/20120502_FDF_CRG/20120514_FDF_CRG_c12.mtb	1005	NA	WWSS	water	1	156514	1337148687	1	0.0600000000000001	0.00461538461538462	8023	1
3	Drink 1	Intake 1	15	156899	1337149072	/users/cn/jespinosa/phecomp/data/CRG/20120502_FDF_CRG/20120502_FDF_CRG/20120514_FDF_CRG_c12.mtb	1006	NA	WWSS	water	1	156884	1337149057	1	0.02	0.00133333333333333	8024	1
3	Food 1	Intake 3	421	1348	1337164627	/users/cn/jespinosa/phecomp/data/CRG/20120502_FDF_CRG/20120502_FDF_CRG/20120516_FDF_CRG_c12.mtb	2082	18606	WWSS	food_sc	3	927	1337164206	1	0.16	0.000380047505938242	8025	1
3	Drink 2	Intake 2	16	1556	1337164835	/users/cn/jespinosa/phecomp/data/CRG/20120502_FDF_CRG/20120502_FDF_CRG/20120516_FDF_CRG_c12.mtb	2610	NA	WWSS	water	2	1540	1337164819	1	0.02	0.00125	8026	1
3	Drink 2	Intake 2	16	2191	1337165470	/users/cn/jespinosa/phecomp/data/CRG/20120502_FDF_CRG/20120502_FDF_CRG/20120516_FDF_CRG_c12.mtb	2611	NA	WWSS	water	2	2175	1337165454	1	0.02	0.00125	8027	1
3	Drink 1	Intake 1	18	2263	1337165542	/users/cn/jespinosa/phecomp/data/CRG/20120502_FDF_CRG/20120502_FDF_CRG/20120516_FDF_CRG_c12.mtb	1111	NA	WWSS	water	1	2245	1337165524	1	0.06	0.00333333333333333	8028	1
3	Drink 2	Intake 2	37	2643	1337165922	/users/cn/jespinosa/phecomp/data/CRG/20120502_FDF_CRG/20120502_FDF_CRG/20120516_FDF_CRG_c12.mtb	2615	NA	WWSS	water	2	2606	1337165885	1	0.02	0.000540540540540541	8029	1
3	Food 1	Intake 3	43	19997	1337183276	/users/cn/jespinosa/phecomp/data/CRG/20120502_FDF_CRG/20120502_FDF_CRG/20120516_FDF_CRG_c12.mtb	2084	40	WWSS	food_sc	3	19954	1337183233	1	0.04	0.000930232558139535	8030	1
3	Food 1	Intake 3	259	20296	1337183575	/users/cn/jespinosa/phecomp/data/CRG/20120502_FDF_CRG/20120502_FDF_CRG/20120516_FDF_CRG_c12.mtb	2085	5340	WWSS	food_sc	3	20037	1337183316	1	0.1	0.000386100386100386	8031	1
3	Drink 1	Intake 1	14	20666	1337183945	/users/cn/jespinosa/phecomp/data/CRG/20120502_FDF_CRG/20120502_FDF_CRG/20120516_FDF_CRG_c12.mtb	1113	NA	WWSS	water	1	20652	1337183931	1	0.02	0.00142857142857143	8032	1
3	Food 1	Intake 3	44	25680	1337188959	/users/cn/jespinosa/phecomp/data/CRG/20120502_FDF_CRG/20120502_FDF_CRG/20120516_FDF_CRG_c12.mtb	2086	4	WWSS	food_sc	3	25636	1337188915	1	0.04	0.000909090909090909	8033	1
3	Food 1	Intake 3	65	25749	1337189028	/users/cn/jespinosa/phecomp/data/CRG/20120502_FDF_CRG/20120502_FDF_CRG/20120516_FDF_CRG_c12.mtb	2087	18	WWSS	food_sc	3	25684	1337188963	1	0.04	0.000615384615384615	8034	1
3	Food 1	Intake 3	171	25938	1337189217	/users/cn/jespinosa/phecomp/data/CRG/20120502_FDF_CRG/20120502_FDF_CRG/20120516_FDF_CRG_c12.mtb	2088	2367	WWSS	food_sc	3	25767	1337189046	1	0.04	0.000233918128654971	8035	1
3	Drink 1	Intake 1	33	26584	1337189863	/users/cn/jespinosa/phecomp/data/CRG/20120502_FDF_CRG/20120502_FDF_CRG/20120516_FDF_CRG_c12.mtb	1114	NA	WWSS	water	1	26551	1337189830	1	0.12	0.00363636363636364	8036	1
3	Food 2	Intake 4	113	28418	1337191697	/users/cn/jespinosa/phecomp/data/CRG/20120502_FDF_CRG/20120502_FDF_CRG/20120516_FDF_CRG_c12.mtb	3463	17	WWSS	food_sc	4	28305	1337191584	1	0.04	0.000353982300884956	8037	1
3	Food 2	Intake 4	83	28518	1337191797	/users/cn/jespinosa/phecomp/data/CRG/20120502_FDF_CRG/20120502_FDF_CRG/20120516_FDF_CRG_c12.mtb	3464	1299	WWSS	food_sc	4	28435	1337191714	1	0.02	0.000240963855421687	8038	1
3	Drink 1	Intake 1	20	29563	1337192842	/users/cn/jespinosa/phecomp/data/CRG/20120502_FDF_CRG/20120502_FDF_CRG/20120516_FDF_CRG_c12.mtb	1116	NA	WWSS	water	1	29543	1337192822	1	0.06	0.003	8039	1
3	Food 1	Intake 3	306	30123	1337193402	/users/cn/jespinosa/phecomp/data/CRG/20120502_FDF_CRG/20120502_FDF_CRG/20120516_FDF_CRG_c12.mtb	2090	8	WWSS	food_sc	3	29817	1337193096	1	0.12	0.000392156862745098	8040	1
3	Food 1	Intake 3	49	30180	1337193459	/users/cn/jespinosa/phecomp/data/CRG/20120502_FDF_CRG/20120502_FDF_CRG/20120516_FDF_CRG_c12.mtb	2091	1230	WWSS	food_sc	3	30131	1337193410	1	0.02	0.000408163265306122	8041	1
3	Drink 2	Intake 2	23	30499	1337193778	/users/cn/jespinosa/phecomp/data/CRG/20120502_FDF_CRG/20120502_FDF_CRG/20120516_FDF_CRG_c12.mtb	2620	NA	WWSS	water	2	30476	1337193755	1	0.04	0.00173913043478261	8042	1
3	Drink 1	Intake 1	15	31220	1337194499	/users/cn/jespinosa/phecomp/data/CRG/20120502_FDF_CRG/20120502_FDF_CRG/20120516_FDF_CRG_c12.mtb	1117	NA	WWSS	water	1	31205	1337194484	1	0.04	0.00266666666666667	8043	1
3	Food 1	Intake 3	346	31756	1337195035	/users/cn/jespinosa/phecomp/data/CRG/20120502_FDF_CRG/20120502_FDF_CRG/20120516_FDF_CRG_c12.mtb	2092	149	WWSS	food_sc	3	31410	1337194689	1	0.16	0.00046242774566474	8044	1
3	Drink 1	Intake 1	20	31826	1337195105	/users/cn/jespinosa/phecomp/data/CRG/20120502_FDF_CRG/20120502_FDF_CRG/20120516_FDF_CRG_c12.mtb	1118	NA	WWSS	water	1	31806	1337195085	1	0.08	0.004	8045	1
3	Food 1	Intake 3	47	31952	1337195231	/users/cn/jespinosa/phecomp/data/CRG/20120502_FDF_CRG/20120502_FDF_CRG/20120516_FDF_CRG_c12.mtb	2094	943	WWSS	food_sc	3	31905	1337195184	1	0.02	0.000425531914893617	8046	1
3	Drink 2	Intake 2	19	32172	1337195451	/users/cn/jespinosa/phecomp/data/CRG/20120502_FDF_CRG/20120502_FDF_CRG/20120516_FDF_CRG_c12.mtb	2621	NA	WWSS	water	2	32153	1337195432	1	0.06	0.00315789473684211	8047	1
3	Food 1	Intake 3	223	33118	1337196397	/users/cn/jespinosa/phecomp/data/CRG/20120502_FDF_CRG/20120502_FDF_CRG/20120516_FDF_CRG_c12.mtb	2095	2004	WWSS	food_sc	3	32895	1337196174	1	0.1	0.000448430493273543	8048	1
3	Drink 1	Intake 1	20	33389	1337196668	/users/cn/jespinosa/phecomp/data/CRG/20120502_FDF_CRG/20120502_FDF_CRG/20120516_FDF_CRG_c12.mtb	1120	NA	WWSS	water	1	33369	1337196648	1	0.06	0.003	8049	1
3	Food 1	Intake 3	581	35703	1337198982	/users/cn/jespinosa/phecomp/data/CRG/20120502_FDF_CRG/20120502_FDF_CRG/20120516_FDF_CRG_c12.mtb	2097	133	WWSS	food_sc	3	35122	1337198401	1	0.14	0.000240963855421687	8050	1
3	Drink 1	Intake 1	18	35644	1337198923	/users/cn/jespinosa/phecomp/data/CRG/20120502_FDF_CRG/20120502_FDF_CRG/20120516_FDF_CRG_c12.mtb	1121	NA	WWSS	water	1	35626	1337198905	1	0.04	0.00222222222222222	8051	1
3	Drink 1	Intake 1	14	35836	1337199115	/users/cn/jespinosa/phecomp/data/CRG/20120502_FDF_CRG/20120502_FDF_CRG/20120516_FDF_CRG_c12.mtb	1124	NA	WWSS	water	1	35822	1337199101	1	0.04	0.00285714285714286	8052	1
3	Food 1	Intake 3	261	36097	1337199376	/users/cn/jespinosa/phecomp/data/CRG/20120502_FDF_CRG/20120502_FDF_CRG/20120516_FDF_CRG_c12.mtb	2099	1180	WWSS	food_sc	3	35836	1337199115	1	0.02	7.66283524904215e-05	8053	1
3	Drink 1	Intake 1	20	36058	1337199337	/users/cn/jespinosa/phecomp/data/CRG/20120502_FDF_CRG/20120502_FDF_CRG/20120516_FDF_CRG_c12.mtb	1125	NA	WWSS	water	1	36038	1337199317	1	0.02	0.001	8054	1
3	Drink 1	Intake 1	15	36415	1337199694	/users/cn/jespinosa/phecomp/data/CRG/20120502_FDF_CRG/20120502_FDF_CRG/20120516_FDF_CRG_c12.mtb	1126	NA	WWSS	water	1	36400	1337199679	1	0.08	0.00533333333333333	8055	1
3	Drink 1	Intake 1	16	36860	1337200139	/users/cn/jespinosa/phecomp/data/CRG/20120502_FDF_CRG/20120502_FDF_CRG/20120516_FDF_CRG_c12.mtb	1127	NA	WWSS	water	1	36844	1337200123	1	0.0600000000000001	0.00375000000000001	8056	1
3	Food 1	Intake 3	72	37349	1337200628	/users/cn/jespinosa/phecomp/data/CRG/20120502_FDF_CRG/20120502_FDF_CRG/20120516_FDF_CRG_c12.mtb	2104	34	WWSS	food_sc	3	37277	1337200556	1	0.02	0.000277777777777778	8057	1
3	Food 1	Intake 3	12	37395	1337200674	/users/cn/jespinosa/phecomp/data/CRG/20120502_FDF_CRG/20120502_FDF_CRG/20120516_FDF_CRG_c12.mtb	2105	37	WWSS	food_sc	3	37383	1337200662	1	0.04	0.00333333333333333	8058	1
3	Food 1	Intake 3	105	37537	1337200816	/users/cn/jespinosa/phecomp/data/CRG/20120502_FDF_CRG/20120502_FDF_CRG/20120516_FDF_CRG_c12.mtb	2106	76	WWSS	food_sc	3	37432	1337200711	1	0.02	0.00019047619047619	8059	1
3	Food 1	Intake 3	785	38398	1337201677	/users/cn/jespinosa/phecomp/data/CRG/20120502_FDF_CRG/20120502_FDF_CRG/20120516_FDF_CRG_c12.mtb	2108	9	WWSS	food_sc	3	37613	1337200892	1	0.26	0.000331210191082803	8060	1
3	Drink 1	Intake 1	12	38156	1337201435	/users/cn/jespinosa/phecomp/data/CRG/20120502_FDF_CRG/20120502_FDF_CRG/20120516_FDF_CRG_c12.mtb	1128	NA	WWSS	water	1	38144	1337201423	1	0.0399999999999999	0.00333333333333332	8061	1
3	Food 1	Intake 3	71	38478	1337201757	/users/cn/jespinosa/phecomp/data/CRG/20120502_FDF_CRG/20120502_FDF_CRG/20120516_FDF_CRG_c12.mtb	2109	819	WWSS	food_sc	3	38407	1337201686	1	0.0599999999999998	0.000845070422535208	8062	1
3	Drink 2	Intake 2	27	38516	1337201795	/users/cn/jespinosa/phecomp/data/CRG/20120502_FDF_CRG/20120502_FDF_CRG/20120516_FDF_CRG_c12.mtb	2624	NA	WWSS	water	2	38489	1337201768	1	0.08	0.00296296296296296	8063	1
3	Drink 1	Intake 1	20	38762	1337202041	/users/cn/jespinosa/phecomp/data/CRG/20120502_FDF_CRG/20120502_FDF_CRG/20120516_FDF_CRG_c12.mtb	1129	NA	WWSS	water	1	38742	1337202021	1	0.0600000000000001	0.00300000000000001	8064	1
3	Food 2	Intake 4	134	39431	1337202710	/users/cn/jespinosa/phecomp/data/CRG/20120502_FDF_CRG/20120502_FDF_CRG/20120516_FDF_CRG_c12.mtb	3474	2055	WWSS	food_sc	4	39297	1337202576	1	0.02	0.000149253731343284	8065	1
3	Drink 2	Intake 2	12	39548	1337202827	/users/cn/jespinosa/phecomp/data/CRG/20120502_FDF_CRG/20120502_FDF_CRG/20120516_FDF_CRG_c12.mtb	2625	NA	WWSS	water	2	39536	1337202815	1	0.02	0.00166666666666667	8066	1
3	Food 1	Intake 3	271	41757	1337205036	/users/cn/jespinosa/phecomp/data/CRG/20120502_FDF_CRG/20120502_FDF_CRG/20120516_FDF_CRG_c12.mtb	2111	1112	WWSS	food_sc	3	41486	1337204765	1	0.0800000000000001	0.000295202952029521	8067	1
3	Drink 2	Intake 2	16	41774	1337205053	/users/cn/jespinosa/phecomp/data/CRG/20120502_FDF_CRG/20120502_FDF_CRG/20120516_FDF_CRG_c12.mtb	2627	NA	WWSS	water	2	41758	1337205037	1	0.02	0.00125	8068	1
3	Drink 2	Intake 2	37	42453	1337205732	/users/cn/jespinosa/phecomp/data/CRG/20120502_FDF_CRG/20120502_FDF_CRG/20120516_FDF_CRG_c12.mtb	2630	NA	WWSS	water	2	42416	1337205695	1	0.02	0.000540540540540541	8069	1
3	Drink 2	Intake 2	49	42542	1337205821	/users/cn/jespinosa/phecomp/data/CRG/20120502_FDF_CRG/20120502_FDF_CRG/20120516_FDF_CRG_c12.mtb	2631	NA	WWSS	water	2	42493	1337205772	1	0.04	0.000816326530612245	8070	1
3	Drink 2	Intake 2	60	42608	1337205887	/users/cn/jespinosa/phecomp/data/CRG/20120502_FDF_CRG/20120502_FDF_CRG/20120516_FDF_CRG_c12.mtb	2632	NA	WWSS	water	2	42548	1337205827	1	0.06	0.001	8071	1
3	Drink 2	Intake 2	23	42733	1337206012	/users/cn/jespinosa/phecomp/data/CRG/20120502_FDF_CRG/20120502_FDF_CRG/20120516_FDF_CRG_c12.mtb	2633	NA	WWSS	water	2	42710	1337205989	1	0.04	0.00173913043478261	8072	1
3	Food 2	Intake 4	444	43313	1337206592	/users/cn/jespinosa/phecomp/data/CRG/20120502_FDF_CRG/20120502_FDF_CRG/20120516_FDF_CRG_c12.mtb	3478	126	WWSS	food_sc	4	42869	1337206148	1	0.1	0.000225225225225225	8073	1
3	Drink 2	Intake 2	21	43336	1337206615	/users/cn/jespinosa/phecomp/data/CRG/20120502_FDF_CRG/20120502_FDF_CRG/20120516_FDF_CRG_c12.mtb	2635	NA	WWSS	water	2	43315	1337206594	1	0.06	0.00285714285714286	8074	1
3	Food 2	Intake 4	115	43554	1337206833	/users/cn/jespinosa/phecomp/data/CRG/20120502_FDF_CRG/20120502_FDF_CRG/20120516_FDF_CRG_c12.mtb	3480	4116	WWSS	food_sc	4	43439	1337206718	1	0.02	0.000173913043478261	8075	1
3	Drink 1	Intake 1	24	43578	1337206857	/users/cn/jespinosa/phecomp/data/CRG/20120502_FDF_CRG/20120502_FDF_CRG/20120516_FDF_CRG_c12.mtb	1132	NA	WWSS	water	1	43554	1337206833	1	0.1	0.00416666666666667	8076	1
3	Food 1	Intake 3	401	48071	1337211350	/users/cn/jespinosa/phecomp/data/CRG/20120502_FDF_CRG/20120502_FDF_CRG/20120516_FDF_CRG_c12.mtb	2117	363	WWSS	food_sc	3	47670	1337210949	1	0.1	0.000249376558603491	8077	1
3	Drink 1	Intake 1	16	48423	1337211702	/users/cn/jespinosa/phecomp/data/CRG/20120502_FDF_CRG/20120502_FDF_CRG/20120516_FDF_CRG_c12.mtb	1134	NA	WWSS	water	1	48407	1337211686	1	0.0599999999999999	0.00374999999999999	8078	1
3	Food 1	Intake 3	179	48613	1337211892	/users/cn/jespinosa/phecomp/data/CRG/20120502_FDF_CRG/20120502_FDF_CRG/20120516_FDF_CRG_c12.mtb	2119	1943	WWSS	food_sc	3	48434	1337211713	1	0.04	0.000223463687150838	8079	1
3	Drink 1	Intake 1	20	48632	1337211911	/users/cn/jespinosa/phecomp/data/CRG/20120502_FDF_CRG/20120502_FDF_CRG/20120516_FDF_CRG_c12.mtb	1135	NA	WWSS	water	1	48612	1337211891	1	0.04	0.002	8080	1
3	Drink 1	Intake 1	13	48807	1337212086	/users/cn/jespinosa/phecomp/data/CRG/20120502_FDF_CRG/20120502_FDF_CRG/20120516_FDF_CRG_c12.mtb	1136	NA	WWSS	water	1	48794	1337212073	1	0.04	0.00307692307692308	8081	1
3	Drink 2	Intake 2	116	49493	1337212772	/users/cn/jespinosa/phecomp/data/CRG/20120502_FDF_CRG/20120502_FDF_CRG/20120516_FDF_CRG_c12.mtb	2638	NA	WWSS	water	2	49377	1337212656	1	0.08	0.000689655172413793	8082	1
3	Drink 2	Intake 2	47	49554	1337212833	/users/cn/jespinosa/phecomp/data/CRG/20120502_FDF_CRG/20120502_FDF_CRG/20120516_FDF_CRG_c12.mtb	2639	NA	WWSS	water	2	49507	1337212786	1	0.02	0.000425531914893617	8083	1
3	Food 1	Intake 3	180	50736	1337214015	/users/cn/jespinosa/phecomp/data/CRG/20120502_FDF_CRG/20120502_FDF_CRG/20120516_FDF_CRG_c12.mtb	2124	14	WWSS	food_sc	3	50556	1337213835	1	0.04	0.000222222222222222	8084	1
3	Food 1	Intake 3	161	50911	1337214190	/users/cn/jespinosa/phecomp/data/CRG/20120502_FDF_CRG/20120502_FDF_CRG/20120516_FDF_CRG_c12.mtb	2125	1855	WWSS	food_sc	3	50750	1337214029	1	0.02	0.000124223602484472	8085	1
3	Drink 1	Intake 1	22	50925	1337214204	/users/cn/jespinosa/phecomp/data/CRG/20120502_FDF_CRG/20120502_FDF_CRG/20120516_FDF_CRG_c12.mtb	1138	NA	WWSS	water	1	50903	1337214182	1	0.04	0.00181818181818182	8086	1
3	Drink 1	Intake 1	17	51076	1337214355	/users/cn/jespinosa/phecomp/data/CRG/20120502_FDF_CRG/20120502_FDF_CRG/20120516_FDF_CRG_c12.mtb	1139	NA	WWSS	water	1	51059	1337214338	1	0.0800000000000001	0.00470588235294118	8087	1
3	Drink 2	Intake 2	30	51176	1337214455	/users/cn/jespinosa/phecomp/data/CRG/20120502_FDF_CRG/20120502_FDF_CRG/20120516_FDF_CRG_c12.mtb	2642	NA	WWSS	water	2	51146	1337214425	1	0.02	0.000666666666666667	8088	1
3	Food 1	Intake 3	604	53370	1337216649	/users/cn/jespinosa/phecomp/data/CRG/20120502_FDF_CRG/20120502_FDF_CRG/20120516_FDF_CRG_c12.mtb	2127	6833	WWSS	food_sc	3	52766	1337216045	1	0.0599999999999998	9.93377483443705e-05	8089	1
3	Drink 1	Intake 1	20	53382	1337216661	/users/cn/jespinosa/phecomp/data/CRG/20120502_FDF_CRG/20120502_FDF_CRG/20120516_FDF_CRG_c12.mtb	1143	NA	WWSS	water	1	53362	1337216641	1	0.0799999999999998	0.00399999999999999	8090	1
3	Drink 1	Intake 1	15	53548	1337216827	/users/cn/jespinosa/phecomp/data/CRG/20120502_FDF_CRG/20120502_FDF_CRG/20120516_FDF_CRG_c12.mtb	1144	NA	WWSS	water	1	53533	1337216812	1	0.02	0.00133333333333333	8091	1
3	Food 1	Intake 3	604	60807	1337224086	/users/cn/jespinosa/phecomp/data/CRG/20120502_FDF_CRG/20120502_FDF_CRG/20120516_FDF_CRG_c12.mtb	2133	508	WWSS	food_sc	3	60203	1337223482	1	0.12	0.000198675496688742	8092	1
3	Drink 1	Intake 1	17	60837	1337224116	/users/cn/jespinosa/phecomp/data/CRG/20120502_FDF_CRG/20120502_FDF_CRG/20120516_FDF_CRG_c12.mtb	1145	NA	WWSS	water	1	60820	1337224099	1	0.04	0.00235294117647059	8093	1
3	Drink 2	Intake 2	19	60965	1337224244	/users/cn/jespinosa/phecomp/data/CRG/20120502_FDF_CRG/20120502_FDF_CRG/20120516_FDF_CRG_c12.mtb	2647	NA	WWSS	water	2	60946	1337224225	1	0.04	0.00210526315789474	8094	1
3	Drink 2	Intake 2	24	61166	1337224445	/users/cn/jespinosa/phecomp/data/CRG/20120502_FDF_CRG/20120502_FDF_CRG/20120516_FDF_CRG_c12.mtb	2649	NA	WWSS	water	2	61142	1337224421	1	0.02	0.000833333333333333	8095	1
3	Drink 1	Intake 1	17	61254	1337224533	/users/cn/jespinosa/phecomp/data/CRG/20120502_FDF_CRG/20120502_FDF_CRG/20120516_FDF_CRG_c12.mtb	1146	NA	WWSS	water	1	61237	1337224516	1	0.04	0.00235294117647059	8096	1
3	Food 1	Intake 3	534	61849	1337225128	/users/cn/jespinosa/phecomp/data/CRG/20120502_FDF_CRG/20120502_FDF_CRG/20120516_FDF_CRG_c12.mtb	2135	2367	WWSS	food_sc	3	61315	1337224594	1	0.0800000000000001	0.000149812734082397	8097	1
3	Drink 1	Intake 1	28	61882	1337225161	/users/cn/jespinosa/phecomp/data/CRG/20120502_FDF_CRG/20120502_FDF_CRG/20120516_FDF_CRG_c12.mtb	1147	NA	WWSS	water	1	61854	1337225133	1	0.12	0.00428571428571429	8098	1
3	Drink 2	Intake 2	26	61955	1337225234	/users/cn/jespinosa/phecomp/data/CRG/20120502_FDF_CRG/20120502_FDF_CRG/20120516_FDF_CRG_c12.mtb	2651	NA	WWSS	water	2	61929	1337225208	1	0.08	0.00307692307692308	8099	1
3	Food 1	Intake 3	158	64374	1337227653	/users/cn/jespinosa/phecomp/data/CRG/20120502_FDF_CRG/20120502_FDF_CRG/20120516_FDF_CRG_c12.mtb	2137	2406	WWSS	food_sc	3	64216	1337227495	1	0.02	0.000126582278481013	8100	1
3	Food 1	Intake 3	379	67159	1337230438	/users/cn/jespinosa/phecomp/data/CRG/20120502_FDF_CRG/20120502_FDF_CRG/20120516_FDF_CRG_c12.mtb	2139	1879	WWSS	food_sc	3	66780	1337230059	1	0.02	5.27704485488127e-05	8101	1
3	Drink 1	Intake 1	38	67396	1337230675	/users/cn/jespinosa/phecomp/data/CRG/20120502_FDF_CRG/20120502_FDF_CRG/20120516_FDF_CRG_c12.mtb	1148	NA	WWSS	water	1	67358	1337230637	1	0.04	0.00105263157894737	8102	1
3	Food 1	Intake 3	404	69442	1337232721	/users/cn/jespinosa/phecomp/data/CRG/20120502_FDF_CRG/20120502_FDF_CRG/20120516_FDF_CRG_c12.mtb	2141	529	WWSS	food_sc	3	69038	1337232317	1	0.04	9.9009900990099e-05	8103	1
3	Drink 1	Intake 1	16	69686	1337232965	/users/cn/jespinosa/phecomp/data/CRG/20120502_FDF_CRG/20120502_FDF_CRG/20120516_FDF_CRG_c12.mtb	1149	NA	WWSS	water	1	69670	1337232949	1	0.02	0.00125	8104	1
3	Food 1	Intake 3	54	70025	1337233304	/users/cn/jespinosa/phecomp/data/CRG/20120502_FDF_CRG/20120502_FDF_CRG/20120516_FDF_CRG_c12.mtb	2143	63	WWSS	food_sc	3	69971	1337233250	1	0.02	0.00037037037037037	8105	1
3	Food 2	Intake 4	517	70605	1337233884	/users/cn/jespinosa/phecomp/data/CRG/20120502_FDF_CRG/20120502_FDF_CRG/20120516_FDF_CRG_c12.mtb	3520	704	WWSS	food_sc	4	70088	1337233367	1	0.22	0.000425531914893617	8106	1
3	Drink 1	Intake 1	31	70636	1337233915	/users/cn/jespinosa/phecomp/data/CRG/20120502_FDF_CRG/20120502_FDF_CRG/20120516_FDF_CRG_c12.mtb	1150	NA	WWSS	water	1	70605	1337233884	1	0.12	0.00387096774193548	8107	1
3	Drink 1	Intake 1	18	70667	1337233946	/users/cn/jespinosa/phecomp/data/CRG/20120502_FDF_CRG/20120502_FDF_CRG/20120516_FDF_CRG_c12.mtb	1151	NA	WWSS	water	1	70649	1337233928	1	0.04	0.00222222222222222	8108	1
3	Drink 1	Intake 1	18	70734	1337234013	/users/cn/jespinosa/phecomp/data/CRG/20120502_FDF_CRG/20120502_FDF_CRG/20120516_FDF_CRG_c12.mtb	1152	NA	WWSS	water	1	70716	1337233995	1	0.0399999999999998	0.00222222222222221	8109	1
3	Drink 2	Intake 2	18	71269	1337234548	/users/cn/jespinosa/phecomp/data/CRG/20120502_FDF_CRG/20120502_FDF_CRG/20120516_FDF_CRG_c12.mtb	2654	NA	WWSS	water	2	71251	1337234530	1	0.0599999999999999	0.00333333333333333	8110	1
3	Food 2	Intake 4	154	71463	1337234742	/users/cn/jespinosa/phecomp/data/CRG/20120502_FDF_CRG/20120502_FDF_CRG/20120516_FDF_CRG_c12.mtb	3524	6	WWSS	food_sc	4	71309	1337234588	1	0.04	0.00025974025974026	8111	1
3	Food 2	Intake 4	49	71518	1337234797	/users/cn/jespinosa/phecomp/data/CRG/20120502_FDF_CRG/20120502_FDF_CRG/20120516_FDF_CRG_c12.mtb	3525	7	WWSS	food_sc	4	71469	1337234748	1	0.04	0.000816326530612245	8112	1
3	Food 2	Intake 4	91	71616	1337234895	/users/cn/jespinosa/phecomp/data/CRG/20120502_FDF_CRG/20120502_FDF_CRG/20120516_FDF_CRG_c12.mtb	3526	7470	WWSS	food_sc	4	71525	1337234804	1	0.04	0.00043956043956044	8113	1
3	Drink 1	Intake 1	19	71643	1337234922	/users/cn/jespinosa/phecomp/data/CRG/20120502_FDF_CRG/20120502_FDF_CRG/20120516_FDF_CRG_c12.mtb	1153	NA	WWSS	water	1	71624	1337234903	1	0.0600000000000001	0.00315789473684211	8114	1
3	Drink 1	Intake 1	17	71763	1337235042	/users/cn/jespinosa/phecomp/data/CRG/20120502_FDF_CRG/20120502_FDF_CRG/20120516_FDF_CRG_c12.mtb	1154	NA	WWSS	water	1	71746	1337235025	1	0.04	0.00235294117647059	8115	1
3	Drink 1	Intake 1	14	72522	1337235801	/users/cn/jespinosa/phecomp/data/CRG/20120502_FDF_CRG/20120502_FDF_CRG/20120516_FDF_CRG_c12.mtb	1156	NA	WWSS	water	1	72508	1337235787	1	0.0399999999999998	0.00285714285714284	8116	1
3	Food 2	Intake 4	462	79548	1337242827	/users/cn/jespinosa/phecomp/data/CRG/20120502_FDF_CRG/20120502_FDF_CRG/20120516_FDF_CRG_c12.mtb	3529	798	WWSS	food_sc	4	79086	1337242365	1	0.22	0.000476190476190476	8117	1
3	Drink 2	Intake 2	15	79572	1337242851	/users/cn/jespinosa/phecomp/data/CRG/20120502_FDF_CRG/20120502_FDF_CRG/20120516_FDF_CRG_c12.mtb	2657	NA	WWSS	water	2	79557	1337242836	1	0.02	0.00133333333333333	8118	1
3	Drink 1	Intake 1	12	79636	1337242915	/users/cn/jespinosa/phecomp/data/CRG/20120502_FDF_CRG/20120502_FDF_CRG/20120516_FDF_CRG_c12.mtb	1157	NA	WWSS	water	1	79624	1337242903	1	0.0600000000000001	0.00500000000000001	8119	1
3	Drink 1	Intake 1	14	79890	1337243169	/users/cn/jespinosa/phecomp/data/CRG/20120502_FDF_CRG/20120502_FDF_CRG/20120516_FDF_CRG_c12.mtb	1158	NA	WWSS	water	1	79876	1337243155	1	0.1	0.00714285714285714	8120	1
3	Food 2	Intake 4	159	80505	1337243784	/users/cn/jespinosa/phecomp/data/CRG/20120502_FDF_CRG/20120502_FDF_CRG/20120516_FDF_CRG_c12.mtb	3530	5090	WWSS	food_sc	4	80346	1337243625	1	0.0599999999999999	0.000377358490566037	8121	1
3	Drink 1	Intake 1	14	80625	1337243904	/users/cn/jespinosa/phecomp/data/CRG/20120502_FDF_CRG/20120502_FDF_CRG/20120516_FDF_CRG_c12.mtb	1159	NA	WWSS	water	1	80611	1337243890	1	0.02	0.00142857142857143	8122	1
3	Food 2	Intake 4	277	85872	1337249151	/users/cn/jespinosa/phecomp/data/CRG/20120502_FDF_CRG/20120502_FDF_CRG/20120516_FDF_CRG_c12.mtb	3531	23040	WWSS	food_sc	4	85595	1337248874	1	0.42	0.00151624548736462	8123	1
3	Drink 1	Intake 1	14	86157	1337249436	/users/cn/jespinosa/phecomp/data/CRG/20120502_FDF_CRG/20120502_FDF_CRG/20120516_FDF_CRG_c12.mtb	1160	NA	WWSS	water	1	86143	1337249422	1	0.0600000000000001	0.00428571428571429	8124	1
3	Drink 1	Intake 1	16	86232	1337249511	/users/cn/jespinosa/phecomp/data/CRG/20120502_FDF_CRG/20120502_FDF_CRG/20120516_FDF_CRG_c12.mtb	1161	NA	WWSS	water	1	86216	1337249495	1	0.02	0.00125	8125	1
3	Drink 2	Intake 2	12	86681	1337249960	/users/cn/jespinosa/phecomp/data/CRG/20120502_FDF_CRG/20120502_FDF_CRG/20120516_FDF_CRG_c12.mtb	2659	NA	WWSS	water	2	86669	1337249948	1	0.0800000000000001	0.00666666666666667	8126	1
3	Drink 1	Intake 1	9	86994	1337250273	/users/cn/jespinosa/phecomp/data/CRG/20120502_FDF_CRG/20120502_FDF_CRG/20120516_FDF_CRG_c12.mtb	1162	NA	WWSS	water	1	86985	1337250264	1	0.04	0.00444444444444444	8127	1
3	Drink 2	Intake 2	24	87372	1337250651	/users/cn/jespinosa/phecomp/data/CRG/20120502_FDF_CRG/20120502_FDF_CRG/20120516_FDF_CRG_c12.mtb	2662	NA	WWSS	water	2	87348	1337250627	1	0.04	0.00166666666666667	8128	1
3	Drink 2	Intake 2	29	108762	1337272041	/users/cn/jespinosa/phecomp/data/CRG/20120502_FDF_CRG/20120502_FDF_CRG/20120516_FDF_CRG_c12.mtb	2665	NA	WWSS	water	2	108733	1337272012	1	0.02	0.000689655172413793	8129	1
3	Food 2	Intake 4	17	108929	1337272208	/users/cn/jespinosa/phecomp/data/CRG/20120502_FDF_CRG/20120502_FDF_CRG/20120516_FDF_CRG_c12.mtb	3539	5516	WWSS	food_sc	4	108912	1337272191	1	0.02	0.00117647058823529	8130	1
3	Food 2	Intake 4	792	115237	1337278516	/users/cn/jespinosa/phecomp/data/CRG/20120502_FDF_CRG/20120502_FDF_CRG/20120516_FDF_CRG_c12.mtb	3543	399	WWSS	food_sc	4	114445	1337277724	1	0.16	0.000202020202020202	8131	1
3	Drink 1	Intake 1	12	115461	1337278740	/users/cn/jespinosa/phecomp/data/CRG/20120502_FDF_CRG/20120502_FDF_CRG/20120516_FDF_CRG_c12.mtb	1165	NA	WWSS	water	1	115449	1337278728	1	0.04	0.00333333333333333	8132	1
3	Food 2	Intake 4	290	115926	1337279205	/users/cn/jespinosa/phecomp/data/CRG/20120502_FDF_CRG/20120502_FDF_CRG/20120516_FDF_CRG_c12.mtb	3545	867	WWSS	food_sc	4	115636	1337278915	1	0.0800000000000001	0.000275862068965518	8133	1
3	Drink 2	Intake 2	24	115949	1337279228	/users/cn/jespinosa/phecomp/data/CRG/20120502_FDF_CRG/20120502_FDF_CRG/20120516_FDF_CRG_c12.mtb	2667	NA	WWSS	water	2	115925	1337279204	1	0.04	0.00166666666666667	8134	1
3	Drink 1	Intake 1	16	116195	1337279474	/users/cn/jespinosa/phecomp/data/CRG/20120502_FDF_CRG/20120502_FDF_CRG/20120516_FDF_CRG_c12.mtb	1166	NA	WWSS	water	1	116179	1337279458	1	0.04	0.0025	8135	1
3	Drink 2	Intake 2	18	116577	1337279856	/users/cn/jespinosa/phecomp/data/CRG/20120502_FDF_CRG/20120502_FDF_CRG/20120516_FDF_CRG_c12.mtb	2668	NA	WWSS	water	2	116559	1337279838	1	0.0600000000000001	0.00333333333333334	8136	1
3	Food 2	Intake 4	289	117082	1337280361	/users/cn/jespinosa/phecomp/data/CRG/20120502_FDF_CRG/20120502_FDF_CRG/20120516_FDF_CRG_c12.mtb	3546	1428	WWSS	food_sc	4	116793	1337280072	1	0.1	0.000346020761245675	8137	1
3	Drink 1	Intake 1	15	117109	1337280388	/users/cn/jespinosa/phecomp/data/CRG/20120502_FDF_CRG/20120502_FDF_CRG/20120516_FDF_CRG_c12.mtb	1167	NA	WWSS	water	1	117094	1337280373	1	0.0399999999999996	0.00266666666666664	8138	1
3	Drink 1	Intake 1	12	117724	1337281003	/users/cn/jespinosa/phecomp/data/CRG/20120502_FDF_CRG/20120502_FDF_CRG/20120516_FDF_CRG_c12.mtb	1168	NA	WWSS	water	1	117712	1337280991	1	0.0200000000000005	0.00166666666666671	8139	1
3	Drink 1	Intake 1	16	118010	1337281289	/users/cn/jespinosa/phecomp/data/CRG/20120502_FDF_CRG/20120502_FDF_CRG/20120516_FDF_CRG_c12.mtb	1169	NA	WWSS	water	1	117994	1337281273	1	0.0399999999999996	0.00249999999999997	8140	1
3	Food 2	Intake 4	507	119017	1337282296	/users/cn/jespinosa/phecomp/data/CRG/20120502_FDF_CRG/20120502_FDF_CRG/20120516_FDF_CRG_c12.mtb	3548	43	WWSS	food_sc	4	118510	1337281789	1	0.0999999999999999	0.00019723865877712	8141	1
3	Drink 2	Intake 2	25	119039	1337282318	/users/cn/jespinosa/phecomp/data/CRG/20120502_FDF_CRG/20120502_FDF_CRG/20120516_FDF_CRG_c12.mtb	2669	NA	WWSS	water	2	119014	1337282293	1	0.04	0.0016	8142	1
3	Food 2	Intake 4	355	119415	1337282694	/users/cn/jespinosa/phecomp/data/CRG/20120502_FDF_CRG/20120502_FDF_CRG/20120516_FDF_CRG_c12.mtb	3549	1151	WWSS	food_sc	4	119060	1337282339	1	0.14	0.000394366197183099	8143	1
3	Drink 2	Intake 2	25	119436	1337282715	/users/cn/jespinosa/phecomp/data/CRG/20120502_FDF_CRG/20120502_FDF_CRG/20120516_FDF_CRG_c12.mtb	2670	NA	WWSS	water	2	119411	1337282690	1	0.0799999999999998	0.00319999999999999	8144	1
3	Drink 1	Intake 1	24	119528	1337282807	/users/cn/jespinosa/phecomp/data/CRG/20120502_FDF_CRG/20120502_FDF_CRG/20120516_FDF_CRG_c12.mtb	1170	NA	WWSS	water	1	119504	1337282783	1	0.0600000000000001	0.0025	8145	1
3	Drink 1	Intake 1	25	120043	1337283322	/users/cn/jespinosa/phecomp/data/CRG/20120502_FDF_CRG/20120502_FDF_CRG/20120516_FDF_CRG_c12.mtb	1171	NA	WWSS	water	1	120018	1337283297	1	0.04	0.0016	8146	1
3	Drink 2	Intake 2	11	120190	1337283469	/users/cn/jespinosa/phecomp/data/CRG/20120502_FDF_CRG/20120502_FDF_CRG/20120516_FDF_CRG_c12.mtb	2674	NA	WWSS	water	2	120179	1337283458	1	0.02	0.00181818181818182	8147	1
3	Food 2	Intake 4	401	120967	1337284246	/users/cn/jespinosa/phecomp/data/CRG/20120502_FDF_CRG/20120502_FDF_CRG/20120516_FDF_CRG_c12.mtb	3553	1673	WWSS	food_sc	4	120566	1337283845	1	0.0800000000000001	0.000199501246882793	8148	1
3	Drink 1	Intake 1	18	121072	1337284351	/users/cn/jespinosa/phecomp/data/CRG/20120502_FDF_CRG/20120502_FDF_CRG/20120516_FDF_CRG_c12.mtb	1172	NA	WWSS	water	1	121054	1337284333	1	0.04	0.00222222222222222	8149	1
3	Food 2	Intake 4	640	123280	1337286559	/users/cn/jespinosa/phecomp/data/CRG/20120502_FDF_CRG/20120502_FDF_CRG/20120516_FDF_CRG_c12.mtb	3556	601	WWSS	food_sc	4	122640	1337285919	1	0.18	0.00028125	8150	1
3	Drink 2	Intake 2	17	123319	1337286598	/users/cn/jespinosa/phecomp/data/CRG/20120502_FDF_CRG/20120502_FDF_CRG/20120516_FDF_CRG_c12.mtb	2677	NA	WWSS	water	2	123302	1337286581	1	0.04	0.00235294117647059	8151	1
3	Drink 1	Intake 1	16	123459	1337286738	/users/cn/jespinosa/phecomp/data/CRG/20120502_FDF_CRG/20120502_FDF_CRG/20120516_FDF_CRG_c12.mtb	1173	NA	WWSS	water	1	123443	1337286722	1	0.04	0.0025	8152	1
3	Food 1	Intake 3	38	123919	1337287198	/users/cn/jespinosa/phecomp/data/CRG/20120502_FDF_CRG/20120502_FDF_CRG/20120516_FDF_CRG_c12.mtb	2147	1120	WWSS	food_sc	3	123881	1337287160	1	0.02	0.000526315789473684	8153	1
3	Food 2	Intake 4	450	125489	1337288768	/users/cn/jespinosa/phecomp/data/CRG/20120502_FDF_CRG/20120502_FDF_CRG/20120516_FDF_CRG_c12.mtb	3559	1235	WWSS	food_sc	4	125039	1337288318	1	0.18	0.0004	8154	1
3	Drink 1	Intake 1	16	125544	1337288823	/users/cn/jespinosa/phecomp/data/CRG/20120502_FDF_CRG/20120502_FDF_CRG/20120516_FDF_CRG_c12.mtb	1175	NA	WWSS	water	1	125528	1337288807	1	0.04	0.0025	8155	1
3	Food 2	Intake 4	430	127154	1337290433	/users/cn/jespinosa/phecomp/data/CRG/20120502_FDF_CRG/20120502_FDF_CRG/20120516_FDF_CRG_c12.mtb	3560	2376	WWSS	food_sc	4	126724	1337290003	1	0.2	0.000465116279069767	8156	1
3	Drink 2	Intake 2	20	127168	1337290447	/users/cn/jespinosa/phecomp/data/CRG/20120502_FDF_CRG/20120502_FDF_CRG/20120516_FDF_CRG_c12.mtb	2679	NA	WWSS	water	2	127148	1337290427	1	0.04	0.002	8157	1
3	Drink 1	Intake 1	16	127180	1337290459	/users/cn/jespinosa/phecomp/data/CRG/20120502_FDF_CRG/20120502_FDF_CRG/20120516_FDF_CRG_c12.mtb	1176	NA	WWSS	water	1	127164	1337290443	1	0.04	0.0025	8158	1
3	Drink 1	Intake 1	17	127380	1337290659	/users/cn/jespinosa/phecomp/data/CRG/20120502_FDF_CRG/20120502_FDF_CRG/20120516_FDF_CRG_c12.mtb	1177	NA	WWSS	water	1	127363	1337290642	1	0.04	0.00235294117647059	8159	1
3	Drink 1	Intake 1	12	128610	1337291889	/users/cn/jespinosa/phecomp/data/CRG/20120502_FDF_CRG/20120502_FDF_CRG/20120516_FDF_CRG_c12.mtb	1178	NA	WWSS	water	1	128598	1337291877	1	0.02	0.00166666666666667	8160	1
3	Drink 1	Intake 1	18	129167	1337292446	/users/cn/jespinosa/phecomp/data/CRG/20120502_FDF_CRG/20120502_FDF_CRG/20120516_FDF_CRG_c12.mtb	1179	NA	WWSS	water	1	129149	1337292428	1	0.02	0.00111111111111111	8161	1
3	Food 2	Intake 4	208	129738	1337293017	/users/cn/jespinosa/phecomp/data/CRG/20120502_FDF_CRG/20120502_FDF_CRG/20120516_FDF_CRG_c12.mtb	3565	106	WWSS	food_sc	4	129530	1337292809	1	0.0800000000000001	0.000384615384615385	8162	1
3	Drink 2	Intake 2	25	129763	1337293042	/users/cn/jespinosa/phecomp/data/CRG/20120502_FDF_CRG/20120502_FDF_CRG/20120516_FDF_CRG_c12.mtb	2682	NA	WWSS	water	2	129738	1337293017	1	0.0799999999999998	0.00319999999999999	8163	1
3	Drink 1	Intake 1	16	129851	1337293130	/users/cn/jespinosa/phecomp/data/CRG/20120502_FDF_CRG/20120502_FDF_CRG/20120516_FDF_CRG_c12.mtb	1180	NA	WWSS	water	1	129835	1337293114	1	0.02	0.00125	8164	1
3	Food 2	Intake 4	243	130087	1337293366	/users/cn/jespinosa/phecomp/data/CRG/20120502_FDF_CRG/20120502_FDF_CRG/20120516_FDF_CRG_c12.mtb	3567	2365	WWSS	food_sc	4	129844	1337293123	1	0.14	0.000576131687242798	8165	1
3	Drink 2	Intake 2	23	130146	1337293425	/users/cn/jespinosa/phecomp/data/CRG/20120502_FDF_CRG/20120502_FDF_CRG/20120516_FDF_CRG_c12.mtb	2683	NA	WWSS	water	2	130123	1337293402	1	0.0600000000000001	0.00260869565217392	8166	1
3	Drink 2	Intake 2	44	130479	1337293758	/users/cn/jespinosa/phecomp/data/CRG/20120502_FDF_CRG/20120502_FDF_CRG/20120516_FDF_CRG_c12.mtb	2684	NA	WWSS	water	2	130435	1337293714	1	0.02	0.000454545454545455	8167	1
3	Drink 1	Intake 1	15	131018	1337294297	/users/cn/jespinosa/phecomp/data/CRG/20120502_FDF_CRG/20120502_FDF_CRG/20120516_FDF_CRG_c12.mtb	1181	NA	WWSS	water	1	131003	1337294282	1	0.0600000000000001	0.00400000000000001	8168	1
3	Food 2	Intake 4	94	132546	1337295825	/users/cn/jespinosa/phecomp/data/CRG/20120502_FDF_CRG/20120502_FDF_CRG/20120516_FDF_CRG_c12.mtb	3572	2387	WWSS	food_sc	4	132452	1337295731	1	0.32	0.00340425531914894	8169	1
3	Drink 1	Intake 1	18	133021	1337296300	/users/cn/jespinosa/phecomp/data/CRG/20120502_FDF_CRG/20120502_FDF_CRG/20120516_FDF_CRG_c12.mtb	1184	NA	WWSS	water	1	133003	1337296282	1	0.0600000000000001	0.00333333333333334	8170	1
3	Drink 1	Intake 1	16	133729	1337297008	/users/cn/jespinosa/phecomp/data/CRG/20120502_FDF_CRG/20120502_FDF_CRG/20120516_FDF_CRG_c12.mtb	1186	NA	WWSS	water	1	133713	1337296992	1	0.02	0.00125	8171	1
3	Drink 1	Intake 1	24	134300	1337297579	/users/cn/jespinosa/phecomp/data/CRG/20120502_FDF_CRG/20120502_FDF_CRG/20120516_FDF_CRG_c12.mtb	1188	NA	WWSS	water	1	134276	1337297555	1	0.04	0.00166666666666667	8172	1
3	Food 2	Intake 4	22	134955	1337298234	/users/cn/jespinosa/phecomp/data/CRG/20120502_FDF_CRG/20120502_FDF_CRG/20120516_FDF_CRG_c12.mtb	3576	5973	WWSS	food_sc	4	134933	1337298212	1	0.02	0.000909090909090909	8173	1
3	Drink 1	Intake 1	15	135367	1337298646	/users/cn/jespinosa/phecomp/data/CRG/20120502_FDF_CRG/20120502_FDF_CRG/20120516_FDF_CRG_c12.mtb	1189	NA	WWSS	water	1	135352	1337298631	1	0.02	0.00133333333333333	8174	1
3	Drink 1	Intake 1	23	135410	1337298689	/users/cn/jespinosa/phecomp/data/CRG/20120502_FDF_CRG/20120502_FDF_CRG/20120516_FDF_CRG_c12.mtb	1190	NA	WWSS	water	1	135387	1337298666	1	0.02	0.000869565217391304	8175	1
3	Drink 2	Intake 2	49	139963	1337303242	/users/cn/jespinosa/phecomp/data/CRG/20120502_FDF_CRG/20120502_FDF_CRG/20120516_FDF_CRG_c12.mtb	2697	NA	WWSS	water	2	139914	1337303193	1	0.02	0.000408163265306122	8176	1
3	Food 2	Intake 4	46	140974	1337304253	/users/cn/jespinosa/phecomp/data/CRG/20120502_FDF_CRG/20120502_FDF_CRG/20120516_FDF_CRG_c12.mtb	3589	11073	WWSS	food_sc	4	140928	1337304207	1	0.02	0.000434782608695652	8177	1
3	Drink 1	Intake 1	18	141035	1337304314	/users/cn/jespinosa/phecomp/data/CRG/20120502_FDF_CRG/20120502_FDF_CRG/20120516_FDF_CRG_c12.mtb	1193	NA	WWSS	water	1	141017	1337304296	1	0.04	0.00222222222222222	8178	1
3	Food 2	Intake 4	265	152312	1337315591	/users/cn/jespinosa/phecomp/data/CRG/20120502_FDF_CRG/20120502_FDF_CRG/20120516_FDF_CRG_c12.mtb	3603	3183	WWSS	food_sc	4	152047	1337315326	1	0.02	7.54716981132076e-05	8179	1
3	Food 2	Intake 4	708	156203	1337319482	/users/cn/jespinosa/phecomp/data/CRG/20120502_FDF_CRG/20120502_FDF_CRG/20120516_FDF_CRG_c12.mtb	3604	347	WWSS	food_sc	4	155495	1337318774	1	0.16	0.000225988700564972	8180	1
3	Drink 2	Intake 2	33	156239	1337319518	/users/cn/jespinosa/phecomp/data/CRG/20120502_FDF_CRG/20120502_FDF_CRG/20120516_FDF_CRG_c12.mtb	2700	NA	WWSS	water	2	156206	1337319485	1	0.12	0.00363636363636364	8181	1
3	Drink 2	Intake 2	17	156329	1337319608	/users/cn/jespinosa/phecomp/data/CRG/20120502_FDF_CRG/20120502_FDF_CRG/20120516_FDF_CRG_c12.mtb	2701	NA	WWSS	water	2	156312	1337319591	1	0.02	0.00117647058823529	8182	1
3	Drink 1	Intake 1	21	156372	1337319651	/users/cn/jespinosa/phecomp/data/CRG/20120502_FDF_CRG/20120502_FDF_CRG/20120516_FDF_CRG_c12.mtb	1194	NA	WWSS	water	1	156351	1337319630	1	0.02	0.000952380952380952	8183	1
3	Drink 2	Intake 2	17	156450	1337319729	/users/cn/jespinosa/phecomp/data/CRG/20120502_FDF_CRG/20120502_FDF_CRG/20120516_FDF_CRG_c12.mtb	2702	NA	WWSS	water	2	156433	1337319712	1	0.02	0.00117647058823529	8184	1
3	Food 2	Intake 4	338	156888	1337320167	/users/cn/jespinosa/phecomp/data/CRG/20120502_FDF_CRG/20120502_FDF_CRG/20120516_FDF_CRG_c12.mtb	3608	72	WWSS	food_sc	4	156550	1337319829	1	0.0599999999999996	0.000177514792899407	8185	1
3	Drink 2	Intake 2	28	156912	1337320191	/users/cn/jespinosa/phecomp/data/CRG/20120502_FDF_CRG/20120502_FDF_CRG/20120516_FDF_CRG_c12.mtb	2703	NA	WWSS	water	2	156884	1337320163	1	0.0799999999999998	0.00285714285714285	8186	1
3	Food 2	Intake 4	294	157254	1337320533	/users/cn/jespinosa/phecomp/data/CRG/20120502_FDF_CRG/20120502_FDF_CRG/20120516_FDF_CRG_c12.mtb	3609	136	WWSS	food_sc	4	156960	1337320239	1	0.12	0.000408163265306122	8187	1
3	Drink 1	Intake 1	28	157273	1337320552	/users/cn/jespinosa/phecomp/data/CRG/20120502_FDF_CRG/20120502_FDF_CRG/20120516_FDF_CRG_c12.mtb	1195	NA	WWSS	water	1	157245	1337320524	1	0.14	0.005	8188	1
3	Drink 2	Intake 2	15	157327	1337320606	/users/cn/jespinosa/phecomp/data/CRG/20120502_FDF_CRG/20120502_FDF_CRG/20120516_FDF_CRG_c12.mtb	2704	NA	WWSS	water	2	157312	1337320591	1	0.02	0.00133333333333333	8189	1
3	Food 2	Intake 4	161	157551	1337320830	/users/cn/jespinosa/phecomp/data/CRG/20120502_FDF_CRG/20120502_FDF_CRG/20120516_FDF_CRG_c12.mtb	3610	13582	WWSS	food_sc	4	157390	1337320669	1	0.0600000000000001	0.000372670807453417	8190	1
3	Drink 2	Intake 2	25	157572	1337320851	/users/cn/jespinosa/phecomp/data/CRG/20120502_FDF_CRG/20120502_FDF_CRG/20120516_FDF_CRG_c12.mtb	2706	NA	WWSS	water	2	157547	1337320826	1	0.0799999999999998	0.00319999999999999	8191	1
3	Drink 2	Intake 2	25	158172	1337321451	/users/cn/jespinosa/phecomp/data/CRG/20120502_FDF_CRG/20120502_FDF_CRG/20120516_FDF_CRG_c12.mtb	2707	NA	WWSS	water	2	158147	1337321426	1	0.0800000000000001	0.0032	8192	1
3	Food 2	Intake 4	91	1988	1337334503	/users/cn/jespinosa/phecomp/data/CRG/20120502_FDF_CRG/20120502_FDF_CRG/20120518_FDF_CRG_c12.mtb	3614	4	WWSS	food_sc	4	1897	1337334412	1	0.04	0.00043956043956044	8193	1
3	Food 2	Intake 4	258	2250	1337334765	/users/cn/jespinosa/phecomp/data/CRG/20120502_FDF_CRG/20120502_FDF_CRG/20120518_FDF_CRG_c12.mtb	3615	4599	WWSS	food_sc	4	1992	1337334507	1	0.12	0.000465116279069767	8194	1
3	Drink 1	Intake 1	15	2352	1337334867	/users/cn/jespinosa/phecomp/data/CRG/20120502_FDF_CRG/20120502_FDF_CRG/20120518_FDF_CRG_c12.mtb	1196	NA	WWSS	water	1	2337	1337334852	1	0.02	0.00133333333333333	8195	1
3	Drink 1	Intake 1	10	3299	1337335814	/users/cn/jespinosa/phecomp/data/CRG/20120502_FDF_CRG/20120502_FDF_CRG/20120518_FDF_CRG_c12.mtb	1197	NA	WWSS	water	1	3289	1337335804	1	0.04	0.004	8196	1
3	Food 2	Intake 4	186	7035	1337339550	/users/cn/jespinosa/phecomp/data/CRG/20120502_FDF_CRG/20120502_FDF_CRG/20120518_FDF_CRG_c12.mtb	3617	14	WWSS	food_sc	4	6849	1337339364	1	0.08	0.00043010752688172	8197	1
3	Food 2	Intake 4	155	7204	1337339719	/users/cn/jespinosa/phecomp/data/CRG/20120502_FDF_CRG/20120502_FDF_CRG/20120518_FDF_CRG_c12.mtb	3618	97	WWSS	food_sc	4	7049	1337339564	1	0.04	0.000258064516129032	8198	1
3	Food 2	Intake 4	51	7352	1337339867	/users/cn/jespinosa/phecomp/data/CRG/20120502_FDF_CRG/20120502_FDF_CRG/20120518_FDF_CRG_c12.mtb	3619	1184	WWSS	food_sc	4	7301	1337339816	1	0.02	0.000392156862745098	8199	1
3	Drink 2	Intake 2	13	7968	1337340483	/users/cn/jespinosa/phecomp/data/CRG/20120502_FDF_CRG/20120502_FDF_CRG/20120518_FDF_CRG_c12.mtb	2709	NA	WWSS	water	2	7955	1337340470	1	0.04	0.00307692307692308	8200	1
3	Food 2	Intake 4	141	8677	1337341192	/users/cn/jespinosa/phecomp/data/CRG/20120502_FDF_CRG/20120502_FDF_CRG/20120518_FDF_CRG_c12.mtb	3621	21529	WWSS	food_sc	4	8536	1337341051	1	0.02	0.000141843971631206	8201	1
3	Drink 1	Intake 1	12	8825	1337341340	/users/cn/jespinosa/phecomp/data/CRG/20120502_FDF_CRG/20120502_FDF_CRG/20120518_FDF_CRG_c12.mtb	1199	NA	WWSS	water	1	8813	1337341328	1	0.04	0.00333333333333333	8202	1
3	Food 1	Intake 3	156	30362	1337362877	/users/cn/jespinosa/phecomp/data/CRG/20120502_FDF_CRG/20120502_FDF_CRG/20120518_FDF_CRG_c12.mtb	2173	4	WWSS	food_sc	3	30206	1337362721	1	0.02	0.000128205128205128	8203	1
3	Food 1	Intake 3	176	30542	1337363057	/users/cn/jespinosa/phecomp/data/CRG/20120502_FDF_CRG/20120502_FDF_CRG/20120518_FDF_CRG_c12.mtb	2174	48	WWSS	food_sc	3	30366	1337362881	1	0.04	0.000227272727272727	8204	1
3	Food 1	Intake 3	86	30676	1337363191	/users/cn/jespinosa/phecomp/data/CRG/20120502_FDF_CRG/20120502_FDF_CRG/20120518_FDF_CRG_c12.mtb	2175	1722	WWSS	food_sc	3	30590	1337363105	1	0.02	0.000232558139534884	8205	1
3	Food 1	Intake 3	23	32421	1337364936	/users/cn/jespinosa/phecomp/data/CRG/20120502_FDF_CRG/20120502_FDF_CRG/20120518_FDF_CRG_c12.mtb	2176	COLL	WWSS	food_sc	3	32398	1337364913	1	0.02	0.000869565217391304	8206	1
3	Food 2	Intake 4	275	32684	1337365199	/users/cn/jespinosa/phecomp/data/CRG/20120502_FDF_CRG/20120502_FDF_CRG/20120518_FDF_CRG_c12.mtb	3624	5	WWSS	food_sc	4	32409	1337364924	1	0.1	0.000363636363636364	8207	1
3	Food 2	Intake 4	102	32791	1337365306	/users/cn/jespinosa/phecomp/data/CRG/20120502_FDF_CRG/20120502_FDF_CRG/20120518_FDF_CRG_c12.mtb	3625	75	WWSS	food_sc	4	32689	1337365204	1	0.02	0.000196078431372549	8208	1
3	Food 2	Intake 4	163	33029	1337365544	/users/cn/jespinosa/phecomp/data/CRG/20120502_FDF_CRG/20120502_FDF_CRG/20120518_FDF_CRG_c12.mtb	3627	1922	WWSS	food_sc	4	32866	1337365381	1	0.06	0.000368098159509202	8209	1
3	Drink 1	Intake 1	18	33044	1337365559	/users/cn/jespinosa/phecomp/data/CRG/20120502_FDF_CRG/20120502_FDF_CRG/20120518_FDF_CRG_c12.mtb	1200	NA	WWSS	water	1	33026	1337365541	1	0.04	0.00222222222222222	8210	1
3	Drink 2	Intake 2	17	33067	1337365582	/users/cn/jespinosa/phecomp/data/CRG/20120502_FDF_CRG/20120502_FDF_CRG/20120518_FDF_CRG_c12.mtb	2710	NA	WWSS	water	2	33050	1337365565	1	0.02	0.00117647058823529	8211	1
3	Drink 1	Intake 1	15	33133	1337365648	/users/cn/jespinosa/phecomp/data/CRG/20120502_FDF_CRG/20120502_FDF_CRG/20120518_FDF_CRG_c12.mtb	1201	NA	WWSS	water	1	33118	1337365633	1	0.02	0.00133333333333333	8212	1
3	Drink 1	Intake 1	11	33171	1337365686	/users/cn/jespinosa/phecomp/data/CRG/20120502_FDF_CRG/20120502_FDF_CRG/20120518_FDF_CRG_c12.mtb	1202	NA	WWSS	water	1	33160	1337365675	1	0.02	0.00181818181818182	8213	1
3	Drink 1	Intake 1	12	34085	1337366600	/users/cn/jespinosa/phecomp/data/CRG/20120502_FDF_CRG/20120502_FDF_CRG/20120518_FDF_CRG_c12.mtb	1203	NA	WWSS	water	1	34073	1337366588	1	0.06	0.005	8214	1
3	Food 2	Intake 4	263	35214	1337367729	/users/cn/jespinosa/phecomp/data/CRG/20120502_FDF_CRG/20120502_FDF_CRG/20120518_FDF_CRG_c12.mtb	3629	431	WWSS	food_sc	4	34951	1337367466	1	0.1	0.000380228136882129	8215	1
3	Drink 2	Intake 2	34	35286	1337367801	/users/cn/jespinosa/phecomp/data/CRG/20120502_FDF_CRG/20120502_FDF_CRG/20120518_FDF_CRG_c12.mtb	2711	NA	WWSS	water	2	35252	1337367767	1	0.02	0.000588235294117647	8216	1
3	Drink 1	Intake 1	25	35384	1337367899	/users/cn/jespinosa/phecomp/data/CRG/20120502_FDF_CRG/20120502_FDF_CRG/20120518_FDF_CRG_c12.mtb	1205	NA	WWSS	water	1	35359	1337367874	1	0.06	0.0024	8217	1
3	Food 1	Intake 3	534	36179	1337368694	/users/cn/jespinosa/phecomp/data/CRG/20120502_FDF_CRG/20120502_FDF_CRG/20120518_FDF_CRG_c12.mtb	2179	1036	WWSS	food_sc	3	35645	1337368160	1	0.18	0.000337078651685393	8218	1
3	Drink 1	Intake 1	20	36207	1337368722	/users/cn/jespinosa/phecomp/data/CRG/20120502_FDF_CRG/20120502_FDF_CRG/20120518_FDF_CRG_c12.mtb	1206	NA	WWSS	water	1	36187	1337368702	1	0.08	0.004	8219	1
3	Drink 1	Intake 1	17	36278	1337368793	/users/cn/jespinosa/phecomp/data/CRG/20120502_FDF_CRG/20120502_FDF_CRG/20120518_FDF_CRG_c12.mtb	1207	NA	WWSS	water	1	36261	1337368776	1	0.08	0.00470588235294118	8220	1
3	Food 2	Intake 4	68	37283	1337369798	/users/cn/jespinosa/phecomp/data/CRG/20120502_FDF_CRG/20120502_FDF_CRG/20120518_FDF_CRG_c12.mtb	3632	6	WWSS	food_sc	4	37215	1337369730	1	0.02	0.000294117647058824	8221	1
3	Food 2	Intake 4	128	37417	1337369932	/users/cn/jespinosa/phecomp/data/CRG/20120502_FDF_CRG/20120502_FDF_CRG/20120518_FDF_CRG_c12.mtb	3633	749	WWSS	food_sc	4	37289	1337369804	1	0.02	0.00015625	8222	1
3	Drink 1	Intake 1	17	37927	1337370442	/users/cn/jespinosa/phecomp/data/CRG/20120502_FDF_CRG/20120502_FDF_CRG/20120518_FDF_CRG_c12.mtb	1209	NA	WWSS	water	1	37910	1337370425	1	0.02	0.00117647058823529	8223	1
3	Food 2	Intake 4	17	38183	1337370698	/users/cn/jespinosa/phecomp/data/CRG/20120502_FDF_CRG/20120502_FDF_CRG/20120518_FDF_CRG_c12.mtb	3634	1088	WWSS	food_sc	4	38166	1337370681	1	0.02	0.00117647058823529	8224	1
3	Drink 2	Intake 2	26	38251	1337370766	/users/cn/jespinosa/phecomp/data/CRG/20120502_FDF_CRG/20120502_FDF_CRG/20120518_FDF_CRG_c12.mtb	2713	NA	WWSS	water	2	38225	1337370740	1	0.02	0.000769230769230769	8225	1
3	Drink 1	Intake 1	14	38288	1337370803	/users/cn/jespinosa/phecomp/data/CRG/20120502_FDF_CRG/20120502_FDF_CRG/20120518_FDF_CRG_c12.mtb	1210	NA	WWSS	water	1	38274	1337370789	1	0.04	0.00285714285714286	8226	1
3	Food 1	Intake 3	329	39600	1337372115	/users/cn/jespinosa/phecomp/data/CRG/20120502_FDF_CRG/20120502_FDF_CRG/20120518_FDF_CRG_c12.mtb	2180	4	WWSS	food_sc	3	39271	1337371786	1	0.14	0.000425531914893617	8227	1
3	Food 1	Intake 3	240	39844	1337372359	/users/cn/jespinosa/phecomp/data/CRG/20120502_FDF_CRG/20120502_FDF_CRG/20120518_FDF_CRG_c12.mtb	2181	6	WWSS	food_sc	3	39604	1337372119	1	0.16	0.000666666666666667	8228	1
3	Food 1	Intake 3	80	39930	1337372445	/users/cn/jespinosa/phecomp/data/CRG/20120502_FDF_CRG/20120502_FDF_CRG/20120518_FDF_CRG_c12.mtb	2182	2261	WWSS	food_sc	3	39850	1337372365	1	0.04	0.0005	8229	1
3	Drink 2	Intake 2	19	39942	1337372457	/users/cn/jespinosa/phecomp/data/CRG/20120502_FDF_CRG/20120502_FDF_CRG/20120518_FDF_CRG_c12.mtb	2714	NA	WWSS	water	2	39923	1337372438	1	0.06	0.00315789473684211	8230	1
3	Drink 1	Intake 1	15	40009	1337372524	/users/cn/jespinosa/phecomp/data/CRG/20120502_FDF_CRG/20120502_FDF_CRG/20120518_FDF_CRG_c12.mtb	1211	NA	WWSS	water	1	39994	1337372509	1	0.0599999999999999	0.00399999999999999	8231	1
3	Drink 1	Intake 1	17	40112	1337372627	/users/cn/jespinosa/phecomp/data/CRG/20120502_FDF_CRG/20120502_FDF_CRG/20120518_FDF_CRG_c12.mtb	1213	NA	WWSS	water	1	40095	1337372610	1	0.04	0.00235294117647059	8232	1
3	Drink 2	Intake 2	23	40354	1337372869	/users/cn/jespinosa/phecomp/data/CRG/20120502_FDF_CRG/20120502_FDF_CRG/20120518_FDF_CRG_c12.mtb	2718	NA	WWSS	water	2	40331	1337372846	1	0.04	0.00173913043478261	8233	1
3	Food 1	Intake 3	197	42388	1337374903	/users/cn/jespinosa/phecomp/data/CRG/20120502_FDF_CRG/20120502_FDF_CRG/20120518_FDF_CRG_c12.mtb	2183	9	WWSS	food_sc	3	42191	1337374706	1	0.1	0.00050761421319797	8234	1
3	Food 1	Intake 3	152	42549	1337375064	/users/cn/jespinosa/phecomp/data/CRG/20120502_FDF_CRG/20120502_FDF_CRG/20120518_FDF_CRG_c12.mtb	2184	2013	WWSS	food_sc	3	42397	1337374912	1	0.12	0.000789473684210526	8235	1
3	Drink 2	Intake 2	15	42682	1337375197	/users/cn/jespinosa/phecomp/data/CRG/20120502_FDF_CRG/20120502_FDF_CRG/20120518_FDF_CRG_c12.mtb	2719	NA	WWSS	water	2	42667	1337375182	1	0.02	0.00133333333333333	8236	1
3	Drink 1	Intake 1	13	42715	1337375230	/users/cn/jespinosa/phecomp/data/CRG/20120502_FDF_CRG/20120502_FDF_CRG/20120518_FDF_CRG_c12.mtb	1214	NA	WWSS	water	1	42702	1337375217	1	0.0600000000000001	0.00461538461538462	8237	1
3	Drink 1	Intake 1	31	43365	1337375880	/users/cn/jespinosa/phecomp/data/CRG/20120502_FDF_CRG/20120502_FDF_CRG/20120518_FDF_CRG_c12.mtb	1215	NA	WWSS	water	1	43334	1337375849	1	0.0399999999999999	0.00129032258064516	8238	1
3	Drink 2	Intake 2	47	44315	1337376830	/users/cn/jespinosa/phecomp/data/CRG/20120502_FDF_CRG/20120502_FDF_CRG/20120518_FDF_CRG_c12.mtb	2721	NA	WWSS	water	2	44268	1337376783	1	0.02	0.000425531914893617	8239	1
3	Food 1	Intake 3	283	44845	1337377360	/users/cn/jespinosa/phecomp/data/CRG/20120502_FDF_CRG/20120502_FDF_CRG/20120518_FDF_CRG_c12.mtb	2187	3238	WWSS	food_sc	3	44562	1337377077	1	0.14	0.00049469964664311	8240	1
3	Drink 2	Intake 2	13	44865	1337377380	/users/cn/jespinosa/phecomp/data/CRG/20120502_FDF_CRG/20120502_FDF_CRG/20120518_FDF_CRG_c12.mtb	2722	NA	WWSS	water	2	44852	1337377367	1	0.04	0.00307692307692308	8241	1
3	Drink 1	Intake 1	12	45101	1337377616	/users/cn/jespinosa/phecomp/data/CRG/20120502_FDF_CRG/20120502_FDF_CRG/20120518_FDF_CRG_c12.mtb	1216	NA	WWSS	water	1	45089	1337377604	1	0.02	0.00166666666666667	8242	1
3	Drink 2	Intake 2	16	45187	1337377702	/users/cn/jespinosa/phecomp/data/CRG/20120502_FDF_CRG/20120502_FDF_CRG/20120518_FDF_CRG_c12.mtb	2723	NA	WWSS	water	2	45171	1337377686	1	0.04	0.0025	8243	1
3	Food 2	Intake 4	210	48293	1337380808	/users/cn/jespinosa/phecomp/data/CRG/20120502_FDF_CRG/20120502_FDF_CRG/20120518_FDF_CRG_c12.mtb	3644	10	WWSS	food_sc	4	48083	1337380598	1	0.08	0.000380952380952381	8244	1
3	Food 2	Intake 4	138	48441	1337380956	/users/cn/jespinosa/phecomp/data/CRG/20120502_FDF_CRG/20120502_FDF_CRG/20120518_FDF_CRG_c12.mtb	3645	752	WWSS	food_sc	4	48303	1337380818	1	0.0600000000000001	0.000434782608695653	8245	1
3	Drink 1	Intake 1	23	48964	1337381479	/users/cn/jespinosa/phecomp/data/CRG/20120502_FDF_CRG/20120502_FDF_CRG/20120518_FDF_CRG_c12.mtb	1217	NA	WWSS	water	1	48941	1337381456	1	0.0600000000000001	0.00260869565217392	8246	1
3	Drink 2	Intake 2	18	49037	1337381552	/users/cn/jespinosa/phecomp/data/CRG/20120502_FDF_CRG/20120502_FDF_CRG/20120518_FDF_CRG_c12.mtb	2724	NA	WWSS	water	2	49019	1337381534	1	0.02	0.00111111111111111	8247	1
3	Food 2	Intake 4	244	49437	1337381952	/users/cn/jespinosa/phecomp/data/CRG/20120502_FDF_CRG/20120502_FDF_CRG/20120518_FDF_CRG_c12.mtb	3649	1242	WWSS	food_sc	4	49193	1337381708	1	0.08	0.000327868852459016	8248	1
3	Drink 2	Intake 2	23	49460	1337381975	/users/cn/jespinosa/phecomp/data/CRG/20120502_FDF_CRG/20120502_FDF_CRG/20120518_FDF_CRG_c12.mtb	2725	NA	WWSS	water	2	49437	1337381952	1	0.06	0.00260869565217391	8249	1
3	Drink 2	Intake 2	17	49674	1337382189	/users/cn/jespinosa/phecomp/data/CRG/20120502_FDF_CRG/20120502_FDF_CRG/20120518_FDF_CRG_c12.mtb	2727	NA	WWSS	water	2	49657	1337382172	1	0.02	0.00117647058823529	8250	1
3	Drink 1	Intake 1	14	50513	1337383028	/users/cn/jespinosa/phecomp/data/CRG/20120502_FDF_CRG/20120502_FDF_CRG/20120518_FDF_CRG_c12.mtb	1219	NA	WWSS	water	1	50499	1337383014	1	0.0399999999999999	0.00285714285714285	8251	1
3	Food 2	Intake 4	339	51018	1337383533	/users/cn/jespinosa/phecomp/data/CRG/20120502_FDF_CRG/20120502_FDF_CRG/20120518_FDF_CRG_c12.mtb	3651	3957	WWSS	food_sc	4	50679	1337383194	1	0.1	0.000294985250737463	8252	1
3	Drink 1	Intake 1	20	51061	1337383576	/users/cn/jespinosa/phecomp/data/CRG/20120502_FDF_CRG/20120502_FDF_CRG/20120518_FDF_CRG_c12.mtb	1220	NA	WWSS	water	1	51041	1337383556	1	0.0600000000000001	0.00300000000000001	8253	1
3	Drink 1	Intake 1	18	51450	1337383965	/users/cn/jespinosa/phecomp/data/CRG/20120502_FDF_CRG/20120502_FDF_CRG/20120518_FDF_CRG_c12.mtb	1221	NA	WWSS	water	1	51432	1337383947	1	0.0599999999999999	0.00333333333333333	8254	1
3	Food 2	Intake 4	83	55058	1337387573	/users/cn/jespinosa/phecomp/data/CRG/20120502_FDF_CRG/20120502_FDF_CRG/20120518_FDF_CRG_c12.mtb	3657	163	WWSS	food_sc	4	54975	1337387490	1	0.02	0.000240963855421687	8255	1
3	Food 2	Intake 4	41	55262	1337387777	/users/cn/jespinosa/phecomp/data/CRG/20120502_FDF_CRG/20120502_FDF_CRG/20120518_FDF_CRG_c12.mtb	3659	COLL	WWSS	food_sc	4	55221	1337387736	1	0.02	0.00048780487804878	8256	1
3	Food 1	Intake 3	213	55464	1337387979	/users/cn/jespinosa/phecomp/data/CRG/20120502_FDF_CRG/20120502_FDF_CRG/20120518_FDF_CRG_c12.mtb	2193	354	WWSS	food_sc	3	55251	1337387766	1	0.0600000000000001	0.000281690140845071	8257	1
3	Food 1	Intake 3	272	56090	1337388605	/users/cn/jespinosa/phecomp/data/CRG/20120502_FDF_CRG/20120502_FDF_CRG/20120518_FDF_CRG_c12.mtb	2194	53	WWSS	food_sc	3	55818	1337388333	1	0.0600000000000001	0.000220588235294118	8258	1
3	Drink 2	Intake 2	24	56116	1337388631	/users/cn/jespinosa/phecomp/data/CRG/20120502_FDF_CRG/20120502_FDF_CRG/20120518_FDF_CRG_c12.mtb	2733	NA	WWSS	water	2	56092	1337388607	1	0.06	0.0025	8259	1
3	Food 2	Intake 4	297	56440	1337388955	/users/cn/jespinosa/phecomp/data/CRG/20120502_FDF_CRG/20120502_FDF_CRG/20120518_FDF_CRG_c12.mtb	3662	3823	WWSS	food_sc	4	56143	1337388658	1	0.0600000000000001	0.000202020202020202	8260	1
3	Drink 1	Intake 1	20	56530	1337389045	/users/cn/jespinosa/phecomp/data/CRG/20120502_FDF_CRG/20120502_FDF_CRG/20120518_FDF_CRG_c12.mtb	1223	NA	WWSS	water	1	56510	1337389025	1	0.0800000000000001	0.00400000000000001	8261	1
3	Drink 1	Intake 1	17	57642	1337390157	/users/cn/jespinosa/phecomp/data/CRG/20120502_FDF_CRG/20120502_FDF_CRG/20120518_FDF_CRG_c12.mtb	1224	NA	WWSS	water	1	57625	1337390140	1	0.0600000000000001	0.00352941176470589	8262	1
3	Food 2	Intake 4	115	60378	1337392893	/users/cn/jespinosa/phecomp/data/CRG/20120502_FDF_CRG/20120502_FDF_CRG/20120518_FDF_CRG_c12.mtb	3666	107	WWSS	food_sc	4	60263	1337392778	1	0.02	0.000173913043478261	8263	1
3	Food 2	Intake 4	459	60944	1337393459	/users/cn/jespinosa/phecomp/data/CRG/20120502_FDF_CRG/20120502_FDF_CRG/20120518_FDF_CRG_c12.mtb	3667	58	WWSS	food_sc	4	60485	1337393000	1	0.0999999999999999	0.000217864923747276	8264	1
3	Food 2	Intake 4	283	61285	1337393800	/users/cn/jespinosa/phecomp/data/CRG/20120502_FDF_CRG/20120502_FDF_CRG/20120518_FDF_CRG_c12.mtb	3668	6473	WWSS	food_sc	4	61002	1337393517	1	0.1	0.000353356890459364	8265	1
3	Drink 1	Intake 1	26	61310	1337393825	/users/cn/jespinosa/phecomp/data/CRG/20120502_FDF_CRG/20120502_FDF_CRG/20120518_FDF_CRG_c12.mtb	1225	NA	WWSS	water	1	61284	1337393799	1	0.0999999999999999	0.00384615384615384	8266	1
3	Drink 1	Intake 1	15	61461	1337393976	/users/cn/jespinosa/phecomp/data/CRG/20120502_FDF_CRG/20120502_FDF_CRG/20120518_FDF_CRG_c12.mtb	1226	NA	WWSS	water	1	61446	1337393961	1	0.04	0.00266666666666667	8267	1
3	Drink 1	Intake 1	19	61925	1337394440	/users/cn/jespinosa/phecomp/data/CRG/20120502_FDF_CRG/20120502_FDF_CRG/20120518_FDF_CRG_c12.mtb	1227	NA	WWSS	water	1	61906	1337394421	1	0.04	0.00210526315789474	8268	1
3	Food 1	Intake 3	390	68148	1337400663	/users/cn/jespinosa/phecomp/data/CRG/20120502_FDF_CRG/20120502_FDF_CRG/20120518_FDF_CRG_c12.mtb	2196	3708	WWSS	food_sc	3	67758	1337400273	1	0.18	0.000461538461538462	8269	1
3	Drink 2	Intake 2	21	68229	1337400744	/users/cn/jespinosa/phecomp/data/CRG/20120502_FDF_CRG/20120502_FDF_CRG/20120518_FDF_CRG_c12.mtb	2734	NA	WWSS	water	2	68208	1337400723	1	0.0600000000000001	0.00285714285714286	8270	1
3	Drink 2	Intake 2	19	68550	1337401065	/users/cn/jespinosa/phecomp/data/CRG/20120502_FDF_CRG/20120502_FDF_CRG/20120518_FDF_CRG_c12.mtb	2735	NA	WWSS	water	2	68531	1337401046	1	0.0399999999999999	0.00210526315789473	8271	1
3	Drink 1	Intake 1	21	69040	1337401555	/users/cn/jespinosa/phecomp/data/CRG/20120502_FDF_CRG/20120502_FDF_CRG/20120518_FDF_CRG_c12.mtb	1228	NA	WWSS	water	1	69019	1337401534	1	0.0999999999999999	0.00476190476190476	8272	1
3	Food 1	Intake 3	66	71922	1337404437	/users/cn/jespinosa/phecomp/data/CRG/20120502_FDF_CRG/20120502_FDF_CRG/20120518_FDF_CRG_c12.mtb	2198	1220	WWSS	food_sc	3	71856	1337404371	1	0.04	0.000606060606060606	8273	1
3	Food 2	Intake 4	194	73336	1337405851	/users/cn/jespinosa/phecomp/data/CRG/20120502_FDF_CRG/20120502_FDF_CRG/20120518_FDF_CRG_c12.mtb	3674	776	WWSS	food_sc	4	73142	1337405657	1	0.0799999999999998	0.000412371134020617	8274	1
3	Drink 1	Intake 1	17	73661	1337406176	/users/cn/jespinosa/phecomp/data/CRG/20120502_FDF_CRG/20120502_FDF_CRG/20120518_FDF_CRG_c12.mtb	1230	NA	WWSS	water	1	73644	1337406159	1	0.0800000000000001	0.00470588235294118	8275	1
3	Drink 2	Intake 2	19	74003	1337406518	/users/cn/jespinosa/phecomp/data/CRG/20120502_FDF_CRG/20120502_FDF_CRG/20120518_FDF_CRG_c12.mtb	2736	NA	WWSS	water	2	73984	1337406499	1	0.04	0.00210526315789474	8276	1
3	Food 1	Intake 3	154	74266	1337406781	/users/cn/jespinosa/phecomp/data/CRG/20120502_FDF_CRG/20120502_FDF_CRG/20120518_FDF_CRG_c12.mtb	2200	65	WWSS	food_sc	3	74112	1337406627	1	0.02	0.00012987012987013	8277	1
3	Food 2	Intake 4	144	74475	1337406990	/users/cn/jespinosa/phecomp/data/CRG/20120502_FDF_CRG/20120502_FDF_CRG/20120518_FDF_CRG_c12.mtb	3676	6574	WWSS	food_sc	4	74331	1337406846	1	0.04	0.000277777777777778	8278	1
3	Drink 1	Intake 1	18	74524	1337407039	/users/cn/jespinosa/phecomp/data/CRG/20120502_FDF_CRG/20120502_FDF_CRG/20120518_FDF_CRG_c12.mtb	1231	NA	WWSS	water	1	74506	1337407021	1	0.02	0.00111111111111111	8279	1
3	Drink 2	Intake 2	16	74693	1337407208	/users/cn/jespinosa/phecomp/data/CRG/20120502_FDF_CRG/20120502_FDF_CRG/20120518_FDF_CRG_c12.mtb	2737	NA	WWSS	water	2	74677	1337407192	1	0.02	0.00125	8280	1
3	Drink 1	Intake 1	22	75450	1337407965	/users/cn/jespinosa/phecomp/data/CRG/20120502_FDF_CRG/20120502_FDF_CRG/20120518_FDF_CRG_c12.mtb	1232	NA	WWSS	water	1	75428	1337407943	1	0.0600000000000001	0.00272727272727273	8281	1
3	Food 2	Intake 4	78	81127	1337413642	/users/cn/jespinosa/phecomp/data/CRG/20120502_FDF_CRG/20120502_FDF_CRG/20120518_FDF_CRG_c12.mtb	3682	10652	WWSS	food_sc	4	81049	1337413564	1	0.02	0.000256410256410256	8282	1
3	Drink 1	Intake 1	13	81193	1337413708	/users/cn/jespinosa/phecomp/data/CRG/20120502_FDF_CRG/20120502_FDF_CRG/20120518_FDF_CRG_c12.mtb	1233	NA	WWSS	water	1	81180	1337413695	1	0.04	0.00307692307692308	8283	1
3	Food 1	Intake 3	71	91850	1337424365	/users/cn/jespinosa/phecomp/data/CRG/20120502_FDF_CRG/20120502_FDF_CRG/20120518_FDF_CRG_c12.mtb	2209	24432	WWSS	food_sc	3	91779	1337424294	1	0.02	0.00028169014084507	8284	1
3	Drink 2	Intake 2	18	96210	1337428725	/users/cn/jespinosa/phecomp/data/CRG/20120502_FDF_CRG/20120502_FDF_CRG/20120518_FDF_CRG_c12.mtb	2738	NA	WWSS	water	2	96192	1337428707	1	0.02	0.00111111111111111	8285	1
3	Food 1	Intake 3	570	116852	1337449367	/users/cn/jespinosa/phecomp/data/CRG/20120502_FDF_CRG/20120502_FDF_CRG/20120518_FDF_CRG_c12.mtb	2211	2117	WWSS	food_sc	3	116282	1337448797	1	0.18	0.000315789473684211	8286	1
3	Drink 1	Intake 1	14	117062	1337449577	/users/cn/jespinosa/phecomp/data/CRG/20120502_FDF_CRG/20120502_FDF_CRG/20120518_FDF_CRG_c12.mtb	1237	NA	WWSS	water	1	117048	1337449563	1	0.0800000000000001	0.00571428571428572	8287	1
3	Food 2	Intake 4	139	119108	1337451623	/users/cn/jespinosa/phecomp/data/CRG/20120502_FDF_CRG/20120502_FDF_CRG/20120518_FDF_CRG_c12.mtb	3688	44	WWSS	food_sc	4	118969	1337451484	1	0.04	0.000287769784172662	8288	1
3	Drink 2	Intake 2	12	119113	1337451628	/users/cn/jespinosa/phecomp/data/CRG/20120502_FDF_CRG/20120502_FDF_CRG/20120518_FDF_CRG_c12.mtb	2743	NA	WWSS	water	2	119101	1337451616	1	0.0399999999999999	0.00333333333333332	8289	1
3	Food 2	Intake 4	244	119396	1337451911	/users/cn/jespinosa/phecomp/data/CRG/20120502_FDF_CRG/20120502_FDF_CRG/20120518_FDF_CRG_c12.mtb	3689	48	WWSS	food_sc	4	119152	1337451667	1	0.0800000000000001	0.000327868852459017	8290	1
3	Drink 2	Intake 2	19	119405	1337451920	/users/cn/jespinosa/phecomp/data/CRG/20120502_FDF_CRG/20120502_FDF_CRG/20120518_FDF_CRG_c12.mtb	2744	NA	WWSS	water	2	119386	1337451901	1	0.04	0.00210526315789474	8291	1
3	Food 2	Intake 4	61	119505	1337452020	/users/cn/jespinosa/phecomp/data/CRG/20120502_FDF_CRG/20120502_FDF_CRG/20120518_FDF_CRG_c12.mtb	3690	249	WWSS	food_sc	4	119444	1337451959	1	0.02	0.000327868852459016	8292	1
3	Drink 2	Intake 2	20	119648	1337452163	/users/cn/jespinosa/phecomp/data/CRG/20120502_FDF_CRG/20120502_FDF_CRG/20120518_FDF_CRG_c12.mtb	2745	NA	WWSS	water	2	119628	1337452143	1	0.0600000000000001	0.00300000000000001	8293	1
3	Food 2	Intake 4	207	119961	1337452476	/users/cn/jespinosa/phecomp/data/CRG/20120502_FDF_CRG/20120502_FDF_CRG/20120518_FDF_CRG_c12.mtb	3691	1257	WWSS	food_sc	4	119754	1337452269	1	0.0600000000000001	0.000289855072463769	8294	1
3	Drink 1	Intake 1	15	120157	1337452672	/users/cn/jespinosa/phecomp/data/CRG/20120502_FDF_CRG/20120502_FDF_CRG/20120518_FDF_CRG_c12.mtb	1239	NA	WWSS	water	1	120142	1337452657	1	0.0599999999999998	0.00399999999999999	8295	1
3	Drink 1	Intake 1	15	121145	1337453660	/users/cn/jespinosa/phecomp/data/CRG/20120502_FDF_CRG/20120502_FDF_CRG/20120518_FDF_CRG_c12.mtb	1240	NA	WWSS	water	1	121130	1337453645	1	0.04	0.00266666666666667	8296	1
3	Food 2	Intake 4	357	121575	1337454090	/users/cn/jespinosa/phecomp/data/CRG/20120502_FDF_CRG/20120502_FDF_CRG/20120518_FDF_CRG_c12.mtb	3692	314	WWSS	food_sc	4	121218	1337453733	1	0.14	0.000392156862745098	8297	1
3	Drink 2	Intake 2	15	121590	1337454105	/users/cn/jespinosa/phecomp/data/CRG/20120502_FDF_CRG/20120502_FDF_CRG/20120518_FDF_CRG_c12.mtb	2746	NA	WWSS	water	2	121575	1337454090	1	0.0399999999999999	0.00266666666666666	8298	1
3	Drink 1	Intake 1	15	121705	1337454220	/users/cn/jespinosa/phecomp/data/CRG/20120502_FDF_CRG/20120502_FDF_CRG/20120518_FDF_CRG_c12.mtb	1241	NA	WWSS	water	1	121690	1337454205	1	0.0599999999999998	0.00399999999999999	8299	1
3	Food 1	Intake 3	17	121906	1337454421	/users/cn/jespinosa/phecomp/data/CRG/20120502_FDF_CRG/20120502_FDF_CRG/20120518_FDF_CRG_c12.mtb	2214	118	WWSS	food_sc	3	121889	1337454404	1	0.02	0.00117647058823529	8300	1
3	Food 2	Intake 4	154	122178	1337454693	/users/cn/jespinosa/phecomp/data/CRG/20120502_FDF_CRG/20120502_FDF_CRG/20120518_FDF_CRG_c12.mtb	3694	1289	WWSS	food_sc	4	122024	1337454539	1	0.0399999999999998	0.000259740259740258	8301	1
3	Drink 2	Intake 2	31	122399	1337454914	/users/cn/jespinosa/phecomp/data/CRG/20120502_FDF_CRG/20120502_FDF_CRG/20120518_FDF_CRG_c12.mtb	2747	NA	WWSS	water	2	122368	1337454883	1	0.0800000000000001	0.00258064516129033	8302	1
3	Food 1	Intake 3	437	123904	1337456419	/users/cn/jespinosa/phecomp/data/CRG/20120502_FDF_CRG/20120502_FDF_CRG/20120518_FDF_CRG_c12.mtb	2215	2683	WWSS	food_sc	3	123467	1337455982	1	0.18	0.000411899313501144	8303	1
3	Drink 2	Intake 2	18	123918	1337456433	/users/cn/jespinosa/phecomp/data/CRG/20120502_FDF_CRG/20120502_FDF_CRG/20120518_FDF_CRG_c12.mtb	2748	NA	WWSS	water	2	123900	1337456415	1	0.0599999999999999	0.00333333333333333	8304	1
3	Drink 1	Intake 1	15	124053	1337456568	/users/cn/jespinosa/phecomp/data/CRG/20120502_FDF_CRG/20120502_FDF_CRG/20120518_FDF_CRG_c12.mtb	1242	NA	WWSS	water	1	124038	1337456553	1	0.0600000000000001	0.00400000000000001	8305	1
3	Drink 1	Intake 1	12	124885	1337457400	/users/cn/jespinosa/phecomp/data/CRG/20120502_FDF_CRG/20120502_FDF_CRG/20120518_FDF_CRG_c12.mtb	1243	NA	WWSS	water	1	124873	1337457388	1	0.02	0.00166666666666667	8306	1
3	Food 1	Intake 3	523	127110	1337459625	/users/cn/jespinosa/phecomp/data/CRG/20120502_FDF_CRG/20120502_FDF_CRG/20120518_FDF_CRG_c12.mtb	2217	109	WWSS	food_sc	3	126587	1337459102	1	0.24	0.000458891013384321	8307	1
3	Drink 1	Intake 1	14	127163	1337459678	/users/cn/jespinosa/phecomp/data/CRG/20120502_FDF_CRG/20120502_FDF_CRG/20120518_FDF_CRG_c12.mtb	1244	NA	WWSS	water	1	127149	1337459664	1	0.04	0.00285714285714286	8308	1
3	Food 1	Intake 3	84	127303	1337459818	/users/cn/jespinosa/phecomp/data/CRG/20120502_FDF_CRG/20120502_FDF_CRG/20120518_FDF_CRG_c12.mtb	2219	449	WWSS	food_sc	3	127219	1337459734	1	0.02	0.000238095238095238	8309	1
3	Drink 2	Intake 2	20	127401	1337459916	/users/cn/jespinosa/phecomp/data/CRG/20120502_FDF_CRG/20120502_FDF_CRG/20120518_FDF_CRG_c12.mtb	2750	NA	WWSS	water	2	127381	1337459896	1	0.0600000000000001	0.00300000000000001	8310	1
3	Drink 2	Intake 2	17	127710	1337460225	/users/cn/jespinosa/phecomp/data/CRG/20120502_FDF_CRG/20120502_FDF_CRG/20120518_FDF_CRG_c12.mtb	2752	NA	WWSS	water	2	127693	1337460208	1	0.04	0.00235294117647059	8311	1
3	Food 1	Intake 3	147	127899	1337460414	/users/cn/jespinosa/phecomp/data/CRG/20120502_FDF_CRG/20120502_FDF_CRG/20120518_FDF_CRG_c12.mtb	2220	2892	WWSS	food_sc	3	127752	1337460267	1	0.1	0.000680272108843537	8312	1
3	Drink 1	Intake 1	18	127922	1337460437	/users/cn/jespinosa/phecomp/data/CRG/20120502_FDF_CRG/20120502_FDF_CRG/20120518_FDF_CRG_c12.mtb	1245	NA	WWSS	water	1	127904	1337460419	1	0.04	0.00222222222222222	8313	1
3	Drink 2	Intake 2	59	127998	1337460513	/users/cn/jespinosa/phecomp/data/CRG/20120502_FDF_CRG/20120502_FDF_CRG/20120518_FDF_CRG_c12.mtb	2753	NA	WWSS	water	2	127939	1337460454	1	0.04	0.000677966101694915	8314	1
3	Drink 1	Intake 1	15	128274	1337460789	/users/cn/jespinosa/phecomp/data/CRG/20120502_FDF_CRG/20120502_FDF_CRG/20120518_FDF_CRG_c12.mtb	1246	NA	WWSS	water	1	128259	1337460774	1	0.04	0.00266666666666667	8315	1
3	Drink 1	Intake 1	15	128580	1337461095	/users/cn/jespinosa/phecomp/data/CRG/20120502_FDF_CRG/20120502_FDF_CRG/20120518_FDF_CRG_c12.mtb	1247	NA	WWSS	water	1	128565	1337461080	1	0.02	0.00133333333333333	8316	1
3	Drink 2	Intake 2	23	129105	1337461620	/users/cn/jespinosa/phecomp/data/CRG/20120502_FDF_CRG/20120502_FDF_CRG/20120518_FDF_CRG_c12.mtb	2756	NA	WWSS	water	2	129082	1337461597	1	0.0399999999999998	0.0017391304347826	8317	1
3	Food 1	Intake 3	506	131297	1337463812	/users/cn/jespinosa/phecomp/data/CRG/20120502_FDF_CRG/20120502_FDF_CRG/20120518_FDF_CRG_c12.mtb	2222	2082	WWSS	food_sc	3	130791	1337463306	1	0.14	0.000276679841897233	8318	1
3	Drink 1	Intake 1	17	131341	1337463856	/users/cn/jespinosa/phecomp/data/CRG/20120502_FDF_CRG/20120502_FDF_CRG/20120518_FDF_CRG_c12.mtb	1248	NA	WWSS	water	1	131324	1337463839	1	0.02	0.00117647058823529	8319	1
3	Drink 1	Intake 1	15	131375	1337463890	/users/cn/jespinosa/phecomp/data/CRG/20120502_FDF_CRG/20120502_FDF_CRG/20120518_FDF_CRG_c12.mtb	1249	NA	WWSS	water	1	131360	1337463875	1	0.04	0.00266666666666667	8320	1
3	Food 1	Intake 3	17	133396	1337465911	/users/cn/jespinosa/phecomp/data/CRG/20120502_FDF_CRG/20120502_FDF_CRG/20120518_FDF_CRG_c12.mtb	2223	71	WWSS	food_sc	3	133379	1337465894	1	0.0200000000000005	0.00117647058823532	8321	1
3	Food 2	Intake 4	214	133681	1337466196	/users/cn/jespinosa/phecomp/data/CRG/20120502_FDF_CRG/20120502_FDF_CRG/20120518_FDF_CRG_c12.mtb	3713	18	WWSS	food_sc	4	133467	1337465982	1	0.02	9.34579439252336e-05	8322	1
3	Food 2	Intake 4	198	133897	1337466412	/users/cn/jespinosa/phecomp/data/CRG/20120502_FDF_CRG/20120502_FDF_CRG/20120518_FDF_CRG_c12.mtb	3714	94	WWSS	food_sc	4	133699	1337466214	1	0.0600000000000001	0.000303030303030304	8323	1
3	Drink 2	Intake 2	28	133926	1337466441	/users/cn/jespinosa/phecomp/data/CRG/20120502_FDF_CRG/20120502_FDF_CRG/20120518_FDF_CRG_c12.mtb	2757	NA	WWSS	water	2	133898	1337466413	1	0.04	0.00142857142857143	8324	1
3	Drink 1	Intake 1	20	133979	1337466494	/users/cn/jespinosa/phecomp/data/CRG/20120502_FDF_CRG/20120502_FDF_CRG/20120518_FDF_CRG_c12.mtb	1250	NA	WWSS	water	1	133959	1337466474	1	0.0600000000000001	0.00300000000000001	8325	1
3	Food 2	Intake 4	18	134009	1337466524	/users/cn/jespinosa/phecomp/data/CRG/20120502_FDF_CRG/20120502_FDF_CRG/20120518_FDF_CRG_c12.mtb	3715	16	WWSS	food_sc	4	133991	1337466506	1	0.02	0.00111111111111111	8326	1
3	Food 2	Intake 4	161	134186	1337466701	/users/cn/jespinosa/phecomp/data/CRG/20120502_FDF_CRG/20120502_FDF_CRG/20120518_FDF_CRG_c12.mtb	3716	19	WWSS	food_sc	4	134025	1337466540	1	0.02	0.000124223602484472	8327	1
3	Food 2	Intake 4	79	134284	1337466799	/users/cn/jespinosa/phecomp/data/CRG/20120502_FDF_CRG/20120502_FDF_CRG/20120518_FDF_CRG_c12.mtb	3717	1114	WWSS	food_sc	4	134205	1337466720	1	0.02	0.000253164556962025	8328	1
3	Drink 2	Intake 2	29	134309	1337466824	/users/cn/jespinosa/phecomp/data/CRG/20120502_FDF_CRG/20120502_FDF_CRG/20120518_FDF_CRG_c12.mtb	2758	NA	WWSS	water	2	134280	1337466795	1	0.02	0.000689655172413793	8329	1
3	Drink 2	Intake 2	22	134380	1337466895	/users/cn/jespinosa/phecomp/data/CRG/20120502_FDF_CRG/20120502_FDF_CRG/20120518_FDF_CRG_c12.mtb	2759	NA	WWSS	water	2	134358	1337466873	1	0.02	0.000909090909090909	8330	1
3	Drink 2	Intake 2	15	134748	1337467263	/users/cn/jespinosa/phecomp/data/CRG/20120502_FDF_CRG/20120502_FDF_CRG/20120518_FDF_CRG_c12.mtb	2760	NA	WWSS	water	2	134733	1337467248	1	0.02	0.00133333333333333	8331	1
3	Drink 1	Intake 1	18	135342	1337467857	/users/cn/jespinosa/phecomp/data/CRG/20120502_FDF_CRG/20120502_FDF_CRG/20120518_FDF_CRG_c12.mtb	1251	NA	WWSS	water	1	135324	1337467839	1	0.04	0.00222222222222222	8332	1
3	Food 1	Intake 3	274	135672	1337468187	/users/cn/jespinosa/phecomp/data/CRG/20120502_FDF_CRG/20120502_FDF_CRG/20120518_FDF_CRG_c12.mtb	2225	103	WWSS	food_sc	3	135398	1337467913	1	0.0799999999999996	0.000291970802919707	8333	1
3	Drink 1	Intake 1	17	135688	1337468203	/users/cn/jespinosa/phecomp/data/CRG/20120502_FDF_CRG/20120502_FDF_CRG/20120518_FDF_CRG_c12.mtb	1252	NA	WWSS	water	1	135671	1337468186	1	0.04	0.00235294117647059	8334	1
3	Food 2	Intake 4	73	135848	1337468363	/users/cn/jespinosa/phecomp/data/CRG/20120502_FDF_CRG/20120502_FDF_CRG/20120518_FDF_CRG_c12.mtb	3720	193	WWSS	food_sc	4	135775	1337468290	1	0.02	0.000273972602739726	8335	1
3	Food 2	Intake 4	201	136242	1337468757	/users/cn/jespinosa/phecomp/data/CRG/20120502_FDF_CRG/20120502_FDF_CRG/20120518_FDF_CRG_c12.mtb	3722	605	WWSS	food_sc	4	136041	1337468556	1	0.0800000000000001	0.000398009950248757	8336	1
3	Drink 2	Intake 2	23	136264	1337468779	/users/cn/jespinosa/phecomp/data/CRG/20120502_FDF_CRG/20120502_FDF_CRG/20120518_FDF_CRG_c12.mtb	2764	NA	WWSS	water	2	136241	1337468756	1	0.0600000000000001	0.00260869565217392	8337	1
3	Drink 2	Intake 2	9	136808	1337469323	/users/cn/jespinosa/phecomp/data/CRG/20120502_FDF_CRG/20120502_FDF_CRG/20120518_FDF_CRG_c12.mtb	2765	NA	WWSS	water	2	136799	1337469314	1	0.02	0.00222222222222222	8338	1
3	Food 2	Intake 4	169	137016	1337469531	/users/cn/jespinosa/phecomp/data/CRG/20120502_FDF_CRG/20120502_FDF_CRG/20120518_FDF_CRG_c12.mtb	3723	736	WWSS	food_sc	4	136847	1337469362	1	0.02	0.000118343195266272	8339	1
3	Drink 1	Intake 1	14	137298	1337469813	/users/cn/jespinosa/phecomp/data/CRG/20120502_FDF_CRG/20120502_FDF_CRG/20120518_FDF_CRG_c12.mtb	1254	NA	WWSS	water	1	137284	1337469799	1	0.04	0.00285714285714286	8340	1
3	Food 2	Intake 4	297	138049	1337470564	/users/cn/jespinosa/phecomp/data/CRG/20120502_FDF_CRG/20120502_FDF_CRG/20120518_FDF_CRG_c12.mtb	3724	4562	WWSS	food_sc	4	137752	1337470267	1	0.1	0.000336700336700337	8341	1
3	Drink 1	Intake 1	21	138086	1337470601	/users/cn/jespinosa/phecomp/data/CRG/20120502_FDF_CRG/20120502_FDF_CRG/20120518_FDF_CRG_c12.mtb	1255	NA	WWSS	water	1	138065	1337470580	1	0.0599999999999996	0.00285714285714284	8342	1
3	Food 2	Intake 4	131	142742	1337475257	/users/cn/jespinosa/phecomp/data/CRG/20120502_FDF_CRG/20120502_FDF_CRG/20120518_FDF_CRG_c12.mtb	3728	86	WWSS	food_sc	4	142611	1337475126	1	0.02	0.000152671755725191	8343	1
3	Food 2	Intake 4	260	143088	1337475603	/users/cn/jespinosa/phecomp/data/CRG/20120502_FDF_CRG/20120502_FDF_CRG/20120518_FDF_CRG_c12.mtb	3729	6	WWSS	food_sc	4	142828	1337475343	1	0.0800000000000001	0.000307692307692308	8344	1
3	Food 2	Intake 4	251	143345	1337475860	/users/cn/jespinosa/phecomp/data/CRG/20120502_FDF_CRG/20120502_FDF_CRG/20120518_FDF_CRG_c12.mtb	3730	5112	WWSS	food_sc	4	143094	1337475609	1	0.12	0.00047808764940239	8345	1
3	Drink 1	Intake 1	31	143386	1337475901	/users/cn/jespinosa/phecomp/data/CRG/20120502_FDF_CRG/20120502_FDF_CRG/20120518_FDF_CRG_c12.mtb	1256	NA	WWSS	water	1	143355	1337475870	1	0.1	0.0032258064516129	8346	1
3	Drink 2	Intake 2	25	143571	1337476086	/users/cn/jespinosa/phecomp/data/CRG/20120502_FDF_CRG/20120502_FDF_CRG/20120518_FDF_CRG_c12.mtb	2768	NA	WWSS	water	2	143546	1337476061	1	0.02	0.0008	8347	1
3	Drink 1	Intake 1	28	143751	1337476266	/users/cn/jespinosa/phecomp/data/CRG/20120502_FDF_CRG/20120502_FDF_CRG/20120518_FDF_CRG_c12.mtb	1258	NA	WWSS	water	1	143723	1337476238	1	0.02	0.000714285714285714	8348	1
3	Drink 1	Intake 1	14	143975	1337476490	/users/cn/jespinosa/phecomp/data/CRG/20120502_FDF_CRG/20120502_FDF_CRG/20120518_FDF_CRG_c12.mtb	1259	NA	WWSS	water	1	143961	1337476476	1	0.02	0.00142857142857143	8349	1
3	Drink 1	Intake 1	22	144525	1337477040	/users/cn/jespinosa/phecomp/data/CRG/20120502_FDF_CRG/20120502_FDF_CRG/20120518_FDF_CRG_c12.mtb	1260	NA	WWSS	water	1	144503	1337477018	1	0.02	0.000909090909090909	8350	1
3	Food 2	Intake 4	121	148578	1337481093	/users/cn/jespinosa/phecomp/data/CRG/20120502_FDF_CRG/20120502_FDF_CRG/20120518_FDF_CRG_c12.mtb	3736	55	WWSS	food_sc	4	148457	1337480972	1	0.02	0.000165289256198347	8351	1
3	Food 2	Intake 4	262	148895	1337481410	/users/cn/jespinosa/phecomp/data/CRG/20120502_FDF_CRG/20120502_FDF_CRG/20120518_FDF_CRG_c12.mtb	3737	246	WWSS	food_sc	4	148633	1337481148	1	0.1	0.000381679389312977	8352	1
3	Drink 1	Intake 1	19	148936	1337481451	/users/cn/jespinosa/phecomp/data/CRG/20120502_FDF_CRG/20120502_FDF_CRG/20120518_FDF_CRG_c12.mtb	1261	NA	WWSS	water	1	148917	1337481432	1	0.02	0.00105263157894737	8353	1
3	Food 2	Intake 4	148	149289	1337481804	/users/cn/jespinosa/phecomp/data/CRG/20120502_FDF_CRG/20120502_FDF_CRG/20120518_FDF_CRG_c12.mtb	3738	34	WWSS	food_sc	4	149141	1337481656	1	0.02	0.000135135135135135	8354	1
3	Drink 2	Intake 2	23	149319	1337481834	/users/cn/jespinosa/phecomp/data/CRG/20120502_FDF_CRG/20120502_FDF_CRG/20120518_FDF_CRG_c12.mtb	2780	NA	WWSS	water	2	149296	1337481811	1	0.0600000000000001	0.00260869565217392	8355	1
3	Food 2	Intake 4	72	149395	1337481910	/users/cn/jespinosa/phecomp/data/CRG/20120502_FDF_CRG/20120502_FDF_CRG/20120518_FDF_CRG_c12.mtb	3739	5347	WWSS	food_sc	4	149323	1337481838	1	0.04	0.000555555555555556	8356	1
3	Drink 1	Intake 1	15	149524	1337482039	/users/cn/jespinosa/phecomp/data/CRG/20120502_FDF_CRG/20120502_FDF_CRG/20120518_FDF_CRG_c12.mtb	1263	NA	WWSS	water	1	149509	1337482024	1	0.0600000000000001	0.00400000000000001	8357	1
3	Drink 1	Intake 1	17	149658	1337482173	/users/cn/jespinosa/phecomp/data/CRG/20120502_FDF_CRG/20120502_FDF_CRG/20120518_FDF_CRG_c12.mtb	1264	NA	WWSS	water	1	149641	1337482156	1	0.02	0.00117647058823529	8358	1
3	Drink 1	Intake 1	11	150159	1337482674	/users/cn/jespinosa/phecomp/data/CRG/20120502_FDF_CRG/20120502_FDF_CRG/20120518_FDF_CRG_c12.mtb	1265	NA	WWSS	water	1	150148	1337482663	1	0.02	0.00181818181818182	8359	1
3	Food 2	Intake 4	18	154760	1337487275	/users/cn/jespinosa/phecomp/data/CRG/20120502_FDF_CRG/20120502_FDF_CRG/20120518_FDF_CRG_c12.mtb	3744	634	WWSS	food_sc	4	154742	1337487257	1	0.02	0.00111111111111111	8360	1
3	Food 2	Intake 4	96	155490	1337488005	/users/cn/jespinosa/phecomp/data/CRG/20120502_FDF_CRG/20120502_FDF_CRG/20120518_FDF_CRG_c12.mtb	3749	13	WWSS	food_sc	4	155394	1337487909	1	0.02	0.000208333333333333	8361	1
3	Food 2	Intake 4	163	155666	1337488181	/users/cn/jespinosa/phecomp/data/CRG/20120502_FDF_CRG/20120502_FDF_CRG/20120518_FDF_CRG_c12.mtb	3750	115	WWSS	food_sc	4	155503	1337488018	1	0.02	0.000122699386503067	8362	1
3	Drink 2	Intake 2	17	155770	1337488285	/users/cn/jespinosa/phecomp/data/CRG/20120502_FDF_CRG/20120502_FDF_CRG/20120518_FDF_CRG_c12.mtb	2782	NA	WWSS	water	2	155753	1337488268	1	0.02	0.00117647058823529	8363	1
3	Food 2	Intake 4	387	156168	1337488683	/users/cn/jespinosa/phecomp/data/CRG/20120502_FDF_CRG/20120502_FDF_CRG/20120518_FDF_CRG_c12.mtb	3752	2941	WWSS	food_sc	4	155781	1337488296	1	0.16	0.00041343669250646	8364	1
3	Drink 1	Intake 1	47	156209	1337488724	/users/cn/jespinosa/phecomp/data/CRG/20120502_FDF_CRG/20120502_FDF_CRG/20120518_FDF_CRG_c12.mtb	1268	NA	WWSS	water	1	156162	1337488677	1	0.16	0.00340425531914894	8365	1
3	Drink 1	Intake 1	20	156273	1337488788	/users/cn/jespinosa/phecomp/data/CRG/20120502_FDF_CRG/20120502_FDF_CRG/20120518_FDF_CRG_c12.mtb	1269	NA	WWSS	water	1	156253	1337488768	1	0.0599999999999996	0.00299999999999998	8366	1
3	Drink 1	Intake 1	17	158139	1337490654	/users/cn/jespinosa/phecomp/data/CRG/20120502_FDF_CRG/20120502_FDF_CRG/20120518_FDF_CRG_c12.mtb	1270	NA	WWSS	water	1	158122	1337490637	1	0.04	0.00235294117647059	8367	1
3	Food 1	Intake 3	17	159126	1337491641	/users/cn/jespinosa/phecomp/data/CRG/20120502_FDF_CRG/20120502_FDF_CRG/20120518_FDF_CRG_c12.mtb	2236	423	WWSS	food_sc	3	159109	1337491624	1	0.02	0.00117647058823529	8368	1
3	Food 2	Intake 4	66	159615	1337492130	/users/cn/jespinosa/phecomp/data/CRG/20120502_FDF_CRG/20120502_FDF_CRG/20120518_FDF_CRG_c12.mtb	3757	44	WWSS	food_sc	4	159549	1337492064	1	0.02	0.000303030303030303	8369	1
3	Food 2	Intake 4	222	159881	1337492396	/users/cn/jespinosa/phecomp/data/CRG/20120502_FDF_CRG/20120502_FDF_CRG/20120518_FDF_CRG_c12.mtb	3758	32	WWSS	food_sc	4	159659	1337492174	1	0.0800000000000001	0.000360360360360361	8370	1
3	Drink 1	Intake 1	19	159914	1337492429	/users/cn/jespinosa/phecomp/data/CRG/20120502_FDF_CRG/20120502_FDF_CRG/20120518_FDF_CRG_c12.mtb	1271	NA	WWSS	water	1	159895	1337492410	1	0.02	0.00105263157894737	8371	1
3	Food 2	Intake 4	129	160042	1337492557	/users/cn/jespinosa/phecomp/data/CRG/20120502_FDF_CRG/20120502_FDF_CRG/20120518_FDF_CRG_c12.mtb	3759	54	WWSS	food_sc	4	159913	1337492428	1	0.0600000000000001	0.000465116279069768	8372	1
3	Food 2	Intake 4	182	160278	1337492793	/users/cn/jespinosa/phecomp/data/CRG/20120502_FDF_CRG/20120502_FDF_CRG/20120518_FDF_CRG_c12.mtb	3760	766	WWSS	food_sc	4	160096	1337492611	1	0.04	0.00021978021978022	8373	1
3	Drink 2	Intake 2	23	160336	1337492851	/users/cn/jespinosa/phecomp/data/CRG/20120502_FDF_CRG/20120502_FDF_CRG/20120518_FDF_CRG_c12.mtb	2785	NA	WWSS	water	2	160313	1337492828	1	0.0600000000000001	0.00260869565217392	8374	1
3	Drink 2	Intake 2	18	160529	1337493044	/users/cn/jespinosa/phecomp/data/CRG/20120502_FDF_CRG/20120502_FDF_CRG/20120518_FDF_CRG_c12.mtb	2786	NA	WWSS	water	2	160511	1337493026	1	0.04	0.00222222222222222	8375	1
3	Food 1	Intake 3	125	161169	1337493684	/users/cn/jespinosa/phecomp/data/CRG/20120502_FDF_CRG/20120502_FDF_CRG/20120518_FDF_CRG_c12.mtb	2240	48	WWSS	food_sc	3	161044	1337493559	1	0.02	0.00016	8376	1
3	Drink 2	Intake 2	22	161210	1337493725	/users/cn/jespinosa/phecomp/data/CRG/20120502_FDF_CRG/20120502_FDF_CRG/20120518_FDF_CRG_c12.mtb	2787	NA	WWSS	water	2	161188	1337493703	1	0.02	0.000909090909090909	8377	1
3	Food 2	Intake 4	137	161354	1337493869	/users/cn/jespinosa/phecomp/data/CRG/20120502_FDF_CRG/20120502_FDF_CRG/20120518_FDF_CRG_c12.mtb	3765	3501	WWSS	food_sc	4	161217	1337493732	1	0.02	0.000145985401459854	8378	1
3	Drink 2	Intake 2	16	161382	1337493897	/users/cn/jespinosa/phecomp/data/CRG/20120502_FDF_CRG/20120502_FDF_CRG/20120518_FDF_CRG_c12.mtb	2788	NA	WWSS	water	2	161366	1337493881	1	0.04	0.0025	8379	1
3	Drink 1	Intake 1	18	161533	1337494048	/users/cn/jespinosa/phecomp/data/CRG/20120502_FDF_CRG/20120502_FDF_CRG/20120518_FDF_CRG_c12.mtb	1273	NA	WWSS	water	1	161515	1337494030	1	0.04	0.00222222222222222	8380	1
3	Food 2	Intake 4	270	165125	1337497640	/users/cn/jespinosa/phecomp/data/CRG/20120502_FDF_CRG/20120502_FDF_CRG/20120518_FDF_CRG_c12.mtb	3767	25942	WWSS	food_sc	4	164855	1337497370	1	0.0800000000000001	0.000296296296296297	8381	1
3	Drink 1	Intake 1	23	177234	1337509749	/users/cn/jespinosa/phecomp/data/CRG/20120502_FDF_CRG/20120502_FDF_CRG/20120518_FDF_CRG_c12.mtb	1274	NA	WWSS	water	1	177211	1337509726	1	0.0600000000000001	0.00260869565217392	8382	1
3	Food 2	Intake 4	30	191097	1337523612	/users/cn/jespinosa/phecomp/data/CRG/20120502_FDF_CRG/20120502_FDF_CRG/20120518_FDF_CRG_c12.mtb	3769	11964	WWSS	food_sc	4	191067	1337523582	1	0.02	0.000666666666666667	8383	1
3	Food 1	Intake 3	78	203139	1337535654	/users/cn/jespinosa/phecomp/data/CRG/20120502_FDF_CRG/20120502_FDF_CRG/20120518_FDF_CRG_c12.mtb	2245	55	WWSS	food_sc	3	203061	1337535576	1	0.02	0.000256410256410256	8384	1
3	Food 2	Intake 4	76	203270	1337535785	/users/cn/jespinosa/phecomp/data/CRG/20120502_FDF_CRG/20120502_FDF_CRG/20120518_FDF_CRG_c12.mtb	3771	1778	WWSS	food_sc	4	203194	1337535709	1	0.02	0.000263157894736842	8385	1
3	Food 2	Intake 4	79	205127	1337537642	/users/cn/jespinosa/phecomp/data/CRG/20120502_FDF_CRG/20120502_FDF_CRG/20120518_FDF_CRG_c12.mtb	3773	6	WWSS	food_sc	4	205048	1337537563	1	0.02	0.000253164556962025	8386	1
3	Food 2	Intake 4	160	205293	1337537808	/users/cn/jespinosa/phecomp/data/CRG/20120502_FDF_CRG/20120502_FDF_CRG/20120518_FDF_CRG_c12.mtb	3774	40	WWSS	food_sc	4	205133	1337537648	1	0.02	0.000125	8387	1
3	Food 2	Intake 4	201	205534	1337538049	/users/cn/jespinosa/phecomp/data/CRG/20120502_FDF_CRG/20120502_FDF_CRG/20120518_FDF_CRG_c12.mtb	3775	130	WWSS	food_sc	4	205333	1337537848	1	0.0600000000000001	0.000298507462686568	8388	1
3	Drink 1	Intake 1	10	205543	1337538058	/users/cn/jespinosa/phecomp/data/CRG/20120502_FDF_CRG/20120502_FDF_CRG/20120518_FDF_CRG_c12.mtb	1277	NA	WWSS	water	1	205533	1337538048	1	0.02	0.002	8389	1
3	Drink 1	Intake 1	16	205581	1337538096	/users/cn/jespinosa/phecomp/data/CRG/20120502_FDF_CRG/20120502_FDF_CRG/20120518_FDF_CRG_c12.mtb	1278	NA	WWSS	water	1	205565	1337538080	1	0.02	0.00125	8390	1
3	Food 1	Intake 3	181	205845	1337538360	/users/cn/jespinosa/phecomp/data/CRG/20120502_FDF_CRG/20120502_FDF_CRG/20120518_FDF_CRG_c12.mtb	2249	1074	WWSS	food_sc	3	205664	1337538179	1	0.0800000000000001	0.000441988950276244	8391	1
3	Drink 1	Intake 1	22	205876	1337538391	/users/cn/jespinosa/phecomp/data/CRG/20120502_FDF_CRG/20120502_FDF_CRG/20120518_FDF_CRG_c12.mtb	1279	NA	WWSS	water	1	205854	1337538369	1	0.0600000000000001	0.00272727272727273	8392	1
3	Drink 1	Intake 1	17	205897	1337538412	/users/cn/jespinosa/phecomp/data/CRG/20120502_FDF_CRG/20120502_FDF_CRG/20120518_FDF_CRG_c12.mtb	1280	NA	WWSS	water	1	205880	1337538395	1	0.02	0.00117647058823529	8393	1
3	Drink 1	Intake 1	12	206291	1337538806	/users/cn/jespinosa/phecomp/data/CRG/20120502_FDF_CRG/20120502_FDF_CRG/20120518_FDF_CRG_c12.mtb	1281	NA	WWSS	water	1	206279	1337538794	1	0.04	0.00333333333333333	8394	1
3	Food 1	Intake 3	353	207272	1337539787	/users/cn/jespinosa/phecomp/data/CRG/20120502_FDF_CRG/20120502_FDF_CRG/20120518_FDF_CRG_c12.mtb	2251	1034	WWSS	food_sc	3	206919	1337539434	1	0.0600000000000001	0.000169971671388102	8395	1
3	Drink 2	Intake 2	25	207307	1337539822	/users/cn/jespinosa/phecomp/data/CRG/20120502_FDF_CRG/20120502_FDF_CRG/20120518_FDF_CRG_c12.mtb	2793	NA	WWSS	water	2	207282	1337539797	1	0.0799999999999998	0.00319999999999999	8396	1
3	Drink 1	Intake 1	33	207772	1337540287	/users/cn/jespinosa/phecomp/data/CRG/20120502_FDF_CRG/20120502_FDF_CRG/20120518_FDF_CRG_c12.mtb	1282	NA	WWSS	water	1	207739	1337540254	1	0.04	0.00121212121212121	8397	1
3	Food 1	Intake 3	655	208961	1337541476	/users/cn/jespinosa/phecomp/data/CRG/20120502_FDF_CRG/20120502_FDF_CRG/20120518_FDF_CRG_c12.mtb	2253	1101	WWSS	food_sc	3	208306	1337540821	1	0.32	0.000488549618320611	8398	1
3	Drink 1	Intake 1	22	208983	1337541498	/users/cn/jespinosa/phecomp/data/CRG/20120502_FDF_CRG/20120502_FDF_CRG/20120518_FDF_CRG_c12.mtb	1283	NA	WWSS	water	1	208961	1337541476	1	0.0999999999999996	0.00454545454545453	8399	1
3	Drink 2	Intake 2	32	209046	1337541561	/users/cn/jespinosa/phecomp/data/CRG/20120502_FDF_CRG/20120502_FDF_CRG/20120518_FDF_CRG_c12.mtb	2794	NA	WWSS	water	2	209014	1337541529	1	0.04	0.00125	8400	1
3	Drink 1	Intake 1	16	209131	1337541646	/users/cn/jespinosa/phecomp/data/CRG/20120502_FDF_CRG/20120502_FDF_CRG/20120518_FDF_CRG_c12.mtb	1284	NA	WWSS	water	1	209115	1337541630	1	0.02	0.00125	8401	1
3	Drink 2	Intake 2	24	209293	1337541808	/users/cn/jespinosa/phecomp/data/CRG/20120502_FDF_CRG/20120502_FDF_CRG/20120518_FDF_CRG_c12.mtb	2795	NA	WWSS	water	2	209269	1337541784	1	0.0600000000000001	0.0025	8402	1
3	Drink 1	Intake 1	14	209672	1337542187	/users/cn/jespinosa/phecomp/data/CRG/20120502_FDF_CRG/20120502_FDF_CRG/20120518_FDF_CRG_c12.mtb	1286	NA	WWSS	water	1	209658	1337542173	1	0.04	0.00285714285714286	8403	1
3	Food 1	Intake 3	264	210326	1337542841	/users/cn/jespinosa/phecomp/data/CRG/20120502_FDF_CRG/20120502_FDF_CRG/20120518_FDF_CRG_c12.mtb	2256	1494	WWSS	food_sc	3	210062	1337542577	1	0.14	0.00053030303030303	8404	1
3	Drink 1	Intake 1	21	210563	1337543078	/users/cn/jespinosa/phecomp/data/CRG/20120502_FDF_CRG/20120502_FDF_CRG/20120518_FDF_CRG_c12.mtb	1287	NA	WWSS	water	1	210542	1337543057	1	0.0600000000000001	0.00285714285714286	8405	1
3	Food 1	Intake 3	204	212024	1337544539	/users/cn/jespinosa/phecomp/data/CRG/20120502_FDF_CRG/20120502_FDF_CRG/20120518_FDF_CRG_c12.mtb	2257	2276	WWSS	food_sc	3	211820	1337544335	1	0.12	0.000588235294117647	8406	1
3	Drink 1	Intake 1	18	212563	1337545078	/users/cn/jespinosa/phecomp/data/CRG/20120502_FDF_CRG/20120502_FDF_CRG/20120518_FDF_CRG_c12.mtb	1288	NA	WWSS	water	1	212545	1337545060	1	0.0800000000000001	0.00444444444444445	8407	1
3	Food 1	Intake 3	201	214501	1337547016	/users/cn/jespinosa/phecomp/data/CRG/20120502_FDF_CRG/20120502_FDF_CRG/20120518_FDF_CRG_c12.mtb	2258	653	WWSS	food_sc	3	214300	1337546815	1	0.1	0.000497512437810945	8408	1
3	Drink 1	Intake 1	17	214800	1337547315	/users/cn/jespinosa/phecomp/data/CRG/20120502_FDF_CRG/20120502_FDF_CRG/20120518_FDF_CRG_c12.mtb	1289	NA	WWSS	water	1	214783	1337547298	1	0.02	0.00117647058823529	8409	1
3	Drink 1	Intake 1	11	215030	1337547545	/users/cn/jespinosa/phecomp/data/CRG/20120502_FDF_CRG/20120502_FDF_CRG/20120518_FDF_CRG_c12.mtb	1290	NA	WWSS	water	1	215019	1337547534	1	0.04	0.00363636363636364	8410	1
3	Food 1	Intake 3	38	215192	1337547707	/users/cn/jespinosa/phecomp/data/CRG/20120502_FDF_CRG/20120502_FDF_CRG/20120518_FDF_CRG_c12.mtb	2260	1193	WWSS	food_sc	3	215154	1337547669	1	0.26	0.0068421052631579	8411	1
3	Drink 1	Intake 1	13	215572	1337548087	/users/cn/jespinosa/phecomp/data/CRG/20120502_FDF_CRG/20120502_FDF_CRG/20120518_FDF_CRG_c12.mtb	1291	NA	WWSS	water	1	215559	1337548074	1	0.0600000000000001	0.00461538461538462	8412	1
3	Drink 2	Intake 2	23	215960	1337548475	/users/cn/jespinosa/phecomp/data/CRG/20120502_FDF_CRG/20120502_FDF_CRG/20120518_FDF_CRG_c12.mtb	2796	NA	WWSS	water	2	215937	1337548452	1	0.0399999999999998	0.0017391304347826	8413	1
3	Food 1	Intake 3	54	216439	1337548954	/users/cn/jespinosa/phecomp/data/CRG/20120502_FDF_CRG/20120502_FDF_CRG/20120518_FDF_CRG_c12.mtb	2261	1692	WWSS	food_sc	3	216385	1337548900	1	0.02	0.00037037037037037	8414	1
3	Drink 1	Intake 1	23	216459	1337548974	/users/cn/jespinosa/phecomp/data/CRG/20120502_FDF_CRG/20120502_FDF_CRG/20120518_FDF_CRG_c12.mtb	1293	NA	WWSS	water	1	216436	1337548951	1	0.0600000000000001	0.00260869565217392	8415	1
3	Drink 2	Intake 2	27	216847	1337549362	/users/cn/jespinosa/phecomp/data/CRG/20120502_FDF_CRG/20120502_FDF_CRG/20120518_FDF_CRG_c12.mtb	2798	NA	WWSS	water	2	216820	1337549335	1	0.0800000000000001	0.00296296296296297	8416	1
3	Drink 2	Intake 2	29	217747	1337550262	/users/cn/jespinosa/phecomp/data/CRG/20120502_FDF_CRG/20120502_FDF_CRG/20120518_FDF_CRG_c12.mtb	2800	NA	WWSS	water	2	217718	1337550233	1	0.0800000000000001	0.00275862068965518	8417	1
3	Food 2	Intake 4	253	218384	1337550899	/users/cn/jespinosa/phecomp/data/CRG/20120502_FDF_CRG/20120502_FDF_CRG/20120518_FDF_CRG_c12.mtb	3804	419	WWSS	food_sc	4	218131	1337550646	1	0.0200000000000005	7.90513833992115e-05	8418	1
3	Drink 1	Intake 1	18	218616	1337551131	/users/cn/jespinosa/phecomp/data/CRG/20120502_FDF_CRG/20120502_FDF_CRG/20120518_FDF_CRG_c12.mtb	1294	NA	WWSS	water	1	218598	1337551113	1	0.0600000000000001	0.00333333333333334	8419	1
3	Food 2	Intake 4	268	219071	1337551586	/users/cn/jespinosa/phecomp/data/CRG/20120502_FDF_CRG/20120502_FDF_CRG/20120518_FDF_CRG_c12.mtb	3809	1873	WWSS	food_sc	4	218803	1337551318	1	0.0599999999999996	0.000223880597014924	8420	1
3	Drink 1	Intake 1	15	219630	1337552145	/users/cn/jespinosa/phecomp/data/CRG/20120502_FDF_CRG/20120502_FDF_CRG/20120518_FDF_CRG_c12.mtb	1295	NA	WWSS	water	1	219615	1337552130	1	0.04	0.00266666666666667	8421	1
3	Food 1	Intake 3	212	221156	1337553671	/users/cn/jespinosa/phecomp/data/CRG/20120502_FDF_CRG/20120502_FDF_CRG/20120518_FDF_CRG_c12.mtb	2266	374	WWSS	food_sc	3	220944	1337553459	1	0.0600000000000001	0.000283018867924529	8422	1
3	Drink 2	Intake 2	20	221521	1337554036	/users/cn/jespinosa/phecomp/data/CRG/20120502_FDF_CRG/20120502_FDF_CRG/20120518_FDF_CRG_c12.mtb	2802	NA	WWSS	water	2	221501	1337554016	1	0.02	0.001	8423	1
3	Food 2	Intake 4	133	221663	1337554178	/users/cn/jespinosa/phecomp/data/CRG/20120502_FDF_CRG/20120502_FDF_CRG/20120518_FDF_CRG_c12.mtb	3813	9	WWSS	food_sc	4	221530	1337554045	1	0.02	0.000150375939849624	8424	1
3	Food 2	Intake 4	133	221805	1337554320	/users/cn/jespinosa/phecomp/data/CRG/20120502_FDF_CRG/20120502_FDF_CRG/20120518_FDF_CRG_c12.mtb	3814	136	WWSS	food_sc	4	221672	1337554187	1	0.04	0.000300751879699248	8425	1
3	Drink 2	Intake 2	15	221820	1337554335	/users/cn/jespinosa/phecomp/data/CRG/20120502_FDF_CRG/20120502_FDF_CRG/20120518_FDF_CRG_c12.mtb	2803	NA	WWSS	water	2	221805	1337554320	1	0.02	0.00133333333333333	8426	1
3	Food 2	Intake 4	211	222152	1337554667	/users/cn/jespinosa/phecomp/data/CRG/20120502_FDF_CRG/20120502_FDF_CRG/20120518_FDF_CRG_c12.mtb	3816	184	WWSS	food_sc	4	221941	1337554456	1	0.0600000000000001	0.00028436018957346	8427	1
3	Drink 2	Intake 2	25	222166	1337554681	/users/cn/jespinosa/phecomp/data/CRG/20120502_FDF_CRG/20120502_FDF_CRG/20120518_FDF_CRG_c12.mtb	2804	NA	WWSS	water	2	222141	1337554656	1	0.0800000000000001	0.0032	8428	1
3	Food 2	Intake 4	125	222461	1337554976	/users/cn/jespinosa/phecomp/data/CRG/20120502_FDF_CRG/20120502_FDF_CRG/20120518_FDF_CRG_c12.mtb	3819	402	WWSS	food_sc	4	222336	1337554851	1	0.02	0.00016	8429	1
3	Drink 2	Intake 2	22	222478	1337554993	/users/cn/jespinosa/phecomp/data/CRG/20120502_FDF_CRG/20120502_FDF_CRG/20120518_FDF_CRG_c12.mtb	2805	NA	WWSS	water	2	222456	1337554971	1	0.0600000000000001	0.00272727272727273	8430	1
3	Drink 2	Intake 2	16	222645	1337555160	/users/cn/jespinosa/phecomp/data/CRG/20120502_FDF_CRG/20120502_FDF_CRG/20120518_FDF_CRG_c12.mtb	2806	NA	WWSS	water	2	222629	1337555144	1	0.02	0.00125	8431	1
3	Food 2	Intake 4	50	222913	1337555428	/users/cn/jespinosa/phecomp/data/CRG/20120502_FDF_CRG/20120502_FDF_CRG/20120518_FDF_CRG_c12.mtb	3822	17	WWSS	food_sc	4	222863	1337555378	1	0.02	0.0004	8432	1
3	Food 1	Intake 3	66	222996	1337555511	/users/cn/jespinosa/phecomp/data/CRG/20120502_FDF_CRG/20120502_FDF_CRG/20120518_FDF_CRG_c12.mtb	2268	431	WWSS	food_sc	3	222930	1337555445	1	0.02	0.000303030303030303	8433	1
3	Drink 1	Intake 1	17	223208	1337555723	/users/cn/jespinosa/phecomp/data/CRG/20120502_FDF_CRG/20120502_FDF_CRG/20120518_FDF_CRG_c12.mtb	1299	NA	WWSS	water	1	223191	1337555706	1	0.04	0.00235294117647059	8434	1
3	Food 2	Intake 4	102	223529	1337556044	/users/cn/jespinosa/phecomp/data/CRG/20120502_FDF_CRG/20120502_FDF_CRG/20120518_FDF_CRG_c12.mtb	3825	587	WWSS	food_sc	4	223427	1337555942	1	0.02	0.000196078431372549	8435	1
3	Drink 2	Intake 2	18	224109	1337556624	/users/cn/jespinosa/phecomp/data/CRG/20120502_FDF_CRG/20120502_FDF_CRG/20120518_FDF_CRG_c12.mtb	2807	NA	WWSS	water	2	224091	1337556606	1	0.04	0.00222222222222222	8436	1
3	Food 2	Intake 4	169	224285	1337556800	/users/cn/jespinosa/phecomp/data/CRG/20120502_FDF_CRG/20120502_FDF_CRG/20120518_FDF_CRG_c12.mtb	3828	174	WWSS	food_sc	4	224116	1337556631	1	0.02	0.000118343195266272	8437	1
3	Food 2	Intake 4	52	224511	1337557026	/users/cn/jespinosa/phecomp/data/CRG/20120502_FDF_CRG/20120502_FDF_CRG/20120518_FDF_CRG_c12.mtb	3831	363	WWSS	food_sc	4	224459	1337556974	1	0.02	0.000384615384615385	8438	1
3	Food 2	Intake 4	237	225111	1337557626	/users/cn/jespinosa/phecomp/data/CRG/20120502_FDF_CRG/20120502_FDF_CRG/20120518_FDF_CRG_c12.mtb	3832	180	WWSS	food_sc	4	224874	1337557389	1	0.02	8.43881856540084e-05	8439	1
3	Drink 1	Intake 1	15	225235	1337557750	/users/cn/jespinosa/phecomp/data/CRG/20120502_FDF_CRG/20120502_FDF_CRG/20120518_FDF_CRG_c12.mtb	1301	NA	WWSS	water	1	225220	1337557735	1	0.02	0.00133333333333333	8440	1
3	Food 1	Intake 3	117	225408	1337557923	/users/cn/jespinosa/phecomp/data/CRG/20120502_FDF_CRG/20120502_FDF_CRG/20120518_FDF_CRG_c12.mtb	2274	1894	WWSS	food_sc	3	225291	1337557806	1	0.02	0.000170940170940171	8441	1
3	Drink 1	Intake 1	11	225491	1337558006	/users/cn/jespinosa/phecomp/data/CRG/20120502_FDF_CRG/20120502_FDF_CRG/20120518_FDF_CRG_c12.mtb	1302	NA	WWSS	water	1	225480	1337557995	1	0.02	0.00181818181818182	8442	1
3	Food 1	Intake 3	111	227413	1337559928	/users/cn/jespinosa/phecomp/data/CRG/20120502_FDF_CRG/20120502_FDF_CRG/20120518_FDF_CRG_c12.mtb	2275	602	WWSS	food_sc	3	227302	1337559817	1	0.02	0.00018018018018018	8443	1
3	Food 1	Intake 3	158	228173	1337560688	/users/cn/jespinosa/phecomp/data/CRG/20120502_FDF_CRG/20120502_FDF_CRG/20120518_FDF_CRG_c12.mtb	2277	53	WWSS	food_sc	3	228015	1337560530	1	0.02	0.000126582278481013	8444	1
3	Food 1	Intake 3	343	228569	1337561084	/users/cn/jespinosa/phecomp/data/CRG/20120502_FDF_CRG/20120502_FDF_CRG/20120518_FDF_CRG_c12.mtb	2278	479	WWSS	food_sc	3	228226	1337560741	1	0.0799999999999996	0.000233236151603497	8445	1
3	Drink 2	Intake 2	23	228583	1337561098	/users/cn/jespinosa/phecomp/data/CRG/20120502_FDF_CRG/20120502_FDF_CRG/20120518_FDF_CRG_c12.mtb	2810	NA	WWSS	water	2	228560	1337561075	1	0.04	0.00173913043478261	8446	1
3	Drink 2	Intake 2	18	228623	1337561138	/users/cn/jespinosa/phecomp/data/CRG/20120502_FDF_CRG/20120502_FDF_CRG/20120518_FDF_CRG_c12.mtb	2811	NA	WWSS	water	2	228605	1337561120	1	0.02	0.00111111111111111	8447	1
3	Drink 1	Intake 1	12	228989	1337561504	/users/cn/jespinosa/phecomp/data/CRG/20120502_FDF_CRG/20120502_FDF_CRG/20120518_FDF_CRG_c12.mtb	1303	NA	WWSS	water	1	228977	1337561492	1	0.02	0.00166666666666667	8448	1
3	Food 1	Intake 3	205	229253	1337561768	/users/cn/jespinosa/phecomp/data/CRG/20120502_FDF_CRG/20120502_FDF_CRG/20120518_FDF_CRG_c12.mtb	2282	6908	WWSS	food_sc	3	229048	1337561563	1	0.04	0.000195121951219512	8449	1
3	Drink 2	Intake 2	19	229333	1337561848	/users/cn/jespinosa/phecomp/data/CRG/20120502_FDF_CRG/20120502_FDF_CRG/20120518_FDF_CRG_c12.mtb	2812	NA	WWSS	water	2	229314	1337561829	1	0.04	0.00210526315789474	8450	1
3	Food 2	Intake 4	349	236510	1337569025	/users/cn/jespinosa/phecomp/data/CRG/20120502_FDF_CRG/20120502_FDF_CRG/20120518_FDF_CRG_c12.mtb	3850	13	WWSS	food_sc	4	236161	1337568676	1	0.16	0.000458452722063037	8451	1
3	Food 2	Intake 4	150	236673	1337569188	/users/cn/jespinosa/phecomp/data/CRG/20120502_FDF_CRG/20120502_FDF_CRG/20120518_FDF_CRG_c12.mtb	3851	90	WWSS	food_sc	4	236523	1337569038	1	0.0799999999999996	0.000533333333333331	8452	1
3	Drink 2	Intake 2	25	236692	1337569207	/users/cn/jespinosa/phecomp/data/CRG/20120502_FDF_CRG/20120502_FDF_CRG/20120518_FDF_CRG_c12.mtb	2813	NA	WWSS	water	2	236667	1337569182	1	0.0800000000000001	0.0032	8453	1
3	Drink 1	Intake 1	15	236720	1337569235	/users/cn/jespinosa/phecomp/data/CRG/20120502_FDF_CRG/20120502_FDF_CRG/20120518_FDF_CRG_c12.mtb	1304	NA	WWSS	water	1	236705	1337569220	1	0.02	0.00133333333333333	8454	1
3	Food 2	Intake 4	23	236786	1337569301	/users/cn/jespinosa/phecomp/data/CRG/20120502_FDF_CRG/20120502_FDF_CRG/20120518_FDF_CRG_c12.mtb	3852	3948	WWSS	food_sc	4	236763	1337569278	1	0.02	0.000869565217391304	8455	1
3	Drink 2	Intake 2	16	236817	1337569332	/users/cn/jespinosa/phecomp/data/CRG/20120502_FDF_CRG/20120502_FDF_CRG/20120518_FDF_CRG_c12.mtb	2814	NA	WWSS	water	2	236801	1337569316	1	0.04	0.0025	8456	1
3	Drink 2	Intake 2	18	236954	1337569469	/users/cn/jespinosa/phecomp/data/CRG/20120502_FDF_CRG/20120502_FDF_CRG/20120518_FDF_CRG_c12.mtb	2815	NA	WWSS	water	2	236936	1337569451	1	0.04	0.00222222222222222	8457	1
3	Drink 1	Intake 1	9	237245	1337569760	/users/cn/jespinosa/phecomp/data/CRG/20120502_FDF_CRG/20120502_FDF_CRG/20120518_FDF_CRG_c12.mtb	1305	NA	WWSS	water	1	237236	1337569751	1	0.04	0.00444444444444444	8458	1
3	Drink 2	Intake 2	17	238101	1337570616	/users/cn/jespinosa/phecomp/data/CRG/20120502_FDF_CRG/20120502_FDF_CRG/20120518_FDF_CRG_c12.mtb	2816	NA	WWSS	water	2	238084	1337570599	1	0.02	0.00117647058823529	8459	1
3	Food 2	Intake 4	534	241268	1337573783	/users/cn/jespinosa/phecomp/data/CRG/20120502_FDF_CRG/20120502_FDF_CRG/20120518_FDF_CRG_c12.mtb	3859	3813	WWSS	food_sc	4	240734	1337573249	1	0.18	0.000337078651685393	8460	1
3	Drink 1	Intake 1	20	241285	1337573800	/users/cn/jespinosa/phecomp/data/CRG/20120502_FDF_CRG/20120502_FDF_CRG/20120518_FDF_CRG_c12.mtb	1306	NA	WWSS	water	1	241265	1337573780	1	0.04	0.002	8461	1
3	Drink 2	Intake 2	15	241325	1337573840	/users/cn/jespinosa/phecomp/data/CRG/20120502_FDF_CRG/20120502_FDF_CRG/20120518_FDF_CRG_c12.mtb	2817	NA	WWSS	water	2	241310	1337573825	1	0.02	0.00133333333333333	8462	1
3	Drink 2	Intake 2	17	241509	1337574024	/users/cn/jespinosa/phecomp/data/CRG/20120502_FDF_CRG/20120502_FDF_CRG/20120518_FDF_CRG_c12.mtb	2818	NA	WWSS	water	2	241492	1337574007	1	0.02	0.00117647058823529	8463	1
3	Drink 2	Intake 2	22	241621	1337574136	/users/cn/jespinosa/phecomp/data/CRG/20120502_FDF_CRG/20120502_FDF_CRG/20120518_FDF_CRG_c12.mtb	2819	NA	WWSS	water	2	241599	1337574114	1	0.0600000000000001	0.00272727272727273	8464	1
3	Food 2	Intake 4	26	245107	1337577622	/users/cn/jespinosa/phecomp/data/CRG/20120502_FDF_CRG/20120502_FDF_CRG/20120518_FDF_CRG_c12.mtb	3863	358	WWSS	food_sc	4	245081	1337577596	1	0.0200000000000005	0.000769230769230788	8465	1
3	Food 1	Intake 3	657	246122	1337578637	/users/cn/jespinosa/phecomp/data/CRG/20120502_FDF_CRG/20120502_FDF_CRG/20120518_FDF_CRG_c12.mtb	2294	174	WWSS	food_sc	3	245465	1337577980	1	0.18	0.000273972602739726	8466	1
3	Drink 2	Intake 2	27	246140	1337578655	/users/cn/jespinosa/phecomp/data/CRG/20120502_FDF_CRG/20120502_FDF_CRG/20120518_FDF_CRG_c12.mtb	2820	NA	WWSS	water	2	246113	1337578628	1	0.0799999999999996	0.00296296296296295	8467	1
3	Drink 2	Intake 2	23	246238	1337578753	/users/cn/jespinosa/phecomp/data/CRG/20120502_FDF_CRG/20120502_FDF_CRG/20120518_FDF_CRG_c12.mtb	2821	NA	WWSS	water	2	246215	1337578730	1	0.0600000000000005	0.00260869565217393	8468	1
3	Food 1	Intake 3	152	246448	1337578963	/users/cn/jespinosa/phecomp/data/CRG/20120502_FDF_CRG/20120502_FDF_CRG/20120518_FDF_CRG_c12.mtb	2296	75	WWSS	food_sc	3	246296	1337578811	1	0.0399999999999996	0.000263157894736839	8469	1
3	Drink 2	Intake 2	18	246466	1337578981	/users/cn/jespinosa/phecomp/data/CRG/20120502_FDF_CRG/20120502_FDF_CRG/20120518_FDF_CRG_c12.mtb	2822	NA	WWSS	water	2	246448	1337578963	1	0.0599999999999996	0.00333333333333331	8470	1
3	Food 1	Intake 3	147	246670	1337579185	/users/cn/jespinosa/phecomp/data/CRG/20120502_FDF_CRG/20120502_FDF_CRG/20120518_FDF_CRG_c12.mtb	2298	690	WWSS	food_sc	3	246523	1337579038	1	0.04	0.000272108843537415	8471	1
3	Drink 2	Intake 2	15	246771	1337579286	/users/cn/jespinosa/phecomp/data/CRG/20120502_FDF_CRG/20120502_FDF_CRG/20120518_FDF_CRG_c12.mtb	2823	NA	WWSS	water	2	246756	1337579271	1	0.02	0.00133333333333333	8472	1
3	Drink 1	Intake 1	18	246828	1337579343	/users/cn/jespinosa/phecomp/data/CRG/20120502_FDF_CRG/20120502_FDF_CRG/20120518_FDF_CRG_c12.mtb	1309	NA	WWSS	water	1	246810	1337579325	1	0.0200000000000005	0.00111111111111114	8473	1
3	Food 1	Intake 3	96	247456	1337579971	/users/cn/jespinosa/phecomp/data/CRG/20120502_FDF_CRG/20120502_FDF_CRG/20120518_FDF_CRG_c12.mtb	2302	5765	WWSS	food_sc	3	247360	1337579875	1	0.0200000000000005	0.000208333333333339	8474	1
3	Drink 2	Intake 2	28	247572	1337580087	/users/cn/jespinosa/phecomp/data/CRG/20120502_FDF_CRG/20120502_FDF_CRG/20120518_FDF_CRG_c12.mtb	2824	NA	WWSS	water	2	247544	1337580059	1	0.02	0.000714285714285714	8475	1
3	Drink 2	Intake 2	19	247687	1337580202	/users/cn/jespinosa/phecomp/data/CRG/20120502_FDF_CRG/20120502_FDF_CRG/20120518_FDF_CRG_c12.mtb	2825	NA	WWSS	water	2	247668	1337580183	1	0.02	0.00105263157894737	8476	1
3	Drink 1	Intake 1	16	248351	1337580866	/users/cn/jespinosa/phecomp/data/CRG/20120502_FDF_CRG/20120502_FDF_CRG/20120518_FDF_CRG_c12.mtb	1311	NA	WWSS	water	1	248335	1337580850	1	0.0200000000000005	0.00125000000000003	8477	1
3	Drink 2	Intake 2	39	249753	1337582268	/users/cn/jespinosa/phecomp/data/CRG/20120502_FDF_CRG/20120502_FDF_CRG/20120518_FDF_CRG_c12.mtb	2827	NA	WWSS	water	2	249714	1337582229	1	0.02	0.000512820512820513	8478	1
3	Food 2	Intake 4	226	253447	1337585962	/users/cn/jespinosa/phecomp/data/CRG/20120502_FDF_CRG/20120502_FDF_CRG/20120518_FDF_CRG_c12.mtb	3883	37941	WWSS	food_sc	4	253221	1337585736	1	0.54	0.00238938053097345	8479	1
3	Drink 2	Intake 2	29	253954	1337586469	/users/cn/jespinosa/phecomp/data/CRG/20120502_FDF_CRG/20120502_FDF_CRG/20120518_FDF_CRG_c12.mtb	2828	NA	WWSS	water	2	253925	1337586440	1	0.0600000000000001	0.00206896551724138	8480	1
3	Drink 2	Intake 2	31	254044	1337586559	/users/cn/jespinosa/phecomp/data/CRG/20120502_FDF_CRG/20120502_FDF_CRG/20120518_FDF_CRG_c12.mtb	2829	NA	WWSS	water	2	254013	1337586528	1	0.16	0.00516129032258065	8481	1
3	Drink 1	Intake 1	24	254899	1337587414	/users/cn/jespinosa/phecomp/data/CRG/20120502_FDF_CRG/20120502_FDF_CRG/20120518_FDF_CRG_c12.mtb	1313	NA	WWSS	water	1	254875	1337587390	1	0.0800000000000001	0.00333333333333334	8482	1
3	Drink 1	Intake 1	20	255057	1337587572	/users/cn/jespinosa/phecomp/data/CRG/20120502_FDF_CRG/20120502_FDF_CRG/20120518_FDF_CRG_c12.mtb	1314	NA	WWSS	water	1	255037	1337587552	1	0.0800000000000001	0.00400000000000001	8483	1
3	Drink 2	Intake 2	14	255569	1337588084	/users/cn/jespinosa/phecomp/data/CRG/20120502_FDF_CRG/20120502_FDF_CRG/20120518_FDF_CRG_c12.mtb	2830	NA	WWSS	water	2	255555	1337588070	1	0.04	0.00285714285714286	8484	1
3	Food 1	Intake 3	108	22067	1337624011	/users/cn/jespinosa/phecomp/data/CRG/20120502_FDF_CRG/20120502_FDF_CRG/20120521_FDF_CRG_c12.mtb	2634	18	WWSS	food_sc	3	21959	1337623903	1	0.02	0.000185185185185185	8485	1
3	Food 2	Intake 4	36	22121	1337624065	/users/cn/jespinosa/phecomp/data/CRG/20120502_FDF_CRG/20120502_FDF_CRG/20120521_FDF_CRG_c12.mtb	4524	322	WWSS	food_sc	4	22085	1337624029	1	0.02	0.000555555555555556	8486	1
3	Food 1	Intake 3	163	22606	1337624550	/users/cn/jespinosa/phecomp/data/CRG/20120502_FDF_CRG/20120502_FDF_CRG/20120521_FDF_CRG_c12.mtb	2637	143	WWSS	food_sc	3	22443	1337624387	1	0.02	0.000122699386503067	8487	1
3	Food 1	Intake 3	548	23297	1337625241	/users/cn/jespinosa/phecomp/data/CRG/20120502_FDF_CRG/20120502_FDF_CRG/20120521_FDF_CRG_c12.mtb	2639	2833	WWSS	food_sc	3	22749	1337624693	1	0.12	0.000218978102189781	8488	1
3	Drink 2	Intake 2	23	23354	1337625298	/users/cn/jespinosa/phecomp/data/CRG/20120502_FDF_CRG/20120502_FDF_CRG/20120521_FDF_CRG_c12.mtb	3042	NA	WWSS	water	2	23331	1337625275	1	0.02	0.000869565217391304	8489	1
3	Drink 1	Intake 1	16	23398	1337625342	/users/cn/jespinosa/phecomp/data/CRG/20120502_FDF_CRG/20120502_FDF_CRG/20120521_FDF_CRG_c12.mtb	1598	NA	WWSS	water	1	23382	1337625326	1	0.06	0.00375	8490	1
3	Drink 1	Intake 1	18	24270	1337626214	/users/cn/jespinosa/phecomp/data/CRG/20120502_FDF_CRG/20120502_FDF_CRG/20120521_FDF_CRG_c12.mtb	1599	NA	WWSS	water	1	24252	1337626196	1	0.04	0.00222222222222222	8491	1
3	Drink 1	Intake 1	16	26016	1337627960	/users/cn/jespinosa/phecomp/data/CRG/20120502_FDF_CRG/20120502_FDF_CRG/20120521_FDF_CRG_c12.mtb	1600	NA	WWSS	water	1	26000	1337627944	1	0.02	0.00125	8492	1
3	Drink 2	Intake 2	34	26042	1337627986	/users/cn/jespinosa/phecomp/data/CRG/20120502_FDF_CRG/20120502_FDF_CRG/20120521_FDF_CRG_c12.mtb	3043	NA	WWSS	water	2	26008	1337627952	1	0.06	0.00176470588235294	8493	1
3	Food 1	Intake 3	495	26625	1337628569	/users/cn/jespinosa/phecomp/data/CRG/20120502_FDF_CRG/20120502_FDF_CRG/20120521_FDF_CRG_c12.mtb	2641	804	WWSS	food_sc	3	26130	1337628074	1	0.1	0.000202020202020202	8494	1
3	Drink 1	Intake 1	24	26649	1337628593	/users/cn/jespinosa/phecomp/data/CRG/20120502_FDF_CRG/20120502_FDF_CRG/20120521_FDF_CRG_c12.mtb	1601	NA	WWSS	water	1	26625	1337628569	1	0.1	0.00416666666666667	8495	1
3	Food 1	Intake 3	586	28015	1337629959	/users/cn/jespinosa/phecomp/data/CRG/20120502_FDF_CRG/20120502_FDF_CRG/20120521_FDF_CRG_c12.mtb	2642	1078	WWSS	food_sc	3	27429	1337629373	1	0.24	0.000409556313993174	8496	1
3	Drink 1	Intake 1	28	28045	1337629989	/users/cn/jespinosa/phecomp/data/CRG/20120502_FDF_CRG/20120502_FDF_CRG/20120521_FDF_CRG_c12.mtb	1602	NA	WWSS	water	1	28017	1337629961	1	0.12	0.00428571428571429	8497	1
3	Drink 2	Intake 2	76	28330	1337630274	/users/cn/jespinosa/phecomp/data/CRG/20120502_FDF_CRG/20120502_FDF_CRG/20120521_FDF_CRG_c12.mtb	3044	NA	WWSS	water	2	28254	1337630198	1	0.08	0.00105263157894737	8498	1
3	Food 1	Intake 3	40	29133	1337631077	/users/cn/jespinosa/phecomp/data/CRG/20120502_FDF_CRG/20120502_FDF_CRG/20120521_FDF_CRG_c12.mtb	2643	312	WWSS	food_sc	3	29093	1337631037	1	0.02	0.0005	8499	1
3	Drink 2	Intake 2	28	29185	1337631129	/users/cn/jespinosa/phecomp/data/CRG/20120502_FDF_CRG/20120502_FDF_CRG/20120521_FDF_CRG_c12.mtb	3046	NA	WWSS	water	2	29157	1337631101	1	0.06	0.00214285714285714	8500	1
3	Food 1	Intake 3	438	29883	1337631827	/users/cn/jespinosa/phecomp/data/CRG/20120502_FDF_CRG/20120502_FDF_CRG/20120521_FDF_CRG_c12.mtb	2644	2721	WWSS	food_sc	3	29445	1337631389	1	0.16	0.000365296803652968	8501	1
3	Drink 1	Intake 1	16	29898	1337631842	/users/cn/jespinosa/phecomp/data/CRG/20120502_FDF_CRG/20120502_FDF_CRG/20120521_FDF_CRG_c12.mtb	1604	NA	WWSS	water	1	29882	1337631826	1	0.04	0.0025	8502	1
3	Drink 1	Intake 1	18	30074	1337632018	/users/cn/jespinosa/phecomp/data/CRG/20120502_FDF_CRG/20120502_FDF_CRG/20120521_FDF_CRG_c12.mtb	1605	NA	WWSS	water	1	30056	1337632000	1	0.04	0.00222222222222222	8503	1
3	Food 1	Intake 3	577	33181	1337635125	/users/cn/jespinosa/phecomp/data/CRG/20120502_FDF_CRG/20120502_FDF_CRG/20120521_FDF_CRG_c12.mtb	2647	2008	WWSS	food_sc	3	32604	1337634548	1	0.24	0.000415944540727903	8504	1
3	Drink 1	Intake 1	15	33197	1337635141	/users/cn/jespinosa/phecomp/data/CRG/20120502_FDF_CRG/20120502_FDF_CRG/20120521_FDF_CRG_c12.mtb	1606	NA	WWSS	water	1	33182	1337635126	1	0.04	0.00266666666666667	8505	1
3	Drink 1	Intake 1	15	33275	1337635219	/users/cn/jespinosa/phecomp/data/CRG/20120502_FDF_CRG/20120502_FDF_CRG/20120521_FDF_CRG_c12.mtb	1607	NA	WWSS	water	1	33260	1337635204	1	0.02	0.00133333333333333	8506	1
3	Drink 2	Intake 2	15	33608	1337635552	/users/cn/jespinosa/phecomp/data/CRG/20120502_FDF_CRG/20120502_FDF_CRG/20120521_FDF_CRG_c12.mtb	3048	NA	WWSS	water	2	33593	1337635537	1	0.02	0.00133333333333333	8507	1
3	Drink 2	Intake 2	44	33801	1337635745	/users/cn/jespinosa/phecomp/data/CRG/20120502_FDF_CRG/20120502_FDF_CRG/20120521_FDF_CRG_c12.mtb	3049	NA	WWSS	water	2	33757	1337635701	1	0.02	0.000454545454545455	8508	1
3	Drink 1	Intake 1	15	33812	1337635756	/users/cn/jespinosa/phecomp/data/CRG/20120502_FDF_CRG/20120502_FDF_CRG/20120521_FDF_CRG_c12.mtb	1608	NA	WWSS	water	1	33797	1337635741	1	0.02	0.00133333333333333	8509	1
3	Drink 2	Intake 2	16	34042	1337635986	/users/cn/jespinosa/phecomp/data/CRG/20120502_FDF_CRG/20120502_FDF_CRG/20120521_FDF_CRG_c12.mtb	3050	NA	WWSS	water	2	34026	1337635970	1	0.02	0.00125	8510	1
3	Drink 2	Intake 2	22	34337	1337636281	/users/cn/jespinosa/phecomp/data/CRG/20120502_FDF_CRG/20120502_FDF_CRG/20120521_FDF_CRG_c12.mtb	3051	NA	WWSS	water	2	34315	1337636259	1	0.04	0.00181818181818182	8511	1
3	Food 1	Intake 3	477	35666	1337637610	/users/cn/jespinosa/phecomp/data/CRG/20120502_FDF_CRG/20120502_FDF_CRG/20120521_FDF_CRG_c12.mtb	2649	4315	WWSS	food_sc	3	35189	1337637133	1	0.6	0.00125786163522013	8512	1
3	Drink 1	Intake 1	13	35861	1337637805	/users/cn/jespinosa/phecomp/data/CRG/20120502_FDF_CRG/20120502_FDF_CRG/20120521_FDF_CRG_c12.mtb	1609	NA	WWSS	water	1	35848	1337637792	1	0.08	0.00615384615384615	8513	1
3	Drink 2	Intake 2	18	35951	1337637895	/users/cn/jespinosa/phecomp/data/CRG/20120502_FDF_CRG/20120502_FDF_CRG/20120521_FDF_CRG_c12.mtb	3053	NA	WWSS	water	2	35933	1337637877	1	0.08	0.00444444444444444	8514	1
3	Drink 1	Intake 1	15	36438	1337638382	/users/cn/jespinosa/phecomp/data/CRG/20120502_FDF_CRG/20120502_FDF_CRG/20120521_FDF_CRG_c12.mtb	1610	NA	WWSS	water	1	36423	1337638367	1	0.02	0.00133333333333333	8515	1
3	Drink 2	Intake 2	29	36773	1337638717	/users/cn/jespinosa/phecomp/data/CRG/20120502_FDF_CRG/20120502_FDF_CRG/20120521_FDF_CRG_c12.mtb	3054	NA	WWSS	water	2	36744	1337638688	1	0.08	0.00275862068965517	8516	1
3	Drink 1	Intake 1	44	36892	1337638836	/users/cn/jespinosa/phecomp/data/CRG/20120502_FDF_CRG/20120502_FDF_CRG/20120521_FDF_CRG_c12.mtb	1611	NA	WWSS	water	1	36848	1337638792	1	0.02	0.000454545454545455	8517	1
3	Drink 1	Intake 1	18	37051	1337638995	/users/cn/jespinosa/phecomp/data/CRG/20120502_FDF_CRG/20120502_FDF_CRG/20120521_FDF_CRG_c12.mtb	1612	NA	WWSS	water	1	37033	1337638977	1	0.04	0.00222222222222222	8518	1
3	Drink 2	Intake 2	41	38360	1337640304	/users/cn/jespinosa/phecomp/data/CRG/20120502_FDF_CRG/20120502_FDF_CRG/20120521_FDF_CRG_c12.mtb	3056	NA	WWSS	water	2	38319	1337640263	1	0.0600000000000001	0.00146341463414634	8519	1
3	Drink 1	Intake 1	17	38384	1337640328	/users/cn/jespinosa/phecomp/data/CRG/20120502_FDF_CRG/20120502_FDF_CRG/20120521_FDF_CRG_c12.mtb	1613	NA	WWSS	water	1	38367	1337640311	1	0.0599999999999999	0.00352941176470588	8520	1
3	Food 1	Intake 3	48	40029	1337641973	/users/cn/jespinosa/phecomp/data/CRG/20120502_FDF_CRG/20120502_FDF_CRG/20120521_FDF_CRG_c12.mtb	2652	5121	WWSS	food_sc	3	39981	1337641925	1	0.02	0.000416666666666667	8521	1
3	Drink 1	Intake 1	14	40279	1337642223	/users/cn/jespinosa/phecomp/data/CRG/20120502_FDF_CRG/20120502_FDF_CRG/20120521_FDF_CRG_c12.mtb	1614	NA	WWSS	water	1	40265	1337642209	1	0.04	0.00285714285714286	8522	1
3	Food 1	Intake 3	46	45196	1337647140	/users/cn/jespinosa/phecomp/data/CRG/20120502_FDF_CRG/20120502_FDF_CRG/20120521_FDF_CRG_c12.mtb	2657	564	WWSS	food_sc	3	45150	1337647094	1	0.02	0.000434782608695652	8523	1
3	Drink 2	Intake 2	18	45536	1337647480	/users/cn/jespinosa/phecomp/data/CRG/20120502_FDF_CRG/20120502_FDF_CRG/20120521_FDF_CRG_c12.mtb	3060	NA	WWSS	water	2	45518	1337647462	1	0.0399999999999999	0.00222222222222222	8524	1
3	Food 2	Intake 4	51	45811	1337647755	/users/cn/jespinosa/phecomp/data/CRG/20120502_FDF_CRG/20120502_FDF_CRG/20120521_FDF_CRG_c12.mtb	4561	18	WWSS	food_sc	4	45760	1337647704	1	0.02	0.000392156862745098	8525	1
3	Food 2	Intake 4	575	46404	1337648348	/users/cn/jespinosa/phecomp/data/CRG/20120502_FDF_CRG/20120502_FDF_CRG/20120521_FDF_CRG_c12.mtb	4562	2549	WWSS	food_sc	4	45829	1337647773	1	0.2	0.000347826086956522	8526	1
3	Drink 1	Intake 1	30	46429	1337648373	/users/cn/jespinosa/phecomp/data/CRG/20120502_FDF_CRG/20120502_FDF_CRG/20120521_FDF_CRG_c12.mtb	1615	NA	WWSS	water	1	46399	1337648343	1	0.14	0.00466666666666667	8527	1
3	Drink 2	Intake 2	14	46489	1337648433	/users/cn/jespinosa/phecomp/data/CRG/20120502_FDF_CRG/20120502_FDF_CRG/20120521_FDF_CRG_c12.mtb	3061	NA	WWSS	water	2	46475	1337648419	1	0.02	0.00142857142857143	8528	1
3	Drink 2	Intake 2	10	46942	1337648886	/users/cn/jespinosa/phecomp/data/CRG/20120502_FDF_CRG/20120502_FDF_CRG/20120521_FDF_CRG_c12.mtb	3064	NA	WWSS	water	2	46932	1337648876	1	0.02	0.002	8529	1
3	Drink 2	Intake 2	35	47147	1337649091	/users/cn/jespinosa/phecomp/data/CRG/20120502_FDF_CRG/20120502_FDF_CRG/20120521_FDF_CRG_c12.mtb	3065	NA	WWSS	water	2	47112	1337649056	1	0.0600000000000001	0.00171428571428572	8530	1
3	Food 2	Intake 4	28	48981	1337650925	/users/cn/jespinosa/phecomp/data/CRG/20120502_FDF_CRG/20120502_FDF_CRG/20120521_FDF_CRG_c12.mtb	4569	7028	WWSS	food_sc	4	48953	1337650897	1	0.02	0.000714285714285714	8531	1
3	Food 1	Intake 3	54	56063	1337658007	/users/cn/jespinosa/phecomp/data/CRG/20120502_FDF_CRG/20120502_FDF_CRG/20120521_FDF_CRG_c12.mtb	2663	218	WWSS	food_sc	3	56009	1337657953	1	0.02	0.00037037037037037	8532	1
3	Food 1	Intake 3	120	56401	1337658345	/users/cn/jespinosa/phecomp/data/CRG/20120502_FDF_CRG/20120502_FDF_CRG/20120521_FDF_CRG_c12.mtb	2666	6	WWSS	food_sc	3	56281	1337658225	1	0.02	0.000166666666666667	8533	1
3	Food 1	Intake 3	500	56907	1337658851	/users/cn/jespinosa/phecomp/data/CRG/20120502_FDF_CRG/20120502_FDF_CRG/20120521_FDF_CRG_c12.mtb	2667	130	WWSS	food_sc	3	56407	1337658351	1	0.0799999999999998	0.00016	8534	1
3	Drink 2	Intake 2	20	56939	1337658883	/users/cn/jespinosa/phecomp/data/CRG/20120502_FDF_CRG/20120502_FDF_CRG/20120521_FDF_CRG_c12.mtb	3066	NA	WWSS	water	2	56919	1337658863	1	0.0599999999999999	0.00299999999999999	8535	1
3	Drink 2	Intake 2	17	57045	1337658989	/users/cn/jespinosa/phecomp/data/CRG/20120502_FDF_CRG/20120502_FDF_CRG/20120521_FDF_CRG_c12.mtb	3067	NA	WWSS	water	2	57028	1337658972	1	0.02	0.00117647058823529	8536	1
3	Food 2	Intake 4	516	57553	1337659497	/users/cn/jespinosa/phecomp/data/CRG/20120502_FDF_CRG/20120502_FDF_CRG/20120521_FDF_CRG_c12.mtb	4575	4725	WWSS	food_sc	4	57037	1337658981	1	0.08	0.000155038759689922	8537	1
3	Drink 2	Intake 2	33	57589	1337659533	/users/cn/jespinosa/phecomp/data/CRG/20120502_FDF_CRG/20120502_FDF_CRG/20120521_FDF_CRG_c12.mtb	3068	NA	WWSS	water	2	57556	1337659500	1	0.16	0.00484848484848485	8538	1
3	Drink 2	Intake 2	23	57677	1337659621	/users/cn/jespinosa/phecomp/data/CRG/20120502_FDF_CRG/20120502_FDF_CRG/20120521_FDF_CRG_c12.mtb	3069	NA	WWSS	water	2	57654	1337659598	1	0.0599999999999999	0.00260869565217391	8539	1
3	Drink 1	Intake 1	18	58103	1337660047	/users/cn/jespinosa/phecomp/data/CRG/20120502_FDF_CRG/20120502_FDF_CRG/20120521_FDF_CRG_c12.mtb	1617	NA	WWSS	water	1	58085	1337660029	1	0.0399999999999999	0.00222222222222222	8540	1
3	Food 2	Intake 4	372	62650	1337664594	/users/cn/jespinosa/phecomp/data/CRG/20120502_FDF_CRG/20120502_FDF_CRG/20120521_FDF_CRG_c12.mtb	4582	178	WWSS	food_sc	4	62278	1337664222	1	0.12	0.00032258064516129	8541	1
3	Drink 1	Intake 1	18	62718	1337664662	/users/cn/jespinosa/phecomp/data/CRG/20120502_FDF_CRG/20120502_FDF_CRG/20120521_FDF_CRG_c12.mtb	1619	NA	WWSS	water	1	62700	1337664644	1	0.0600000000000001	0.00333333333333334	8542	1
3	Food 2	Intake 4	329	63157	1337665101	/users/cn/jespinosa/phecomp/data/CRG/20120502_FDF_CRG/20120502_FDF_CRG/20120521_FDF_CRG_c12.mtb	4585	1136	WWSS	food_sc	4	62828	1337664772	1	0.12	0.000364741641337386	8543	1
3	Drink 2	Intake 2	36	63205	1337665149	/users/cn/jespinosa/phecomp/data/CRG/20120502_FDF_CRG/20120502_FDF_CRG/20120521_FDF_CRG_c12.mtb	3074	NA	WWSS	water	2	63169	1337665113	1	0.16	0.00444444444444444	8544	1
3	Drink 2	Intake 2	22	63245	1337665189	/users/cn/jespinosa/phecomp/data/CRG/20120502_FDF_CRG/20120502_FDF_CRG/20120521_FDF_CRG_c12.mtb	3075	NA	WWSS	water	2	63223	1337665167	1	0.0599999999999998	0.00272727272727272	8545	1
3	Drink 2	Intake 2	12	63533	1337665477	/users/cn/jespinosa/phecomp/data/CRG/20120502_FDF_CRG/20120502_FDF_CRG/20120521_FDF_CRG_c12.mtb	3077	NA	WWSS	water	2	63521	1337665465	1	0.02	0.00166666666666667	8546	1
3	Drink 2	Intake 2	19	64085	1337666029	/users/cn/jespinosa/phecomp/data/CRG/20120502_FDF_CRG/20120502_FDF_CRG/20120521_FDF_CRG_c12.mtb	3078	NA	WWSS	water	2	64066	1337666010	1	0.02	0.00105263157894737	8547	1
3	Food 2	Intake 4	132	64425	1337666369	/users/cn/jespinosa/phecomp/data/CRG/20120502_FDF_CRG/20120502_FDF_CRG/20120521_FDF_CRG_c12.mtb	4591	43846	WWSS	food_sc	4	64293	1337666237	1	0.4	0.00303030303030303	8548	1
3	Drink 2	Intake 2	28	64850	1337666794	/users/cn/jespinosa/phecomp/data/CRG/20120502_FDF_CRG/20120502_FDF_CRG/20120521_FDF_CRG_c12.mtb	3079	NA	WWSS	water	2	64822	1337666766	1	0.14	0.005	8549	1
3	Drink 2	Intake 2	20	64956	1337666900	/users/cn/jespinosa/phecomp/data/CRG/20120502_FDF_CRG/20120502_FDF_CRG/20120521_FDF_CRG_c12.mtb	3080	NA	WWSS	water	2	64936	1337666880	1	0.0600000000000001	0.00300000000000001	8550	1
3	Drink 2	Intake 2	25	65212	1337667156	/users/cn/jespinosa/phecomp/data/CRG/20120502_FDF_CRG/20120502_FDF_CRG/20120521_FDF_CRG_c12.mtb	3082	NA	WWSS	water	2	65187	1337667131	1	0.0600000000000001	0.0024	8551	1
3	Drink 2	Intake 2	15	65740	1337667684	/users/cn/jespinosa/phecomp/data/CRG/20120502_FDF_CRG/20120502_FDF_CRG/20120521_FDF_CRG_c12.mtb	3083	NA	WWSS	water	2	65725	1337667669	1	0.02	0.00133333333333333	8552	1
3	Drink 1	Intake 1	13	70234	1337672178	/users/cn/jespinosa/phecomp/data/CRG/20120502_FDF_CRG/20120502_FDF_CRG/20120521_FDF_CRG_c12.mtb	1622	NA	WWSS	water	1	70221	1337672165	1	0.04	0.00307692307692308	8553	1
3	Drink 1	Intake 1	9	81821	1337683765	/users/cn/jespinosa/phecomp/data/CRG/20120502_FDF_CRG/20120502_FDF_CRG/20120521_FDF_CRG_c12.mtb	1623	NA	WWSS	water	1	81812	1337683756	1	0.02	0.00222222222222222	8554	1
3	Food 1	Intake 3	391	108662	1337710606	/users/cn/jespinosa/phecomp/data/CRG/20120502_FDF_CRG/20120502_FDF_CRG/20120521_FDF_CRG_c12.mtb	2680	11	WWSS	food_sc	3	108271	1337710215	1	0.02	5.1150895140665e-05	8555	1
3	Food 1	Intake 3	59	108732	1337710676	/users/cn/jespinosa/phecomp/data/CRG/20120502_FDF_CRG/20120502_FDF_CRG/20120521_FDF_CRG_c12.mtb	2681	1267	WWSS	food_sc	3	108673	1337710617	1	0.02	0.000338983050847458	8556	1
3	Drink 2	Intake 2	21	108868	1337710812	/users/cn/jespinosa/phecomp/data/CRG/20120502_FDF_CRG/20120502_FDF_CRG/20120521_FDF_CRG_c12.mtb	3086	NA	WWSS	water	2	108847	1337710791	1	0.04	0.0019047619047619	8557	1
3	Drink 2	Intake 2	18	109069	1337711013	/users/cn/jespinosa/phecomp/data/CRG/20120502_FDF_CRG/20120502_FDF_CRG/20120521_FDF_CRG_c12.mtb	3087	NA	WWSS	water	2	109051	1337710995	1	0.02	0.00111111111111111	8558	1
3	Food 2	Intake 4	110	110109	1337712053	/users/cn/jespinosa/phecomp/data/CRG/20120502_FDF_CRG/20120502_FDF_CRG/20120521_FDF_CRG_c12.mtb	4615	264	WWSS	food_sc	4	109999	1337711943	1	0.04	0.000363636363636364	8559	1
3	Food 2	Intake 4	69	110442	1337712386	/users/cn/jespinosa/phecomp/data/CRG/20120502_FDF_CRG/20120502_FDF_CRG/20120521_FDF_CRG_c12.mtb	4618	151	WWSS	food_sc	4	110373	1337712317	1	0.02	0.000289855072463768	8560	1
3	Food 1	Intake 3	330	110923	1337712867	/users/cn/jespinosa/phecomp/data/CRG/20120502_FDF_CRG/20120502_FDF_CRG/20120521_FDF_CRG_c12.mtb	2687	140	WWSS	food_sc	3	110593	1337712537	1	0.02	6.06060606060606e-05	8561	1
3	Drink 2	Intake 2	24	110936	1337712880	/users/cn/jespinosa/phecomp/data/CRG/20120502_FDF_CRG/20120502_FDF_CRG/20120521_FDF_CRG_c12.mtb	3092	NA	WWSS	water	2	110912	1337712856	1	0.0600000000000001	0.0025	8562	1
3	Drink 2	Intake 2	21	111027	1337712971	/users/cn/jespinosa/phecomp/data/CRG/20120502_FDF_CRG/20120502_FDF_CRG/20120521_FDF_CRG_c12.mtb	3093	NA	WWSS	water	2	111006	1337712950	1	0.02	0.000952380952380952	8563	1
3	Food 1	Intake 3	460	111523	1337713467	/users/cn/jespinosa/phecomp/data/CRG/20120502_FDF_CRG/20120502_FDF_CRG/20120521_FDF_CRG_c12.mtb	2688	37	WWSS	food_sc	3	111063	1337713007	1	0.02	4.34782608695652e-05	8564	1
3	Drink 2	Intake 2	33	111555	1337713499	/users/cn/jespinosa/phecomp/data/CRG/20120502_FDF_CRG/20120502_FDF_CRG/20120521_FDF_CRG_c12.mtb	3094	NA	WWSS	water	2	111522	1337713466	1	0.0599999999999998	0.00181818181818181	8565	1
3	Food 1	Intake 3	770	112330	1337714274	/users/cn/jespinosa/phecomp/data/CRG/20120502_FDF_CRG/20120502_FDF_CRG/20120521_FDF_CRG_c12.mtb	2689	128	WWSS	food_sc	3	111560	1337713504	1	0.12	0.000155844155844156	8566	1
3	Drink 1	Intake 1	23	112345	1337714289	/users/cn/jespinosa/phecomp/data/CRG/20120502_FDF_CRG/20120502_FDF_CRG/20120521_FDF_CRG_c12.mtb	1628	NA	WWSS	water	1	112322	1337714266	1	0.12	0.00521739130434783	8567	1
3	Drink 2	Intake 2	21	112432	1337714376	/users/cn/jespinosa/phecomp/data/CRG/20120502_FDF_CRG/20120502_FDF_CRG/20120521_FDF_CRG_c12.mtb	3095	NA	WWSS	water	2	112411	1337714355	1	0.04	0.0019047619047619	8568	1
3	Food 1	Intake 3	610	113068	1337715012	/users/cn/jespinosa/phecomp/data/CRG/20120502_FDF_CRG/20120502_FDF_CRG/20120521_FDF_CRG_c12.mtb	2690	768	WWSS	food_sc	3	112458	1337714402	1	0.2	0.000327868852459016	8569	1
3	Drink 1	Intake 1	14	113074	1337715018	/users/cn/jespinosa/phecomp/data/CRG/20120502_FDF_CRG/20120502_FDF_CRG/20120521_FDF_CRG_c12.mtb	1629	NA	WWSS	water	1	113060	1337715004	1	0.1	0.00714285714285714	8570	1
3	Drink 2	Intake 2	20	113114	1337715058	/users/cn/jespinosa/phecomp/data/CRG/20120502_FDF_CRG/20120502_FDF_CRG/20120521_FDF_CRG_c12.mtb	3096	NA	WWSS	water	2	113094	1337715038	1	0.02	0.001	8571	1
3	Food 1	Intake 3	550	114386	1337716330	/users/cn/jespinosa/phecomp/data/CRG/20120502_FDF_CRG/20120502_FDF_CRG/20120521_FDF_CRG_c12.mtb	2691	981	WWSS	food_sc	3	113836	1337715780	1	0.14	0.000254545454545455	8572	1
3	Drink 2	Intake 2	22	114400	1337716344	/users/cn/jespinosa/phecomp/data/CRG/20120502_FDF_CRG/20120502_FDF_CRG/20120521_FDF_CRG_c12.mtb	3097	NA	WWSS	water	2	114378	1337716322	1	0.12	0.00545454545454545	8573	1
3	Drink 1	Intake 1	16	114809	1337716753	/users/cn/jespinosa/phecomp/data/CRG/20120502_FDF_CRG/20120502_FDF_CRG/20120521_FDF_CRG_c12.mtb	1630	NA	WWSS	water	1	114793	1337716737	1	0.02	0.00125	8574	1
3	Food 1	Intake 3	764	116131	1337718075	/users/cn/jespinosa/phecomp/data/CRG/20120502_FDF_CRG/20120502_FDF_CRG/20120521_FDF_CRG_c12.mtb	2692	688	WWSS	food_sc	3	115367	1337717311	1	0.14	0.000183246073298429	8575	1
3	Drink 2	Intake 2	23	116146	1337718090	/users/cn/jespinosa/phecomp/data/CRG/20120502_FDF_CRG/20120502_FDF_CRG/20120521_FDF_CRG_c12.mtb	3098	NA	WWSS	water	2	116123	1337718067	1	0.0800000000000001	0.00347826086956522	8576	1
3	Drink 1	Intake 1	17	116220	1337718164	/users/cn/jespinosa/phecomp/data/CRG/20120502_FDF_CRG/20120502_FDF_CRG/20120521_FDF_CRG_c12.mtb	1631	NA	WWSS	water	1	116203	1337718147	1	0.04	0.00235294117647059	8577	1
3	Drink 2	Intake 2	18	116574	1337718518	/users/cn/jespinosa/phecomp/data/CRG/20120502_FDF_CRG/20120502_FDF_CRG/20120521_FDF_CRG_c12.mtb	3100	NA	WWSS	water	2	116556	1337718500	1	0.04	0.00222222222222222	8578	1
3	Food 1	Intake 3	72	116891	1337718835	/users/cn/jespinosa/phecomp/data/CRG/20120502_FDF_CRG/20120502_FDF_CRG/20120521_FDF_CRG_c12.mtb	2694	3670	WWSS	food_sc	3	116819	1337718763	1	0.02	0.000277777777777778	8579	1
3	Drink 1	Intake 1	25	116975	1337718919	/users/cn/jespinosa/phecomp/data/CRG/20120502_FDF_CRG/20120502_FDF_CRG/20120521_FDF_CRG_c12.mtb	1632	NA	WWSS	water	1	116950	1337718894	1	0.0599999999999998	0.00239999999999999	8580	1
3	Drink 2	Intake 2	18	119953	1337721897	/users/cn/jespinosa/phecomp/data/CRG/20120502_FDF_CRG/20120502_FDF_CRG/20120521_FDF_CRG_c12.mtb	3101	NA	WWSS	water	2	119935	1337721879	1	0.04	0.00222222222222222	8581	1
3	Food 1	Intake 3	304	120865	1337722809	/users/cn/jespinosa/phecomp/data/CRG/20120502_FDF_CRG/20120502_FDF_CRG/20120521_FDF_CRG_c12.mtb	2706	244	WWSS	food_sc	3	120561	1337722505	1	0.02	6.57894736842105e-05	8582	1
3	Drink 2	Intake 2	21	120881	1337722825	/users/cn/jespinosa/phecomp/data/CRG/20120502_FDF_CRG/20120502_FDF_CRG/20120521_FDF_CRG_c12.mtb	3102	NA	WWSS	water	2	120860	1337722804	1	0.04	0.0019047619047619	8583	1
3	Drink 2	Intake 2	23	120955	1337722899	/users/cn/jespinosa/phecomp/data/CRG/20120502_FDF_CRG/20120502_FDF_CRG/20120521_FDF_CRG_c12.mtb	3103	NA	WWSS	water	2	120932	1337722876	1	0.02	0.000869565217391304	8584	1
3	Food 1	Intake 3	1177	122286	1337724230	/users/cn/jespinosa/phecomp/data/CRG/20120502_FDF_CRG/20120502_FDF_CRG/20120521_FDF_CRG_c12.mtb	2707	606	WWSS	food_sc	3	121109	1337723053	1	0.32	0.000271877655055225	8585	1
3	Drink 2	Intake 2	38	122321	1337724265	/users/cn/jespinosa/phecomp/data/CRG/20120502_FDF_CRG/20120502_FDF_CRG/20120521_FDF_CRG_c12.mtb	3104	NA	WWSS	water	2	122283	1337724227	1	0.18	0.00473684210526316	8586	1
3	Drink 2	Intake 2	19	122379	1337724323	/users/cn/jespinosa/phecomp/data/CRG/20120502_FDF_CRG/20120502_FDF_CRG/20120521_FDF_CRG_c12.mtb	3105	NA	WWSS	water	2	122360	1337724304	1	0.04	0.00210526315789474	8587	1
3	Drink 2	Intake 2	26	122652	1337724596	/users/cn/jespinosa/phecomp/data/CRG/20120502_FDF_CRG/20120502_FDF_CRG/20120521_FDF_CRG_c12.mtb	3106	NA	WWSS	water	2	122626	1337724570	1	0.02	0.000769230769230769	8588	1
3	Drink 2	Intake 2	20	122810	1337724754	/users/cn/jespinosa/phecomp/data/CRG/20120502_FDF_CRG/20120502_FDF_CRG/20120521_FDF_CRG_c12.mtb	3107	NA	WWSS	water	2	122790	1337724734	1	0.02	0.001	8589	1
3	Food 1	Intake 3	488	123380	1337725324	/users/cn/jespinosa/phecomp/data/CRG/20120502_FDF_CRG/20120502_FDF_CRG/20120521_FDF_CRG_c12.mtb	2710	1162	WWSS	food_sc	3	122892	1337724836	1	0.3	0.000614754098360656	8590	1
3	Drink 2	Intake 2	29	123408	1337725352	/users/cn/jespinosa/phecomp/data/CRG/20120502_FDF_CRG/20120502_FDF_CRG/20120521_FDF_CRG_c12.mtb	3108	NA	WWSS	water	2	123379	1337725323	1	0.12	0.00413793103448276	8591	1
3	Drink 1	Intake 1	18	123734	1337725678	/users/cn/jespinosa/phecomp/data/CRG/20120502_FDF_CRG/20120502_FDF_CRG/20120521_FDF_CRG_c12.mtb	1633	NA	WWSS	water	1	123716	1337725660	1	0.04	0.00222222222222222	8592	1
3	Drink 2	Intake 2	15	124050	1337725994	/users/cn/jespinosa/phecomp/data/CRG/20120502_FDF_CRG/20120502_FDF_CRG/20120521_FDF_CRG_c12.mtb	3110	NA	WWSS	water	2	124035	1337725979	1	0.02	0.00133333333333333	8593	1
3	Food 1	Intake 3	345	124887	1337726831	/users/cn/jespinosa/phecomp/data/CRG/20120502_FDF_CRG/20120502_FDF_CRG/20120521_FDF_CRG_c12.mtb	2712	4746	WWSS	food_sc	3	124542	1337726486	1	0.42	0.00121739130434783	8594	1
3	Drink 2	Intake 2	49	125189	1337727133	/users/cn/jespinosa/phecomp/data/CRG/20120502_FDF_CRG/20120502_FDF_CRG/20120521_FDF_CRG_c12.mtb	3111	NA	WWSS	water	2	125140	1337727084	1	0.16	0.00326530612244898	8595	1
3	Drink 2	Intake 2	17	125223	1337727167	/users/cn/jespinosa/phecomp/data/CRG/20120502_FDF_CRG/20120502_FDF_CRG/20120521_FDF_CRG_c12.mtb	3112	NA	WWSS	water	2	125206	1337727150	1	0.02	0.00117647058823529	8596	1
3	Drink 1	Intake 1	18	125597	1337727541	/users/cn/jespinosa/phecomp/data/CRG/20120502_FDF_CRG/20120502_FDF_CRG/20120521_FDF_CRG_c12.mtb	1635	NA	WWSS	water	1	125579	1337727523	1	0.02	0.00111111111111111	8597	1
3	Drink 2	Intake 2	46	125739	1337727683	/users/cn/jespinosa/phecomp/data/CRG/20120502_FDF_CRG/20120502_FDF_CRG/20120521_FDF_CRG_c12.mtb	3118	NA	WWSS	water	2	125693	1337727637	1	0.0200000000000005	0.000434782608695663	8598	1
3	Drink 2	Intake 2	18	125873	1337727817	/users/cn/jespinosa/phecomp/data/CRG/20120502_FDF_CRG/20120502_FDF_CRG/20120521_FDF_CRG_c12.mtb	3121	NA	WWSS	water	2	125855	1337727799	1	0.0200000000000005	0.00111111111111114	8599	1
3	Drink 1	Intake 1	15	126345	1337728289	/users/cn/jespinosa/phecomp/data/CRG/20120502_FDF_CRG/20120502_FDF_CRG/20120521_FDF_CRG_c12.mtb	1636	NA	WWSS	water	1	126330	1337728274	1	0.04	0.00266666666666667	8600	1
3	Drink 2	Intake 2	19	126565	1337728509	/users/cn/jespinosa/phecomp/data/CRG/20120502_FDF_CRG/20120502_FDF_CRG/20120521_FDF_CRG_c12.mtb	3124	NA	WWSS	water	2	126546	1337728490	1	0.0399999999999996	0.00210526315789472	8601	1
3	Drink 2	Intake 2	20	127218	1337729162	/users/cn/jespinosa/phecomp/data/CRG/20120502_FDF_CRG/20120502_FDF_CRG/20120521_FDF_CRG_c12.mtb	3127	NA	WWSS	water	2	127198	1337729142	1	0.02	0.001	8602	1
3	Food 1	Intake 3	15	129648	1337731592	/users/cn/jespinosa/phecomp/data/CRG/20120502_FDF_CRG/20120502_FDF_CRG/20120521_FDF_CRG_c12.mtb	2713	2683	WWSS	food_sc	3	129633	1337731577	1	0.02	0.00133333333333333	8603	1
3	Food 1	Intake 3	773	133104	1337735048	/users/cn/jespinosa/phecomp/data/CRG/20120502_FDF_CRG/20120502_FDF_CRG/20120521_FDF_CRG_c12.mtb	2720	967	WWSS	food_sc	3	132331	1337734275	1	0.3	0.000388098318240621	8604	1
3	Drink 2	Intake 2	28	133129	1337735073	/users/cn/jespinosa/phecomp/data/CRG/20120502_FDF_CRG/20120502_FDF_CRG/20120521_FDF_CRG_c12.mtb	3130	NA	WWSS	water	2	133101	1337735045	1	0.1	0.00357142857142857	8605	1
3	Drink 2	Intake 2	21	133161	1337735105	/users/cn/jespinosa/phecomp/data/CRG/20120502_FDF_CRG/20120502_FDF_CRG/20120521_FDF_CRG_c12.mtb	3131	NA	WWSS	water	2	133140	1337735084	1	0.04	0.0019047619047619	8606	1
3	Drink 2	Intake 2	22	133298	1337735242	/users/cn/jespinosa/phecomp/data/CRG/20120502_FDF_CRG/20120502_FDF_CRG/20120521_FDF_CRG_c12.mtb	3132	NA	WWSS	water	2	133276	1337735220	1	0.02	0.000909090909090909	8607	1
3	Drink 2	Intake 2	19	133446	1337735390	/users/cn/jespinosa/phecomp/data/CRG/20120502_FDF_CRG/20120502_FDF_CRG/20120521_FDF_CRG_c12.mtb	3133	NA	WWSS	water	2	133427	1337735371	1	0.04	0.00210526315789474	8608	1
3	Drink 1	Intake 1	15	133809	1337735753	/users/cn/jespinosa/phecomp/data/CRG/20120502_FDF_CRG/20120502_FDF_CRG/20120521_FDF_CRG_c12.mtb	1637	NA	WWSS	water	1	133794	1337735738	1	0.0600000000000001	0.00400000000000001	8609	1
3	Food 1	Intake 3	344	134415	1337736359	/users/cn/jespinosa/phecomp/data/CRG/20120502_FDF_CRG/20120502_FDF_CRG/20120521_FDF_CRG_c12.mtb	2724	1521	WWSS	food_sc	3	134071	1337736015	1	0.18	0.000523255813953488	8610	1
3	Drink 2	Intake 2	20	134430	1337736374	/users/cn/jespinosa/phecomp/data/CRG/20120502_FDF_CRG/20120502_FDF_CRG/20120521_FDF_CRG_c12.mtb	3135	NA	WWSS	water	2	134410	1337736354	1	0.0800000000000001	0.00400000000000001	8611	1
3	Drink 1	Intake 1	16	134559	1337736503	/users/cn/jespinosa/phecomp/data/CRG/20120502_FDF_CRG/20120502_FDF_CRG/20120521_FDF_CRG_c12.mtb	1639	NA	WWSS	water	1	134543	1337736487	1	0.04	0.0025	8612	1
3	Food 1	Intake 3	19	135955	1337737899	/users/cn/jespinosa/phecomp/data/CRG/20120502_FDF_CRG/20120502_FDF_CRG/20120521_FDF_CRG_c12.mtb	2725	100	WWSS	food_sc	3	135936	1337737880	1	0.02	0.00105263157894737	8613	1
3	Food 1	Intake 3	23	136078	1337738022	/users/cn/jespinosa/phecomp/data/CRG/20120502_FDF_CRG/20120502_FDF_CRG/20120521_FDF_CRG_c12.mtb	2726	4837	WWSS	food_sc	3	136055	1337737999	1	0.02	0.000869565217391304	8614	1
3	Food 1	Intake 3	391	141306	1337743250	/users/cn/jespinosa/phecomp/data/CRG/20120502_FDF_CRG/20120502_FDF_CRG/20120521_FDF_CRG_c12.mtb	2729	249	WWSS	food_sc	3	140915	1337742859	1	0.0999999999999996	0.000255754475703324	8615	1
3	Drink 1	Intake 1	18	141531	1337743475	/users/cn/jespinosa/phecomp/data/CRG/20120502_FDF_CRG/20120502_FDF_CRG/20120521_FDF_CRG_c12.mtb	1640	NA	WWSS	water	1	141513	1337743457	1	0.0600000000000001	0.00333333333333334	8616	1
3	Food 1	Intake 3	120	141675	1337743619	/users/cn/jespinosa/phecomp/data/CRG/20120502_FDF_CRG/20120502_FDF_CRG/20120521_FDF_CRG_c12.mtb	2730	4197	WWSS	food_sc	3	141555	1337743499	1	0.0200000000000005	0.000166666666666671	8617	1
3	Drink 1	Intake 1	13	141966	1337743910	/users/cn/jespinosa/phecomp/data/CRG/20120502_FDF_CRG/20120502_FDF_CRG/20120521_FDF_CRG_c12.mtb	1641	NA	WWSS	water	1	141953	1337743897	1	0.02	0.00153846153846154	8618	1
3	Food 1	Intake 3	443	146315	1337748259	/users/cn/jespinosa/phecomp/data/CRG/20120502_FDF_CRG/20120502_FDF_CRG/20120521_FDF_CRG_c12.mtb	2753	585	WWSS	food_sc	3	145872	1337747816	1	0.0200000000000005	4.51467268623036e-05	8619	1
3	Food 1	Intake 3	216	147116	1337749060	/users/cn/jespinosa/phecomp/data/CRG/20120502_FDF_CRG/20120502_FDF_CRG/20120521_FDF_CRG_c12.mtb	2758	490	WWSS	food_sc	3	146900	1337748844	1	0.04	0.000185185185185185	8620	1
3	Food 1	Intake 3	318	147924	1337749868	/users/cn/jespinosa/phecomp/data/CRG/20120502_FDF_CRG/20120502_FDF_CRG/20120521_FDF_CRG_c12.mtb	2763	695	WWSS	food_sc	3	147606	1337749550	1	0.3	0.000943396226415094	8621	1
3	Drink 2	Intake 2	17	148426	1337750370	/users/cn/jespinosa/phecomp/data/CRG/20120502_FDF_CRG/20120502_FDF_CRG/20120521_FDF_CRG_c12.mtb	3136	NA	WWSS	water	2	148409	1337750353	1	0.04	0.00235294117647059	8622	1
3	Food 2	Intake 4	263	148882	1337750826	/users/cn/jespinosa/phecomp/data/CRG/20120502_FDF_CRG/20120502_FDF_CRG/20120521_FDF_CRG_c12.mtb	4663	265	WWSS	food_sc	4	148619	1337750563	1	0.04	0.000152091254752852	8623	1
3	Drink 2	Intake 2	15	148904	1337750848	/users/cn/jespinosa/phecomp/data/CRG/20120502_FDF_CRG/20120502_FDF_CRG/20120521_FDF_CRG_c12.mtb	3137	NA	WWSS	water	2	148889	1337750833	1	0.04	0.00266666666666667	8624	1
3	Drink 2	Intake 2	17	149105	1337751049	/users/cn/jespinosa/phecomp/data/CRG/20120502_FDF_CRG/20120502_FDF_CRG/20120521_FDF_CRG_c12.mtb	3138	NA	WWSS	water	2	149088	1337751032	1	0.04	0.00235294117647059	8625	1
3	Food 2	Intake 4	377	149524	1337751468	/users/cn/jespinosa/phecomp/data/CRG/20120502_FDF_CRG/20120502_FDF_CRG/20120521_FDF_CRG_c12.mtb	4666	431	WWSS	food_sc	4	149147	1337751091	1	0.0799999999999998	0.000212201591511936	8626	1
3	Drink 2	Intake 2	27	149551	1337751495	/users/cn/jespinosa/phecomp/data/CRG/20120502_FDF_CRG/20120502_FDF_CRG/20120521_FDF_CRG_c12.mtb	3139	NA	WWSS	water	2	149524	1337751468	1	0.12	0.00444444444444444	8627	1
3	Drink 2	Intake 2	23	149612	1337751556	/users/cn/jespinosa/phecomp/data/CRG/20120502_FDF_CRG/20120502_FDF_CRG/20120521_FDF_CRG_c12.mtb	3140	NA	WWSS	water	2	149589	1337751533	1	0.0800000000000001	0.00347826086956522	8628	1
3	Food 2	Intake 4	464	150419	1337752363	/users/cn/jespinosa/phecomp/data/CRG/20120502_FDF_CRG/20120502_FDF_CRG/20120521_FDF_CRG_c12.mtb	4670	371	WWSS	food_sc	4	149955	1337751899	1	0.16	0.000344827586206897	8629	1
3	Drink 2	Intake 2	47	150468	1337752412	/users/cn/jespinosa/phecomp/data/CRG/20120502_FDF_CRG/20120502_FDF_CRG/20120521_FDF_CRG_c12.mtb	3141	NA	WWSS	water	2	150421	1337752365	1	0.1	0.00212765957446809	8630	1
3	Drink 2	Intake 2	22	150629	1337752573	/users/cn/jespinosa/phecomp/data/CRG/20120502_FDF_CRG/20120502_FDF_CRG/20120521_FDF_CRG_c12.mtb	3142	NA	WWSS	water	2	150607	1337752551	1	0.02	0.000909090909090909	8631	1
3	Food 2	Intake 4	76	150866	1337752810	/users/cn/jespinosa/phecomp/data/CRG/20120502_FDF_CRG/20120502_FDF_CRG/20120521_FDF_CRG_c12.mtb	4673	40	WWSS	food_sc	4	150790	1337752734	1	0.02	0.000263157894736842	8632	1
3	Food 2	Intake 4	227	151133	1337753077	/users/cn/jespinosa/phecomp/data/CRG/20120502_FDF_CRG/20120502_FDF_CRG/20120521_FDF_CRG_c12.mtb	4674	411	WWSS	food_sc	4	150906	1337752850	1	0.0399999999999998	0.000176211453744493	8633	1
3	Drink 1	Intake 1	17	151161	1337753105	/users/cn/jespinosa/phecomp/data/CRG/20120502_FDF_CRG/20120502_FDF_CRG/20120521_FDF_CRG_c12.mtb	1645	NA	WWSS	water	1	151144	1337753088	1	0.0399999999999998	0.00235294117647058	8634	1
3	Food 1	Intake 3	62	151606	1337753550	/users/cn/jespinosa/phecomp/data/CRG/20120502_FDF_CRG/20120502_FDF_CRG/20120521_FDF_CRG_c12.mtb	2766	8956	WWSS	food_sc	3	151544	1337753488	1	0.0200000000000005	0.000322580645161298	8635	1
3	Drink 2	Intake 2	25	151723	1337753667	/users/cn/jespinosa/phecomp/data/CRG/20120502_FDF_CRG/20120502_FDF_CRG/20120521_FDF_CRG_c12.mtb	3143	NA	WWSS	water	2	151698	1337753642	1	0.04	0.0016	8636	1
3	Food 2	Intake 4	730	161292	1337763236	/users/cn/jespinosa/phecomp/data/CRG/20120502_FDF_CRG/20120502_FDF_CRG/20120521_FDF_CRG_c12.mtb	4677	LAST	WWSS	food_sc	4	160562	1337762506	1	0.16	0.000219178082191781	8637	1
3	Drink 2	Intake 2	17	161335	1337763279	/users/cn/jespinosa/phecomp/data/CRG/20120502_FDF_CRG/20120502_FDF_CRG/20120521_FDF_CRG_c12.mtb	3144	NA	WWSS	water	2	161318	1337763262	1	0.02	0.00117647058823529	8638	1
3	Drink 1	Intake 1	14	161409	1337763353	/users/cn/jespinosa/phecomp/data/CRG/20120502_FDF_CRG/20120502_FDF_CRG/20120521_FDF_CRG_c12.mtb	1646	NA	WWSS	water	1	161395	1337763339	1	0.04	0.00285714285714286	8639	1
3	Drink 2	Intake 2	17	161821	1337763765	/users/cn/jespinosa/phecomp/data/CRG/20120502_FDF_CRG/20120502_FDF_CRG/20120521_FDF_CRG_c12.mtb	3145	LAST	WWSS	water	2	161804	1337763748	1	0.02	0.00117647058823529	8640	1
3	Drink 1	Intake 1	23	1840	1335959848	/users/cn/jespinosa/phecomp/data/CRG/20120502_FDF_CRG/20120502_FDF_CRG/20120502_FDF_CRG_c12.mtb	50	NA	WWSS	water	1	1817	1335959825	1	0.02	0.000869565217391304	6783	1
3	Food 1	Intake 3	68	2168	1335960176	/users/cn/jespinosa/phecomp/data/CRG/20120502_FDF_CRG/20120502_FDF_CRG/20120502_FDF_CRG_c12.mtb	87	16871	WWSS	food_sc	3	2100	1335960108	1	0.02	0.000294117647058824	6784	1
3	Drink 2	Intake 2	22	2778	1335960786	/users/cn/jespinosa/phecomp/data/CRG/20120502_FDF_CRG/20120502_FDF_CRG/20120502_FDF_CRG_c12.mtb	450	NA	WWSS	water	2	2756	1335960764	1	0.02	0.000909090909090909	6785	1
3	Drink 2	Intake 2	46	12232	1335970240	/users/cn/jespinosa/phecomp/data/CRG/20120502_FDF_CRG/20120502_FDF_CRG/20120502_FDF_CRG_c12.mtb	478	NA	WWSS	water	2	12186	1335970194	1	0.02	0.000434782608695652	6786	1
3	Food 2	Intake 4	329	19368	1335977376	/users/cn/jespinosa/phecomp/data/CRG/20120502_FDF_CRG/20120502_FDF_CRG/20120502_FDF_CRG_c12.mtb	333	112	WWSS	food_sc	4	19039	1335977047	1	0.04	0.000121580547112462	6787	1
3	Food 2	Intake 4	44	19524	1335977532	/users/cn/jespinosa/phecomp/data/CRG/20120502_FDF_CRG/20120502_FDF_CRG/20120502_FDF_CRG_c12.mtb	334	15	WWSS	food_sc	4	19480	1335977488	1	0.04	0.000909090909090909	6788	1
3	Food 2	Intake 4	49	19588	1335977596	/users/cn/jespinosa/phecomp/data/CRG/20120502_FDF_CRG/20120502_FDF_CRG/20120502_FDF_CRG_c12.mtb	335	32	WWSS	food_sc	4	19539	1335977547	1	0.04	0.000816326530612245	6789	1
3	Food 2	Intake 4	192	19812	1335977820	/users/cn/jespinosa/phecomp/data/CRG/20120502_FDF_CRG/20120502_FDF_CRG/20120502_FDF_CRG_c12.mtb	336	4207	WWSS	food_sc	4	19620	1335977628	1	0.06	0.0003125	6790	1
3	Drink 1	Intake 1	28	19929	1335977937	/users/cn/jespinosa/phecomp/data/CRG/20120502_FDF_CRG/20120502_FDF_CRG/20120502_FDF_CRG_c12.mtb	61	NA	WWSS	water	1	19901	1335977909	1	0.04	0.00142857142857143	6791	1
3	Drink 1	Intake 1	37	19986	1335977994	/users/cn/jespinosa/phecomp/data/CRG/20120502_FDF_CRG/20120502_FDF_CRG/20120502_FDF_CRG_c12.mtb	62	NA	WWSS	water	1	19949	1335977957	1	0.02	0.000540540540540541	6792	1
3	Drink 2	Intake 2	24	20854	1335978862	/users/cn/jespinosa/phecomp/data/CRG/20120502_FDF_CRG/20120502_FDF_CRG/20120502_FDF_CRG_c12.mtb	486	NA	WWSS	water	2	20830	1335978838	1	0.02	0.000833333333333333	6793	1
3	Drink 2	Intake 2	44	20925	1335978933	/users/cn/jespinosa/phecomp/data/CRG/20120502_FDF_CRG/20120502_FDF_CRG/20120502_FDF_CRG_c12.mtb	487	NA	WWSS	water	2	20881	1335978889	1	0.04	0.000909090909090909	6794	1
3	Drink 2	Intake 2	30	21864	1335979872	/users/cn/jespinosa/phecomp/data/CRG/20120502_FDF_CRG/20120502_FDF_CRG/20120502_FDF_CRG_c12.mtb	488	NA	WWSS	water	2	21834	1335979842	1	0.02	0.000666666666666667	6795	1
3	Drink 2	Intake 2	27	21980	1335979988	/users/cn/jespinosa/phecomp/data/CRG/20120502_FDF_CRG/20120502_FDF_CRG/20120502_FDF_CRG_c12.mtb	490	NA	WWSS	water	2	21953	1335979961	1	0.02	0.000740740740740741	6796	1
3	Food 2	Intake 4	348	24367	1335982375	/users/cn/jespinosa/phecomp/data/CRG/20120502_FDF_CRG/20120502_FDF_CRG/20120502_FDF_CRG_c12.mtb	339	1246	WWSS	food_sc	4	24019	1335982027	1	0.06	0.000172413793103448	6797	1
3	Drink 1	Intake 1	18	24509	1335982517	/users/cn/jespinosa/phecomp/data/CRG/20120502_FDF_CRG/20120502_FDF_CRG/20120502_FDF_CRG_c12.mtb	64	NA	WWSS	water	1	24491	1335982499	1	0.04	0.00222222222222222	6798	1
3	Food 2	Intake 4	368	25981	1335983989	/users/cn/jespinosa/phecomp/data/CRG/20120502_FDF_CRG/20120502_FDF_CRG/20120502_FDF_CRG_c12.mtb	340	530	WWSS	food_sc	4	25613	1335983621	1	0.12	0.000326086956521739	6799	1
3	Drink 2	Intake 2	22	26051	1335984059	/users/cn/jespinosa/phecomp/data/CRG/20120502_FDF_CRG/20120502_FDF_CRG/20120502_FDF_CRG_c12.mtb	494	NA	WWSS	water	2	26029	1335984037	1	0.08	0.00363636363636364	6800	1
3	Drink 2	Intake 2	57	26144	1335984152	/users/cn/jespinosa/phecomp/data/CRG/20120502_FDF_CRG/20120502_FDF_CRG/20120502_FDF_CRG_c12.mtb	495	NA	WWSS	water	2	26087	1335984095	1	0.04	0.000701754385964912	6801	1
3	Food 2	Intake 4	141	26652	1335984660	/users/cn/jespinosa/phecomp/data/CRG/20120502_FDF_CRG/20120502_FDF_CRG/20120502_FDF_CRG_c12.mtb	344	281	WWSS	food_sc	4	26511	1335984519	1	0.04	0.000283687943262411	6802	1
3	Drink 2	Intake 2	22	26701	1335984709	/users/cn/jespinosa/phecomp/data/CRG/20120502_FDF_CRG/20120502_FDF_CRG/20120502_FDF_CRG_c12.mtb	499	NA	WWSS	water	2	26679	1335984687	1	0.08	0.00363636363636364	6803	1
3	Food 2	Intake 4	89	27022	1335985030	/users/cn/jespinosa/phecomp/data/CRG/20120502_FDF_CRG/20120502_FDF_CRG/20120502_FDF_CRG_c12.mtb	345	4	WWSS	food_sc	4	26933	1335984941	1	0.06	0.000674157303370786	6804	1
3	Food 2	Intake 4	223	27249	1335985257	/users/cn/jespinosa/phecomp/data/CRG/20120502_FDF_CRG/20120502_FDF_CRG/20120502_FDF_CRG_c12.mtb	346	827	WWSS	food_sc	4	27026	1335985034	1	0.08	0.000358744394618834	6805	1
3	Drink 2	Intake 2	28	27526	1335985534	/users/cn/jespinosa/phecomp/data/CRG/20120502_FDF_CRG/20120502_FDF_CRG/20120502_FDF_CRG_c12.mtb	501	NA	WWSS	water	2	27498	1335985506	1	0.08	0.00285714285714286	6806	1
3	Food 2	Intake 4	169	28245	1335986253	/users/cn/jespinosa/phecomp/data/CRG/20120502_FDF_CRG/20120502_FDF_CRG/20120502_FDF_CRG_c12.mtb	349	1188	WWSS	food_sc	4	28076	1335986084	1	0.0399999999999999	0.000236686390532544	6807	1
3	Drink 2	Intake 2	36	28304	1335986312	/users/cn/jespinosa/phecomp/data/CRG/20120502_FDF_CRG/20120502_FDF_CRG/20120502_FDF_CRG_c12.mtb	503	NA	WWSS	water	2	28268	1335986276	1	0.1	0.00277777777777778	6808	1
3	Drink 2	Intake 2	27	28743	1335986751	/users/cn/jespinosa/phecomp/data/CRG/20120502_FDF_CRG/20120502_FDF_CRG/20120502_FDF_CRG_c12.mtb	506	NA	WWSS	water	2	28716	1335986724	1	0.04	0.00148148148148148	6809	1
3	Food 2	Intake 4	358	29791	1335987799	/users/cn/jespinosa/phecomp/data/CRG/20120502_FDF_CRG/20120502_FDF_CRG/20120502_FDF_CRG_c12.mtb	350	5	WWSS	food_sc	4	29433	1335987441	1	0.0600000000000001	0.000167597765363129	6810	1
3	Food 2	Intake 4	45	29841	1335987849	/users/cn/jespinosa/phecomp/data/CRG/20120502_FDF_CRG/20120502_FDF_CRG/20120502_FDF_CRG_c12.mtb	351	516	WWSS	food_sc	4	29796	1335987804	1	0.02	0.000444444444444444	6811	1
3	Drink 2	Intake 2	63	29900	1335987908	/users/cn/jespinosa/phecomp/data/CRG/20120502_FDF_CRG/20120502_FDF_CRG/20120502_FDF_CRG_c12.mtb	507	NA	WWSS	water	2	29837	1335987845	1	0.12	0.0019047619047619	6812	1
3	Food 1	Intake 3	371	30728	1335988736	/users/cn/jespinosa/phecomp/data/CRG/20120502_FDF_CRG/20120502_FDF_CRG/20120502_FDF_CRG_c12.mtb	103	1347	WWSS	food_sc	3	30357	1335988365	1	0.06	0.000161725067385445	6813	1
3	Drink 2	Intake 2	12	30822	1335988830	/users/cn/jespinosa/phecomp/data/CRG/20120502_FDF_CRG/20120502_FDF_CRG/20120502_FDF_CRG_c12.mtb	511	NA	WWSS	water	2	30810	1335988818	1	0.0599999999999999	0.00499999999999999	6814	1
3	Drink 2	Intake 2	94	31202	1335989210	/users/cn/jespinosa/phecomp/data/CRG/20120502_FDF_CRG/20120502_FDF_CRG/20120502_FDF_CRG_c12.mtb	514	NA	WWSS	water	2	31108	1335989116	1	0.02	0.000212765957446809	6815	1
3	Drink 2	Intake 2	20	31809	1335989817	/users/cn/jespinosa/phecomp/data/CRG/20120502_FDF_CRG/20120502_FDF_CRG/20120502_FDF_CRG_c12.mtb	519	NA	WWSS	water	2	31789	1335989797	1	0.02	0.001	6816	1
3	Food 2	Intake 4	644	32719	1335990727	/users/cn/jespinosa/phecomp/data/CRG/20120502_FDF_CRG/20120502_FDF_CRG/20120502_FDF_CRG_c12.mtb	358	2796	WWSS	food_sc	4	32075	1335990083	1	0.26	0.000403726708074534	6817	1
3	Drink 2	Intake 2	55	32773	1335990781	/users/cn/jespinosa/phecomp/data/CRG/20120502_FDF_CRG/20120502_FDF_CRG/20120502_FDF_CRG_c12.mtb	521	NA	WWSS	water	2	32718	1335990726	1	0.12	0.00218181818181818	6818	1
3	Drink 2	Intake 2	20	33019	1335991027	/users/cn/jespinosa/phecomp/data/CRG/20120502_FDF_CRG/20120502_FDF_CRG/20120502_FDF_CRG_c12.mtb	524	NA	WWSS	water	2	32999	1335991007	1	0.02	0.001	6819	1
3	Drink 2	Intake 2	31	33085	1335991093	/users/cn/jespinosa/phecomp/data/CRG/20120502_FDF_CRG/20120502_FDF_CRG/20120502_FDF_CRG_c12.mtb	525	NA	WWSS	water	2	33054	1335991062	1	0.0399999999999999	0.00129032258064516	6820	1
3	Drink 2	Intake 2	38	33649	1335991657	/users/cn/jespinosa/phecomp/data/CRG/20120502_FDF_CRG/20120502_FDF_CRG/20120502_FDF_CRG_c12.mtb	530	NA	WWSS	water	2	33611	1335991619	1	0.0600000000000001	0.00157894736842106	6821	1
3	Food 2	Intake 4	170	35685	1335993693	/users/cn/jespinosa/phecomp/data/CRG/20120502_FDF_CRG/20120502_FDF_CRG/20120502_FDF_CRG_c12.mtb	363	871	WWSS	food_sc	4	35515	1335993523	1	0.02	0.000117647058823529	6822	1
3	Drink 2	Intake 2	20	35994	1335994002	/users/cn/jespinosa/phecomp/data/CRG/20120502_FDF_CRG/20120502_FDF_CRG/20120502_FDF_CRG_c12.mtb	535	NA	WWSS	water	2	35974	1335993982	1	0.04	0.002	6823	1
3	Food 2	Intake 4	683	37239	1335995247	/users/cn/jespinosa/phecomp/data/CRG/20120502_FDF_CRG/20120502_FDF_CRG/20120502_FDF_CRG_c12.mtb	366	601	WWSS	food_sc	4	36556	1335994564	1	0.22	0.000322108345534407	6824	1
3	Drink 2	Intake 2	19	37252	1335995260	/users/cn/jespinosa/phecomp/data/CRG/20120502_FDF_CRG/20120502_FDF_CRG/20120502_FDF_CRG_c12.mtb	536	NA	WWSS	water	2	37233	1335995241	1	0.02	0.00105263157894737	6825	1
3	Drink 1	Intake 1	17	37400	1335995408	/users/cn/jespinosa/phecomp/data/CRG/20120502_FDF_CRG/20120502_FDF_CRG/20120502_FDF_CRG_c12.mtb	66	NA	WWSS	water	1	37383	1335995391	1	0.02	0.00117647058823529	6826	1
3	Drink 2	Intake 2	25	37423	1335995431	/users/cn/jespinosa/phecomp/data/CRG/20120502_FDF_CRG/20120502_FDF_CRG/20120502_FDF_CRG_c12.mtb	537	NA	WWSS	water	2	37398	1335995406	1	0.02	0.0008	6827	1
3	Drink 2	Intake 2	28	37731	1335995739	/users/cn/jespinosa/phecomp/data/CRG/20120502_FDF_CRG/20120502_FDF_CRG/20120502_FDF_CRG_c12.mtb	539	NA	WWSS	water	2	37703	1335995711	1	0.0599999999999998	0.00214285714285714	6828	1
3	Food 2	Intake 4	121	37961	1335995969	/users/cn/jespinosa/phecomp/data/CRG/20120502_FDF_CRG/20120502_FDF_CRG/20120502_FDF_CRG_c12.mtb	369	147	WWSS	food_sc	4	37840	1335995848	1	0.04	0.000330578512396694	6829	1
3	Drink 2	Intake 2	12	38112	1335996120	/users/cn/jespinosa/phecomp/data/CRG/20120502_FDF_CRG/20120502_FDF_CRG/20120502_FDF_CRG_c12.mtb	541	NA	WWSS	water	2	38100	1335996108	1	0.02	0.00166666666666667	6830	1
3	Food 1	Intake 3	157	38265	1335996273	/users/cn/jespinosa/phecomp/data/CRG/20120502_FDF_CRG/20120502_FDF_CRG/20120502_FDF_CRG_c12.mtb	108	320	WWSS	food_sc	3	38108	1335996116	1	0.02	0.000127388535031847	6831	1
3	Drink 2	Intake 2	36	38302	1335996310	/users/cn/jespinosa/phecomp/data/CRG/20120502_FDF_CRG/20120502_FDF_CRG/20120502_FDF_CRG_c12.mtb	542	NA	WWSS	water	2	38266	1335996274	1	0.1	0.00277777777777778	6832	1
3	Drink 2	Intake 2	36	38585	1335996593	/users/cn/jespinosa/phecomp/data/CRG/20120502_FDF_CRG/20120502_FDF_CRG/20120502_FDF_CRG_c12.mtb	545	NA	WWSS	water	2	38549	1335996557	1	0.0999999999999999	0.00277777777777777	6833	1
3	Food 2	Intake 4	178	38763	1335996771	/users/cn/jespinosa/phecomp/data/CRG/20120502_FDF_CRG/20120502_FDF_CRG/20120502_FDF_CRG_c12.mtb	372	392	WWSS	food_sc	4	38585	1335996593	1	0.02	0.000112359550561798	6834	1
3	Food 1	Intake 3	96	39251	1335997259	/users/cn/jespinosa/phecomp/data/CRG/20120502_FDF_CRG/20120502_FDF_CRG/20120502_FDF_CRG_c12.mtb	110	177	WWSS	food_sc	3	39155	1335997163	1	0.04	0.000416666666666667	6835	1
3	Drink 1	Intake 1	17	39277	1335997285	/users/cn/jespinosa/phecomp/data/CRG/20120502_FDF_CRG/20120502_FDF_CRG/20120502_FDF_CRG_c12.mtb	68	NA	WWSS	water	1	39260	1335997268	1	0.02	0.00117647058823529	6836	1
3	Food 1	Intake 3	163	39591	1335997599	/users/cn/jespinosa/phecomp/data/CRG/20120502_FDF_CRG/20120502_FDF_CRG/20120502_FDF_CRG_c12.mtb	111	278	WWSS	food_sc	3	39428	1335997436	1	0.06	0.000368098159509202	6837	1
3	Drink 2	Intake 2	24	39636	1335997644	/users/cn/jespinosa/phecomp/data/CRG/20120502_FDF_CRG/20120502_FDF_CRG/20120502_FDF_CRG_c12.mtb	552	NA	WWSS	water	2	39612	1335997620	1	0.0800000000000001	0.00333333333333334	6838	1
3	Food 2	Intake 4	189	40058	1335998066	/users/cn/jespinosa/phecomp/data/CRG/20120502_FDF_CRG/20120502_FDF_CRG/20120502_FDF_CRG_c12.mtb	376	17	WWSS	food_sc	4	39869	1335997877	1	0.04	0.000211640211640212	6839	1
3	Food 2	Intake 4	101	40176	1335998184	/users/cn/jespinosa/phecomp/data/CRG/20120502_FDF_CRG/20120502_FDF_CRG/20120502_FDF_CRG_c12.mtb	377	868	WWSS	food_sc	4	40075	1335998083	1	0.04	0.000396039603960396	6840	1
3	Drink 2	Intake 2	58	40231	1335998239	/users/cn/jespinosa/phecomp/data/CRG/20120502_FDF_CRG/20120502_FDF_CRG/20120502_FDF_CRG_c12.mtb	554	NA	WWSS	water	2	40173	1335998181	1	0.12	0.00206896551724138	6841	1
3	Food 2	Intake 4	316	41360	1335999368	/users/cn/jespinosa/phecomp/data/CRG/20120502_FDF_CRG/20120502_FDF_CRG/20120502_FDF_CRG_c12.mtb	379	64	WWSS	food_sc	4	41044	1335999052	1	0.0399999999999998	0.000126582278481012	6842	1
3	Food 2	Intake 4	122	41546	1335999554	/users/cn/jespinosa/phecomp/data/CRG/20120502_FDF_CRG/20120502_FDF_CRG/20120502_FDF_CRG_c12.mtb	380	351	WWSS	food_sc	4	41424	1335999432	1	0.02	0.000163934426229508	6843	1
3	Drink 2	Intake 2	35	41619	1335999627	/users/cn/jespinosa/phecomp/data/CRG/20120502_FDF_CRG/20120502_FDF_CRG/20120502_FDF_CRG_c12.mtb	562	NA	WWSS	water	2	41584	1335999592	1	0.1	0.00285714285714286	6844	1
3	Food 1	Intake 3	94	41991	1335999999	/users/cn/jespinosa/phecomp/data/CRG/20120502_FDF_CRG/20120502_FDF_CRG/20120502_FDF_CRG_c12.mtb	112	13	WWSS	food_sc	3	41897	1335999905	1	0.02	0.000212765957446809	6845	1
3	Food 2	Intake 4	100	42104	1336000112	/users/cn/jespinosa/phecomp/data/CRG/20120502_FDF_CRG/20120502_FDF_CRG/20120502_FDF_CRG_c12.mtb	382	379	WWSS	food_sc	4	42004	1336000012	1	0.02	0.0002	6846	1
3	Food 1	Intake 3	92	42575	1336000583	/users/cn/jespinosa/phecomp/data/CRG/20120502_FDF_CRG/20120502_FDF_CRG/20120502_FDF_CRG_c12.mtb	113	136	WWSS	food_sc	3	42483	1336000491	1	0.02	0.000217391304347826	6847	1
3	Food 2	Intake 4	120	42831	1336000839	/users/cn/jespinosa/phecomp/data/CRG/20120502_FDF_CRG/20120502_FDF_CRG/20120502_FDF_CRG_c12.mtb	385	1505	WWSS	food_sc	4	42711	1336000719	1	0.02	0.000166666666666667	6848	1
3	Drink 2	Intake 2	31	42945	1336000953	/users/cn/jespinosa/phecomp/data/CRG/20120502_FDF_CRG/20120502_FDF_CRG/20120502_FDF_CRG_c12.mtb	568	NA	WWSS	water	2	42914	1336000922	1	0.1	0.0032258064516129	6849	1
3	Food 1	Intake 3	200	44536	1336002544	/users/cn/jespinosa/phecomp/data/CRG/20120502_FDF_CRG/20120502_FDF_CRG/20120502_FDF_CRG_c12.mtb	114	1010	WWSS	food_sc	3	44336	1336002344	1	0.02	0.0001	6850	1
3	Drink 2	Intake 2	13	44957	1336002965	/users/cn/jespinosa/phecomp/data/CRG/20120502_FDF_CRG/20120502_FDF_CRG/20120502_FDF_CRG_c12.mtb	580	NA	WWSS	water	2	44944	1336002952	1	0.02	0.00153846153846154	6851	1
3	Food 2	Intake 4	64	45610	1336003618	/users/cn/jespinosa/phecomp/data/CRG/20120502_FDF_CRG/20120502_FDF_CRG/20120502_FDF_CRG_c12.mtb	390	4007	WWSS	food_sc	4	45546	1336003554	1	0.02	0.0003125	6852	1
3	Food 2	Intake 4	118	49735	1336007743	/users/cn/jespinosa/phecomp/data/CRG/20120502_FDF_CRG/20120502_FDF_CRG/20120502_FDF_CRG_c12.mtb	391	COLL	WWSS	food_sc	4	49617	1336007625	1	0.02	0.000169491525423729	6853	1
3	Food 1	Intake 3	36	49760	1336007768	/users/cn/jespinosa/phecomp/data/CRG/20120502_FDF_CRG/20120502_FDF_CRG/20120502_FDF_CRG_c12.mtb	115	28	WWSS	food_sc	3	49724	1336007732	1	0.02	0.000555555555555556	6854	1
3	Food 2	Intake 4	14	49802	1336007810	/users/cn/jespinosa/phecomp/data/CRG/20120502_FDF_CRG/20120502_FDF_CRG/20120502_FDF_CRG_c12.mtb	393	6732	WWSS	food_sc	4	49788	1336007796	1	0.02	0.00142857142857143	6855	1
3	Drink 2	Intake 2	25	49917	1336007925	/users/cn/jespinosa/phecomp/data/CRG/20120502_FDF_CRG/20120502_FDF_CRG/20120502_FDF_CRG_c12.mtb	583	NA	WWSS	water	2	49892	1336007900	1	0.0600000000000001	0.0024	6856	1
3	Drink 2	Intake 2	24	49973	1336007981	/users/cn/jespinosa/phecomp/data/CRG/20120502_FDF_CRG/20120502_FDF_CRG/20120502_FDF_CRG_c12.mtb	584	NA	WWSS	water	2	49949	1336007957	1	0.04	0.00166666666666667	6857	1
3	Drink 2	Intake 2	15	50096	1336008104	/users/cn/jespinosa/phecomp/data/CRG/20120502_FDF_CRG/20120502_FDF_CRG/20120502_FDF_CRG_c12.mtb	586	NA	WWSS	water	2	50081	1336008089	1	0.02	0.00133333333333333	6858	1
3	Food 1	Intake 3	151	56685	1336014693	/users/cn/jespinosa/phecomp/data/CRG/20120502_FDF_CRG/20120502_FDF_CRG/20120502_FDF_CRG_c12.mtb	118	25	WWSS	food_sc	3	56534	1336014542	1	0.04	0.000264900662251656	6859	1
3	Food 1	Intake 3	106	56816	1336014824	/users/cn/jespinosa/phecomp/data/CRG/20120502_FDF_CRG/20120502_FDF_CRG/20120502_FDF_CRG_c12.mtb	119	342	WWSS	food_sc	3	56710	1336014718	1	0.02	0.000188679245283019	6860	1
3	Drink 2	Intake 2	25	56955	1336014963	/users/cn/jespinosa/phecomp/data/CRG/20120502_FDF_CRG/20120502_FDF_CRG/20120502_FDF_CRG_c12.mtb	587	NA	WWSS	water	2	56930	1336014938	1	0.02	0.0008	6861	1
3	Drink 2	Intake 2	44	57087	1336015095	/users/cn/jespinosa/phecomp/data/CRG/20120502_FDF_CRG/20120502_FDF_CRG/20120502_FDF_CRG_c12.mtb	588	NA	WWSS	water	2	57043	1336015051	1	0.12	0.00272727272727273	6862	1
3	Food 1	Intake 3	86	57244	1336015252	/users/cn/jespinosa/phecomp/data/CRG/20120502_FDF_CRG/20120502_FDF_CRG/20120502_FDF_CRG_c12.mtb	121	3498	WWSS	food_sc	3	57158	1336015166	1	0.02	0.000232558139534884	6863	1
3	Drink 2	Intake 2	18	57568	1336015576	/users/cn/jespinosa/phecomp/data/CRG/20120502_FDF_CRG/20120502_FDF_CRG/20120502_FDF_CRG_c12.mtb	590	NA	WWSS	water	2	57550	1336015558	1	0.02	0.00111111111111111	6864	1
3	Food 1	Intake 3	89	60831	1336018839	/users/cn/jespinosa/phecomp/data/CRG/20120502_FDF_CRG/20120502_FDF_CRG/20120502_FDF_CRG_c12.mtb	123	9	WWSS	food_sc	3	60742	1336018750	1	0.02	0.000224719101123596	6865	1
3	Food 1	Intake 3	205	61045	1336019053	/users/cn/jespinosa/phecomp/data/CRG/20120502_FDF_CRG/20120502_FDF_CRG/20120502_FDF_CRG_c12.mtb	124	14	WWSS	food_sc	3	60840	1336018848	1	0.1	0.000487804878048781	6866	1
3	Food 1	Intake 3	24	61083	1336019091	/users/cn/jespinosa/phecomp/data/CRG/20120502_FDF_CRG/20120502_FDF_CRG/20120502_FDF_CRG_c12.mtb	125	6	WWSS	food_sc	3	61059	1336019067	1	0.02	0.000833333333333333	6867	1
3	Food 1	Intake 3	44	61133	1336019141	/users/cn/jespinosa/phecomp/data/CRG/20120502_FDF_CRG/20120502_FDF_CRG/20120502_FDF_CRG_c12.mtb	126	2854	WWSS	food_sc	3	61089	1336019097	1	0.04	0.000909090909090909	6868	1
3	Drink 1	Intake 1	18	61293	1336019301	/users/cn/jespinosa/phecomp/data/CRG/20120502_FDF_CRG/20120502_FDF_CRG/20120502_FDF_CRG_c12.mtb	75	NA	WWSS	water	1	61275	1336019283	1	0.06	0.00333333333333333	6869	1
3	Drink 1	Intake 1	28	61421	1336019429	/users/cn/jespinosa/phecomp/data/CRG/20120502_FDF_CRG/20120502_FDF_CRG/20120502_FDF_CRG_c12.mtb	76	NA	WWSS	water	1	61393	1336019401	1	0.08	0.00285714285714286	6870	1
3	Drink 1	Intake 1	19	61903	1336019911	/users/cn/jespinosa/phecomp/data/CRG/20120502_FDF_CRG/20120502_FDF_CRG/20120502_FDF_CRG_c12.mtb	77	NA	WWSS	water	1	61884	1336019892	1	0.08	0.00421052631578947	6871	1
3	Drink 1	Intake 1	15	63443	1336021451	/users/cn/jespinosa/phecomp/data/CRG/20120502_FDF_CRG/20120502_FDF_CRG/20120502_FDF_CRG_c12.mtb	78	NA	WWSS	water	1	63428	1336021436	1	0.04	0.00266666666666667	6872	1
3	Food 1	Intake 3	127	64114	1336022122	/users/cn/jespinosa/phecomp/data/CRG/20120502_FDF_CRG/20120502_FDF_CRG/20120502_FDF_CRG_c12.mtb	130	4	WWSS	food_sc	3	63987	1336021995	1	0.0399999999999999	0.000314960629921259	6873	1
3	Food 1	Intake 3	274	64392	1336022400	/users/cn/jespinosa/phecomp/data/CRG/20120502_FDF_CRG/20120502_FDF_CRG/20120502_FDF_CRG_c12.mtb	131	401	WWSS	food_sc	3	64118	1336022126	1	0.0600000000000001	0.000218978102189781	6874	1
3	Drink 2	Intake 2	25	64490	1336022498	/users/cn/jespinosa/phecomp/data/CRG/20120502_FDF_CRG/20120502_FDF_CRG/20120502_FDF_CRG_c12.mtb	592	NA	WWSS	water	2	64465	1336022473	1	0.0600000000000001	0.0024	6875	1
3	Food 1	Intake 3	27	64820	1336022828	/users/cn/jespinosa/phecomp/data/CRG/20120502_FDF_CRG/20120502_FDF_CRG/20120502_FDF_CRG_c12.mtb	133	26	WWSS	food_sc	3	64793	1336022801	1	0.02	0.000740740740740741	6876	1
3	Food 1	Intake 3	73	64919	1336022927	/users/cn/jespinosa/phecomp/data/CRG/20120502_FDF_CRG/20120502_FDF_CRG/20120502_FDF_CRG_c12.mtb	134	965	WWSS	food_sc	3	64846	1336022854	1	0.0399999999999999	0.000547945205479451	6877	1
3	Drink 2	Intake 2	17	64964	1336022972	/users/cn/jespinosa/phecomp/data/CRG/20120502_FDF_CRG/20120502_FDF_CRG/20120502_FDF_CRG_c12.mtb	595	NA	WWSS	water	2	64947	1336022955	1	0.02	0.00117647058823529	6878	1
3	Drink 2	Intake 2	29	65057	1336023065	/users/cn/jespinosa/phecomp/data/CRG/20120502_FDF_CRG/20120502_FDF_CRG/20120502_FDF_CRG_c12.mtb	596	NA	WWSS	water	2	65028	1336023036	1	0.0599999999999996	0.00206896551724137	6879	1
3	Drink 2	Intake 2	15	65133	1336023141	/users/cn/jespinosa/phecomp/data/CRG/20120502_FDF_CRG/20120502_FDF_CRG/20120502_FDF_CRG_c12.mtb	597	NA	WWSS	water	2	65118	1336023126	1	0.0200000000000005	0.00133333333333337	6880	1
3	Drink 2	Intake 2	26	65665	1336023673	/users/cn/jespinosa/phecomp/data/CRG/20120502_FDF_CRG/20120502_FDF_CRG/20120502_FDF_CRG_c12.mtb	598	NA	WWSS	water	2	65639	1336023647	1	0.0999999999999996	0.00384615384615383	6881	1
3	Food 1	Intake 3	57	65941	1336023949	/users/cn/jespinosa/phecomp/data/CRG/20120502_FDF_CRG/20120502_FDF_CRG/20120502_FDF_CRG_c12.mtb	138	9	WWSS	food_sc	3	65884	1336023892	1	0.02	0.000350877192982456	6882	1
3	Food 1	Intake 3	195	66145	1336024153	/users/cn/jespinosa/phecomp/data/CRG/20120502_FDF_CRG/20120502_FDF_CRG/20120502_FDF_CRG_c12.mtb	139	812	WWSS	food_sc	3	65950	1336023958	1	0.0600000000000001	0.000307692307692308	6883	1
3	Drink 2	Intake 2	20	66175	1336024183	/users/cn/jespinosa/phecomp/data/CRG/20120502_FDF_CRG/20120502_FDF_CRG/20120502_FDF_CRG_c12.mtb	599	NA	WWSS	water	2	66155	1336024163	1	0.04	0.002	6884	1
3	Drink 2	Intake 2	87	66411	1336024419	/users/cn/jespinosa/phecomp/data/CRG/20120502_FDF_CRG/20120502_FDF_CRG/20120502_FDF_CRG_c12.mtb	601	NA	WWSS	water	2	66324	1336024332	1	0.02	0.000229885057471264	6885	1
3	Drink 2	Intake 2	57	66475	1336024483	/users/cn/jespinosa/phecomp/data/CRG/20120502_FDF_CRG/20120502_FDF_CRG/20120502_FDF_CRG_c12.mtb	602	NA	WWSS	water	2	66418	1336024426	1	0.02	0.000350877192982456	6886	1
3	Drink 2	Intake 2	143	66652	1336024660	/users/cn/jespinosa/phecomp/data/CRG/20120502_FDF_CRG/20120502_FDF_CRG/20120502_FDF_CRG_c12.mtb	603	NA	WWSS	water	2	66509	1336024517	1	0.02	0.00013986013986014	6887	1
3	Drink 1	Intake 1	17	66719	1336024727	/users/cn/jespinosa/phecomp/data/CRG/20120502_FDF_CRG/20120502_FDF_CRG/20120502_FDF_CRG_c12.mtb	80	NA	WWSS	water	1	66702	1336024710	1	0.02	0.00117647058823529	6888	1
3	Food 1	Intake 3	260	67217	1336025225	/users/cn/jespinosa/phecomp/data/CRG/20120502_FDF_CRG/20120502_FDF_CRG/20120502_FDF_CRG_c12.mtb	141	99	WWSS	food_sc	3	66957	1336024965	1	0.0599999999999999	0.00023076923076923	6889	1
3	Food 1	Intake 3	139	67455	1336025463	/users/cn/jespinosa/phecomp/data/CRG/20120502_FDF_CRG/20120502_FDF_CRG/20120502_FDF_CRG_c12.mtb	142	313	WWSS	food_sc	3	67316	1336025324	1	0.02	0.000143884892086331	6890	1
3	Drink 2	Intake 2	23	67551	1336025559	/users/cn/jespinosa/phecomp/data/CRG/20120502_FDF_CRG/20120502_FDF_CRG/20120502_FDF_CRG_c12.mtb	609	NA	WWSS	water	2	67528	1336025536	1	0.02	0.000869565217391304	6891	1
3	Drink 2	Intake 2	31	67636	1336025644	/users/cn/jespinosa/phecomp/data/CRG/20120502_FDF_CRG/20120502_FDF_CRG/20120502_FDF_CRG_c12.mtb	610	NA	WWSS	water	2	67605	1336025613	1	0.1	0.0032258064516129	6892	1
3	Food 1	Intake 3	174	67942	1336025950	/users/cn/jespinosa/phecomp/data/CRG/20120502_FDF_CRG/20120502_FDF_CRG/20120502_FDF_CRG_c12.mtb	143	6289	WWSS	food_sc	3	67768	1336025776	1	0.04	0.000229885057471264	6893	1
3	Drink 1	Intake 1	13	68128	1336026136	/users/cn/jespinosa/phecomp/data/CRG/20120502_FDF_CRG/20120502_FDF_CRG/20120502_FDF_CRG_c12.mtb	81	NA	WWSS	water	1	68115	1336026123	1	0.02	0.00153846153846154	6894	1
3	Drink 2	Intake 2	16	68643	1336026651	/users/cn/jespinosa/phecomp/data/CRG/20120502_FDF_CRG/20120502_FDF_CRG/20120502_FDF_CRG_c12.mtb	615	NA	WWSS	water	2	68627	1336026635	1	0.02	0.00125	6895	1
3	Drink 2	Intake 2	21	74186	1336032194	/users/cn/jespinosa/phecomp/data/CRG/20120502_FDF_CRG/20120502_FDF_CRG/20120502_FDF_CRG_c12.mtb	617	NA	WWSS	water	2	74165	1336032173	1	0.02	0.000952380952380952	6896	1
3	Food 1	Intake 3	94	74325	1336032333	/users/cn/jespinosa/phecomp/data/CRG/20120502_FDF_CRG/20120502_FDF_CRG/20120502_FDF_CRG_c12.mtb	148	29842	WWSS	food_sc	3	74231	1336032239	1	0.02	0.000212765957446809	6897	1
3	Drink 2	Intake 2	16	74938	1336032946	/users/cn/jespinosa/phecomp/data/CRG/20120502_FDF_CRG/20120502_FDF_CRG/20120502_FDF_CRG_c12.mtb	618	NA	WWSS	water	2	74922	1336032930	1	0.04	0.0025	6898	1
3	Drink 2	Intake 2	42	75259	1336033267	/users/cn/jespinosa/phecomp/data/CRG/20120502_FDF_CRG/20120502_FDF_CRG/20120502_FDF_CRG_c12.mtb	620	NA	WWSS	water	2	75217	1336033225	1	0.1	0.00238095238095238	6899	1
3	Drink 2	Intake 2	47	80193	1336038201	/users/cn/jespinosa/phecomp/data/CRG/20120502_FDF_CRG/20120502_FDF_CRG/20120502_FDF_CRG_c12.mtb	628	NA	WWSS	water	2	80146	1336038154	1	0.02	0.000425531914893617	6900	1
3	Drink 2	Intake 2	17	81571	1336039579	/users/cn/jespinosa/phecomp/data/CRG/20120502_FDF_CRG/20120502_FDF_CRG/20120502_FDF_CRG_c12.mtb	633	NA	WWSS	water	2	81554	1336039562	1	0.02	0.00117647058823529	6901	1
3	Food 1	Intake 3	232	104399	1336062407	/users/cn/jespinosa/phecomp/data/CRG/20120502_FDF_CRG/20120502_FDF_CRG/20120502_FDF_CRG_c12.mtb	155	1551	WWSS	food_sc	3	104167	1336062175	1	0.02	8.62068965517241e-05	6902	1
3	Drink 2	Intake 2	20	104781	1336062789	/users/cn/jespinosa/phecomp/data/CRG/20120502_FDF_CRG/20120502_FDF_CRG/20120502_FDF_CRG_c12.mtb	645	NA	WWSS	water	2	104761	1336062769	1	0.02	0.001	6903	1
3	Drink 2	Intake 2	14	105296	1336063304	/users/cn/jespinosa/phecomp/data/CRG/20120502_FDF_CRG/20120502_FDF_CRG/20120502_FDF_CRG_c12.mtb	646	NA	WWSS	water	2	105282	1336063290	1	0.02	0.00142857142857143	6904	1
3	Drink 2	Intake 2	14	105467	1336063475	/users/cn/jespinosa/phecomp/data/CRG/20120502_FDF_CRG/20120502_FDF_CRG/20120502_FDF_CRG_c12.mtb	647	NA	WWSS	water	2	105453	1336063461	1	0.02	0.00142857142857143	6905	1
3	Drink 2	Intake 2	13	105707	1336063715	/users/cn/jespinosa/phecomp/data/CRG/20120502_FDF_CRG/20120502_FDF_CRG/20120502_FDF_CRG_c12.mtb	650	NA	WWSS	water	2	105694	1336063702	1	0.02	0.00153846153846154	6906	1
3	Food 1	Intake 3	140	106090	1336064098	/users/cn/jespinosa/phecomp/data/CRG/20120502_FDF_CRG/20120502_FDF_CRG/20120502_FDF_CRG_c12.mtb	161	4218	WWSS	food_sc	3	105950	1336063958	1	0.02	0.000142857142857143	6907	1
3	Food 1	Intake 3	679	110987	1336068995	/users/cn/jespinosa/phecomp/data/CRG/20120502_FDF_CRG/20120502_FDF_CRG/20120502_FDF_CRG_c12.mtb	163	1620	WWSS	food_sc	3	110308	1336068316	1	0.14	0.000206185567010309	6908	1
3	Drink 2	Intake 2	23	111030	1336069038	/users/cn/jespinosa/phecomp/data/CRG/20120502_FDF_CRG/20120502_FDF_CRG/20120502_FDF_CRG_c12.mtb	652	NA	WWSS	water	2	111007	1336069015	1	0.0800000000000001	0.00347826086956522	6909	1
3	Drink 2	Intake 2	84	111265	1336069273	/users/cn/jespinosa/phecomp/data/CRG/20120502_FDF_CRG/20120502_FDF_CRG/20120502_FDF_CRG_c12.mtb	653	NA	WWSS	water	2	111181	1336069189	1	0.02	0.000238095238095238	6910	1
3	Drink 2	Intake 2	13	111392	1336069400	/users/cn/jespinosa/phecomp/data/CRG/20120502_FDF_CRG/20120502_FDF_CRG/20120502_FDF_CRG_c12.mtb	655	NA	WWSS	water	2	111379	1336069387	1	0.02	0.00153846153846154	6911	1
3	Drink 1	Intake 1	11	112447	1336070455	/users/cn/jespinosa/phecomp/data/CRG/20120502_FDF_CRG/20120502_FDF_CRG/20120502_FDF_CRG_c12.mtb	89	NA	WWSS	water	1	112436	1336070444	1	0.02	0.00181818181818182	6912	1
3	Food 1	Intake 3	339	112946	1336070954	/users/cn/jespinosa/phecomp/data/CRG/20120502_FDF_CRG/20120502_FDF_CRG/20120502_FDF_CRG_c12.mtb	166	224	WWSS	food_sc	3	112607	1336070615	1	0.0599999999999998	0.000176991150442477	6913	1
3	Drink 2	Intake 2	18	112964	1336070972	/users/cn/jespinosa/phecomp/data/CRG/20120502_FDF_CRG/20120502_FDF_CRG/20120502_FDF_CRG_c12.mtb	659	NA	WWSS	water	2	112946	1336070954	1	0.0600000000000001	0.00333333333333334	6914	1
3	Drink 2	Intake 2	20	113061	1336071069	/users/cn/jespinosa/phecomp/data/CRG/20120502_FDF_CRG/20120502_FDF_CRG/20120502_FDF_CRG_c12.mtb	660	NA	WWSS	water	2	113041	1336071049	1	0.04	0.002	6915	1
3	Food 1	Intake 3	618	113788	1336071796	/users/cn/jespinosa/phecomp/data/CRG/20120502_FDF_CRG/20120502_FDF_CRG/20120502_FDF_CRG_c12.mtb	168	444	WWSS	food_sc	3	113170	1336071178	1	0.2	0.000323624595469256	6916	1
3	Drink 2	Intake 2	26	113828	1336071836	/users/cn/jespinosa/phecomp/data/CRG/20120502_FDF_CRG/20120502_FDF_CRG/20120502_FDF_CRG_c12.mtb	661	NA	WWSS	water	2	113802	1336071810	1	0.0800000000000001	0.00307692307692308	6917	1
3	Drink 2	Intake 2	26	114095	1336072103	/users/cn/jespinosa/phecomp/data/CRG/20120502_FDF_CRG/20120502_FDF_CRG/20120502_FDF_CRG_c12.mtb	663	NA	WWSS	water	2	114069	1336072077	1	0.0399999999999996	0.00153846153846152	6918	1
3	Drink 1	Intake 1	15	114100	1336072108	/users/cn/jespinosa/phecomp/data/CRG/20120502_FDF_CRG/20120502_FDF_CRG/20120502_FDF_CRG_c12.mtb	90	NA	WWSS	water	1	114085	1336072093	1	0.02	0.00133333333333333	6919	1
3	Food 1	Intake 3	326	114558	1336072566	/users/cn/jespinosa/phecomp/data/CRG/20120502_FDF_CRG/20120502_FDF_CRG/20120502_FDF_CRG_c12.mtb	169	47	WWSS	food_sc	3	114232	1336072240	1	0.0800000000000001	0.000245398773006135	6920	1
3	Food 1	Intake 3	88	114693	1336072701	/users/cn/jespinosa/phecomp/data/CRG/20120502_FDF_CRG/20120502_FDF_CRG/20120502_FDF_CRG_c12.mtb	170	258	WWSS	food_sc	3	114605	1336072613	1	0.02	0.000227272727272727	6921	1
3	Drink 2	Intake 2	15	114705	1336072713	/users/cn/jespinosa/phecomp/data/CRG/20120502_FDF_CRG/20120502_FDF_CRG/20120502_FDF_CRG_c12.mtb	665	NA	WWSS	water	2	114690	1336072698	1	0.0600000000000001	0.00400000000000001	6922	1
3	Food 1	Intake 3	229	115180	1336073188	/users/cn/jespinosa/phecomp/data/CRG/20120502_FDF_CRG/20120502_FDF_CRG/20120502_FDF_CRG_c12.mtb	172	2500	WWSS	food_sc	3	114951	1336072959	1	0.04	0.000174672489082969	6923	1
3	Drink 2	Intake 2	18	115194	1336073202	/users/cn/jespinosa/phecomp/data/CRG/20120502_FDF_CRG/20120502_FDF_CRG/20120502_FDF_CRG_c12.mtb	667	NA	WWSS	water	2	115176	1336073184	1	0.0600000000000001	0.00333333333333334	6924	1
3	Drink 2	Intake 2	14	115521	1336073529	/users/cn/jespinosa/phecomp/data/CRG/20120502_FDF_CRG/20120502_FDF_CRG/20120502_FDF_CRG_c12.mtb	668	NA	WWSS	water	2	115507	1336073515	1	0.02	0.00142857142857143	6925	1
3	Drink 1	Intake 1	16	116701	1336074709	/users/cn/jespinosa/phecomp/data/CRG/20120502_FDF_CRG/20120502_FDF_CRG/20120502_FDF_CRG_c12.mtb	92	NA	WWSS	water	1	116685	1336074693	1	0.02	0.00125	6926	1
3	Food 1	Intake 3	520	118200	1336076208	/users/cn/jespinosa/phecomp/data/CRG/20120502_FDF_CRG/20120502_FDF_CRG/20120502_FDF_CRG_c12.mtb	175	1919	WWSS	food_sc	3	117680	1336075688	1	0.16	0.000307692307692308	6927	1
3	Drink 2	Intake 2	25	118219	1336076227	/users/cn/jespinosa/phecomp/data/CRG/20120502_FDF_CRG/20120502_FDF_CRG/20120502_FDF_CRG_c12.mtb	669	NA	WWSS	water	2	118194	1336076202	1	0.1	0.004	6928	1
3	Drink 2	Intake 2	19	118292	1336076300	/users/cn/jespinosa/phecomp/data/CRG/20120502_FDF_CRG/20120502_FDF_CRG/20120502_FDF_CRG_c12.mtb	670	NA	WWSS	water	2	118273	1336076281	1	0.04	0.00210526315789474	6929	1
3	Drink 2	Intake 2	13	118616	1336076624	/users/cn/jespinosa/phecomp/data/CRG/20120502_FDF_CRG/20120502_FDF_CRG/20120502_FDF_CRG_c12.mtb	671	NA	WWSS	water	2	118603	1336076611	1	0.0600000000000001	0.00461538461538462	6930	1
3	Drink 2	Intake 2	25	119189	1336077197	/users/cn/jespinosa/phecomp/data/CRG/20120502_FDF_CRG/20120502_FDF_CRG/20120502_FDF_CRG_c12.mtb	674	NA	WWSS	water	2	119164	1336077172	1	0.1	0.004	6931	1
3	Food 1	Intake 3	413	120532	1336078540	/users/cn/jespinosa/phecomp/data/CRG/20120502_FDF_CRG/20120502_FDF_CRG/20120502_FDF_CRG_c12.mtb	183	1170	WWSS	food_sc	3	120119	1336078127	1	0.16	0.000387409200968523	6932	1
3	Drink 2	Intake 2	33	120570	1336078578	/users/cn/jespinosa/phecomp/data/CRG/20120502_FDF_CRG/20120502_FDF_CRG/20120502_FDF_CRG_c12.mtb	677	NA	WWSS	water	2	120537	1336078545	1	0.0599999999999996	0.00181818181818181	6933	1
3	Drink 2	Intake 2	23	120653	1336078661	/users/cn/jespinosa/phecomp/data/CRG/20120502_FDF_CRG/20120502_FDF_CRG/20120502_FDF_CRG_c12.mtb	678	NA	WWSS	water	2	120630	1336078638	1	0.0600000000000001	0.00260869565217392	6934	1
3	Drink 1	Intake 1	32	120779	1336078787	/users/cn/jespinosa/phecomp/data/CRG/20120502_FDF_CRG/20120502_FDF_CRG/20120502_FDF_CRG_c12.mtb	97	NA	WWSS	water	1	120747	1336078755	1	0.02	0.000625	6935	1
3	Food 1	Intake 3	196	121898	1336079906	/users/cn/jespinosa/phecomp/data/CRG/20120502_FDF_CRG/20120502_FDF_CRG/20120502_FDF_CRG_c12.mtb	187	676	WWSS	food_sc	3	121702	1336079710	1	0.04	0.000204081632653061	6936	1
3	Drink 2	Intake 2	28	122153	1336080161	/users/cn/jespinosa/phecomp/data/CRG/20120502_FDF_CRG/20120502_FDF_CRG/20120502_FDF_CRG_c12.mtb	683	NA	WWSS	water	2	122125	1336080133	1	0.1	0.00357142857142857	6937	1
3	Food 2	Intake 4	116	122690	1336080698	/users/cn/jespinosa/phecomp/data/CRG/20120502_FDF_CRG/20120502_FDF_CRG/20120502_FDF_CRG_c12.mtb	447	14	WWSS	food_sc	4	122574	1336080582	1	0.02	0.000172413793103448	6938	1
3	Food 2	Intake 4	118	122822	1336080830	/users/cn/jespinosa/phecomp/data/CRG/20120502_FDF_CRG/20120502_FDF_CRG/20120502_FDF_CRG_c12.mtb	448	19	WWSS	food_sc	4	122704	1336080712	1	0.04	0.000338983050847458	6939	1
3	Food 1	Intake 3	264	123105	1336081113	/users/cn/jespinosa/phecomp/data/CRG/20120502_FDF_CRG/20120502_FDF_CRG/20120502_FDF_CRG_c12.mtb	190	3716	WWSS	food_sc	3	122841	1336080849	1	0.02	7.57575757575758e-05	6940	1
3	Drink 2	Intake 2	18	123159	1336081167	/users/cn/jespinosa/phecomp/data/CRG/20120502_FDF_CRG/20120502_FDF_CRG/20120502_FDF_CRG_c12.mtb	684	NA	WWSS	water	2	123141	1336081149	1	0.04	0.00222222222222222	6941	1
3	Drink 1	Intake 1	9	123915	1336081923	/users/cn/jespinosa/phecomp/data/CRG/20120502_FDF_CRG/20120502_FDF_CRG/20120502_FDF_CRG_c12.mtb	99	NA	WWSS	water	1	123906	1336081914	1	0.02	0.00222222222222222	6942	1
3	Drink 2	Intake 2	20	124199	1336082207	/users/cn/jespinosa/phecomp/data/CRG/20120502_FDF_CRG/20120502_FDF_CRG/20120502_FDF_CRG_c12.mtb	687	NA	WWSS	water	2	124179	1336082187	1	0.02	0.001	6943	1
3	Food 1	Intake 3	388	127209	1336085217	/users/cn/jespinosa/phecomp/data/CRG/20120502_FDF_CRG/20120502_FDF_CRG/20120502_FDF_CRG_c12.mtb	191	184	WWSS	food_sc	3	126821	1336084829	1	0.04	0.000103092783505155	6944	1
3	Food 1	Intake 3	296	127689	1336085697	/users/cn/jespinosa/phecomp/data/CRG/20120502_FDF_CRG/20120502_FDF_CRG/20120502_FDF_CRG_c12.mtb	192	193	WWSS	food_sc	3	127393	1336085401	1	0.1	0.000337837837837838	6945	1
3	Drink 2	Intake 2	39	127724	1336085732	/users/cn/jespinosa/phecomp/data/CRG/20120502_FDF_CRG/20120502_FDF_CRG/20120502_FDF_CRG_c12.mtb	688	NA	WWSS	water	2	127685	1336085693	1	0.1	0.00256410256410256	6946	1
3	Drink 2	Intake 2	10	127880	1336085888	/users/cn/jespinosa/phecomp/data/CRG/20120502_FDF_CRG/20120502_FDF_CRG/20120502_FDF_CRG_c12.mtb	689	NA	WWSS	water	2	127870	1336085878	1	0.04	0.004	6947	1
3	Food 2	Intake 4	171	128053	1336086061	/users/cn/jespinosa/phecomp/data/CRG/20120502_FDF_CRG/20120502_FDF_CRG/20120502_FDF_CRG_c12.mtb	455	175	WWSS	food_sc	4	127882	1336085890	1	0.0600000000000001	0.000350877192982457	6948	1
3	Drink 2	Intake 2	25	128196	1336086204	/users/cn/jespinosa/phecomp/data/CRG/20120502_FDF_CRG/20120502_FDF_CRG/20120502_FDF_CRG_c12.mtb	690	NA	WWSS	water	2	128171	1336086179	1	0.04	0.0016	6949	1
3	Food 1	Intake 3	105	128333	1336086341	/users/cn/jespinosa/phecomp/data/CRG/20120502_FDF_CRG/20120502_FDF_CRG/20120502_FDF_CRG_c12.mtb	194	114	WWSS	food_sc	3	128228	1336086236	1	0.02	0.00019047619047619	6950	1
3	Food 2	Intake 4	232	128679	1336086687	/users/cn/jespinosa/phecomp/data/CRG/20120502_FDF_CRG/20120502_FDF_CRG/20120502_FDF_CRG_c12.mtb	457	496	WWSS	food_sc	4	128447	1336086455	1	0.0800000000000001	0.000344827586206897	6951	1
3	Drink 2	Intake 2	32	128708	1336086716	/users/cn/jespinosa/phecomp/data/CRG/20120502_FDF_CRG/20120502_FDF_CRG/20120502_FDF_CRG_c12.mtb	691	NA	WWSS	water	2	128676	1336086684	1	0.0800000000000001	0.0025	6952	1
3	Food 1	Intake 3	143	129318	1336087326	/users/cn/jespinosa/phecomp/data/CRG/20120502_FDF_CRG/20120502_FDF_CRG/20120502_FDF_CRG_c12.mtb	195	1375	WWSS	food_sc	3	129175	1336087183	1	0.0600000000000001	0.00041958041958042	6953	1
3	Drink 2	Intake 2	18	129343	1336087351	/users/cn/jespinosa/phecomp/data/CRG/20120502_FDF_CRG/20120502_FDF_CRG/20120502_FDF_CRG_c12.mtb	693	NA	WWSS	water	2	129325	1336087333	1	0.0200000000000005	0.00111111111111114	6954	1
3	Drink 1	Intake 1	24	129504	1336087512	/users/cn/jespinosa/phecomp/data/CRG/20120502_FDF_CRG/20120502_FDF_CRG/20120502_FDF_CRG_c12.mtb	101	NA	WWSS	water	1	129480	1336087488	1	0.04	0.00166666666666667	6955	1
3	Drink 2	Intake 2	19	129818	1336087826	/users/cn/jespinosa/phecomp/data/CRG/20120502_FDF_CRG/20120502_FDF_CRG/20120502_FDF_CRG_c12.mtb	695	NA	WWSS	water	2	129799	1336087807	1	0.0200000000000005	0.00105263157894739	6956	1
3	Food 2	Intake 4	160	130853	1336088861	/users/cn/jespinosa/phecomp/data/CRG/20120502_FDF_CRG/20120502_FDF_CRG/20120502_FDF_CRG_c12.mtb	462	6	WWSS	food_sc	4	130693	1336088701	1	0.0399999999999998	0.000249999999999999	6957	1
3	Food 2	Intake 4	285	131144	1336089152	/users/cn/jespinosa/phecomp/data/CRG/20120502_FDF_CRG/20120502_FDF_CRG/20120502_FDF_CRG_c12.mtb	463	93	WWSS	food_sc	4	130859	1336088867	1	0.0999999999999999	0.000350877192982456	6958	1
3	Drink 2	Intake 2	29	131185	1336089193	/users/cn/jespinosa/phecomp/data/CRG/20120502_FDF_CRG/20120502_FDF_CRG/20120502_FDF_CRG_c12.mtb	699	NA	WWSS	water	2	131156	1336089164	1	0.04	0.00137931034482759	6959	1
3	Food 2	Intake 4	102	131339	1336089347	/users/cn/jespinosa/phecomp/data/CRG/20120502_FDF_CRG/20120502_FDF_CRG/20120502_FDF_CRG_c12.mtb	464	7031	WWSS	food_sc	4	131237	1336089245	1	0.02	0.000196078431372549	6960	1
3	Drink 2	Intake 2	16	131919	1336089927	/users/cn/jespinosa/phecomp/data/CRG/20120502_FDF_CRG/20120502_FDF_CRG/20120502_FDF_CRG_c12.mtb	701	NA	WWSS	water	2	131903	1336089911	1	0.04	0.0025	6961	1
3	Drink 2	Intake 2	29	132212	1336090220	/users/cn/jespinosa/phecomp/data/CRG/20120502_FDF_CRG/20120502_FDF_CRG/20120502_FDF_CRG_c12.mtb	702	NA	WWSS	water	2	132183	1336090191	1	0.04	0.00137931034482759	6962	1
3	Drink 1	Intake 1	16	132757	1336090765	/users/cn/jespinosa/phecomp/data/CRG/20120502_FDF_CRG/20120502_FDF_CRG/20120502_FDF_CRG_c12.mtb	104	NA	WWSS	water	1	132741	1336090749	1	0.02	0.00125	6963	1
3	Food 1	Intake 3	166	138536	1336096544	/users/cn/jespinosa/phecomp/data/CRG/20120502_FDF_CRG/20120502_FDF_CRG/20120502_FDF_CRG_c12.mtb	198	20	WWSS	food_sc	3	138370	1336096378	1	0.0600000000000001	0.000361445783132531	6964	1
3	Food 1	Intake 3	23	138579	1336096587	/users/cn/jespinosa/phecomp/data/CRG/20120502_FDF_CRG/20120502_FDF_CRG/20120502_FDF_CRG_c12.mtb	199	5	WWSS	food_sc	3	138556	1336096564	1	0.02	0.000869565217391304	6965	1
3	Food 1	Intake 3	145	138729	1336096737	/users/cn/jespinosa/phecomp/data/CRG/20120502_FDF_CRG/20120502_FDF_CRG/20120502_FDF_CRG_c12.mtb	200	217	WWSS	food_sc	3	138584	1336096592	1	0.0399999999999996	0.000275862068965514	6966	1
3	Drink 1	Intake 1	32	138938	1336096946	/users/cn/jespinosa/phecomp/data/CRG/20120502_FDF_CRG/20120502_FDF_CRG/20120502_FDF_CRG_c12.mtb	106	NA	WWSS	water	1	138906	1336096914	1	0.0599999999999999	0.001875	6967	1
3	Food 1	Intake 3	55	139001	1336097009	/users/cn/jespinosa/phecomp/data/CRG/20120502_FDF_CRG/20120502_FDF_CRG/20120502_FDF_CRG_c12.mtb	202	14	WWSS	food_sc	3	138946	1336096954	1	0.04	0.000727272727272727	6968	1
3	Food 1	Intake 3	105	139120	1336097128	/users/cn/jespinosa/phecomp/data/CRG/20120502_FDF_CRG/20120502_FDF_CRG/20120502_FDF_CRG_c12.mtb	203	21	WWSS	food_sc	3	139015	1336097023	1	0.0600000000000001	0.000571428571428572	6969	1
3	Food 1	Intake 3	53	139194	1336097202	/users/cn/jespinosa/phecomp/data/CRG/20120502_FDF_CRG/20120502_FDF_CRG/20120502_FDF_CRG_c12.mtb	204	117	WWSS	food_sc	3	139141	1336097149	1	0.02	0.000377358490566038	6970	1
3	Drink 2	Intake 2	32	139232	1336097240	/users/cn/jespinosa/phecomp/data/CRG/20120502_FDF_CRG/20120502_FDF_CRG/20120502_FDF_CRG_c12.mtb	704	NA	WWSS	water	2	139200	1336097208	1	0.0800000000000001	0.0025	6971	1
3	Drink 2	Intake 2	16	139266	1336097274	/users/cn/jespinosa/phecomp/data/CRG/20120502_FDF_CRG/20120502_FDF_CRG/20120502_FDF_CRG_c12.mtb	705	NA	WWSS	water	2	139250	1336097258	1	0.0200000000000005	0.00125000000000003	6972	1
3	Food 1	Intake 3	134	139445	1336097453	/users/cn/jespinosa/phecomp/data/CRG/20120502_FDF_CRG/20120502_FDF_CRG/20120502_FDF_CRG_c12.mtb	205	9234	WWSS	food_sc	3	139311	1336097319	1	0.02	0.000149253731343284	6973	1
3	Drink 2	Intake 2	21	139466	1336097474	/users/cn/jespinosa/phecomp/data/CRG/20120502_FDF_CRG/20120502_FDF_CRG/20120502_FDF_CRG_c12.mtb	706	NA	WWSS	water	2	139445	1336097453	1	0.0799999999999992	0.00380952380952377	6974	1
3	Drink 2	Intake 2	20	139719	1336097727	/users/cn/jespinosa/phecomp/data/CRG/20120502_FDF_CRG/20120502_FDF_CRG/20120502_FDF_CRG_c12.mtb	707	NA	WWSS	water	2	139699	1336097707	1	0.04	0.002	6975	1
3	Drink 2	Intake 2	19	140068	1336098076	/users/cn/jespinosa/phecomp/data/CRG/20120502_FDF_CRG/20120502_FDF_CRG/20120502_FDF_CRG_c12.mtb	709	NA	WWSS	water	2	140049	1336098057	1	0.04	0.00210526315789474	6976	1
3	Drink 2	Intake 2	38	140707	1336098715	/users/cn/jespinosa/phecomp/data/CRG/20120502_FDF_CRG/20120502_FDF_CRG/20120502_FDF_CRG_c12.mtb	710	NA	WWSS	water	2	140669	1336098677	1	0.0600000000000005	0.00157894736842107	6977	1
3	Food 1	Intake 3	28	148707	1336106715	/users/cn/jespinosa/phecomp/data/CRG/20120502_FDF_CRG/20120502_FDF_CRG/20120502_FDF_CRG_c12.mtb	212	8	WWSS	food_sc	3	148679	1336106687	1	0.02	0.000714285714285714	6978	1
3	Food 1	Intake 3	124	148839	1336106847	/users/cn/jespinosa/phecomp/data/CRG/20120502_FDF_CRG/20120502_FDF_CRG/20120502_FDF_CRG_c12.mtb	213	23	WWSS	food_sc	3	148715	1336106723	1	0.02	0.000161290322580645	6979	1
3	Food 2	Intake 4	124	148986	1336106994	/users/cn/jespinosa/phecomp/data/CRG/20120502_FDF_CRG/20120502_FDF_CRG/20120502_FDF_CRG_c12.mtb	474	23	WWSS	food_sc	4	148862	1336106870	1	0.02	0.000161290322580645	6980	1
3	Food 1	Intake 3	100	149109	1336107117	/users/cn/jespinosa/phecomp/data/CRG/20120502_FDF_CRG/20120502_FDF_CRG/20120502_FDF_CRG_c12.mtb	214	438	WWSS	food_sc	3	149009	1336107017	1	0.02	0.0002	6981	1
3	Drink 2	Intake 2	28	149202	1336107210	/users/cn/jespinosa/phecomp/data/CRG/20120502_FDF_CRG/20120502_FDF_CRG/20120502_FDF_CRG_c12.mtb	711	NA	WWSS	water	2	149174	1336107182	1	0.0599999999999996	0.00214285714285713	6982	1
3	Drink 2	Intake 2	49	149273	1336107281	/users/cn/jespinosa/phecomp/data/CRG/20120502_FDF_CRG/20120502_FDF_CRG/20120502_FDF_CRG_c12.mtb	712	NA	WWSS	water	2	149224	1336107232	1	0.0200000000000005	0.000408163265306133	6983	1
3	Food 1	Intake 3	137	149684	1336107692	/users/cn/jespinosa/phecomp/data/CRG/20120502_FDF_CRG/20120502_FDF_CRG/20120502_FDF_CRG_c12.mtb	218	174	WWSS	food_sc	3	149547	1336107555	1	0.02	0.000145985401459854	6984	1
3	Drink 2	Intake 2	17	149698	1336107706	/users/cn/jespinosa/phecomp/data/CRG/20120502_FDF_CRG/20120502_FDF_CRG/20120502_FDF_CRG_c12.mtb	714	NA	WWSS	water	2	149681	1336107689	1	0.04	0.00235294117647059	6985	1
3	Food 2	Intake 4	84	149942	1336107950	/users/cn/jespinosa/phecomp/data/CRG/20120502_FDF_CRG/20120502_FDF_CRG/20120502_FDF_CRG_c12.mtb	479	390	WWSS	food_sc	4	149858	1336107866	1	0.02	0.000238095238095238	6986	1
3	Drink 2	Intake 2	25	150001	1336108009	/users/cn/jespinosa/phecomp/data/CRG/20120502_FDF_CRG/20120502_FDF_CRG/20120502_FDF_CRG_c12.mtb	715	NA	WWSS	water	2	149976	1336107984	1	0.0800000000000001	0.0032	6987	1
3	Food 1	Intake 3	282	150614	1336108622	/users/cn/jespinosa/phecomp/data/CRG/20120502_FDF_CRG/20120502_FDF_CRG/20120502_FDF_CRG_c12.mtb	220	13	WWSS	food_sc	3	150332	1336108340	1	0.0600000000000001	0.000212765957446809	6988	1
3	Food 1	Intake 3	73	150700	1336108708	/users/cn/jespinosa/phecomp/data/CRG/20120502_FDF_CRG/20120502_FDF_CRG/20120502_FDF_CRG_c12.mtb	221	147	WWSS	food_sc	3	150627	1336108635	1	0.02	0.000273972602739726	6989	1
3	Drink 2	Intake 2	23	150736	1336108744	/users/cn/jespinosa/phecomp/data/CRG/20120502_FDF_CRG/20120502_FDF_CRG/20120502_FDF_CRG_c12.mtb	717	NA	WWSS	water	2	150713	1336108721	1	0.0599999999999996	0.0026086956521739	6990	1
3	Food 2	Intake 4	312	151159	1336109167	/users/cn/jespinosa/phecomp/data/CRG/20120502_FDF_CRG/20120502_FDF_CRG/20120502_FDF_CRG_c12.mtb	482	366	WWSS	food_sc	4	150847	1336108855	1	0.04	0.000128205128205128	6991	1
3	Drink 2	Intake 2	35	151220	1336109228	/users/cn/jespinosa/phecomp/data/CRG/20120502_FDF_CRG/20120502_FDF_CRG/20120502_FDF_CRG_c12.mtb	718	NA	WWSS	water	2	151185	1336109193	1	0.0999999999999996	0.00285714285714285	6992	1
3	Drink 2	Intake 2	25	151329	1336109337	/users/cn/jespinosa/phecomp/data/CRG/20120502_FDF_CRG/20120502_FDF_CRG/20120502_FDF_CRG_c12.mtb	719	NA	WWSS	water	2	151304	1336109312	1	0.0800000000000001	0.0032	6993	1
3	Food 2	Intake 4	165	151690	1336109698	/users/cn/jespinosa/phecomp/data/CRG/20120502_FDF_CRG/20120502_FDF_CRG/20120502_FDF_CRG_c12.mtb	486	471	WWSS	food_sc	4	151525	1336109533	1	0.02	0.000121212121212121	6994	1
3	Food 1	Intake 3	653	152814	1336110822	/users/cn/jespinosa/phecomp/data/CRG/20120502_FDF_CRG/20120502_FDF_CRG/20120502_FDF_CRG_c12.mtb	228	618	WWSS	food_sc	3	152161	1336110169	1	0.28	0.000428790199081164	6995	1
3	Drink 2	Intake 2	24	152861	1336110869	/users/cn/jespinosa/phecomp/data/CRG/20120502_FDF_CRG/20120502_FDF_CRG/20120502_FDF_CRG_c12.mtb	720	NA	WWSS	water	2	152837	1336110845	1	0.04	0.00166666666666667	6996	1
3	Drink 1	Intake 1	20	152933	1336110941	/users/cn/jespinosa/phecomp/data/CRG/20120502_FDF_CRG/20120502_FDF_CRG/20120502_FDF_CRG_c12.mtb	109	NA	WWSS	water	1	152913	1336110921	1	0.0600000000000001	0.00300000000000001	6997	1
3	Drink 2	Intake 2	23	153375	1336111383	/users/cn/jespinosa/phecomp/data/CRG/20120502_FDF_CRG/20120502_FDF_CRG/20120502_FDF_CRG_c12.mtb	724	NA	WWSS	water	2	153352	1336111360	1	0.04	0.00173913043478261	6998	1
3	Food 1	Intake 3	192	153624	1336111632	/users/cn/jespinosa/phecomp/data/CRG/20120502_FDF_CRG/20120502_FDF_CRG/20120502_FDF_CRG_c12.mtb	229	96	WWSS	food_sc	3	153432	1336111440	1	0.0800000000000001	0.000416666666666667	6999	1
3	Food 2	Intake 4	86	153806	1336111814	/users/cn/jespinosa/phecomp/data/CRG/20120502_FDF_CRG/20120502_FDF_CRG/20120502_FDF_CRG_c12.mtb	492	5950	WWSS	food_sc	4	153720	1336111728	1	0.02	0.000232558139534884	7000	1
3	Drink 2	Intake 2	43	153844	1336111852	/users/cn/jespinosa/phecomp/data/CRG/20120502_FDF_CRG/20120502_FDF_CRG/20120502_FDF_CRG_c12.mtb	725	NA	WWSS	water	2	153801	1336111809	1	0.0800000000000001	0.00186046511627907	7001	1
3	Drink 2	Intake 2	24	153927	1336111935	/users/cn/jespinosa/phecomp/data/CRG/20120502_FDF_CRG/20120502_FDF_CRG/20120502_FDF_CRG_c12.mtb	726	NA	WWSS	water	2	153903	1336111911	1	0.0600000000000005	0.00250000000000002	7002	1
3	Drink 2	Intake 2	23	154976	1336112984	/users/cn/jespinosa/phecomp/data/CRG/20120502_FDF_CRG/20120502_FDF_CRG/20120502_FDF_CRG_c12.mtb	736	NA	WWSS	water	2	154953	1336112961	1	0.0200000000000005	0.000869565217391326	7003	1
3	Drink 2	Intake 2	21	159595	1336117603	/users/cn/jespinosa/phecomp/data/CRG/20120502_FDF_CRG/20120502_FDF_CRG/20120502_FDF_CRG_c12.mtb	744	NA	WWSS	water	2	159574	1336117582	1	0.04	0.0019047619047619	7004	1
3	Food 1	Intake 3	191	159947	1336117955	/users/cn/jespinosa/phecomp/data/CRG/20120502_FDF_CRG/20120502_FDF_CRG/20120502_FDF_CRG_c12.mtb	233	11	WWSS	food_sc	3	159756	1336117764	1	0.0600000000000001	0.000314136125654451	7005	1
3	Food 1	Intake 3	115	160073	1336118081	/users/cn/jespinosa/phecomp/data/CRG/20120502_FDF_CRG/20120502_FDF_CRG/20120502_FDF_CRG_c12.mtb	234	32658	WWSS	food_sc	3	159958	1336117966	1	0.02	0.000173913043478261	7006	1
3	Food 1	Intake 3	24	28577	1336150763	/users/cn/jespinosa/phecomp/data/CRG/20120502_FDF_CRG/20120502_FDF_CRG/20120504_FDF_CRG_c12.mtb	579	656	WWSS	food_sc	3	28553	1336150739	1	0.02	0.000833333333333333	7007	1
3	Food 1	Intake 3	338	29571	1336151757	/users/cn/jespinosa/phecomp/data/CRG/20120502_FDF_CRG/20120502_FDF_CRG/20120504_FDF_CRG_c12.mtb	581	2443	WWSS	food_sc	3	29233	1336151419	1	0.04	0.000118343195266272	7008	1
3	Drink 2	Intake 2	33	29616	1336151802	/users/cn/jespinosa/phecomp/data/CRG/20120502_FDF_CRG/20120502_FDF_CRG/20120504_FDF_CRG_c12.mtb	1093	NA	WWSS	water	2	29583	1336151769	1	0.02	0.000606060606060606	7009	1
3	Food 1	Intake 3	172	32186	1336154372	/users/cn/jespinosa/phecomp/data/CRG/20120502_FDF_CRG/20120502_FDF_CRG/20120504_FDF_CRG_c12.mtb	582	390	WWSS	food_sc	3	32014	1336154200	1	0.02	0.000116279069767442	7010	1
3	Food 1	Intake 3	101	32677	1336154863	/users/cn/jespinosa/phecomp/data/CRG/20120502_FDF_CRG/20120502_FDF_CRG/20120504_FDF_CRG_c12.mtb	583	252	WWSS	food_sc	3	32576	1336154762	1	0.02	0.000198019801980198	7011	1
3	Food 2	Intake 4	1004	33933	1336156119	/users/cn/jespinosa/phecomp/data/CRG/20120502_FDF_CRG/20120502_FDF_CRG/20120504_FDF_CRG_c12.mtb	845	440	WWSS	food_sc	4	32929	1336155115	1	0.22	0.000219123505976096	7012	1
3	Drink 2	Intake 2	30	33960	1336156146	/users/cn/jespinosa/phecomp/data/CRG/20120502_FDF_CRG/20120502_FDF_CRG/20120504_FDF_CRG_c12.mtb	1095	NA	WWSS	water	2	33930	1336156116	1	0.16	0.00533333333333333	7013	1
3	Food 2	Intake 4	263	34636	1336156822	/users/cn/jespinosa/phecomp/data/CRG/20120502_FDF_CRG/20120502_FDF_CRG/20120504_FDF_CRG_c12.mtb	847	2220	WWSS	food_sc	4	34373	1336156559	1	0.06	0.000228136882129278	7014	1
3	Drink 2	Intake 2	22	34658	1336156844	/users/cn/jespinosa/phecomp/data/CRG/20120502_FDF_CRG/20120502_FDF_CRG/20120504_FDF_CRG_c12.mtb	1096	NA	WWSS	water	2	34636	1336156822	1	0.08	0.00363636363636364	7015	1
3	Drink 2	Intake 2	17	34840	1336157026	/users/cn/jespinosa/phecomp/data/CRG/20120502_FDF_CRG/20120502_FDF_CRG/20120504_FDF_CRG_c12.mtb	1097	NA	WWSS	water	2	34823	1336157009	1	0.02	0.00117647058823529	7016	1
3	Food 2	Intake 4	112	36968	1336159154	/users/cn/jespinosa/phecomp/data/CRG/20120502_FDF_CRG/20120502_FDF_CRG/20120504_FDF_CRG_c12.mtb	850	59	WWSS	food_sc	4	36856	1336159042	1	0.02	0.000178571428571429	7017	1
3	Food 2	Intake 4	806	37833	1336160019	/users/cn/jespinosa/phecomp/data/CRG/20120502_FDF_CRG/20120502_FDF_CRG/20120504_FDF_CRG_c12.mtb	851	505	WWSS	food_sc	4	37027	1336159213	1	0.2	0.000248138957816377	7018	1
3	Drink 2	Intake 2	33	37857	1336160043	/users/cn/jespinosa/phecomp/data/CRG/20120502_FDF_CRG/20120502_FDF_CRG/20120504_FDF_CRG_c12.mtb	1098	NA	WWSS	water	2	37824	1336160010	1	0.12	0.00363636363636364	7019	1
3	Drink 2	Intake 2	18	37992	1336160178	/users/cn/jespinosa/phecomp/data/CRG/20120502_FDF_CRG/20120502_FDF_CRG/20120504_FDF_CRG_c12.mtb	1100	NA	WWSS	water	2	37974	1336160160	1	0.02	0.00111111111111111	7020	1
3	Drink 2	Intake 2	27	38245	1336160431	/users/cn/jespinosa/phecomp/data/CRG/20120502_FDF_CRG/20120502_FDF_CRG/20120504_FDF_CRG_c12.mtb	1103	NA	WWSS	water	2	38218	1336160404	1	0.06	0.00222222222222222	7021	1
3	Food 2	Intake 4	458	38796	1336160982	/users/cn/jespinosa/phecomp/data/CRG/20120502_FDF_CRG/20120502_FDF_CRG/20120504_FDF_CRG_c12.mtb	856	38	WWSS	food_sc	4	38338	1336160524	1	0.14	0.000305676855895197	7022	1
3	Food 2	Intake 4	185	39019	1336161205	/users/cn/jespinosa/phecomp/data/CRG/20120502_FDF_CRG/20120502_FDF_CRG/20120504_FDF_CRG_c12.mtb	857	721	WWSS	food_sc	4	38834	1336161020	1	0.0599999999999999	0.000324324324324324	7023	1
3	Drink 2	Intake 2	31	39049	1336161235	/users/cn/jespinosa/phecomp/data/CRG/20120502_FDF_CRG/20120502_FDF_CRG/20120504_FDF_CRG_c12.mtb	1104	NA	WWSS	water	2	39018	1336161204	1	0.12	0.00387096774193548	7024	1
3	Drink 2	Intake 2	18	39123	1336161309	/users/cn/jespinosa/phecomp/data/CRG/20120502_FDF_CRG/20120502_FDF_CRG/20120504_FDF_CRG_c12.mtb	1105	NA	WWSS	water	2	39105	1336161291	1	0.02	0.00111111111111111	7025	1
3	Drink 2	Intake 2	21	39239	1336161425	/users/cn/jespinosa/phecomp/data/CRG/20120502_FDF_CRG/20120502_FDF_CRG/20120504_FDF_CRG_c12.mtb	1106	NA	WWSS	water	2	39218	1336161404	1	0.02	0.000952380952380952	7026	1
3	Drink 2	Intake 2	20	39294	1336161480	/users/cn/jespinosa/phecomp/data/CRG/20120502_FDF_CRG/20120502_FDF_CRG/20120504_FDF_CRG_c12.mtb	1107	NA	WWSS	water	2	39274	1336161460	1	0.04	0.002	7027	1
3	Food 2	Intake 4	173	39913	1336162099	/users/cn/jespinosa/phecomp/data/CRG/20120502_FDF_CRG/20120502_FDF_CRG/20120504_FDF_CRG_c12.mtb	860	2715	WWSS	food_sc	4	39740	1336161926	1	0.02	0.000115606936416185	7028	1
3	Food 2	Intake 4	124	42752	1336164938	/users/cn/jespinosa/phecomp/data/CRG/20120502_FDF_CRG/20120502_FDF_CRG/20120504_FDF_CRG_c12.mtb	861	COLL	WWSS	food_sc	4	42628	1336164814	1	0.02	0.000161290322580645	7029	1
3	Food 1	Intake 3	549	43289	1336165475	/users/cn/jespinosa/phecomp/data/CRG/20120502_FDF_CRG/20120502_FDF_CRG/20120504_FDF_CRG_c12.mtb	591	139	WWSS	food_sc	3	42740	1336164926	1	0.18	0.000327868852459016	7030	1
3	Drink 2	Intake 2	20	43303	1336165489	/users/cn/jespinosa/phecomp/data/CRG/20120502_FDF_CRG/20120502_FDF_CRG/20120504_FDF_CRG_c12.mtb	1109	NA	WWSS	water	2	43283	1336165469	1	0.0800000000000001	0.00400000000000001	7031	1
3	Food 1	Intake 3	81	43509	1336165695	/users/cn/jespinosa/phecomp/data/CRG/20120502_FDF_CRG/20120502_FDF_CRG/20120504_FDF_CRG_c12.mtb	592	903	WWSS	food_sc	3	43428	1336165614	1	0.04	0.000493827160493827	7032	1
3	Drink 2	Intake 2	22	43532	1336165718	/users/cn/jespinosa/phecomp/data/CRG/20120502_FDF_CRG/20120502_FDF_CRG/20120504_FDF_CRG_c12.mtb	1112	NA	WWSS	water	2	43510	1336165696	1	0.0599999999999999	0.00272727272727272	7033	1
3	Drink 1	Intake 1	12	43726	1336165912	/users/cn/jespinosa/phecomp/data/CRG/20120502_FDF_CRG/20120502_FDF_CRG/20120504_FDF_CRG_c12.mtb	243	NA	WWSS	water	1	43714	1336165900	1	0.02	0.00166666666666667	7034	1
3	Drink 2	Intake 2	27	43942	1336166128	/users/cn/jespinosa/phecomp/data/CRG/20120502_FDF_CRG/20120502_FDF_CRG/20120504_FDF_CRG_c12.mtb	1114	NA	WWSS	water	2	43915	1336166101	1	0.02	0.000740740740740741	7035	1
3	Drink 1	Intake 1	32	44301	1336166487	/users/cn/jespinosa/phecomp/data/CRG/20120502_FDF_CRG/20120502_FDF_CRG/20120504_FDF_CRG_c12.mtb	244	NA	WWSS	water	1	44269	1336166455	1	0.1	0.003125	7036	1
3	Drink 2	Intake 2	15	44342	1336166528	/users/cn/jespinosa/phecomp/data/CRG/20120502_FDF_CRG/20120502_FDF_CRG/20120504_FDF_CRG_c12.mtb	1116	NA	WWSS	water	2	44327	1336166513	1	0.02	0.00133333333333333	7037	1
3	Food 1	Intake 3	632	45044	1336167230	/users/cn/jespinosa/phecomp/data/CRG/20120502_FDF_CRG/20120502_FDF_CRG/20120504_FDF_CRG_c12.mtb	599	3389	WWSS	food_sc	3	44412	1336166598	1	0.24	0.000379746835443038	7038	1
3	Drink 2	Intake 2	24	45066	1336167252	/users/cn/jespinosa/phecomp/data/CRG/20120502_FDF_CRG/20120502_FDF_CRG/20120504_FDF_CRG_c12.mtb	1117	NA	WWSS	water	2	45042	1336167228	1	0.0599999999999999	0.0025	7039	1
3	Drink 2	Intake 2	9	45098	1336167284	/users/cn/jespinosa/phecomp/data/CRG/20120502_FDF_CRG/20120502_FDF_CRG/20120504_FDF_CRG_c12.mtb	1118	NA	WWSS	water	2	45089	1336167275	1	0.02	0.00222222222222222	7040	1
3	Drink 2	Intake 2	18	45172	1336167358	/users/cn/jespinosa/phecomp/data/CRG/20120502_FDF_CRG/20120502_FDF_CRG/20120504_FDF_CRG_c12.mtb	1119	NA	WWSS	water	2	45154	1336167340	1	0.04	0.00222222222222222	7041	1
3	Drink 2	Intake 2	16	45251	1336167437	/users/cn/jespinosa/phecomp/data/CRG/20120502_FDF_CRG/20120502_FDF_CRG/20120504_FDF_CRG_c12.mtb	1120	NA	WWSS	water	2	45235	1336167421	1	0.02	0.00125	7042	1
3	Drink 1	Intake 1	12	45722	1336167908	/users/cn/jespinosa/phecomp/data/CRG/20120502_FDF_CRG/20120502_FDF_CRG/20120504_FDF_CRG_c12.mtb	246	NA	WWSS	water	1	45710	1336167896	1	0.04	0.00333333333333333	7043	1
3	Food 1	Intake 3	453	48886	1336171072	/users/cn/jespinosa/phecomp/data/CRG/20120502_FDF_CRG/20120502_FDF_CRG/20120504_FDF_CRG_c12.mtb	603	80	WWSS	food_sc	3	48433	1336170619	1	0.1	0.00022075055187638	7044	1
3	Drink 2	Intake 2	17	48902	1336171088	/users/cn/jespinosa/phecomp/data/CRG/20120502_FDF_CRG/20120502_FDF_CRG/20120504_FDF_CRG_c12.mtb	1123	NA	WWSS	water	2	48885	1336171071	1	0.04	0.00235294117647059	7045	1
3	Drink 2	Intake 2	25	48955	1336171141	/users/cn/jespinosa/phecomp/data/CRG/20120502_FDF_CRG/20120502_FDF_CRG/20120504_FDF_CRG_c12.mtb	1124	NA	WWSS	water	2	48930	1336171116	1	0.02	0.0008	7046	1
3	Food 1	Intake 3	284	49250	1336171436	/users/cn/jespinosa/phecomp/data/CRG/20120502_FDF_CRG/20120502_FDF_CRG/20120504_FDF_CRG_c12.mtb	604	464	WWSS	food_sc	3	48966	1336171152	1	0.0399999999999999	0.000140845070422535	7047	1
3	Drink 1	Intake 1	15	49421	1336171607	/users/cn/jespinosa/phecomp/data/CRG/20120502_FDF_CRG/20120502_FDF_CRG/20120504_FDF_CRG_c12.mtb	247	NA	WWSS	water	1	49406	1336171592	1	0.02	0.00133333333333333	7048	1
3	Drink 2	Intake 2	25	49521	1336171707	/users/cn/jespinosa/phecomp/data/CRG/20120502_FDF_CRG/20120502_FDF_CRG/20120504_FDF_CRG_c12.mtb	1126	NA	WWSS	water	2	49496	1336171682	1	0.02	0.0008	7049	1
3	Drink 2	Intake 2	15	49655	1336171841	/users/cn/jespinosa/phecomp/data/CRG/20120502_FDF_CRG/20120502_FDF_CRG/20120504_FDF_CRG_c12.mtb	1127	NA	WWSS	water	2	49640	1336171826	1	0.04	0.00266666666666667	7050	1
3	Food 1	Intake 3	490	50204	1336172390	/users/cn/jespinosa/phecomp/data/CRG/20120502_FDF_CRG/20120502_FDF_CRG/20120504_FDF_CRG_c12.mtb	608	200	WWSS	food_sc	3	49714	1336171900	1	0.16	0.000326530612244898	7051	1
3	Drink 1	Intake 1	20	50229	1336172415	/users/cn/jespinosa/phecomp/data/CRG/20120502_FDF_CRG/20120502_FDF_CRG/20120504_FDF_CRG_c12.mtb	249	NA	WWSS	water	1	50209	1336172395	1	0.06	0.003	7052	1
3	Drink 2	Intake 2	33	50377	1336172563	/users/cn/jespinosa/phecomp/data/CRG/20120502_FDF_CRG/20120502_FDF_CRG/20120504_FDF_CRG_c12.mtb	1128	NA	WWSS	water	2	50344	1336172530	1	0.0999999999999999	0.00303030303030303	7053	1
3	Food 1	Intake 3	217	50621	1336172807	/users/cn/jespinosa/phecomp/data/CRG/20120502_FDF_CRG/20120502_FDF_CRG/20120504_FDF_CRG_c12.mtb	609	5445	WWSS	food_sc	3	50404	1336172590	1	0.04	0.000184331797235023	7054	1
3	Drink 2	Intake 2	18	50715	1336172901	/users/cn/jespinosa/phecomp/data/CRG/20120502_FDF_CRG/20120502_FDF_CRG/20120504_FDF_CRG_c12.mtb	1129	NA	WWSS	water	2	50697	1336172883	1	0.02	0.00111111111111111	7055	1
3	Food 1	Intake 3	233	56299	1336178485	/users/cn/jespinosa/phecomp/data/CRG/20120502_FDF_CRG/20120502_FDF_CRG/20120504_FDF_CRG_c12.mtb	612	115	WWSS	food_sc	3	56066	1336178252	1	0.02	8.58369098712446e-05	7056	1
3	Food 1	Intake 3	121	56535	1336178721	/users/cn/jespinosa/phecomp/data/CRG/20120502_FDF_CRG/20120502_FDF_CRG/20120504_FDF_CRG_c12.mtb	614	139	WWSS	food_sc	3	56414	1336178600	1	0.0399999999999999	0.000330578512396693	7057	1
3	Drink 2	Intake 2	25	56647	1336178833	/users/cn/jespinosa/phecomp/data/CRG/20120502_FDF_CRG/20120502_FDF_CRG/20120504_FDF_CRG_c12.mtb	1131	NA	WWSS	water	2	56622	1336178808	1	0.0800000000000001	0.0032	7058	1
3	Food 1	Intake 3	323	56997	1336179183	/users/cn/jespinosa/phecomp/data/CRG/20120502_FDF_CRG/20120502_FDF_CRG/20120504_FDF_CRG_c12.mtb	617	115	WWSS	food_sc	3	56674	1336178860	1	0.0600000000000001	0.000185758513931889	7059	1
3	Drink 2	Intake 2	25	57033	1336179219	/users/cn/jespinosa/phecomp/data/CRG/20120502_FDF_CRG/20120502_FDF_CRG/20120504_FDF_CRG_c12.mtb	1132	NA	WWSS	water	2	57008	1336179194	1	0.0799999999999998	0.00319999999999999	7060	1
3	Food 1	Intake 3	523	57635	1336179821	/users/cn/jespinosa/phecomp/data/CRG/20120502_FDF_CRG/20120502_FDF_CRG/20120504_FDF_CRG_c12.mtb	618	1375	WWSS	food_sc	3	57112	1336179298	1	0.16	0.000305927342256214	7061	1
3	Drink 1	Intake 1	20	57654	1336179840	/users/cn/jespinosa/phecomp/data/CRG/20120502_FDF_CRG/20120502_FDF_CRG/20120504_FDF_CRG_c12.mtb	250	NA	WWSS	water	1	57634	1336179820	1	0.1	0.005	7062	1
3	Drink 1	Intake 1	22	57681	1336179867	/users/cn/jespinosa/phecomp/data/CRG/20120502_FDF_CRG/20120502_FDF_CRG/20120504_FDF_CRG_c12.mtb	251	NA	WWSS	water	1	57659	1336179845	1	0.04	0.00181818181818182	7063	1
3	Drink 2	Intake 2	15	57709	1336179895	/users/cn/jespinosa/phecomp/data/CRG/20120502_FDF_CRG/20120502_FDF_CRG/20120504_FDF_CRG_c12.mtb	1133	NA	WWSS	water	2	57694	1336179880	1	0.02	0.00133333333333333	7064	1
3	Drink 1	Intake 1	17	58495	1336180681	/users/cn/jespinosa/phecomp/data/CRG/20120502_FDF_CRG/20120502_FDF_CRG/20120504_FDF_CRG_c12.mtb	252	NA	WWSS	water	1	58478	1336180664	1	0.02	0.00117647058823529	7065	1
3	Food 1	Intake 3	60	59070	1336181256	/users/cn/jespinosa/phecomp/data/CRG/20120502_FDF_CRG/20120502_FDF_CRG/20120504_FDF_CRG_c12.mtb	621	585	WWSS	food_sc	3	59010	1336181196	1	0.02	0.000333333333333333	7066	1
3	Food 1	Intake 3	300	59955	1336182141	/users/cn/jespinosa/phecomp/data/CRG/20120502_FDF_CRG/20120502_FDF_CRG/20120504_FDF_CRG_c12.mtb	622	152	WWSS	food_sc	3	59655	1336181841	1	0.02	6.66666666666667e-05	7067	1
3	Drink 1	Intake 1	15	59972	1336182158	/users/cn/jespinosa/phecomp/data/CRG/20120502_FDF_CRG/20120502_FDF_CRG/20120504_FDF_CRG_c12.mtb	253	NA	WWSS	water	1	59957	1336182143	1	0.02	0.00133333333333333	7068	1
3	Drink 1	Intake 1	15	60015	1336182201	/users/cn/jespinosa/phecomp/data/CRG/20120502_FDF_CRG/20120502_FDF_CRG/20120504_FDF_CRG_c12.mtb	254	NA	WWSS	water	1	60000	1336182186	1	0.02	0.00133333333333333	7069	1
3	Drink 2	Intake 2	15	60064	1336182250	/users/cn/jespinosa/phecomp/data/CRG/20120502_FDF_CRG/20120502_FDF_CRG/20120504_FDF_CRG_c12.mtb	1137	NA	WWSS	water	2	60049	1336182235	1	0.02	0.00133333333333333	7070	1
3	Food 1	Intake 3	68	60175	1336182361	/users/cn/jespinosa/phecomp/data/CRG/20120502_FDF_CRG/20120502_FDF_CRG/20120504_FDF_CRG_c12.mtb	623	40	WWSS	food_sc	3	60107	1336182293	1	0.02	0.000294117647058824	7071	1
3	Food 1	Intake 3	272	60487	1336182673	/users/cn/jespinosa/phecomp/data/CRG/20120502_FDF_CRG/20120502_FDF_CRG/20120504_FDF_CRG_c12.mtb	624	10881	WWSS	food_sc	3	60215	1336182401	1	0.0600000000000001	0.000220588235294118	7072	1
3	Drink 2	Intake 2	17	61193	1336183379	/users/cn/jespinosa/phecomp/data/CRG/20120502_FDF_CRG/20120502_FDF_CRG/20120504_FDF_CRG_c12.mtb	1138	NA	WWSS	water	2	61176	1336183362	1	0.02	0.00117647058823529	7073	1
3	Drink 1	Intake 1	15	61426	1336183612	/users/cn/jespinosa/phecomp/data/CRG/20120502_FDF_CRG/20120502_FDF_CRG/20120504_FDF_CRG_c12.mtb	255	NA	WWSS	water	1	61411	1336183597	1	0.04	0.00266666666666667	7074	1
3	Drink 2	Intake 2	28	71191	1336193377	/users/cn/jespinosa/phecomp/data/CRG/20120502_FDF_CRG/20120502_FDF_CRG/20120504_FDF_CRG_c12.mtb	1139	NA	WWSS	water	2	71163	1336193349	1	0.1	0.00357142857142857	7075	1
3	Food 1	Intake 3	57	71425	1336193611	/users/cn/jespinosa/phecomp/data/CRG/20120502_FDF_CRG/20120502_FDF_CRG/20120504_FDF_CRG_c12.mtb	631	1885	WWSS	food_sc	3	71368	1336193554	1	0.02	0.000350877192982456	7076	1
3	Drink 2	Intake 2	10	72836	1336195022	/users/cn/jespinosa/phecomp/data/CRG/20120502_FDF_CRG/20120502_FDF_CRG/20120504_FDF_CRG_c12.mtb	1153	NA	WWSS	water	2	72826	1336195012	1	0.02	0.002	7077	1
3	Drink 2	Intake 2	58	73122	1336195308	/users/cn/jespinosa/phecomp/data/CRG/20120502_FDF_CRG/20120502_FDF_CRG/20120504_FDF_CRG_c12.mtb	1154	NA	WWSS	water	2	73064	1336195250	1	0.0600000000000001	0.00103448275862069	7078	1
3	Drink 2	Intake 2	17	73177	1336195363	/users/cn/jespinosa/phecomp/data/CRG/20120502_FDF_CRG/20120502_FDF_CRG/20120504_FDF_CRG_c12.mtb	1155	NA	WWSS	water	2	73160	1336195346	1	0.02	0.00117647058823529	7079	1
3	Food 1	Intake 3	59	73369	1336195555	/users/cn/jespinosa/phecomp/data/CRG/20120502_FDF_CRG/20120502_FDF_CRG/20120504_FDF_CRG_c12.mtb	642	994	WWSS	food_sc	3	73310	1336195496	1	0.02	0.000338983050847458	7080	1
3	Drink 2	Intake 2	27	73776	1336195962	/users/cn/jespinosa/phecomp/data/CRG/20120502_FDF_CRG/20120502_FDF_CRG/20120504_FDF_CRG_c12.mtb	1157	NA	WWSS	water	2	73749	1336195935	1	0.0599999999999998	0.00222222222222221	7081	1
3	Drink 1	Intake 1	22	73832	1336196018	/users/cn/jespinosa/phecomp/data/CRG/20120502_FDF_CRG/20120502_FDF_CRG/20120504_FDF_CRG_c12.mtb	257	NA	WWSS	water	1	73810	1336195996	1	0.02	0.000909090909090909	7082	1
3	Drink 2	Intake 2	16	74361	1336196547	/users/cn/jespinosa/phecomp/data/CRG/20120502_FDF_CRG/20120502_FDF_CRG/20120504_FDF_CRG_c12.mtb	1158	NA	WWSS	water	2	74345	1336196531	1	0.02	0.00125	7083	1
3	Food 2	Intake 4	42	74405	1336196591	/users/cn/jespinosa/phecomp/data/CRG/20120502_FDF_CRG/20120502_FDF_CRG/20120504_FDF_CRG_c12.mtb	898	COLL	WWSS	food_sc	4	74363	1336196549	1	0.02	0.000476190476190476	7084	1
3	Food 1	Intake 3	159	74552	1336196738	/users/cn/jespinosa/phecomp/data/CRG/20120502_FDF_CRG/20120502_FDF_CRG/20120504_FDF_CRG_c12.mtb	647	506	WWSS	food_sc	3	74393	1336196579	1	0.02	0.000125786163522013	7085	1
3	Drink 2	Intake 2	15	74643	1336196829	/users/cn/jespinosa/phecomp/data/CRG/20120502_FDF_CRG/20120502_FDF_CRG/20120504_FDF_CRG_c12.mtb	1159	NA	WWSS	water	2	74628	1336196814	1	0.0599999999999998	0.00399999999999999	7086	1
3	Drink 2	Intake 2	15	75061	1336197247	/users/cn/jespinosa/phecomp/data/CRG/20120502_FDF_CRG/20120502_FDF_CRG/20120504_FDF_CRG_c12.mtb	1161	NA	WWSS	water	2	75046	1336197232	1	0.02	0.00133333333333333	7087	1
3	Food 1	Intake 3	82	75140	1336197326	/users/cn/jespinosa/phecomp/data/CRG/20120502_FDF_CRG/20120502_FDF_CRG/20120504_FDF_CRG_c12.mtb	651	6915	WWSS	food_sc	3	75058	1336197244	1	0.02	0.00024390243902439	7088	1
3	Drink 2	Intake 2	16	75645	1336197831	/users/cn/jespinosa/phecomp/data/CRG/20120502_FDF_CRG/20120502_FDF_CRG/20120504_FDF_CRG_c12.mtb	1163	NA	WWSS	water	2	75629	1336197815	1	0.02	0.00125	7089	1
3	Drink 2	Intake 2	16	75937	1336198123	/users/cn/jespinosa/phecomp/data/CRG/20120502_FDF_CRG/20120502_FDF_CRG/20120504_FDF_CRG_c12.mtb	1164	NA	WWSS	water	2	75921	1336198107	1	0.02	0.00125	7090	1
3	Drink 2	Intake 2	23	81548	1336203734	/users/cn/jespinosa/phecomp/data/CRG/20120502_FDF_CRG/20120502_FDF_CRG/20120504_FDF_CRG_c12.mtb	1167	NA	WWSS	water	2	81525	1336203711	1	0.02	0.000869565217391304	7091	1
3	Food 2	Intake 4	123	82178	1336204364	/users/cn/jespinosa/phecomp/data/CRG/20120502_FDF_CRG/20120502_FDF_CRG/20120504_FDF_CRG_c12.mtb	907	25	WWSS	food_sc	4	82055	1336204241	1	0.04	0.00032520325203252	7092	1
3	Food 2	Intake 4	189	82392	1336204578	/users/cn/jespinosa/phecomp/data/CRG/20120502_FDF_CRG/20120502_FDF_CRG/20120504_FDF_CRG_c12.mtb	908	10	WWSS	food_sc	4	82203	1336204389	1	0.0599999999999999	0.000317460317460317	7093	1
3	Food 2	Intake 4	472	82874	1336205060	/users/cn/jespinosa/phecomp/data/CRG/20120502_FDF_CRG/20120502_FDF_CRG/20120504_FDF_CRG_c12.mtb	909	286	WWSS	food_sc	4	82402	1336204588	1	0.12	0.000254237288135593	7094	1
3	Drink 2	Intake 2	75	82951	1336205137	/users/cn/jespinosa/phecomp/data/CRG/20120502_FDF_CRG/20120502_FDF_CRG/20120504_FDF_CRG_c12.mtb	1169	NA	WWSS	water	2	82876	1336205062	1	0.0600000000000001	0.000800000000000001	7095	1
3	Drink 2	Intake 2	43	83025	1336205211	/users/cn/jespinosa/phecomp/data/CRG/20120502_FDF_CRG/20120502_FDF_CRG/20120504_FDF_CRG_c12.mtb	1170	NA	WWSS	water	2	82982	1336205168	1	0.04	0.000930232558139535	7096	1
3	Drink 2	Intake 2	36	83157	1336205343	/users/cn/jespinosa/phecomp/data/CRG/20120502_FDF_CRG/20120502_FDF_CRG/20120504_FDF_CRG_c12.mtb	1172	NA	WWSS	water	2	83121	1336205307	1	0.02	0.000555555555555556	7097	1
3	Food 2	Intake 4	514	83674	1336205860	/users/cn/jespinosa/phecomp/data/CRG/20120502_FDF_CRG/20120502_FDF_CRG/20120504_FDF_CRG_c12.mtb	910	876	WWSS	food_sc	4	83160	1336205346	1	0.18	0.000350194552529183	7098	1
3	Drink 2	Intake 2	44	83740	1336205926	/users/cn/jespinosa/phecomp/data/CRG/20120502_FDF_CRG/20120502_FDF_CRG/20120504_FDF_CRG_c12.mtb	1173	NA	WWSS	water	2	83696	1336205882	1	0.18	0.00409090909090909	7099	1
3	Drink 2	Intake 2	13	83906	1336206092	/users/cn/jespinosa/phecomp/data/CRG/20120502_FDF_CRG/20120502_FDF_CRG/20120504_FDF_CRG_c12.mtb	1174	NA	WWSS	water	2	83893	1336206079	1	0.02	0.00153846153846154	7100	1
3	Drink 1	Intake 1	15	83948	1336206134	/users/cn/jespinosa/phecomp/data/CRG/20120502_FDF_CRG/20120502_FDF_CRG/20120504_FDF_CRG_c12.mtb	259	NA	WWSS	water	1	83933	1336206119	1	0.0600000000000001	0.00400000000000001	7101	1
3	Drink 2	Intake 2	17	84011	1336206197	/users/cn/jespinosa/phecomp/data/CRG/20120502_FDF_CRG/20120502_FDF_CRG/20120504_FDF_CRG_c12.mtb	1175	NA	WWSS	water	2	83994	1336206180	1	0.0399999999999996	0.00235294117647056	7102	1
3	Drink 2	Intake 2	18	84139	1336206325	/users/cn/jespinosa/phecomp/data/CRG/20120502_FDF_CRG/20120502_FDF_CRG/20120504_FDF_CRG_c12.mtb	1176	NA	WWSS	water	2	84121	1336206307	1	0.0200000000000005	0.00111111111111114	7103	1
3	Drink 2	Intake 2	18	84323	1336206509	/users/cn/jespinosa/phecomp/data/CRG/20120502_FDF_CRG/20120502_FDF_CRG/20120504_FDF_CRG_c12.mtb	1179	NA	WWSS	water	2	84305	1336206491	1	0.02	0.00111111111111111	7104	1
3	Food 2	Intake 4	78	84628	1336206814	/users/cn/jespinosa/phecomp/data/CRG/20120502_FDF_CRG/20120502_FDF_CRG/20120504_FDF_CRG_c12.mtb	915	8962	WWSS	food_sc	4	84550	1336206736	1	0.02	0.000256410256410256	7105	1
3	Drink 2	Intake 2	38	84856	1336207042	/users/cn/jespinosa/phecomp/data/CRG/20120502_FDF_CRG/20120502_FDF_CRG/20120504_FDF_CRG_c12.mtb	1185	NA	WWSS	water	2	84818	1336207004	1	0.0600000000000001	0.00157894736842106	7106	1
3	Drink 2	Intake 2	20	84974	1336207160	/users/cn/jespinosa/phecomp/data/CRG/20120502_FDF_CRG/20120502_FDF_CRG/20120504_FDF_CRG_c12.mtb	1187	NA	WWSS	water	2	84954	1336207140	1	0.04	0.002	7107	1
3	Food 2	Intake 4	455	94045	1336216231	/users/cn/jespinosa/phecomp/data/CRG/20120502_FDF_CRG/20120502_FDF_CRG/20120504_FDF_CRG_c12.mtb	920	31	WWSS	food_sc	4	93590	1336215776	1	0.0600000000000001	0.000131868131868132	7108	1
3	Food 2	Intake 4	142	94218	1336216404	/users/cn/jespinosa/phecomp/data/CRG/20120502_FDF_CRG/20120502_FDF_CRG/20120504_FDF_CRG_c12.mtb	921	1076	WWSS	food_sc	4	94076	1336216262	1	0.02	0.000140845070422535	7109	1
3	Drink 2	Intake 2	22	94364	1336216550	/users/cn/jespinosa/phecomp/data/CRG/20120502_FDF_CRG/20120502_FDF_CRG/20120504_FDF_CRG_c12.mtb	1191	NA	WWSS	water	2	94342	1336216528	1	0.02	0.000909090909090909	7110	1
3	Drink 2	Intake 2	16	94534	1336216720	/users/cn/jespinosa/phecomp/data/CRG/20120502_FDF_CRG/20120502_FDF_CRG/20120504_FDF_CRG_c12.mtb	1192	NA	WWSS	water	2	94518	1336216704	1	0.04	0.0025	7111	1
3	Drink 2	Intake 2	17	94723	1336216909	/users/cn/jespinosa/phecomp/data/CRG/20120502_FDF_CRG/20120502_FDF_CRG/20120504_FDF_CRG_c12.mtb	1194	NA	WWSS	water	2	94706	1336216892	1	0.02	0.00117647058823529	7112	1
3	Drink 2	Intake 2	39	95047	1336217233	/users/cn/jespinosa/phecomp/data/CRG/20120502_FDF_CRG/20120502_FDF_CRG/20120504_FDF_CRG_c12.mtb	1196	NA	WWSS	water	2	95008	1336217194	1	0.02	0.000512820512820513	7113	1
3	Food 2	Intake 4	278	95572	1336217758	/users/cn/jespinosa/phecomp/data/CRG/20120502_FDF_CRG/20120502_FDF_CRG/20120504_FDF_CRG_c12.mtb	924	21721	WWSS	food_sc	4	95294	1336217480	1	0.02	7.19424460431655e-05	7114	1
3	Food 2	Intake 4	354	117647	1336239833	/users/cn/jespinosa/phecomp/data/CRG/20120502_FDF_CRG/20120502_FDF_CRG/20120504_FDF_CRG_c12.mtb	931	19	WWSS	food_sc	4	117293	1336239479	1	0.04	0.000112994350282486	7115	1
3	Food 2	Intake 4	152	117818	1336240004	/users/cn/jespinosa/phecomp/data/CRG/20120502_FDF_CRG/20120502_FDF_CRG/20120504_FDF_CRG_c12.mtb	932	331	WWSS	food_sc	4	117666	1336239852	1	0.02	0.000131578947368421	7116	1
3	Food 2	Intake 4	483	118632	1336240818	/users/cn/jespinosa/phecomp/data/CRG/20120502_FDF_CRG/20120502_FDF_CRG/20120504_FDF_CRG_c12.mtb	934	977	WWSS	food_sc	4	118149	1336240335	1	0.0599999999999998	0.000124223602484472	7117	1
3	Drink 2	Intake 2	21	118650	1336240836	/users/cn/jespinosa/phecomp/data/CRG/20120502_FDF_CRG/20120502_FDF_CRG/20120504_FDF_CRG_c12.mtb	1198	NA	WWSS	water	2	118629	1336240815	1	0.02	0.000952380952380952	7118	1
3	Drink 2	Intake 2	18	118869	1336241055	/users/cn/jespinosa/phecomp/data/CRG/20120502_FDF_CRG/20120502_FDF_CRG/20120504_FDF_CRG_c12.mtb	1199	NA	WWSS	water	2	118851	1336241037	1	0.04	0.00222222222222222	7119	1
3	Food 1	Intake 3	411	120020	1336242206	/users/cn/jespinosa/phecomp/data/CRG/20120502_FDF_CRG/20120502_FDF_CRG/20120504_FDF_CRG_c12.mtb	665	248	WWSS	food_sc	3	119609	1336241795	1	0.02	4.8661800486618e-05	7120	1
3	Drink 1	Intake 1	15	120239	1336242425	/users/cn/jespinosa/phecomp/data/CRG/20120502_FDF_CRG/20120502_FDF_CRG/20120504_FDF_CRG_c12.mtb	261	NA	WWSS	water	1	120224	1336242410	1	0.0399999999999999	0.00266666666666666	7121	1
3	Drink 2	Intake 2	19	120253	1336242439	/users/cn/jespinosa/phecomp/data/CRG/20120502_FDF_CRG/20120502_FDF_CRG/20120504_FDF_CRG_c12.mtb	1200	NA	WWSS	water	2	120234	1336242420	1	0.04	0.00210526315789474	7122	1
3	Food 1	Intake 3	235	120503	1336242689	/users/cn/jespinosa/phecomp/data/CRG/20120502_FDF_CRG/20120502_FDF_CRG/20120504_FDF_CRG_c12.mtb	667	7	WWSS	food_sc	3	120268	1336242454	1	0.0800000000000001	0.000340425531914894	7123	1
3	Food 1	Intake 3	531	121041	1336243227	/users/cn/jespinosa/phecomp/data/CRG/20120502_FDF_CRG/20120502_FDF_CRG/20120504_FDF_CRG_c12.mtb	668	8	WWSS	food_sc	3	120510	1336242696	1	0.22	0.000414312617702448	7124	1
3	Food 1	Intake 3	160	121209	1336243395	/users/cn/jespinosa/phecomp/data/CRG/20120502_FDF_CRG/20120502_FDF_CRG/20120504_FDF_CRG_c12.mtb	669	6939	WWSS	food_sc	3	121049	1336243235	1	0.36	0.00225	7125	1
3	Drink 1	Intake 1	32	121446	1336243632	/users/cn/jespinosa/phecomp/data/CRG/20120502_FDF_CRG/20120502_FDF_CRG/20120504_FDF_CRG_c12.mtb	262	NA	WWSS	water	1	121414	1336243600	1	0.14	0.004375	7126	1
3	Drink 2	Intake 2	20	121477	1336243663	/users/cn/jespinosa/phecomp/data/CRG/20120502_FDF_CRG/20120502_FDF_CRG/20120504_FDF_CRG_c12.mtb	1201	NA	WWSS	water	2	121457	1336243643	1	0.04	0.002	7127	1
3	Drink 2	Intake 2	28	121559	1336243745	/users/cn/jespinosa/phecomp/data/CRG/20120502_FDF_CRG/20120502_FDF_CRG/20120504_FDF_CRG_c12.mtb	1202	NA	WWSS	water	2	121531	1336243717	1	0.02	0.000714285714285714	7128	1
3	Drink 2	Intake 2	10	121607	1336243793	/users/cn/jespinosa/phecomp/data/CRG/20120502_FDF_CRG/20120502_FDF_CRG/20120504_FDF_CRG_c12.mtb	1203	NA	WWSS	water	2	121597	1336243783	1	0.02	0.002	7129	1
3	Drink 2	Intake 2	21	122157	1336244343	/users/cn/jespinosa/phecomp/data/CRG/20120502_FDF_CRG/20120502_FDF_CRG/20120504_FDF_CRG_c12.mtb	1206	NA	WWSS	water	2	122136	1336244322	1	0.0600000000000005	0.00285714285714288	7130	1
3	Drink 1	Intake 1	10	122411	1336244597	/users/cn/jespinosa/phecomp/data/CRG/20120502_FDF_CRG/20120502_FDF_CRG/20120504_FDF_CRG_c12.mtb	263	NA	WWSS	water	1	122401	1336244587	1	0.02	0.002	7131	1
3	Drink 2	Intake 2	18	122581	1336244767	/users/cn/jespinosa/phecomp/data/CRG/20120502_FDF_CRG/20120502_FDF_CRG/20120504_FDF_CRG_c12.mtb	1208	NA	WWSS	water	2	122563	1336244749	1	0.02	0.00111111111111111	7132	1
3	Drink 2	Intake 2	20	123047	1336245233	/users/cn/jespinosa/phecomp/data/CRG/20120502_FDF_CRG/20120502_FDF_CRG/20120504_FDF_CRG_c12.mtb	1209	NA	WWSS	water	2	123027	1336245213	1	0.04	0.002	7133	1
3	Drink 2	Intake 2	20	123697	1336245883	/users/cn/jespinosa/phecomp/data/CRG/20120502_FDF_CRG/20120502_FDF_CRG/20120504_FDF_CRG_c12.mtb	1210	NA	WWSS	water	2	123677	1336245863	1	0.04	0.002	7134	1
3	Drink 2	Intake 2	13	127509	1336249695	/users/cn/jespinosa/phecomp/data/CRG/20120502_FDF_CRG/20120502_FDF_CRG/20120504_FDF_CRG_c12.mtb	1211	NA	WWSS	water	2	127496	1336249682	1	0.04	0.00307692307692308	7135	1
3	Food 2	Intake 4	1327	129475	1336251661	/users/cn/jespinosa/phecomp/data/CRG/20120502_FDF_CRG/20120502_FDF_CRG/20120504_FDF_CRG_c12.mtb	944	430	WWSS	food_sc	4	128148	1336250334	1	0.0600000000000001	4.52147701582518e-05	7136	1
3	Drink 2	Intake 2	35	129510	1336251696	/users/cn/jespinosa/phecomp/data/CRG/20120502_FDF_CRG/20120502_FDF_CRG/20120504_FDF_CRG_c12.mtb	1212	NA	WWSS	water	2	129475	1336251661	1	0.1	0.00285714285714286	7137	1
3	Food 2	Intake 4	635	130540	1336252726	/users/cn/jespinosa/phecomp/data/CRG/20120502_FDF_CRG/20120502_FDF_CRG/20120504_FDF_CRG_c12.mtb	946	1296	WWSS	food_sc	4	129905	1336252091	1	0.0600000000000001	9.44881889763781e-05	7138	1
3	Drink 2	Intake 2	24	130560	1336252746	/users/cn/jespinosa/phecomp/data/CRG/20120502_FDF_CRG/20120502_FDF_CRG/20120504_FDF_CRG_c12.mtb	1213	NA	WWSS	water	2	130536	1336252722	1	0.1	0.00416666666666667	7139	1
3	Drink 2	Intake 2	15	131302	1336253488	/users/cn/jespinosa/phecomp/data/CRG/20120502_FDF_CRG/20120502_FDF_CRG/20120504_FDF_CRG_c12.mtb	1214	NA	WWSS	water	2	131287	1336253473	1	0.02	0.00133333333333333	7140	1
3	Food 1	Intake 3	1288	133124	1336255310	/users/cn/jespinosa/phecomp/data/CRG/20120502_FDF_CRG/20120502_FDF_CRG/20120504_FDF_CRG_c12.mtb	685	9	WWSS	food_sc	3	131836	1336254022	1	0.02	1.5527950310559e-05	7141	1
3	Food 1	Intake 3	685	133818	1336256004	/users/cn/jespinosa/phecomp/data/CRG/20120502_FDF_CRG/20120502_FDF_CRG/20120504_FDF_CRG_c12.mtb	686	17	WWSS	food_sc	3	133133	1336255319	1	0.14	0.000204379562043796	7142	1
3	Food 1	Intake 3	161	133996	1336256182	/users/cn/jespinosa/phecomp/data/CRG/20120502_FDF_CRG/20120502_FDF_CRG/20120504_FDF_CRG_c12.mtb	687	91	WWSS	food_sc	3	133835	1336256021	1	0.04	0.000248447204968944	7143	1
3	Drink 2	Intake 2	36	134028	1336256214	/users/cn/jespinosa/phecomp/data/CRG/20120502_FDF_CRG/20120502_FDF_CRG/20120504_FDF_CRG_c12.mtb	1216	NA	WWSS	water	2	133992	1336256178	1	0.24	0.00666666666666667	7144	1
3	Drink 2	Intake 2	33	134088	1336256274	/users/cn/jespinosa/phecomp/data/CRG/20120502_FDF_CRG/20120502_FDF_CRG/20120504_FDF_CRG_c12.mtb	1217	NA	WWSS	water	2	134055	1336256241	1	0.0800000000000001	0.00242424242424243	7145	1
3	Food 1	Intake 3	427	134514	1336256700	/users/cn/jespinosa/phecomp/data/CRG/20120502_FDF_CRG/20120502_FDF_CRG/20120504_FDF_CRG_c12.mtb	688	96	WWSS	food_sc	3	134087	1336256273	1	0.0399999999999996	9.36768149882895e-05	7146	1
3	Drink 2	Intake 2	25	134535	1336256721	/users/cn/jespinosa/phecomp/data/CRG/20120502_FDF_CRG/20120502_FDF_CRG/20120504_FDF_CRG_c12.mtb	1218	NA	WWSS	water	2	134510	1336256696	1	0.0600000000000001	0.0024	7147	1
3	Food 1	Intake 3	512	135122	1336257308	/users/cn/jespinosa/phecomp/data/CRG/20120502_FDF_CRG/20120502_FDF_CRG/20120504_FDF_CRG_c12.mtb	689	19	WWSS	food_sc	3	134610	1336256796	1	0.04	7.8125e-05	7148	1
3	Drink 2	Intake 2	20	135148	1336257334	/users/cn/jespinosa/phecomp/data/CRG/20120502_FDF_CRG/20120502_FDF_CRG/20120504_FDF_CRG_c12.mtb	1219	NA	WWSS	water	2	135128	1336257314	1	0.04	0.002	7149	1
3	Food 1	Intake 3	720	135861	1336258047	/users/cn/jespinosa/phecomp/data/CRG/20120502_FDF_CRG/20120502_FDF_CRG/20120504_FDF_CRG_c12.mtb	690	223	WWSS	food_sc	3	135141	1336257327	1	0.1	0.000138888888888889	7150	1
3	Drink 2	Intake 2	28	135892	1336258078	/users/cn/jespinosa/phecomp/data/CRG/20120502_FDF_CRG/20120502_FDF_CRG/20120504_FDF_CRG_c12.mtb	1220	NA	WWSS	water	2	135864	1336258050	1	0.12	0.00428571428571429	7151	1
3	Food 1	Intake 3	571	136655	1336258841	/users/cn/jespinosa/phecomp/data/CRG/20120502_FDF_CRG/20120502_FDF_CRG/20120504_FDF_CRG_c12.mtb	691	257	WWSS	food_sc	3	136084	1336258270	1	0.0600000000000001	0.00010507880910683	7152	1
3	Drink 2	Intake 2	25	136678	1336258864	/users/cn/jespinosa/phecomp/data/CRG/20120502_FDF_CRG/20120502_FDF_CRG/20120504_FDF_CRG_c12.mtb	1223	NA	WWSS	water	2	136653	1336258839	1	0.12	0.0048	7153	1
3	Food 1	Intake 3	628	137540	1336259726	/users/cn/jespinosa/phecomp/data/CRG/20120502_FDF_CRG/20120502_FDF_CRG/20120504_FDF_CRG_c12.mtb	692	3349	WWSS	food_sc	3	136912	1336259098	1	0.0800000000000001	0.000127388535031847	7154	1
3	Drink 2	Intake 2	24	137559	1336259745	/users/cn/jespinosa/phecomp/data/CRG/20120502_FDF_CRG/20120502_FDF_CRG/20120504_FDF_CRG_c12.mtb	1224	NA	WWSS	water	2	137535	1336259721	1	0.0600000000000001	0.0025	7155	1
3	Food 1	Intake 3	733	141622	1336263808	/users/cn/jespinosa/phecomp/data/CRG/20120502_FDF_CRG/20120502_FDF_CRG/20120504_FDF_CRG_c12.mtb	695	458	WWSS	food_sc	3	140889	1336263075	1	0.14	0.000190995907230559	7156	1
3	Drink 2	Intake 2	15	141634	1336263820	/users/cn/jespinosa/phecomp/data/CRG/20120502_FDF_CRG/20120502_FDF_CRG/20120504_FDF_CRG_c12.mtb	1226	NA	WWSS	water	2	141619	1336263805	1	0.02	0.00133333333333333	7157	1
3	Drink 2	Intake 2	24	141974	1336264160	/users/cn/jespinosa/phecomp/data/CRG/20120502_FDF_CRG/20120502_FDF_CRG/20120504_FDF_CRG_c12.mtb	1227	NA	WWSS	water	2	141950	1336264136	1	0.0800000000000001	0.00333333333333334	7158	1
3	Food 1	Intake 3	485	142565	1336264751	/users/cn/jespinosa/phecomp/data/CRG/20120502_FDF_CRG/20120502_FDF_CRG/20120504_FDF_CRG_c12.mtb	698	5	WWSS	food_sc	3	142080	1336264266	1	0.16	0.000329896907216495	7159	1
3	Food 1	Intake 3	182	142752	1336264938	/users/cn/jespinosa/phecomp/data/CRG/20120502_FDF_CRG/20120502_FDF_CRG/20120504_FDF_CRG_c12.mtb	699	58	WWSS	food_sc	3	142570	1336264756	1	0.1	0.000549450549450549	7160	1
3	Food 1	Intake 3	259	143069	1336265255	/users/cn/jespinosa/phecomp/data/CRG/20120502_FDF_CRG/20120502_FDF_CRG/20120504_FDF_CRG_c12.mtb	700	166	WWSS	food_sc	3	142810	1336264996	1	0.0800000000000001	0.000308880308880309	7161	1
3	Drink 2	Intake 2	35	143101	1336265287	/users/cn/jespinosa/phecomp/data/CRG/20120502_FDF_CRG/20120502_FDF_CRG/20120504_FDF_CRG_c12.mtb	1228	NA	WWSS	water	2	143066	1336265252	1	0.24	0.00685714285714286	7162	1
3	Drink 2	Intake 2	17	143133	1336265319	/users/cn/jespinosa/phecomp/data/CRG/20120502_FDF_CRG/20120502_FDF_CRG/20120504_FDF_CRG_c12.mtb	1229	NA	WWSS	water	2	143116	1336265302	1	0.0599999999999996	0.00352941176470586	7163	1
3	Food 1	Intake 3	515	143750	1336265936	/users/cn/jespinosa/phecomp/data/CRG/20120502_FDF_CRG/20120502_FDF_CRG/20120504_FDF_CRG_c12.mtb	702	955	WWSS	food_sc	3	143235	1336265421	1	0.24	0.000466019417475728	7164	1
3	Drink 2	Intake 2	30	143782	1336265968	/users/cn/jespinosa/phecomp/data/CRG/20120502_FDF_CRG/20120502_FDF_CRG/20120504_FDF_CRG_c12.mtb	1230	NA	WWSS	water	2	143752	1336265938	1	0.140000000000001	0.0046666666666667	7165	1
3	Drink 2	Intake 2	32	144388	1336266574	/users/cn/jespinosa/phecomp/data/CRG/20120502_FDF_CRG/20120502_FDF_CRG/20120504_FDF_CRG_c12.mtb	1233	NA	WWSS	water	2	144356	1336266542	1	0.04	0.00125	7166	1
3	Food 1	Intake 3	157	144862	1336267048	/users/cn/jespinosa/phecomp/data/CRG/20120502_FDF_CRG/20120502_FDF_CRG/20120504_FDF_CRG_c12.mtb	704	11916	WWSS	food_sc	3	144705	1336266891	1	0.02	0.000127388535031847	7167	1
3	Drink 2	Intake 2	14	145611	1336267797	/users/cn/jespinosa/phecomp/data/CRG/20120502_FDF_CRG/20120502_FDF_CRG/20120504_FDF_CRG_c12.mtb	1241	NA	WWSS	water	2	145597	1336267783	1	0.0400000000000009	0.00285714285714292	7168	1
3	Food 1	Intake 3	1006	157784	1336279970	/users/cn/jespinosa/phecomp/data/CRG/20120502_FDF_CRG/20120502_FDF_CRG/20120504_FDF_CRG_c12.mtb	713	522	WWSS	food_sc	3	156778	1336278964	1	0.12	0.000119284294234592	7169	1
3	Drink 2	Intake 2	28	157809	1336279995	/users/cn/jespinosa/phecomp/data/CRG/20120502_FDF_CRG/20120502_FDF_CRG/20120504_FDF_CRG_c12.mtb	1255	NA	WWSS	water	2	157781	1336279967	1	0.0999999999999996	0.00357142857142856	7170	1
3	Drink 1	Intake 1	23	158195	1336280381	/users/cn/jespinosa/phecomp/data/CRG/20120502_FDF_CRG/20120502_FDF_CRG/20120504_FDF_CRG_c12.mtb	264	NA	WWSS	water	1	158172	1336280358	1	0.02	0.000869565217391304	7171	1
3	Drink 2	Intake 2	15	158244	1336280430	/users/cn/jespinosa/phecomp/data/CRG/20120502_FDF_CRG/20120502_FDF_CRG/20120504_FDF_CRG_c12.mtb	1256	NA	WWSS	water	2	158229	1336280415	1	0.0200000000000005	0.00133333333333337	7172	1
3	Food 1	Intake 3	614	158920	1336281106	/users/cn/jespinosa/phecomp/data/CRG/20120502_FDF_CRG/20120502_FDF_CRG/20120504_FDF_CRG_c12.mtb	717	6	WWSS	food_sc	3	158306	1336280492	1	0.1	0.000162866449511401	7173	1
3	Food 1	Intake 3	398	159324	1336281510	/users/cn/jespinosa/phecomp/data/CRG/20120502_FDF_CRG/20120502_FDF_CRG/20120504_FDF_CRG_c12.mtb	718	210	WWSS	food_sc	3	158926	1336281112	1	0.0800000000000001	0.000201005025125628	7174	1
3	Drink 2	Intake 2	28	159365	1336281551	/users/cn/jespinosa/phecomp/data/CRG/20120502_FDF_CRG/20120502_FDF_CRG/20120504_FDF_CRG_c12.mtb	1257	NA	WWSS	water	2	159337	1336281523	1	0.0999999999999996	0.00357142857142856	7175	1
3	Drink 1	Intake 1	17	159468	1336281654	/users/cn/jespinosa/phecomp/data/CRG/20120502_FDF_CRG/20120502_FDF_CRG/20120504_FDF_CRG_c12.mtb	265	NA	WWSS	water	1	159451	1336281637	1	0.0399999999999999	0.00235294117647058	7176	1
3	Drink 1	Intake 1	16	159527	1336281713	/users/cn/jespinosa/phecomp/data/CRG/20120502_FDF_CRG/20120502_FDF_CRG/20120504_FDF_CRG_c12.mtb	266	NA	WWSS	water	1	159511	1336281697	1	0.02	0.00125	7177	1
3	Food 1	Intake 3	1563	161097	1336283283	/users/cn/jespinosa/phecomp/data/CRG/20120502_FDF_CRG/20120502_FDF_CRG/20120504_FDF_CRG_c12.mtb	719	450	WWSS	food_sc	3	159534	1336281720	1	0.14	8.95713371721049e-05	7178	1
3	Drink 2	Intake 2	19	161116	1336283302	/users/cn/jespinosa/phecomp/data/CRG/20120502_FDF_CRG/20120502_FDF_CRG/20120504_FDF_CRG_c12.mtb	1258	NA	WWSS	water	2	161097	1336283283	1	0.04	0.00210526315789474	7179	1
3	Drink 1	Intake 1	17	161178	1336283364	/users/cn/jespinosa/phecomp/data/CRG/20120502_FDF_CRG/20120502_FDF_CRG/20120504_FDF_CRG_c12.mtb	267	NA	WWSS	water	1	161161	1336283347	1	0.04	0.00235294117647059	7180	1
3	Food 1	Intake 3	290	161837	1336284023	/users/cn/jespinosa/phecomp/data/CRG/20120502_FDF_CRG/20120502_FDF_CRG/20120504_FDF_CRG_c12.mtb	723	59	WWSS	food_sc	3	161547	1336283733	1	0.02	6.89655172413793e-05	7181	1
3	Food 1	Intake 3	542	162438	1336284624	/users/cn/jespinosa/phecomp/data/CRG/20120502_FDF_CRG/20120502_FDF_CRG/20120504_FDF_CRG_c12.mtb	724	40134	WWSS	food_sc	3	161896	1336284082	1	0.0600000000000001	0.00011070110701107	7182	1
3	Drink 2	Intake 2	29	162462	1336284648	/users/cn/jespinosa/phecomp/data/CRG/20120502_FDF_CRG/20120502_FDF_CRG/20120504_FDF_CRG_c12.mtb	1259	NA	WWSS	water	2	162433	1336284619	1	0.0999999999999996	0.00344827586206895	7183	1
3	Food 1	Intake 3	123	202695	1336324881	/users/cn/jespinosa/phecomp/data/CRG/20120502_FDF_CRG/20120502_FDF_CRG/20120504_FDF_CRG_c12.mtb	732	162	WWSS	food_sc	3	202572	1336324758	1	0.02	0.00016260162601626	7184	1
3	Food 2	Intake 4	1040	203897	1336326083	/users/cn/jespinosa/phecomp/data/CRG/20120502_FDF_CRG/20120502_FDF_CRG/20120504_FDF_CRG_c12.mtb	963	143	WWSS	food_sc	4	202857	1336325043	1	0.16	0.000153846153846154	7185	1
3	Drink 2	Intake 2	26	203920	1336326106	/users/cn/jespinosa/phecomp/data/CRG/20120502_FDF_CRG/20120502_FDF_CRG/20120504_FDF_CRG_c12.mtb	1266	NA	WWSS	water	2	203894	1336326080	1	0.0600000000000005	0.00230769230769233	7186	1
3	Drink 2	Intake 2	20	203966	1336326152	/users/cn/jespinosa/phecomp/data/CRG/20120502_FDF_CRG/20120502_FDF_CRG/20120504_FDF_CRG_c12.mtb	1267	NA	WWSS	water	2	203946	1336326132	1	0.0599999999999996	0.00299999999999998	7187	1
3	Food 2	Intake 4	285	204325	1336326511	/users/cn/jespinosa/phecomp/data/CRG/20120502_FDF_CRG/20120502_FDF_CRG/20120504_FDF_CRG_c12.mtb	965	1773	WWSS	food_sc	4	204040	1336326226	1	0.0399999999999998	0.000140350877192982	7188	1
3	Drink 2	Intake 2	14	204331	1336326517	/users/cn/jespinosa/phecomp/data/CRG/20120502_FDF_CRG/20120502_FDF_CRG/20120504_FDF_CRG_c12.mtb	1268	NA	WWSS	water	2	204317	1336326503	1	0.0600000000000005	0.00428571428571432	7189	1
3	Food 2	Intake 4	542	206640	1336328826	/users/cn/jespinosa/phecomp/data/CRG/20120502_FDF_CRG/20120502_FDF_CRG/20120504_FDF_CRG_c12.mtb	968	10	WWSS	food_sc	4	206098	1336328284	1	0.0999999999999999	0.00018450184501845	7190	1
3	Food 2	Intake 4	601	207251	1336329437	/users/cn/jespinosa/phecomp/data/CRG/20120502_FDF_CRG/20120502_FDF_CRG/20120504_FDF_CRG_c12.mtb	969	61	WWSS	food_sc	4	206650	1336328836	1	0.16	0.000266222961730449	7191	1
3	Drink 2	Intake 2	28	207271	1336329457	/users/cn/jespinosa/phecomp/data/CRG/20120502_FDF_CRG/20120502_FDF_CRG/20120504_FDF_CRG_c12.mtb	1269	NA	WWSS	water	2	207243	1336329429	1	0.12	0.00428571428571429	7192	1
3	Food 2	Intake 4	626	207938	1336330124	/users/cn/jespinosa/phecomp/data/CRG/20120502_FDF_CRG/20120502_FDF_CRG/20120504_FDF_CRG_c12.mtb	970	255	WWSS	food_sc	4	207312	1336329498	1	0.12	0.000191693290734824	7193	1
3	Drink 2	Intake 2	34	207966	1336330152	/users/cn/jespinosa/phecomp/data/CRG/20120502_FDF_CRG/20120502_FDF_CRG/20120504_FDF_CRG_c12.mtb	1270	NA	WWSS	water	2	207932	1336330118	1	0.16	0.00470588235294118	7194	1
3	Food 2	Intake 4	625	208818	1336331004	/users/cn/jespinosa/phecomp/data/CRG/20120502_FDF_CRG/20120502_FDF_CRG/20120504_FDF_CRG_c12.mtb	971	4	WWSS	food_sc	4	208193	1336330379	1	0.0800000000000001	0.000128	7195	1
3	Food 2	Intake 4	231	209053	1336331239	/users/cn/jespinosa/phecomp/data/CRG/20120502_FDF_CRG/20120502_FDF_CRG/20120504_FDF_CRG_c12.mtb	972	437	WWSS	food_sc	4	208822	1336331008	1	0.04	0.000173160173160173	7196	1
3	Drink 2	Intake 2	28	209076	1336331262	/users/cn/jespinosa/phecomp/data/CRG/20120502_FDF_CRG/20120502_FDF_CRG/20120504_FDF_CRG_c12.mtb	1272	NA	WWSS	water	2	209048	1336331234	1	0.12	0.00428571428571429	7197	1
3	Food 2	Intake 4	1048	210538	1336332724	/users/cn/jespinosa/phecomp/data/CRG/20120502_FDF_CRG/20120502_FDF_CRG/20120504_FDF_CRG_c12.mtb	973	44	WWSS	food_sc	4	209490	1336331676	1	0.0999999999999996	9.54198473282439e-05	7198	1
3	Drink 2	Intake 2	29	210556	1336332742	/users/cn/jespinosa/phecomp/data/CRG/20120502_FDF_CRG/20120502_FDF_CRG/20120504_FDF_CRG_c12.mtb	1273	NA	WWSS	water	2	210527	1336332713	1	0.14	0.00482758620689655	7199	1
3	Food 2	Intake 4	916	211498	1336333684	/users/cn/jespinosa/phecomp/data/CRG/20120502_FDF_CRG/20120502_FDF_CRG/20120504_FDF_CRG_c12.mtb	974	6	WWSS	food_sc	4	210582	1336332768	1	0.26	0.000283842794759825	7200	1
3	Food 2	Intake 4	49	211553	1336333739	/users/cn/jespinosa/phecomp/data/CRG/20120502_FDF_CRG/20120502_FDF_CRG/20120504_FDF_CRG_c12.mtb	975	48	WWSS	food_sc	4	211504	1336333690	1	0.02	0.000408163265306122	7201	1
3	Drink 2	Intake 2	26	211577	1336333763	/users/cn/jespinosa/phecomp/data/CRG/20120502_FDF_CRG/20120502_FDF_CRG/20120504_FDF_CRG_c12.mtb	1274	NA	WWSS	water	2	211551	1336333737	1	0.180000000000001	0.00692307692307696	7202	1
3	Food 2	Intake 4	171	211772	1336333958	/users/cn/jespinosa/phecomp/data/CRG/20120502_FDF_CRG/20120502_FDF_CRG/20120504_FDF_CRG_c12.mtb	976	2250	WWSS	food_sc	4	211601	1336333787	1	0.04	0.000233918128654971	7203	1
3	Drink 2	Intake 2	33	212275	1336334461	/users/cn/jespinosa/phecomp/data/CRG/20120502_FDF_CRG/20120502_FDF_CRG/20120504_FDF_CRG_c12.mtb	1278	NA	WWSS	water	2	212242	1336334428	1	0.0200000000000005	0.000606060606060621	7204	1
3	Drink 2	Intake 2	18	214015	1336336201	/users/cn/jespinosa/phecomp/data/CRG/20120502_FDF_CRG/20120502_FDF_CRG/20120504_FDF_CRG_c12.mtb	1288	NA	WWSS	water	2	213997	1336336183	1	0.04	0.00222222222222222	7205	1
3	Food 2	Intake 4	1042	215064	1336337250	/users/cn/jespinosa/phecomp/data/CRG/20120502_FDF_CRG/20120502_FDF_CRG/20120504_FDF_CRG_c12.mtb	985	706	WWSS	food_sc	4	214022	1336336208	1	0.12	0.000115163147792706	7206	1
3	Drink 2	Intake 2	25	215087	1336337273	/users/cn/jespinosa/phecomp/data/CRG/20120502_FDF_CRG/20120502_FDF_CRG/20120504_FDF_CRG_c12.mtb	1289	NA	WWSS	water	2	215062	1336337248	1	0.0599999999999996	0.00239999999999998	7207	1
3	Drink 2	Intake 2	17	215390	1336337576	/users/cn/jespinosa/phecomp/data/CRG/20120502_FDF_CRG/20120502_FDF_CRG/20120504_FDF_CRG_c12.mtb	1290	NA	WWSS	water	2	215373	1336337559	1	0.0200000000000005	0.00117647058823532	7208	1
3	Food 2	Intake 4	888	216658	1336338844	/users/cn/jespinosa/phecomp/data/CRG/20120502_FDF_CRG/20120502_FDF_CRG/20120504_FDF_CRG_c12.mtb	990	93	WWSS	food_sc	4	215770	1336337956	1	0.14	0.000157657657657658	7209	1
3	Drink 2	Intake 2	30	216679	1336338865	/users/cn/jespinosa/phecomp/data/CRG/20120502_FDF_CRG/20120502_FDF_CRG/20120504_FDF_CRG_c12.mtb	1294	NA	WWSS	water	2	216649	1336338835	1	0.16	0.00533333333333333	7210	1
3	Food 2	Intake 4	693	217444	1336339630	/users/cn/jespinosa/phecomp/data/CRG/20120502_FDF_CRG/20120502_FDF_CRG/20120504_FDF_CRG_c12.mtb	991	31	WWSS	food_sc	4	216751	1336338937	1	0.14	0.000202020202020202	7211	1
3	Food 2	Intake 4	514	217989	1336340175	/users/cn/jespinosa/phecomp/data/CRG/20120502_FDF_CRG/20120502_FDF_CRG/20120504_FDF_CRG_c12.mtb	992	83	WWSS	food_sc	4	217475	1336339661	1	0.18	0.000350194552529183	7212	1
3	Drink 2	Intake 2	30	218013	1336340199	/users/cn/jespinosa/phecomp/data/CRG/20120502_FDF_CRG/20120502_FDF_CRG/20120504_FDF_CRG_c12.mtb	1295	NA	WWSS	water	2	217983	1336340169	1	0.180000000000001	0.00600000000000003	7213	1
3	Food 2	Intake 4	233	218305	1336340491	/users/cn/jespinosa/phecomp/data/CRG/20120502_FDF_CRG/20120502_FDF_CRG/20120504_FDF_CRG_c12.mtb	993	38	WWSS	food_sc	4	218072	1336340258	1	0.0600000000000001	0.000257510729613734	7214	1
3	Food 2	Intake 4	61	218404	1336340590	/users/cn/jespinosa/phecomp/data/CRG/20120502_FDF_CRG/20120502_FDF_CRG/20120504_FDF_CRG_c12.mtb	995	6	WWSS	food_sc	4	218343	1336340529	1	0.02	0.000327868852459016	7215	1
3	Food 2	Intake 4	366	218776	1336340962	/users/cn/jespinosa/phecomp/data/CRG/20120502_FDF_CRG/20120502_FDF_CRG/20120504_FDF_CRG_c12.mtb	996	770	WWSS	food_sc	4	218410	1336340596	1	0.14	0.000382513661202186	7216	1
3	Drink 2	Intake 2	28	218794	1336340980	/users/cn/jespinosa/phecomp/data/CRG/20120502_FDF_CRG/20120502_FDF_CRG/20120504_FDF_CRG_c12.mtb	1297	NA	WWSS	water	2	218766	1336340952	1	0.16	0.00571428571428571	7217	1
3	Drink 2	Intake 2	52	219094	1336341280	/users/cn/jespinosa/phecomp/data/CRG/20120502_FDF_CRG/20120502_FDF_CRG/20120504_FDF_CRG_c12.mtb	1298	NA	WWSS	water	2	219042	1336341228	1	0.04	0.000769230769230769	7218	1
3	Food 2	Intake 4	541	220087	1336342273	/users/cn/jespinosa/phecomp/data/CRG/20120502_FDF_CRG/20120502_FDF_CRG/20120504_FDF_CRG_c12.mtb	998	5241	WWSS	food_sc	4	219546	1336341732	1	0.14	0.000258780036968577	7219	1
3	Drink 2	Intake 2	21	220097	1336342283	/users/cn/jespinosa/phecomp/data/CRG/20120502_FDF_CRG/20120502_FDF_CRG/20120504_FDF_CRG_c12.mtb	1301	NA	WWSS	water	2	220076	1336342262	1	0.0999999999999996	0.00476190476190474	7220	1
3	Drink 2	Intake 2	18	220120	1336342306	/users/cn/jespinosa/phecomp/data/CRG/20120502_FDF_CRG/20120502_FDF_CRG/20120504_FDF_CRG_c12.mtb	1302	NA	WWSS	water	2	220102	1336342288	1	0.0200000000000005	0.00111111111111114	7221	1
3	Food 2	Intake 4	439	225767	1336347953	/users/cn/jespinosa/phecomp/data/CRG/20120502_FDF_CRG/20120502_FDF_CRG/20120504_FDF_CRG_c12.mtb	1000	3650	WWSS	food_sc	4	225328	1336347514	1	0.46	0.00104783599088838	7222	1
3	Drink 2	Intake 2	65	226257	1336348443	/users/cn/jespinosa/phecomp/data/CRG/20120502_FDF_CRG/20120502_FDF_CRG/20120504_FDF_CRG_c12.mtb	1306	NA	WWSS	water	2	226192	1336348378	1	0.18	0.00276923076923077	7223	1
3	Drink 1	Intake 1	18	226318	1336348504	/users/cn/jespinosa/phecomp/data/CRG/20120502_FDF_CRG/20120502_FDF_CRG/20120504_FDF_CRG_c12.mtb	271	NA	WWSS	water	1	226300	1336348486	1	0.04	0.00222222222222222	7224	1
3	Drink 2	Intake 2	21	226542	1336348728	/users/cn/jespinosa/phecomp/data/CRG/20120502_FDF_CRG/20120502_FDF_CRG/20120504_FDF_CRG_c12.mtb	1307	NA	WWSS	water	2	226521	1336348707	1	0.04	0.0019047619047619	7225	1
3	Drink 2	Intake 2	15	226933	1336349119	/users/cn/jespinosa/phecomp/data/CRG/20120502_FDF_CRG/20120502_FDF_CRG/20120504_FDF_CRG_c12.mtb	1312	NA	WWSS	water	2	226918	1336349104	1	0.0200000000000005	0.00133333333333337	7226	1
3	Drink 2	Intake 2	35	227066	1336349252	/users/cn/jespinosa/phecomp/data/CRG/20120502_FDF_CRG/20120502_FDF_CRG/20120504_FDF_CRG_c12.mtb	1313	NA	WWSS	water	2	227031	1336349217	1	0.0399999999999991	0.00114285714285712	7227	1
3	Drink 2	Intake 2	17	227572	1336349758	/users/cn/jespinosa/phecomp/data/CRG/20120502_FDF_CRG/20120502_FDF_CRG/20120504_FDF_CRG_c12.mtb	1316	NA	WWSS	water	2	227555	1336349741	1	0.0200000000000005	0.00117647058823532	7228	1
3	Drink 2	Intake 2	20	228381	1336350567	/users/cn/jespinosa/phecomp/data/CRG/20120502_FDF_CRG/20120502_FDF_CRG/20120504_FDF_CRG_c12.mtb	1317	NA	WWSS	water	2	228361	1336350547	1	0.04	0.002	7229	1
3	Drink 2	Intake 2	12	228514	1336350700	/users/cn/jespinosa/phecomp/data/CRG/20120502_FDF_CRG/20120502_FDF_CRG/20120504_FDF_CRG_c12.mtb	1318	NA	WWSS	water	2	228502	1336350688	1	0.04	0.00333333333333333	7230	1
3	Drink 2	Intake 2	15	229190	1336351376	/users/cn/jespinosa/phecomp/data/CRG/20120502_FDF_CRG/20120502_FDF_CRG/20120504_FDF_CRG_c12.mtb	1320	NA	WWSS	water	2	229175	1336351361	1	0.0200000000000005	0.00133333333333337	7231	1
3	Food 2	Intake 4	76	229493	1336351679	/users/cn/jespinosa/phecomp/data/CRG/20120502_FDF_CRG/20120502_FDF_CRG/20120504_FDF_CRG_c12.mtb	1011	545	WWSS	food_sc	4	229417	1336351603	1	0.0200000000000005	0.000263157894736849	7232	1
3	Food 2	Intake 4	898	230936	1336353122	/users/cn/jespinosa/phecomp/data/CRG/20120502_FDF_CRG/20120502_FDF_CRG/20120504_FDF_CRG_c12.mtb	1014	4407	WWSS	food_sc	4	230038	1336352224	1	0.12	0.000133630289532294	7233	1
3	Drink 2	Intake 2	20	230959	1336353145	/users/cn/jespinosa/phecomp/data/CRG/20120502_FDF_CRG/20120502_FDF_CRG/20120504_FDF_CRG_c12.mtb	1322	NA	WWSS	water	2	230939	1336353125	1	0.0800000000000001	0.00400000000000001	7234	1
3	Drink 1	Intake 1	19	235072	1336357258	/users/cn/jespinosa/phecomp/data/CRG/20120502_FDF_CRG/20120502_FDF_CRG/20120504_FDF_CRG_c12.mtb	275	NA	WWSS	water	1	235053	1336357239	1	0.02	0.00105263157894737	7235	1
3	Food 2	Intake 4	856	236199	1336358385	/users/cn/jespinosa/phecomp/data/CRG/20120502_FDF_CRG/20120502_FDF_CRG/20120504_FDF_CRG_c12.mtb	1018	1346	WWSS	food_sc	4	235343	1336357529	1	0.14	0.000163551401869159	7236	1
3	Drink 2	Intake 2	25	236231	1336358417	/users/cn/jespinosa/phecomp/data/CRG/20120502_FDF_CRG/20120502_FDF_CRG/20120504_FDF_CRG_c12.mtb	1323	NA	WWSS	water	2	236206	1336358392	1	0.0800000000000001	0.0032	7237	1
3	Drink 2	Intake 2	13	236446	1336358632	/users/cn/jespinosa/phecomp/data/CRG/20120502_FDF_CRG/20120502_FDF_CRG/20120504_FDF_CRG_c12.mtb	1325	NA	WWSS	water	2	236433	1336358619	1	0.0800000000000001	0.00615384615384616	7238	1
3	Drink 1	Intake 1	24	237261	1336359447	/users/cn/jespinosa/phecomp/data/CRG/20120502_FDF_CRG/20120502_FDF_CRG/20120504_FDF_CRG_c12.mtb	277	NA	WWSS	water	1	237237	1336359423	1	0.02	0.000833333333333333	7239	1
3	Food 2	Intake 4	295	237840	1336360026	/users/cn/jespinosa/phecomp/data/CRG/20120502_FDF_CRG/20120502_FDF_CRG/20120504_FDF_CRG_c12.mtb	1024	51	WWSS	food_sc	4	237545	1336359731	1	0.0600000000000005	0.000203389830508476	7240	1
3	Food 2	Intake 4	524	238415	1336360601	/users/cn/jespinosa/phecomp/data/CRG/20120502_FDF_CRG/20120502_FDF_CRG/20120504_FDF_CRG_c12.mtb	1025	7753	WWSS	food_sc	4	237891	1336360077	1	0.119999999999999	0.000229007633587784	7241	1
3	Drink 2	Intake 2	26	238468	1336360654	/users/cn/jespinosa/phecomp/data/CRG/20120502_FDF_CRG/20120502_FDF_CRG/20120504_FDF_CRG_c12.mtb	1328	NA	WWSS	water	2	238442	1336360628	1	0.0800000000000001	0.00307692307692308	7242	1
3	Food 1	Intake 3	620	246788	1336368974	/users/cn/jespinosa/phecomp/data/CRG/20120502_FDF_CRG/20120502_FDF_CRG/20120504_FDF_CRG_c12.mtb	758	4	WWSS	food_sc	3	246168	1336368354	1	0.14	0.000225806451612903	7243	1
3	Food 1	Intake 3	292	247084	1336369270	/users/cn/jespinosa/phecomp/data/CRG/20120502_FDF_CRG/20120502_FDF_CRG/20120504_FDF_CRG_c12.mtb	759	714	WWSS	food_sc	3	246792	1336368978	1	0.12	0.000410958904109589	7244	1
3	Drink 2	Intake 2	30	247108	1336369294	/users/cn/jespinosa/phecomp/data/CRG/20120502_FDF_CRG/20120502_FDF_CRG/20120504_FDF_CRG_c12.mtb	1334	NA	WWSS	water	2	247078	1336369264	1	0.16	0.00533333333333333	7245	1
3	Drink 2	Intake 2	18	247154	1336369340	/users/cn/jespinosa/phecomp/data/CRG/20120502_FDF_CRG/20120502_FDF_CRG/20120504_FDF_CRG_c12.mtb	1335	NA	WWSS	water	2	247136	1336369322	1	0.0599999999999996	0.00333333333333331	7246	1
3	Drink 2	Intake 2	72	247800	1336369986	/users/cn/jespinosa/phecomp/data/CRG/20120502_FDF_CRG/20120502_FDF_CRG/20120504_FDF_CRG_c12.mtb	1337	NA	WWSS	water	2	247728	1336369914	1	0.0200000000000005	0.000277777777777785	7247	1
3	Food 1	Intake 3	401	248199	1336370385	/users/cn/jespinosa/phecomp/data/CRG/20120502_FDF_CRG/20120502_FDF_CRG/20120504_FDF_CRG_c12.mtb	762	1825	WWSS	food_sc	3	247798	1336369984	1	0.12	0.00029925187032419	7248	1
3	Drink 2	Intake 2	18	248271	1336370457	/users/cn/jespinosa/phecomp/data/CRG/20120502_FDF_CRG/20120502_FDF_CRG/20120504_FDF_CRG_c12.mtb	1338	NA	WWSS	water	2	248253	1336370439	1	0.0800000000000001	0.00444444444444445	7249	1
3	Drink 2	Intake 2	33	248577	1336370763	/users/cn/jespinosa/phecomp/data/CRG/20120502_FDF_CRG/20120502_FDF_CRG/20120504_FDF_CRG_c12.mtb	1339	NA	WWSS	water	2	248544	1336370730	1	0.0599999999999996	0.00181818181818181	7250	1
3	Drink 2	Intake 2	109	249772	1336371958	/users/cn/jespinosa/phecomp/data/CRG/20120502_FDF_CRG/20120502_FDF_CRG/20120504_FDF_CRG_c12.mtb	1342	NA	WWSS	water	2	249663	1336371849	1	0.0200000000000005	0.000183486238532115	7251	1
3	Food 1	Intake 3	446	250470	1336372656	/users/cn/jespinosa/phecomp/data/CRG/20120502_FDF_CRG/20120502_FDF_CRG/20120504_FDF_CRG_c12.mtb	764	14372	WWSS	food_sc	3	250024	1336372210	1	0.0999999999999996	0.00022421524663677	7252	1
3	Drink 1	Intake 1	11	307	1336382818	/users/cn/jespinosa/phecomp/data/CRG/20120502_FDF_CRG/20120502_FDF_CRG/20120507_FDF_CRG_c12.mtb	348	NA	WWSS	water	1	296	1336382807	1	0.04	0.00363636363636364	7253	1
3	Drink 2	Intake 2	13	1705	1336384216	/users/cn/jespinosa/phecomp/data/CRG/20120502_FDF_CRG/20120502_FDF_CRG/20120507_FDF_CRG_c12.mtb	1512	NA	WWSS	water	2	1692	1336384203	1	0.06	0.00461538461538461	7254	1
3	Drink 2	Intake 2	17	4370	1336386881	/users/cn/jespinosa/phecomp/data/CRG/20120502_FDF_CRG/20120502_FDF_CRG/20120507_FDF_CRG_c12.mtb	1514	NA	WWSS	water	2	4353	1336386864	1	0.02	0.00117647058823529	7255	1
3	Food 2	Intake 4	484	5001	1336387512	/users/cn/jespinosa/phecomp/data/CRG/20120502_FDF_CRG/20120502_FDF_CRG/20120507_FDF_CRG_c12.mtb	1397	17999	WWSS	food_sc	4	4517	1336387028	1	0.04	8.26446280991736e-05	7256	1
3	Drink 1	Intake 1	14	5126	1336387637	/users/cn/jespinosa/phecomp/data/CRG/20120502_FDF_CRG/20120502_FDF_CRG/20120507_FDF_CRG_c12.mtb	349	NA	WWSS	water	1	5112	1336387623	1	0.04	0.00285714285714286	7257	1
3	Drink 2	Intake 2	9	22831	1336405342	/users/cn/jespinosa/phecomp/data/CRG/20120502_FDF_CRG/20120502_FDF_CRG/20120507_FDF_CRG_c12.mtb	1521	NA	WWSS	water	2	22822	1336405333	1	0.02	0.00222222222222222	7258	1
3	Food 1	Intake 3	411	23411	1336405922	/users/cn/jespinosa/phecomp/data/CRG/20120502_FDF_CRG/20120502_FDF_CRG/20120507_FDF_CRG_c12.mtb	912	6015	WWSS	food_sc	3	23000	1336405511	1	0.06	0.000145985401459854	7259	1
3	Food 1	Intake 3	521	29947	1336412458	/users/cn/jespinosa/phecomp/data/CRG/20120502_FDF_CRG/20120502_FDF_CRG/20120507_FDF_CRG_c12.mtb	914	COLL	WWSS	food_sc	3	29426	1336411937	1	0.04	7.67754318618042e-05	7260	1
3	Food 2	Intake 4	375	30313	1336412824	/users/cn/jespinosa/phecomp/data/CRG/20120502_FDF_CRG/20120502_FDF_CRG/20120507_FDF_CRG_c12.mtb	1402	1742	WWSS	food_sc	4	29938	1336412449	1	0.04	0.000106666666666667	7261	1
3	Drink 1	Intake 1	13	31290	1336413801	/users/cn/jespinosa/phecomp/data/CRG/20120502_FDF_CRG/20120502_FDF_CRG/20120507_FDF_CRG_c12.mtb	352	NA	WWSS	water	1	31277	1336413788	1	0.04	0.00307692307692308	7262	1
3	Food 2	Intake 4	57	32112	1336414623	/users/cn/jespinosa/phecomp/data/CRG/20120502_FDF_CRG/20120502_FDF_CRG/20120507_FDF_CRG_c12.mtb	1404	30	WWSS	food_sc	4	32055	1336414566	1	0.02	0.000350877192982456	7263	1
3	Food 2	Intake 4	237	32379	1336414890	/users/cn/jespinosa/phecomp/data/CRG/20120502_FDF_CRG/20120502_FDF_CRG/20120507_FDF_CRG_c12.mtb	1405	8	WWSS	food_sc	4	32142	1336414653	1	0.02	8.43881856540084e-05	7264	1
3	Food 1	Intake 3	731	33118	1336415629	/users/cn/jespinosa/phecomp/data/CRG/20120502_FDF_CRG/20120502_FDF_CRG/20120507_FDF_CRG_c12.mtb	919	740	WWSS	food_sc	3	32387	1336414898	1	0.18	0.000246238030095759	7265	1
3	Drink 2	Intake 2	12	33126	1336415637	/users/cn/jespinosa/phecomp/data/CRG/20120502_FDF_CRG/20120502_FDF_CRG/20120507_FDF_CRG_c12.mtb	1523	NA	WWSS	water	2	33114	1336415625	1	0.04	0.00333333333333333	7266	1
3	Drink 2	Intake 2	18	33234	1336415745	/users/cn/jespinosa/phecomp/data/CRG/20120502_FDF_CRG/20120502_FDF_CRG/20120507_FDF_CRG_c12.mtb	1524	NA	WWSS	water	2	33216	1336415727	1	0.02	0.00111111111111111	7267	1
3	Drink 2	Intake 2	21	33851	1336416362	/users/cn/jespinosa/phecomp/data/CRG/20120502_FDF_CRG/20120502_FDF_CRG/20120507_FDF_CRG_c12.mtb	1525	NA	WWSS	water	2	33830	1336416341	1	0.08	0.00380952380952381	7268	1
3	Food 1	Intake 3	760	34618	1336417129	/users/cn/jespinosa/phecomp/data/CRG/20120502_FDF_CRG/20120502_FDF_CRG/20120507_FDF_CRG_c12.mtb	920	958	WWSS	food_sc	3	33858	1336416369	1	0.22	0.000289473684210526	7269	1
3	Drink 2	Intake 2	125	34748	1336417259	/users/cn/jespinosa/phecomp/data/CRG/20120502_FDF_CRG/20120502_FDF_CRG/20120507_FDF_CRG_c12.mtb	1526	NA	WWSS	water	2	34623	1336417134	1	0.08	0.00064	7270	1
3	Drink 2	Intake 2	103	34873	1336417384	/users/cn/jespinosa/phecomp/data/CRG/20120502_FDF_CRG/20120502_FDF_CRG/20120507_FDF_CRG_c12.mtb	1527	NA	WWSS	water	2	34770	1336417281	1	0.02	0.000194174757281553	7271	1
3	Drink 2	Intake 2	21	34917	1336417428	/users/cn/jespinosa/phecomp/data/CRG/20120502_FDF_CRG/20120502_FDF_CRG/20120507_FDF_CRG_c12.mtb	1528	NA	WWSS	water	2	34896	1336417407	1	0.02	0.000952380952380952	7272	1
3	Drink 1	Intake 1	25	35568	1336418079	/users/cn/jespinosa/phecomp/data/CRG/20120502_FDF_CRG/20120502_FDF_CRG/20120507_FDF_CRG_c12.mtb	353	NA	WWSS	water	1	35543	1336418054	1	0.08	0.0032	7273	1
3	Food 1	Intake 3	811	36387	1336418898	/users/cn/jespinosa/phecomp/data/CRG/20120502_FDF_CRG/20120502_FDF_CRG/20120507_FDF_CRG_c12.mtb	921	1351	WWSS	food_sc	3	35576	1336418087	1	0.26	0.00032059186189889	7274	1
3	Drink 1	Intake 1	37	36420	1336418931	/users/cn/jespinosa/phecomp/data/CRG/20120502_FDF_CRG/20120502_FDF_CRG/20120507_FDF_CRG_c12.mtb	354	NA	WWSS	water	1	36383	1336418894	1	0.14	0.00378378378378378	7275	1
3	Food 1	Intake 3	162	37900	1336420411	/users/cn/jespinosa/phecomp/data/CRG/20120502_FDF_CRG/20120502_FDF_CRG/20120507_FDF_CRG_c12.mtb	922	9	WWSS	food_sc	3	37738	1336420249	1	0.0599999999999999	0.00037037037037037	7276	1
3	Food 1	Intake 3	407	38316	1336420827	/users/cn/jespinosa/phecomp/data/CRG/20120502_FDF_CRG/20120502_FDF_CRG/20120507_FDF_CRG_c12.mtb	923	778	WWSS	food_sc	3	37909	1336420420	1	0.2	0.000491400491400491	7277	1
3	Drink 2	Intake 2	33	38342	1336420853	/users/cn/jespinosa/phecomp/data/CRG/20120502_FDF_CRG/20120502_FDF_CRG/20120507_FDF_CRG_c12.mtb	1529	NA	WWSS	water	2	38309	1336420820	1	0.16	0.00484848484848485	7278	1
3	Drink 2	Intake 2	15	38416	1336420927	/users/cn/jespinosa/phecomp/data/CRG/20120502_FDF_CRG/20120502_FDF_CRG/20120507_FDF_CRG_c12.mtb	1530	NA	WWSS	water	2	38401	1336420912	1	0.02	0.00133333333333333	7279	1
3	Drink 2	Intake 2	15	38570	1336421081	/users/cn/jespinosa/phecomp/data/CRG/20120502_FDF_CRG/20120502_FDF_CRG/20120507_FDF_CRG_c12.mtb	1533	NA	WWSS	water	2	38555	1336421066	1	0.0399999999999999	0.00266666666666666	7280	1
3	Drink 2	Intake 2	66	39046	1336421557	/users/cn/jespinosa/phecomp/data/CRG/20120502_FDF_CRG/20120502_FDF_CRG/20120507_FDF_CRG_c12.mtb	1538	NA	WWSS	water	2	38980	1336421491	1	0.02	0.000303030303030303	7281	1
3	Food 1	Intake 3	40	39134	1336421645	/users/cn/jespinosa/phecomp/data/CRG/20120502_FDF_CRG/20120502_FDF_CRG/20120507_FDF_CRG_c12.mtb	925	25	WWSS	food_sc	3	39094	1336421605	1	0.04	0.001	7282	1
3	Food 1	Intake 3	23	39182	1336421693	/users/cn/jespinosa/phecomp/data/CRG/20120502_FDF_CRG/20120502_FDF_CRG/20120507_FDF_CRG_c12.mtb	926	23	WWSS	food_sc	3	39159	1336421670	1	0.02	0.000869565217391304	7283	1
3	Food 1	Intake 3	326	39531	1336422042	/users/cn/jespinosa/phecomp/data/CRG/20120502_FDF_CRG/20120502_FDF_CRG/20120507_FDF_CRG_c12.mtb	927	5757	WWSS	food_sc	3	39205	1336421716	1	0.36	0.00110429447852761	7284	1
3	Drink 1	Intake 1	26	39757	1336422268	/users/cn/jespinosa/phecomp/data/CRG/20120502_FDF_CRG/20120502_FDF_CRG/20120507_FDF_CRG_c12.mtb	355	NA	WWSS	water	1	39731	1336422242	1	0.14	0.00538461538461539	7285	1
3	Drink 2	Intake 2	23	39822	1336422333	/users/cn/jespinosa/phecomp/data/CRG/20120502_FDF_CRG/20120502_FDF_CRG/20120507_FDF_CRG_c12.mtb	1540	NA	WWSS	water	2	39799	1336422310	1	0.02	0.000869565217391304	7286	1
3	Drink 2	Intake 2	14	40233	1336422744	/users/cn/jespinosa/phecomp/data/CRG/20120502_FDF_CRG/20120502_FDF_CRG/20120507_FDF_CRG_c12.mtb	1541	NA	WWSS	water	2	40219	1336422730	1	0.04	0.00285714285714286	7287	1
3	Drink 2	Intake 2	135	43563	1336426074	/users/cn/jespinosa/phecomp/data/CRG/20120502_FDF_CRG/20120502_FDF_CRG/20120507_FDF_CRG_c12.mtb	1544	NA	WWSS	water	2	43428	1336425939	1	0.02	0.000148148148148148	7288	1
3	Food 1	Intake 3	173	45461	1336427972	/users/cn/jespinosa/phecomp/data/CRG/20120502_FDF_CRG/20120502_FDF_CRG/20120507_FDF_CRG_c12.mtb	932	16	WWSS	food_sc	3	45288	1336427799	1	0.0800000000000001	0.00046242774566474	7289	1
3	Food 1	Intake 3	254	45731	1336428242	/users/cn/jespinosa/phecomp/data/CRG/20120502_FDF_CRG/20120502_FDF_CRG/20120507_FDF_CRG_c12.mtb	933	1490	WWSS	food_sc	3	45477	1336427988	1	0.28	0.00110236220472441	7290	1
3	Drink 2	Intake 2	17	45997	1336428508	/users/cn/jespinosa/phecomp/data/CRG/20120502_FDF_CRG/20120502_FDF_CRG/20120507_FDF_CRG_c12.mtb	1549	NA	WWSS	water	2	45980	1336428491	1	0.1	0.00588235294117647	7291	1
3	Drink 1	Intake 1	16	46049	1336428560	/users/cn/jespinosa/phecomp/data/CRG/20120502_FDF_CRG/20120502_FDF_CRG/20120507_FDF_CRG_c12.mtb	356	NA	WWSS	water	1	46033	1336428544	1	0.04	0.0025	7292	1
3	Drink 2	Intake 2	16	46286	1336428797	/users/cn/jespinosa/phecomp/data/CRG/20120502_FDF_CRG/20120502_FDF_CRG/20120507_FDF_CRG_c12.mtb	1551	NA	WWSS	water	2	46270	1336428781	1	0.0399999999999999	0.00249999999999999	7293	1
3	Drink 2	Intake 2	15	46381	1336428892	/users/cn/jespinosa/phecomp/data/CRG/20120502_FDF_CRG/20120502_FDF_CRG/20120507_FDF_CRG_c12.mtb	1552	NA	WWSS	water	2	46366	1336428877	1	0.02	0.00133333333333333	7294	1
3	Drink 2	Intake 2	23	46859	1336429370	/users/cn/jespinosa/phecomp/data/CRG/20120502_FDF_CRG/20120502_FDF_CRG/20120507_FDF_CRG_c12.mtb	1554	NA	WWSS	water	2	46836	1336429347	1	0.02	0.000869565217391304	7295	1
3	Drink 2	Intake 2	19	46978	1336429489	/users/cn/jespinosa/phecomp/data/CRG/20120502_FDF_CRG/20120502_FDF_CRG/20120507_FDF_CRG_c12.mtb	1555	NA	WWSS	water	2	46959	1336429470	1	0.04	0.00210526315789474	7296	1
3	Food 1	Intake 3	155	47376	1336429887	/users/cn/jespinosa/phecomp/data/CRG/20120502_FDF_CRG/20120502_FDF_CRG/20120507_FDF_CRG_c12.mtb	936	1568	WWSS	food_sc	3	47221	1336429732	1	0.0599999999999998	0.000387096774193547	7297	1
3	Drink 2	Intake 2	25	47415	1336429926	/users/cn/jespinosa/phecomp/data/CRG/20120502_FDF_CRG/20120502_FDF_CRG/20120507_FDF_CRG_c12.mtb	1556	NA	WWSS	water	2	47390	1336429901	1	0.0399999999999999	0.0016	7298	1
3	Food 1	Intake 3	452	49396	1336431907	/users/cn/jespinosa/phecomp/data/CRG/20120502_FDF_CRG/20120502_FDF_CRG/20120507_FDF_CRG_c12.mtb	937	886	WWSS	food_sc	3	48944	1336431455	1	0.14	0.000309734513274336	7299	1
3	Drink 2	Intake 2	23	49410	1336431921	/users/cn/jespinosa/phecomp/data/CRG/20120502_FDF_CRG/20120502_FDF_CRG/20120507_FDF_CRG_c12.mtb	1558	NA	WWSS	water	2	49387	1336431898	1	0.0600000000000001	0.00260869565217392	7300	1
3	Drink 2	Intake 2	18	49568	1336432079	/users/cn/jespinosa/phecomp/data/CRG/20120502_FDF_CRG/20120502_FDF_CRG/20120507_FDF_CRG_c12.mtb	1559	NA	WWSS	water	2	49550	1336432061	1	0.02	0.00111111111111111	7301	1
3	Drink 1	Intake 1	12	50063	1336432574	/users/cn/jespinosa/phecomp/data/CRG/20120502_FDF_CRG/20120502_FDF_CRG/20120507_FDF_CRG_c12.mtb	357	NA	WWSS	water	1	50051	1336432562	1	0.02	0.00166666666666667	7302	1
3	Food 1	Intake 3	59	50341	1336432852	/users/cn/jespinosa/phecomp/data/CRG/20120502_FDF_CRG/20120502_FDF_CRG/20120507_FDF_CRG_c12.mtb	940	3085	WWSS	food_sc	3	50282	1336432793	1	0.26	0.00440677966101695	7303	1
3	Drink 2	Intake 2	22	50661	1336433172	/users/cn/jespinosa/phecomp/data/CRG/20120502_FDF_CRG/20120502_FDF_CRG/20120507_FDF_CRG_c12.mtb	1563	NA	WWSS	water	2	50639	1336433150	1	0.0800000000000001	0.00363636363636364	7304	1
3	Drink 2	Intake 2	20	50702	1336433213	/users/cn/jespinosa/phecomp/data/CRG/20120502_FDF_CRG/20120502_FDF_CRG/20120507_FDF_CRG_c12.mtb	1564	NA	WWSS	water	2	50682	1336433193	1	0.02	0.001	7305	1
3	Drink 2	Intake 2	75	50949	1336433460	/users/cn/jespinosa/phecomp/data/CRG/20120502_FDF_CRG/20120502_FDF_CRG/20120507_FDF_CRG_c12.mtb	1566	NA	WWSS	water	2	50874	1336433385	1	0.0399999999999998	0.000533333333333331	7306	1
3	Drink 2	Intake 2	28	51193	1336433704	/users/cn/jespinosa/phecomp/data/CRG/20120502_FDF_CRG/20120502_FDF_CRG/20120507_FDF_CRG_c12.mtb	1571	NA	WWSS	water	2	51165	1336433676	1	0.02	0.000714285714285714	7307	1
3	Food 1	Intake 3	137	53563	1336436074	/users/cn/jespinosa/phecomp/data/CRG/20120502_FDF_CRG/20120502_FDF_CRG/20120507_FDF_CRG_c12.mtb	943	238	WWSS	food_sc	3	53426	1336435937	1	0.04	0.000291970802919708	7308	1
3	Food 1	Intake 3	533	54334	1336436845	/users/cn/jespinosa/phecomp/data/CRG/20120502_FDF_CRG/20120502_FDF_CRG/20120507_FDF_CRG_c12.mtb	945	469	WWSS	food_sc	3	53801	1336436312	1	0.1	0.000187617260787992	7309	1
3	Drink 1	Intake 1	19	54348	1336436859	/users/cn/jespinosa/phecomp/data/CRG/20120502_FDF_CRG/20120502_FDF_CRG/20120507_FDF_CRG_c12.mtb	358	NA	WWSS	water	1	54329	1336436840	1	0.0399999999999999	0.00210526315789473	7310	1
3	Drink 2	Intake 2	32	54382	1336436893	/users/cn/jespinosa/phecomp/data/CRG/20120502_FDF_CRG/20120502_FDF_CRG/20120507_FDF_CRG_c12.mtb	1577	NA	WWSS	water	2	54350	1336436861	1	0.02	0.000625	7311	1
3	Drink 2	Intake 2	27	54506	1336437017	/users/cn/jespinosa/phecomp/data/CRG/20120502_FDF_CRG/20120502_FDF_CRG/20120507_FDF_CRG_c12.mtb	1578	NA	WWSS	water	2	54479	1336436990	1	0.02	0.000740740740740741	7312	1
3	Drink 1	Intake 1	17	54626	1336437137	/users/cn/jespinosa/phecomp/data/CRG/20120502_FDF_CRG/20120502_FDF_CRG/20120507_FDF_CRG_c12.mtb	359	NA	WWSS	water	1	54609	1336437120	1	0.04	0.00235294117647059	7313	1
3	Food 1	Intake 3	124	54927	1336437438	/users/cn/jespinosa/phecomp/data/CRG/20120502_FDF_CRG/20120502_FDF_CRG/20120507_FDF_CRG_c12.mtb	950	1119	WWSS	food_sc	3	54803	1336437314	1	0.02	0.000161290322580645	7314	1
3	Drink 2	Intake 2	16	54942	1336437453	/users/cn/jespinosa/phecomp/data/CRG/20120502_FDF_CRG/20120502_FDF_CRG/20120507_FDF_CRG_c12.mtb	1582	NA	WWSS	water	2	54926	1336437437	1	0.04	0.0025	7315	1
3	Drink 2	Intake 2	15	55225	1336437736	/users/cn/jespinosa/phecomp/data/CRG/20120502_FDF_CRG/20120502_FDF_CRG/20120507_FDF_CRG_c12.mtb	1583	NA	WWSS	water	2	55210	1336437721	1	0.02	0.00133333333333333	7316	1
3	Drink 2	Intake 2	17	55381	1336437892	/users/cn/jespinosa/phecomp/data/CRG/20120502_FDF_CRG/20120502_FDF_CRG/20120507_FDF_CRG_c12.mtb	1584	NA	WWSS	water	2	55364	1336437875	1	0.02	0.00117647058823529	7317	1
3	Food 1	Intake 3	188	56234	1336438745	/users/cn/jespinosa/phecomp/data/CRG/20120502_FDF_CRG/20120502_FDF_CRG/20120507_FDF_CRG_c12.mtb	952	17	WWSS	food_sc	3	56046	1336438557	1	0.02	0.000106382978723404	7318	1
3	Drink 2	Intake 2	24	56253	1336438764	/users/cn/jespinosa/phecomp/data/CRG/20120502_FDF_CRG/20120502_FDF_CRG/20120507_FDF_CRG_c12.mtb	1586	NA	WWSS	water	2	56229	1336438740	1	0.02	0.000833333333333333	7319	1
3	Food 1	Intake 3	353	56604	1336439115	/users/cn/jespinosa/phecomp/data/CRG/20120502_FDF_CRG/20120502_FDF_CRG/20120507_FDF_CRG_c12.mtb	953	38	WWSS	food_sc	3	56251	1336438762	1	0.0800000000000001	0.000226628895184136	7320	1
3	Drink 2	Intake 2	23	56631	1336439142	/users/cn/jespinosa/phecomp/data/CRG/20120502_FDF_CRG/20120502_FDF_CRG/20120507_FDF_CRG_c12.mtb	1587	NA	WWSS	water	2	56608	1336439119	1	0.0599999999999998	0.0026086956521739	7321	1
3	Food 1	Intake 3	144	56786	1336439297	/users/cn/jespinosa/phecomp/data/CRG/20120502_FDF_CRG/20120502_FDF_CRG/20120507_FDF_CRG_c12.mtb	954	99	WWSS	food_sc	3	56642	1336439153	1	0.02	0.000138888888888889	7322	1
3	Food 2	Intake 4	509	57394	1336439905	/users/cn/jespinosa/phecomp/data/CRG/20120502_FDF_CRG/20120502_FDF_CRG/20120507_FDF_CRG_c12.mtb	1421	4298	WWSS	food_sc	4	56885	1336439396	1	0.18	0.000353634577603143	7323	1
3	Drink 2	Intake 2	30	57419	1336439930	/users/cn/jespinosa/phecomp/data/CRG/20120502_FDF_CRG/20120502_FDF_CRG/20120507_FDF_CRG_c12.mtb	1588	NA	WWSS	water	2	57389	1336439900	1	0.12	0.004	7324	1
3	Drink 1	Intake 1	20	57494	1336440005	/users/cn/jespinosa/phecomp/data/CRG/20120502_FDF_CRG/20120502_FDF_CRG/20120507_FDF_CRG_c12.mtb	360	NA	WWSS	water	1	57474	1336439985	1	0.0600000000000001	0.00300000000000001	7325	1
3	Drink 2	Intake 2	17	57873	1336440384	/users/cn/jespinosa/phecomp/data/CRG/20120502_FDF_CRG/20120502_FDF_CRG/20120507_FDF_CRG_c12.mtb	1589	NA	WWSS	water	2	57856	1336440367	1	0.02	0.00117647058823529	7326	1
3	Food 2	Intake 4	743	62435	1336444946	/users/cn/jespinosa/phecomp/data/CRG/20120502_FDF_CRG/20120502_FDF_CRG/20120507_FDF_CRG_c12.mtb	1424	687	WWSS	food_sc	4	61692	1336444203	1	0.24	0.000323014804845222	7327	1
3	Drink 2	Intake 2	26	62458	1336444969	/users/cn/jespinosa/phecomp/data/CRG/20120502_FDF_CRG/20120502_FDF_CRG/20120507_FDF_CRG_c12.mtb	1592	NA	WWSS	water	2	62432	1336444943	1	0.02	0.000769230769230769	7328	1
3	Drink 1	Intake 1	23	62481	1336444992	/users/cn/jespinosa/phecomp/data/CRG/20120502_FDF_CRG/20120502_FDF_CRG/20120507_FDF_CRG_c12.mtb	361	NA	WWSS	water	1	62458	1336444969	1	0.0399999999999999	0.0017391304347826	7329	1
3	Drink 1	Intake 1	12	62576	1336445087	/users/cn/jespinosa/phecomp/data/CRG/20120502_FDF_CRG/20120502_FDF_CRG/20120507_FDF_CRG_c12.mtb	362	NA	WWSS	water	1	62564	1336445075	1	0.04	0.00333333333333333	7330	1
3	Drink 2	Intake 2	13	62901	1336445412	/users/cn/jespinosa/phecomp/data/CRG/20120502_FDF_CRG/20120502_FDF_CRG/20120507_FDF_CRG_c12.mtb	1593	NA	WWSS	water	2	62888	1336445399	1	0.04	0.00307692307692308	7331	1
3	Food 2	Intake 4	332	63454	1336445965	/users/cn/jespinosa/phecomp/data/CRG/20120502_FDF_CRG/20120502_FDF_CRG/20120507_FDF_CRG_c12.mtb	1426	6253	WWSS	food_sc	4	63122	1336445633	1	0.12	0.00036144578313253	7332	1
3	Drink 2	Intake 2	36	63487	1336445998	/users/cn/jespinosa/phecomp/data/CRG/20120502_FDF_CRG/20120502_FDF_CRG/20120507_FDF_CRG_c12.mtb	1594	NA	WWSS	water	2	63451	1336445962	1	0.0800000000000001	0.00222222222222222	7333	1
3	Drink 1	Intake 1	22	63509	1336446020	/users/cn/jespinosa/phecomp/data/CRG/20120502_FDF_CRG/20120502_FDF_CRG/20120507_FDF_CRG_c12.mtb	363	NA	WWSS	water	1	63487	1336445998	1	0.0599999999999999	0.00272727272727272	7334	1
3	Drink 2	Intake 2	20	64130	1336446641	/users/cn/jespinosa/phecomp/data/CRG/20120502_FDF_CRG/20120502_FDF_CRG/20120507_FDF_CRG_c12.mtb	1595	NA	WWSS	water	2	64110	1336446621	1	0.0399999999999998	0.00199999999999999	7335	1
3	Drink 1	Intake 1	18	64546	1336447057	/users/cn/jespinosa/phecomp/data/CRG/20120502_FDF_CRG/20120502_FDF_CRG/20120507_FDF_CRG_c12.mtb	364	NA	WWSS	water	1	64528	1336447039	1	0.04	0.00222222222222222	7336	1
3	Food 2	Intake 4	65	69772	1336452283	/users/cn/jespinosa/phecomp/data/CRG/20120502_FDF_CRG/20120502_FDF_CRG/20120507_FDF_CRG_c12.mtb	1429	47108	WWSS	food_sc	4	69707	1336452218	1	0.34	0.00523076923076923	7337	1
3	Drink 1	Intake 1	28	70242	1336452753	/users/cn/jespinosa/phecomp/data/CRG/20120502_FDF_CRG/20120502_FDF_CRG/20120507_FDF_CRG_c12.mtb	365	NA	WWSS	water	1	70214	1336452725	1	0.1	0.00357142857142857	7338	1
3	Drink 2	Intake 2	37	70599	1336453110	/users/cn/jespinosa/phecomp/data/CRG/20120502_FDF_CRG/20120502_FDF_CRG/20120507_FDF_CRG_c12.mtb	1597	NA	WWSS	water	2	70562	1336453073	1	0.02	0.000540540540540541	7339	1
3	Drink 2	Intake 2	35	70675	1336453186	/users/cn/jespinosa/phecomp/data/CRG/20120502_FDF_CRG/20120502_FDF_CRG/20120507_FDF_CRG_c12.mtb	1598	NA	WWSS	water	2	70640	1336453151	1	0.02	0.000571428571428571	7340	1
3	Drink 1	Intake 1	14	70982	1336453493	/users/cn/jespinosa/phecomp/data/CRG/20120502_FDF_CRG/20120502_FDF_CRG/20120507_FDF_CRG_c12.mtb	367	NA	WWSS	water	1	70968	1336453479	1	0.04	0.00285714285714286	7341	1
3	Drink 2	Intake 2	16	71070	1336453581	/users/cn/jespinosa/phecomp/data/CRG/20120502_FDF_CRG/20120502_FDF_CRG/20120507_FDF_CRG_c12.mtb	1600	NA	WWSS	water	2	71054	1336453565	1	0.02	0.00125	7342	1
3	Drink 2	Intake 2	12	72485	1336454996	/users/cn/jespinosa/phecomp/data/CRG/20120502_FDF_CRG/20120502_FDF_CRG/20120507_FDF_CRG_c12.mtb	1602	NA	WWSS	water	2	72473	1336454984	1	0.04	0.00333333333333333	7343	1
3	Food 1	Intake 3	110	116990	1336499501	/users/cn/jespinosa/phecomp/data/CRG/20120502_FDF_CRG/20120502_FDF_CRG/20120507_FDF_CRG_c12.mtb	963	1425	WWSS	food_sc	3	116880	1336499391	1	0.02	0.000181818181818182	7344	1
3	Food 2	Intake 4	84	118499	1336501010	/users/cn/jespinosa/phecomp/data/CRG/20120502_FDF_CRG/20120502_FDF_CRG/20120507_FDF_CRG_c12.mtb	1447	13	WWSS	food_sc	4	118415	1336500926	1	0.02	0.000238095238095238	7345	1
3	Food 2	Intake 4	551	119063	1336501574	/users/cn/jespinosa/phecomp/data/CRG/20120502_FDF_CRG/20120502_FDF_CRG/20120507_FDF_CRG_c12.mtb	1448	128	WWSS	food_sc	4	118512	1336501023	1	0.12	0.000217785843920145	7346	1
3	Food 1	Intake 3	166	119357	1336501868	/users/cn/jespinosa/phecomp/data/CRG/20120502_FDF_CRG/20120502_FDF_CRG/20120507_FDF_CRG_c12.mtb	966	386	WWSS	food_sc	3	119191	1336501702	1	0.02	0.000120481927710843	7347	1
3	Drink 2	Intake 2	18	119379	1336501890	/users/cn/jespinosa/phecomp/data/CRG/20120502_FDF_CRG/20120502_FDF_CRG/20120507_FDF_CRG_c12.mtb	1608	NA	WWSS	water	2	119361	1336501872	1	0.04	0.00222222222222222	7348	1
3	Drink 2	Intake 2	12	119434	1336501945	/users/cn/jespinosa/phecomp/data/CRG/20120502_FDF_CRG/20120502_FDF_CRG/20120507_FDF_CRG_c12.mtb	1609	NA	WWSS	water	2	119422	1336501933	1	0.02	0.00166666666666667	7349	1
3	Food 2	Intake 4	681	120424	1336502935	/users/cn/jespinosa/phecomp/data/CRG/20120502_FDF_CRG/20120502_FDF_CRG/20120507_FDF_CRG_c12.mtb	1452	913	WWSS	food_sc	4	119743	1336502254	1	0.2	0.000293685756240822	7350	1
3	Drink 2	Intake 2	34	120457	1336502968	/users/cn/jespinosa/phecomp/data/CRG/20120502_FDF_CRG/20120502_FDF_CRG/20120507_FDF_CRG_c12.mtb	1611	NA	WWSS	water	2	120423	1336502934	1	0.18	0.00529411764705882	7351	1
3	Drink 1	Intake 1	20	120890	1336503401	/users/cn/jespinosa/phecomp/data/CRG/20120502_FDF_CRG/20120502_FDF_CRG/20120507_FDF_CRG_c12.mtb	371	NA	WWSS	water	1	120870	1336503381	1	0.04	0.002	7352	1
3	Drink 1	Intake 1	36	121326	1336503837	/users/cn/jespinosa/phecomp/data/CRG/20120502_FDF_CRG/20120502_FDF_CRG/20120507_FDF_CRG_c12.mtb	372	NA	WWSS	water	1	121290	1336503801	1	0.14	0.00388888888888889	7353	1
3	Food 2	Intake 4	593	121930	1336504441	/users/cn/jespinosa/phecomp/data/CRG/20120502_FDF_CRG/20120502_FDF_CRG/20120507_FDF_CRG_c12.mtb	1453	168	WWSS	food_sc	4	121337	1336503848	1	0.14	0.000236087689713322	7354	1
3	Drink 2	Intake 2	16	121943	1336504454	/users/cn/jespinosa/phecomp/data/CRG/20120502_FDF_CRG/20120502_FDF_CRG/20120507_FDF_CRG_c12.mtb	1612	NA	WWSS	water	2	121927	1336504438	1	0.02	0.00125	7355	1
3	Food 2	Intake 4	152	122250	1336504761	/users/cn/jespinosa/phecomp/data/CRG/20120502_FDF_CRG/20120502_FDF_CRG/20120507_FDF_CRG_c12.mtb	1456	991	WWSS	food_sc	4	122098	1336504609	1	0.04	0.000263157894736842	7356	1
3	Drink 2	Intake 2	12	122258	1336504769	/users/cn/jespinosa/phecomp/data/CRG/20120502_FDF_CRG/20120502_FDF_CRG/20120507_FDF_CRG_c12.mtb	1613	NA	WWSS	water	2	122246	1336504757	1	0.04	0.00333333333333333	7357	1
3	Drink 1	Intake 1	26	123076	1336505587	/users/cn/jespinosa/phecomp/data/CRG/20120502_FDF_CRG/20120502_FDF_CRG/20120507_FDF_CRG_c12.mtb	373	NA	WWSS	water	1	123050	1336505561	1	0.0600000000000001	0.00230769230769231	7358	1
3	Drink 2	Intake 2	25	123117	1336505628	/users/cn/jespinosa/phecomp/data/CRG/20120502_FDF_CRG/20120502_FDF_CRG/20120507_FDF_CRG_c12.mtb	1616	NA	WWSS	water	2	123092	1336505603	1	0.02	0.0008	7359	1
3	Food 2	Intake 4	803	124044	1336506555	/users/cn/jespinosa/phecomp/data/CRG/20120502_FDF_CRG/20120502_FDF_CRG/20120507_FDF_CRG_c12.mtb	1458	185	WWSS	food_sc	4	123241	1336505752	1	0.22	0.000273972602739726	7360	1
3	Drink 2	Intake 2	21	124061	1336506572	/users/cn/jespinosa/phecomp/data/CRG/20120502_FDF_CRG/20120502_FDF_CRG/20120507_FDF_CRG_c12.mtb	1618	NA	WWSS	water	2	124040	1336506551	1	0.0800000000000001	0.00380952380952381	7361	1
3	Drink 1	Intake 1	23	124109	1336506620	/users/cn/jespinosa/phecomp/data/CRG/20120502_FDF_CRG/20120502_FDF_CRG/20120507_FDF_CRG_c12.mtb	374	NA	WWSS	water	1	124086	1336506597	1	0.02	0.000869565217391304	7362	1
3	Drink 2	Intake 2	12	124135	1336506646	/users/cn/jespinosa/phecomp/data/CRG/20120502_FDF_CRG/20120502_FDF_CRG/20120507_FDF_CRG_c12.mtb	1619	NA	WWSS	water	2	124123	1336506634	1	0.0399999999999996	0.0033333333333333	7363	1
3	Food 2	Intake 4	443	124672	1336507183	/users/cn/jespinosa/phecomp/data/CRG/20120502_FDF_CRG/20120502_FDF_CRG/20120507_FDF_CRG_c12.mtb	1460	1754	WWSS	food_sc	4	124229	1336506740	1	0.16	0.00036117381489842	7364	1
3	Drink 2	Intake 2	33	124703	1336507214	/users/cn/jespinosa/phecomp/data/CRG/20120502_FDF_CRG/20120502_FDF_CRG/20120507_FDF_CRG_c12.mtb	1620	NA	WWSS	water	2	124670	1336507181	1	0.12	0.00363636363636364	7365	1
3	Food 2	Intake 4	95	126521	1336509032	/users/cn/jespinosa/phecomp/data/CRG/20120502_FDF_CRG/20120502_FDF_CRG/20120507_FDF_CRG_c12.mtb	1461	47	WWSS	food_sc	4	126426	1336508937	1	0.02	0.000210526315789474	7366	1
3	Food 2	Intake 4	168	126736	1336509247	/users/cn/jespinosa/phecomp/data/CRG/20120502_FDF_CRG/20120502_FDF_CRG/20120507_FDF_CRG_c12.mtb	1462	19	WWSS	food_sc	4	126568	1336509079	1	0.0600000000000001	0.000357142857142858	7367	1
3	Food 2	Intake 4	358	127113	1336509624	/users/cn/jespinosa/phecomp/data/CRG/20120502_FDF_CRG/20120502_FDF_CRG/20120507_FDF_CRG_c12.mtb	1463	1602	WWSS	food_sc	4	126755	1336509266	1	0.18	0.000502793296089386	7368	1
3	Drink 2	Intake 2	33	127138	1336509649	/users/cn/jespinosa/phecomp/data/CRG/20120502_FDF_CRG/20120502_FDF_CRG/20120507_FDF_CRG_c12.mtb	1622	NA	WWSS	water	2	127105	1336509616	1	0.14	0.00424242424242424	7369	1
3	Drink 1	Intake 1	16	127218	1336509729	/users/cn/jespinosa/phecomp/data/CRG/20120502_FDF_CRG/20120502_FDF_CRG/20120507_FDF_CRG_c12.mtb	375	NA	WWSS	water	1	127202	1336509713	1	0.02	0.00125	7370	1
3	Drink 1	Intake 1	13	127243	1336509754	/users/cn/jespinosa/phecomp/data/CRG/20120502_FDF_CRG/20120502_FDF_CRG/20120507_FDF_CRG_c12.mtb	376	NA	WWSS	water	1	127230	1336509741	1	0.04	0.00307692307692308	7371	1
3	Drink 2	Intake 2	27	127653	1336510164	/users/cn/jespinosa/phecomp/data/CRG/20120502_FDF_CRG/20120502_FDF_CRG/20120507_FDF_CRG_c12.mtb	1624	NA	WWSS	water	2	127626	1336510137	1	0.0800000000000001	0.00296296296296297	7372	1
3	Food 2	Intake 4	445	129160	1336511671	/users/cn/jespinosa/phecomp/data/CRG/20120502_FDF_CRG/20120502_FDF_CRG/20120507_FDF_CRG_c12.mtb	1466	10	WWSS	food_sc	4	128715	1336511226	1	0.14	0.000314606741573034	7373	1
3	Food 2	Intake 4	170	129340	1336511851	/users/cn/jespinosa/phecomp/data/CRG/20120502_FDF_CRG/20120502_FDF_CRG/20120507_FDF_CRG_c12.mtb	1467	659	WWSS	food_sc	4	129170	1336511681	1	0.0800000000000001	0.000470588235294118	7374	1
3	Drink 2	Intake 2	27	129365	1336511876	/users/cn/jespinosa/phecomp/data/CRG/20120502_FDF_CRG/20120502_FDF_CRG/20120507_FDF_CRG_c12.mtb	1626	NA	WWSS	water	2	129338	1336511849	1	0.0600000000000001	0.00222222222222223	7375	1
3	Drink 2	Intake 2	14	129711	1336512222	/users/cn/jespinosa/phecomp/data/CRG/20120502_FDF_CRG/20120502_FDF_CRG/20120507_FDF_CRG_c12.mtb	1628	NA	WWSS	water	2	129697	1336512208	1	0.02	0.00142857142857143	7376	1
3	Drink 2	Intake 2	15	129788	1336512299	/users/cn/jespinosa/phecomp/data/CRG/20120502_FDF_CRG/20120502_FDF_CRG/20120507_FDF_CRG_c12.mtb	1629	NA	WWSS	water	2	129773	1336512284	1	0.0399999999999996	0.00266666666666664	7377	1
3	Drink 2	Intake 2	12	129983	1336512494	/users/cn/jespinosa/phecomp/data/CRG/20120502_FDF_CRG/20120502_FDF_CRG/20120507_FDF_CRG_c12.mtb	1630	NA	WWSS	water	2	129971	1336512482	1	0.0200000000000005	0.00166666666666671	7378	1
3	Food 2	Intake 4	152	130151	1336512662	/users/cn/jespinosa/phecomp/data/CRG/20120502_FDF_CRG/20120502_FDF_CRG/20120507_FDF_CRG_c12.mtb	1470	94	WWSS	food_sc	4	129999	1336512510	1	0.14	0.000921052631578947	7379	1
3	Food 2	Intake 4	17	130262	1336512773	/users/cn/jespinosa/phecomp/data/CRG/20120502_FDF_CRG/20120502_FDF_CRG/20120507_FDF_CRG_c12.mtb	1471	474	WWSS	food_sc	4	130245	1336512756	1	0.2	0.0117647058823529	7380	1
3	Drink 2	Intake 2	38	130665	1336513176	/users/cn/jespinosa/phecomp/data/CRG/20120502_FDF_CRG/20120502_FDF_CRG/20120507_FDF_CRG_c12.mtb	1632	NA	WWSS	water	2	130627	1336513138	1	0.0600000000000001	0.00157894736842106	7381	1
3	Drink 2	Intake 2	17	130712	1336513223	/users/cn/jespinosa/phecomp/data/CRG/20120502_FDF_CRG/20120502_FDF_CRG/20120507_FDF_CRG_c12.mtb	1633	NA	WWSS	water	2	130695	1336513206	1	0.02	0.00117647058823529	7382	1
3	Food 1	Intake 3	47	130783	1336513294	/users/cn/jespinosa/phecomp/data/CRG/20120502_FDF_CRG/20120502_FDF_CRG/20120507_FDF_CRG_c12.mtb	971	1825	WWSS	food_sc	3	130736	1336513247	1	0.02	0.000425531914893617	7383	1
3	Drink 2	Intake 2	27	131033	1336513544	/users/cn/jespinosa/phecomp/data/CRG/20120502_FDF_CRG/20120502_FDF_CRG/20120507_FDF_CRG_c12.mtb	1635	NA	WWSS	water	2	131006	1336513517	1	0.0600000000000001	0.00222222222222223	7384	1
3	Drink 2	Intake 2	20	131478	1336513989	/users/cn/jespinosa/phecomp/data/CRG/20120502_FDF_CRG/20120502_FDF_CRG/20120507_FDF_CRG_c12.mtb	1637	NA	WWSS	water	2	131458	1336513969	1	0.04	0.002	7385	1
3	Drink 1	Intake 1	22	132502	1336515013	/users/cn/jespinosa/phecomp/data/CRG/20120502_FDF_CRG/20120502_FDF_CRG/20120507_FDF_CRG_c12.mtb	381	NA	WWSS	water	1	132480	1336514991	1	0.0599999999999998	0.00272727272727272	7386	1
3	Food 2	Intake 4	87	132695	1336515206	/users/cn/jespinosa/phecomp/data/CRG/20120502_FDF_CRG/20120502_FDF_CRG/20120507_FDF_CRG_c12.mtb	1478	2310	WWSS	food_sc	4	132608	1336515119	1	0.0200000000000005	0.00022988505747127	7387	1
3	Drink 2	Intake 2	17	132859	1336515370	/users/cn/jespinosa/phecomp/data/CRG/20120502_FDF_CRG/20120502_FDF_CRG/20120507_FDF_CRG_c12.mtb	1639	NA	WWSS	water	2	132842	1336515353	1	0.02	0.00117647058823529	7388	1
3	Food 1	Intake 3	240	135245	1336517756	/users/cn/jespinosa/phecomp/data/CRG/20120502_FDF_CRG/20120502_FDF_CRG/20120507_FDF_CRG_c12.mtb	975	6	WWSS	food_sc	3	135005	1336517516	1	0.0800000000000001	0.000333333333333334	7389	1
3	Food 1	Intake 3	221	135472	1336517983	/users/cn/jespinosa/phecomp/data/CRG/20120502_FDF_CRG/20120502_FDF_CRG/20120507_FDF_CRG_c12.mtb	976	267	WWSS	food_sc	3	135251	1336517762	1	0.0799999999999996	0.000361990950226243	7390	1
3	Drink 2	Intake 2	17	135493	1336518004	/users/cn/jespinosa/phecomp/data/CRG/20120502_FDF_CRG/20120502_FDF_CRG/20120507_FDF_CRG_c12.mtb	1640	NA	WWSS	water	2	135476	1336517987	1	0.02	0.00117647058823529	7391	1
3	Drink 2	Intake 2	13	135618	1336518129	/users/cn/jespinosa/phecomp/data/CRG/20120502_FDF_CRG/20120502_FDF_CRG/20120507_FDF_CRG_c12.mtb	1643	NA	WWSS	water	2	135605	1336518116	1	0.04	0.00307692307692308	7392	1
3	Drink 2	Intake 2	40	135716	1336518227	/users/cn/jespinosa/phecomp/data/CRG/20120502_FDF_CRG/20120502_FDF_CRG/20120507_FDF_CRG_c12.mtb	1644	NA	WWSS	water	2	135676	1336518187	1	0.02	0.0005	7393	1
3	Food 1	Intake 3	81	135820	1336518331	/users/cn/jespinosa/phecomp/data/CRG/20120502_FDF_CRG/20120502_FDF_CRG/20120507_FDF_CRG_c12.mtb	978	335	WWSS	food_sc	3	135739	1336518250	1	0.0200000000000005	0.00024691358024692	7394	1
3	Drink 1	Intake 1	17	135940	1336518451	/users/cn/jespinosa/phecomp/data/CRG/20120502_FDF_CRG/20120502_FDF_CRG/20120507_FDF_CRG_c12.mtb	383	NA	WWSS	water	1	135923	1336518434	1	0.02	0.00117647058823529	7395	1
3	Drink 2	Intake 2	27	136077	1336518588	/users/cn/jespinosa/phecomp/data/CRG/20120502_FDF_CRG/20120502_FDF_CRG/20120507_FDF_CRG_c12.mtb	1646	NA	WWSS	water	2	136050	1336518561	1	0.0600000000000001	0.00222222222222223	7396	1
3	Food 1	Intake 3	468	136623	1336519134	/users/cn/jespinosa/phecomp/data/CRG/20120502_FDF_CRG/20120502_FDF_CRG/20120507_FDF_CRG_c12.mtb	979	99	WWSS	food_sc	3	136155	1336518666	1	0.18	0.000384615384615385	7397	1
3	Drink 2	Intake 2	39	136664	1336519175	/users/cn/jespinosa/phecomp/data/CRG/20120502_FDF_CRG/20120502_FDF_CRG/20120507_FDF_CRG_c12.mtb	1647	NA	WWSS	water	2	136625	1336519136	1	0.0600000000000001	0.00153846153846154	7398	1
3	Food 1	Intake 3	121	136843	1336519354	/users/cn/jespinosa/phecomp/data/CRG/20120502_FDF_CRG/20120502_FDF_CRG/20120507_FDF_CRG_c12.mtb	980	3283	WWSS	food_sc	3	136722	1336519233	1	0.04	0.000330578512396694	7399	1
3	Drink 2	Intake 2	25	136901	1336519412	/users/cn/jespinosa/phecomp/data/CRG/20120502_FDF_CRG/20120502_FDF_CRG/20120507_FDF_CRG_c12.mtb	1648	NA	WWSS	water	2	136876	1336519387	1	0.0999999999999996	0.00399999999999998	7400	1
3	Food 1	Intake 3	324	140450	1336522961	/users/cn/jespinosa/phecomp/data/CRG/20120502_FDF_CRG/20120502_FDF_CRG/20120507_FDF_CRG_c12.mtb	983	48	WWSS	food_sc	3	140126	1336522637	1	0.04	0.000123456790123457	7401	1
3	Food 1	Intake 3	359	140857	1336523368	/users/cn/jespinosa/phecomp/data/CRG/20120502_FDF_CRG/20120502_FDF_CRG/20120507_FDF_CRG_c12.mtb	984	1010	WWSS	food_sc	3	140498	1336523009	1	0.0800000000000001	0.000222841225626741	7402	1
3	Drink 2	Intake 2	13	140879	1336523390	/users/cn/jespinosa/phecomp/data/CRG/20120502_FDF_CRG/20120502_FDF_CRG/20120507_FDF_CRG_c12.mtb	1649	NA	WWSS	water	2	140866	1336523377	1	0.0200000000000005	0.00153846153846158	7403	1
3	Drink 2	Intake 2	45	141166	1336523677	/users/cn/jespinosa/phecomp/data/CRG/20120502_FDF_CRG/20120502_FDF_CRG/20120507_FDF_CRG_c12.mtb	1651	NA	WWSS	water	2	141121	1336523632	1	0.0600000000000001	0.00133333333333334	7404	1
3	Drink 1	Intake 1	17	141706	1336524217	/users/cn/jespinosa/phecomp/data/CRG/20120502_FDF_CRG/20120502_FDF_CRG/20120507_FDF_CRG_c12.mtb	385	NA	WWSS	water	1	141689	1336524200	1	0.02	0.00117647058823529	7405	1
3	Drink 2	Intake 2	23	141806	1336524317	/users/cn/jespinosa/phecomp/data/CRG/20120502_FDF_CRG/20120502_FDF_CRG/20120507_FDF_CRG_c12.mtb	1652	NA	WWSS	water	2	141783	1336524294	1	0.04	0.00173913043478261	7406	1
3	Food 1	Intake 3	510	142377	1336524888	/users/cn/jespinosa/phecomp/data/CRG/20120502_FDF_CRG/20120502_FDF_CRG/20120507_FDF_CRG_c12.mtb	987	914	WWSS	food_sc	3	141867	1336524378	1	0.16	0.000313725490196078	7407	1
3	Drink 2	Intake 2	27	142416	1336524927	/users/cn/jespinosa/phecomp/data/CRG/20120502_FDF_CRG/20120502_FDF_CRG/20120507_FDF_CRG_c12.mtb	1653	NA	WWSS	water	2	142389	1336524900	1	0.0800000000000001	0.00296296296296297	7408	1
3	Drink 2	Intake 2	16	142919	1336525430	/users/cn/jespinosa/phecomp/data/CRG/20120502_FDF_CRG/20120502_FDF_CRG/20120507_FDF_CRG_c12.mtb	1654	NA	WWSS	water	2	142903	1336525414	1	0.02	0.00125	7409	1
3	Drink 2	Intake 2	20	143101	1336525612	/users/cn/jespinosa/phecomp/data/CRG/20120502_FDF_CRG/20120502_FDF_CRG/20120507_FDF_CRG_c12.mtb	1655	NA	WWSS	water	2	143081	1336525592	1	0.02	0.001	7410	1
3	Food 1	Intake 3	407	143698	1336526209	/users/cn/jespinosa/phecomp/data/CRG/20120502_FDF_CRG/20120502_FDF_CRG/20120507_FDF_CRG_c12.mtb	991	903	WWSS	food_sc	3	143291	1336525802	1	0.12	0.000294840294840295	7411	1
3	Drink 2	Intake 2	25	143722	1336526233	/users/cn/jespinosa/phecomp/data/CRG/20120502_FDF_CRG/20120502_FDF_CRG/20120507_FDF_CRG_c12.mtb	1656	NA	WWSS	water	2	143697	1336526208	1	0.0800000000000001	0.0032	7412	1
3	Drink 2	Intake 2	17	144163	1336526674	/users/cn/jespinosa/phecomp/data/CRG/20120502_FDF_CRG/20120502_FDF_CRG/20120507_FDF_CRG_c12.mtb	1657	NA	WWSS	water	2	144146	1336526657	1	0.02	0.00117647058823529	7413	1
3	Food 2	Intake 4	201	144802	1336527313	/users/cn/jespinosa/phecomp/data/CRG/20120502_FDF_CRG/20120502_FDF_CRG/20120507_FDF_CRG_c12.mtb	1498	6344	WWSS	food_sc	4	144601	1336527112	1	0.04	0.000199004975124378	7414	1
3	Drink 2	Intake 2	23	145741	1336528252	/users/cn/jespinosa/phecomp/data/CRG/20120502_FDF_CRG/20120502_FDF_CRG/20120507_FDF_CRG_c12.mtb	1658	NA	WWSS	water	2	145718	1336528229	1	0.02	0.000869565217391304	7415	1
3	Food 1	Intake 3	652	151798	1336534309	/users/cn/jespinosa/phecomp/data/CRG/20120502_FDF_CRG/20120502_FDF_CRG/20120507_FDF_CRG_c12.mtb	997	333	WWSS	food_sc	3	151146	1336533657	1	0.24	0.000368098159509202	7416	1
3	Drink 2	Intake 2	38	151843	1336534354	/users/cn/jespinosa/phecomp/data/CRG/20120502_FDF_CRG/20120502_FDF_CRG/20120507_FDF_CRG_c12.mtb	1660	NA	WWSS	water	2	151805	1336534316	1	0.0600000000000001	0.00157894736842106	7417	1
3	Drink 2	Intake 2	21	151870	1336534381	/users/cn/jespinosa/phecomp/data/CRG/20120502_FDF_CRG/20120502_FDF_CRG/20120507_FDF_CRG_c12.mtb	1661	NA	WWSS	water	2	151849	1336534360	1	0.0599999999999996	0.00285714285714284	7418	1
3	Food 1	Intake 3	160	152291	1336534802	/users/cn/jespinosa/phecomp/data/CRG/20120502_FDF_CRG/20120502_FDF_CRG/20120507_FDF_CRG_c12.mtb	999	2978	WWSS	food_sc	3	152131	1336534642	1	0.0600000000000001	0.000375000000000001	7419	1
3	Drink 2	Intake 2	30	152321	1336534832	/users/cn/jespinosa/phecomp/data/CRG/20120502_FDF_CRG/20120502_FDF_CRG/20120507_FDF_CRG_c12.mtb	1662	NA	WWSS	water	2	152291	1336534802	1	0.1	0.00333333333333333	7420	1
3	Drink 1	Intake 1	11	153404	1336535915	/users/cn/jespinosa/phecomp/data/CRG/20120502_FDF_CRG/20120502_FDF_CRG/20120507_FDF_CRG_c12.mtb	391	NA	WWSS	water	1	153393	1336535904	1	0.02	0.00181818181818182	7421	1
3	Food 1	Intake 3	177	155446	1336537957	/users/cn/jespinosa/phecomp/data/CRG/20120502_FDF_CRG/20120502_FDF_CRG/20120507_FDF_CRG_c12.mtb	1001	497	WWSS	food_sc	3	155269	1336537780	1	0.0999999999999996	0.000564971751412427	7422	1
3	Drink 2	Intake 2	11	155570	1336538081	/users/cn/jespinosa/phecomp/data/CRG/20120502_FDF_CRG/20120502_FDF_CRG/20120507_FDF_CRG_c12.mtb	1663	NA	WWSS	water	2	155559	1336538070	1	0.02	0.00181818181818182	7423	1
3	Food 1	Intake 3	274	156217	1336538728	/users/cn/jespinosa/phecomp/data/CRG/20120502_FDF_CRG/20120502_FDF_CRG/20120507_FDF_CRG_c12.mtb	1004	1644	WWSS	food_sc	3	155943	1336538454	1	0.12	0.000437956204379562	7424	1
3	Drink 2	Intake 2	21	156306	1336538817	/users/cn/jespinosa/phecomp/data/CRG/20120502_FDF_CRG/20120502_FDF_CRG/20120507_FDF_CRG_c12.mtb	1664	NA	WWSS	water	2	156285	1336538796	1	0.0800000000000001	0.00380952380952381	7425	1
3	Drink 1	Intake 1	10	157458	1336539969	/users/cn/jespinosa/phecomp/data/CRG/20120502_FDF_CRG/20120502_FDF_CRG/20120507_FDF_CRG_c12.mtb	393	NA	WWSS	water	1	157448	1336539959	1	0.04	0.004	7426	1
3	Food 1	Intake 3	32	157893	1336540404	/users/cn/jespinosa/phecomp/data/CRG/20120502_FDF_CRG/20120502_FDF_CRG/20120507_FDF_CRG_c12.mtb	1006	88	WWSS	food_sc	3	157861	1336540372	1	0.02	0.000625	7427	1
3	Food 1	Intake 3	318	158299	1336540810	/users/cn/jespinosa/phecomp/data/CRG/20120502_FDF_CRG/20120502_FDF_CRG/20120507_FDF_CRG_c12.mtb	1008	1500	WWSS	food_sc	3	157981	1336540492	1	0.16	0.00050314465408805	7428	1
3	Drink 2	Intake 2	20	158358	1336540869	/users/cn/jespinosa/phecomp/data/CRG/20120502_FDF_CRG/20120502_FDF_CRG/20120507_FDF_CRG_c12.mtb	1665	NA	WWSS	water	2	158338	1336540849	1	0.02	0.001	7429	1
3	Drink 2	Intake 2	17	158512	1336541023	/users/cn/jespinosa/phecomp/data/CRG/20120502_FDF_CRG/20120502_FDF_CRG/20120507_FDF_CRG_c12.mtb	1666	NA	WWSS	water	2	158495	1336541006	1	0.0600000000000001	0.00352941176470589	7430	1
3	Drink 2	Intake 2	16	158983	1336541494	/users/cn/jespinosa/phecomp/data/CRG/20120502_FDF_CRG/20120502_FDF_CRG/20120507_FDF_CRG_c12.mtb	1667	NA	WWSS	water	2	158967	1336541478	1	0.0599999999999996	0.00374999999999998	7431	1
3	Food 1	Intake 3	58	159857	1336542368	/users/cn/jespinosa/phecomp/data/CRG/20120502_FDF_CRG/20120502_FDF_CRG/20120507_FDF_CRG_c12.mtb	1009	11860	WWSS	food_sc	3	159799	1336542310	1	0.300000000000001	0.00517241379310347	7432	1
3	Drink 2	Intake 2	22	160279	1336542790	/users/cn/jespinosa/phecomp/data/CRG/20120502_FDF_CRG/20120502_FDF_CRG/20120507_FDF_CRG_c12.mtb	1669	NA	WWSS	water	2	160257	1336542768	1	0.100000000000001	0.00454545454545459	7433	1
3	Drink 2	Intake 2	25	160980	1336543491	/users/cn/jespinosa/phecomp/data/CRG/20120502_FDF_CRG/20120502_FDF_CRG/20120507_FDF_CRG_c12.mtb	1672	NA	WWSS	water	2	160955	1336543466	1	0.0800000000000001	0.0032	7434	1
3	Food 1	Intake 3	135	675	1336554363	/users/cn/jespinosa/phecomp/data/CRG/20120502_FDF_CRG/20120502_FDF_CRG/20120509_FDF_CRG_c12.mtb	1260	209	WWSS	food_sc	3	540	1336554228	1	0.04	0.000296296296296296	7435	1
3	Food 2	Intake 4	99	983	1336554671	/users/cn/jespinosa/phecomp/data/CRG/20120502_FDF_CRG/20120502_FDF_CRG/20120509_FDF_CRG_c12.mtb	1832	3346	WWSS	food_sc	4	884	1336554572	1	0.02	0.000202020202020202	7436	1
3	Drink 1	Intake 1	21	1175	1336554863	/users/cn/jespinosa/phecomp/data/CRG/20120502_FDF_CRG/20120502_FDF_CRG/20120509_FDF_CRG_c12.mtb	518	NA	WWSS	water	1	1154	1336554842	1	0.04	0.0019047619047619	7437	1
3	Food 1	Intake 3	150	4479	1336558167	/users/cn/jespinosa/phecomp/data/CRG/20120502_FDF_CRG/20120502_FDF_CRG/20120509_FDF_CRG_c12.mtb	1264	14	WWSS	food_sc	3	4329	1336558017	1	0.08	0.000533333333333333	7438	1
3	Food 1	Intake 3	65	4558	1336558246	/users/cn/jespinosa/phecomp/data/CRG/20120502_FDF_CRG/20120502_FDF_CRG/20120509_FDF_CRG_c12.mtb	1265	3221	WWSS	food_sc	3	4493	1336558181	1	0.02	0.000307692307692308	7439	1
3	Drink 2	Intake 2	17	5695	1336559383	/users/cn/jespinosa/phecomp/data/CRG/20120502_FDF_CRG/20120502_FDF_CRG/20120509_FDF_CRG_c12.mtb	1787	NA	WWSS	water	2	5678	1336559366	1	0.02	0.00117647058823529	7440	1
3	Drink 1	Intake 1	22	5738	1336559426	/users/cn/jespinosa/phecomp/data/CRG/20120502_FDF_CRG/20120502_FDF_CRG/20120509_FDF_CRG_c12.mtb	520	NA	WWSS	water	1	5716	1336559404	1	0.06	0.00272727272727273	7441	1
3	Food 1	Intake 3	77	7856	1336561544	/users/cn/jespinosa/phecomp/data/CRG/20120502_FDF_CRG/20120502_FDF_CRG/20120509_FDF_CRG_c12.mtb	1267	13	WWSS	food_sc	3	7779	1336561467	1	0.04	0.000519480519480519	7442	1
3	Food 1	Intake 3	63	7932	1336561620	/users/cn/jespinosa/phecomp/data/CRG/20120502_FDF_CRG/20120502_FDF_CRG/20120509_FDF_CRG_c12.mtb	1268	44	WWSS	food_sc	3	7869	1336561557	1	0.06	0.000952380952380952	7443	1
3	Food 1	Intake 3	96	8072	1336561760	/users/cn/jespinosa/phecomp/data/CRG/20120502_FDF_CRG/20120502_FDF_CRG/20120509_FDF_CRG_c12.mtb	1269	COLL	WWSS	food_sc	3	7976	1336561664	1	0.02	0.000208333333333333	7444	1
3	Food 2	Intake 4	70	8135	1336561823	/users/cn/jespinosa/phecomp/data/CRG/20120502_FDF_CRG/20120502_FDF_CRG/20120509_FDF_CRG_c12.mtb	1833	11041	WWSS	food_sc	4	8065	1336561753	1	0.04	0.000571428571428571	7445	1
3	Food 1	Intake 3	197	19373	1336573061	/users/cn/jespinosa/phecomp/data/CRG/20120502_FDF_CRG/20120502_FDF_CRG/20120509_FDF_CRG_c12.mtb	1271	9992	WWSS	food_sc	3	19176	1336572864	1	0.02	0.000101522842639594	7446	1
3	Food 1	Intake 3	324	29689	1336583377	/users/cn/jespinosa/phecomp/data/CRG/20120502_FDF_CRG/20120502_FDF_CRG/20120509_FDF_CRG_c12.mtb	1273	3032	WWSS	food_sc	3	29365	1336583053	1	0.08	0.000246913580246914	7447	1
3	Food 1	Intake 3	295	33016	1336586704	/users/cn/jespinosa/phecomp/data/CRG/20120502_FDF_CRG/20120502_FDF_CRG/20120509_FDF_CRG_c12.mtb	1274	7	WWSS	food_sc	3	32721	1336586409	1	0.06	0.000203389830508475	7448	1
3	Food 1	Intake 3	118	33141	1336586829	/users/cn/jespinosa/phecomp/data/CRG/20120502_FDF_CRG/20120502_FDF_CRG/20120509_FDF_CRG_c12.mtb	1275	1576	WWSS	food_sc	3	33023	1336586711	1	0.06	0.000508474576271186	7449	1
3	Drink 1	Intake 1	14	33818	1336587506	/users/cn/jespinosa/phecomp/data/CRG/20120502_FDF_CRG/20120502_FDF_CRG/20120509_FDF_CRG_c12.mtb	522	NA	WWSS	water	1	33804	1336587492	1	0.08	0.00571428571428571	7450	1
3	Food 1	Intake 3	293	35010	1336588698	/users/cn/jespinosa/phecomp/data/CRG/20120502_FDF_CRG/20120502_FDF_CRG/20120509_FDF_CRG_c12.mtb	1276	1035	WWSS	food_sc	3	34717	1336588405	1	0.1	0.000341296928327645	7451	1
3	Food 2	Intake 4	232	36277	1336589965	/users/cn/jespinosa/phecomp/data/CRG/20120502_FDF_CRG/20120502_FDF_CRG/20120509_FDF_CRG_c12.mtb	1840	1224	WWSS	food_sc	4	36045	1336589733	1	0.14	0.000603448275862069	7452	1
3	Drink 2	Intake 2	28	36312	1336590000	/users/cn/jespinosa/phecomp/data/CRG/20120502_FDF_CRG/20120502_FDF_CRG/20120509_FDF_CRG_c12.mtb	1793	NA	WWSS	water	2	36284	1336589972	1	0.06	0.00214285714285714	7453	1
3	Drink 2	Intake 2	17	36376	1336590064	/users/cn/jespinosa/phecomp/data/CRG/20120502_FDF_CRG/20120502_FDF_CRG/20120509_FDF_CRG_c12.mtb	1794	NA	WWSS	water	2	36359	1336590047	1	0.02	0.00117647058823529	7454	1
3	Drink 1	Intake 1	19	37044	1336590732	/users/cn/jespinosa/phecomp/data/CRG/20120502_FDF_CRG/20120502_FDF_CRG/20120509_FDF_CRG_c12.mtb	524	NA	WWSS	water	1	37025	1336590713	1	0.06	0.00315789473684211	7455	1
3	Food 2	Intake 4	184	37685	1336591373	/users/cn/jespinosa/phecomp/data/CRG/20120502_FDF_CRG/20120502_FDF_CRG/20120509_FDF_CRG_c12.mtb	1841	97	WWSS	food_sc	4	37501	1336591189	1	0.06	0.000326086956521739	7456	1
3	Drink 1	Intake 1	15	37778	1336591466	/users/cn/jespinosa/phecomp/data/CRG/20120502_FDF_CRG/20120502_FDF_CRG/20120509_FDF_CRG_c12.mtb	525	NA	WWSS	water	1	37763	1336591451	1	0.02	0.00133333333333333	7457	1
3	Food 2	Intake 4	92	37874	1336591562	/users/cn/jespinosa/phecomp/data/CRG/20120502_FDF_CRG/20120502_FDF_CRG/20120509_FDF_CRG_c12.mtb	1842	27	WWSS	food_sc	4	37782	1336591470	1	0.04	0.000434782608695652	7458	1
3	Food 1	Intake 3	79	37980	1336591668	/users/cn/jespinosa/phecomp/data/CRG/20120502_FDF_CRG/20120502_FDF_CRG/20120509_FDF_CRG_c12.mtb	1277	1379	WWSS	food_sc	3	37901	1336591589	1	0.02	0.000253164556962025	7459	1
3	Drink 2	Intake 2	17	38815	1336592503	/users/cn/jespinosa/phecomp/data/CRG/20120502_FDF_CRG/20120502_FDF_CRG/20120509_FDF_CRG_c12.mtb	1799	NA	WWSS	water	2	38798	1336592486	1	0.08	0.00470588235294118	7460	1
3	Food 2	Intake 4	300	39659	1336593347	/users/cn/jespinosa/phecomp/data/CRG/20120502_FDF_CRG/20120502_FDF_CRG/20120509_FDF_CRG_c12.mtb	1845	1121	WWSS	food_sc	4	39359	1336593047	1	0.14	0.000466666666666667	7461	1
3	Drink 2	Intake 2	13	39693	1336593381	/users/cn/jespinosa/phecomp/data/CRG/20120502_FDF_CRG/20120502_FDF_CRG/20120509_FDF_CRG_c12.mtb	1800	NA	WWSS	water	2	39680	1336593368	1	0.04	0.00307692307692308	7462	1
3	Food 2	Intake 4	215	40995	1336594683	/users/cn/jespinosa/phecomp/data/CRG/20120502_FDF_CRG/20120502_FDF_CRG/20120509_FDF_CRG_c12.mtb	1848	1013	WWSS	food_sc	4	40780	1336594468	1	0.08	0.000372093023255814	7463	1
3	Drink 2	Intake 2	14	41033	1336594721	/users/cn/jespinosa/phecomp/data/CRG/20120502_FDF_CRG/20120502_FDF_CRG/20120509_FDF_CRG_c12.mtb	1810	NA	WWSS	water	2	41019	1336594707	1	0.04	0.00285714285714286	7464	1
3	Drink 1	Intake 1	25	41608	1336595296	/users/cn/jespinosa/phecomp/data/CRG/20120502_FDF_CRG/20120502_FDF_CRG/20120509_FDF_CRG_c12.mtb	527	NA	WWSS	water	1	41583	1336595271	1	0.08	0.0032	7465	1
3	Food 2	Intake 4	67	42075	1336595763	/users/cn/jespinosa/phecomp/data/CRG/20120502_FDF_CRG/20120502_FDF_CRG/20120509_FDF_CRG_c12.mtb	1849	4	WWSS	food_sc	4	42008	1336595696	1	0.04	0.000597014925373134	7466	1
3	Food 2	Intake 4	231	42310	1336595998	/users/cn/jespinosa/phecomp/data/CRG/20120502_FDF_CRG/20120502_FDF_CRG/20120509_FDF_CRG_c12.mtb	1850	604	WWSS	food_sc	4	42079	1336595767	1	0.12	0.000519480519480519	7467	1
3	Drink 2	Intake 2	25	42375	1336596063	/users/cn/jespinosa/phecomp/data/CRG/20120502_FDF_CRG/20120502_FDF_CRG/20120509_FDF_CRG_c12.mtb	1811	NA	WWSS	water	2	42350	1336596038	1	0.06	0.0024	7468	1
3	Food 2	Intake 4	207	43121	1336596809	/users/cn/jespinosa/phecomp/data/CRG/20120502_FDF_CRG/20120502_FDF_CRG/20120509_FDF_CRG_c12.mtb	1851	373	WWSS	food_sc	4	42914	1336596602	1	0.12	0.000579710144927536	7469	1
3	Drink 2	Intake 2	31	43223	1336596911	/users/cn/jespinosa/phecomp/data/CRG/20120502_FDF_CRG/20120502_FDF_CRG/20120509_FDF_CRG_c12.mtb	1814	NA	WWSS	water	2	43192	1336596880	1	0.08	0.00258064516129032	7470	1
3	Drink 2	Intake 2	23	43339	1336597027	/users/cn/jespinosa/phecomp/data/CRG/20120502_FDF_CRG/20120502_FDF_CRG/20120509_FDF_CRG_c12.mtb	1815	NA	WWSS	water	2	43316	1336597004	1	0.04	0.00173913043478261	7471	1
3	Food 2	Intake 4	130	43624	1336597312	/users/cn/jespinosa/phecomp/data/CRG/20120502_FDF_CRG/20120502_FDF_CRG/20120509_FDF_CRG_c12.mtb	1853	600	WWSS	food_sc	4	43494	1336597182	1	0.0399999999999999	0.000307692307692307	7472	1
3	Drink 1	Intake 1	16	43729	1336597417	/users/cn/jespinosa/phecomp/data/CRG/20120502_FDF_CRG/20120502_FDF_CRG/20120509_FDF_CRG_c12.mtb	530	NA	WWSS	water	1	43713	1336597401	1	0.02	0.00125	7473	1
3	Drink 2	Intake 2	22	43970	1336597658	/users/cn/jespinosa/phecomp/data/CRG/20120502_FDF_CRG/20120502_FDF_CRG/20120509_FDF_CRG_c12.mtb	1817	NA	WWSS	water	2	43948	1336597636	1	0.02	0.000909090909090909	7474	1
3	Drink 2	Intake 2	19	44114	1336597802	/users/cn/jespinosa/phecomp/data/CRG/20120502_FDF_CRG/20120502_FDF_CRG/20120509_FDF_CRG_c12.mtb	1818	NA	WWSS	water	2	44095	1336597783	1	0.04	0.00210526315789474	7475	1
3	Food 2	Intake 4	154	44378	1336598066	/users/cn/jespinosa/phecomp/data/CRG/20120502_FDF_CRG/20120502_FDF_CRG/20120509_FDF_CRG_c12.mtb	1854	547	WWSS	food_sc	4	44224	1336597912	1	0.02	0.00012987012987013	7476	1
3	Drink 1	Intake 1	20	44565	1336598253	/users/cn/jespinosa/phecomp/data/CRG/20120502_FDF_CRG/20120502_FDF_CRG/20120509_FDF_CRG_c12.mtb	532	NA	WWSS	water	1	44545	1336598233	1	0.06	0.003	7477	1
3	Food 2	Intake 4	262	45187	1336598875	/users/cn/jespinosa/phecomp/data/CRG/20120502_FDF_CRG/20120502_FDF_CRG/20120509_FDF_CRG_c12.mtb	1858	678	WWSS	food_sc	4	44925	1336598613	1	0.16	0.000610687022900763	7478	1
3	Drink 2	Intake 2	21	45251	1336598939	/users/cn/jespinosa/phecomp/data/CRG/20120502_FDF_CRG/20120502_FDF_CRG/20120509_FDF_CRG_c12.mtb	1819	NA	WWSS	water	2	45230	1336598918	1	0.04	0.0019047619047619	7479	1
3	Food 2	Intake 4	35	45900	1336599588	/users/cn/jespinosa/phecomp/data/CRG/20120502_FDF_CRG/20120502_FDF_CRG/20120509_FDF_CRG_c12.mtb	1860	741	WWSS	food_sc	4	45865	1336599553	1	0.02	0.000571428571428571	7480	1
3	Drink 2	Intake 2	13	46090	1336599778	/users/cn/jespinosa/phecomp/data/CRG/20120502_FDF_CRG/20120502_FDF_CRG/20120509_FDF_CRG_c12.mtb	1821	NA	WWSS	water	2	46077	1336599765	1	0.0399999999999999	0.00307692307692307	7481	1
3	Food 2	Intake 4	23	46664	1336600352	/users/cn/jespinosa/phecomp/data/CRG/20120502_FDF_CRG/20120502_FDF_CRG/20120509_FDF_CRG_c12.mtb	1861	3483	WWSS	food_sc	4	46641	1336600329	1	0.28	0.0121739130434783	7482	1
3	Drink 2	Intake 2	22	47074	1336600762	/users/cn/jespinosa/phecomp/data/CRG/20120502_FDF_CRG/20120502_FDF_CRG/20120509_FDF_CRG_c12.mtb	1825	NA	WWSS	water	2	47052	1336600740	1	0.04	0.00181818181818182	7483	1
3	Drink 2	Intake 2	18	47276	1336600964	/users/cn/jespinosa/phecomp/data/CRG/20120502_FDF_CRG/20120502_FDF_CRG/20120509_FDF_CRG_c12.mtb	1826	NA	WWSS	water	2	47258	1336600946	1	0.02	0.00111111111111111	7484	1
3	Drink 1	Intake 1	15	47334	1336601022	/users/cn/jespinosa/phecomp/data/CRG/20120502_FDF_CRG/20120502_FDF_CRG/20120509_FDF_CRG_c12.mtb	533	NA	WWSS	water	1	47319	1336601007	1	0.02	0.00133333333333333	7485	1
3	Drink 2	Intake 2	20	48815	1336602503	/users/cn/jespinosa/phecomp/data/CRG/20120502_FDF_CRG/20120502_FDF_CRG/20120509_FDF_CRG_c12.mtb	1827	NA	WWSS	water	2	48795	1336602483	1	0.02	0.001	7486	1
3	Food 2	Intake 4	15	50162	1336603850	/users/cn/jespinosa/phecomp/data/CRG/20120502_FDF_CRG/20120502_FDF_CRG/20120509_FDF_CRG_c12.mtb	1863	793	WWSS	food_sc	4	50147	1336603835	1	0.02	0.00133333333333333	7487	1
3	Food 1	Intake 3	32	50987	1336604675	/users/cn/jespinosa/phecomp/data/CRG/20120502_FDF_CRG/20120502_FDF_CRG/20120509_FDF_CRG_c12.mtb	1284	1662	WWSS	food_sc	3	50955	1336604643	1	0.02	0.000625	7488	1
3	Drink 1	Intake 1	18	51397	1336605085	/users/cn/jespinosa/phecomp/data/CRG/20120502_FDF_CRG/20120502_FDF_CRG/20120509_FDF_CRG_c12.mtb	534	NA	WWSS	water	1	51379	1336605067	1	0.04	0.00222222222222222	7489	1
3	Drink 1	Intake 1	15	52165	1336605853	/users/cn/jespinosa/phecomp/data/CRG/20120502_FDF_CRG/20120502_FDF_CRG/20120509_FDF_CRG_c12.mtb	536	NA	WWSS	water	1	52150	1336605838	1	0.0600000000000001	0.00400000000000001	7490	1
3	Food 2	Intake 4	82	52731	1336606419	/users/cn/jespinosa/phecomp/data/CRG/20120502_FDF_CRG/20120502_FDF_CRG/20120509_FDF_CRG_c12.mtb	1875	2008	WWSS	food_sc	4	52649	1336606337	1	0.02	0.00024390243902439	7491	1
3	Drink 2	Intake 2	28	54414	1336608102	/users/cn/jespinosa/phecomp/data/CRG/20120502_FDF_CRG/20120502_FDF_CRG/20120509_FDF_CRG_c12.mtb	1833	NA	WWSS	water	2	54386	1336608074	1	0.02	0.000714285714285714	7492	1
3	Food 2	Intake 4	106	54845	1336608533	/users/cn/jespinosa/phecomp/data/CRG/20120502_FDF_CRG/20120502_FDF_CRG/20120509_FDF_CRG_c12.mtb	1882	1339	WWSS	food_sc	4	54739	1336608427	1	0.02	0.000188679245283019	7493	1
3	Food 2	Intake 4	321	56505	1336610193	/users/cn/jespinosa/phecomp/data/CRG/20120502_FDF_CRG/20120502_FDF_CRG/20120509_FDF_CRG_c12.mtb	1892	1425	WWSS	food_sc	4	56184	1336609872	1	0.02	6.23052959501558e-05	7494	1
3	Food 2	Intake 4	417	58347	1336612035	/users/cn/jespinosa/phecomp/data/CRG/20120502_FDF_CRG/20120502_FDF_CRG/20120509_FDF_CRG_c12.mtb	1898	25	WWSS	food_sc	4	57930	1336611618	1	0.12	0.000287769784172662	7495	1
3	Food 2	Intake 4	81	58453	1336612141	/users/cn/jespinosa/phecomp/data/CRG/20120502_FDF_CRG/20120502_FDF_CRG/20120509_FDF_CRG_c12.mtb	1899	5436	WWSS	food_sc	4	58372	1336612060	1	0.04	0.000493827160493827	7496	1
3	Drink 2	Intake 2	33	58488	1336612176	/users/cn/jespinosa/phecomp/data/CRG/20120502_FDF_CRG/20120502_FDF_CRG/20120509_FDF_CRG_c12.mtb	1848	NA	WWSS	water	2	58455	1336612143	1	0.14	0.00424242424242424	7497	1
3	Drink 1	Intake 1	15	58539	1336612227	/users/cn/jespinosa/phecomp/data/CRG/20120502_FDF_CRG/20120502_FDF_CRG/20120509_FDF_CRG_c12.mtb	540	NA	WWSS	water	1	58524	1336612212	1	0.02	0.00133333333333333	7498	1
3	Drink 2	Intake 2	33	58713	1336612401	/users/cn/jespinosa/phecomp/data/CRG/20120502_FDF_CRG/20120502_FDF_CRG/20120509_FDF_CRG_c12.mtb	1849	NA	WWSS	water	2	58680	1336612368	1	0.02	0.000606060606060606	7499	1
3	Food 2	Intake 4	339	64228	1336617916	/users/cn/jespinosa/phecomp/data/CRG/20120502_FDF_CRG/20120502_FDF_CRG/20120509_FDF_CRG_c12.mtb	1906	223	WWSS	food_sc	4	63889	1336617577	1	0.14	0.000412979351032448	7500	1
3	Drink 2	Intake 2	16	64397	1336618085	/users/cn/jespinosa/phecomp/data/CRG/20120502_FDF_CRG/20120502_FDF_CRG/20120509_FDF_CRG_c12.mtb	1850	NA	WWSS	water	2	64381	1336618069	1	0.04	0.0025	7501	1
3	Food 2	Intake 4	66	64517	1336618205	/users/cn/jespinosa/phecomp/data/CRG/20120502_FDF_CRG/20120502_FDF_CRG/20120509_FDF_CRG_c12.mtb	1908	2332	WWSS	food_sc	4	64451	1336618139	1	0.02	0.000303030303030303	7502	1
3	Drink 2	Intake 2	38	64687	1336618375	/users/cn/jespinosa/phecomp/data/CRG/20120502_FDF_CRG/20120502_FDF_CRG/20120509_FDF_CRG_c12.mtb	1851	NA	WWSS	water	2	64649	1336618337	1	0.0599999999999999	0.00157894736842105	7503	1
3	Drink 2	Intake 2	18	65007	1336618695	/users/cn/jespinosa/phecomp/data/CRG/20120502_FDF_CRG/20120502_FDF_CRG/20120509_FDF_CRG_c12.mtb	1852	NA	WWSS	water	2	64989	1336618677	1	0.04	0.00222222222222222	7504	1
3	Drink 1	Intake 1	13	65809	1336619497	/users/cn/jespinosa/phecomp/data/CRG/20120502_FDF_CRG/20120502_FDF_CRG/20120509_FDF_CRG_c12.mtb	544	NA	WWSS	water	1	65796	1336619484	1	0.1	0.00769230769230769	7505	1
3	Food 2	Intake 4	47	66896	1336620584	/users/cn/jespinosa/phecomp/data/CRG/20120502_FDF_CRG/20120502_FDF_CRG/20120509_FDF_CRG_c12.mtb	1911	256	WWSS	food_sc	4	66849	1336620537	1	0.02	0.000425531914893617	7506	1
3	Food 2	Intake 4	196	67348	1336621036	/users/cn/jespinosa/phecomp/data/CRG/20120502_FDF_CRG/20120502_FDF_CRG/20120509_FDF_CRG_c12.mtb	1913	9	WWSS	food_sc	4	67152	1336620840	1	0.0999999999999999	0.000510204081632653	7507	1
3	Food 2	Intake 4	132	67489	1336621177	/users/cn/jespinosa/phecomp/data/CRG/20120502_FDF_CRG/20120502_FDF_CRG/20120509_FDF_CRG_c12.mtb	1914	1665	WWSS	food_sc	4	67357	1336621045	1	0.04	0.000303030303030303	7508	1
3	Drink 2	Intake 2	19	67508	1336621196	/users/cn/jespinosa/phecomp/data/CRG/20120502_FDF_CRG/20120502_FDF_CRG/20120509_FDF_CRG_c12.mtb	1853	NA	WWSS	water	2	67489	1336621177	1	0.04	0.00210526315789474	7509	1
3	Drink 2	Intake 2	14	67576	1336621264	/users/cn/jespinosa/phecomp/data/CRG/20120502_FDF_CRG/20120502_FDF_CRG/20120509_FDF_CRG_c12.mtb	1854	NA	WWSS	water	2	67562	1336621250	1	0.02	0.00142857142857143	7510	1
3	Drink 2	Intake 2	20	68174	1336621862	/users/cn/jespinosa/phecomp/data/CRG/20120502_FDF_CRG/20120502_FDF_CRG/20120509_FDF_CRG_c12.mtb	1855	NA	WWSS	water	2	68154	1336621842	1	0.02	0.001	7511	1
3	Drink 2	Intake 2	25	68649	1336622337	/users/cn/jespinosa/phecomp/data/CRG/20120502_FDF_CRG/20120502_FDF_CRG/20120509_FDF_CRG_c12.mtb	1856	NA	WWSS	water	2	68624	1336622312	1	0.02	0.0008	7512	1
3	Food 2	Intake 4	165	69319	1336623007	/users/cn/jespinosa/phecomp/data/CRG/20120502_FDF_CRG/20120502_FDF_CRG/20120509_FDF_CRG_c12.mtb	1916	2156	WWSS	food_sc	4	69154	1336622842	1	0.04	0.000242424242424242	7513	1
3	Drink 2	Intake 2	18	69413	1336623101	/users/cn/jespinosa/phecomp/data/CRG/20120502_FDF_CRG/20120502_FDF_CRG/20120509_FDF_CRG_c12.mtb	1863	NA	WWSS	water	2	69395	1336623083	1	0.02	0.00111111111111111	7514	1
3	Food 2	Intake 4	344	71819	1336625507	/users/cn/jespinosa/phecomp/data/CRG/20120502_FDF_CRG/20120502_FDF_CRG/20120509_FDF_CRG_c12.mtb	1919	22	WWSS	food_sc	4	71475	1336625163	1	0.04	0.000116279069767442	7515	1
3	Food 2	Intake 4	45	71886	1336625574	/users/cn/jespinosa/phecomp/data/CRG/20120502_FDF_CRG/20120502_FDF_CRG/20120509_FDF_CRG_c12.mtb	1920	4	WWSS	food_sc	4	71841	1336625529	1	0.04	0.000888888888888889	7516	1
3	Food 2	Intake 4	86	71976	1336625664	/users/cn/jespinosa/phecomp/data/CRG/20120502_FDF_CRG/20120502_FDF_CRG/20120509_FDF_CRG_c12.mtb	1921	145	WWSS	food_sc	4	71890	1336625578	1	0.02	0.000232558139534884	7517	1
3	Drink 2	Intake 2	26	71996	1336625684	/users/cn/jespinosa/phecomp/data/CRG/20120502_FDF_CRG/20120502_FDF_CRG/20120509_FDF_CRG_c12.mtb	1866	NA	WWSS	water	2	71970	1336625658	1	0.0799999999999998	0.00307692307692307	7518	1
3	Food 2	Intake 4	82	72203	1336625891	/users/cn/jespinosa/phecomp/data/CRG/20120502_FDF_CRG/20120502_FDF_CRG/20120509_FDF_CRG_c12.mtb	1923	265	WWSS	food_sc	4	72121	1336625809	1	0.02	0.00024390243902439	7519	1
3	Food 2	Intake 4	75	72543	1336626231	/users/cn/jespinosa/phecomp/data/CRG/20120502_FDF_CRG/20120502_FDF_CRG/20120509_FDF_CRG_c12.mtb	1926	126	WWSS	food_sc	4	72468	1336626156	1	0.02	0.000266666666666667	7520	1
3	Drink 2	Intake 2	24	72560	1336626248	/users/cn/jespinosa/phecomp/data/CRG/20120502_FDF_CRG/20120502_FDF_CRG/20120509_FDF_CRG_c12.mtb	1867	NA	WWSS	water	2	72536	1336626224	1	0.1	0.00416666666666667	7521	1
3	Food 2	Intake 4	101	72770	1336626458	/users/cn/jespinosa/phecomp/data/CRG/20120502_FDF_CRG/20120502_FDF_CRG/20120509_FDF_CRG_c12.mtb	1927	3568	WWSS	food_sc	4	72669	1336626357	1	0.02	0.000198019801980198	7522	1
3	Drink 2	Intake 2	16	73018	1336626706	/users/cn/jespinosa/phecomp/data/CRG/20120502_FDF_CRG/20120502_FDF_CRG/20120509_FDF_CRG_c12.mtb	1869	NA	WWSS	water	2	73002	1336626690	1	0.02	0.00125	7523	1
3	Food 2	Intake 4	79	76417	1336630105	/users/cn/jespinosa/phecomp/data/CRG/20120502_FDF_CRG/20120502_FDF_CRG/20120509_FDF_CRG_c12.mtb	1929	1140	WWSS	food_sc	4	76338	1336630026	1	0.02	0.000253164556962025	7524	1
3	Food 2	Intake 4	300	77857	1336631545	/users/cn/jespinosa/phecomp/data/CRG/20120502_FDF_CRG/20120502_FDF_CRG/20120509_FDF_CRG_c12.mtb	1931	8461	WWSS	food_sc	4	77557	1336631245	1	0.04	0.000133333333333333	7525	1
3	Food 2	Intake 4	230	86548	1336640236	/users/cn/jespinosa/phecomp/data/CRG/20120502_FDF_CRG/20120502_FDF_CRG/20120509_FDF_CRG_c12.mtb	1934	14605	WWSS	food_sc	4	86318	1336640006	1	0.02	8.69565217391304e-05	7526	1
3	Drink 1	Intake 1	20	86574	1336640262	/users/cn/jespinosa/phecomp/data/CRG/20120502_FDF_CRG/20120502_FDF_CRG/20120509_FDF_CRG_c12.mtb	550	NA	WWSS	water	1	86554	1336640242	1	0.0399999999999999	0.00199999999999999	7527	1
3	Drink 2	Intake 2	28	86982	1336640670	/users/cn/jespinosa/phecomp/data/CRG/20120502_FDF_CRG/20120502_FDF_CRG/20120509_FDF_CRG_c12.mtb	1874	NA	WWSS	water	2	86954	1336640642	1	0.0399999999999998	0.00142857142857142	7528	1
3	Food 2	Intake 4	30	101183	1336654871	/users/cn/jespinosa/phecomp/data/CRG/20120502_FDF_CRG/20120502_FDF_CRG/20120509_FDF_CRG_c12.mtb	1939	18611	WWSS	food_sc	4	101153	1336654841	1	0.02	0.000666666666666667	7529	1
3	Food 1	Intake 3	75	119869	1336673557	/users/cn/jespinosa/phecomp/data/CRG/20120502_FDF_CRG/20120502_FDF_CRG/20120509_FDF_CRG_c12.mtb	1310	13	WWSS	food_sc	3	119794	1336673482	1	0.02	0.000266666666666667	7530	1
3	Food 1	Intake 3	78	119960	1336673648	/users/cn/jespinosa/phecomp/data/CRG/20120502_FDF_CRG/20120502_FDF_CRG/20120509_FDF_CRG_c12.mtb	1311	544	WWSS	food_sc	3	119882	1336673570	1	0.02	0.000256410256410256	7531	1
3	Food 2	Intake 4	320	120824	1336674512	/users/cn/jespinosa/phecomp/data/CRG/20120502_FDF_CRG/20120502_FDF_CRG/20120509_FDF_CRG_c12.mtb	1946	4522	WWSS	food_sc	4	120504	1336674192	1	0.02	6.25e-05	7532	1
3	Drink 2	Intake 2	18	120959	1336674647	/users/cn/jespinosa/phecomp/data/CRG/20120502_FDF_CRG/20120502_FDF_CRG/20120509_FDF_CRG_c12.mtb	1878	NA	WWSS	water	2	120941	1336674629	1	0.04	0.00222222222222222	7533	1
3	Food 2	Intake 4	532	125878	1336679566	/users/cn/jespinosa/phecomp/data/CRG/20120502_FDF_CRG/20120502_FDF_CRG/20120509_FDF_CRG_c12.mtb	1949	712	WWSS	food_sc	4	125346	1336679034	1	0.0799999999999996	0.000150375939849623	7534	1
3	Drink 1	Intake 1	14	125980	1336679668	/users/cn/jespinosa/phecomp/data/CRG/20120502_FDF_CRG/20120502_FDF_CRG/20120509_FDF_CRG_c12.mtb	553	NA	WWSS	water	1	125966	1336679654	1	0.0800000000000001	0.00571428571428572	7535	1
3	Food 2	Intake 4	391	126981	1336680669	/users/cn/jespinosa/phecomp/data/CRG/20120502_FDF_CRG/20120502_FDF_CRG/20120509_FDF_CRG_c12.mtb	1951	1395	WWSS	food_sc	4	126590	1336680278	1	0.12	0.00030690537084399	7536	1
3	Drink 2	Intake 2	18	127003	1336680691	/users/cn/jespinosa/phecomp/data/CRG/20120502_FDF_CRG/20120502_FDF_CRG/20120509_FDF_CRG_c12.mtb	1880	NA	WWSS	water	2	126985	1336680673	1	0.0600000000000001	0.00333333333333334	7537	1
3	Drink 1	Intake 1	21	127121	1336680809	/users/cn/jespinosa/phecomp/data/CRG/20120502_FDF_CRG/20120502_FDF_CRG/20120509_FDF_CRG_c12.mtb	554	NA	WWSS	water	1	127100	1336680788	1	0.0399999999999999	0.0019047619047619	7538	1
3	Drink 1	Intake 1	12	128068	1336681756	/users/cn/jespinosa/phecomp/data/CRG/20120502_FDF_CRG/20120502_FDF_CRG/20120509_FDF_CRG_c12.mtb	555	NA	WWSS	water	1	128056	1336681744	1	0.04	0.00333333333333333	7539	1
3	Food 2	Intake 4	147	128523	1336682211	/users/cn/jespinosa/phecomp/data/CRG/20120502_FDF_CRG/20120502_FDF_CRG/20120509_FDF_CRG_c12.mtb	1954	908	WWSS	food_sc	4	128376	1336682064	1	0.02	0.000136054421768707	7540	1
3	Drink 2	Intake 2	13	128551	1336682239	/users/cn/jespinosa/phecomp/data/CRG/20120502_FDF_CRG/20120502_FDF_CRG/20120509_FDF_CRG_c12.mtb	1884	NA	WWSS	water	2	128538	1336682226	1	0.02	0.00153846153846154	7541	1
3	Food 2	Intake 4	541	129972	1336683660	/users/cn/jespinosa/phecomp/data/CRG/20120502_FDF_CRG/20120502_FDF_CRG/20120509_FDF_CRG_c12.mtb	1957	88	WWSS	food_sc	4	129431	1336683119	1	0.14	0.000258780036968577	7542	1
3	Food 2	Intake 4	160	130220	1336683908	/users/cn/jespinosa/phecomp/data/CRG/20120502_FDF_CRG/20120502_FDF_CRG/20120509_FDF_CRG_c12.mtb	1959	523	WWSS	food_sc	4	130060	1336683748	1	0.04	0.00025	7543	1
3	Drink 2	Intake 2	24	130236	1336683924	/users/cn/jespinosa/phecomp/data/CRG/20120502_FDF_CRG/20120502_FDF_CRG/20120509_FDF_CRG_c12.mtb	1885	NA	WWSS	water	2	130212	1336683900	1	0.0800000000000001	0.00333333333333334	7544	1
3	Drink 2	Intake 2	19	130310	1336683998	/users/cn/jespinosa/phecomp/data/CRG/20120502_FDF_CRG/20120502_FDF_CRG/20120509_FDF_CRG_c12.mtb	1886	NA	WWSS	water	2	130291	1336683979	1	0.04	0.00210526315789474	7545	1
3	Food 1	Intake 3	17	130760	1336684448	/users/cn/jespinosa/phecomp/data/CRG/20120502_FDF_CRG/20120502_FDF_CRG/20120509_FDF_CRG_c12.mtb	1321	1552	WWSS	food_sc	3	130743	1336684431	1	0.02	0.00117647058823529	7546	1
3	Drink 2	Intake 2	18	130973	1336684661	/users/cn/jespinosa/phecomp/data/CRG/20120502_FDF_CRG/20120502_FDF_CRG/20120509_FDF_CRG_c12.mtb	1888	NA	WWSS	water	2	130955	1336684643	1	0.04	0.00222222222222222	7547	1
3	Food 2	Intake 4	238	132550	1336686238	/users/cn/jespinosa/phecomp/data/CRG/20120502_FDF_CRG/20120502_FDF_CRG/20120509_FDF_CRG_c12.mtb	1964	26	WWSS	food_sc	4	132312	1336686000	1	0.02	8.40336134453782e-05	7548	1
3	Food 1	Intake 3	607	133183	1336686871	/users/cn/jespinosa/phecomp/data/CRG/20120502_FDF_CRG/20120502_FDF_CRG/20120509_FDF_CRG_c12.mtb	1322	646	WWSS	food_sc	3	132576	1336686264	1	0.14	0.000230642504118616	7549	1
3	Drink 2	Intake 2	17	133250	1336686938	/users/cn/jespinosa/phecomp/data/CRG/20120502_FDF_CRG/20120502_FDF_CRG/20120509_FDF_CRG_c12.mtb	1889	NA	WWSS	water	2	133233	1336686921	1	0.04	0.00235294117647059	7550	1
3	Drink 2	Intake 2	17	133419	1336687107	/users/cn/jespinosa/phecomp/data/CRG/20120502_FDF_CRG/20120502_FDF_CRG/20120509_FDF_CRG_c12.mtb	1890	NA	WWSS	water	2	133402	1336687090	1	0.0399999999999998	0.00235294117647058	7551	1
3	Food 1	Intake 3	86	133915	1336687603	/users/cn/jespinosa/phecomp/data/CRG/20120502_FDF_CRG/20120502_FDF_CRG/20120509_FDF_CRG_c12.mtb	1323	4	WWSS	food_sc	3	133829	1336687517	1	0.04	0.000465116279069767	7552	1
3	Food 1	Intake 3	160	134079	1336687767	/users/cn/jespinosa/phecomp/data/CRG/20120502_FDF_CRG/20120502_FDF_CRG/20120509_FDF_CRG_c12.mtb	1324	2217	WWSS	food_sc	3	133919	1336687607	1	0.02	0.000125	7553	1
3	Drink 2	Intake 2	20	134130	1336687818	/users/cn/jespinosa/phecomp/data/CRG/20120502_FDF_CRG/20120502_FDF_CRG/20120509_FDF_CRG_c12.mtb	1891	NA	WWSS	water	2	134110	1336687798	1	0.0600000000000001	0.00300000000000001	7554	1
3	Food 1	Intake 3	358	136654	1336690342	/users/cn/jespinosa/phecomp/data/CRG/20120502_FDF_CRG/20120502_FDF_CRG/20120509_FDF_CRG_c12.mtb	1327	22	WWSS	food_sc	3	136296	1336689984	1	0.1	0.000279329608938548	7555	1
3	Food 1	Intake 3	108	136784	1336690472	/users/cn/jespinosa/phecomp/data/CRG/20120502_FDF_CRG/20120502_FDF_CRG/20120509_FDF_CRG_c12.mtb	1328	386	WWSS	food_sc	3	136676	1336690364	1	0.04	0.00037037037037037	7556	1
3	Drink 2	Intake 2	16	136807	1336690495	/users/cn/jespinosa/phecomp/data/CRG/20120502_FDF_CRG/20120502_FDF_CRG/20120509_FDF_CRG_c12.mtb	1892	NA	WWSS	water	2	136791	1336690479	1	0.02	0.00125	7557	1
3	Drink 2	Intake 2	26	136970	1336690658	/users/cn/jespinosa/phecomp/data/CRG/20120502_FDF_CRG/20120502_FDF_CRG/20120509_FDF_CRG_c12.mtb	1893	NA	WWSS	water	2	136944	1336690632	1	0.0599999999999998	0.0023076923076923	7558	1
3	Food 1	Intake 3	78	137248	1336690936	/users/cn/jespinosa/phecomp/data/CRG/20120502_FDF_CRG/20120502_FDF_CRG/20120509_FDF_CRG_c12.mtb	1330	414	WWSS	food_sc	3	137170	1336690858	1	0.02	0.000256410256410256	7559	1
3	Drink 2	Intake 2	35	137341	1336691029	/users/cn/jespinosa/phecomp/data/CRG/20120502_FDF_CRG/20120502_FDF_CRG/20120509_FDF_CRG_c12.mtb	1894	NA	WWSS	water	2	137306	1336690994	1	0.0600000000000001	0.00171428571428572	7560	1
3	Drink 1	Intake 1	18	137572	1336691260	/users/cn/jespinosa/phecomp/data/CRG/20120502_FDF_CRG/20120502_FDF_CRG/20120509_FDF_CRG_c12.mtb	559	NA	WWSS	water	1	137554	1336691242	1	0.04	0.00222222222222222	7561	1
3	Food 1	Intake 3	406	138068	1336691756	/users/cn/jespinosa/phecomp/data/CRG/20120502_FDF_CRG/20120502_FDF_CRG/20120509_FDF_CRG_c12.mtb	1332	470	WWSS	food_sc	3	137662	1336691350	1	0.0800000000000001	0.00019704433497537	7562	1
3	Drink 2	Intake 2	19	138082	1336691770	/users/cn/jespinosa/phecomp/data/CRG/20120502_FDF_CRG/20120502_FDF_CRG/20120509_FDF_CRG_c12.mtb	1895	NA	WWSS	water	2	138063	1336691751	1	0.02	0.00105263157894737	7563	1
3	Drink 2	Intake 2	25	138187	1336691875	/users/cn/jespinosa/phecomp/data/CRG/20120502_FDF_CRG/20120502_FDF_CRG/20120509_FDF_CRG_c12.mtb	1896	NA	WWSS	water	2	138162	1336691850	1	0.02	0.0008	7564	1
3	Drink 2	Intake 2	18	138224	1336691912	/users/cn/jespinosa/phecomp/data/CRG/20120502_FDF_CRG/20120502_FDF_CRG/20120509_FDF_CRG_c12.mtb	1897	NA	WWSS	water	2	138206	1336691894	1	0.02	0.00111111111111111	7565	1
3	Food 2	Intake 4	290	138828	1336692516	/users/cn/jespinosa/phecomp/data/CRG/20120502_FDF_CRG/20120502_FDF_CRG/20120509_FDF_CRG_c12.mtb	1980	1606	WWSS	food_sc	4	138538	1336692226	1	0.02	6.89655172413793e-05	7566	1
3	Drink 2	Intake 2	25	138847	1336692535	/users/cn/jespinosa/phecomp/data/CRG/20120502_FDF_CRG/20120502_FDF_CRG/20120509_FDF_CRG_c12.mtb	1898	NA	WWSS	water	2	138822	1336692510	1	0.0600000000000001	0.0024	7567	1
3	Food 1	Intake 3	305	140739	1336694427	/users/cn/jespinosa/phecomp/data/CRG/20120502_FDF_CRG/20120502_FDF_CRG/20120509_FDF_CRG_c12.mtb	1335	43	WWSS	food_sc	3	140434	1336694122	1	0.0399999999999998	0.000131147540983606	7568	1
3	Food 2	Intake 4	54	140836	1336694524	/users/cn/jespinosa/phecomp/data/CRG/20120502_FDF_CRG/20120502_FDF_CRG/20120509_FDF_CRG_c12.mtb	1982	905	WWSS	food_sc	4	140782	1336694470	1	0.02	0.00037037037037037	7569	1
3	Drink 2	Intake 2	29	140916	1336694604	/users/cn/jespinosa/phecomp/data/CRG/20120502_FDF_CRG/20120502_FDF_CRG/20120509_FDF_CRG_c12.mtb	1899	NA	WWSS	water	2	140887	1336694575	1	0.04	0.00137931034482759	7570	1
3	Food 2	Intake 4	89	141830	1336695518	/users/cn/jespinosa/phecomp/data/CRG/20120502_FDF_CRG/20120502_FDF_CRG/20120509_FDF_CRG_c12.mtb	1985	879	WWSS	food_sc	4	141741	1336695429	1	0.02	0.000224719101123596	7571	1
3	Food 1	Intake 3	101	142810	1336696498	/users/cn/jespinosa/phecomp/data/CRG/20120502_FDF_CRG/20120502_FDF_CRG/20120509_FDF_CRG_c12.mtb	1342	COLL	WWSS	food_sc	3	142709	1336696397	1	0.02	0.000198019801980198	7572	1
3	Food 2	Intake 4	435	143233	1336696921	/users/cn/jespinosa/phecomp/data/CRG/20120502_FDF_CRG/20120502_FDF_CRG/20120509_FDF_CRG_c12.mtb	1989	1995	WWSS	food_sc	4	142798	1336696486	1	0.0999999999999996	0.000229885057471263	7573	1
3	Drink 1	Intake 1	18	144107	1336697795	/users/cn/jespinosa/phecomp/data/CRG/20120502_FDF_CRG/20120502_FDF_CRG/20120509_FDF_CRG_c12.mtb	562	NA	WWSS	water	1	144089	1336697777	1	0.08	0.00444444444444444	7574	1
3	Food 2	Intake 4	616	145844	1336699532	/users/cn/jespinosa/phecomp/data/CRG/20120502_FDF_CRG/20120502_FDF_CRG/20120509_FDF_CRG_c12.mtb	1992	32	WWSS	food_sc	4	145228	1336698916	1	0.14	0.000227272727272727	7575	1
3	Food 2	Intake 4	68	145944	1336699632	/users/cn/jespinosa/phecomp/data/CRG/20120502_FDF_CRG/20120502_FDF_CRG/20120509_FDF_CRG_c12.mtb	1993	1329	WWSS	food_sc	4	145876	1336699564	1	0.02	0.000294117647058824	7576	1
3	Drink 2	Intake 2	13	145954	1336699642	/users/cn/jespinosa/phecomp/data/CRG/20120502_FDF_CRG/20120502_FDF_CRG/20120509_FDF_CRG_c12.mtb	1902	NA	WWSS	water	2	145941	1336699629	1	0.02	0.00153846153846154	7577	1
3	Drink 2	Intake 2	21	146017	1336699705	/users/cn/jespinosa/phecomp/data/CRG/20120502_FDF_CRG/20120502_FDF_CRG/20120509_FDF_CRG_c12.mtb	1903	NA	WWSS	water	2	145996	1336699684	1	0.0600000000000001	0.00285714285714286	7578	1
3	Drink 2	Intake 2	16	146400	1336700088	/users/cn/jespinosa/phecomp/data/CRG/20120502_FDF_CRG/20120502_FDF_CRG/20120509_FDF_CRG_c12.mtb	1904	NA	WWSS	water	2	146384	1336700072	1	0.04	0.0025	7579	1
3	Drink 1	Intake 1	26	146651	1336700339	/users/cn/jespinosa/phecomp/data/CRG/20120502_FDF_CRG/20120502_FDF_CRG/20120509_FDF_CRG_c12.mtb	563	NA	WWSS	water	1	146625	1336700313	1	0.1	0.00384615384615385	7580	1
3	Food 2	Intake 4	552	147825	1336701513	/users/cn/jespinosa/phecomp/data/CRG/20120502_FDF_CRG/20120502_FDF_CRG/20120509_FDF_CRG_c12.mtb	1996	2647	WWSS	food_sc	4	147273	1336700961	1	0.12	0.000217391304347826	7581	1
3	Drink 2	Intake 2	15	148474	1336702162	/users/cn/jespinosa/phecomp/data/CRG/20120502_FDF_CRG/20120502_FDF_CRG/20120509_FDF_CRG_c12.mtb	1905	NA	WWSS	water	2	148459	1336702147	1	0.02	0.00133333333333333	7582	1
3	Drink 2	Intake 2	10	149014	1336702702	/users/cn/jespinosa/phecomp/data/CRG/20120502_FDF_CRG/20120502_FDF_CRG/20120509_FDF_CRG_c12.mtb	1906	NA	WWSS	water	2	149004	1336702692	1	0.0399999999999996	0.00399999999999996	7583	1
3	Food 2	Intake 4	303	150775	1336704463	/users/cn/jespinosa/phecomp/data/CRG/20120502_FDF_CRG/20120502_FDF_CRG/20120509_FDF_CRG_c12.mtb	2000	38	WWSS	food_sc	4	150472	1336704160	1	0.0800000000000001	0.000264026402640264	7584	1
3	Food 2	Intake 4	243	151056	1336704744	/users/cn/jespinosa/phecomp/data/CRG/20120502_FDF_CRG/20120502_FDF_CRG/20120509_FDF_CRG_c12.mtb	2001	187	WWSS	food_sc	4	150813	1336704501	1	0.0600000000000001	0.000246913580246914	7585	1
3	Drink 2	Intake 2	15	151078	1336704766	/users/cn/jespinosa/phecomp/data/CRG/20120502_FDF_CRG/20120502_FDF_CRG/20120509_FDF_CRG_c12.mtb	1907	NA	WWSS	water	2	151063	1336704751	1	0.04	0.00266666666666667	7586	1
3	Drink 2	Intake 2	18	151118	1336704806	/users/cn/jespinosa/phecomp/data/CRG/20120502_FDF_CRG/20120502_FDF_CRG/20120509_FDF_CRG_c12.mtb	1908	NA	WWSS	water	2	151100	1336704788	1	0.02	0.00111111111111111	7587	1
3	Food 2	Intake 4	105	151348	1336705036	/users/cn/jespinosa/phecomp/data/CRG/20120502_FDF_CRG/20120502_FDF_CRG/20120509_FDF_CRG_c12.mtb	2003	1027	WWSS	food_sc	4	151243	1336704931	1	0.02	0.00019047619047619	7588	1
3	Drink 2	Intake 2	24	151513	1336705201	/users/cn/jespinosa/phecomp/data/CRG/20120502_FDF_CRG/20120502_FDF_CRG/20120509_FDF_CRG_c12.mtb	1909	NA	WWSS	water	2	151489	1336705177	1	0.0600000000000001	0.0025	7589	1
3	Drink 2	Intake 2	36	152224	1336705912	/users/cn/jespinosa/phecomp/data/CRG/20120502_FDF_CRG/20120502_FDF_CRG/20120509_FDF_CRG_c12.mtb	1910	NA	WWSS	water	2	152188	1336705876	1	0.0800000000000001	0.00222222222222222	7590	1
3	Food 1	Intake 3	82	152457	1336706145	/users/cn/jespinosa/phecomp/data/CRG/20120502_FDF_CRG/20120502_FDF_CRG/20120509_FDF_CRG_c12.mtb	1347	1487	WWSS	food_sc	3	152375	1336706063	1	0.02	0.00024390243902439	7591	1
3	Food 2	Intake 4	172	154116	1336707804	/users/cn/jespinosa/phecomp/data/CRG/20120502_FDF_CRG/20120502_FDF_CRG/20120509_FDF_CRG_c12.mtb	2009	1379	WWSS	food_sc	4	153944	1336707632	1	0.0200000000000005	0.000116279069767445	7592	1
3	Food 2	Intake 4	323	155818	1336709506	/users/cn/jespinosa/phecomp/data/CRG/20120502_FDF_CRG/20120502_FDF_CRG/20120509_FDF_CRG_c12.mtb	2013	24	WWSS	food_sc	4	155495	1336709183	1	0.0600000000000001	0.000185758513931889	7593	1
3	Food 2	Intake 4	235	156077	1336709765	/users/cn/jespinosa/phecomp/data/CRG/20120502_FDF_CRG/20120502_FDF_CRG/20120509_FDF_CRG_c12.mtb	2014	2957	WWSS	food_sc	4	155842	1336709530	1	0.0600000000000001	0.000255319148936171	7594	1
3	Drink 2	Intake 2	23	156102	1336709790	/users/cn/jespinosa/phecomp/data/CRG/20120502_FDF_CRG/20120502_FDF_CRG/20120509_FDF_CRG_c12.mtb	1912	NA	WWSS	water	2	156079	1336709767	1	0.0600000000000001	0.00260869565217392	7595	1
3	Drink 2	Intake 2	16	156439	1336710127	/users/cn/jespinosa/phecomp/data/CRG/20120502_FDF_CRG/20120502_FDF_CRG/20120509_FDF_CRG_c12.mtb	1913	NA	WWSS	water	2	156423	1336710111	1	0.02	0.00125	7596	1
3	Drink 2	Intake 2	30	157042	1336710730	/users/cn/jespinosa/phecomp/data/CRG/20120502_FDF_CRG/20120502_FDF_CRG/20120509_FDF_CRG_c12.mtb	1914	NA	WWSS	water	2	157012	1336710700	1	0.0800000000000001	0.00266666666666667	7597	1
3	Food 2	Intake 4	101	159135	1336712823	/users/cn/jespinosa/phecomp/data/CRG/20120502_FDF_CRG/20120502_FDF_CRG/20120509_FDF_CRG_c12.mtb	2022	42	WWSS	food_sc	4	159034	1336712722	1	0.02	0.000198019801980198	7598	1
3	Food 2	Intake 4	215	159392	1336713080	/users/cn/jespinosa/phecomp/data/CRG/20120502_FDF_CRG/20120502_FDF_CRG/20120509_FDF_CRG_c12.mtb	2023	96	WWSS	food_sc	4	159177	1336712865	1	0.0600000000000001	0.000279069767441861	7599	1
3	Food 2	Intake 4	134	159622	1336713310	/users/cn/jespinosa/phecomp/data/CRG/20120502_FDF_CRG/20120502_FDF_CRG/20120509_FDF_CRG_c12.mtb	2024	146	WWSS	food_sc	4	159488	1336713176	1	0.02	0.000149253731343284	7600	1
3	Drink 2	Intake 2	23	159641	1336713329	/users/cn/jespinosa/phecomp/data/CRG/20120502_FDF_CRG/20120502_FDF_CRG/20120509_FDF_CRG_c12.mtb	1915	NA	WWSS	water	2	159618	1336713306	1	0.04	0.00173913043478261	7601	1
3	Food 2	Intake 4	152	159920	1336713608	/users/cn/jespinosa/phecomp/data/CRG/20120502_FDF_CRG/20120502_FDF_CRG/20120509_FDF_CRG_c12.mtb	2026	870	WWSS	food_sc	4	159768	1336713456	1	0.02	0.000131578947368421	7602	1
3	Drink 2	Intake 2	20	159940	1336713628	/users/cn/jespinosa/phecomp/data/CRG/20120502_FDF_CRG/20120502_FDF_CRG/20120509_FDF_CRG_c12.mtb	1916	NA	WWSS	water	2	159920	1336713608	1	0.0599999999999996	0.00299999999999998	7603	1
3	Drink 2	Intake 2	16	160204	1336713892	/users/cn/jespinosa/phecomp/data/CRG/20120502_FDF_CRG/20120502_FDF_CRG/20120509_FDF_CRG_c12.mtb	1917	NA	WWSS	water	2	160188	1336713876	1	0.0200000000000005	0.00125000000000003	7604	1
3	Drink 2	Intake 2	19	160723	1336714411	/users/cn/jespinosa/phecomp/data/CRG/20120502_FDF_CRG/20120502_FDF_CRG/20120509_FDF_CRG_c12.mtb	1918	NA	WWSS	water	2	160704	1336714392	1	0.04	0.00210526315789474	7605	1
3	Food 1	Intake 3	226	161016	1336714704	/users/cn/jespinosa/phecomp/data/CRG/20120502_FDF_CRG/20120502_FDF_CRG/20120509_FDF_CRG_c12.mtb	1356	5789	WWSS	food_sc	3	160790	1336714478	1	0.02	8.84955752212389e-05	7606	1
3	Drink 2	Intake 2	15	161415	1336715103	/users/cn/jespinosa/phecomp/data/CRG/20120502_FDF_CRG/20120502_FDF_CRG/20120509_FDF_CRG_c12.mtb	1919	NA	WWSS	water	2	161400	1336715088	1	0.0399999999999996	0.00266666666666664	7607	1
3	Food 2	Intake 4	311	167116	1336720804	/users/cn/jespinosa/phecomp/data/CRG/20120502_FDF_CRG/20120502_FDF_CRG/20120509_FDF_CRG_c12.mtb	2033	12838	WWSS	food_sc	4	166805	1336720493	1	0.02	6.43086816720257e-05	7608	1
3	Drink 2	Intake 2	46	169012	1336722700	/users/cn/jespinosa/phecomp/data/CRG/20120502_FDF_CRG/20120502_FDF_CRG/20120509_FDF_CRG_c12.mtb	1923	NA	WWSS	water	2	168966	1336722654	1	0.02	0.000434782608695652	7609	1
3	Food 2	Intake 4	274	3051	1336733916	/users/cn/jespinosa/phecomp/data/CRG/20120502_FDF_CRG/20120502_FDF_CRG/20120511_FDF_CRG_c12.mtb	2434	3561	WWSS	food_sc	4	2777	1336733642	1	0.02	7.2992700729927e-05	7610	1
3	Food 2	Intake 4	255	6867	1336737732	/users/cn/jespinosa/phecomp/data/CRG/20120502_FDF_CRG/20120502_FDF_CRG/20120511_FDF_CRG_c12.mtb	2435	23060	WWSS	food_sc	4	6612	1336737477	1	0.06	0.000235294117647059	7611	1
3	Drink 2	Intake 2	15	7065	1336737930	/users/cn/jespinosa/phecomp/data/CRG/20120502_FDF_CRG/20120502_FDF_CRG/20120511_FDF_CRG_c12.mtb	2107	NA	WWSS	water	2	7050	1336737915	1	0.02	0.00133333333333333	7612	1
3	Food 2	Intake 4	336	30263	1336761128	/users/cn/jespinosa/phecomp/data/CRG/20120502_FDF_CRG/20120502_FDF_CRG/20120511_FDF_CRG_c12.mtb	2444	23	WWSS	food_sc	4	29927	1336760792	1	0.02	5.95238095238095e-05	7613	1
3	Food 1	Intake 3	377	30663	1336761528	/users/cn/jespinosa/phecomp/data/CRG/20120502_FDF_CRG/20120502_FDF_CRG/20120511_FDF_CRG_c12.mtb	1573	1595	WWSS	food_sc	3	30286	1336761151	1	0.08	0.000212201591511936	7614	1
3	Drink 1	Intake 1	14	31597	1336762462	/users/cn/jespinosa/phecomp/data/CRG/20120502_FDF_CRG/20120502_FDF_CRG/20120511_FDF_CRG_c12.mtb	759	NA	WWSS	water	1	31583	1336762448	1	0.06	0.00428571428571429	7615	1
3	Drink 2	Intake 2	11	31984	1336762849	/users/cn/jespinosa/phecomp/data/CRG/20120502_FDF_CRG/20120502_FDF_CRG/20120511_FDF_CRG_c12.mtb	2109	NA	WWSS	water	2	31973	1336762838	1	0.02	0.00181818181818182	7616	1
3	Food 1	Intake 3	698	32956	1336763821	/users/cn/jespinosa/phecomp/data/CRG/20120502_FDF_CRG/20120502_FDF_CRG/20120511_FDF_CRG_c12.mtb	1575	64	WWSS	food_sc	3	32258	1336763123	1	0.08	0.000114613180515759	7617	1
3	Food 2	Intake 4	359	33379	1336764244	/users/cn/jespinosa/phecomp/data/CRG/20120502_FDF_CRG/20120502_FDF_CRG/20120511_FDF_CRG_c12.mtb	2448	1121	WWSS	food_sc	4	33020	1336763885	1	0.08	0.000222841225626741	7618	1
3	Drink 1	Intake 1	26	33400	1336764265	/users/cn/jespinosa/phecomp/data/CRG/20120502_FDF_CRG/20120502_FDF_CRG/20120511_FDF_CRG_c12.mtb	760	NA	WWSS	water	1	33374	1336764239	1	0.1	0.00384615384615385	7619	1
3	Drink 1	Intake 1	15	34010	1336764875	/users/cn/jespinosa/phecomp/data/CRG/20120502_FDF_CRG/20120502_FDF_CRG/20120511_FDF_CRG_c12.mtb	761	NA	WWSS	water	1	33995	1336764860	1	0.02	0.00133333333333333	7620	1
3	Food 1	Intake 3	90	34590	1336765455	/users/cn/jespinosa/phecomp/data/CRG/20120502_FDF_CRG/20120502_FDF_CRG/20120511_FDF_CRG_c12.mtb	1577	COLL	WWSS	food_sc	3	34500	1336765365	1	0.02	0.000222222222222222	7621	1
3	Food 2	Intake 4	631	35210	1336766075	/users/cn/jespinosa/phecomp/data/CRG/20120502_FDF_CRG/20120502_FDF_CRG/20120511_FDF_CRG_c12.mtb	2449	41	WWSS	food_sc	4	34579	1336765444	1	0.16	0.000253565768621236	7622	1
3	Drink 2	Intake 2	25	35230	1336766095	/users/cn/jespinosa/phecomp/data/CRG/20120502_FDF_CRG/20120502_FDF_CRG/20120511_FDF_CRG_c12.mtb	2111	NA	WWSS	water	2	35205	1336766070	1	0.1	0.004	7623	1
3	Food 2	Intake 4	56	35307	1336766172	/users/cn/jespinosa/phecomp/data/CRG/20120502_FDF_CRG/20120502_FDF_CRG/20120511_FDF_CRG_c12.mtb	2450	912	WWSS	food_sc	4	35251	1336766116	1	0.02	0.000357142857142857	7624	1
3	Drink 2	Intake 2	31	35391	1336766256	/users/cn/jespinosa/phecomp/data/CRG/20120502_FDF_CRG/20120502_FDF_CRG/20120511_FDF_CRG_c12.mtb	2112	NA	WWSS	water	2	35360	1336766225	1	0.08	0.00258064516129032	7625	1
3	Food 2	Intake 4	102	36321	1336767186	/users/cn/jespinosa/phecomp/data/CRG/20120502_FDF_CRG/20120502_FDF_CRG/20120511_FDF_CRG_c12.mtb	2452	39	WWSS	food_sc	4	36219	1336767084	1	0.02	0.000196078431372549	7626	1
3	Food 2	Intake 4	615	36975	1336767840	/users/cn/jespinosa/phecomp/data/CRG/20120502_FDF_CRG/20120502_FDF_CRG/20120511_FDF_CRG_c12.mtb	2453	1321	WWSS	food_sc	4	36360	1336767225	1	0.18	0.000292682926829268	7627	1
3	Drink 2	Intake 2	20	36991	1336767856	/users/cn/jespinosa/phecomp/data/CRG/20120502_FDF_CRG/20120502_FDF_CRG/20120511_FDF_CRG_c12.mtb	2113	NA	WWSS	water	2	36971	1336767836	1	0.12	0.006	7628	1
3	Drink 2	Intake 2	17	37057	1336767922	/users/cn/jespinosa/phecomp/data/CRG/20120502_FDF_CRG/20120502_FDF_CRG/20120511_FDF_CRG_c12.mtb	2114	NA	WWSS	water	2	37040	1336767905	1	0.04	0.00235294117647059	7629	1
3	Food 2	Intake 4	288	38584	1336769449	/users/cn/jespinosa/phecomp/data/CRG/20120502_FDF_CRG/20120502_FDF_CRG/20120511_FDF_CRG_c12.mtb	2456	15	WWSS	food_sc	4	38296	1336769161	1	0.0399999999999999	0.000138888888888889	7630	1
3	Food 1	Intake 3	233	38832	1336769697	/users/cn/jespinosa/phecomp/data/CRG/20120502_FDF_CRG/20120502_FDF_CRG/20120511_FDF_CRG_c12.mtb	1578	1066	WWSS	food_sc	3	38599	1336769464	1	0.04	0.000171673819742489	7631	1
3	Drink 2	Intake 2	22	38878	1336769743	/users/cn/jespinosa/phecomp/data/CRG/20120502_FDF_CRG/20120502_FDF_CRG/20120511_FDF_CRG_c12.mtb	2115	NA	WWSS	water	2	38856	1336769721	1	0.1	0.00454545454545455	7632	1
3	Food 2	Intake 4	333	40231	1336771096	/users/cn/jespinosa/phecomp/data/CRG/20120502_FDF_CRG/20120502_FDF_CRG/20120511_FDF_CRG_c12.mtb	2458	280	WWSS	food_sc	4	39898	1336770763	1	0.02	6.00600600600601e-05	7633	1
3	Drink 2	Intake 2	17	40241	1336771106	/users/cn/jespinosa/phecomp/data/CRG/20120502_FDF_CRG/20120502_FDF_CRG/20120511_FDF_CRG_c12.mtb	2116	NA	WWSS	water	2	40224	1336771089	1	0.02	0.00117647058823529	7634	1
3	Drink 1	Intake 1	16	40396	1336771261	/users/cn/jespinosa/phecomp/data/CRG/20120502_FDF_CRG/20120502_FDF_CRG/20120511_FDF_CRG_c12.mtb	763	NA	WWSS	water	1	40380	1336771245	1	0.02	0.00125	7635	1
3	Food 1	Intake 3	560	41071	1336771936	/users/cn/jespinosa/phecomp/data/CRG/20120502_FDF_CRG/20120502_FDF_CRG/20120511_FDF_CRG_c12.mtb	1580	1370	WWSS	food_sc	3	40511	1336771376	1	0.14	0.00025	7636	1
3	Drink 2	Intake 2	18	41101	1336771966	/users/cn/jespinosa/phecomp/data/CRG/20120502_FDF_CRG/20120502_FDF_CRG/20120511_FDF_CRG_c12.mtb	2117	NA	WWSS	water	2	41083	1336771948	1	0.04	0.00222222222222222	7637	1
3	Drink 2	Intake 2	15	41265	1336772130	/users/cn/jespinosa/phecomp/data/CRG/20120502_FDF_CRG/20120502_FDF_CRG/20120511_FDF_CRG_c12.mtb	2118	NA	WWSS	water	2	41250	1336772115	1	0.0399999999999999	0.00266666666666666	7638	1
3	Drink 2	Intake 2	16	41348	1336772213	/users/cn/jespinosa/phecomp/data/CRG/20120502_FDF_CRG/20120502_FDF_CRG/20120511_FDF_CRG_c12.mtb	2119	NA	WWSS	water	2	41332	1336772197	1	0.02	0.00125	7639	1
3	Drink 2	Intake 2	23	41471	1336772336	/users/cn/jespinosa/phecomp/data/CRG/20120502_FDF_CRG/20120502_FDF_CRG/20120511_FDF_CRG_c12.mtb	2120	NA	WWSS	water	2	41448	1336772313	1	0.02	0.000869565217391304	7640	1
3	Food 1	Intake 3	403	42844	1336773709	/users/cn/jespinosa/phecomp/data/CRG/20120502_FDF_CRG/20120502_FDF_CRG/20120511_FDF_CRG_c12.mtb	1584	40	WWSS	food_sc	3	42441	1336773306	1	0.12	0.000297766749379653	7641	1
3	Food 1	Intake 3	374	43258	1336774123	/users/cn/jespinosa/phecomp/data/CRG/20120502_FDF_CRG/20120502_FDF_CRG/20120511_FDF_CRG_c12.mtb	1585	197	WWSS	food_sc	3	42884	1336773749	1	0.12	0.000320855614973262	7642	1
3	Drink 2	Intake 2	23	43270	1336774135	/users/cn/jespinosa/phecomp/data/CRG/20120502_FDF_CRG/20120502_FDF_CRG/20120511_FDF_CRG_c12.mtb	2121	NA	WWSS	water	2	43247	1336774112	1	0.1	0.00434782608695652	7643	1
3	Food 1	Intake 3	190	43645	1336774510	/users/cn/jespinosa/phecomp/data/CRG/20120502_FDF_CRG/20120502_FDF_CRG/20120511_FDF_CRG_c12.mtb	1587	1692	WWSS	food_sc	3	43455	1336774320	1	0.04	0.000210526315789474	7644	1
3	Drink 2	Intake 2	22	43679	1336774544	/users/cn/jespinosa/phecomp/data/CRG/20120502_FDF_CRG/20120502_FDF_CRG/20120511_FDF_CRG_c12.mtb	2122	NA	WWSS	water	2	43657	1336774522	1	0.0600000000000001	0.00272727272727273	7645	1
3	Drink 2	Intake 2	21	45321	1336776186	/users/cn/jespinosa/phecomp/data/CRG/20120502_FDF_CRG/20120502_FDF_CRG/20120511_FDF_CRG_c12.mtb	2123	NA	WWSS	water	2	45300	1336776165	1	0.0399999999999999	0.0019047619047619	7646	1
3	Food 1	Intake 3	797	46134	1336776999	/users/cn/jespinosa/phecomp/data/CRG/20120502_FDF_CRG/20120502_FDF_CRG/20120511_FDF_CRG_c12.mtb	1589	1202	WWSS	food_sc	3	45337	1336776202	1	0.3	0.000376411543287327	7647	1
3	Drink 2	Intake 2	31	46157	1336777022	/users/cn/jespinosa/phecomp/data/CRG/20120502_FDF_CRG/20120502_FDF_CRG/20120511_FDF_CRG_c12.mtb	2124	NA	WWSS	water	2	46126	1336776991	1	0.12	0.00387096774193548	7648	1
3	Drink 2	Intake 2	19	46223	1336777088	/users/cn/jespinosa/phecomp/data/CRG/20120502_FDF_CRG/20120502_FDF_CRG/20120511_FDF_CRG_c12.mtb	2125	NA	WWSS	water	2	46204	1336777069	1	0.04	0.00210526315789474	7649	1
3	Drink 1	Intake 1	24	46497	1336777362	/users/cn/jespinosa/phecomp/data/CRG/20120502_FDF_CRG/20120502_FDF_CRG/20120511_FDF_CRG_c12.mtb	764	NA	WWSS	water	1	46473	1336777338	1	0.04	0.00166666666666667	7650	1
3	Drink 2	Intake 2	15	46500	1336777365	/users/cn/jespinosa/phecomp/data/CRG/20120502_FDF_CRG/20120502_FDF_CRG/20120511_FDF_CRG_c12.mtb	2126	NA	WWSS	water	2	46485	1336777350	1	0.04	0.00266666666666667	7651	1
3	Drink 2	Intake 2	44	46984	1336777849	/users/cn/jespinosa/phecomp/data/CRG/20120502_FDF_CRG/20120502_FDF_CRG/20120511_FDF_CRG_c12.mtb	2132	NA	WWSS	water	2	46940	1336777805	1	0.02	0.000454545454545455	7652	1
3	Drink 1	Intake 1	13	47327	1336778192	/users/cn/jespinosa/phecomp/data/CRG/20120502_FDF_CRG/20120502_FDF_CRG/20120511_FDF_CRG_c12.mtb	766	NA	WWSS	water	1	47314	1336778179	1	0.04	0.00307692307692308	7653	1
3	Food 2	Intake 4	86	47422	1336778287	/users/cn/jespinosa/phecomp/data/CRG/20120502_FDF_CRG/20120502_FDF_CRG/20120511_FDF_CRG_c12.mtb	2468	40	WWSS	food_sc	4	47336	1336778201	1	0.02	0.000232558139534884	7654	1
3	Food 1	Intake 3	293	47755	1336778620	/users/cn/jespinosa/phecomp/data/CRG/20120502_FDF_CRG/20120502_FDF_CRG/20120511_FDF_CRG_c12.mtb	1592	2668	WWSS	food_sc	3	47462	1336778327	1	0.16	0.000546075085324232	7655	1
3	Drink 2	Intake 2	26	47783	1336778648	/users/cn/jespinosa/phecomp/data/CRG/20120502_FDF_CRG/20120502_FDF_CRG/20120511_FDF_CRG_c12.mtb	2138	NA	WWSS	water	2	47757	1336778622	1	0.0800000000000001	0.00307692307692308	7656	1
3	Drink 1	Intake 1	27	47836	1336778701	/users/cn/jespinosa/phecomp/data/CRG/20120502_FDF_CRG/20120502_FDF_CRG/20120511_FDF_CRG_c12.mtb	767	NA	WWSS	water	1	47809	1336778674	1	0.04	0.00148148148148148	7657	1
3	Drink 2	Intake 2	19	48706	1336779571	/users/cn/jespinosa/phecomp/data/CRG/20120502_FDF_CRG/20120502_FDF_CRG/20120511_FDF_CRG_c12.mtb	2140	NA	WWSS	water	2	48687	1336779552	1	0.0399999999999998	0.00210526315789473	7658	1
3	Drink 1	Intake 1	14	50067	1336780932	/users/cn/jespinosa/phecomp/data/CRG/20120502_FDF_CRG/20120502_FDF_CRG/20120511_FDF_CRG_c12.mtb	768	NA	WWSS	water	1	50053	1336780918	1	0.04	0.00285714285714286	7659	1
3	Food 1	Intake 3	369	50792	1336781657	/users/cn/jespinosa/phecomp/data/CRG/20120502_FDF_CRG/20120502_FDF_CRG/20120511_FDF_CRG_c12.mtb	1593	1172	WWSS	food_sc	3	50423	1336781288	1	0.22	0.000596205962059621	7660	1
3	Drink 2	Intake 2	13	50809	1336781674	/users/cn/jespinosa/phecomp/data/CRG/20120502_FDF_CRG/20120502_FDF_CRG/20120511_FDF_CRG_c12.mtb	2142	NA	WWSS	water	2	50796	1336781661	1	0.0600000000000001	0.00461538461538462	7661	1
3	Drink 2	Intake 2	13	51168	1336782033	/users/cn/jespinosa/phecomp/data/CRG/20120502_FDF_CRG/20120502_FDF_CRG/20120511_FDF_CRG_c12.mtb	2143	NA	WWSS	water	2	51155	1336782020	1	0.0600000000000001	0.00461538461538462	7662	1
3	Drink 2	Intake 2	88	51494	1336782359	/users/cn/jespinosa/phecomp/data/CRG/20120502_FDF_CRG/20120502_FDF_CRG/20120511_FDF_CRG_c12.mtb	2144	NA	WWSS	water	2	51406	1336782271	1	0.02	0.000227272727272727	7663	1
3	Food 2	Intake 4	76	52040	1336782905	/users/cn/jespinosa/phecomp/data/CRG/20120502_FDF_CRG/20120502_FDF_CRG/20120511_FDF_CRG_c12.mtb	2473	1425	WWSS	food_sc	4	51964	1336782829	1	0.02	0.000263157894736842	7664	1
3	Drink 2	Intake 2	19	52173	1336783038	/users/cn/jespinosa/phecomp/data/CRG/20120502_FDF_CRG/20120502_FDF_CRG/20120511_FDF_CRG_c12.mtb	2147	NA	WWSS	water	2	52154	1336783019	1	0.0399999999999998	0.00210526315789473	7665	1
3	Drink 2	Intake 2	15	52374	1336783239	/users/cn/jespinosa/phecomp/data/CRG/20120502_FDF_CRG/20120502_FDF_CRG/20120511_FDF_CRG_c12.mtb	2148	NA	WWSS	water	2	52359	1336783224	1	0.04	0.00266666666666667	7666	1
3	Drink 1	Intake 1	42	52714	1336783579	/users/cn/jespinosa/phecomp/data/CRG/20120502_FDF_CRG/20120502_FDF_CRG/20120511_FDF_CRG_c12.mtb	772	NA	WWSS	water	1	52672	1336783537	1	0.02	0.000476190476190476	7667	1
3	Drink 2	Intake 2	28	52774	1336783639	/users/cn/jespinosa/phecomp/data/CRG/20120502_FDF_CRG/20120502_FDF_CRG/20120511_FDF_CRG_c12.mtb	2150	NA	WWSS	water	2	52746	1336783611	1	0.02	0.000714285714285714	7668	1
3	Food 1	Intake 3	85	53550	1336784415	/users/cn/jespinosa/phecomp/data/CRG/20120502_FDF_CRG/20120502_FDF_CRG/20120511_FDF_CRG_c12.mtb	1596	6830	WWSS	food_sc	3	53465	1336784330	1	0.22	0.00258823529411765	7669	1
3	Drink 2	Intake 2	28	53848	1336784713	/users/cn/jespinosa/phecomp/data/CRG/20120502_FDF_CRG/20120502_FDF_CRG/20120511_FDF_CRG_c12.mtb	2153	NA	WWSS	water	2	53820	1336784685	1	0.0800000000000001	0.00285714285714286	7670	1
3	Drink 2	Intake 2	15	54094	1336784959	/users/cn/jespinosa/phecomp/data/CRG/20120502_FDF_CRG/20120502_FDF_CRG/20120511_FDF_CRG_c12.mtb	2154	NA	WWSS	water	2	54079	1336784944	1	0.04	0.00266666666666667	7671	1
3	Drink 2	Intake 2	47	54476	1336785341	/users/cn/jespinosa/phecomp/data/CRG/20120502_FDF_CRG/20120502_FDF_CRG/20120511_FDF_CRG_c12.mtb	2156	NA	WWSS	water	2	54429	1336785294	1	0.04	0.000851063829787234	7672	1
3	Drink 1	Intake 1	18	55076	1336785941	/users/cn/jespinosa/phecomp/data/CRG/20120502_FDF_CRG/20120502_FDF_CRG/20120511_FDF_CRG_c12.mtb	777	NA	WWSS	water	1	55058	1336785923	1	0.02	0.00111111111111111	7673	1
3	Drink 2	Intake 2	29	55094	1336785959	/users/cn/jespinosa/phecomp/data/CRG/20120502_FDF_CRG/20120502_FDF_CRG/20120511_FDF_CRG_c12.mtb	2157	NA	WWSS	water	2	55065	1336785930	1	0.04	0.00137931034482759	7674	1
3	Drink 2	Intake 2	15	56005	1336786870	/users/cn/jespinosa/phecomp/data/CRG/20120502_FDF_CRG/20120502_FDF_CRG/20120511_FDF_CRG_c12.mtb	2159	NA	WWSS	water	2	55990	1336786855	1	0.02	0.00133333333333333	7675	1
3	Drink 2	Intake 2	16	59595	1336790460	/users/cn/jespinosa/phecomp/data/CRG/20120502_FDF_CRG/20120502_FDF_CRG/20120511_FDF_CRG_c12.mtb	2160	NA	WWSS	water	2	59579	1336790444	1	0.04	0.0025	7676	1
3	Food 2	Intake 4	110	60490	1336791355	/users/cn/jespinosa/phecomp/data/CRG/20120502_FDF_CRG/20120502_FDF_CRG/20120511_FDF_CRG_c12.mtb	2489	9	WWSS	food_sc	4	60380	1336791245	1	0.02	0.000181818181818182	7677	1
3	Food 1	Intake 3	71	60570	1336791435	/users/cn/jespinosa/phecomp/data/CRG/20120502_FDF_CRG/20120502_FDF_CRG/20120511_FDF_CRG_c12.mtb	1603	3353	WWSS	food_sc	3	60499	1336791364	1	0.04	0.000563380281690141	7678	1
3	Drink 1	Intake 1	15	60936	1336791801	/users/cn/jespinosa/phecomp/data/CRG/20120502_FDF_CRG/20120502_FDF_CRG/20120511_FDF_CRG_c12.mtb	779	NA	WWSS	water	1	60921	1336791786	1	0.02	0.00133333333333333	7679	1
3	Drink 2	Intake 2	25	61228	1336792093	/users/cn/jespinosa/phecomp/data/CRG/20120502_FDF_CRG/20120502_FDF_CRG/20120511_FDF_CRG_c12.mtb	2161	NA	WWSS	water	2	61203	1336792068	1	0.0399999999999998	0.00159999999999999	7680	1
3	Drink 2	Intake 2	20	61342	1336792207	/users/cn/jespinosa/phecomp/data/CRG/20120502_FDF_CRG/20120502_FDF_CRG/20120511_FDF_CRG_c12.mtb	2162	NA	WWSS	water	2	61322	1336792187	1	0.04	0.002	7681	1
3	Food 2	Intake 4	356	64279	1336795144	/users/cn/jespinosa/phecomp/data/CRG/20120502_FDF_CRG/20120502_FDF_CRG/20120511_FDF_CRG_c12.mtb	2494	25	WWSS	food_sc	4	63923	1336794788	1	0.0600000000000001	0.000168539325842697	7682	1
3	Food 2	Intake 4	103	64407	1336795272	/users/cn/jespinosa/phecomp/data/CRG/20120502_FDF_CRG/20120502_FDF_CRG/20120511_FDF_CRG_c12.mtb	2495	2137	WWSS	food_sc	4	64304	1336795169	1	0.02	0.000194174757281553	7683	1
3	Drink 2	Intake 2	18	64427	1336795292	/users/cn/jespinosa/phecomp/data/CRG/20120502_FDF_CRG/20120502_FDF_CRG/20120511_FDF_CRG_c12.mtb	2163	NA	WWSS	water	2	64409	1336795274	1	0.04	0.00222222222222222	7684	1
3	Drink 1	Intake 1	19	64564	1336795429	/users/cn/jespinosa/phecomp/data/CRG/20120502_FDF_CRG/20120502_FDF_CRG/20120511_FDF_CRG_c12.mtb	781	NA	WWSS	water	1	64545	1336795410	1	0.08	0.00421052631578947	7685	1
3	Food 2	Intake 4	477	67021	1336797886	/users/cn/jespinosa/phecomp/data/CRG/20120502_FDF_CRG/20120502_FDF_CRG/20120511_FDF_CRG_c12.mtb	2498	545	WWSS	food_sc	4	66544	1336797409	1	0.16	0.000335429769392034	7686	1
3	Drink 2	Intake 2	23	67056	1336797921	/users/cn/jespinosa/phecomp/data/CRG/20120502_FDF_CRG/20120502_FDF_CRG/20120511_FDF_CRG_c12.mtb	2164	NA	WWSS	water	2	67033	1336797898	1	0.0599999999999998	0.0026086956521739	7687	1
3	Drink 2	Intake 2	31	67326	1336798191	/users/cn/jespinosa/phecomp/data/CRG/20120502_FDF_CRG/20120502_FDF_CRG/20120511_FDF_CRG_c12.mtb	2165	NA	WWSS	water	2	67295	1336798160	1	0.1	0.0032258064516129	7688	1
3	Food 2	Intake 4	397	67963	1336798828	/users/cn/jespinosa/phecomp/data/CRG/20120502_FDF_CRG/20120502_FDF_CRG/20120511_FDF_CRG_c12.mtb	2503	1969	WWSS	food_sc	4	67566	1336798431	1	0.04	0.000100755667506297	7689	1
3	Drink 2	Intake 2	18	68005	1336798870	/users/cn/jespinosa/phecomp/data/CRG/20120502_FDF_CRG/20120502_FDF_CRG/20120511_FDF_CRG_c12.mtb	2166	NA	WWSS	water	2	67987	1336798852	1	0.0600000000000001	0.00333333333333334	7690	1
3	Drink 1	Intake 1	15	69091	1336799956	/users/cn/jespinosa/phecomp/data/CRG/20120502_FDF_CRG/20120502_FDF_CRG/20120511_FDF_CRG_c12.mtb	782	NA	WWSS	water	1	69076	1336799941	1	0.02	0.00133333333333333	7691	1
3	Food 2	Intake 4	121	70053	1336800918	/users/cn/jespinosa/phecomp/data/CRG/20120502_FDF_CRG/20120502_FDF_CRG/20120511_FDF_CRG_c12.mtb	2507	421	WWSS	food_sc	4	69932	1336800797	1	0.02	0.000165289256198347	7692	1
3	Food 2	Intake 4	403	70877	1336801742	/users/cn/jespinosa/phecomp/data/CRG/20120502_FDF_CRG/20120502_FDF_CRG/20120511_FDF_CRG_c12.mtb	2510	12	WWSS	food_sc	4	70474	1336801339	1	0.12	0.000297766749379653	7693	1
3	Food 2	Intake 4	103	70992	1336801857	/users/cn/jespinosa/phecomp/data/CRG/20120502_FDF_CRG/20120502_FDF_CRG/20120511_FDF_CRG_c12.mtb	2511	640	WWSS	food_sc	4	70889	1336801754	1	0.02	0.000194174757281553	7694	1
3	Drink 2	Intake 2	23	71066	1336801931	/users/cn/jespinosa/phecomp/data/CRG/20120502_FDF_CRG/20120502_FDF_CRG/20120511_FDF_CRG_c12.mtb	2167	NA	WWSS	water	2	71043	1336801908	1	0.0800000000000001	0.00347826086956522	7695	1
3	Drink 2	Intake 2	16	71404	1336802269	/users/cn/jespinosa/phecomp/data/CRG/20120502_FDF_CRG/20120502_FDF_CRG/20120511_FDF_CRG_c12.mtb	2169	NA	WWSS	water	2	71388	1336802253	1	0.02	0.00125	7696	1
3	Food 2	Intake 4	166	71798	1336802663	/users/cn/jespinosa/phecomp/data/CRG/20120502_FDF_CRG/20120502_FDF_CRG/20120511_FDF_CRG_c12.mtb	2516	42141	WWSS	food_sc	4	71632	1336802497	1	0.02	0.000120481927710843	7697	1
3	Drink 1	Intake 1	16	71898	1336802763	/users/cn/jespinosa/phecomp/data/CRG/20120502_FDF_CRG/20120502_FDF_CRG/20120511_FDF_CRG_c12.mtb	785	NA	WWSS	water	1	71882	1336802747	1	0.02	0.00125	7698	1
3	Drink 1	Intake 1	19	72017	1336802882	/users/cn/jespinosa/phecomp/data/CRG/20120502_FDF_CRG/20120502_FDF_CRG/20120511_FDF_CRG_c12.mtb	786	NA	WWSS	water	1	71998	1336802863	1	0.02	0.00105263157894737	7699	1
3	Drink 2	Intake 2	17	83446	1336814311	/users/cn/jespinosa/phecomp/data/CRG/20120502_FDF_CRG/20120502_FDF_CRG/20120511_FDF_CRG_c12.mtb	2174	NA	WWSS	water	2	83429	1336814294	1	0.02	0.00117647058823529	7700	1
3	Food 1	Intake 3	49	113988	1336844853	/users/cn/jespinosa/phecomp/data/CRG/20120502_FDF_CRG/20120502_FDF_CRG/20120511_FDF_CRG_c12.mtb	1623	47	WWSS	food_sc	3	113939	1336844804	1	0.02	0.000408163265306122	7701	1
3	Food 2	Intake 4	938	114973	1336845838	/users/cn/jespinosa/phecomp/data/CRG/20120502_FDF_CRG/20120502_FDF_CRG/20120511_FDF_CRG_c12.mtb	2524	1942	WWSS	food_sc	4	114035	1336844900	1	0.18	0.000191897654584222	7702	1
3	Drink 2	Intake 2	14	114989	1336845854	/users/cn/jespinosa/phecomp/data/CRG/20120502_FDF_CRG/20120502_FDF_CRG/20120511_FDF_CRG_c12.mtb	2177	NA	WWSS	water	2	114975	1336845840	1	0.02	0.00142857142857143	7703	1
3	Drink 1	Intake 1	22	115097	1336845962	/users/cn/jespinosa/phecomp/data/CRG/20120502_FDF_CRG/20120502_FDF_CRG/20120511_FDF_CRG_c12.mtb	789	NA	WWSS	water	1	115075	1336845940	1	0.0599999999999999	0.00272727272727272	7704	1
3	Drink 1	Intake 1	18	115486	1336846351	/users/cn/jespinosa/phecomp/data/CRG/20120502_FDF_CRG/20120502_FDF_CRG/20120511_FDF_CRG_c12.mtb	790	NA	WWSS	water	1	115468	1336846333	1	0.0600000000000001	0.00333333333333334	7705	1
3	Drink 1	Intake 1	17	116421	1336847286	/users/cn/jespinosa/phecomp/data/CRG/20120502_FDF_CRG/20120502_FDF_CRG/20120511_FDF_CRG_c12.mtb	791	NA	WWSS	water	1	116404	1336847269	1	0.0399999999999999	0.00235294117647058	7706	1
3	Food 2	Intake 4	628	117543	1336848408	/users/cn/jespinosa/phecomp/data/CRG/20120502_FDF_CRG/20120502_FDF_CRG/20120511_FDF_CRG_c12.mtb	2528	1467	WWSS	food_sc	4	116915	1336847780	1	0.26	0.000414012738853503	7707	1
3	Drink 1	Intake 1	15	117553	1336848418	/users/cn/jespinosa/phecomp/data/CRG/20120502_FDF_CRG/20120502_FDF_CRG/20120511_FDF_CRG_c12.mtb	792	NA	WWSS	water	1	117538	1336848403	1	0.0600000000000001	0.00400000000000001	7708	1
3	Drink 2	Intake 2	9	117643	1336848508	/users/cn/jespinosa/phecomp/data/CRG/20120502_FDF_CRG/20120502_FDF_CRG/20120511_FDF_CRG_c12.mtb	2179	NA	WWSS	water	2	117634	1336848499	1	0.04	0.00444444444444444	7709	1
3	Drink 2	Intake 2	33	118244	1336849109	/users/cn/jespinosa/phecomp/data/CRG/20120502_FDF_CRG/20120502_FDF_CRG/20120511_FDF_CRG_c12.mtb	2183	NA	WWSS	water	2	118211	1336849076	1	0.02	0.000606060606060606	7710	1
3	Drink 1	Intake 1	14	118973	1336849838	/users/cn/jespinosa/phecomp/data/CRG/20120502_FDF_CRG/20120502_FDF_CRG/20120511_FDF_CRG_c12.mtb	793	NA	WWSS	water	1	118959	1336849824	1	0.02	0.00142857142857143	7711	1
3	Food 2	Intake 4	379	119389	1336850254	/users/cn/jespinosa/phecomp/data/CRG/20120502_FDF_CRG/20120502_FDF_CRG/20120511_FDF_CRG_c12.mtb	2535	1100	WWSS	food_sc	4	119010	1336849875	1	0.16	0.000422163588390501	7712	1
3	Drink 2	Intake 2	20	119401	1336850266	/users/cn/jespinosa/phecomp/data/CRG/20120502_FDF_CRG/20120502_FDF_CRG/20120511_FDF_CRG_c12.mtb	2185	NA	WWSS	water	2	119381	1336850246	1	0.0799999999999996	0.00399999999999998	7713	1
3	Food 2	Intake 4	206	120695	1336851560	/users/cn/jespinosa/phecomp/data/CRG/20120502_FDF_CRG/20120502_FDF_CRG/20120511_FDF_CRG_c12.mtb	2537	676	WWSS	food_sc	4	120489	1336851354	1	0.0599999999999998	0.000291262135922329	7714	1
3	Drink 2	Intake 2	20	120718	1336851583	/users/cn/jespinosa/phecomp/data/CRG/20120502_FDF_CRG/20120502_FDF_CRG/20120511_FDF_CRG_c12.mtb	2187	NA	WWSS	water	2	120698	1336851563	1	0.02	0.001	7715	1
3	Food 1	Intake 3	122	121493	1336852358	/users/cn/jespinosa/phecomp/data/CRG/20120502_FDF_CRG/20120502_FDF_CRG/20120511_FDF_CRG_c12.mtb	1626	88	WWSS	food_sc	3	121371	1336852236	1	0.02	0.000163934426229508	7716	1
3	Drink 2	Intake 2	18	121524	1336852389	/users/cn/jespinosa/phecomp/data/CRG/20120502_FDF_CRG/20120502_FDF_CRG/20120511_FDF_CRG_c12.mtb	2188	NA	WWSS	water	2	121506	1336852371	1	0.0600000000000001	0.00333333333333334	7717	1
3	Food 2	Intake 4	205	121786	1336852651	/users/cn/jespinosa/phecomp/data/CRG/20120502_FDF_CRG/20120502_FDF_CRG/20120511_FDF_CRG_c12.mtb	2541	731	WWSS	food_sc	4	121581	1336852446	1	0.0800000000000001	0.000390243902439025	7718	1
3	Drink 2	Intake 2	12	121800	1336852665	/users/cn/jespinosa/phecomp/data/CRG/20120502_FDF_CRG/20120502_FDF_CRG/20120511_FDF_CRG_c12.mtb	2189	NA	WWSS	water	2	121788	1336852653	1	0.04	0.00333333333333333	7719	1
3	Food 2	Intake 4	180	122697	1336853562	/users/cn/jespinosa/phecomp/data/CRG/20120502_FDF_CRG/20120502_FDF_CRG/20120511_FDF_CRG_c12.mtb	2542	960	WWSS	food_sc	4	122517	1336853382	1	0.0600000000000001	0.000333333333333334	7720	1
3	Drink 2	Intake 2	29	122726	1336853591	/users/cn/jespinosa/phecomp/data/CRG/20120502_FDF_CRG/20120502_FDF_CRG/20120511_FDF_CRG_c12.mtb	2190	NA	WWSS	water	2	122697	1336853562	1	0.04	0.00137931034482759	7721	1
3	Drink 2	Intake 2	49	123331	1336854196	/users/cn/jespinosa/phecomp/data/CRG/20120502_FDF_CRG/20120502_FDF_CRG/20120511_FDF_CRG_c12.mtb	2191	NA	WWSS	water	2	123282	1336854147	1	0.04	0.000816326530612245	7722	1
3	Drink 2	Intake 2	12	123454	1336854319	/users/cn/jespinosa/phecomp/data/CRG/20120502_FDF_CRG/20120502_FDF_CRG/20120511_FDF_CRG_c12.mtb	2194	NA	WWSS	water	2	123442	1336854307	1	0.02	0.00166666666666667	7723	1
3	Food 2	Intake 4	458	124115	1336854980	/users/cn/jespinosa/phecomp/data/CRG/20120502_FDF_CRG/20120502_FDF_CRG/20120511_FDF_CRG_c12.mtb	2547	6	WWSS	food_sc	4	123657	1336854522	1	0.26	0.000567685589519651	7724	1
3	Food 2	Intake 4	24	124145	1336855010	/users/cn/jespinosa/phecomp/data/CRG/20120502_FDF_CRG/20120502_FDF_CRG/20120511_FDF_CRG_c12.mtb	2548	5970	WWSS	food_sc	4	124121	1336854986	1	0.24	0.01	7725	1
3	Drink 2	Intake 2	25	124307	1336855172	/users/cn/jespinosa/phecomp/data/CRG/20120502_FDF_CRG/20120502_FDF_CRG/20120511_FDF_CRG_c12.mtb	2195	NA	WWSS	water	2	124282	1336855147	1	0.0600000000000001	0.0024	7726	1
3	Drink 2	Intake 2	43	124391	1336855256	/users/cn/jespinosa/phecomp/data/CRG/20120502_FDF_CRG/20120502_FDF_CRG/20120511_FDF_CRG_c12.mtb	2196	NA	WWSS	water	2	124348	1336855213	1	0.0600000000000001	0.0013953488372093	7727	1
3	Drink 2	Intake 2	14	124608	1336855473	/users/cn/jespinosa/phecomp/data/CRG/20120502_FDF_CRG/20120502_FDF_CRG/20120511_FDF_CRG_c12.mtb	2198	NA	WWSS	water	2	124594	1336855459	1	0.02	0.00142857142857143	7728	1
3	Drink 2	Intake 2	11	124919	1336855784	/users/cn/jespinosa/phecomp/data/CRG/20120502_FDF_CRG/20120502_FDF_CRG/20120511_FDF_CRG_c12.mtb	2201	NA	WWSS	water	2	124908	1336855773	1	0.02	0.00181818181818182	7729	1
3	Drink 1	Intake 1	12	125603	1336856468	/users/cn/jespinosa/phecomp/data/CRG/20120502_FDF_CRG/20120502_FDF_CRG/20120511_FDF_CRG_c12.mtb	798	NA	WWSS	water	1	125591	1336856456	1	0.0600000000000001	0.00500000000000001	7730	1
3	Drink 2	Intake 2	14	126365	1336857230	/users/cn/jespinosa/phecomp/data/CRG/20120502_FDF_CRG/20120502_FDF_CRG/20120511_FDF_CRG_c12.mtb	2203	NA	WWSS	water	2	126351	1336857216	1	0.0399999999999996	0.00285714285714283	7731	1
3	Food 2	Intake 4	253	130368	1336861233	/users/cn/jespinosa/phecomp/data/CRG/20120502_FDF_CRG/20120502_FDF_CRG/20120511_FDF_CRG_c12.mtb	2559	918	WWSS	food_sc	4	130115	1336860980	1	0.12	0.000474308300395257	7732	1
3	Drink 2	Intake 2	20	130387	1336861252	/users/cn/jespinosa/phecomp/data/CRG/20120502_FDF_CRG/20120502_FDF_CRG/20120511_FDF_CRG_c12.mtb	2205	NA	WWSS	water	2	130367	1336861232	1	0.04	0.002	7733	1
3	Drink 2	Intake 2	40	130482	1336861347	/users/cn/jespinosa/phecomp/data/CRG/20120502_FDF_CRG/20120502_FDF_CRG/20120511_FDF_CRG_c12.mtb	2206	NA	WWSS	water	2	130442	1336861307	1	0.04	0.001	7734	1
3	Drink 2	Intake 2	21	130980	1336861845	/users/cn/jespinosa/phecomp/data/CRG/20120502_FDF_CRG/20120502_FDF_CRG/20120511_FDF_CRG_c12.mtb	2209	NA	WWSS	water	2	130959	1336861824	1	0.0600000000000001	0.00285714285714286	7735	1
3	Food 2	Intake 4	117	131403	1336862268	/users/cn/jespinosa/phecomp/data/CRG/20120502_FDF_CRG/20120502_FDF_CRG/20120511_FDF_CRG_c12.mtb	2568	12	WWSS	food_sc	4	131286	1336862151	1	0.02	0.000170940170940171	7736	1
3	Food 2	Intake 4	240	131655	1336862520	/users/cn/jespinosa/phecomp/data/CRG/20120502_FDF_CRG/20120502_FDF_CRG/20120511_FDF_CRG_c12.mtb	2569	209	WWSS	food_sc	4	131415	1336862280	1	0.0800000000000001	0.000333333333333334	7737	1
3	Drink 2	Intake 2	18	131669	1336862534	/users/cn/jespinosa/phecomp/data/CRG/20120502_FDF_CRG/20120502_FDF_CRG/20120511_FDF_CRG_c12.mtb	2210	NA	WWSS	water	2	131651	1336862516	1	0.0600000000000001	0.00333333333333334	7738	1
3	Drink 2	Intake 2	44	131795	1336862660	/users/cn/jespinosa/phecomp/data/CRG/20120502_FDF_CRG/20120502_FDF_CRG/20120511_FDF_CRG_c12.mtb	2211	NA	WWSS	water	2	131751	1336862616	1	0.1	0.00227272727272727	7739	1
3	Food 2	Intake 4	290	132154	1336863019	/users/cn/jespinosa/phecomp/data/CRG/20120502_FDF_CRG/20120502_FDF_CRG/20120511_FDF_CRG_c12.mtb	2571	1270	WWSS	food_sc	4	131864	1336862729	1	0.0600000000000005	0.00020689655172414	7740	1
3	Drink 2	Intake 2	17	132419	1336863284	/users/cn/jespinosa/phecomp/data/CRG/20120502_FDF_CRG/20120502_FDF_CRG/20120511_FDF_CRG_c12.mtb	2213	NA	WWSS	water	2	132402	1336863267	1	0.04	0.00235294117647059	7741	1
3	Drink 2	Intake 2	40	133160	1336864025	/users/cn/jespinosa/phecomp/data/CRG/20120502_FDF_CRG/20120502_FDF_CRG/20120511_FDF_CRG_c12.mtb	2214	NA	WWSS	water	2	133120	1336863985	1	0.04	0.001	7742	1
3	Food 2	Intake 4	430	133854	1336864719	/users/cn/jespinosa/phecomp/data/CRG/20120502_FDF_CRG/20120502_FDF_CRG/20120511_FDF_CRG_c12.mtb	2576	764	WWSS	food_sc	4	133424	1336864289	1	0.2	0.000465116279069767	7743	1
3	Drink 2	Intake 2	26	133873	1336864738	/users/cn/jespinosa/phecomp/data/CRG/20120502_FDF_CRG/20120502_FDF_CRG/20120511_FDF_CRG_c12.mtb	2215	NA	WWSS	water	2	133847	1336864712	1	0.0800000000000001	0.00307692307692308	7744	1
3	Food 2	Intake 4	269	134887	1336865752	/users/cn/jespinosa/phecomp/data/CRG/20120502_FDF_CRG/20120502_FDF_CRG/20120511_FDF_CRG_c12.mtb	2580	1662	WWSS	food_sc	4	134618	1336865483	1	0.04	0.000148698884758364	7745	1
3	Drink 2	Intake 2	19	134911	1336865776	/users/cn/jespinosa/phecomp/data/CRG/20120502_FDF_CRG/20120502_FDF_CRG/20120511_FDF_CRG_c12.mtb	2216	NA	WWSS	water	2	134892	1336865757	1	0.02	0.00105263157894737	7746	1
3	Drink 1	Intake 1	17	135453	1336866318	/users/cn/jespinosa/phecomp/data/CRG/20120502_FDF_CRG/20120502_FDF_CRG/20120511_FDF_CRG_c12.mtb	803	NA	WWSS	water	1	135436	1336866301	1	0.0599999999999999	0.00352941176470588	7747	1
3	Food 1	Intake 3	553	137102	1336867967	/users/cn/jespinosa/phecomp/data/CRG/20120502_FDF_CRG/20120502_FDF_CRG/20120511_FDF_CRG_c12.mtb	1636	5	WWSS	food_sc	3	136549	1336867414	1	0.2	0.000361663652802893	7748	1
3	Food 1	Intake 3	194	137301	1336868166	/users/cn/jespinosa/phecomp/data/CRG/20120502_FDF_CRG/20120502_FDF_CRG/20120511_FDF_CRG_c12.mtb	1637	159	WWSS	food_sc	3	137107	1336867972	1	0.0800000000000001	0.000412371134020619	7749	1
3	Drink 2	Intake 2	13	137318	1336868183	/users/cn/jespinosa/phecomp/data/CRG/20120502_FDF_CRG/20120502_FDF_CRG/20120511_FDF_CRG_c12.mtb	2221	NA	WWSS	water	2	137305	1336868170	1	0.0599999999999996	0.00461538461538458	7750	1
3	Drink 2	Intake 2	31	137360	1336868225	/users/cn/jespinosa/phecomp/data/CRG/20120502_FDF_CRG/20120502_FDF_CRG/20120511_FDF_CRG_c12.mtb	2222	NA	WWSS	water	2	137329	1336868194	1	0.0200000000000005	0.000645161290322597	7751	1
3	Food 1	Intake 3	49	137509	1336868374	/users/cn/jespinosa/phecomp/data/CRG/20120502_FDF_CRG/20120502_FDF_CRG/20120511_FDF_CRG_c12.mtb	1638	493	WWSS	food_sc	3	137460	1336868325	1	0.02	0.000408163265306122	7752	1
3	Drink 2	Intake 2	27	137718	1336868583	/users/cn/jespinosa/phecomp/data/CRG/20120502_FDF_CRG/20120502_FDF_CRG/20120511_FDF_CRG_c12.mtb	2223	NA	WWSS	water	2	137691	1336868556	1	0.0399999999999996	0.00148148148148147	7753	1
3	Food 1	Intake 3	188	138190	1336869055	/users/cn/jespinosa/phecomp/data/CRG/20120502_FDF_CRG/20120502_FDF_CRG/20120511_FDF_CRG_c12.mtb	1639	849	WWSS	food_sc	3	138002	1336868867	1	0.0600000000000001	0.000319148936170213	7754	1
3	Drink 2	Intake 2	18	138205	1336869070	/users/cn/jespinosa/phecomp/data/CRG/20120502_FDF_CRG/20120502_FDF_CRG/20120511_FDF_CRG_c12.mtb	2225	NA	WWSS	water	2	138187	1336869052	1	0.04	0.00222222222222222	7755	1
3	Drink 1	Intake 1	15	138351	1336869216	/users/cn/jespinosa/phecomp/data/CRG/20120502_FDF_CRG/20120502_FDF_CRG/20120511_FDF_CRG_c12.mtb	806	NA	WWSS	water	1	138336	1336869201	1	0.02	0.00133333333333333	7756	1
3	Food 2	Intake 4	52	139091	1336869956	/users/cn/jespinosa/phecomp/data/CRG/20120502_FDF_CRG/20120502_FDF_CRG/20120511_FDF_CRG_c12.mtb	2589	6443	WWSS	food_sc	4	139039	1336869904	1	0.02	0.000384615384615385	7757	1
3	Food 1	Intake 3	214	145748	1336876613	/users/cn/jespinosa/phecomp/data/CRG/20120502_FDF_CRG/20120502_FDF_CRG/20120511_FDF_CRG_c12.mtb	1644	19	WWSS	food_sc	3	145534	1336876399	1	0.1	0.000467289719626168	7758	1
3	Food 1	Intake 3	149	145916	1336876781	/users/cn/jespinosa/phecomp/data/CRG/20120502_FDF_CRG/20120502_FDF_CRG/20120511_FDF_CRG_c12.mtb	1645	609	WWSS	food_sc	3	145767	1336876632	1	0.0600000000000001	0.00040268456375839	7759	1
3	Drink 2	Intake 2	20	146266	1336877131	/users/cn/jespinosa/phecomp/data/CRG/20120502_FDF_CRG/20120502_FDF_CRG/20120511_FDF_CRG_c12.mtb	2235	NA	WWSS	water	2	146246	1336877111	1	0.0800000000000001	0.00400000000000001	7760	1
3	Drink 2	Intake 2	14	146366	1336877231	/users/cn/jespinosa/phecomp/data/CRG/20120502_FDF_CRG/20120502_FDF_CRG/20120511_FDF_CRG_c12.mtb	2236	NA	WWSS	water	2	146352	1336877217	1	0.02	0.00142857142857143	7761	1
3	Food 1	Intake 3	267	146792	1336877657	/users/cn/jespinosa/phecomp/data/CRG/20120502_FDF_CRG/20120502_FDF_CRG/20120511_FDF_CRG_c12.mtb	1647	2741	WWSS	food_sc	3	146525	1336877390	1	0.1	0.000374531835205993	7762	1
3	Drink 2	Intake 2	14	146817	1336877682	/users/cn/jespinosa/phecomp/data/CRG/20120502_FDF_CRG/20120502_FDF_CRG/20120511_FDF_CRG_c12.mtb	2237	NA	WWSS	water	2	146803	1336877668	1	0.04	0.00285714285714286	7763	1
3	Drink 2	Intake 2	16	146945	1336877810	/users/cn/jespinosa/phecomp/data/CRG/20120502_FDF_CRG/20120502_FDF_CRG/20120511_FDF_CRG_c12.mtb	2238	NA	WWSS	water	2	146929	1336877794	1	0.02	0.00125	7764	1
3	Drink 1	Intake 1	17	147063	1336877928	/users/cn/jespinosa/phecomp/data/CRG/20120502_FDF_CRG/20120502_FDF_CRG/20120511_FDF_CRG_c12.mtb	809	NA	WWSS	water	1	147046	1336877911	1	0.0800000000000001	0.00470588235294118	7765	1
3	Food 1	Intake 3	155	149688	1336880553	/users/cn/jespinosa/phecomp/data/CRG/20120502_FDF_CRG/20120502_FDF_CRG/20120511_FDF_CRG_c12.mtb	1649	619	WWSS	food_sc	3	149533	1336880398	1	0.04	0.000258064516129032	7766	1
3	Drink 2	Intake 2	26	149824	1336880689	/users/cn/jespinosa/phecomp/data/CRG/20120502_FDF_CRG/20120502_FDF_CRG/20120511_FDF_CRG_c12.mtb	2240	NA	WWSS	water	2	149798	1336880663	1	0.02	0.000769230769230769	7767	1
3	Food 2	Intake 4	448	150755	1336881620	/users/cn/jespinosa/phecomp/data/CRG/20120502_FDF_CRG/20120502_FDF_CRG/20120511_FDF_CRG_c12.mtb	2599	109	WWSS	food_sc	4	150307	1336881172	1	0.16	0.000357142857142857	7768	1
3	Drink 2	Intake 2	39	150785	1336881650	/users/cn/jespinosa/phecomp/data/CRG/20120502_FDF_CRG/20120502_FDF_CRG/20120511_FDF_CRG_c12.mtb	2246	NA	WWSS	water	2	150746	1336881611	1	0.0600000000000001	0.00153846153846154	7769	1
3	Drink 2	Intake 2	18	150835	1336881700	/users/cn/jespinosa/phecomp/data/CRG/20120502_FDF_CRG/20120502_FDF_CRG/20120511_FDF_CRG_c12.mtb	2247	NA	WWSS	water	2	150817	1336881682	1	0.04	0.00222222222222222	7770	1
3	Food 2	Intake 4	34	150898	1336881763	/users/cn/jespinosa/phecomp/data/CRG/20120502_FDF_CRG/20120502_FDF_CRG/20120511_FDF_CRG_c12.mtb	2600	182	WWSS	food_sc	4	150864	1336881729	1	0.02	0.000588235294117647	7771	1
3	Food 2	Intake 4	121	151201	1336882066	/users/cn/jespinosa/phecomp/data/CRG/20120502_FDF_CRG/20120502_FDF_CRG/20120511_FDF_CRG_c12.mtb	2602	423	WWSS	food_sc	4	151080	1336881945	1	0.02	0.000165289256198347	7772	1
3	Drink 2	Intake 2	41	151236	1336882101	/users/cn/jespinosa/phecomp/data/CRG/20120502_FDF_CRG/20120502_FDF_CRG/20120511_FDF_CRG_c12.mtb	2249	NA	WWSS	water	2	151195	1336882060	1	0.0600000000000001	0.00146341463414634	7773	1
3	Food 2	Intake 4	126	151750	1336882615	/users/cn/jespinosa/phecomp/data/CRG/20120502_FDF_CRG/20120502_FDF_CRG/20120511_FDF_CRG_c12.mtb	2603	3365	WWSS	food_sc	4	151624	1336882489	1	0.0599999999999996	0.000476190476190473	7774	1
3	Drink 2	Intake 2	21	151763	1336882628	/users/cn/jespinosa/phecomp/data/CRG/20120502_FDF_CRG/20120502_FDF_CRG/20120511_FDF_CRG_c12.mtb	2251	NA	WWSS	water	2	151742	1336882607	1	0.04	0.0019047619047619	7775	1
3	Drink 2	Intake 2	31	152138	1336883003	/users/cn/jespinosa/phecomp/data/CRG/20120502_FDF_CRG/20120502_FDF_CRG/20120511_FDF_CRG_c12.mtb	2252	NA	WWSS	water	2	152107	1336882972	1	0.0600000000000001	0.00193548387096775	7776	1
3	Drink 1	Intake 1	16	154442	1336885307	/users/cn/jespinosa/phecomp/data/CRG/20120502_FDF_CRG/20120502_FDF_CRG/20120511_FDF_CRG_c12.mtb	811	NA	WWSS	water	1	154426	1336885291	1	0.02	0.00125	7777	1
3	Food 1	Intake 3	117	155232	1336886097	/users/cn/jespinosa/phecomp/data/CRG/20120502_FDF_CRG/20120502_FDF_CRG/20120511_FDF_CRG_c12.mtb	1652	9	WWSS	food_sc	3	155115	1336885980	1	0.04	0.000341880341880342	7778	1
3	Food 1	Intake 3	160	155401	1336886266	/users/cn/jespinosa/phecomp/data/CRG/20120502_FDF_CRG/20120502_FDF_CRG/20120511_FDF_CRG_c12.mtb	1653	579	WWSS	food_sc	3	155241	1336886106	1	0.04	0.00025	7779	1
3	Drink 2	Intake 2	22	155623	1336886488	/users/cn/jespinosa/phecomp/data/CRG/20120502_FDF_CRG/20120502_FDF_CRG/20120511_FDF_CRG_c12.mtb	2256	NA	WWSS	water	2	155601	1336886466	1	0.02	0.000909090909090909	7780	1
3	Food 1	Intake 3	63	156043	1336886908	/users/cn/jespinosa/phecomp/data/CRG/20120502_FDF_CRG/20120502_FDF_CRG/20120511_FDF_CRG_c12.mtb	1656	198	WWSS	food_sc	3	155980	1336886845	1	0.02	0.000317460317460317	7781	1
3	Food 1	Intake 3	321	156562	1336887427	/users/cn/jespinosa/phecomp/data/CRG/20120502_FDF_CRG/20120502_FDF_CRG/20120511_FDF_CRG_c12.mtb	1657	1401	WWSS	food_sc	3	156241	1336887106	1	0.14	0.00043613707165109	7782	1
3	Drink 2	Intake 2	29	156588	1336887453	/users/cn/jespinosa/phecomp/data/CRG/20120502_FDF_CRG/20120502_FDF_CRG/20120511_FDF_CRG_c12.mtb	2260	NA	WWSS	water	2	156559	1336887424	1	0.1	0.00344827586206897	7783	1
3	Drink 2	Intake 2	17	156803	1336887668	/users/cn/jespinosa/phecomp/data/CRG/20120502_FDF_CRG/20120502_FDF_CRG/20120511_FDF_CRG_c12.mtb	2261	NA	WWSS	water	2	156786	1336887651	1	0.02	0.00117647058823529	7784	1
3	Drink 2	Intake 2	22	157614	1336888479	/users/cn/jespinosa/phecomp/data/CRG/20120502_FDF_CRG/20120502_FDF_CRG/20120511_FDF_CRG_c12.mtb	2264	NA	WWSS	water	2	157592	1336888457	1	0.0800000000000001	0.00363636363636364	7785	1
3	Food 1	Intake 3	71	158034	1336888899	/users/cn/jespinosa/phecomp/data/CRG/20120502_FDF_CRG/20120502_FDF_CRG/20120511_FDF_CRG_c12.mtb	1663	COLL	WWSS	food_sc	3	157963	1336888828	1	0.02	0.00028169014084507	7786	1
3	Food 2	Intake 4	386	158412	1336889277	/users/cn/jespinosa/phecomp/data/CRG/20120502_FDF_CRG/20120502_FDF_CRG/20120511_FDF_CRG_c12.mtb	2616	9	WWSS	food_sc	4	158026	1336888891	1	0.22	0.000569948186528497	7787	1
3	Food 2	Intake 4	98	158519	1336889384	/users/cn/jespinosa/phecomp/data/CRG/20120502_FDF_CRG/20120502_FDF_CRG/20120511_FDF_CRG_c12.mtb	2617	7649	WWSS	food_sc	4	158421	1336889286	1	0.04	0.000408163265306122	7788	1
3	Drink 2	Intake 2	28	158541	1336889406	/users/cn/jespinosa/phecomp/data/CRG/20120502_FDF_CRG/20120502_FDF_CRG/20120511_FDF_CRG_c12.mtb	2265	NA	WWSS	water	2	158513	1336889378	1	0.0599999999999996	0.00214285714285713	7789	1
3	Drink 2	Intake 2	25	158604	1336889469	/users/cn/jespinosa/phecomp/data/CRG/20120502_FDF_CRG/20120502_FDF_CRG/20120511_FDF_CRG_c12.mtb	2266	NA	WWSS	water	2	158579	1336889444	1	0.100000000000001	0.00400000000000004	7790	1
3	Food 2	Intake 4	118	166286	1336897151	/users/cn/jespinosa/phecomp/data/CRG/20120502_FDF_CRG/20120502_FDF_CRG/20120511_FDF_CRG_c12.mtb	2621	13272	WWSS	food_sc	4	166168	1336897033	1	0.02	0.000169491525423729	7791	1
3	Food 2	Intake 4	152	179710	1336910575	/users/cn/jespinosa/phecomp/data/CRG/20120502_FDF_CRG/20120502_FDF_CRG/20120511_FDF_CRG_c12.mtb	2624	20934	WWSS	food_sc	4	179558	1336910423	1	0.04	0.000263157894736842	7792	1
3	Food 1	Intake 3	383	201027	1336931892	/users/cn/jespinosa/phecomp/data/CRG/20120502_FDF_CRG/20120502_FDF_CRG/20120511_FDF_CRG_c12.mtb	1669	1327	WWSS	food_sc	3	200644	1336931509	1	0.1	0.000261096605744125	7793	1
3	Food 2	Intake 4	20	202374	1336933239	/users/cn/jespinosa/phecomp/data/CRG/20120502_FDF_CRG/20120502_FDF_CRG/20120511_FDF_CRG_c12.mtb	2627	COLL	WWSS	food_sc	4	202354	1336933219	1	0.02	0.001	7794	1
3	Food 1	Intake 3	234	202607	1336933472	/users/cn/jespinosa/phecomp/data/CRG/20120502_FDF_CRG/20120502_FDF_CRG/20120511_FDF_CRG_c12.mtb	1671	60	WWSS	food_sc	3	202373	1336933238	1	0.02	8.54700854700855e-05	7795	1
3	Drink 1	Intake 1	20	202640	1336933505	/users/cn/jespinosa/phecomp/data/CRG/20120502_FDF_CRG/20120502_FDF_CRG/20120511_FDF_CRG_c12.mtb	821	NA	WWSS	water	1	202620	1336933485	1	0.04	0.002	7796	1
3	Food 2	Intake 4	427	203094	1336933959	/users/cn/jespinosa/phecomp/data/CRG/20120502_FDF_CRG/20120502_FDF_CRG/20120511_FDF_CRG_c12.mtb	2628	905	WWSS	food_sc	4	202667	1336933532	1	0.14	0.000327868852459016	7797	1
3	Drink 2	Intake 2	17	203172	1336934037	/users/cn/jespinosa/phecomp/data/CRG/20120502_FDF_CRG/20120502_FDF_CRG/20120511_FDF_CRG_c12.mtb	2276	NA	WWSS	water	2	203155	1336934020	1	0.0200000000000005	0.00117647058823532	7798	1
3	Drink 1	Intake 1	25	203326	1336934191	/users/cn/jespinosa/phecomp/data/CRG/20120502_FDF_CRG/20120502_FDF_CRG/20120511_FDF_CRG_c12.mtb	823	NA	WWSS	water	1	203301	1336934166	1	0.0599999999999998	0.00239999999999999	7799	1
3	Drink 2	Intake 2	17	203965	1336934830	/users/cn/jespinosa/phecomp/data/CRG/20120502_FDF_CRG/20120502_FDF_CRG/20120511_FDF_CRG_c12.mtb	2278	NA	WWSS	water	2	203948	1336934813	1	0.04	0.00235294117647059	7800	1
3	Food 2	Intake 4	312	204311	1336935176	/users/cn/jespinosa/phecomp/data/CRG/20120502_FDF_CRG/20120502_FDF_CRG/20120511_FDF_CRG_c12.mtb	2630	1217	WWSS	food_sc	4	203999	1336934864	1	0.14	0.000448717948717949	7801	1
3	Drink 1	Intake 1	12	204415	1336935280	/users/cn/jespinosa/phecomp/data/CRG/20120502_FDF_CRG/20120502_FDF_CRG/20120511_FDF_CRG_c12.mtb	824	NA	WWSS	water	1	204403	1336935268	1	0.04	0.00333333333333333	7802	1
3	Drink 1	Intake 1	16	205517	1336936382	/users/cn/jespinosa/phecomp/data/CRG/20120502_FDF_CRG/20120502_FDF_CRG/20120511_FDF_CRG_c12.mtb	825	NA	WWSS	water	1	205501	1336936366	1	0.02	0.00125	7803	1
3	Food 2	Intake 4	227	205755	1336936620	/users/cn/jespinosa/phecomp/data/CRG/20120502_FDF_CRG/20120502_FDF_CRG/20120511_FDF_CRG_c12.mtb	2632	788	WWSS	food_sc	4	205528	1336936393	1	0.0800000000000001	0.000352422907488987	7804	1
3	Drink 2	Intake 2	66	205928	1336936793	/users/cn/jespinosa/phecomp/data/CRG/20120502_FDF_CRG/20120502_FDF_CRG/20120511_FDF_CRG_c12.mtb	2280	NA	WWSS	water	2	205862	1336936727	1	0.0200000000000005	0.000303030303030311	7805	1
3	Food 2	Intake 4	96	206639	1336937504	/users/cn/jespinosa/phecomp/data/CRG/20120502_FDF_CRG/20120502_FDF_CRG/20120511_FDF_CRG_c12.mtb	2633	4	WWSS	food_sc	4	206543	1336937408	1	0.0599999999999996	0.000624999999999996	7806	1
3	Food 2	Intake 4	137	206780	1336937645	/users/cn/jespinosa/phecomp/data/CRG/20120502_FDF_CRG/20120502_FDF_CRG/20120511_FDF_CRG_c12.mtb	2634	1176	WWSS	food_sc	4	206643	1336937508	1	0.0600000000000005	0.000437956204379566	7807	1
3	Drink 2	Intake 2	25	206801	1336937666	/users/cn/jespinosa/phecomp/data/CRG/20120502_FDF_CRG/20120502_FDF_CRG/20120511_FDF_CRG_c12.mtb	2285	NA	WWSS	water	2	206776	1336937641	1	0.04	0.0016	7808	1
3	Drink 2	Intake 2	17	207032	1336937897	/users/cn/jespinosa/phecomp/data/CRG/20120502_FDF_CRG/20120502_FDF_CRG/20120511_FDF_CRG_c12.mtb	2286	NA	WWSS	water	2	207015	1336937880	1	0.0200000000000005	0.00117647058823532	7809	1
3	Food 2	Intake 4	395	208351	1336939216	/users/cn/jespinosa/phecomp/data/CRG/20120502_FDF_CRG/20120502_FDF_CRG/20120511_FDF_CRG_c12.mtb	2635	228	WWSS	food_sc	4	207956	1336938821	1	0.44	0.00111392405063291	7810	1
3	Drink 2	Intake 2	29	208493	1336939358	/users/cn/jespinosa/phecomp/data/CRG/20120502_FDF_CRG/20120502_FDF_CRG/20120511_FDF_CRG_c12.mtb	2288	NA	WWSS	water	2	208464	1336939329	1	0.0800000000000001	0.00275862068965518	7811	1
3	Food 1	Intake 3	71	208650	1336939515	/users/cn/jespinosa/phecomp/data/CRG/20120502_FDF_CRG/20120502_FDF_CRG/20120511_FDF_CRG_c12.mtb	1673	5478	WWSS	food_sc	3	208579	1336939444	1	0.02	0.00028169014084507	7812	1
3	Drink 1	Intake 1	20	208999	1336939864	/users/cn/jespinosa/phecomp/data/CRG/20120502_FDF_CRG/20120502_FDF_CRG/20120511_FDF_CRG_c12.mtb	826	NA	WWSS	water	1	208979	1336939844	1	0.0600000000000001	0.00300000000000001	7813	1
3	Drink 2	Intake 2	22	209999	1336940864	/users/cn/jespinosa/phecomp/data/CRG/20120502_FDF_CRG/20120502_FDF_CRG/20120511_FDF_CRG_c12.mtb	2291	NA	WWSS	water	2	209977	1336940842	1	0.0800000000000001	0.00363636363636364	7814	1
3	Drink 1	Intake 1	15	211450	1336942315	/users/cn/jespinosa/phecomp/data/CRG/20120502_FDF_CRG/20120502_FDF_CRG/20120511_FDF_CRG_c12.mtb	827	NA	WWSS	water	1	211435	1336942300	1	0.04	0.00266666666666667	7815	1
3	Food 1	Intake 3	385	214513	1336945378	/users/cn/jespinosa/phecomp/data/CRG/20120502_FDF_CRG/20120502_FDF_CRG/20120511_FDF_CRG_c12.mtb	1680	231	WWSS	food_sc	3	214128	1336944993	1	0.0800000000000001	0.000207792207792208	7816	1
3	Food 1	Intake 3	369	215113	1336945978	/users/cn/jespinosa/phecomp/data/CRG/20120502_FDF_CRG/20120502_FDF_CRG/20120511_FDF_CRG_c12.mtb	1683	543	WWSS	food_sc	3	214744	1336945609	1	0.16	0.00043360433604336	7817	1
3	Drink 2	Intake 2	23	215143	1336946008	/users/cn/jespinosa/phecomp/data/CRG/20120502_FDF_CRG/20120502_FDF_CRG/20120511_FDF_CRG_c12.mtb	2295	NA	WWSS	water	2	215120	1336945985	1	0.12	0.00521739130434783	7818	1
3	Drink 2	Intake 2	20	215266	1336946131	/users/cn/jespinosa/phecomp/data/CRG/20120502_FDF_CRG/20120502_FDF_CRG/20120511_FDF_CRG_c12.mtb	2297	NA	WWSS	water	2	215246	1336946111	1	0.0200000000000005	0.00100000000000002	7819	1
3	Drink 1	Intake 1	20	215288	1336946153	/users/cn/jespinosa/phecomp/data/CRG/20120502_FDF_CRG/20120502_FDF_CRG/20120511_FDF_CRG_c12.mtb	830	NA	WWSS	water	1	215268	1336946133	1	0.02	0.001	7820	1
3	Drink 2	Intake 2	14	215446	1336946311	/users/cn/jespinosa/phecomp/data/CRG/20120502_FDF_CRG/20120502_FDF_CRG/20120511_FDF_CRG_c12.mtb	2298	NA	WWSS	water	2	215432	1336946297	1	0.04	0.00285714285714286	7821	1
3	Food 1	Intake 3	167	215823	1336946688	/users/cn/jespinosa/phecomp/data/CRG/20120502_FDF_CRG/20120502_FDF_CRG/20120511_FDF_CRG_c12.mtb	1686	1524	WWSS	food_sc	3	215656	1336946521	1	0.04	0.000239520958083832	7822	1
3	Drink 2	Intake 2	15	216427	1336947292	/users/cn/jespinosa/phecomp/data/CRG/20120502_FDF_CRG/20120502_FDF_CRG/20120511_FDF_CRG_c12.mtb	2299	NA	WWSS	water	2	216412	1336947277	1	0.04	0.00266666666666667	7823	1
3	Food 1	Intake 3	64	217411	1336948276	/users/cn/jespinosa/phecomp/data/CRG/20120502_FDF_CRG/20120502_FDF_CRG/20120511_FDF_CRG_c12.mtb	1690	344	WWSS	food_sc	3	217347	1336948212	1	0.02	0.0003125	7824	1
3	Food 2	Intake 4	289	218044	1336948909	/users/cn/jespinosa/phecomp/data/CRG/20120502_FDF_CRG/20120502_FDF_CRG/20120511_FDF_CRG_c12.mtb	2656	1753	WWSS	food_sc	4	217755	1336948620	1	0.04	0.00013840830449827	7825	1
3	Drink 2	Intake 2	18	218347	1336949212	/users/cn/jespinosa/phecomp/data/CRG/20120502_FDF_CRG/20120502_FDF_CRG/20120511_FDF_CRG_c12.mtb	2302	NA	WWSS	water	2	218329	1336949194	1	0.0200000000000005	0.00111111111111114	7826	1
3	Food 1	Intake 3	799	220596	1336951461	/users/cn/jespinosa/phecomp/data/CRG/20120502_FDF_CRG/20120502_FDF_CRG/20120511_FDF_CRG_c12.mtb	1695	855	WWSS	food_sc	3	219797	1336950662	1	0.3	0.000375469336670839	7827	1
3	Drink 1	Intake 1	21	220609	1336951474	/users/cn/jespinosa/phecomp/data/CRG/20120502_FDF_CRG/20120502_FDF_CRG/20120511_FDF_CRG_c12.mtb	834	NA	WWSS	water	1	220588	1336951453	1	0.04	0.0019047619047619	7828	1
3	Drink 1	Intake 1	18	220653	1336951518	/users/cn/jespinosa/phecomp/data/CRG/20120502_FDF_CRG/20120502_FDF_CRG/20120511_FDF_CRG_c12.mtb	835	NA	WWSS	water	1	220635	1336951500	1	0.0800000000000001	0.00444444444444445	7829	1
3	Drink 2	Intake 2	17	220705	1336951570	/users/cn/jespinosa/phecomp/data/CRG/20120502_FDF_CRG/20120502_FDF_CRG/20120511_FDF_CRG_c12.mtb	2304	NA	WWSS	water	2	220688	1336951553	1	0.0599999999999996	0.00352941176470586	7830	1
3	Food 1	Intake 3	255	221706	1336952571	/users/cn/jespinosa/phecomp/data/CRG/20120502_FDF_CRG/20120502_FDF_CRG/20120511_FDF_CRG_c12.mtb	1696	2709	WWSS	food_sc	3	221451	1336952316	1	0.18	0.000705882352941176	7831	1
3	Drink 1	Intake 1	17	221726	1336952591	/users/cn/jespinosa/phecomp/data/CRG/20120502_FDF_CRG/20120502_FDF_CRG/20120511_FDF_CRG_c12.mtb	836	NA	WWSS	water	1	221709	1336952574	1	0.04	0.00235294117647059	7832	1
3	Drink 2	Intake 2	19	222068	1336952933	/users/cn/jespinosa/phecomp/data/CRG/20120502_FDF_CRG/20120502_FDF_CRG/20120511_FDF_CRG_c12.mtb	2307	NA	WWSS	water	2	222049	1336952914	1	0.0400000000000009	0.00210526315789478	7833	1
3	Food 1	Intake 3	191	224606	1336955471	/users/cn/jespinosa/phecomp/data/CRG/20120502_FDF_CRG/20120502_FDF_CRG/20120511_FDF_CRG_c12.mtb	1698	1503	WWSS	food_sc	3	224415	1336955280	1	0.32	0.00167539267015707	7834	1
3	Drink 1	Intake 1	22	224811	1336955676	/users/cn/jespinosa/phecomp/data/CRG/20120502_FDF_CRG/20120502_FDF_CRG/20120511_FDF_CRG_c12.mtb	837	NA	WWSS	water	1	224789	1336955654	1	0.04	0.00181818181818182	7835	1
3	Drink 1	Intake 1	18	224985	1336955850	/users/cn/jespinosa/phecomp/data/CRG/20120502_FDF_CRG/20120502_FDF_CRG/20120511_FDF_CRG_c12.mtb	838	NA	WWSS	water	1	224967	1336955832	1	0.02	0.00111111111111111	7836	1
3	Drink 2	Intake 2	16	225183	1336956048	/users/cn/jespinosa/phecomp/data/CRG/20120502_FDF_CRG/20120502_FDF_CRG/20120511_FDF_CRG_c12.mtb	2312	NA	WWSS	water	2	225167	1336956032	1	0.04	0.0025	7837	1
3	Drink 2	Intake 2	22	225501	1336956366	/users/cn/jespinosa/phecomp/data/CRG/20120502_FDF_CRG/20120502_FDF_CRG/20120511_FDF_CRG_c12.mtb	2313	NA	WWSS	water	2	225479	1336956344	1	0.0200000000000005	0.000909090909090932	7838	1
3	Drink 2	Intake 2	18	225750	1336956615	/users/cn/jespinosa/phecomp/data/CRG/20120502_FDF_CRG/20120502_FDF_CRG/20120511_FDF_CRG_c12.mtb	2314	NA	WWSS	water	2	225732	1336956597	1	0.0599999999999996	0.00333333333333331	7839	1
3	Drink 2	Intake 2	17	225898	1336956763	/users/cn/jespinosa/phecomp/data/CRG/20120502_FDF_CRG/20120502_FDF_CRG/20120511_FDF_CRG_c12.mtb	2315	NA	WWSS	water	2	225881	1336956746	1	0.04	0.00235294117647059	7840	1
3	Food 1	Intake 3	94	226203	1336957068	/users/cn/jespinosa/phecomp/data/CRG/20120502_FDF_CRG/20120502_FDF_CRG/20120511_FDF_CRG_c12.mtb	1700	9009	WWSS	food_sc	3	226109	1336956974	1	0.02	0.000212765957446809	7841	1
3	Drink 1	Intake 1	17	226516	1336957381	/users/cn/jespinosa/phecomp/data/CRG/20120502_FDF_CRG/20120502_FDF_CRG/20120511_FDF_CRG_c12.mtb	841	NA	WWSS	water	1	226499	1336957364	1	0.04	0.00235294117647059	7842	1
3	Food 2	Intake 4	652	235864	1336966729	/users/cn/jespinosa/phecomp/data/CRG/20120502_FDF_CRG/20120502_FDF_CRG/20120511_FDF_CRG_c12.mtb	2679	4	WWSS	food_sc	4	235212	1336966077	1	0.16	0.000245398773006135	7843	1
3	Food 2	Intake 4	122	235990	1336966855	/users/cn/jespinosa/phecomp/data/CRG/20120502_FDF_CRG/20120502_FDF_CRG/20120511_FDF_CRG_c12.mtb	2680	200	WWSS	food_sc	4	235868	1336966733	1	0.0800000000000001	0.000655737704918034	7844	1
3	Drink 2	Intake 2	18	236008	1336966873	/users/cn/jespinosa/phecomp/data/CRG/20120502_FDF_CRG/20120502_FDF_CRG/20120511_FDF_CRG_c12.mtb	2321	NA	WWSS	water	2	235990	1336966855	1	0.12	0.00666666666666667	7845	1
3	Drink 2	Intake 2	20	236047	1336966912	/users/cn/jespinosa/phecomp/data/CRG/20120502_FDF_CRG/20120502_FDF_CRG/20120511_FDF_CRG_c12.mtb	2322	NA	WWSS	water	2	236027	1336966892	1	0.0600000000000005	0.00300000000000002	7846	1
3	Food 2	Intake 4	141	236331	1336967196	/users/cn/jespinosa/phecomp/data/CRG/20120502_FDF_CRG/20120502_FDF_CRG/20120511_FDF_CRG_c12.mtb	2682	4208	WWSS	food_sc	4	236190	1336967055	1	0.04	0.000283687943262411	7847	1
3	Drink 1	Intake 1	18	236342	1336967207	/users/cn/jespinosa/phecomp/data/CRG/20120502_FDF_CRG/20120502_FDF_CRG/20120511_FDF_CRG_c12.mtb	844	NA	WWSS	water	1	236324	1336967189	1	0.02	0.00111111111111111	7848	1
3	Drink 2	Intake 2	18	236386	1336967251	/users/cn/jespinosa/phecomp/data/CRG/20120502_FDF_CRG/20120502_FDF_CRG/20120511_FDF_CRG_c12.mtb	2323	NA	WWSS	water	2	236368	1336967233	1	0.0599999999999996	0.00333333333333331	7849	1
3	Drink 2	Intake 2	15	236656	1336967521	/users/cn/jespinosa/phecomp/data/CRG/20120502_FDF_CRG/20120502_FDF_CRG/20120511_FDF_CRG_c12.mtb	2324	NA	WWSS	water	2	236641	1336967506	1	0.0200000000000005	0.00133333333333337	7850	1
3	Food 1	Intake 3	449	240988	1336971853	/users/cn/jespinosa/phecomp/data/CRG/20120502_FDF_CRG/20120502_FDF_CRG/20120511_FDF_CRG_c12.mtb	1706	1127	WWSS	food_sc	3	240539	1336971404	1	0.1	0.00022271714922049	7851	1
3	Drink 2	Intake 2	27	241043	1336971908	/users/cn/jespinosa/phecomp/data/CRG/20120502_FDF_CRG/20120502_FDF_CRG/20120511_FDF_CRG_c12.mtb	2326	NA	WWSS	water	2	241016	1336971881	1	0.04	0.00148148148148148	7852	1
3	Drink 2	Intake 2	19	241713	1336972578	/users/cn/jespinosa/phecomp/data/CRG/20120502_FDF_CRG/20120502_FDF_CRG/20120511_FDF_CRG_c12.mtb	2328	NA	WWSS	water	2	241694	1336972559	1	0.0399999999999991	0.00210526315789469	7853	1
3	Food 2	Intake 4	215	242330	1336973195	/users/cn/jespinosa/phecomp/data/CRG/20120502_FDF_CRG/20120502_FDF_CRG/20120511_FDF_CRG_c12.mtb	2697	33	WWSS	food_sc	4	242115	1336972980	1	0.12	0.000558139534883721	7854	1
3	Food 2	Intake 4	268	242631	1336973496	/users/cn/jespinosa/phecomp/data/CRG/20120502_FDF_CRG/20120502_FDF_CRG/20120511_FDF_CRG_c12.mtb	2698	279	WWSS	food_sc	4	242363	1336973228	1	0.0800000000000001	0.000298507462686568	7855	1
3	Drink 1	Intake 1	23	242652	1336973517	/users/cn/jespinosa/phecomp/data/CRG/20120502_FDF_CRG/20120502_FDF_CRG/20120511_FDF_CRG_c12.mtb	847	NA	WWSS	water	1	242629	1336973494	1	0.0799999999999998	0.00347826086956521	7856	1
3	Drink 2	Intake 2	16	242694	1336973559	/users/cn/jespinosa/phecomp/data/CRG/20120502_FDF_CRG/20120502_FDF_CRG/20120511_FDF_CRG_c12.mtb	2329	NA	WWSS	water	2	242678	1336973543	1	0.0400000000000009	0.00250000000000006	7857	1
3	Food 2	Intake 4	163	243073	1336973938	/users/cn/jespinosa/phecomp/data/CRG/20120502_FDF_CRG/20120502_FDF_CRG/20120511_FDF_CRG_c12.mtb	2700	439	WWSS	food_sc	4	242910	1336973775	1	0.0200000000000005	0.000122699386503071	7858	1
3	Drink 2	Intake 2	15	243187	1336974052	/users/cn/jespinosa/phecomp/data/CRG/20120502_FDF_CRG/20120502_FDF_CRG/20120511_FDF_CRG_c12.mtb	2332	NA	WWSS	water	2	243172	1336974037	1	0.0200000000000005	0.00133333333333337	7859	1
3	Food 2	Intake 4	225	243737	1336974602	/users/cn/jespinosa/phecomp/data/CRG/20120502_FDF_CRG/20120502_FDF_CRG/20120511_FDF_CRG_c12.mtb	2702	18358	WWSS	food_sc	4	243512	1336974377	1	0.04	0.000177777777777778	7860	1
3	Drink 2	Intake 2	47	248634	1336979499	/users/cn/jespinosa/phecomp/data/CRG/20120502_FDF_CRG/20120502_FDF_CRG/20120511_FDF_CRG_c12.mtb	2334	NA	WWSS	water	2	248587	1336979452	1	0.0200000000000005	0.000425531914893628	7861	1
3	Food 1	Intake 3	448	1235	1336993408	/users/cn/jespinosa/phecomp/data/CRG/20120502_FDF_CRG/20120502_FDF_CRG/20120514_FDF_CRG_c12.mtb	1845	6261	WWSS	food_sc	3	787	1336992960	1	0.18	0.000401785714285714	7862	1
3	Drink 1	Intake 1	10	1279	1336993452	/users/cn/jespinosa/phecomp/data/CRG/20120502_FDF_CRG/20120502_FDF_CRG/20120514_FDF_CRG_c12.mtb	937	NA	WWSS	water	1	1269	1336993442	1	0.04	0.004	7863	1
3	Drink 1	Intake 1	12	1466	1336993639	/users/cn/jespinosa/phecomp/data/CRG/20120502_FDF_CRG/20120502_FDF_CRG/20120514_FDF_CRG_c12.mtb	938	NA	WWSS	water	1	1454	1336993627	1	0.04	0.00333333333333333	7864	1
3	Food 1	Intake 3	325	7821	1336999994	/users/cn/jespinosa/phecomp/data/CRG/20120502_FDF_CRG/20120502_FDF_CRG/20120514_FDF_CRG_c12.mtb	1847	6527	WWSS	food_sc	3	7496	1336999669	1	0.12	0.000369230769230769	7865	1
3	Drink 2	Intake 2	10	7928	1337000101	/users/cn/jespinosa/phecomp/data/CRG/20120502_FDF_CRG/20120502_FDF_CRG/20120514_FDF_CRG_c12.mtb	2424	NA	WWSS	water	2	7918	1337000091	1	0.02	0.002	7866	1
3	Drink 1	Intake 1	13	7947	1337000120	/users/cn/jespinosa/phecomp/data/CRG/20120502_FDF_CRG/20120502_FDF_CRG/20120514_FDF_CRG_c12.mtb	939	NA	WWSS	water	1	7934	1337000107	1	0.06	0.00461538461538461	7867	1
3	Drink 1	Intake 1	17	8293	1337000466	/users/cn/jespinosa/phecomp/data/CRG/20120502_FDF_CRG/20120502_FDF_CRG/20120514_FDF_CRG_c12.mtb	940	NA	WWSS	water	1	8276	1337000449	1	0.04	0.00235294117647059	7868	1
3	Food 1	Intake 3	19	14367	1337006540	/users/cn/jespinosa/phecomp/data/CRG/20120502_FDF_CRG/20120502_FDF_CRG/20120514_FDF_CRG_c12.mtb	1851	9204	WWSS	food_sc	3	14348	1337006521	1	0.02	0.00105263157894737	7869	1
3	Food 1	Intake 3	533	24104	1337016277	/users/cn/jespinosa/phecomp/data/CRG/20120502_FDF_CRG/20120502_FDF_CRG/20120514_FDF_CRG_c12.mtb	1853	2957	WWSS	food_sc	3	23571	1337015744	1	0.14	0.000262664165103189	7870	1
3	Drink 1	Intake 1	17	24433	1337016606	/users/cn/jespinosa/phecomp/data/CRG/20120502_FDF_CRG/20120502_FDF_CRG/20120514_FDF_CRG_c12.mtb	941	NA	WWSS	water	1	24416	1337016589	1	0.04	0.00235294117647059	7871	1
3	Drink 1	Intake 1	15	25295	1337017468	/users/cn/jespinosa/phecomp/data/CRG/20120502_FDF_CRG/20120502_FDF_CRG/20120514_FDF_CRG_c12.mtb	942	NA	WWSS	water	1	25280	1337017453	1	0.04	0.00266666666666667	7872	1
3	Food 1	Intake 3	459	27520	1337019693	/users/cn/jespinosa/phecomp/data/CRG/20120502_FDF_CRG/20120502_FDF_CRG/20120514_FDF_CRG_c12.mtb	1855	28	WWSS	food_sc	3	27061	1337019234	1	0.14	0.000305010893246187	7873	1
3	Drink 1	Intake 1	11	27526	1337019699	/users/cn/jespinosa/phecomp/data/CRG/20120502_FDF_CRG/20120502_FDF_CRG/20120514_FDF_CRG_c12.mtb	943	NA	WWSS	water	1	27515	1337019688	1	0.02	0.00181818181818182	7874	1
3	Food 1	Intake 3	165	27713	1337019886	/users/cn/jespinosa/phecomp/data/CRG/20120502_FDF_CRG/20120502_FDF_CRG/20120514_FDF_CRG_c12.mtb	1856	1927	WWSS	food_sc	3	27548	1337019721	1	0.0800000000000001	0.000484848484848485	7875	1
3	Drink 2	Intake 2	21	27733	1337019906	/users/cn/jespinosa/phecomp/data/CRG/20120502_FDF_CRG/20120502_FDF_CRG/20120514_FDF_CRG_c12.mtb	2427	NA	WWSS	water	2	27712	1337019885	1	0.06	0.00285714285714286	7876	1
3	Drink 1	Intake 1	15	28097	1337020270	/users/cn/jespinosa/phecomp/data/CRG/20120502_FDF_CRG/20120502_FDF_CRG/20120514_FDF_CRG_c12.mtb	944	NA	WWSS	water	1	28082	1337020255	1	0.02	0.00133333333333333	7877	1
3	Drink 1	Intake 1	22	28509	1337020682	/users/cn/jespinosa/phecomp/data/CRG/20120502_FDF_CRG/20120502_FDF_CRG/20120514_FDF_CRG_c12.mtb	945	NA	WWSS	water	1	28487	1337020660	1	0.04	0.00181818181818182	7878	1
3	Drink 2	Intake 2	10	28752	1337020925	/users/cn/jespinosa/phecomp/data/CRG/20120502_FDF_CRG/20120502_FDF_CRG/20120514_FDF_CRG_c12.mtb	2428	NA	WWSS	water	2	28742	1337020915	1	0.02	0.002	7879	1
3	Drink 1	Intake 1	16	28819	1337020992	/users/cn/jespinosa/phecomp/data/CRG/20120502_FDF_CRG/20120502_FDF_CRG/20120514_FDF_CRG_c12.mtb	946	NA	WWSS	water	1	28803	1337020976	1	0.06	0.00375	7880	1
3	Food 1	Intake 3	491	30131	1337022304	/users/cn/jespinosa/phecomp/data/CRG/20120502_FDF_CRG/20120502_FDF_CRG/20120514_FDF_CRG_c12.mtb	1858	136	WWSS	food_sc	3	29640	1337021813	1	0.18	0.000366598778004073	7881	1
3	Drink 2	Intake 2	22	30161	1337022334	/users/cn/jespinosa/phecomp/data/CRG/20120502_FDF_CRG/20120502_FDF_CRG/20120514_FDF_CRG_c12.mtb	2430	NA	WWSS	water	2	30139	1337022312	1	0.06	0.00272727272727273	7882	1
3	Drink 1	Intake 1	16	30235	1337022408	/users/cn/jespinosa/phecomp/data/CRG/20120502_FDF_CRG/20120502_FDF_CRG/20120514_FDF_CRG_c12.mtb	947	NA	WWSS	water	1	30219	1337022392	1	0.02	0.00125	7883	1
3	Food 2	Intake 4	223	30490	1337022663	/users/cn/jespinosa/phecomp/data/CRG/20120502_FDF_CRG/20120502_FDF_CRG/20120514_FDF_CRG_c12.mtb	2991	2005	WWSS	food_sc	4	30267	1337022440	1	0.1	0.000448430493273543	7884	1
3	Drink 2	Intake 2	15	30504	1337022677	/users/cn/jespinosa/phecomp/data/CRG/20120502_FDF_CRG/20120502_FDF_CRG/20120514_FDF_CRG_c12.mtb	2431	NA	WWSS	water	2	30489	1337022662	1	0.04	0.00266666666666667	7885	1
3	Drink 2	Intake 2	16	30537	1337022710	/users/cn/jespinosa/phecomp/data/CRG/20120502_FDF_CRG/20120502_FDF_CRG/20120514_FDF_CRG_c12.mtb	2432	NA	WWSS	water	2	30521	1337022694	1	0.02	0.00125	7886	1
3	Drink 1	Intake 1	15	30590	1337022763	/users/cn/jespinosa/phecomp/data/CRG/20120502_FDF_CRG/20120502_FDF_CRG/20120514_FDF_CRG_c12.mtb	948	NA	WWSS	water	1	30575	1337022748	1	0.04	0.00266666666666667	7887	1
3	Drink 1	Intake 1	8	31423	1337023596	/users/cn/jespinosa/phecomp/data/CRG/20120502_FDF_CRG/20120502_FDF_CRG/20120514_FDF_CRG_c12.mtb	949	NA	WWSS	water	1	31415	1337023588	1	0.04	0.005	7888	1
3	Food 2	Intake 4	325	32820	1337024993	/users/cn/jespinosa/phecomp/data/CRG/20120502_FDF_CRG/20120502_FDF_CRG/20120514_FDF_CRG_c12.mtb	2995	2050	WWSS	food_sc	4	32495	1337024668	1	0.12	0.000369230769230769	7889	1
3	Drink 2	Intake 2	24	32885	1337025058	/users/cn/jespinosa/phecomp/data/CRG/20120502_FDF_CRG/20120502_FDF_CRG/20120514_FDF_CRG_c12.mtb	2436	NA	WWSS	water	2	32861	1337025034	1	0.06	0.0025	7890	1
3	Food 2	Intake 4	557	35427	1337027600	/users/cn/jespinosa/phecomp/data/CRG/20120502_FDF_CRG/20120502_FDF_CRG/20120514_FDF_CRG_c12.mtb	2999	313	WWSS	food_sc	4	34870	1337027043	1	0.28	0.000502692998204668	7891	1
3	Drink 2	Intake 2	23	35442	1337027615	/users/cn/jespinosa/phecomp/data/CRG/20120502_FDF_CRG/20120502_FDF_CRG/20120514_FDF_CRG_c12.mtb	2437	NA	WWSS	water	2	35419	1337027592	1	0.08	0.00347826086956522	7892	1
3	Drink 2	Intake 2	16	35510	1337027683	/users/cn/jespinosa/phecomp/data/CRG/20120502_FDF_CRG/20120502_FDF_CRG/20120514_FDF_CRG_c12.mtb	2438	NA	WWSS	water	2	35494	1337027667	1	0.04	0.0025	7893	1
3	Drink 1	Intake 1	19	35685	1337027858	/users/cn/jespinosa/phecomp/data/CRG/20120502_FDF_CRG/20120502_FDF_CRG/20120514_FDF_CRG_c12.mtb	950	NA	WWSS	water	1	35666	1337027839	1	0.04	0.00210526315789474	7894	1
3	Food 2	Intake 4	108	35848	1337028021	/users/cn/jespinosa/phecomp/data/CRG/20120502_FDF_CRG/20120502_FDF_CRG/20120514_FDF_CRG_c12.mtb	3002	2441	WWSS	food_sc	4	35740	1337027913	1	0.04	0.00037037037037037	7895	1
3	Drink 1	Intake 1	23	35977	1337028150	/users/cn/jespinosa/phecomp/data/CRG/20120502_FDF_CRG/20120502_FDF_CRG/20120514_FDF_CRG_c12.mtb	951	NA	WWSS	water	1	35954	1337028127	1	0.02	0.000869565217391304	7896	1
3	Drink 2	Intake 2	17	35981	1337028154	/users/cn/jespinosa/phecomp/data/CRG/20120502_FDF_CRG/20120502_FDF_CRG/20120514_FDF_CRG_c12.mtb	2439	NA	WWSS	water	2	35964	1337028137	1	0.02	0.00117647058823529	7897	1
3	Food 2	Intake 4	139	38428	1337030601	/users/cn/jespinosa/phecomp/data/CRG/20120502_FDF_CRG/20120502_FDF_CRG/20120514_FDF_CRG_c12.mtb	3003	18	WWSS	food_sc	4	38289	1337030462	1	0.0399999999999999	0.000287769784172661	7898	1
3	Food 2	Intake 4	199	38645	1337030818	/users/cn/jespinosa/phecomp/data/CRG/20120502_FDF_CRG/20120502_FDF_CRG/20120514_FDF_CRG_c12.mtb	3004	1120	WWSS	food_sc	4	38446	1337030619	1	0.0800000000000001	0.000402010050251257	7899	1
3	Drink 1	Intake 1	21	38660	1337030833	/users/cn/jespinosa/phecomp/data/CRG/20120502_FDF_CRG/20120502_FDF_CRG/20120514_FDF_CRG_c12.mtb	952	NA	WWSS	water	1	38639	1337030812	1	0.1	0.00476190476190476	7900	1
3	Food 1	Intake 3	473	40238	1337032411	/users/cn/jespinosa/phecomp/data/CRG/20120502_FDF_CRG/20120502_FDF_CRG/20120514_FDF_CRG_c12.mtb	1863	1341	WWSS	food_sc	3	39765	1337031938	1	0.18	0.000380549682875264	7901	1
3	Drink 2	Intake 2	23	40260	1337032433	/users/cn/jespinosa/phecomp/data/CRG/20120502_FDF_CRG/20120502_FDF_CRG/20120514_FDF_CRG_c12.mtb	2440	NA	WWSS	water	2	40237	1337032410	1	0.06	0.00260869565217391	7902	1
3	Drink 2	Intake 2	14	40365	1337032538	/users/cn/jespinosa/phecomp/data/CRG/20120502_FDF_CRG/20120502_FDF_CRG/20120514_FDF_CRG_c12.mtb	2441	NA	WWSS	water	2	40351	1337032524	1	0.04	0.00285714285714286	7903	1
3	Food 1	Intake 3	58	41637	1337033810	/users/cn/jespinosa/phecomp/data/CRG/20120502_FDF_CRG/20120502_FDF_CRG/20120514_FDF_CRG_c12.mtb	1865	77	WWSS	food_sc	3	41579	1337033752	1	0.02	0.000344827586206897	7904	1
3	Food 1	Intake 3	57	41771	1337033944	/users/cn/jespinosa/phecomp/data/CRG/20120502_FDF_CRG/20120502_FDF_CRG/20120514_FDF_CRG_c12.mtb	1866	1418	WWSS	food_sc	3	41714	1337033887	1	0.02	0.000350877192982456	7905	1
3	Drink 2	Intake 2	17	42993	1337035166	/users/cn/jespinosa/phecomp/data/CRG/20120502_FDF_CRG/20120502_FDF_CRG/20120514_FDF_CRG_c12.mtb	2443	NA	WWSS	water	2	42976	1337035149	1	0.02	0.00117647058823529	7906	1
3	Food 2	Intake 4	149	43338	1337035511	/users/cn/jespinosa/phecomp/data/CRG/20120502_FDF_CRG/20120502_FDF_CRG/20120514_FDF_CRG_c12.mtb	3014	242	WWSS	food_sc	4	43189	1337035362	1	0.02	0.000134228187919463	7907	1
3	Drink 1	Intake 1	16	43415	1337035588	/users/cn/jespinosa/phecomp/data/CRG/20120502_FDF_CRG/20120502_FDF_CRG/20120514_FDF_CRG_c12.mtb	954	NA	WWSS	water	1	43399	1337035572	1	0.0399999999999999	0.00249999999999999	7908	1
3	Food 2	Intake 4	366	43946	1337036119	/users/cn/jespinosa/phecomp/data/CRG/20120502_FDF_CRG/20120502_FDF_CRG/20120514_FDF_CRG_c12.mtb	3015	2268	WWSS	food_sc	4	43580	1337035753	1	0.1	0.000273224043715847	7909	1
3	Drink 2	Intake 2	23	44004	1337036177	/users/cn/jespinosa/phecomp/data/CRG/20120502_FDF_CRG/20120502_FDF_CRG/20120514_FDF_CRG_c12.mtb	2444	NA	WWSS	water	2	43981	1337036154	1	0.0399999999999999	0.0017391304347826	7910	1
3	Food 2	Intake 4	471	46685	1337038858	/users/cn/jespinosa/phecomp/data/CRG/20120502_FDF_CRG/20120502_FDF_CRG/20120514_FDF_CRG_c12.mtb	3019	1165	WWSS	food_sc	4	46214	1337038387	1	0.14	0.00029723991507431	7911	1
3	Drink 2	Intake 2	23	46698	1337038871	/users/cn/jespinosa/phecomp/data/CRG/20120502_FDF_CRG/20120502_FDF_CRG/20120514_FDF_CRG_c12.mtb	2446	NA	WWSS	water	2	46675	1337038848	1	0.04	0.00173913043478261	7912	1
3	Drink 2	Intake 2	23	47070	1337039243	/users/cn/jespinosa/phecomp/data/CRG/20120502_FDF_CRG/20120502_FDF_CRG/20120514_FDF_CRG_c12.mtb	2447	NA	WWSS	water	2	47047	1337039220	1	0.08	0.00347826086956522	7913	1
3	Drink 1	Intake 1	12	47258	1337039431	/users/cn/jespinosa/phecomp/data/CRG/20120502_FDF_CRG/20120502_FDF_CRG/20120514_FDF_CRG_c12.mtb	956	NA	WWSS	water	1	47246	1337039419	1	0.02	0.00166666666666667	7914	1
3	Drink 1	Intake 1	21	47378	1337039551	/users/cn/jespinosa/phecomp/data/CRG/20120502_FDF_CRG/20120502_FDF_CRG/20120514_FDF_CRG_c12.mtb	957	NA	WWSS	water	1	47357	1337039530	1	0.04	0.0019047619047619	7915	1
3	Drink 1	Intake 1	12	47451	1337039624	/users/cn/jespinosa/phecomp/data/CRG/20120502_FDF_CRG/20120502_FDF_CRG/20120514_FDF_CRG_c12.mtb	958	NA	WWSS	water	1	47439	1337039612	1	0.02	0.00166666666666667	7916	1
3	Food 2	Intake 4	413	48263	1337040436	/users/cn/jespinosa/phecomp/data/CRG/20120502_FDF_CRG/20120502_FDF_CRG/20120514_FDF_CRG_c12.mtb	3023	207	WWSS	food_sc	4	47850	1337040023	1	0.14	0.000338983050847458	7917	1
3	Drink 2	Intake 2	24	48289	1337040462	/users/cn/jespinosa/phecomp/data/CRG/20120502_FDF_CRG/20120502_FDF_CRG/20120514_FDF_CRG_c12.mtb	2450	NA	WWSS	water	2	48265	1337040438	1	0.0800000000000001	0.00333333333333334	7918	1
3	Food 2	Intake 4	76	48546	1337040719	/users/cn/jespinosa/phecomp/data/CRG/20120502_FDF_CRG/20120502_FDF_CRG/20120514_FDF_CRG_c12.mtb	3024	2200	WWSS	food_sc	4	48470	1337040643	1	0.02	0.000263157894736842	7919	1
3	Drink 2	Intake 2	14	48805	1337040978	/users/cn/jespinosa/phecomp/data/CRG/20120502_FDF_CRG/20120502_FDF_CRG/20120514_FDF_CRG_c12.mtb	2451	NA	WWSS	water	2	48791	1337040964	1	0.02	0.00142857142857143	7920	1
3	Drink 1	Intake 1	31	49751	1337041924	/users/cn/jespinosa/phecomp/data/CRG/20120502_FDF_CRG/20120502_FDF_CRG/20120514_FDF_CRG_c12.mtb	961	NA	WWSS	water	1	49720	1337041893	1	0.0399999999999999	0.00129032258064516	7921	1
3	Food 2	Intake 4	94	50840	1337043013	/users/cn/jespinosa/phecomp/data/CRG/20120502_FDF_CRG/20120502_FDF_CRG/20120514_FDF_CRG_c12.mtb	3028	5076	WWSS	food_sc	4	50746	1337042919	1	0.02	0.000212765957446809	7922	1
3	Food 2	Intake 4	248	56164	1337048337	/users/cn/jespinosa/phecomp/data/CRG/20120502_FDF_CRG/20120502_FDF_CRG/20120514_FDF_CRG_c12.mtb	3032	263	WWSS	food_sc	4	55916	1337048089	1	0.04	0.000161290322580645	7923	1
3	Food 2	Intake 4	163	56590	1337048763	/users/cn/jespinosa/phecomp/data/CRG/20120502_FDF_CRG/20120502_FDF_CRG/20120514_FDF_CRG_c12.mtb	3034	64	WWSS	food_sc	4	56427	1337048600	1	0.02	0.000122699386503067	7924	1
3	Food 2	Intake 4	155	56809	1337048982	/users/cn/jespinosa/phecomp/data/CRG/20120502_FDF_CRG/20120502_FDF_CRG/20120514_FDF_CRG_c12.mtb	3035	3741	WWSS	food_sc	4	56654	1337048827	1	0.04	0.000258064516129032	7925	1
3	Drink 2	Intake 2	14	56892	1337049065	/users/cn/jespinosa/phecomp/data/CRG/20120502_FDF_CRG/20120502_FDF_CRG/20120514_FDF_CRG_c12.mtb	2454	NA	WWSS	water	2	56878	1337049051	1	0.0600000000000001	0.00428571428571429	7926	1
3	Drink 2	Intake 2	10	57406	1337049579	/users/cn/jespinosa/phecomp/data/CRG/20120502_FDF_CRG/20120502_FDF_CRG/20120514_FDF_CRG_c12.mtb	2455	NA	WWSS	water	2	57396	1337049569	1	0.04	0.004	7927	1
3	Food 2	Intake 4	335	60885	1337053058	/users/cn/jespinosa/phecomp/data/CRG/20120502_FDF_CRG/20120502_FDF_CRG/20120514_FDF_CRG_c12.mtb	3039	2460	WWSS	food_sc	4	60550	1337052723	1	0.1	0.000298507462686567	7928	1
3	Food 2	Intake 4	68	63413	1337055586	/users/cn/jespinosa/phecomp/data/CRG/20120502_FDF_CRG/20120502_FDF_CRG/20120514_FDF_CRG_c12.mtb	3041	857	WWSS	food_sc	4	63345	1337055518	1	0.02	0.000294117647058824	7929	1
3	Drink 2	Intake 2	17	63583	1337055756	/users/cn/jespinosa/phecomp/data/CRG/20120502_FDF_CRG/20120502_FDF_CRG/20120514_FDF_CRG_c12.mtb	2457	NA	WWSS	water	2	63566	1337055739	1	0.0399999999999999	0.00235294117647058	7930	1
3	Drink 2	Intake 2	15	63697	1337055870	/users/cn/jespinosa/phecomp/data/CRG/20120502_FDF_CRG/20120502_FDF_CRG/20120514_FDF_CRG_c12.mtb	2458	NA	WWSS	water	2	63682	1337055855	1	0.02	0.00133333333333333	7931	1
3	Food 2	Intake 4	233	64503	1337056676	/users/cn/jespinosa/phecomp/data/CRG/20120502_FDF_CRG/20120502_FDF_CRG/20120514_FDF_CRG_c12.mtb	3044	108	WWSS	food_sc	4	64270	1337056443	1	0.0399999999999998	0.000171673819742488	7932	1
3	Drink 1	Intake 1	17	64558	1337056731	/users/cn/jespinosa/phecomp/data/CRG/20120502_FDF_CRG/20120502_FDF_CRG/20120514_FDF_CRG_c12.mtb	964	NA	WWSS	water	1	64541	1337056714	1	0.02	0.00117647058823529	7933	1
3	Drink 2	Intake 2	17	64595	1337056768	/users/cn/jespinosa/phecomp/data/CRG/20120502_FDF_CRG/20120502_FDF_CRG/20120514_FDF_CRG_c12.mtb	2459	NA	WWSS	water	2	64578	1337056751	1	0.02	0.00117647058823529	7934	1
3	Food 2	Intake 4	398	65009	1337057182	/users/cn/jespinosa/phecomp/data/CRG/20120502_FDF_CRG/20120502_FDF_CRG/20120514_FDF_CRG_c12.mtb	3045	2053	WWSS	food_sc	4	64611	1337056784	1	0.1	0.000251256281407035	7935	1
3	Drink 1	Intake 1	15	65029	1337057202	/users/cn/jespinosa/phecomp/data/CRG/20120502_FDF_CRG/20120502_FDF_CRG/20120514_FDF_CRG_c12.mtb	965	NA	WWSS	water	1	65014	1337057187	1	0.0800000000000001	0.00533333333333334	7936	1
3	Drink 2	Intake 2	17	65202	1337057375	/users/cn/jespinosa/phecomp/data/CRG/20120502_FDF_CRG/20120502_FDF_CRG/20120514_FDF_CRG_c12.mtb	2460	NA	WWSS	water	2	65185	1337057358	1	0.04	0.00235294117647059	7937	1
3	Drink 1	Intake 1	15	66090	1337058263	/users/cn/jespinosa/phecomp/data/CRG/20120502_FDF_CRG/20120502_FDF_CRG/20120514_FDF_CRG_c12.mtb	966	NA	WWSS	water	1	66075	1337058248	1	0.0599999999999999	0.00399999999999999	7938	1
3	Food 2	Intake 4	368	67430	1337059603	/users/cn/jespinosa/phecomp/data/CRG/20120502_FDF_CRG/20120502_FDF_CRG/20120514_FDF_CRG_c12.mtb	3048	10156	WWSS	food_sc	4	67062	1337059235	1	0.1	0.000271739130434783	7939	1
3	Drink 2	Intake 2	20	67464	1337059637	/users/cn/jespinosa/phecomp/data/CRG/20120502_FDF_CRG/20120502_FDF_CRG/20120514_FDF_CRG_c12.mtb	2462	NA	WWSS	water	2	67444	1337059617	1	0.04	0.002	7940	1
3	Drink 2	Intake 2	37	67728	1337059901	/users/cn/jespinosa/phecomp/data/CRG/20120502_FDF_CRG/20120502_FDF_CRG/20120514_FDF_CRG_c12.mtb	2463	NA	WWSS	water	2	67691	1337059864	1	0.04	0.00108108108108108	7941	1
3	Food 2	Intake 4	75	77661	1337069834	/users/cn/jespinosa/phecomp/data/CRG/20120502_FDF_CRG/20120502_FDF_CRG/20120514_FDF_CRG_c12.mtb	3060	36196	WWSS	food_sc	4	77586	1337069759	1	0.04	0.000533333333333333	7942	1
3	Drink 1	Intake 1	13	78071	1337070244	/users/cn/jespinosa/phecomp/data/CRG/20120502_FDF_CRG/20120502_FDF_CRG/20120514_FDF_CRG_c12.mtb	970	NA	WWSS	water	1	78058	1337070231	1	0.04	0.00307692307692308	7943	1
3	Food 1	Intake 3	171	114028	1337106201	/users/cn/jespinosa/phecomp/data/CRG/20120502_FDF_CRG/20120502_FDF_CRG/20120514_FDF_CRG_c12.mtb	1887	89	WWSS	food_sc	3	113857	1337106030	1	0.04	0.000233918128654971	7944	1
3	Food 1	Intake 3	125	114242	1337106415	/users/cn/jespinosa/phecomp/data/CRG/20120502_FDF_CRG/20120502_FDF_CRG/20120514_FDF_CRG_c12.mtb	1888	272	WWSS	food_sc	3	114117	1337106290	1	0.02	0.00016	7945	1
3	Drink 1	Intake 1	18	114445	1337106618	/users/cn/jespinosa/phecomp/data/CRG/20120502_FDF_CRG/20120502_FDF_CRG/20120514_FDF_CRG_c12.mtb	974	NA	WWSS	water	1	114427	1337106600	1	0.04	0.00222222222222222	7946	1
3	Food 2	Intake 4	208	114722	1337106895	/users/cn/jespinosa/phecomp/data/CRG/20120502_FDF_CRG/20120502_FDF_CRG/20120514_FDF_CRG_c12.mtb	3073	30	WWSS	food_sc	4	114514	1337106687	1	0.02	9.61538461538462e-05	7947	1
3	Food 2	Intake 4	266	115018	1337107191	/users/cn/jespinosa/phecomp/data/CRG/20120502_FDF_CRG/20120502_FDF_CRG/20120514_FDF_CRG_c12.mtb	3074	674	WWSS	food_sc	4	114752	1337106925	1	0.0799999999999998	0.000300751879699247	7948	1
3	Drink 2	Intake 2	24	115041	1337107214	/users/cn/jespinosa/phecomp/data/CRG/20120502_FDF_CRG/20120502_FDF_CRG/20120514_FDF_CRG_c12.mtb	2466	NA	WWSS	water	2	115017	1337107190	1	0.0399999999999998	0.00166666666666666	7949	1
3	Drink 2	Intake 2	17	115080	1337107253	/users/cn/jespinosa/phecomp/data/CRG/20120502_FDF_CRG/20120502_FDF_CRG/20120514_FDF_CRG_c12.mtb	2467	NA	WWSS	water	2	115063	1337107236	1	0.02	0.00117647058823529	7950	1
3	Drink 2	Intake 2	28	115262	1337107435	/users/cn/jespinosa/phecomp/data/CRG/20120502_FDF_CRG/20120502_FDF_CRG/20120514_FDF_CRG_c12.mtb	2468	NA	WWSS	water	2	115234	1337107407	1	0.0800000000000001	0.00285714285714286	7951	1
3	Drink 2	Intake 2	16	115518	1337107691	/users/cn/jespinosa/phecomp/data/CRG/20120502_FDF_CRG/20120502_FDF_CRG/20120514_FDF_CRG_c12.mtb	2469	NA	WWSS	water	2	115502	1337107675	1	0.02	0.00125	7952	1
3	Drink 1	Intake 1	47	115623	1337107796	/users/cn/jespinosa/phecomp/data/CRG/20120502_FDF_CRG/20120502_FDF_CRG/20120514_FDF_CRG_c12.mtb	976	NA	WWSS	water	1	115576	1337107749	1	0.04	0.000851063829787234	7953	1
3	Food 2	Intake 4	237	115929	1337108102	/users/cn/jespinosa/phecomp/data/CRG/20120502_FDF_CRG/20120502_FDF_CRG/20120514_FDF_CRG_c12.mtb	3080	10	WWSS	food_sc	4	115692	1337107865	1	0.04	0.000168776371308017	7954	1
3	Food 2	Intake 4	348	116287	1337108460	/users/cn/jespinosa/phecomp/data/CRG/20120502_FDF_CRG/20120502_FDF_CRG/20120514_FDF_CRG_c12.mtb	3081	1155	WWSS	food_sc	4	115939	1337108112	1	0.0999999999999999	0.00028735632183908	7955	1
3	Drink 2	Intake 2	29	116320	1337108493	/users/cn/jespinosa/phecomp/data/CRG/20120502_FDF_CRG/20120502_FDF_CRG/20120514_FDF_CRG_c12.mtb	2471	NA	WWSS	water	2	116291	1337108464	1	0.0999999999999999	0.00344827586206896	7956	1
3	Drink 2	Intake 2	30	116382	1337108555	/users/cn/jespinosa/phecomp/data/CRG/20120502_FDF_CRG/20120502_FDF_CRG/20120514_FDF_CRG_c12.mtb	2472	NA	WWSS	water	2	116352	1337108525	1	0.02	0.000666666666666667	7957	1
3	Drink 2	Intake 2	15	117007	1337109180	/users/cn/jespinosa/phecomp/data/CRG/20120502_FDF_CRG/20120502_FDF_CRG/20120514_FDF_CRG_c12.mtb	2473	NA	WWSS	water	2	116992	1337109165	1	0.02	0.00133333333333333	7958	1
3	Food 2	Intake 4	458	117900	1337110073	/users/cn/jespinosa/phecomp/data/CRG/20120502_FDF_CRG/20120502_FDF_CRG/20120514_FDF_CRG_c12.mtb	3083	13	WWSS	food_sc	4	117442	1337109615	1	0.18	0.000393013100436681	7959	1
3	Food 2	Intake 4	94	118007	1337110180	/users/cn/jespinosa/phecomp/data/CRG/20120502_FDF_CRG/20120502_FDF_CRG/20120514_FDF_CRG_c12.mtb	3084	1731	WWSS	food_sc	4	117913	1337110086	1	0.04	0.000425531914893617	7960	1
3	Drink 2	Intake 2	26	118026	1337110199	/users/cn/jespinosa/phecomp/data/CRG/20120502_FDF_CRG/20120502_FDF_CRG/20120514_FDF_CRG_c12.mtb	2474	NA	WWSS	water	2	118000	1337110173	1	0.0800000000000001	0.00307692307692308	7961	1
3	Drink 1	Intake 1	17	118066	1337110239	/users/cn/jespinosa/phecomp/data/CRG/20120502_FDF_CRG/20120502_FDF_CRG/20120514_FDF_CRG_c12.mtb	977	NA	WWSS	water	1	118049	1337110222	1	0.04	0.00235294117647059	7962	1
3	Drink 1	Intake 1	23	118239	1337110412	/users/cn/jespinosa/phecomp/data/CRG/20120502_FDF_CRG/20120502_FDF_CRG/20120514_FDF_CRG_c12.mtb	978	NA	WWSS	water	1	118216	1337110389	1	0.0599999999999998	0.0026086956521739	7963	1
3	Drink 2	Intake 2	16	119192	1337111365	/users/cn/jespinosa/phecomp/data/CRG/20120502_FDF_CRG/20120502_FDF_CRG/20120514_FDF_CRG_c12.mtb	2475	NA	WWSS	water	2	119176	1337111349	1	0.04	0.0025	7964	1
3	Food 2	Intake 4	259	119997	1337112170	/users/cn/jespinosa/phecomp/data/CRG/20120502_FDF_CRG/20120502_FDF_CRG/20120514_FDF_CRG_c12.mtb	3086	1853	WWSS	food_sc	4	119738	1337111911	1	0.12	0.000463320463320463	7965	1
3	Drink 2	Intake 2	15	120021	1337112194	/users/cn/jespinosa/phecomp/data/CRG/20120502_FDF_CRG/20120502_FDF_CRG/20120514_FDF_CRG_c12.mtb	2476	NA	WWSS	water	2	120006	1337112179	1	0.02	0.00133333333333333	7966	1
3	Drink 2	Intake 2	23	120568	1337112741	/users/cn/jespinosa/phecomp/data/CRG/20120502_FDF_CRG/20120502_FDF_CRG/20120514_FDF_CRG_c12.mtb	2477	NA	WWSS	water	2	120545	1337112718	1	0.0600000000000001	0.00260869565217392	7967	1
3	Food 2	Intake 4	266	122116	1337114289	/users/cn/jespinosa/phecomp/data/CRG/20120502_FDF_CRG/20120502_FDF_CRG/20120514_FDF_CRG_c12.mtb	3089	1840	WWSS	food_sc	4	121850	1337114023	1	0.16	0.000601503759398496	7968	1
3	Drink 2	Intake 2	17	122336	1337114509	/users/cn/jespinosa/phecomp/data/CRG/20120502_FDF_CRG/20120502_FDF_CRG/20120514_FDF_CRG_c12.mtb	2478	NA	WWSS	water	2	122319	1337114492	1	0.02	0.00117647058823529	7969	1
3	Drink 1	Intake 1	13	122390	1337114563	/users/cn/jespinosa/phecomp/data/CRG/20120502_FDF_CRG/20120502_FDF_CRG/20120514_FDF_CRG_c12.mtb	979	NA	WWSS	water	1	122377	1337114550	1	0.0600000000000001	0.00461538461538462	7970	1
3	Food 2	Intake 4	139	124095	1337116268	/users/cn/jespinosa/phecomp/data/CRG/20120502_FDF_CRG/20120502_FDF_CRG/20120514_FDF_CRG_c12.mtb	3090	5	WWSS	food_sc	4	123956	1337116129	1	0.0800000000000001	0.000575539568345324	7971	1
3	Food 2	Intake 4	24	124124	1337116297	/users/cn/jespinosa/phecomp/data/CRG/20120502_FDF_CRG/20120502_FDF_CRG/20120514_FDF_CRG_c12.mtb	3091	1234	WWSS	food_sc	4	124100	1337116273	1	0.28	0.0116666666666667	7972	1
3	Drink 1	Intake 1	19	124603	1337116776	/users/cn/jespinosa/phecomp/data/CRG/20120502_FDF_CRG/20120502_FDF_CRG/20120514_FDF_CRG_c12.mtb	980	NA	WWSS	water	1	124584	1337116757	1	0.04	0.00210526315789474	7973	1
3	Drink 2	Intake 2	36	124822	1337116995	/users/cn/jespinosa/phecomp/data/CRG/20120502_FDF_CRG/20120502_FDF_CRG/20120514_FDF_CRG_c12.mtb	2479	NA	WWSS	water	2	124786	1337116959	1	0.04	0.00111111111111111	7974	1
3	Drink 2	Intake 2	19	125107	1337117280	/users/cn/jespinosa/phecomp/data/CRG/20120502_FDF_CRG/20120502_FDF_CRG/20120514_FDF_CRG_c12.mtb	2480	NA	WWSS	water	2	125088	1337117261	1	0.0399999999999998	0.00210526315789473	7975	1
3	Food 2	Intake 4	150	125508	1337117681	/users/cn/jespinosa/phecomp/data/CRG/20120502_FDF_CRG/20120502_FDF_CRG/20120514_FDF_CRG_c12.mtb	3098	8	WWSS	food_sc	4	125358	1337117531	1	0.04	0.000266666666666667	7976	1
3	Food 2	Intake 4	237	125753	1337117926	/users/cn/jespinosa/phecomp/data/CRG/20120502_FDF_CRG/20120502_FDF_CRG/20120514_FDF_CRG_c12.mtb	3099	2473	WWSS	food_sc	4	125516	1337117689	1	0.12	0.000506329113924051	7977	1
3	Drink 2	Intake 2	44	125789	1337117962	/users/cn/jespinosa/phecomp/data/CRG/20120502_FDF_CRG/20120502_FDF_CRG/20120514_FDF_CRG_c12.mtb	2481	NA	WWSS	water	2	125745	1337117918	1	0.0800000000000001	0.00181818181818182	7978	1
3	Drink 2	Intake 2	23	125996	1337118169	/users/cn/jespinosa/phecomp/data/CRG/20120502_FDF_CRG/20120502_FDF_CRG/20120514_FDF_CRG_c12.mtb	2482	NA	WWSS	water	2	125973	1337118146	1	0.0799999999999998	0.00347826086956521	7979	1
3	Drink 2	Intake 2	18	126725	1337118898	/users/cn/jespinosa/phecomp/data/CRG/20120502_FDF_CRG/20120502_FDF_CRG/20120514_FDF_CRG_c12.mtb	2483	NA	WWSS	water	2	126707	1337118880	1	0.0600000000000001	0.00333333333333334	7980	1
3	Drink 1	Intake 1	39	127194	1337119367	/users/cn/jespinosa/phecomp/data/CRG/20120502_FDF_CRG/20120502_FDF_CRG/20120514_FDF_CRG_c12.mtb	981	NA	WWSS	water	1	127155	1337119328	1	0.02	0.000512820512820513	7981	1
3	Drink 2	Intake 2	16	127200	1337119373	/users/cn/jespinosa/phecomp/data/CRG/20120502_FDF_CRG/20120502_FDF_CRG/20120514_FDF_CRG_c12.mtb	2484	NA	WWSS	water	2	127184	1337119357	1	0.04	0.0025	7982	1
3	Food 1	Intake 3	188	128414	1337120587	/users/cn/jespinosa/phecomp/data/CRG/20120502_FDF_CRG/20120502_FDF_CRG/20120514_FDF_CRG_c12.mtb	1898	1089	WWSS	food_sc	3	128226	1337120399	1	0.0399999999999998	0.000212765957446807	7983	1
3	Drink 1	Intake 1	14	128420	1337120593	/users/cn/jespinosa/phecomp/data/CRG/20120502_FDF_CRG/20120502_FDF_CRG/20120514_FDF_CRG_c12.mtb	983	NA	WWSS	water	1	128406	1337120579	1	0.02	0.00142857142857143	7984	1
3	Drink 1	Intake 1	20	129054	1337121227	/users/cn/jespinosa/phecomp/data/CRG/20120502_FDF_CRG/20120502_FDF_CRG/20120514_FDF_CRG_c12.mtb	984	NA	WWSS	water	1	129034	1337121207	1	0.0599999999999998	0.00299999999999999	7985	1
3	Food 2	Intake 4	89	129592	1337121765	/users/cn/jespinosa/phecomp/data/CRG/20120502_FDF_CRG/20120502_FDF_CRG/20120514_FDF_CRG_c12.mtb	3109	22	WWSS	food_sc	4	129503	1337121676	1	0.02	0.000224719101123596	7986	1
3	Food 2	Intake 4	118	129732	1337121905	/users/cn/jespinosa/phecomp/data/CRG/20120502_FDF_CRG/20120502_FDF_CRG/20120514_FDF_CRG_c12.mtb	3110	6	WWSS	food_sc	4	129614	1337121787	1	0.02	0.000169491525423729	7987	1
3	Food 2	Intake 4	111	129849	1337122022	/users/cn/jespinosa/phecomp/data/CRG/20120502_FDF_CRG/20120502_FDF_CRG/20120514_FDF_CRG_c12.mtb	3111	2223	WWSS	food_sc	4	129738	1337121911	1	0.04	0.00036036036036036	7988	1
3	Drink 2	Intake 2	19	129890	1337122063	/users/cn/jespinosa/phecomp/data/CRG/20120502_FDF_CRG/20120502_FDF_CRG/20120514_FDF_CRG_c12.mtb	2487	NA	WWSS	water	2	129871	1337122044	1	0.04	0.00210526315789474	7989	1
3	Food 1	Intake 3	203	132275	1337124448	/users/cn/jespinosa/phecomp/data/CRG/20120502_FDF_CRG/20120502_FDF_CRG/20120514_FDF_CRG_c12.mtb	1900	164	WWSS	food_sc	3	132072	1337124245	1	0.0600000000000001	0.000295566502463055	7990	1
3	Food 2	Intake 4	149	132588	1337124761	/users/cn/jespinosa/phecomp/data/CRG/20120502_FDF_CRG/20120502_FDF_CRG/20120514_FDF_CRG_c12.mtb	3115	638	WWSS	food_sc	4	132439	1337124612	1	0.04	0.000268456375838926	7991	1
3	Drink 2	Intake 2	23	132608	1337124781	/users/cn/jespinosa/phecomp/data/CRG/20120502_FDF_CRG/20120502_FDF_CRG/20120514_FDF_CRG_c12.mtb	2490	NA	WWSS	water	2	132585	1337124758	1	0.0600000000000001	0.00260869565217392	7992	1
3	Drink 2	Intake 2	18	133064	1337125237	/users/cn/jespinosa/phecomp/data/CRG/20120502_FDF_CRG/20120502_FDF_CRG/20120514_FDF_CRG_c12.mtb	2492	NA	WWSS	water	2	133046	1337125219	1	0.04	0.00222222222222222	7993	1
3	Food 2	Intake 4	270	133496	1337125669	/users/cn/jespinosa/phecomp/data/CRG/20120502_FDF_CRG/20120502_FDF_CRG/20120514_FDF_CRG_c12.mtb	3120	1483	WWSS	food_sc	4	133226	1337125399	1	0.1	0.00037037037037037	7994	1
3	Drink 2	Intake 2	28	133516	1337125689	/users/cn/jespinosa/phecomp/data/CRG/20120502_FDF_CRG/20120502_FDF_CRG/20120514_FDF_CRG_c12.mtb	2493	NA	WWSS	water	2	133488	1337125661	1	0.0800000000000001	0.00285714285714286	7995	1
3	Drink 1	Intake 1	23	133744	1337125917	/users/cn/jespinosa/phecomp/data/CRG/20120502_FDF_CRG/20120502_FDF_CRG/20120514_FDF_CRG_c12.mtb	987	NA	WWSS	water	1	133721	1337125894	1	0.0800000000000001	0.00347826086956522	7996	1
3	Drink 1	Intake 1	84	134185	1337126358	/users/cn/jespinosa/phecomp/data/CRG/20120502_FDF_CRG/20120502_FDF_CRG/20120514_FDF_CRG_c12.mtb	988	NA	WWSS	water	1	134101	1337126274	1	0.02	0.000238095238095238	7997	1
3	Food 2	Intake 4	321	135300	1337127473	/users/cn/jespinosa/phecomp/data/CRG/20120502_FDF_CRG/20120502_FDF_CRG/20120514_FDF_CRG_c12.mtb	3121	5040	WWSS	food_sc	4	134979	1337127152	1	0.1	0.000311526479750779	7998	1
3	Drink 2	Intake 2	20	135384	1337127557	/users/cn/jespinosa/phecomp/data/CRG/20120502_FDF_CRG/20120502_FDF_CRG/20120514_FDF_CRG_c12.mtb	2495	NA	WWSS	water	2	135364	1337127537	1	0.0599999999999996	0.00299999999999998	7999	1
3	Drink 1	Intake 1	17	135456	1337127629	/users/cn/jespinosa/phecomp/data/CRG/20120502_FDF_CRG/20120502_FDF_CRG/20120514_FDF_CRG_c12.mtb	990	NA	WWSS	water	1	135439	1337127612	1	0.02	0.00117647058823529	8000	1
3	Food 2	Intake 4	301	140641	1337132814	/users/cn/jespinosa/phecomp/data/CRG/20120502_FDF_CRG/20120502_FDF_CRG/20120514_FDF_CRG_c12.mtb	3124	185	WWSS	food_sc	4	140340	1337132513	1	0.12	0.000398671096345515	8001	1
3	Food 2	Intake 4	165	140991	1337133164	/users/cn/jespinosa/phecomp/data/CRG/20120502_FDF_CRG/20120502_FDF_CRG/20120514_FDF_CRG_c12.mtb	3126	1643	WWSS	food_sc	4	140826	1337132999	1	0.04	0.000242424242424242	8002	1
3	Drink 1	Intake 1	23	141026	1337133199	/users/cn/jespinosa/phecomp/data/CRG/20120502_FDF_CRG/20120502_FDF_CRG/20120514_FDF_CRG_c12.mtb	991	NA	WWSS	water	1	141003	1337133176	1	0.0600000000000001	0.00260869565217392	8003	1
3	Drink 2	Intake 2	22	141054	1337133227	/users/cn/jespinosa/phecomp/data/CRG/20120502_FDF_CRG/20120502_FDF_CRG/20120514_FDF_CRG_c12.mtb	2497	NA	WWSS	water	2	141032	1337133205	1	0.04	0.00181818181818182	8004	1
3	Drink 1	Intake 1	15	141401	1337133574	/users/cn/jespinosa/phecomp/data/CRG/20120502_FDF_CRG/20120502_FDF_CRG/20120514_FDF_CRG_c12.mtb	993	NA	WWSS	water	1	141386	1337133559	1	0.0600000000000001	0.00400000000000001	8005	1
3	Food 2	Intake 4	216	142850	1337135023	/users/cn/jespinosa/phecomp/data/CRG/20120502_FDF_CRG/20120502_FDF_CRG/20120514_FDF_CRG_c12.mtb	3129	149	WWSS	food_sc	4	142634	1337134807	1	0.0800000000000001	0.000370370370370371	8006	1
3	Food 2	Intake 4	97	143096	1337135269	/users/cn/jespinosa/phecomp/data/CRG/20120502_FDF_CRG/20120502_FDF_CRG/20120514_FDF_CRG_c12.mtb	3130	6756	WWSS	food_sc	4	142999	1337135172	1	0.02	0.000206185567010309	8007	1
3	Drink 1	Intake 1	16	143112	1337135285	/users/cn/jespinosa/phecomp/data/CRG/20120502_FDF_CRG/20120502_FDF_CRG/20120514_FDF_CRG_c12.mtb	994	NA	WWSS	water	1	143096	1337135269	1	0.02	0.00125	8008	1
3	Food 2	Intake 4	340	150192	1337142365	/users/cn/jespinosa/phecomp/data/CRG/20120502_FDF_CRG/20120502_FDF_CRG/20120514_FDF_CRG_c12.mtb	3135	85	WWSS	food_sc	4	149852	1337142025	1	0.0600000000000001	0.000176470588235294	8009	1
3	Food 2	Intake 4	329	150606	1337142779	/users/cn/jespinosa/phecomp/data/CRG/20120502_FDF_CRG/20120502_FDF_CRG/20120514_FDF_CRG_c12.mtb	3137	4507	WWSS	food_sc	4	150277	1337142450	1	0.0800000000000001	0.000243161094224924	8010	1
3	Drink 1	Intake 1	17	150616	1337142789	/users/cn/jespinosa/phecomp/data/CRG/20120502_FDF_CRG/20120502_FDF_CRG/20120514_FDF_CRG_c12.mtb	995	NA	WWSS	water	1	150599	1337142772	1	0.0799999999999998	0.00470588235294116	8011	1
3	Drink 1	Intake 1	20	150680	1337142853	/users/cn/jespinosa/phecomp/data/CRG/20120502_FDF_CRG/20120502_FDF_CRG/20120514_FDF_CRG_c12.mtb	996	NA	WWSS	water	1	150660	1337142833	1	0.02	0.001	8012	1
3	Drink 1	Intake 1	15	151098	1337143271	/users/cn/jespinosa/phecomp/data/CRG/20120502_FDF_CRG/20120502_FDF_CRG/20120514_FDF_CRG_c12.mtb	997	NA	WWSS	water	1	151083	1337143256	1	0.0599999999999998	0.00399999999999999	8013	1
3	Drink 1	Intake 1	12	151145	1337143318	/users/cn/jespinosa/phecomp/data/CRG/20120502_FDF_CRG/20120502_FDF_CRG/20120514_FDF_CRG_c12.mtb	998	NA	WWSS	water	1	151133	1337143306	1	0.02	0.00166666666666667	8014	1
3	Drink 1	Intake 1	123	152035	1337144208	/users/cn/jespinosa/phecomp/data/CRG/20120502_FDF_CRG/20120502_FDF_CRG/20120514_FDF_CRG_c12.mtb	999	NA	WWSS	water	1	151912	1337144085	1	0.04	0.00032520325203252	8015	1
3	Food 1	Intake 3	385	155498	1337147671	/users/cn/jespinosa/phecomp/data/CRG/20120502_FDF_CRG/20120502_FDF_CRG/20120514_FDF_CRG_c12.mtb	1913	43	WWSS	food_sc	3	155113	1337147286	1	0.04	0.000103896103896104	8016	1
3	Drink 2	Intake 2	24	155536	1337147709	/users/cn/jespinosa/phecomp/data/CRG/20120502_FDF_CRG/20120502_FDF_CRG/20120514_FDF_CRG_c12.mtb	2502	NA	WWSS	water	2	155512	1337147685	1	0.0600000000000001	0.0025	8017	1
3	Food 1	Intake 3	182	155723	1337147896	/users/cn/jespinosa/phecomp/data/CRG/20120502_FDF_CRG/20120502_FDF_CRG/20120514_FDF_CRG_c12.mtb	1914	40	WWSS	food_sc	3	155541	1337147714	1	0.04	0.00021978021978022	8018	1
3	Food 1	Intake 3	141	155904	1337148077	/users/cn/jespinosa/phecomp/data/CRG/20120502_FDF_CRG/20120502_FDF_CRG/20120514_FDF_CRG_c12.mtb	1915	16129	WWSS	food_sc	3	155763	1337147936	1	0.02	0.000141843971631206	8019	1
3	Drink 2	Intake 2	25	155921	1337148094	/users/cn/jespinosa/phecomp/data/CRG/20120502_FDF_CRG/20120502_FDF_CRG/20120514_FDF_CRG_c12.mtb	2503	NA	WWSS	water	2	155896	1337148069	1	0.04	0.0016	8020	1
3	Drink 2	Intake 2	29	156088	1337148261	/users/cn/jespinosa/phecomp/data/CRG/20120502_FDF_CRG/20120502_FDF_CRG/20120514_FDF_CRG_c12.mtb	2504	NA	WWSS	water	2	156059	1337148232	1	0.02	0.000689655172413793	8021	1
3	Drink 2	Intake 2	16	156241	1337148414	/users/cn/jespinosa/phecomp/data/CRG/20120502_FDF_CRG/20120502_FDF_CRG/20120514_FDF_CRG_c12.mtb	2505	NA	WWSS	water	2	156225	1337148398	1	0.02	0.00125	8022	1
3	Drink 1	Intake 1	13	156527	1337148700	/users/cn/jespinosa/phecomp/data/CRG/20120502_FDF_CRG/20120502_FDF_CRG/20120514_FDF_CRG_c12.mtb	1005	NA	WWSS	water	1	156514	1337148687	1	0.0600000000000001	0.00461538461538462	8023	1
3	Drink 1	Intake 1	15	156899	1337149072	/users/cn/jespinosa/phecomp/data/CRG/20120502_FDF_CRG/20120502_FDF_CRG/20120514_FDF_CRG_c12.mtb	1006	NA	WWSS	water	1	156884	1337149057	1	0.02	0.00133333333333333	8024	1
3	Food 1	Intake 3	421	1348	1337164627	/users/cn/jespinosa/phecomp/data/CRG/20120502_FDF_CRG/20120502_FDF_CRG/20120516_FDF_CRG_c12.mtb	2082	18606	WWSS	food_sc	3	927	1337164206	1	0.16	0.000380047505938242	8025	1
3	Drink 2	Intake 2	16	1556	1337164835	/users/cn/jespinosa/phecomp/data/CRG/20120502_FDF_CRG/20120502_FDF_CRG/20120516_FDF_CRG_c12.mtb	2610	NA	WWSS	water	2	1540	1337164819	1	0.02	0.00125	8026	1
3	Drink 2	Intake 2	16	2191	1337165470	/users/cn/jespinosa/phecomp/data/CRG/20120502_FDF_CRG/20120502_FDF_CRG/20120516_FDF_CRG_c12.mtb	2611	NA	WWSS	water	2	2175	1337165454	1	0.02	0.00125	8027	1
3	Drink 1	Intake 1	18	2263	1337165542	/users/cn/jespinosa/phecomp/data/CRG/20120502_FDF_CRG/20120502_FDF_CRG/20120516_FDF_CRG_c12.mtb	1111	NA	WWSS	water	1	2245	1337165524	1	0.06	0.00333333333333333	8028	1
3	Drink 2	Intake 2	37	2643	1337165922	/users/cn/jespinosa/phecomp/data/CRG/20120502_FDF_CRG/20120502_FDF_CRG/20120516_FDF_CRG_c12.mtb	2615	NA	WWSS	water	2	2606	1337165885	1	0.02	0.000540540540540541	8029	1
3	Food 1	Intake 3	43	19997	1337183276	/users/cn/jespinosa/phecomp/data/CRG/20120502_FDF_CRG/20120502_FDF_CRG/20120516_FDF_CRG_c12.mtb	2084	40	WWSS	food_sc	3	19954	1337183233	1	0.04	0.000930232558139535	8030	1
3	Food 1	Intake 3	259	20296	1337183575	/users/cn/jespinosa/phecomp/data/CRG/20120502_FDF_CRG/20120502_FDF_CRG/20120516_FDF_CRG_c12.mtb	2085	5340	WWSS	food_sc	3	20037	1337183316	1	0.1	0.000386100386100386	8031	1
3	Drink 1	Intake 1	14	20666	1337183945	/users/cn/jespinosa/phecomp/data/CRG/20120502_FDF_CRG/20120502_FDF_CRG/20120516_FDF_CRG_c12.mtb	1113	NA	WWSS	water	1	20652	1337183931	1	0.02	0.00142857142857143	8032	1
3	Food 1	Intake 3	44	25680	1337188959	/users/cn/jespinosa/phecomp/data/CRG/20120502_FDF_CRG/20120502_FDF_CRG/20120516_FDF_CRG_c12.mtb	2086	4	WWSS	food_sc	3	25636	1337188915	1	0.04	0.000909090909090909	8033	1
3	Food 1	Intake 3	65	25749	1337189028	/users/cn/jespinosa/phecomp/data/CRG/20120502_FDF_CRG/20120502_FDF_CRG/20120516_FDF_CRG_c12.mtb	2087	18	WWSS	food_sc	3	25684	1337188963	1	0.04	0.000615384615384615	8034	1
3	Food 1	Intake 3	171	25938	1337189217	/users/cn/jespinosa/phecomp/data/CRG/20120502_FDF_CRG/20120502_FDF_CRG/20120516_FDF_CRG_c12.mtb	2088	2367	WWSS	food_sc	3	25767	1337189046	1	0.04	0.000233918128654971	8035	1
3	Drink 1	Intake 1	33	26584	1337189863	/users/cn/jespinosa/phecomp/data/CRG/20120502_FDF_CRG/20120502_FDF_CRG/20120516_FDF_CRG_c12.mtb	1114	NA	WWSS	water	1	26551	1337189830	1	0.12	0.00363636363636364	8036	1
3	Food 2	Intake 4	113	28418	1337191697	/users/cn/jespinosa/phecomp/data/CRG/20120502_FDF_CRG/20120502_FDF_CRG/20120516_FDF_CRG_c12.mtb	3463	17	WWSS	food_sc	4	28305	1337191584	1	0.04	0.000353982300884956	8037	1
3	Food 2	Intake 4	83	28518	1337191797	/users/cn/jespinosa/phecomp/data/CRG/20120502_FDF_CRG/20120502_FDF_CRG/20120516_FDF_CRG_c12.mtb	3464	1299	WWSS	food_sc	4	28435	1337191714	1	0.02	0.000240963855421687	8038	1
3	Drink 1	Intake 1	20	29563	1337192842	/users/cn/jespinosa/phecomp/data/CRG/20120502_FDF_CRG/20120502_FDF_CRG/20120516_FDF_CRG_c12.mtb	1116	NA	WWSS	water	1	29543	1337192822	1	0.06	0.003	8039	1
3	Food 1	Intake 3	306	30123	1337193402	/users/cn/jespinosa/phecomp/data/CRG/20120502_FDF_CRG/20120502_FDF_CRG/20120516_FDF_CRG_c12.mtb	2090	8	WWSS	food_sc	3	29817	1337193096	1	0.12	0.000392156862745098	8040	1
3	Food 1	Intake 3	49	30180	1337193459	/users/cn/jespinosa/phecomp/data/CRG/20120502_FDF_CRG/20120502_FDF_CRG/20120516_FDF_CRG_c12.mtb	2091	1230	WWSS	food_sc	3	30131	1337193410	1	0.02	0.000408163265306122	8041	1
3	Drink 2	Intake 2	23	30499	1337193778	/users/cn/jespinosa/phecomp/data/CRG/20120502_FDF_CRG/20120502_FDF_CRG/20120516_FDF_CRG_c12.mtb	2620	NA	WWSS	water	2	30476	1337193755	1	0.04	0.00173913043478261	8042	1
3	Drink 1	Intake 1	15	31220	1337194499	/users/cn/jespinosa/phecomp/data/CRG/20120502_FDF_CRG/20120502_FDF_CRG/20120516_FDF_CRG_c12.mtb	1117	NA	WWSS	water	1	31205	1337194484	1	0.04	0.00266666666666667	8043	1
3	Food 1	Intake 3	346	31756	1337195035	/users/cn/jespinosa/phecomp/data/CRG/20120502_FDF_CRG/20120502_FDF_CRG/20120516_FDF_CRG_c12.mtb	2092	149	WWSS	food_sc	3	31410	1337194689	1	0.16	0.00046242774566474	8044	1
3	Drink 1	Intake 1	20	31826	1337195105	/users/cn/jespinosa/phecomp/data/CRG/20120502_FDF_CRG/20120502_FDF_CRG/20120516_FDF_CRG_c12.mtb	1118	NA	WWSS	water	1	31806	1337195085	1	0.08	0.004	8045	1
3	Food 1	Intake 3	47	31952	1337195231	/users/cn/jespinosa/phecomp/data/CRG/20120502_FDF_CRG/20120502_FDF_CRG/20120516_FDF_CRG_c12.mtb	2094	943	WWSS	food_sc	3	31905	1337195184	1	0.02	0.000425531914893617	8046	1
3	Drink 2	Intake 2	19	32172	1337195451	/users/cn/jespinosa/phecomp/data/CRG/20120502_FDF_CRG/20120502_FDF_CRG/20120516_FDF_CRG_c12.mtb	2621	NA	WWSS	water	2	32153	1337195432	1	0.06	0.00315789473684211	8047	1
3	Food 1	Intake 3	223	33118	1337196397	/users/cn/jespinosa/phecomp/data/CRG/20120502_FDF_CRG/20120502_FDF_CRG/20120516_FDF_CRG_c12.mtb	2095	2004	WWSS	food_sc	3	32895	1337196174	1	0.1	0.000448430493273543	8048	1
3	Drink 1	Intake 1	20	33389	1337196668	/users/cn/jespinosa/phecomp/data/CRG/20120502_FDF_CRG/20120502_FDF_CRG/20120516_FDF_CRG_c12.mtb	1120	NA	WWSS	water	1	33369	1337196648	1	0.06	0.003	8049	1
3	Food 1	Intake 3	581	35703	1337198982	/users/cn/jespinosa/phecomp/data/CRG/20120502_FDF_CRG/20120502_FDF_CRG/20120516_FDF_CRG_c12.mtb	2097	133	WWSS	food_sc	3	35122	1337198401	1	0.14	0.000240963855421687	8050	1
3	Drink 1	Intake 1	18	35644	1337198923	/users/cn/jespinosa/phecomp/data/CRG/20120502_FDF_CRG/20120502_FDF_CRG/20120516_FDF_CRG_c12.mtb	1121	NA	WWSS	water	1	35626	1337198905	1	0.04	0.00222222222222222	8051	1
3	Drink 1	Intake 1	14	35836	1337199115	/users/cn/jespinosa/phecomp/data/CRG/20120502_FDF_CRG/20120502_FDF_CRG/20120516_FDF_CRG_c12.mtb	1124	NA	WWSS	water	1	35822	1337199101	1	0.04	0.00285714285714286	8052	1
3	Food 1	Intake 3	261	36097	1337199376	/users/cn/jespinosa/phecomp/data/CRG/20120502_FDF_CRG/20120502_FDF_CRG/20120516_FDF_CRG_c12.mtb	2099	1180	WWSS	food_sc	3	35836	1337199115	1	0.02	7.66283524904215e-05	8053	1
3	Drink 1	Intake 1	20	36058	1337199337	/users/cn/jespinosa/phecomp/data/CRG/20120502_FDF_CRG/20120502_FDF_CRG/20120516_FDF_CRG_c12.mtb	1125	NA	WWSS	water	1	36038	1337199317	1	0.02	0.001	8054	1
3	Drink 1	Intake 1	15	36415	1337199694	/users/cn/jespinosa/phecomp/data/CRG/20120502_FDF_CRG/20120502_FDF_CRG/20120516_FDF_CRG_c12.mtb	1126	NA	WWSS	water	1	36400	1337199679	1	0.08	0.00533333333333333	8055	1
3	Drink 1	Intake 1	16	36860	1337200139	/users/cn/jespinosa/phecomp/data/CRG/20120502_FDF_CRG/20120502_FDF_CRG/20120516_FDF_CRG_c12.mtb	1127	NA	WWSS	water	1	36844	1337200123	1	0.0600000000000001	0.00375000000000001	8056	1
3	Food 1	Intake 3	72	37349	1337200628	/users/cn/jespinosa/phecomp/data/CRG/20120502_FDF_CRG/20120502_FDF_CRG/20120516_FDF_CRG_c12.mtb	2104	34	WWSS	food_sc	3	37277	1337200556	1	0.02	0.000277777777777778	8057	1
3	Food 1	Intake 3	12	37395	1337200674	/users/cn/jespinosa/phecomp/data/CRG/20120502_FDF_CRG/20120502_FDF_CRG/20120516_FDF_CRG_c12.mtb	2105	37	WWSS	food_sc	3	37383	1337200662	1	0.04	0.00333333333333333	8058	1
3	Food 1	Intake 3	105	37537	1337200816	/users/cn/jespinosa/phecomp/data/CRG/20120502_FDF_CRG/20120502_FDF_CRG/20120516_FDF_CRG_c12.mtb	2106	76	WWSS	food_sc	3	37432	1337200711	1	0.02	0.00019047619047619	8059	1
3	Food 1	Intake 3	785	38398	1337201677	/users/cn/jespinosa/phecomp/data/CRG/20120502_FDF_CRG/20120502_FDF_CRG/20120516_FDF_CRG_c12.mtb	2108	9	WWSS	food_sc	3	37613	1337200892	1	0.26	0.000331210191082803	8060	1
3	Drink 1	Intake 1	12	38156	1337201435	/users/cn/jespinosa/phecomp/data/CRG/20120502_FDF_CRG/20120502_FDF_CRG/20120516_FDF_CRG_c12.mtb	1128	NA	WWSS	water	1	38144	1337201423	1	0.0399999999999999	0.00333333333333332	8061	1
3	Food 1	Intake 3	71	38478	1337201757	/users/cn/jespinosa/phecomp/data/CRG/20120502_FDF_CRG/20120502_FDF_CRG/20120516_FDF_CRG_c12.mtb	2109	819	WWSS	food_sc	3	38407	1337201686	1	0.0599999999999998	0.000845070422535208	8062	1
3	Drink 2	Intake 2	27	38516	1337201795	/users/cn/jespinosa/phecomp/data/CRG/20120502_FDF_CRG/20120502_FDF_CRG/20120516_FDF_CRG_c12.mtb	2624	NA	WWSS	water	2	38489	1337201768	1	0.08	0.00296296296296296	8063	1
3	Drink 1	Intake 1	20	38762	1337202041	/users/cn/jespinosa/phecomp/data/CRG/20120502_FDF_CRG/20120502_FDF_CRG/20120516_FDF_CRG_c12.mtb	1129	NA	WWSS	water	1	38742	1337202021	1	0.0600000000000001	0.00300000000000001	8064	1
3	Food 2	Intake 4	134	39431	1337202710	/users/cn/jespinosa/phecomp/data/CRG/20120502_FDF_CRG/20120502_FDF_CRG/20120516_FDF_CRG_c12.mtb	3474	2055	WWSS	food_sc	4	39297	1337202576	1	0.02	0.000149253731343284	8065	1
3	Drink 2	Intake 2	12	39548	1337202827	/users/cn/jespinosa/phecomp/data/CRG/20120502_FDF_CRG/20120502_FDF_CRG/20120516_FDF_CRG_c12.mtb	2625	NA	WWSS	water	2	39536	1337202815	1	0.02	0.00166666666666667	8066	1
3	Food 1	Intake 3	271	41757	1337205036	/users/cn/jespinosa/phecomp/data/CRG/20120502_FDF_CRG/20120502_FDF_CRG/20120516_FDF_CRG_c12.mtb	2111	1112	WWSS	food_sc	3	41486	1337204765	1	0.0800000000000001	0.000295202952029521	8067	1
3	Drink 2	Intake 2	16	41774	1337205053	/users/cn/jespinosa/phecomp/data/CRG/20120502_FDF_CRG/20120502_FDF_CRG/20120516_FDF_CRG_c12.mtb	2627	NA	WWSS	water	2	41758	1337205037	1	0.02	0.00125	8068	1
3	Drink 2	Intake 2	37	42453	1337205732	/users/cn/jespinosa/phecomp/data/CRG/20120502_FDF_CRG/20120502_FDF_CRG/20120516_FDF_CRG_c12.mtb	2630	NA	WWSS	water	2	42416	1337205695	1	0.02	0.000540540540540541	8069	1
3	Drink 2	Intake 2	49	42542	1337205821	/users/cn/jespinosa/phecomp/data/CRG/20120502_FDF_CRG/20120502_FDF_CRG/20120516_FDF_CRG_c12.mtb	2631	NA	WWSS	water	2	42493	1337205772	1	0.04	0.000816326530612245	8070	1
3	Drink 2	Intake 2	60	42608	1337205887	/users/cn/jespinosa/phecomp/data/CRG/20120502_FDF_CRG/20120502_FDF_CRG/20120516_FDF_CRG_c12.mtb	2632	NA	WWSS	water	2	42548	1337205827	1	0.06	0.001	8071	1
3	Drink 2	Intake 2	23	42733	1337206012	/users/cn/jespinosa/phecomp/data/CRG/20120502_FDF_CRG/20120502_FDF_CRG/20120516_FDF_CRG_c12.mtb	2633	NA	WWSS	water	2	42710	1337205989	1	0.04	0.00173913043478261	8072	1
3	Food 2	Intake 4	444	43313	1337206592	/users/cn/jespinosa/phecomp/data/CRG/20120502_FDF_CRG/20120502_FDF_CRG/20120516_FDF_CRG_c12.mtb	3478	126	WWSS	food_sc	4	42869	1337206148	1	0.1	0.000225225225225225	8073	1
3	Drink 2	Intake 2	21	43336	1337206615	/users/cn/jespinosa/phecomp/data/CRG/20120502_FDF_CRG/20120502_FDF_CRG/20120516_FDF_CRG_c12.mtb	2635	NA	WWSS	water	2	43315	1337206594	1	0.06	0.00285714285714286	8074	1
3	Food 2	Intake 4	115	43554	1337206833	/users/cn/jespinosa/phecomp/data/CRG/20120502_FDF_CRG/20120502_FDF_CRG/20120516_FDF_CRG_c12.mtb	3480	4116	WWSS	food_sc	4	43439	1337206718	1	0.02	0.000173913043478261	8075	1
3	Drink 1	Intake 1	24	43578	1337206857	/users/cn/jespinosa/phecomp/data/CRG/20120502_FDF_CRG/20120502_FDF_CRG/20120516_FDF_CRG_c12.mtb	1132	NA	WWSS	water	1	43554	1337206833	1	0.1	0.00416666666666667	8076	1
3	Food 1	Intake 3	401	48071	1337211350	/users/cn/jespinosa/phecomp/data/CRG/20120502_FDF_CRG/20120502_FDF_CRG/20120516_FDF_CRG_c12.mtb	2117	363	WWSS	food_sc	3	47670	1337210949	1	0.1	0.000249376558603491	8077	1
3	Drink 1	Intake 1	16	48423	1337211702	/users/cn/jespinosa/phecomp/data/CRG/20120502_FDF_CRG/20120502_FDF_CRG/20120516_FDF_CRG_c12.mtb	1134	NA	WWSS	water	1	48407	1337211686	1	0.0599999999999999	0.00374999999999999	8078	1
3	Food 1	Intake 3	179	48613	1337211892	/users/cn/jespinosa/phecomp/data/CRG/20120502_FDF_CRG/20120502_FDF_CRG/20120516_FDF_CRG_c12.mtb	2119	1943	WWSS	food_sc	3	48434	1337211713	1	0.04	0.000223463687150838	8079	1
3	Drink 1	Intake 1	20	48632	1337211911	/users/cn/jespinosa/phecomp/data/CRG/20120502_FDF_CRG/20120502_FDF_CRG/20120516_FDF_CRG_c12.mtb	1135	NA	WWSS	water	1	48612	1337211891	1	0.04	0.002	8080	1
3	Drink 1	Intake 1	13	48807	1337212086	/users/cn/jespinosa/phecomp/data/CRG/20120502_FDF_CRG/20120502_FDF_CRG/20120516_FDF_CRG_c12.mtb	1136	NA	WWSS	water	1	48794	1337212073	1	0.04	0.00307692307692308	8081	1
3	Drink 2	Intake 2	116	49493	1337212772	/users/cn/jespinosa/phecomp/data/CRG/20120502_FDF_CRG/20120502_FDF_CRG/20120516_FDF_CRG_c12.mtb	2638	NA	WWSS	water	2	49377	1337212656	1	0.08	0.000689655172413793	8082	1
3	Drink 2	Intake 2	47	49554	1337212833	/users/cn/jespinosa/phecomp/data/CRG/20120502_FDF_CRG/20120502_FDF_CRG/20120516_FDF_CRG_c12.mtb	2639	NA	WWSS	water	2	49507	1337212786	1	0.02	0.000425531914893617	8083	1
3	Food 1	Intake 3	180	50736	1337214015	/users/cn/jespinosa/phecomp/data/CRG/20120502_FDF_CRG/20120502_FDF_CRG/20120516_FDF_CRG_c12.mtb	2124	14	WWSS	food_sc	3	50556	1337213835	1	0.04	0.000222222222222222	8084	1
3	Food 1	Intake 3	161	50911	1337214190	/users/cn/jespinosa/phecomp/data/CRG/20120502_FDF_CRG/20120502_FDF_CRG/20120516_FDF_CRG_c12.mtb	2125	1855	WWSS	food_sc	3	50750	1337214029	1	0.02	0.000124223602484472	8085	1
3	Drink 1	Intake 1	22	50925	1337214204	/users/cn/jespinosa/phecomp/data/CRG/20120502_FDF_CRG/20120502_FDF_CRG/20120516_FDF_CRG_c12.mtb	1138	NA	WWSS	water	1	50903	1337214182	1	0.04	0.00181818181818182	8086	1
3	Drink 1	Intake 1	17	51076	1337214355	/users/cn/jespinosa/phecomp/data/CRG/20120502_FDF_CRG/20120502_FDF_CRG/20120516_FDF_CRG_c12.mtb	1139	NA	WWSS	water	1	51059	1337214338	1	0.0800000000000001	0.00470588235294118	8087	1
3	Drink 2	Intake 2	30	51176	1337214455	/users/cn/jespinosa/phecomp/data/CRG/20120502_FDF_CRG/20120502_FDF_CRG/20120516_FDF_CRG_c12.mtb	2642	NA	WWSS	water	2	51146	1337214425	1	0.02	0.000666666666666667	8088	1
3	Food 1	Intake 3	604	53370	1337216649	/users/cn/jespinosa/phecomp/data/CRG/20120502_FDF_CRG/20120502_FDF_CRG/20120516_FDF_CRG_c12.mtb	2127	6833	WWSS	food_sc	3	52766	1337216045	1	0.0599999999999998	9.93377483443705e-05	8089	1
3	Drink 1	Intake 1	20	53382	1337216661	/users/cn/jespinosa/phecomp/data/CRG/20120502_FDF_CRG/20120502_FDF_CRG/20120516_FDF_CRG_c12.mtb	1143	NA	WWSS	water	1	53362	1337216641	1	0.0799999999999998	0.00399999999999999	8090	1
3	Drink 1	Intake 1	15	53548	1337216827	/users/cn/jespinosa/phecomp/data/CRG/20120502_FDF_CRG/20120502_FDF_CRG/20120516_FDF_CRG_c12.mtb	1144	NA	WWSS	water	1	53533	1337216812	1	0.02	0.00133333333333333	8091	1
3	Food 1	Intake 3	604	60807	1337224086	/users/cn/jespinosa/phecomp/data/CRG/20120502_FDF_CRG/20120502_FDF_CRG/20120516_FDF_CRG_c12.mtb	2133	508	WWSS	food_sc	3	60203	1337223482	1	0.12	0.000198675496688742	8092	1
3	Drink 1	Intake 1	17	60837	1337224116	/users/cn/jespinosa/phecomp/data/CRG/20120502_FDF_CRG/20120502_FDF_CRG/20120516_FDF_CRG_c12.mtb	1145	NA	WWSS	water	1	60820	1337224099	1	0.04	0.00235294117647059	8093	1
3	Drink 2	Intake 2	19	60965	1337224244	/users/cn/jespinosa/phecomp/data/CRG/20120502_FDF_CRG/20120502_FDF_CRG/20120516_FDF_CRG_c12.mtb	2647	NA	WWSS	water	2	60946	1337224225	1	0.04	0.00210526315789474	8094	1
3	Drink 2	Intake 2	24	61166	1337224445	/users/cn/jespinosa/phecomp/data/CRG/20120502_FDF_CRG/20120502_FDF_CRG/20120516_FDF_CRG_c12.mtb	2649	NA	WWSS	water	2	61142	1337224421	1	0.02	0.000833333333333333	8095	1
3	Drink 1	Intake 1	17	61254	1337224533	/users/cn/jespinosa/phecomp/data/CRG/20120502_FDF_CRG/20120502_FDF_CRG/20120516_FDF_CRG_c12.mtb	1146	NA	WWSS	water	1	61237	1337224516	1	0.04	0.00235294117647059	8096	1
3	Food 1	Intake 3	534	61849	1337225128	/users/cn/jespinosa/phecomp/data/CRG/20120502_FDF_CRG/20120502_FDF_CRG/20120516_FDF_CRG_c12.mtb	2135	2367	WWSS	food_sc	3	61315	1337224594	1	0.0800000000000001	0.000149812734082397	8097	1
3	Drink 1	Intake 1	28	61882	1337225161	/users/cn/jespinosa/phecomp/data/CRG/20120502_FDF_CRG/20120502_FDF_CRG/20120516_FDF_CRG_c12.mtb	1147	NA	WWSS	water	1	61854	1337225133	1	0.12	0.00428571428571429	8098	1
3	Drink 2	Intake 2	26	61955	1337225234	/users/cn/jespinosa/phecomp/data/CRG/20120502_FDF_CRG/20120502_FDF_CRG/20120516_FDF_CRG_c12.mtb	2651	NA	WWSS	water	2	61929	1337225208	1	0.08	0.00307692307692308	8099	1
3	Food 1	Intake 3	158	64374	1337227653	/users/cn/jespinosa/phecomp/data/CRG/20120502_FDF_CRG/20120502_FDF_CRG/20120516_FDF_CRG_c12.mtb	2137	2406	WWSS	food_sc	3	64216	1337227495	1	0.02	0.000126582278481013	8100	1
3	Food 1	Intake 3	379	67159	1337230438	/users/cn/jespinosa/phecomp/data/CRG/20120502_FDF_CRG/20120502_FDF_CRG/20120516_FDF_CRG_c12.mtb	2139	1879	WWSS	food_sc	3	66780	1337230059	1	0.02	5.27704485488127e-05	8101	1
3	Drink 1	Intake 1	38	67396	1337230675	/users/cn/jespinosa/phecomp/data/CRG/20120502_FDF_CRG/20120502_FDF_CRG/20120516_FDF_CRG_c12.mtb	1148	NA	WWSS	water	1	67358	1337230637	1	0.04	0.00105263157894737	8102	1
3	Food 1	Intake 3	404	69442	1337232721	/users/cn/jespinosa/phecomp/data/CRG/20120502_FDF_CRG/20120502_FDF_CRG/20120516_FDF_CRG_c12.mtb	2141	529	WWSS	food_sc	3	69038	1337232317	1	0.04	9.9009900990099e-05	8103	1
3	Drink 1	Intake 1	16	69686	1337232965	/users/cn/jespinosa/phecomp/data/CRG/20120502_FDF_CRG/20120502_FDF_CRG/20120516_FDF_CRG_c12.mtb	1149	NA	WWSS	water	1	69670	1337232949	1	0.02	0.00125	8104	1
3	Food 1	Intake 3	54	70025	1337233304	/users/cn/jespinosa/phecomp/data/CRG/20120502_FDF_CRG/20120502_FDF_CRG/20120516_FDF_CRG_c12.mtb	2143	63	WWSS	food_sc	3	69971	1337233250	1	0.02	0.00037037037037037	8105	1
3	Food 2	Intake 4	517	70605	1337233884	/users/cn/jespinosa/phecomp/data/CRG/20120502_FDF_CRG/20120502_FDF_CRG/20120516_FDF_CRG_c12.mtb	3520	704	WWSS	food_sc	4	70088	1337233367	1	0.22	0.000425531914893617	8106	1
3	Drink 1	Intake 1	31	70636	1337233915	/users/cn/jespinosa/phecomp/data/CRG/20120502_FDF_CRG/20120502_FDF_CRG/20120516_FDF_CRG_c12.mtb	1150	NA	WWSS	water	1	70605	1337233884	1	0.12	0.00387096774193548	8107	1
3	Drink 1	Intake 1	18	70667	1337233946	/users/cn/jespinosa/phecomp/data/CRG/20120502_FDF_CRG/20120502_FDF_CRG/20120516_FDF_CRG_c12.mtb	1151	NA	WWSS	water	1	70649	1337233928	1	0.04	0.00222222222222222	8108	1
3	Drink 1	Intake 1	18	70734	1337234013	/users/cn/jespinosa/phecomp/data/CRG/20120502_FDF_CRG/20120502_FDF_CRG/20120516_FDF_CRG_c12.mtb	1152	NA	WWSS	water	1	70716	1337233995	1	0.0399999999999998	0.00222222222222221	8109	1
3	Drink 2	Intake 2	18	71269	1337234548	/users/cn/jespinosa/phecomp/data/CRG/20120502_FDF_CRG/20120502_FDF_CRG/20120516_FDF_CRG_c12.mtb	2654	NA	WWSS	water	2	71251	1337234530	1	0.0599999999999999	0.00333333333333333	8110	1
3	Food 2	Intake 4	154	71463	1337234742	/users/cn/jespinosa/phecomp/data/CRG/20120502_FDF_CRG/20120502_FDF_CRG/20120516_FDF_CRG_c12.mtb	3524	6	WWSS	food_sc	4	71309	1337234588	1	0.04	0.00025974025974026	8111	1
3	Food 2	Intake 4	49	71518	1337234797	/users/cn/jespinosa/phecomp/data/CRG/20120502_FDF_CRG/20120502_FDF_CRG/20120516_FDF_CRG_c12.mtb	3525	7	WWSS	food_sc	4	71469	1337234748	1	0.04	0.000816326530612245	8112	1
3	Food 2	Intake 4	91	71616	1337234895	/users/cn/jespinosa/phecomp/data/CRG/20120502_FDF_CRG/20120502_FDF_CRG/20120516_FDF_CRG_c12.mtb	3526	7470	WWSS	food_sc	4	71525	1337234804	1	0.04	0.00043956043956044	8113	1
3	Drink 1	Intake 1	19	71643	1337234922	/users/cn/jespinosa/phecomp/data/CRG/20120502_FDF_CRG/20120502_FDF_CRG/20120516_FDF_CRG_c12.mtb	1153	NA	WWSS	water	1	71624	1337234903	1	0.0600000000000001	0.00315789473684211	8114	1
3	Drink 1	Intake 1	17	71763	1337235042	/users/cn/jespinosa/phecomp/data/CRG/20120502_FDF_CRG/20120502_FDF_CRG/20120516_FDF_CRG_c12.mtb	1154	NA	WWSS	water	1	71746	1337235025	1	0.04	0.00235294117647059	8115	1
3	Drink 1	Intake 1	14	72522	1337235801	/users/cn/jespinosa/phecomp/data/CRG/20120502_FDF_CRG/20120502_FDF_CRG/20120516_FDF_CRG_c12.mtb	1156	NA	WWSS	water	1	72508	1337235787	1	0.0399999999999998	0.00285714285714284	8116	1
3	Food 2	Intake 4	462	79548	1337242827	/users/cn/jespinosa/phecomp/data/CRG/20120502_FDF_CRG/20120502_FDF_CRG/20120516_FDF_CRG_c12.mtb	3529	798	WWSS	food_sc	4	79086	1337242365	1	0.22	0.000476190476190476	8117	1
3	Drink 2	Intake 2	15	79572	1337242851	/users/cn/jespinosa/phecomp/data/CRG/20120502_FDF_CRG/20120502_FDF_CRG/20120516_FDF_CRG_c12.mtb	2657	NA	WWSS	water	2	79557	1337242836	1	0.02	0.00133333333333333	8118	1
3	Drink 1	Intake 1	12	79636	1337242915	/users/cn/jespinosa/phecomp/data/CRG/20120502_FDF_CRG/20120502_FDF_CRG/20120516_FDF_CRG_c12.mtb	1157	NA	WWSS	water	1	79624	1337242903	1	0.0600000000000001	0.00500000000000001	8119	1
3	Drink 1	Intake 1	14	79890	1337243169	/users/cn/jespinosa/phecomp/data/CRG/20120502_FDF_CRG/20120502_FDF_CRG/20120516_FDF_CRG_c12.mtb	1158	NA	WWSS	water	1	79876	1337243155	1	0.1	0.00714285714285714	8120	1
3	Food 2	Intake 4	159	80505	1337243784	/users/cn/jespinosa/phecomp/data/CRG/20120502_FDF_CRG/20120502_FDF_CRG/20120516_FDF_CRG_c12.mtb	3530	5090	WWSS	food_sc	4	80346	1337243625	1	0.0599999999999999	0.000377358490566037	8121	1
3	Drink 1	Intake 1	14	80625	1337243904	/users/cn/jespinosa/phecomp/data/CRG/20120502_FDF_CRG/20120502_FDF_CRG/20120516_FDF_CRG_c12.mtb	1159	NA	WWSS	water	1	80611	1337243890	1	0.02	0.00142857142857143	8122	1
3	Food 2	Intake 4	277	85872	1337249151	/users/cn/jespinosa/phecomp/data/CRG/20120502_FDF_CRG/20120502_FDF_CRG/20120516_FDF_CRG_c12.mtb	3531	23040	WWSS	food_sc	4	85595	1337248874	1	0.42	0.00151624548736462	8123	1
3	Drink 1	Intake 1	14	86157	1337249436	/users/cn/jespinosa/phecomp/data/CRG/20120502_FDF_CRG/20120502_FDF_CRG/20120516_FDF_CRG_c12.mtb	1160	NA	WWSS	water	1	86143	1337249422	1	0.0600000000000001	0.00428571428571429	8124	1
3	Drink 1	Intake 1	16	86232	1337249511	/users/cn/jespinosa/phecomp/data/CRG/20120502_FDF_CRG/20120502_FDF_CRG/20120516_FDF_CRG_c12.mtb	1161	NA	WWSS	water	1	86216	1337249495	1	0.02	0.00125	8125	1
3	Drink 2	Intake 2	12	86681	1337249960	/users/cn/jespinosa/phecomp/data/CRG/20120502_FDF_CRG/20120502_FDF_CRG/20120516_FDF_CRG_c12.mtb	2659	NA	WWSS	water	2	86669	1337249948	1	0.0800000000000001	0.00666666666666667	8126	1
3	Drink 1	Intake 1	9	86994	1337250273	/users/cn/jespinosa/phecomp/data/CRG/20120502_FDF_CRG/20120502_FDF_CRG/20120516_FDF_CRG_c12.mtb	1162	NA	WWSS	water	1	86985	1337250264	1	0.04	0.00444444444444444	8127	1
3	Drink 2	Intake 2	24	87372	1337250651	/users/cn/jespinosa/phecomp/data/CRG/20120502_FDF_CRG/20120502_FDF_CRG/20120516_FDF_CRG_c12.mtb	2662	NA	WWSS	water	2	87348	1337250627	1	0.04	0.00166666666666667	8128	1
3	Drink 2	Intake 2	29	108762	1337272041	/users/cn/jespinosa/phecomp/data/CRG/20120502_FDF_CRG/20120502_FDF_CRG/20120516_FDF_CRG_c12.mtb	2665	NA	WWSS	water	2	108733	1337272012	1	0.02	0.000689655172413793	8129	1
3	Food 2	Intake 4	17	108929	1337272208	/users/cn/jespinosa/phecomp/data/CRG/20120502_FDF_CRG/20120502_FDF_CRG/20120516_FDF_CRG_c12.mtb	3539	5516	WWSS	food_sc	4	108912	1337272191	1	0.02	0.00117647058823529	8130	1
3	Food 2	Intake 4	792	115237	1337278516	/users/cn/jespinosa/phecomp/data/CRG/20120502_FDF_CRG/20120502_FDF_CRG/20120516_FDF_CRG_c12.mtb	3543	399	WWSS	food_sc	4	114445	1337277724	1	0.16	0.000202020202020202	8131	1
3	Drink 1	Intake 1	12	115461	1337278740	/users/cn/jespinosa/phecomp/data/CRG/20120502_FDF_CRG/20120502_FDF_CRG/20120516_FDF_CRG_c12.mtb	1165	NA	WWSS	water	1	115449	1337278728	1	0.04	0.00333333333333333	8132	1
3	Food 2	Intake 4	290	115926	1337279205	/users/cn/jespinosa/phecomp/data/CRG/20120502_FDF_CRG/20120502_FDF_CRG/20120516_FDF_CRG_c12.mtb	3545	867	WWSS	food_sc	4	115636	1337278915	1	0.0800000000000001	0.000275862068965518	8133	1
3	Drink 2	Intake 2	24	115949	1337279228	/users/cn/jespinosa/phecomp/data/CRG/20120502_FDF_CRG/20120502_FDF_CRG/20120516_FDF_CRG_c12.mtb	2667	NA	WWSS	water	2	115925	1337279204	1	0.04	0.00166666666666667	8134	1
3	Drink 1	Intake 1	16	116195	1337279474	/users/cn/jespinosa/phecomp/data/CRG/20120502_FDF_CRG/20120502_FDF_CRG/20120516_FDF_CRG_c12.mtb	1166	NA	WWSS	water	1	116179	1337279458	1	0.04	0.0025	8135	1
3	Drink 2	Intake 2	18	116577	1337279856	/users/cn/jespinosa/phecomp/data/CRG/20120502_FDF_CRG/20120502_FDF_CRG/20120516_FDF_CRG_c12.mtb	2668	NA	WWSS	water	2	116559	1337279838	1	0.0600000000000001	0.00333333333333334	8136	1
3	Food 2	Intake 4	289	117082	1337280361	/users/cn/jespinosa/phecomp/data/CRG/20120502_FDF_CRG/20120502_FDF_CRG/20120516_FDF_CRG_c12.mtb	3546	1428	WWSS	food_sc	4	116793	1337280072	1	0.1	0.000346020761245675	8137	1
3	Drink 1	Intake 1	15	117109	1337280388	/users/cn/jespinosa/phecomp/data/CRG/20120502_FDF_CRG/20120502_FDF_CRG/20120516_FDF_CRG_c12.mtb	1167	NA	WWSS	water	1	117094	1337280373	1	0.0399999999999996	0.00266666666666664	8138	1
3	Drink 1	Intake 1	12	117724	1337281003	/users/cn/jespinosa/phecomp/data/CRG/20120502_FDF_CRG/20120502_FDF_CRG/20120516_FDF_CRG_c12.mtb	1168	NA	WWSS	water	1	117712	1337280991	1	0.0200000000000005	0.00166666666666671	8139	1
3	Drink 1	Intake 1	16	118010	1337281289	/users/cn/jespinosa/phecomp/data/CRG/20120502_FDF_CRG/20120502_FDF_CRG/20120516_FDF_CRG_c12.mtb	1169	NA	WWSS	water	1	117994	1337281273	1	0.0399999999999996	0.00249999999999997	8140	1
3	Food 2	Intake 4	507	119017	1337282296	/users/cn/jespinosa/phecomp/data/CRG/20120502_FDF_CRG/20120502_FDF_CRG/20120516_FDF_CRG_c12.mtb	3548	43	WWSS	food_sc	4	118510	1337281789	1	0.0999999999999999	0.00019723865877712	8141	1
3	Drink 2	Intake 2	25	119039	1337282318	/users/cn/jespinosa/phecomp/data/CRG/20120502_FDF_CRG/20120502_FDF_CRG/20120516_FDF_CRG_c12.mtb	2669	NA	WWSS	water	2	119014	1337282293	1	0.04	0.0016	8142	1
3	Food 2	Intake 4	355	119415	1337282694	/users/cn/jespinosa/phecomp/data/CRG/20120502_FDF_CRG/20120502_FDF_CRG/20120516_FDF_CRG_c12.mtb	3549	1151	WWSS	food_sc	4	119060	1337282339	1	0.14	0.000394366197183099	8143	1
3	Drink 2	Intake 2	25	119436	1337282715	/users/cn/jespinosa/phecomp/data/CRG/20120502_FDF_CRG/20120502_FDF_CRG/20120516_FDF_CRG_c12.mtb	2670	NA	WWSS	water	2	119411	1337282690	1	0.0799999999999998	0.00319999999999999	8144	1
3	Drink 1	Intake 1	24	119528	1337282807	/users/cn/jespinosa/phecomp/data/CRG/20120502_FDF_CRG/20120502_FDF_CRG/20120516_FDF_CRG_c12.mtb	1170	NA	WWSS	water	1	119504	1337282783	1	0.0600000000000001	0.0025	8145	1
3	Drink 1	Intake 1	25	120043	1337283322	/users/cn/jespinosa/phecomp/data/CRG/20120502_FDF_CRG/20120502_FDF_CRG/20120516_FDF_CRG_c12.mtb	1171	NA	WWSS	water	1	120018	1337283297	1	0.04	0.0016	8146	1
3	Drink 2	Intake 2	11	120190	1337283469	/users/cn/jespinosa/phecomp/data/CRG/20120502_FDF_CRG/20120502_FDF_CRG/20120516_FDF_CRG_c12.mtb	2674	NA	WWSS	water	2	120179	1337283458	1	0.02	0.00181818181818182	8147	1
3	Food 2	Intake 4	401	120967	1337284246	/users/cn/jespinosa/phecomp/data/CRG/20120502_FDF_CRG/20120502_FDF_CRG/20120516_FDF_CRG_c12.mtb	3553	1673	WWSS	food_sc	4	120566	1337283845	1	0.0800000000000001	0.000199501246882793	8148	1
3	Drink 1	Intake 1	18	121072	1337284351	/users/cn/jespinosa/phecomp/data/CRG/20120502_FDF_CRG/20120502_FDF_CRG/20120516_FDF_CRG_c12.mtb	1172	NA	WWSS	water	1	121054	1337284333	1	0.04	0.00222222222222222	8149	1
3	Food 2	Intake 4	640	123280	1337286559	/users/cn/jespinosa/phecomp/data/CRG/20120502_FDF_CRG/20120502_FDF_CRG/20120516_FDF_CRG_c12.mtb	3556	601	WWSS	food_sc	4	122640	1337285919	1	0.18	0.00028125	8150	1
3	Drink 2	Intake 2	17	123319	1337286598	/users/cn/jespinosa/phecomp/data/CRG/20120502_FDF_CRG/20120502_FDF_CRG/20120516_FDF_CRG_c12.mtb	2677	NA	WWSS	water	2	123302	1337286581	1	0.04	0.00235294117647059	8151	1
3	Drink 1	Intake 1	16	123459	1337286738	/users/cn/jespinosa/phecomp/data/CRG/20120502_FDF_CRG/20120502_FDF_CRG/20120516_FDF_CRG_c12.mtb	1173	NA	WWSS	water	1	123443	1337286722	1	0.04	0.0025	8152	1
3	Food 1	Intake 3	38	123919	1337287198	/users/cn/jespinosa/phecomp/data/CRG/20120502_FDF_CRG/20120502_FDF_CRG/20120516_FDF_CRG_c12.mtb	2147	1120	WWSS	food_sc	3	123881	1337287160	1	0.02	0.000526315789473684	8153	1
3	Food 2	Intake 4	450	125489	1337288768	/users/cn/jespinosa/phecomp/data/CRG/20120502_FDF_CRG/20120502_FDF_CRG/20120516_FDF_CRG_c12.mtb	3559	1235	WWSS	food_sc	4	125039	1337288318	1	0.18	0.0004	8154	1
3	Drink 1	Intake 1	16	125544	1337288823	/users/cn/jespinosa/phecomp/data/CRG/20120502_FDF_CRG/20120502_FDF_CRG/20120516_FDF_CRG_c12.mtb	1175	NA	WWSS	water	1	125528	1337288807	1	0.04	0.0025	8155	1
3	Food 2	Intake 4	430	127154	1337290433	/users/cn/jespinosa/phecomp/data/CRG/20120502_FDF_CRG/20120502_FDF_CRG/20120516_FDF_CRG_c12.mtb	3560	2376	WWSS	food_sc	4	126724	1337290003	1	0.2	0.000465116279069767	8156	1
3	Drink 2	Intake 2	20	127168	1337290447	/users/cn/jespinosa/phecomp/data/CRG/20120502_FDF_CRG/20120502_FDF_CRG/20120516_FDF_CRG_c12.mtb	2679	NA	WWSS	water	2	127148	1337290427	1	0.04	0.002	8157	1
3	Drink 1	Intake 1	16	127180	1337290459	/users/cn/jespinosa/phecomp/data/CRG/20120502_FDF_CRG/20120502_FDF_CRG/20120516_FDF_CRG_c12.mtb	1176	NA	WWSS	water	1	127164	1337290443	1	0.04	0.0025	8158	1
3	Drink 1	Intake 1	17	127380	1337290659	/users/cn/jespinosa/phecomp/data/CRG/20120502_FDF_CRG/20120502_FDF_CRG/20120516_FDF_CRG_c12.mtb	1177	NA	WWSS	water	1	127363	1337290642	1	0.04	0.00235294117647059	8159	1
3	Drink 1	Intake 1	12	128610	1337291889	/users/cn/jespinosa/phecomp/data/CRG/20120502_FDF_CRG/20120502_FDF_CRG/20120516_FDF_CRG_c12.mtb	1178	NA	WWSS	water	1	128598	1337291877	1	0.02	0.00166666666666667	8160	1
3	Drink 1	Intake 1	18	129167	1337292446	/users/cn/jespinosa/phecomp/data/CRG/20120502_FDF_CRG/20120502_FDF_CRG/20120516_FDF_CRG_c12.mtb	1179	NA	WWSS	water	1	129149	1337292428	1	0.02	0.00111111111111111	8161	1
3	Food 2	Intake 4	208	129738	1337293017	/users/cn/jespinosa/phecomp/data/CRG/20120502_FDF_CRG/20120502_FDF_CRG/20120516_FDF_CRG_c12.mtb	3565	106	WWSS	food_sc	4	129530	1337292809	1	0.0800000000000001	0.000384615384615385	8162	1
3	Drink 2	Intake 2	25	129763	1337293042	/users/cn/jespinosa/phecomp/data/CRG/20120502_FDF_CRG/20120502_FDF_CRG/20120516_FDF_CRG_c12.mtb	2682	NA	WWSS	water	2	129738	1337293017	1	0.0799999999999998	0.00319999999999999	8163	1
3	Drink 1	Intake 1	16	129851	1337293130	/users/cn/jespinosa/phecomp/data/CRG/20120502_FDF_CRG/20120502_FDF_CRG/20120516_FDF_CRG_c12.mtb	1180	NA	WWSS	water	1	129835	1337293114	1	0.02	0.00125	8164	1
3	Food 2	Intake 4	243	130087	1337293366	/users/cn/jespinosa/phecomp/data/CRG/20120502_FDF_CRG/20120502_FDF_CRG/20120516_FDF_CRG_c12.mtb	3567	2365	WWSS	food_sc	4	129844	1337293123	1	0.14	0.000576131687242798	8165	1
3	Drink 2	Intake 2	23	130146	1337293425	/users/cn/jespinosa/phecomp/data/CRG/20120502_FDF_CRG/20120502_FDF_CRG/20120516_FDF_CRG_c12.mtb	2683	NA	WWSS	water	2	130123	1337293402	1	0.0600000000000001	0.00260869565217392	8166	1
3	Drink 2	Intake 2	44	130479	1337293758	/users/cn/jespinosa/phecomp/data/CRG/20120502_FDF_CRG/20120502_FDF_CRG/20120516_FDF_CRG_c12.mtb	2684	NA	WWSS	water	2	130435	1337293714	1	0.02	0.000454545454545455	8167	1
3	Drink 1	Intake 1	15	131018	1337294297	/users/cn/jespinosa/phecomp/data/CRG/20120502_FDF_CRG/20120502_FDF_CRG/20120516_FDF_CRG_c12.mtb	1181	NA	WWSS	water	1	131003	1337294282	1	0.0600000000000001	0.00400000000000001	8168	1
3	Food 2	Intake 4	94	132546	1337295825	/users/cn/jespinosa/phecomp/data/CRG/20120502_FDF_CRG/20120502_FDF_CRG/20120516_FDF_CRG_c12.mtb	3572	2387	WWSS	food_sc	4	132452	1337295731	1	0.32	0.00340425531914894	8169	1
3	Drink 1	Intake 1	18	133021	1337296300	/users/cn/jespinosa/phecomp/data/CRG/20120502_FDF_CRG/20120502_FDF_CRG/20120516_FDF_CRG_c12.mtb	1184	NA	WWSS	water	1	133003	1337296282	1	0.0600000000000001	0.00333333333333334	8170	1
3	Drink 1	Intake 1	16	133729	1337297008	/users/cn/jespinosa/phecomp/data/CRG/20120502_FDF_CRG/20120502_FDF_CRG/20120516_FDF_CRG_c12.mtb	1186	NA	WWSS	water	1	133713	1337296992	1	0.02	0.00125	8171	1
3	Drink 1	Intake 1	24	134300	1337297579	/users/cn/jespinosa/phecomp/data/CRG/20120502_FDF_CRG/20120502_FDF_CRG/20120516_FDF_CRG_c12.mtb	1188	NA	WWSS	water	1	134276	1337297555	1	0.04	0.00166666666666667	8172	1
3	Food 2	Intake 4	22	134955	1337298234	/users/cn/jespinosa/phecomp/data/CRG/20120502_FDF_CRG/20120502_FDF_CRG/20120516_FDF_CRG_c12.mtb	3576	5973	WWSS	food_sc	4	134933	1337298212	1	0.02	0.000909090909090909	8173	1
3	Drink 1	Intake 1	15	135367	1337298646	/users/cn/jespinosa/phecomp/data/CRG/20120502_FDF_CRG/20120502_FDF_CRG/20120516_FDF_CRG_c12.mtb	1189	NA	WWSS	water	1	135352	1337298631	1	0.02	0.00133333333333333	8174	1
3	Drink 1	Intake 1	23	135410	1337298689	/users/cn/jespinosa/phecomp/data/CRG/20120502_FDF_CRG/20120502_FDF_CRG/20120516_FDF_CRG_c12.mtb	1190	NA	WWSS	water	1	135387	1337298666	1	0.02	0.000869565217391304	8175	1
3	Drink 2	Intake 2	49	139963	1337303242	/users/cn/jespinosa/phecomp/data/CRG/20120502_FDF_CRG/20120502_FDF_CRG/20120516_FDF_CRG_c12.mtb	2697	NA	WWSS	water	2	139914	1337303193	1	0.02	0.000408163265306122	8176	1
3	Food 2	Intake 4	46	140974	1337304253	/users/cn/jespinosa/phecomp/data/CRG/20120502_FDF_CRG/20120502_FDF_CRG/20120516_FDF_CRG_c12.mtb	3589	11073	WWSS	food_sc	4	140928	1337304207	1	0.02	0.000434782608695652	8177	1
3	Drink 1	Intake 1	18	141035	1337304314	/users/cn/jespinosa/phecomp/data/CRG/20120502_FDF_CRG/20120502_FDF_CRG/20120516_FDF_CRG_c12.mtb	1193	NA	WWSS	water	1	141017	1337304296	1	0.04	0.00222222222222222	8178	1
3	Food 2	Intake 4	265	152312	1337315591	/users/cn/jespinosa/phecomp/data/CRG/20120502_FDF_CRG/20120502_FDF_CRG/20120516_FDF_CRG_c12.mtb	3603	3183	WWSS	food_sc	4	152047	1337315326	1	0.02	7.54716981132076e-05	8179	1
3	Food 2	Intake 4	708	156203	1337319482	/users/cn/jespinosa/phecomp/data/CRG/20120502_FDF_CRG/20120502_FDF_CRG/20120516_FDF_CRG_c12.mtb	3604	347	WWSS	food_sc	4	155495	1337318774	1	0.16	0.000225988700564972	8180	1
3	Drink 2	Intake 2	33	156239	1337319518	/users/cn/jespinosa/phecomp/data/CRG/20120502_FDF_CRG/20120502_FDF_CRG/20120516_FDF_CRG_c12.mtb	2700	NA	WWSS	water	2	156206	1337319485	1	0.12	0.00363636363636364	8181	1
3	Drink 2	Intake 2	17	156329	1337319608	/users/cn/jespinosa/phecomp/data/CRG/20120502_FDF_CRG/20120502_FDF_CRG/20120516_FDF_CRG_c12.mtb	2701	NA	WWSS	water	2	156312	1337319591	1	0.02	0.00117647058823529	8182	1
3	Drink 1	Intake 1	21	156372	1337319651	/users/cn/jespinosa/phecomp/data/CRG/20120502_FDF_CRG/20120502_FDF_CRG/20120516_FDF_CRG_c12.mtb	1194	NA	WWSS	water	1	156351	1337319630	1	0.02	0.000952380952380952	8183	1
3	Drink 2	Intake 2	17	156450	1337319729	/users/cn/jespinosa/phecomp/data/CRG/20120502_FDF_CRG/20120502_FDF_CRG/20120516_FDF_CRG_c12.mtb	2702	NA	WWSS	water	2	156433	1337319712	1	0.02	0.00117647058823529	8184	1
3	Food 2	Intake 4	338	156888	1337320167	/users/cn/jespinosa/phecomp/data/CRG/20120502_FDF_CRG/20120502_FDF_CRG/20120516_FDF_CRG_c12.mtb	3608	72	WWSS	food_sc	4	156550	1337319829	1	0.0599999999999996	0.000177514792899407	8185	1
3	Drink 2	Intake 2	28	156912	1337320191	/users/cn/jespinosa/phecomp/data/CRG/20120502_FDF_CRG/20120502_FDF_CRG/20120516_FDF_CRG_c12.mtb	2703	NA	WWSS	water	2	156884	1337320163	1	0.0799999999999998	0.00285714285714285	8186	1
3	Food 2	Intake 4	294	157254	1337320533	/users/cn/jespinosa/phecomp/data/CRG/20120502_FDF_CRG/20120502_FDF_CRG/20120516_FDF_CRG_c12.mtb	3609	136	WWSS	food_sc	4	156960	1337320239	1	0.12	0.000408163265306122	8187	1
3	Drink 1	Intake 1	28	157273	1337320552	/users/cn/jespinosa/phecomp/data/CRG/20120502_FDF_CRG/20120502_FDF_CRG/20120516_FDF_CRG_c12.mtb	1195	NA	WWSS	water	1	157245	1337320524	1	0.14	0.005	8188	1
3	Drink 2	Intake 2	15	157327	1337320606	/users/cn/jespinosa/phecomp/data/CRG/20120502_FDF_CRG/20120502_FDF_CRG/20120516_FDF_CRG_c12.mtb	2704	NA	WWSS	water	2	157312	1337320591	1	0.02	0.00133333333333333	8189	1
3	Food 2	Intake 4	161	157551	1337320830	/users/cn/jespinosa/phecomp/data/CRG/20120502_FDF_CRG/20120502_FDF_CRG/20120516_FDF_CRG_c12.mtb	3610	13582	WWSS	food_sc	4	157390	1337320669	1	0.0600000000000001	0.000372670807453417	8190	1
3	Drink 2	Intake 2	25	157572	1337320851	/users/cn/jespinosa/phecomp/data/CRG/20120502_FDF_CRG/20120502_FDF_CRG/20120516_FDF_CRG_c12.mtb	2706	NA	WWSS	water	2	157547	1337320826	1	0.0799999999999998	0.00319999999999999	8191	1
3	Drink 2	Intake 2	25	158172	1337321451	/users/cn/jespinosa/phecomp/data/CRG/20120502_FDF_CRG/20120502_FDF_CRG/20120516_FDF_CRG_c12.mtb	2707	NA	WWSS	water	2	158147	1337321426	1	0.0800000000000001	0.0032	8192	1
3	Food 2	Intake 4	91	1988	1337334503	/users/cn/jespinosa/phecomp/data/CRG/20120502_FDF_CRG/20120502_FDF_CRG/20120518_FDF_CRG_c12.mtb	3614	4	WWSS	food_sc	4	1897	1337334412	1	0.04	0.00043956043956044	8193	1
3	Food 2	Intake 4	258	2250	1337334765	/users/cn/jespinosa/phecomp/data/CRG/20120502_FDF_CRG/20120502_FDF_CRG/20120518_FDF_CRG_c12.mtb	3615	4599	WWSS	food_sc	4	1992	1337334507	1	0.12	0.000465116279069767	8194	1
3	Drink 1	Intake 1	15	2352	1337334867	/users/cn/jespinosa/phecomp/data/CRG/20120502_FDF_CRG/20120502_FDF_CRG/20120518_FDF_CRG_c12.mtb	1196	NA	WWSS	water	1	2337	1337334852	1	0.02	0.00133333333333333	8195	1
3	Drink 1	Intake 1	10	3299	1337335814	/users/cn/jespinosa/phecomp/data/CRG/20120502_FDF_CRG/20120502_FDF_CRG/20120518_FDF_CRG_c12.mtb	1197	NA	WWSS	water	1	3289	1337335804	1	0.04	0.004	8196	1
3	Food 2	Intake 4	186	7035	1337339550	/users/cn/jespinosa/phecomp/data/CRG/20120502_FDF_CRG/20120502_FDF_CRG/20120518_FDF_CRG_c12.mtb	3617	14	WWSS	food_sc	4	6849	1337339364	1	0.08	0.00043010752688172	8197	1
3	Food 2	Intake 4	155	7204	1337339719	/users/cn/jespinosa/phecomp/data/CRG/20120502_FDF_CRG/20120502_FDF_CRG/20120518_FDF_CRG_c12.mtb	3618	97	WWSS	food_sc	4	7049	1337339564	1	0.04	0.000258064516129032	8198	1
3	Food 2	Intake 4	51	7352	1337339867	/users/cn/jespinosa/phecomp/data/CRG/20120502_FDF_CRG/20120502_FDF_CRG/20120518_FDF_CRG_c12.mtb	3619	1184	WWSS	food_sc	4	7301	1337339816	1	0.02	0.000392156862745098	8199	1
3	Drink 2	Intake 2	13	7968	1337340483	/users/cn/jespinosa/phecomp/data/CRG/20120502_FDF_CRG/20120502_FDF_CRG/20120518_FDF_CRG_c12.mtb	2709	NA	WWSS	water	2	7955	1337340470	1	0.04	0.00307692307692308	8200	1
3	Food 2	Intake 4	141	8677	1337341192	/users/cn/jespinosa/phecomp/data/CRG/20120502_FDF_CRG/20120502_FDF_CRG/20120518_FDF_CRG_c12.mtb	3621	21529	WWSS	food_sc	4	8536	1337341051	1	0.02	0.000141843971631206	8201	1
3	Drink 1	Intake 1	12	8825	1337341340	/users/cn/jespinosa/phecomp/data/CRG/20120502_FDF_CRG/20120502_FDF_CRG/20120518_FDF_CRG_c12.mtb	1199	NA	WWSS	water	1	8813	1337341328	1	0.04	0.00333333333333333	8202	1
3	Food 1	Intake 3	156	30362	1337362877	/users/cn/jespinosa/phecomp/data/CRG/20120502_FDF_CRG/20120502_FDF_CRG/20120518_FDF_CRG_c12.mtb	2173	4	WWSS	food_sc	3	30206	1337362721	1	0.02	0.000128205128205128	8203	1
3	Food 1	Intake 3	176	30542	1337363057	/users/cn/jespinosa/phecomp/data/CRG/20120502_FDF_CRG/20120502_FDF_CRG/20120518_FDF_CRG_c12.mtb	2174	48	WWSS	food_sc	3	30366	1337362881	1	0.04	0.000227272727272727	8204	1
3	Food 1	Intake 3	86	30676	1337363191	/users/cn/jespinosa/phecomp/data/CRG/20120502_FDF_CRG/20120502_FDF_CRG/20120518_FDF_CRG_c12.mtb	2175	1722	WWSS	food_sc	3	30590	1337363105	1	0.02	0.000232558139534884	8205	1
3	Food 1	Intake 3	23	32421	1337364936	/users/cn/jespinosa/phecomp/data/CRG/20120502_FDF_CRG/20120502_FDF_CRG/20120518_FDF_CRG_c12.mtb	2176	COLL	WWSS	food_sc	3	32398	1337364913	1	0.02	0.000869565217391304	8206	1
3	Food 2	Intake 4	275	32684	1337365199	/users/cn/jespinosa/phecomp/data/CRG/20120502_FDF_CRG/20120502_FDF_CRG/20120518_FDF_CRG_c12.mtb	3624	5	WWSS	food_sc	4	32409	1337364924	1	0.1	0.000363636363636364	8207	1
3	Food 2	Intake 4	102	32791	1337365306	/users/cn/jespinosa/phecomp/data/CRG/20120502_FDF_CRG/20120502_FDF_CRG/20120518_FDF_CRG_c12.mtb	3625	75	WWSS	food_sc	4	32689	1337365204	1	0.02	0.000196078431372549	8208	1
3	Food 2	Intake 4	163	33029	1337365544	/users/cn/jespinosa/phecomp/data/CRG/20120502_FDF_CRG/20120502_FDF_CRG/20120518_FDF_CRG_c12.mtb	3627	1922	WWSS	food_sc	4	32866	1337365381	1	0.06	0.000368098159509202	8209	1
3	Drink 1	Intake 1	18	33044	1337365559	/users/cn/jespinosa/phecomp/data/CRG/20120502_FDF_CRG/20120502_FDF_CRG/20120518_FDF_CRG_c12.mtb	1200	NA	WWSS	water	1	33026	1337365541	1	0.04	0.00222222222222222	8210	1
3	Drink 2	Intake 2	17	33067	1337365582	/users/cn/jespinosa/phecomp/data/CRG/20120502_FDF_CRG/20120502_FDF_CRG/20120518_FDF_CRG_c12.mtb	2710	NA	WWSS	water	2	33050	1337365565	1	0.02	0.00117647058823529	8211	1
3	Drink 1	Intake 1	15	33133	1337365648	/users/cn/jespinosa/phecomp/data/CRG/20120502_FDF_CRG/20120502_FDF_CRG/20120518_FDF_CRG_c12.mtb	1201	NA	WWSS	water	1	33118	1337365633	1	0.02	0.00133333333333333	8212	1
3	Drink 1	Intake 1	11	33171	1337365686	/users/cn/jespinosa/phecomp/data/CRG/20120502_FDF_CRG/20120502_FDF_CRG/20120518_FDF_CRG_c12.mtb	1202	NA	WWSS	water	1	33160	1337365675	1	0.02	0.00181818181818182	8213	1
3	Drink 1	Intake 1	12	34085	1337366600	/users/cn/jespinosa/phecomp/data/CRG/20120502_FDF_CRG/20120502_FDF_CRG/20120518_FDF_CRG_c12.mtb	1203	NA	WWSS	water	1	34073	1337366588	1	0.06	0.005	8214	1
3	Food 2	Intake 4	263	35214	1337367729	/users/cn/jespinosa/phecomp/data/CRG/20120502_FDF_CRG/20120502_FDF_CRG/20120518_FDF_CRG_c12.mtb	3629	431	WWSS	food_sc	4	34951	1337367466	1	0.1	0.000380228136882129	8215	1
3	Drink 2	Intake 2	34	35286	1337367801	/users/cn/jespinosa/phecomp/data/CRG/20120502_FDF_CRG/20120502_FDF_CRG/20120518_FDF_CRG_c12.mtb	2711	NA	WWSS	water	2	35252	1337367767	1	0.02	0.000588235294117647	8216	1
3	Drink 1	Intake 1	25	35384	1337367899	/users/cn/jespinosa/phecomp/data/CRG/20120502_FDF_CRG/20120502_FDF_CRG/20120518_FDF_CRG_c12.mtb	1205	NA	WWSS	water	1	35359	1337367874	1	0.06	0.0024	8217	1
3	Food 1	Intake 3	534	36179	1337368694	/users/cn/jespinosa/phecomp/data/CRG/20120502_FDF_CRG/20120502_FDF_CRG/20120518_FDF_CRG_c12.mtb	2179	1036	WWSS	food_sc	3	35645	1337368160	1	0.18	0.000337078651685393	8218	1
3	Drink 1	Intake 1	20	36207	1337368722	/users/cn/jespinosa/phecomp/data/CRG/20120502_FDF_CRG/20120502_FDF_CRG/20120518_FDF_CRG_c12.mtb	1206	NA	WWSS	water	1	36187	1337368702	1	0.08	0.004	8219	1
3	Drink 1	Intake 1	17	36278	1337368793	/users/cn/jespinosa/phecomp/data/CRG/20120502_FDF_CRG/20120502_FDF_CRG/20120518_FDF_CRG_c12.mtb	1207	NA	WWSS	water	1	36261	1337368776	1	0.08	0.00470588235294118	8220	1
3	Food 2	Intake 4	68	37283	1337369798	/users/cn/jespinosa/phecomp/data/CRG/20120502_FDF_CRG/20120502_FDF_CRG/20120518_FDF_CRG_c12.mtb	3632	6	WWSS	food_sc	4	37215	1337369730	1	0.02	0.000294117647058824	8221	1
3	Food 2	Intake 4	128	37417	1337369932	/users/cn/jespinosa/phecomp/data/CRG/20120502_FDF_CRG/20120502_FDF_CRG/20120518_FDF_CRG_c12.mtb	3633	749	WWSS	food_sc	4	37289	1337369804	1	0.02	0.00015625	8222	1
3	Drink 1	Intake 1	17	37927	1337370442	/users/cn/jespinosa/phecomp/data/CRG/20120502_FDF_CRG/20120502_FDF_CRG/20120518_FDF_CRG_c12.mtb	1209	NA	WWSS	water	1	37910	1337370425	1	0.02	0.00117647058823529	8223	1
3	Food 2	Intake 4	17	38183	1337370698	/users/cn/jespinosa/phecomp/data/CRG/20120502_FDF_CRG/20120502_FDF_CRG/20120518_FDF_CRG_c12.mtb	3634	1088	WWSS	food_sc	4	38166	1337370681	1	0.02	0.00117647058823529	8224	1
3	Drink 2	Intake 2	26	38251	1337370766	/users/cn/jespinosa/phecomp/data/CRG/20120502_FDF_CRG/20120502_FDF_CRG/20120518_FDF_CRG_c12.mtb	2713	NA	WWSS	water	2	38225	1337370740	1	0.02	0.000769230769230769	8225	1
3	Drink 1	Intake 1	14	38288	1337370803	/users/cn/jespinosa/phecomp/data/CRG/20120502_FDF_CRG/20120502_FDF_CRG/20120518_FDF_CRG_c12.mtb	1210	NA	WWSS	water	1	38274	1337370789	1	0.04	0.00285714285714286	8226	1
3	Food 1	Intake 3	329	39600	1337372115	/users/cn/jespinosa/phecomp/data/CRG/20120502_FDF_CRG/20120502_FDF_CRG/20120518_FDF_CRG_c12.mtb	2180	4	WWSS	food_sc	3	39271	1337371786	1	0.14	0.000425531914893617	8227	1
3	Food 1	Intake 3	240	39844	1337372359	/users/cn/jespinosa/phecomp/data/CRG/20120502_FDF_CRG/20120502_FDF_CRG/20120518_FDF_CRG_c12.mtb	2181	6	WWSS	food_sc	3	39604	1337372119	1	0.16	0.000666666666666667	8228	1
3	Food 1	Intake 3	80	39930	1337372445	/users/cn/jespinosa/phecomp/data/CRG/20120502_FDF_CRG/20120502_FDF_CRG/20120518_FDF_CRG_c12.mtb	2182	2261	WWSS	food_sc	3	39850	1337372365	1	0.04	0.0005	8229	1
3	Drink 2	Intake 2	19	39942	1337372457	/users/cn/jespinosa/phecomp/data/CRG/20120502_FDF_CRG/20120502_FDF_CRG/20120518_FDF_CRG_c12.mtb	2714	NA	WWSS	water	2	39923	1337372438	1	0.06	0.00315789473684211	8230	1
3	Drink 1	Intake 1	15	40009	1337372524	/users/cn/jespinosa/phecomp/data/CRG/20120502_FDF_CRG/20120502_FDF_CRG/20120518_FDF_CRG_c12.mtb	1211	NA	WWSS	water	1	39994	1337372509	1	0.0599999999999999	0.00399999999999999	8231	1
3	Drink 1	Intake 1	17	40112	1337372627	/users/cn/jespinosa/phecomp/data/CRG/20120502_FDF_CRG/20120502_FDF_CRG/20120518_FDF_CRG_c12.mtb	1213	NA	WWSS	water	1	40095	1337372610	1	0.04	0.00235294117647059	8232	1
3	Drink 2	Intake 2	23	40354	1337372869	/users/cn/jespinosa/phecomp/data/CRG/20120502_FDF_CRG/20120502_FDF_CRG/20120518_FDF_CRG_c12.mtb	2718	NA	WWSS	water	2	40331	1337372846	1	0.04	0.00173913043478261	8233	1
3	Food 1	Intake 3	197	42388	1337374903	/users/cn/jespinosa/phecomp/data/CRG/20120502_FDF_CRG/20120502_FDF_CRG/20120518_FDF_CRG_c12.mtb	2183	9	WWSS	food_sc	3	42191	1337374706	1	0.1	0.00050761421319797	8234	1
3	Food 1	Intake 3	152	42549	1337375064	/users/cn/jespinosa/phecomp/data/CRG/20120502_FDF_CRG/20120502_FDF_CRG/20120518_FDF_CRG_c12.mtb	2184	2013	WWSS	food_sc	3	42397	1337374912	1	0.12	0.000789473684210526	8235	1
3	Drink 2	Intake 2	15	42682	1337375197	/users/cn/jespinosa/phecomp/data/CRG/20120502_FDF_CRG/20120502_FDF_CRG/20120518_FDF_CRG_c12.mtb	2719	NA	WWSS	water	2	42667	1337375182	1	0.02	0.00133333333333333	8236	1
3	Drink 1	Intake 1	13	42715	1337375230	/users/cn/jespinosa/phecomp/data/CRG/20120502_FDF_CRG/20120502_FDF_CRG/20120518_FDF_CRG_c12.mtb	1214	NA	WWSS	water	1	42702	1337375217	1	0.0600000000000001	0.00461538461538462	8237	1
3	Drink 1	Intake 1	31	43365	1337375880	/users/cn/jespinosa/phecomp/data/CRG/20120502_FDF_CRG/20120502_FDF_CRG/20120518_FDF_CRG_c12.mtb	1215	NA	WWSS	water	1	43334	1337375849	1	0.0399999999999999	0.00129032258064516	8238	1
3	Drink 2	Intake 2	47	44315	1337376830	/users/cn/jespinosa/phecomp/data/CRG/20120502_FDF_CRG/20120502_FDF_CRG/20120518_FDF_CRG_c12.mtb	2721	NA	WWSS	water	2	44268	1337376783	1	0.02	0.000425531914893617	8239	1
3	Food 1	Intake 3	283	44845	1337377360	/users/cn/jespinosa/phecomp/data/CRG/20120502_FDF_CRG/20120502_FDF_CRG/20120518_FDF_CRG_c12.mtb	2187	3238	WWSS	food_sc	3	44562	1337377077	1	0.14	0.00049469964664311	8240	1
3	Drink 2	Intake 2	13	44865	1337377380	/users/cn/jespinosa/phecomp/data/CRG/20120502_FDF_CRG/20120502_FDF_CRG/20120518_FDF_CRG_c12.mtb	2722	NA	WWSS	water	2	44852	1337377367	1	0.04	0.00307692307692308	8241	1
3	Drink 1	Intake 1	12	45101	1337377616	/users/cn/jespinosa/phecomp/data/CRG/20120502_FDF_CRG/20120502_FDF_CRG/20120518_FDF_CRG_c12.mtb	1216	NA	WWSS	water	1	45089	1337377604	1	0.02	0.00166666666666667	8242	1
3	Drink 2	Intake 2	16	45187	1337377702	/users/cn/jespinosa/phecomp/data/CRG/20120502_FDF_CRG/20120502_FDF_CRG/20120518_FDF_CRG_c12.mtb	2723	NA	WWSS	water	2	45171	1337377686	1	0.04	0.0025	8243	1
3	Food 2	Intake 4	210	48293	1337380808	/users/cn/jespinosa/phecomp/data/CRG/20120502_FDF_CRG/20120502_FDF_CRG/20120518_FDF_CRG_c12.mtb	3644	10	WWSS	food_sc	4	48083	1337380598	1	0.08	0.000380952380952381	8244	1
3	Food 2	Intake 4	138	48441	1337380956	/users/cn/jespinosa/phecomp/data/CRG/20120502_FDF_CRG/20120502_FDF_CRG/20120518_FDF_CRG_c12.mtb	3645	752	WWSS	food_sc	4	48303	1337380818	1	0.0600000000000001	0.000434782608695653	8245	1
3	Drink 1	Intake 1	23	48964	1337381479	/users/cn/jespinosa/phecomp/data/CRG/20120502_FDF_CRG/20120502_FDF_CRG/20120518_FDF_CRG_c12.mtb	1217	NA	WWSS	water	1	48941	1337381456	1	0.0600000000000001	0.00260869565217392	8246	1
3	Drink 2	Intake 2	18	49037	1337381552	/users/cn/jespinosa/phecomp/data/CRG/20120502_FDF_CRG/20120502_FDF_CRG/20120518_FDF_CRG_c12.mtb	2724	NA	WWSS	water	2	49019	1337381534	1	0.02	0.00111111111111111	8247	1
3	Food 2	Intake 4	244	49437	1337381952	/users/cn/jespinosa/phecomp/data/CRG/20120502_FDF_CRG/20120502_FDF_CRG/20120518_FDF_CRG_c12.mtb	3649	1242	WWSS	food_sc	4	49193	1337381708	1	0.08	0.000327868852459016	8248	1
3	Drink 2	Intake 2	23	49460	1337381975	/users/cn/jespinosa/phecomp/data/CRG/20120502_FDF_CRG/20120502_FDF_CRG/20120518_FDF_CRG_c12.mtb	2725	NA	WWSS	water	2	49437	1337381952	1	0.06	0.00260869565217391	8249	1
3	Drink 2	Intake 2	17	49674	1337382189	/users/cn/jespinosa/phecomp/data/CRG/20120502_FDF_CRG/20120502_FDF_CRG/20120518_FDF_CRG_c12.mtb	2727	NA	WWSS	water	2	49657	1337382172	1	0.02	0.00117647058823529	8250	1
3	Drink 1	Intake 1	14	50513	1337383028	/users/cn/jespinosa/phecomp/data/CRG/20120502_FDF_CRG/20120502_FDF_CRG/20120518_FDF_CRG_c12.mtb	1219	NA	WWSS	water	1	50499	1337383014	1	0.0399999999999999	0.00285714285714285	8251	1
3	Food 2	Intake 4	339	51018	1337383533	/users/cn/jespinosa/phecomp/data/CRG/20120502_FDF_CRG/20120502_FDF_CRG/20120518_FDF_CRG_c12.mtb	3651	3957	WWSS	food_sc	4	50679	1337383194	1	0.1	0.000294985250737463	8252	1
3	Drink 1	Intake 1	20	51061	1337383576	/users/cn/jespinosa/phecomp/data/CRG/20120502_FDF_CRG/20120502_FDF_CRG/20120518_FDF_CRG_c12.mtb	1220	NA	WWSS	water	1	51041	1337383556	1	0.0600000000000001	0.00300000000000001	8253	1
3	Drink 1	Intake 1	18	51450	1337383965	/users/cn/jespinosa/phecomp/data/CRG/20120502_FDF_CRG/20120502_FDF_CRG/20120518_FDF_CRG_c12.mtb	1221	NA	WWSS	water	1	51432	1337383947	1	0.0599999999999999	0.00333333333333333	8254	1
3	Food 2	Intake 4	83	55058	1337387573	/users/cn/jespinosa/phecomp/data/CRG/20120502_FDF_CRG/20120502_FDF_CRG/20120518_FDF_CRG_c12.mtb	3657	163	WWSS	food_sc	4	54975	1337387490	1	0.02	0.000240963855421687	8255	1
3	Food 2	Intake 4	41	55262	1337387777	/users/cn/jespinosa/phecomp/data/CRG/20120502_FDF_CRG/20120502_FDF_CRG/20120518_FDF_CRG_c12.mtb	3659	COLL	WWSS	food_sc	4	55221	1337387736	1	0.02	0.00048780487804878	8256	1
3	Food 1	Intake 3	213	55464	1337387979	/users/cn/jespinosa/phecomp/data/CRG/20120502_FDF_CRG/20120502_FDF_CRG/20120518_FDF_CRG_c12.mtb	2193	354	WWSS	food_sc	3	55251	1337387766	1	0.0600000000000001	0.000281690140845071	8257	1
3	Food 1	Intake 3	272	56090	1337388605	/users/cn/jespinosa/phecomp/data/CRG/20120502_FDF_CRG/20120502_FDF_CRG/20120518_FDF_CRG_c12.mtb	2194	53	WWSS	food_sc	3	55818	1337388333	1	0.0600000000000001	0.000220588235294118	8258	1
3	Drink 2	Intake 2	24	56116	1337388631	/users/cn/jespinosa/phecomp/data/CRG/20120502_FDF_CRG/20120502_FDF_CRG/20120518_FDF_CRG_c12.mtb	2733	NA	WWSS	water	2	56092	1337388607	1	0.06	0.0025	8259	1
3	Food 2	Intake 4	297	56440	1337388955	/users/cn/jespinosa/phecomp/data/CRG/20120502_FDF_CRG/20120502_FDF_CRG/20120518_FDF_CRG_c12.mtb	3662	3823	WWSS	food_sc	4	56143	1337388658	1	0.0600000000000001	0.000202020202020202	8260	1
3	Drink 1	Intake 1	20	56530	1337389045	/users/cn/jespinosa/phecomp/data/CRG/20120502_FDF_CRG/20120502_FDF_CRG/20120518_FDF_CRG_c12.mtb	1223	NA	WWSS	water	1	56510	1337389025	1	0.0800000000000001	0.00400000000000001	8261	1
3	Drink 1	Intake 1	17	57642	1337390157	/users/cn/jespinosa/phecomp/data/CRG/20120502_FDF_CRG/20120502_FDF_CRG/20120518_FDF_CRG_c12.mtb	1224	NA	WWSS	water	1	57625	1337390140	1	0.0600000000000001	0.00352941176470589	8262	1
3	Food 2	Intake 4	115	60378	1337392893	/users/cn/jespinosa/phecomp/data/CRG/20120502_FDF_CRG/20120502_FDF_CRG/20120518_FDF_CRG_c12.mtb	3666	107	WWSS	food_sc	4	60263	1337392778	1	0.02	0.000173913043478261	8263	1
3	Food 2	Intake 4	459	60944	1337393459	/users/cn/jespinosa/phecomp/data/CRG/20120502_FDF_CRG/20120502_FDF_CRG/20120518_FDF_CRG_c12.mtb	3667	58	WWSS	food_sc	4	60485	1337393000	1	0.0999999999999999	0.000217864923747276	8264	1
3	Food 2	Intake 4	283	61285	1337393800	/users/cn/jespinosa/phecomp/data/CRG/20120502_FDF_CRG/20120502_FDF_CRG/20120518_FDF_CRG_c12.mtb	3668	6473	WWSS	food_sc	4	61002	1337393517	1	0.1	0.000353356890459364	8265	1
3	Drink 1	Intake 1	26	61310	1337393825	/users/cn/jespinosa/phecomp/data/CRG/20120502_FDF_CRG/20120502_FDF_CRG/20120518_FDF_CRG_c12.mtb	1225	NA	WWSS	water	1	61284	1337393799	1	0.0999999999999999	0.00384615384615384	8266	1
3	Drink 1	Intake 1	15	61461	1337393976	/users/cn/jespinosa/phecomp/data/CRG/20120502_FDF_CRG/20120502_FDF_CRG/20120518_FDF_CRG_c12.mtb	1226	NA	WWSS	water	1	61446	1337393961	1	0.04	0.00266666666666667	8267	1
3	Drink 1	Intake 1	19	61925	1337394440	/users/cn/jespinosa/phecomp/data/CRG/20120502_FDF_CRG/20120502_FDF_CRG/20120518_FDF_CRG_c12.mtb	1227	NA	WWSS	water	1	61906	1337394421	1	0.04	0.00210526315789474	8268	1
3	Food 1	Intake 3	390	68148	1337400663	/users/cn/jespinosa/phecomp/data/CRG/20120502_FDF_CRG/20120502_FDF_CRG/20120518_FDF_CRG_c12.mtb	2196	3708	WWSS	food_sc	3	67758	1337400273	1	0.18	0.000461538461538462	8269	1
3	Drink 2	Intake 2	21	68229	1337400744	/users/cn/jespinosa/phecomp/data/CRG/20120502_FDF_CRG/20120502_FDF_CRG/20120518_FDF_CRG_c12.mtb	2734	NA	WWSS	water	2	68208	1337400723	1	0.0600000000000001	0.00285714285714286	8270	1
3	Drink 2	Intake 2	19	68550	1337401065	/users/cn/jespinosa/phecomp/data/CRG/20120502_FDF_CRG/20120502_FDF_CRG/20120518_FDF_CRG_c12.mtb	2735	NA	WWSS	water	2	68531	1337401046	1	0.0399999999999999	0.00210526315789473	8271	1
3	Drink 1	Intake 1	21	69040	1337401555	/users/cn/jespinosa/phecomp/data/CRG/20120502_FDF_CRG/20120502_FDF_CRG/20120518_FDF_CRG_c12.mtb	1228	NA	WWSS	water	1	69019	1337401534	1	0.0999999999999999	0.00476190476190476	8272	1
3	Food 1	Intake 3	66	71922	1337404437	/users/cn/jespinosa/phecomp/data/CRG/20120502_FDF_CRG/20120502_FDF_CRG/20120518_FDF_CRG_c12.mtb	2198	1220	WWSS	food_sc	3	71856	1337404371	1	0.04	0.000606060606060606	8273	1
3	Food 2	Intake 4	194	73336	1337405851	/users/cn/jespinosa/phecomp/data/CRG/20120502_FDF_CRG/20120502_FDF_CRG/20120518_FDF_CRG_c12.mtb	3674	776	WWSS	food_sc	4	73142	1337405657	1	0.0799999999999998	0.000412371134020617	8274	1
3	Drink 1	Intake 1	17	73661	1337406176	/users/cn/jespinosa/phecomp/data/CRG/20120502_FDF_CRG/20120502_FDF_CRG/20120518_FDF_CRG_c12.mtb	1230	NA	WWSS	water	1	73644	1337406159	1	0.0800000000000001	0.00470588235294118	8275	1
3	Drink 2	Intake 2	19	74003	1337406518	/users/cn/jespinosa/phecomp/data/CRG/20120502_FDF_CRG/20120502_FDF_CRG/20120518_FDF_CRG_c12.mtb	2736	NA	WWSS	water	2	73984	1337406499	1	0.04	0.00210526315789474	8276	1
3	Food 1	Intake 3	154	74266	1337406781	/users/cn/jespinosa/phecomp/data/CRG/20120502_FDF_CRG/20120502_FDF_CRG/20120518_FDF_CRG_c12.mtb	2200	65	WWSS	food_sc	3	74112	1337406627	1	0.02	0.00012987012987013	8277	1
3	Food 2	Intake 4	144	74475	1337406990	/users/cn/jespinosa/phecomp/data/CRG/20120502_FDF_CRG/20120502_FDF_CRG/20120518_FDF_CRG_c12.mtb	3676	6574	WWSS	food_sc	4	74331	1337406846	1	0.04	0.000277777777777778	8278	1
3	Drink 1	Intake 1	18	74524	1337407039	/users/cn/jespinosa/phecomp/data/CRG/20120502_FDF_CRG/20120502_FDF_CRG/20120518_FDF_CRG_c12.mtb	1231	NA	WWSS	water	1	74506	1337407021	1	0.02	0.00111111111111111	8279	1
3	Drink 2	Intake 2	16	74693	1337407208	/users/cn/jespinosa/phecomp/data/CRG/20120502_FDF_CRG/20120502_FDF_CRG/20120518_FDF_CRG_c12.mtb	2737	NA	WWSS	water	2	74677	1337407192	1	0.02	0.00125	8280	1
3	Drink 1	Intake 1	22	75450	1337407965	/users/cn/jespinosa/phecomp/data/CRG/20120502_FDF_CRG/20120502_FDF_CRG/20120518_FDF_CRG_c12.mtb	1232	NA	WWSS	water	1	75428	1337407943	1	0.0600000000000001	0.00272727272727273	8281	1
3	Food 2	Intake 4	78	81127	1337413642	/users/cn/jespinosa/phecomp/data/CRG/20120502_FDF_CRG/20120502_FDF_CRG/20120518_FDF_CRG_c12.mtb	3682	10652	WWSS	food_sc	4	81049	1337413564	1	0.02	0.000256410256410256	8282	1
3	Drink 1	Intake 1	13	81193	1337413708	/users/cn/jespinosa/phecomp/data/CRG/20120502_FDF_CRG/20120502_FDF_CRG/20120518_FDF_CRG_c12.mtb	1233	NA	WWSS	water	1	81180	1337413695	1	0.04	0.00307692307692308	8283	1
3	Food 1	Intake 3	71	91850	1337424365	/users/cn/jespinosa/phecomp/data/CRG/20120502_FDF_CRG/20120502_FDF_CRG/20120518_FDF_CRG_c12.mtb	2209	24432	WWSS	food_sc	3	91779	1337424294	1	0.02	0.00028169014084507	8284	1
3	Drink 2	Intake 2	18	96210	1337428725	/users/cn/jespinosa/phecomp/data/CRG/20120502_FDF_CRG/20120502_FDF_CRG/20120518_FDF_CRG_c12.mtb	2738	NA	WWSS	water	2	96192	1337428707	1	0.02	0.00111111111111111	8285	1
3	Food 1	Intake 3	570	116852	1337449367	/users/cn/jespinosa/phecomp/data/CRG/20120502_FDF_CRG/20120502_FDF_CRG/20120518_FDF_CRG_c12.mtb	2211	2117	WWSS	food_sc	3	116282	1337448797	1	0.18	0.000315789473684211	8286	1
3	Drink 1	Intake 1	14	117062	1337449577	/users/cn/jespinosa/phecomp/data/CRG/20120502_FDF_CRG/20120502_FDF_CRG/20120518_FDF_CRG_c12.mtb	1237	NA	WWSS	water	1	117048	1337449563	1	0.0800000000000001	0.00571428571428572	8287	1
3	Food 2	Intake 4	139	119108	1337451623	/users/cn/jespinosa/phecomp/data/CRG/20120502_FDF_CRG/20120502_FDF_CRG/20120518_FDF_CRG_c12.mtb	3688	44	WWSS	food_sc	4	118969	1337451484	1	0.04	0.000287769784172662	8288	1
3	Drink 2	Intake 2	12	119113	1337451628	/users/cn/jespinosa/phecomp/data/CRG/20120502_FDF_CRG/20120502_FDF_CRG/20120518_FDF_CRG_c12.mtb	2743	NA	WWSS	water	2	119101	1337451616	1	0.0399999999999999	0.00333333333333332	8289	1
3	Food 2	Intake 4	244	119396	1337451911	/users/cn/jespinosa/phecomp/data/CRG/20120502_FDF_CRG/20120502_FDF_CRG/20120518_FDF_CRG_c12.mtb	3689	48	WWSS	food_sc	4	119152	1337451667	1	0.0800000000000001	0.000327868852459017	8290	1
3	Drink 2	Intake 2	19	119405	1337451920	/users/cn/jespinosa/phecomp/data/CRG/20120502_FDF_CRG/20120502_FDF_CRG/20120518_FDF_CRG_c12.mtb	2744	NA	WWSS	water	2	119386	1337451901	1	0.04	0.00210526315789474	8291	1
3	Food 2	Intake 4	61	119505	1337452020	/users/cn/jespinosa/phecomp/data/CRG/20120502_FDF_CRG/20120502_FDF_CRG/20120518_FDF_CRG_c12.mtb	3690	249	WWSS	food_sc	4	119444	1337451959	1	0.02	0.000327868852459016	8292	1
3	Drink 2	Intake 2	20	119648	1337452163	/users/cn/jespinosa/phecomp/data/CRG/20120502_FDF_CRG/20120502_FDF_CRG/20120518_FDF_CRG_c12.mtb	2745	NA	WWSS	water	2	119628	1337452143	1	0.0600000000000001	0.00300000000000001	8293	1
3	Food 2	Intake 4	207	119961	1337452476	/users/cn/jespinosa/phecomp/data/CRG/20120502_FDF_CRG/20120502_FDF_CRG/20120518_FDF_CRG_c12.mtb	3691	1257	WWSS	food_sc	4	119754	1337452269	1	0.0600000000000001	0.000289855072463769	8294	1
3	Drink 1	Intake 1	15	120157	1337452672	/users/cn/jespinosa/phecomp/data/CRG/20120502_FDF_CRG/20120502_FDF_CRG/20120518_FDF_CRG_c12.mtb	1239	NA	WWSS	water	1	120142	1337452657	1	0.0599999999999998	0.00399999999999999	8295	1
3	Drink 1	Intake 1	15	121145	1337453660	/users/cn/jespinosa/phecomp/data/CRG/20120502_FDF_CRG/20120502_FDF_CRG/20120518_FDF_CRG_c12.mtb	1240	NA	WWSS	water	1	121130	1337453645	1	0.04	0.00266666666666667	8296	1
3	Food 2	Intake 4	357	121575	1337454090	/users/cn/jespinosa/phecomp/data/CRG/20120502_FDF_CRG/20120502_FDF_CRG/20120518_FDF_CRG_c12.mtb	3692	314	WWSS	food_sc	4	121218	1337453733	1	0.14	0.000392156862745098	8297	1
3	Drink 2	Intake 2	15	121590	1337454105	/users/cn/jespinosa/phecomp/data/CRG/20120502_FDF_CRG/20120502_FDF_CRG/20120518_FDF_CRG_c12.mtb	2746	NA	WWSS	water	2	121575	1337454090	1	0.0399999999999999	0.00266666666666666	8298	1
3	Drink 1	Intake 1	15	121705	1337454220	/users/cn/jespinosa/phecomp/data/CRG/20120502_FDF_CRG/20120502_FDF_CRG/20120518_FDF_CRG_c12.mtb	1241	NA	WWSS	water	1	121690	1337454205	1	0.0599999999999998	0.00399999999999999	8299	1
3	Food 1	Intake 3	17	121906	1337454421	/users/cn/jespinosa/phecomp/data/CRG/20120502_FDF_CRG/20120502_FDF_CRG/20120518_FDF_CRG_c12.mtb	2214	118	WWSS	food_sc	3	121889	1337454404	1	0.02	0.00117647058823529	8300	1
3	Food 2	Intake 4	154	122178	1337454693	/users/cn/jespinosa/phecomp/data/CRG/20120502_FDF_CRG/20120502_FDF_CRG/20120518_FDF_CRG_c12.mtb	3694	1289	WWSS	food_sc	4	122024	1337454539	1	0.0399999999999998	0.000259740259740258	8301	1
3	Drink 2	Intake 2	31	122399	1337454914	/users/cn/jespinosa/phecomp/data/CRG/20120502_FDF_CRG/20120502_FDF_CRG/20120518_FDF_CRG_c12.mtb	2747	NA	WWSS	water	2	122368	1337454883	1	0.0800000000000001	0.00258064516129033	8302	1
3	Food 1	Intake 3	437	123904	1337456419	/users/cn/jespinosa/phecomp/data/CRG/20120502_FDF_CRG/20120502_FDF_CRG/20120518_FDF_CRG_c12.mtb	2215	2683	WWSS	food_sc	3	123467	1337455982	1	0.18	0.000411899313501144	8303	1
3	Drink 2	Intake 2	18	123918	1337456433	/users/cn/jespinosa/phecomp/data/CRG/20120502_FDF_CRG/20120502_FDF_CRG/20120518_FDF_CRG_c12.mtb	2748	NA	WWSS	water	2	123900	1337456415	1	0.0599999999999999	0.00333333333333333	8304	1
3	Drink 1	Intake 1	15	124053	1337456568	/users/cn/jespinosa/phecomp/data/CRG/20120502_FDF_CRG/20120502_FDF_CRG/20120518_FDF_CRG_c12.mtb	1242	NA	WWSS	water	1	124038	1337456553	1	0.0600000000000001	0.00400000000000001	8305	1
3	Drink 1	Intake 1	12	124885	1337457400	/users/cn/jespinosa/phecomp/data/CRG/20120502_FDF_CRG/20120502_FDF_CRG/20120518_FDF_CRG_c12.mtb	1243	NA	WWSS	water	1	124873	1337457388	1	0.02	0.00166666666666667	8306	1
3	Food 1	Intake 3	523	127110	1337459625	/users/cn/jespinosa/phecomp/data/CRG/20120502_FDF_CRG/20120502_FDF_CRG/20120518_FDF_CRG_c12.mtb	2217	109	WWSS	food_sc	3	126587	1337459102	1	0.24	0.000458891013384321	8307	1
3	Drink 1	Intake 1	14	127163	1337459678	/users/cn/jespinosa/phecomp/data/CRG/20120502_FDF_CRG/20120502_FDF_CRG/20120518_FDF_CRG_c12.mtb	1244	NA	WWSS	water	1	127149	1337459664	1	0.04	0.00285714285714286	8308	1
3	Food 1	Intake 3	84	127303	1337459818	/users/cn/jespinosa/phecomp/data/CRG/20120502_FDF_CRG/20120502_FDF_CRG/20120518_FDF_CRG_c12.mtb	2219	449	WWSS	food_sc	3	127219	1337459734	1	0.02	0.000238095238095238	8309	1
3	Drink 2	Intake 2	20	127401	1337459916	/users/cn/jespinosa/phecomp/data/CRG/20120502_FDF_CRG/20120502_FDF_CRG/20120518_FDF_CRG_c12.mtb	2750	NA	WWSS	water	2	127381	1337459896	1	0.0600000000000001	0.00300000000000001	8310	1
3	Drink 2	Intake 2	17	127710	1337460225	/users/cn/jespinosa/phecomp/data/CRG/20120502_FDF_CRG/20120502_FDF_CRG/20120518_FDF_CRG_c12.mtb	2752	NA	WWSS	water	2	127693	1337460208	1	0.04	0.00235294117647059	8311	1
3	Food 1	Intake 3	147	127899	1337460414	/users/cn/jespinosa/phecomp/data/CRG/20120502_FDF_CRG/20120502_FDF_CRG/20120518_FDF_CRG_c12.mtb	2220	2892	WWSS	food_sc	3	127752	1337460267	1	0.1	0.000680272108843537	8312	1
3	Drink 1	Intake 1	18	127922	1337460437	/users/cn/jespinosa/phecomp/data/CRG/20120502_FDF_CRG/20120502_FDF_CRG/20120518_FDF_CRG_c12.mtb	1245	NA	WWSS	water	1	127904	1337460419	1	0.04	0.00222222222222222	8313	1
3	Drink 2	Intake 2	59	127998	1337460513	/users/cn/jespinosa/phecomp/data/CRG/20120502_FDF_CRG/20120502_FDF_CRG/20120518_FDF_CRG_c12.mtb	2753	NA	WWSS	water	2	127939	1337460454	1	0.04	0.000677966101694915	8314	1
3	Drink 1	Intake 1	15	128274	1337460789	/users/cn/jespinosa/phecomp/data/CRG/20120502_FDF_CRG/20120502_FDF_CRG/20120518_FDF_CRG_c12.mtb	1246	NA	WWSS	water	1	128259	1337460774	1	0.04	0.00266666666666667	8315	1
3	Drink 1	Intake 1	15	128580	1337461095	/users/cn/jespinosa/phecomp/data/CRG/20120502_FDF_CRG/20120502_FDF_CRG/20120518_FDF_CRG_c12.mtb	1247	NA	WWSS	water	1	128565	1337461080	1	0.02	0.00133333333333333	8316	1
3	Drink 2	Intake 2	23	129105	1337461620	/users/cn/jespinosa/phecomp/data/CRG/20120502_FDF_CRG/20120502_FDF_CRG/20120518_FDF_CRG_c12.mtb	2756	NA	WWSS	water	2	129082	1337461597	1	0.0399999999999998	0.0017391304347826	8317	1
3	Food 1	Intake 3	506	131297	1337463812	/users/cn/jespinosa/phecomp/data/CRG/20120502_FDF_CRG/20120502_FDF_CRG/20120518_FDF_CRG_c12.mtb	2222	2082	WWSS	food_sc	3	130791	1337463306	1	0.14	0.000276679841897233	8318	1
3	Drink 1	Intake 1	17	131341	1337463856	/users/cn/jespinosa/phecomp/data/CRG/20120502_FDF_CRG/20120502_FDF_CRG/20120518_FDF_CRG_c12.mtb	1248	NA	WWSS	water	1	131324	1337463839	1	0.02	0.00117647058823529	8319	1
3	Drink 1	Intake 1	15	131375	1337463890	/users/cn/jespinosa/phecomp/data/CRG/20120502_FDF_CRG/20120502_FDF_CRG/20120518_FDF_CRG_c12.mtb	1249	NA	WWSS	water	1	131360	1337463875	1	0.04	0.00266666666666667	8320	1
3	Food 1	Intake 3	17	133396	1337465911	/users/cn/jespinosa/phecomp/data/CRG/20120502_FDF_CRG/20120502_FDF_CRG/20120518_FDF_CRG_c12.mtb	2223	71	WWSS	food_sc	3	133379	1337465894	1	0.0200000000000005	0.00117647058823532	8321	1
3	Food 2	Intake 4	214	133681	1337466196	/users/cn/jespinosa/phecomp/data/CRG/20120502_FDF_CRG/20120502_FDF_CRG/20120518_FDF_CRG_c12.mtb	3713	18	WWSS	food_sc	4	133467	1337465982	1	0.02	9.34579439252336e-05	8322	1
3	Food 2	Intake 4	198	133897	1337466412	/users/cn/jespinosa/phecomp/data/CRG/20120502_FDF_CRG/20120502_FDF_CRG/20120518_FDF_CRG_c12.mtb	3714	94	WWSS	food_sc	4	133699	1337466214	1	0.0600000000000001	0.000303030303030304	8323	1
3	Drink 2	Intake 2	28	133926	1337466441	/users/cn/jespinosa/phecomp/data/CRG/20120502_FDF_CRG/20120502_FDF_CRG/20120518_FDF_CRG_c12.mtb	2757	NA	WWSS	water	2	133898	1337466413	1	0.04	0.00142857142857143	8324	1
3	Drink 1	Intake 1	20	133979	1337466494	/users/cn/jespinosa/phecomp/data/CRG/20120502_FDF_CRG/20120502_FDF_CRG/20120518_FDF_CRG_c12.mtb	1250	NA	WWSS	water	1	133959	1337466474	1	0.0600000000000001	0.00300000000000001	8325	1
3	Food 2	Intake 4	18	134009	1337466524	/users/cn/jespinosa/phecomp/data/CRG/20120502_FDF_CRG/20120502_FDF_CRG/20120518_FDF_CRG_c12.mtb	3715	16	WWSS	food_sc	4	133991	1337466506	1	0.02	0.00111111111111111	8326	1
3	Food 2	Intake 4	161	134186	1337466701	/users/cn/jespinosa/phecomp/data/CRG/20120502_FDF_CRG/20120502_FDF_CRG/20120518_FDF_CRG_c12.mtb	3716	19	WWSS	food_sc	4	134025	1337466540	1	0.02	0.000124223602484472	8327	1
3	Food 2	Intake 4	79	134284	1337466799	/users/cn/jespinosa/phecomp/data/CRG/20120502_FDF_CRG/20120502_FDF_CRG/20120518_FDF_CRG_c12.mtb	3717	1114	WWSS	food_sc	4	134205	1337466720	1	0.02	0.000253164556962025	8328	1
3	Drink 2	Intake 2	29	134309	1337466824	/users/cn/jespinosa/phecomp/data/CRG/20120502_FDF_CRG/20120502_FDF_CRG/20120518_FDF_CRG_c12.mtb	2758	NA	WWSS	water	2	134280	1337466795	1	0.02	0.000689655172413793	8329	1
3	Drink 2	Intake 2	22	134380	1337466895	/users/cn/jespinosa/phecomp/data/CRG/20120502_FDF_CRG/20120502_FDF_CRG/20120518_FDF_CRG_c12.mtb	2759	NA	WWSS	water	2	134358	1337466873	1	0.02	0.000909090909090909	8330	1
3	Drink 2	Intake 2	15	134748	1337467263	/users/cn/jespinosa/phecomp/data/CRG/20120502_FDF_CRG/20120502_FDF_CRG/20120518_FDF_CRG_c12.mtb	2760	NA	WWSS	water	2	134733	1337467248	1	0.02	0.00133333333333333	8331	1
3	Drink 1	Intake 1	18	135342	1337467857	/users/cn/jespinosa/phecomp/data/CRG/20120502_FDF_CRG/20120502_FDF_CRG/20120518_FDF_CRG_c12.mtb	1251	NA	WWSS	water	1	135324	1337467839	1	0.04	0.00222222222222222	8332	1
3	Food 1	Intake 3	274	135672	1337468187	/users/cn/jespinosa/phecomp/data/CRG/20120502_FDF_CRG/20120502_FDF_CRG/20120518_FDF_CRG_c12.mtb	2225	103	WWSS	food_sc	3	135398	1337467913	1	0.0799999999999996	0.000291970802919707	8333	1
3	Drink 1	Intake 1	17	135688	1337468203	/users/cn/jespinosa/phecomp/data/CRG/20120502_FDF_CRG/20120502_FDF_CRG/20120518_FDF_CRG_c12.mtb	1252	NA	WWSS	water	1	135671	1337468186	1	0.04	0.00235294117647059	8334	1
3	Food 2	Intake 4	73	135848	1337468363	/users/cn/jespinosa/phecomp/data/CRG/20120502_FDF_CRG/20120502_FDF_CRG/20120518_FDF_CRG_c12.mtb	3720	193	WWSS	food_sc	4	135775	1337468290	1	0.02	0.000273972602739726	8335	1
3	Food 2	Intake 4	201	136242	1337468757	/users/cn/jespinosa/phecomp/data/CRG/20120502_FDF_CRG/20120502_FDF_CRG/20120518_FDF_CRG_c12.mtb	3722	605	WWSS	food_sc	4	136041	1337468556	1	0.0800000000000001	0.000398009950248757	8336	1
3	Drink 2	Intake 2	23	136264	1337468779	/users/cn/jespinosa/phecomp/data/CRG/20120502_FDF_CRG/20120502_FDF_CRG/20120518_FDF_CRG_c12.mtb	2764	NA	WWSS	water	2	136241	1337468756	1	0.0600000000000001	0.00260869565217392	8337	1
3	Drink 2	Intake 2	9	136808	1337469323	/users/cn/jespinosa/phecomp/data/CRG/20120502_FDF_CRG/20120502_FDF_CRG/20120518_FDF_CRG_c12.mtb	2765	NA	WWSS	water	2	136799	1337469314	1	0.02	0.00222222222222222	8338	1
3	Food 2	Intake 4	169	137016	1337469531	/users/cn/jespinosa/phecomp/data/CRG/20120502_FDF_CRG/20120502_FDF_CRG/20120518_FDF_CRG_c12.mtb	3723	736	WWSS	food_sc	4	136847	1337469362	1	0.02	0.000118343195266272	8339	1
3	Drink 1	Intake 1	14	137298	1337469813	/users/cn/jespinosa/phecomp/data/CRG/20120502_FDF_CRG/20120502_FDF_CRG/20120518_FDF_CRG_c12.mtb	1254	NA	WWSS	water	1	137284	1337469799	1	0.04	0.00285714285714286	8340	1
3	Food 2	Intake 4	297	138049	1337470564	/users/cn/jespinosa/phecomp/data/CRG/20120502_FDF_CRG/20120502_FDF_CRG/20120518_FDF_CRG_c12.mtb	3724	4562	WWSS	food_sc	4	137752	1337470267	1	0.1	0.000336700336700337	8341	1
3	Drink 1	Intake 1	21	138086	1337470601	/users/cn/jespinosa/phecomp/data/CRG/20120502_FDF_CRG/20120502_FDF_CRG/20120518_FDF_CRG_c12.mtb	1255	NA	WWSS	water	1	138065	1337470580	1	0.0599999999999996	0.00285714285714284	8342	1
3	Food 2	Intake 4	131	142742	1337475257	/users/cn/jespinosa/phecomp/data/CRG/20120502_FDF_CRG/20120502_FDF_CRG/20120518_FDF_CRG_c12.mtb	3728	86	WWSS	food_sc	4	142611	1337475126	1	0.02	0.000152671755725191	8343	1
3	Food 2	Intake 4	260	143088	1337475603	/users/cn/jespinosa/phecomp/data/CRG/20120502_FDF_CRG/20120502_FDF_CRG/20120518_FDF_CRG_c12.mtb	3729	6	WWSS	food_sc	4	142828	1337475343	1	0.0800000000000001	0.000307692307692308	8344	1
3	Food 2	Intake 4	251	143345	1337475860	/users/cn/jespinosa/phecomp/data/CRG/20120502_FDF_CRG/20120502_FDF_CRG/20120518_FDF_CRG_c12.mtb	3730	5112	WWSS	food_sc	4	143094	1337475609	1	0.12	0.00047808764940239	8345	1
3	Drink 1	Intake 1	31	143386	1337475901	/users/cn/jespinosa/phecomp/data/CRG/20120502_FDF_CRG/20120502_FDF_CRG/20120518_FDF_CRG_c12.mtb	1256	NA	WWSS	water	1	143355	1337475870	1	0.1	0.0032258064516129	8346	1
3	Drink 2	Intake 2	25	143571	1337476086	/users/cn/jespinosa/phecomp/data/CRG/20120502_FDF_CRG/20120502_FDF_CRG/20120518_FDF_CRG_c12.mtb	2768	NA	WWSS	water	2	143546	1337476061	1	0.02	0.0008	8347	1
3	Drink 1	Intake 1	28	143751	1337476266	/users/cn/jespinosa/phecomp/data/CRG/20120502_FDF_CRG/20120502_FDF_CRG/20120518_FDF_CRG_c12.mtb	1258	NA	WWSS	water	1	143723	1337476238	1	0.02	0.000714285714285714	8348	1
3	Drink 1	Intake 1	14	143975	1337476490	/users/cn/jespinosa/phecomp/data/CRG/20120502_FDF_CRG/20120502_FDF_CRG/20120518_FDF_CRG_c12.mtb	1259	NA	WWSS	water	1	143961	1337476476	1	0.02	0.00142857142857143	8349	1
3	Drink 1	Intake 1	22	144525	1337477040	/users/cn/jespinosa/phecomp/data/CRG/20120502_FDF_CRG/20120502_FDF_CRG/20120518_FDF_CRG_c12.mtb	1260	NA	WWSS	water	1	144503	1337477018	1	0.02	0.000909090909090909	8350	1
3	Food 2	Intake 4	121	148578	1337481093	/users/cn/jespinosa/phecomp/data/CRG/20120502_FDF_CRG/20120502_FDF_CRG/20120518_FDF_CRG_c12.mtb	3736	55	WWSS	food_sc	4	148457	1337480972	1	0.02	0.000165289256198347	8351	1
3	Food 2	Intake 4	262	148895	1337481410	/users/cn/jespinosa/phecomp/data/CRG/20120502_FDF_CRG/20120502_FDF_CRG/20120518_FDF_CRG_c12.mtb	3737	246	WWSS	food_sc	4	148633	1337481148	1	0.1	0.000381679389312977	8352	1
3	Drink 1	Intake 1	19	148936	1337481451	/users/cn/jespinosa/phecomp/data/CRG/20120502_FDF_CRG/20120502_FDF_CRG/20120518_FDF_CRG_c12.mtb	1261	NA	WWSS	water	1	148917	1337481432	1	0.02	0.00105263157894737	8353	1
3	Food 2	Intake 4	148	149289	1337481804	/users/cn/jespinosa/phecomp/data/CRG/20120502_FDF_CRG/20120502_FDF_CRG/20120518_FDF_CRG_c12.mtb	3738	34	WWSS	food_sc	4	149141	1337481656	1	0.02	0.000135135135135135	8354	1
3	Drink 2	Intake 2	23	149319	1337481834	/users/cn/jespinosa/phecomp/data/CRG/20120502_FDF_CRG/20120502_FDF_CRG/20120518_FDF_CRG_c12.mtb	2780	NA	WWSS	water	2	149296	1337481811	1	0.0600000000000001	0.00260869565217392	8355	1
3	Food 2	Intake 4	72	149395	1337481910	/users/cn/jespinosa/phecomp/data/CRG/20120502_FDF_CRG/20120502_FDF_CRG/20120518_FDF_CRG_c12.mtb	3739	5347	WWSS	food_sc	4	149323	1337481838	1	0.04	0.000555555555555556	8356	1
3	Drink 1	Intake 1	15	149524	1337482039	/users/cn/jespinosa/phecomp/data/CRG/20120502_FDF_CRG/20120502_FDF_CRG/20120518_FDF_CRG_c12.mtb	1263	NA	WWSS	water	1	149509	1337482024	1	0.0600000000000001	0.00400000000000001	8357	1
3	Drink 1	Intake 1	17	149658	1337482173	/users/cn/jespinosa/phecomp/data/CRG/20120502_FDF_CRG/20120502_FDF_CRG/20120518_FDF_CRG_c12.mtb	1264	NA	WWSS	water	1	149641	1337482156	1	0.02	0.00117647058823529	8358	1
3	Drink 1	Intake 1	11	150159	1337482674	/users/cn/jespinosa/phecomp/data/CRG/20120502_FDF_CRG/20120502_FDF_CRG/20120518_FDF_CRG_c12.mtb	1265	NA	WWSS	water	1	150148	1337482663	1	0.02	0.00181818181818182	8359	1
3	Food 2	Intake 4	18	154760	1337487275	/users/cn/jespinosa/phecomp/data/CRG/20120502_FDF_CRG/20120502_FDF_CRG/20120518_FDF_CRG_c12.mtb	3744	634	WWSS	food_sc	4	154742	1337487257	1	0.02	0.00111111111111111	8360	1
3	Food 2	Intake 4	96	155490	1337488005	/users/cn/jespinosa/phecomp/data/CRG/20120502_FDF_CRG/20120502_FDF_CRG/20120518_FDF_CRG_c12.mtb	3749	13	WWSS	food_sc	4	155394	1337487909	1	0.02	0.000208333333333333	8361	1
3	Food 2	Intake 4	163	155666	1337488181	/users/cn/jespinosa/phecomp/data/CRG/20120502_FDF_CRG/20120502_FDF_CRG/20120518_FDF_CRG_c12.mtb	3750	115	WWSS	food_sc	4	155503	1337488018	1	0.02	0.000122699386503067	8362	1
3	Drink 2	Intake 2	17	155770	1337488285	/users/cn/jespinosa/phecomp/data/CRG/20120502_FDF_CRG/20120502_FDF_CRG/20120518_FDF_CRG_c12.mtb	2782	NA	WWSS	water	2	155753	1337488268	1	0.02	0.00117647058823529	8363	1
3	Food 2	Intake 4	387	156168	1337488683	/users/cn/jespinosa/phecomp/data/CRG/20120502_FDF_CRG/20120502_FDF_CRG/20120518_FDF_CRG_c12.mtb	3752	2941	WWSS	food_sc	4	155781	1337488296	1	0.16	0.00041343669250646	8364	1
3	Drink 1	Intake 1	47	156209	1337488724	/users/cn/jespinosa/phecomp/data/CRG/20120502_FDF_CRG/20120502_FDF_CRG/20120518_FDF_CRG_c12.mtb	1268	NA	WWSS	water	1	156162	1337488677	1	0.16	0.00340425531914894	8365	1
3	Drink 1	Intake 1	20	156273	1337488788	/users/cn/jespinosa/phecomp/data/CRG/20120502_FDF_CRG/20120502_FDF_CRG/20120518_FDF_CRG_c12.mtb	1269	NA	WWSS	water	1	156253	1337488768	1	0.0599999999999996	0.00299999999999998	8366	1
3	Drink 1	Intake 1	17	158139	1337490654	/users/cn/jespinosa/phecomp/data/CRG/20120502_FDF_CRG/20120502_FDF_CRG/20120518_FDF_CRG_c12.mtb	1270	NA	WWSS	water	1	158122	1337490637	1	0.04	0.00235294117647059	8367	1
3	Food 1	Intake 3	17	159126	1337491641	/users/cn/jespinosa/phecomp/data/CRG/20120502_FDF_CRG/20120502_FDF_CRG/20120518_FDF_CRG_c12.mtb	2236	423	WWSS	food_sc	3	159109	1337491624	1	0.02	0.00117647058823529	8368	1
3	Food 2	Intake 4	66	159615	1337492130	/users/cn/jespinosa/phecomp/data/CRG/20120502_FDF_CRG/20120502_FDF_CRG/20120518_FDF_CRG_c12.mtb	3757	44	WWSS	food_sc	4	159549	1337492064	1	0.02	0.000303030303030303	8369	1
3	Food 2	Intake 4	222	159881	1337492396	/users/cn/jespinosa/phecomp/data/CRG/20120502_FDF_CRG/20120502_FDF_CRG/20120518_FDF_CRG_c12.mtb	3758	32	WWSS	food_sc	4	159659	1337492174	1	0.0800000000000001	0.000360360360360361	8370	1
3	Drink 1	Intake 1	19	159914	1337492429	/users/cn/jespinosa/phecomp/data/CRG/20120502_FDF_CRG/20120502_FDF_CRG/20120518_FDF_CRG_c12.mtb	1271	NA	WWSS	water	1	159895	1337492410	1	0.02	0.00105263157894737	8371	1
3	Food 2	Intake 4	129	160042	1337492557	/users/cn/jespinosa/phecomp/data/CRG/20120502_FDF_CRG/20120502_FDF_CRG/20120518_FDF_CRG_c12.mtb	3759	54	WWSS	food_sc	4	159913	1337492428	1	0.0600000000000001	0.000465116279069768	8372	1
3	Food 2	Intake 4	182	160278	1337492793	/users/cn/jespinosa/phecomp/data/CRG/20120502_FDF_CRG/20120502_FDF_CRG/20120518_FDF_CRG_c12.mtb	3760	766	WWSS	food_sc	4	160096	1337492611	1	0.04	0.00021978021978022	8373	1
3	Drink 2	Intake 2	23	160336	1337492851	/users/cn/jespinosa/phecomp/data/CRG/20120502_FDF_CRG/20120502_FDF_CRG/20120518_FDF_CRG_c12.mtb	2785	NA	WWSS	water	2	160313	1337492828	1	0.0600000000000001	0.00260869565217392	8374	1
3	Drink 2	Intake 2	18	160529	1337493044	/users/cn/jespinosa/phecomp/data/CRG/20120502_FDF_CRG/20120502_FDF_CRG/20120518_FDF_CRG_c12.mtb	2786	NA	WWSS	water	2	160511	1337493026	1	0.04	0.00222222222222222	8375	1
3	Food 1	Intake 3	125	161169	1337493684	/users/cn/jespinosa/phecomp/data/CRG/20120502_FDF_CRG/20120502_FDF_CRG/20120518_FDF_CRG_c12.mtb	2240	48	WWSS	food_sc	3	161044	1337493559	1	0.02	0.00016	8376	1
3	Drink 2	Intake 2	22	161210	1337493725	/users/cn/jespinosa/phecomp/data/CRG/20120502_FDF_CRG/20120502_FDF_CRG/20120518_FDF_CRG_c12.mtb	2787	NA	WWSS	water	2	161188	1337493703	1	0.02	0.000909090909090909	8377	1
3	Food 2	Intake 4	137	161354	1337493869	/users/cn/jespinosa/phecomp/data/CRG/20120502_FDF_CRG/20120502_FDF_CRG/20120518_FDF_CRG_c12.mtb	3765	3501	WWSS	food_sc	4	161217	1337493732	1	0.02	0.000145985401459854	8378	1
3	Drink 2	Intake 2	16	161382	1337493897	/users/cn/jespinosa/phecomp/data/CRG/20120502_FDF_CRG/20120502_FDF_CRG/20120518_FDF_CRG_c12.mtb	2788	NA	WWSS	water	2	161366	1337493881	1	0.04	0.0025	8379	1
3	Drink 1	Intake 1	18	161533	1337494048	/users/cn/jespinosa/phecomp/data/CRG/20120502_FDF_CRG/20120502_FDF_CRG/20120518_FDF_CRG_c12.mtb	1273	NA	WWSS	water	1	161515	1337494030	1	0.04	0.00222222222222222	8380	1
3	Food 2	Intake 4	270	165125	1337497640	/users/cn/jespinosa/phecomp/data/CRG/20120502_FDF_CRG/20120502_FDF_CRG/20120518_FDF_CRG_c12.mtb	3767	25942	WWSS	food_sc	4	164855	1337497370	1	0.0800000000000001	0.000296296296296297	8381	1
3	Drink 1	Intake 1	23	177234	1337509749	/users/cn/jespinosa/phecomp/data/CRG/20120502_FDF_CRG/20120502_FDF_CRG/20120518_FDF_CRG_c12.mtb	1274	NA	WWSS	water	1	177211	1337509726	1	0.0600000000000001	0.00260869565217392	8382	1
3	Food 2	Intake 4	30	191097	1337523612	/users/cn/jespinosa/phecomp/data/CRG/20120502_FDF_CRG/20120502_FDF_CRG/20120518_FDF_CRG_c12.mtb	3769	11964	WWSS	food_sc	4	191067	1337523582	1	0.02	0.000666666666666667	8383	1
3	Food 1	Intake 3	78	203139	1337535654	/users/cn/jespinosa/phecomp/data/CRG/20120502_FDF_CRG/20120502_FDF_CRG/20120518_FDF_CRG_c12.mtb	2245	55	WWSS	food_sc	3	203061	1337535576	1	0.02	0.000256410256410256	8384	1
3	Food 2	Intake 4	76	203270	1337535785	/users/cn/jespinosa/phecomp/data/CRG/20120502_FDF_CRG/20120502_FDF_CRG/20120518_FDF_CRG_c12.mtb	3771	1778	WWSS	food_sc	4	203194	1337535709	1	0.02	0.000263157894736842	8385	1
3	Food 2	Intake 4	79	205127	1337537642	/users/cn/jespinosa/phecomp/data/CRG/20120502_FDF_CRG/20120502_FDF_CRG/20120518_FDF_CRG_c12.mtb	3773	6	WWSS	food_sc	4	205048	1337537563	1	0.02	0.000253164556962025	8386	1
3	Food 2	Intake 4	160	205293	1337537808	/users/cn/jespinosa/phecomp/data/CRG/20120502_FDF_CRG/20120502_FDF_CRG/20120518_FDF_CRG_c12.mtb	3774	40	WWSS	food_sc	4	205133	1337537648	1	0.02	0.000125	8387	1
3	Food 2	Intake 4	201	205534	1337538049	/users/cn/jespinosa/phecomp/data/CRG/20120502_FDF_CRG/20120502_FDF_CRG/20120518_FDF_CRG_c12.mtb	3775	130	WWSS	food_sc	4	205333	1337537848	1	0.0600000000000001	0.000298507462686568	8388	1
3	Drink 1	Intake 1	10	205543	1337538058	/users/cn/jespinosa/phecomp/data/CRG/20120502_FDF_CRG/20120502_FDF_CRG/20120518_FDF_CRG_c12.mtb	1277	NA	WWSS	water	1	205533	1337538048	1	0.02	0.002	8389	1
3	Drink 1	Intake 1	16	205581	1337538096	/users/cn/jespinosa/phecomp/data/CRG/20120502_FDF_CRG/20120502_FDF_CRG/20120518_FDF_CRG_c12.mtb	1278	NA	WWSS	water	1	205565	1337538080	1	0.02	0.00125	8390	1
3	Food 1	Intake 3	181	205845	1337538360	/users/cn/jespinosa/phecomp/data/CRG/20120502_FDF_CRG/20120502_FDF_CRG/20120518_FDF_CRG_c12.mtb	2249	1074	WWSS	food_sc	3	205664	1337538179	1	0.0800000000000001	0.000441988950276244	8391	1
3	Drink 1	Intake 1	22	205876	1337538391	/users/cn/jespinosa/phecomp/data/CRG/20120502_FDF_CRG/20120502_FDF_CRG/20120518_FDF_CRG_c12.mtb	1279	NA	WWSS	water	1	205854	1337538369	1	0.0600000000000001	0.00272727272727273	8392	1
3	Drink 1	Intake 1	17	205897	1337538412	/users/cn/jespinosa/phecomp/data/CRG/20120502_FDF_CRG/20120502_FDF_CRG/20120518_FDF_CRG_c12.mtb	1280	NA	WWSS	water	1	205880	1337538395	1	0.02	0.00117647058823529	8393	1
3	Drink 1	Intake 1	12	206291	1337538806	/users/cn/jespinosa/phecomp/data/CRG/20120502_FDF_CRG/20120502_FDF_CRG/20120518_FDF_CRG_c12.mtb	1281	NA	WWSS	water	1	206279	1337538794	1	0.04	0.00333333333333333	8394	1
3	Food 1	Intake 3	353	207272	1337539787	/users/cn/jespinosa/phecomp/data/CRG/20120502_FDF_CRG/20120502_FDF_CRG/20120518_FDF_CRG_c12.mtb	2251	1034	WWSS	food_sc	3	206919	1337539434	1	0.0600000000000001	0.000169971671388102	8395	1
3	Drink 2	Intake 2	25	207307	1337539822	/users/cn/jespinosa/phecomp/data/CRG/20120502_FDF_CRG/20120502_FDF_CRG/20120518_FDF_CRG_c12.mtb	2793	NA	WWSS	water	2	207282	1337539797	1	0.0799999999999998	0.00319999999999999	8396	1
3	Drink 1	Intake 1	33	207772	1337540287	/users/cn/jespinosa/phecomp/data/CRG/20120502_FDF_CRG/20120502_FDF_CRG/20120518_FDF_CRG_c12.mtb	1282	NA	WWSS	water	1	207739	1337540254	1	0.04	0.00121212121212121	8397	1
3	Food 1	Intake 3	655	208961	1337541476	/users/cn/jespinosa/phecomp/data/CRG/20120502_FDF_CRG/20120502_FDF_CRG/20120518_FDF_CRG_c12.mtb	2253	1101	WWSS	food_sc	3	208306	1337540821	1	0.32	0.000488549618320611	8398	1
3	Drink 1	Intake 1	22	208983	1337541498	/users/cn/jespinosa/phecomp/data/CRG/20120502_FDF_CRG/20120502_FDF_CRG/20120518_FDF_CRG_c12.mtb	1283	NA	WWSS	water	1	208961	1337541476	1	0.0999999999999996	0.00454545454545453	8399	1
3	Drink 2	Intake 2	32	209046	1337541561	/users/cn/jespinosa/phecomp/data/CRG/20120502_FDF_CRG/20120502_FDF_CRG/20120518_FDF_CRG_c12.mtb	2794	NA	WWSS	water	2	209014	1337541529	1	0.04	0.00125	8400	1
3	Drink 1	Intake 1	16	209131	1337541646	/users/cn/jespinosa/phecomp/data/CRG/20120502_FDF_CRG/20120502_FDF_CRG/20120518_FDF_CRG_c12.mtb	1284	NA	WWSS	water	1	209115	1337541630	1	0.02	0.00125	8401	1
3	Drink 2	Intake 2	24	209293	1337541808	/users/cn/jespinosa/phecomp/data/CRG/20120502_FDF_CRG/20120502_FDF_CRG/20120518_FDF_CRG_c12.mtb	2795	NA	WWSS	water	2	209269	1337541784	1	0.0600000000000001	0.0025	8402	1
3	Drink 1	Intake 1	14	209672	1337542187	/users/cn/jespinosa/phecomp/data/CRG/20120502_FDF_CRG/20120502_FDF_CRG/20120518_FDF_CRG_c12.mtb	1286	NA	WWSS	water	1	209658	1337542173	1	0.04	0.00285714285714286	8403	1
3	Food 1	Intake 3	264	210326	1337542841	/users/cn/jespinosa/phecomp/data/CRG/20120502_FDF_CRG/20120502_FDF_CRG/20120518_FDF_CRG_c12.mtb	2256	1494	WWSS	food_sc	3	210062	1337542577	1	0.14	0.00053030303030303	8404	1
3	Drink 1	Intake 1	21	210563	1337543078	/users/cn/jespinosa/phecomp/data/CRG/20120502_FDF_CRG/20120502_FDF_CRG/20120518_FDF_CRG_c12.mtb	1287	NA	WWSS	water	1	210542	1337543057	1	0.0600000000000001	0.00285714285714286	8405	1
3	Food 1	Intake 3	204	212024	1337544539	/users/cn/jespinosa/phecomp/data/CRG/20120502_FDF_CRG/20120502_FDF_CRG/20120518_FDF_CRG_c12.mtb	2257	2276	WWSS	food_sc	3	211820	1337544335	1	0.12	0.000588235294117647	8406	1
3	Drink 1	Intake 1	18	212563	1337545078	/users/cn/jespinosa/phecomp/data/CRG/20120502_FDF_CRG/20120502_FDF_CRG/20120518_FDF_CRG_c12.mtb	1288	NA	WWSS	water	1	212545	1337545060	1	0.0800000000000001	0.00444444444444445	8407	1
3	Food 1	Intake 3	201	214501	1337547016	/users/cn/jespinosa/phecomp/data/CRG/20120502_FDF_CRG/20120502_FDF_CRG/20120518_FDF_CRG_c12.mtb	2258	653	WWSS	food_sc	3	214300	1337546815	1	0.1	0.000497512437810945	8408	1
3	Drink 1	Intake 1	17	214800	1337547315	/users/cn/jespinosa/phecomp/data/CRG/20120502_FDF_CRG/20120502_FDF_CRG/20120518_FDF_CRG_c12.mtb	1289	NA	WWSS	water	1	214783	1337547298	1	0.02	0.00117647058823529	8409	1
3	Drink 1	Intake 1	11	215030	1337547545	/users/cn/jespinosa/phecomp/data/CRG/20120502_FDF_CRG/20120502_FDF_CRG/20120518_FDF_CRG_c12.mtb	1290	NA	WWSS	water	1	215019	1337547534	1	0.04	0.00363636363636364	8410	1
3	Food 1	Intake 3	38	215192	1337547707	/users/cn/jespinosa/phecomp/data/CRG/20120502_FDF_CRG/20120502_FDF_CRG/20120518_FDF_CRG_c12.mtb	2260	1193	WWSS	food_sc	3	215154	1337547669	1	0.26	0.0068421052631579	8411	1
3	Drink 1	Intake 1	13	215572	1337548087	/users/cn/jespinosa/phecomp/data/CRG/20120502_FDF_CRG/20120502_FDF_CRG/20120518_FDF_CRG_c12.mtb	1291	NA	WWSS	water	1	215559	1337548074	1	0.0600000000000001	0.00461538461538462	8412	1
3	Drink 2	Intake 2	23	215960	1337548475	/users/cn/jespinosa/phecomp/data/CRG/20120502_FDF_CRG/20120502_FDF_CRG/20120518_FDF_CRG_c12.mtb	2796	NA	WWSS	water	2	215937	1337548452	1	0.0399999999999998	0.0017391304347826	8413	1
3	Food 1	Intake 3	54	216439	1337548954	/users/cn/jespinosa/phecomp/data/CRG/20120502_FDF_CRG/20120502_FDF_CRG/20120518_FDF_CRG_c12.mtb	2261	1692	WWSS	food_sc	3	216385	1337548900	1	0.02	0.00037037037037037	8414	1
3	Drink 1	Intake 1	23	216459	1337548974	/users/cn/jespinosa/phecomp/data/CRG/20120502_FDF_CRG/20120502_FDF_CRG/20120518_FDF_CRG_c12.mtb	1293	NA	WWSS	water	1	216436	1337548951	1	0.0600000000000001	0.00260869565217392	8415	1
3	Drink 2	Intake 2	27	216847	1337549362	/users/cn/jespinosa/phecomp/data/CRG/20120502_FDF_CRG/20120502_FDF_CRG/20120518_FDF_CRG_c12.mtb	2798	NA	WWSS	water	2	216820	1337549335	1	0.0800000000000001	0.00296296296296297	8416	1
3	Drink 2	Intake 2	29	217747	1337550262	/users/cn/jespinosa/phecomp/data/CRG/20120502_FDF_CRG/20120502_FDF_CRG/20120518_FDF_CRG_c12.mtb	2800	NA	WWSS	water	2	217718	1337550233	1	0.0800000000000001	0.00275862068965518	8417	1
3	Food 2	Intake 4	253	218384	1337550899	/users/cn/jespinosa/phecomp/data/CRG/20120502_FDF_CRG/20120502_FDF_CRG/20120518_FDF_CRG_c12.mtb	3804	419	WWSS	food_sc	4	218131	1337550646	1	0.0200000000000005	7.90513833992115e-05	8418	1
3	Drink 1	Intake 1	18	218616	1337551131	/users/cn/jespinosa/phecomp/data/CRG/20120502_FDF_CRG/20120502_FDF_CRG/20120518_FDF_CRG_c12.mtb	1294	NA	WWSS	water	1	218598	1337551113	1	0.0600000000000001	0.00333333333333334	8419	1
3	Food 2	Intake 4	268	219071	1337551586	/users/cn/jespinosa/phecomp/data/CRG/20120502_FDF_CRG/20120502_FDF_CRG/20120518_FDF_CRG_c12.mtb	3809	1873	WWSS	food_sc	4	218803	1337551318	1	0.0599999999999996	0.000223880597014924	8420	1
3	Drink 1	Intake 1	15	219630	1337552145	/users/cn/jespinosa/phecomp/data/CRG/20120502_FDF_CRG/20120502_FDF_CRG/20120518_FDF_CRG_c12.mtb	1295	NA	WWSS	water	1	219615	1337552130	1	0.04	0.00266666666666667	8421	1
3	Food 1	Intake 3	212	221156	1337553671	/users/cn/jespinosa/phecomp/data/CRG/20120502_FDF_CRG/20120502_FDF_CRG/20120518_FDF_CRG_c12.mtb	2266	374	WWSS	food_sc	3	220944	1337553459	1	0.0600000000000001	0.000283018867924529	8422	1
3	Drink 2	Intake 2	20	221521	1337554036	/users/cn/jespinosa/phecomp/data/CRG/20120502_FDF_CRG/20120502_FDF_CRG/20120518_FDF_CRG_c12.mtb	2802	NA	WWSS	water	2	221501	1337554016	1	0.02	0.001	8423	1
3	Food 2	Intake 4	133	221663	1337554178	/users/cn/jespinosa/phecomp/data/CRG/20120502_FDF_CRG/20120502_FDF_CRG/20120518_FDF_CRG_c12.mtb	3813	9	WWSS	food_sc	4	221530	1337554045	1	0.02	0.000150375939849624	8424	1
3	Food 2	Intake 4	133	221805	1337554320	/users/cn/jespinosa/phecomp/data/CRG/20120502_FDF_CRG/20120502_FDF_CRG/20120518_FDF_CRG_c12.mtb	3814	136	WWSS	food_sc	4	221672	1337554187	1	0.04	0.000300751879699248	8425	1
3	Drink 2	Intake 2	15	221820	1337554335	/users/cn/jespinosa/phecomp/data/CRG/20120502_FDF_CRG/20120502_FDF_CRG/20120518_FDF_CRG_c12.mtb	2803	NA	WWSS	water	2	221805	1337554320	1	0.02	0.00133333333333333	8426	1
3	Food 2	Intake 4	211	222152	1337554667	/users/cn/jespinosa/phecomp/data/CRG/20120502_FDF_CRG/20120502_FDF_CRG/20120518_FDF_CRG_c12.mtb	3816	184	WWSS	food_sc	4	221941	1337554456	1	0.0600000000000001	0.00028436018957346	8427	1
3	Drink 2	Intake 2	25	222166	1337554681	/users/cn/jespinosa/phecomp/data/CRG/20120502_FDF_CRG/20120502_FDF_CRG/20120518_FDF_CRG_c12.mtb	2804	NA	WWSS	water	2	222141	1337554656	1	0.0800000000000001	0.0032	8428	1
3	Food 2	Intake 4	125	222461	1337554976	/users/cn/jespinosa/phecomp/data/CRG/20120502_FDF_CRG/20120502_FDF_CRG/20120518_FDF_CRG_c12.mtb	3819	402	WWSS	food_sc	4	222336	1337554851	1	0.02	0.00016	8429	1
3	Drink 2	Intake 2	22	222478	1337554993	/users/cn/jespinosa/phecomp/data/CRG/20120502_FDF_CRG/20120502_FDF_CRG/20120518_FDF_CRG_c12.mtb	2805	NA	WWSS	water	2	222456	1337554971	1	0.0600000000000001	0.00272727272727273	8430	1
3	Drink 2	Intake 2	16	222645	1337555160	/users/cn/jespinosa/phecomp/data/CRG/20120502_FDF_CRG/20120502_FDF_CRG/20120518_FDF_CRG_c12.mtb	2806	NA	WWSS	water	2	222629	1337555144	1	0.02	0.00125	8431	1
3	Food 2	Intake 4	50	222913	1337555428	/users/cn/jespinosa/phecomp/data/CRG/20120502_FDF_CRG/20120502_FDF_CRG/20120518_FDF_CRG_c12.mtb	3822	17	WWSS	food_sc	4	222863	1337555378	1	0.02	0.0004	8432	1
3	Food 1	Intake 3	66	222996	1337555511	/users/cn/jespinosa/phecomp/data/CRG/20120502_FDF_CRG/20120502_FDF_CRG/20120518_FDF_CRG_c12.mtb	2268	431	WWSS	food_sc	3	222930	1337555445	1	0.02	0.000303030303030303	8433	1
3	Drink 1	Intake 1	17	223208	1337555723	/users/cn/jespinosa/phecomp/data/CRG/20120502_FDF_CRG/20120502_FDF_CRG/20120518_FDF_CRG_c12.mtb	1299	NA	WWSS	water	1	223191	1337555706	1	0.04	0.00235294117647059	8434	1
3	Food 2	Intake 4	102	223529	1337556044	/users/cn/jespinosa/phecomp/data/CRG/20120502_FDF_CRG/20120502_FDF_CRG/20120518_FDF_CRG_c12.mtb	3825	587	WWSS	food_sc	4	223427	1337555942	1	0.02	0.000196078431372549	8435	1
3	Drink 2	Intake 2	18	224109	1337556624	/users/cn/jespinosa/phecomp/data/CRG/20120502_FDF_CRG/20120502_FDF_CRG/20120518_FDF_CRG_c12.mtb	2807	NA	WWSS	water	2	224091	1337556606	1	0.04	0.00222222222222222	8436	1
3	Food 2	Intake 4	169	224285	1337556800	/users/cn/jespinosa/phecomp/data/CRG/20120502_FDF_CRG/20120502_FDF_CRG/20120518_FDF_CRG_c12.mtb	3828	174	WWSS	food_sc	4	224116	1337556631	1	0.02	0.000118343195266272	8437	1
3	Food 2	Intake 4	52	224511	1337557026	/users/cn/jespinosa/phecomp/data/CRG/20120502_FDF_CRG/20120502_FDF_CRG/20120518_FDF_CRG_c12.mtb	3831	363	WWSS	food_sc	4	224459	1337556974	1	0.02	0.000384615384615385	8438	1
3	Food 2	Intake 4	237	225111	1337557626	/users/cn/jespinosa/phecomp/data/CRG/20120502_FDF_CRG/20120502_FDF_CRG/20120518_FDF_CRG_c12.mtb	3832	180	WWSS	food_sc	4	224874	1337557389	1	0.02	8.43881856540084e-05	8439	1
3	Drink 1	Intake 1	15	225235	1337557750	/users/cn/jespinosa/phecomp/data/CRG/20120502_FDF_CRG/20120502_FDF_CRG/20120518_FDF_CRG_c12.mtb	1301	NA	WWSS	water	1	225220	1337557735	1	0.02	0.00133333333333333	8440	1
3	Food 1	Intake 3	117	225408	1337557923	/users/cn/jespinosa/phecomp/data/CRG/20120502_FDF_CRG/20120502_FDF_CRG/20120518_FDF_CRG_c12.mtb	2274	1894	WWSS	food_sc	3	225291	1337557806	1	0.02	0.000170940170940171	8441	1
3	Drink 1	Intake 1	11	225491	1337558006	/users/cn/jespinosa/phecomp/data/CRG/20120502_FDF_CRG/20120502_FDF_CRG/20120518_FDF_CRG_c12.mtb	1302	NA	WWSS	water	1	225480	1337557995	1	0.02	0.00181818181818182	8442	1
3	Food 1	Intake 3	111	227413	1337559928	/users/cn/jespinosa/phecomp/data/CRG/20120502_FDF_CRG/20120502_FDF_CRG/20120518_FDF_CRG_c12.mtb	2275	602	WWSS	food_sc	3	227302	1337559817	1	0.02	0.00018018018018018	8443	1
3	Food 1	Intake 3	158	228173	1337560688	/users/cn/jespinosa/phecomp/data/CRG/20120502_FDF_CRG/20120502_FDF_CRG/20120518_FDF_CRG_c12.mtb	2277	53	WWSS	food_sc	3	228015	1337560530	1	0.02	0.000126582278481013	8444	1
3	Food 1	Intake 3	343	228569	1337561084	/users/cn/jespinosa/phecomp/data/CRG/20120502_FDF_CRG/20120502_FDF_CRG/20120518_FDF_CRG_c12.mtb	2278	479	WWSS	food_sc	3	228226	1337560741	1	0.0799999999999996	0.000233236151603497	8445	1
3	Drink 2	Intake 2	23	228583	1337561098	/users/cn/jespinosa/phecomp/data/CRG/20120502_FDF_CRG/20120502_FDF_CRG/20120518_FDF_CRG_c12.mtb	2810	NA	WWSS	water	2	228560	1337561075	1	0.04	0.00173913043478261	8446	1
3	Drink 2	Intake 2	18	228623	1337561138	/users/cn/jespinosa/phecomp/data/CRG/20120502_FDF_CRG/20120502_FDF_CRG/20120518_FDF_CRG_c12.mtb	2811	NA	WWSS	water	2	228605	1337561120	1	0.02	0.00111111111111111	8447	1
3	Drink 1	Intake 1	12	228989	1337561504	/users/cn/jespinosa/phecomp/data/CRG/20120502_FDF_CRG/20120502_FDF_CRG/20120518_FDF_CRG_c12.mtb	1303	NA	WWSS	water	1	228977	1337561492	1	0.02	0.00166666666666667	8448	1
3	Food 1	Intake 3	205	229253	1337561768	/users/cn/jespinosa/phecomp/data/CRG/20120502_FDF_CRG/20120502_FDF_CRG/20120518_FDF_CRG_c12.mtb	2282	6908	WWSS	food_sc	3	229048	1337561563	1	0.04	0.000195121951219512	8449	1
3	Drink 2	Intake 2	19	229333	1337561848	/users/cn/jespinosa/phecomp/data/CRG/20120502_FDF_CRG/20120502_FDF_CRG/20120518_FDF_CRG_c12.mtb	2812	NA	WWSS	water	2	229314	1337561829	1	0.04	0.00210526315789474	8450	1
3	Food 2	Intake 4	349	236510	1337569025	/users/cn/jespinosa/phecomp/data/CRG/20120502_FDF_CRG/20120502_FDF_CRG/20120518_FDF_CRG_c12.mtb	3850	13	WWSS	food_sc	4	236161	1337568676	1	0.16	0.000458452722063037	8451	1
3	Food 2	Intake 4	150	236673	1337569188	/users/cn/jespinosa/phecomp/data/CRG/20120502_FDF_CRG/20120502_FDF_CRG/20120518_FDF_CRG_c12.mtb	3851	90	WWSS	food_sc	4	236523	1337569038	1	0.0799999999999996	0.000533333333333331	8452	1
3	Drink 2	Intake 2	25	236692	1337569207	/users/cn/jespinosa/phecomp/data/CRG/20120502_FDF_CRG/20120502_FDF_CRG/20120518_FDF_CRG_c12.mtb	2813	NA	WWSS	water	2	236667	1337569182	1	0.0800000000000001	0.0032	8453	1
3	Drink 1	Intake 1	15	236720	1337569235	/users/cn/jespinosa/phecomp/data/CRG/20120502_FDF_CRG/20120502_FDF_CRG/20120518_FDF_CRG_c12.mtb	1304	NA	WWSS	water	1	236705	1337569220	1	0.02	0.00133333333333333	8454	1
3	Food 2	Intake 4	23	236786	1337569301	/users/cn/jespinosa/phecomp/data/CRG/20120502_FDF_CRG/20120502_FDF_CRG/20120518_FDF_CRG_c12.mtb	3852	3948	WWSS	food_sc	4	236763	1337569278	1	0.02	0.000869565217391304	8455	1
3	Drink 2	Intake 2	16	236817	1337569332	/users/cn/jespinosa/phecomp/data/CRG/20120502_FDF_CRG/20120502_FDF_CRG/20120518_FDF_CRG_c12.mtb	2814	NA	WWSS	water	2	236801	1337569316	1	0.04	0.0025	8456	1
3	Drink 2	Intake 2	18	236954	1337569469	/users/cn/jespinosa/phecomp/data/CRG/20120502_FDF_CRG/20120502_FDF_CRG/20120518_FDF_CRG_c12.mtb	2815	NA	WWSS	water	2	236936	1337569451	1	0.04	0.00222222222222222	8457	1
3	Drink 1	Intake 1	9	237245	1337569760	/users/cn/jespinosa/phecomp/data/CRG/20120502_FDF_CRG/20120502_FDF_CRG/20120518_FDF_CRG_c12.mtb	1305	NA	WWSS	water	1	237236	1337569751	1	0.04	0.00444444444444444	8458	1
3	Drink 2	Intake 2	17	238101	1337570616	/users/cn/jespinosa/phecomp/data/CRG/20120502_FDF_CRG/20120502_FDF_CRG/20120518_FDF_CRG_c12.mtb	2816	NA	WWSS	water	2	238084	1337570599	1	0.02	0.00117647058823529	8459	1
3	Food 2	Intake 4	534	241268	1337573783	/users/cn/jespinosa/phecomp/data/CRG/20120502_FDF_CRG/20120502_FDF_CRG/20120518_FDF_CRG_c12.mtb	3859	3813	WWSS	food_sc	4	240734	1337573249	1	0.18	0.000337078651685393	8460	1
3	Drink 1	Intake 1	20	241285	1337573800	/users/cn/jespinosa/phecomp/data/CRG/20120502_FDF_CRG/20120502_FDF_CRG/20120518_FDF_CRG_c12.mtb	1306	NA	WWSS	water	1	241265	1337573780	1	0.04	0.002	8461	1
3	Drink 2	Intake 2	15	241325	1337573840	/users/cn/jespinosa/phecomp/data/CRG/20120502_FDF_CRG/20120502_FDF_CRG/20120518_FDF_CRG_c12.mtb	2817	NA	WWSS	water	2	241310	1337573825	1	0.02	0.00133333333333333	8462	1
3	Drink 2	Intake 2	17	241509	1337574024	/users/cn/jespinosa/phecomp/data/CRG/20120502_FDF_CRG/20120502_FDF_CRG/20120518_FDF_CRG_c12.mtb	2818	NA	WWSS	water	2	241492	1337574007	1	0.02	0.00117647058823529	8463	1
3	Drink 2	Intake 2	22	241621	1337574136	/users/cn/jespinosa/phecomp/data/CRG/20120502_FDF_CRG/20120502_FDF_CRG/20120518_FDF_CRG_c12.mtb	2819	NA	WWSS	water	2	241599	1337574114	1	0.0600000000000001	0.00272727272727273	8464	1
3	Food 2	Intake 4	26	245107	1337577622	/users/cn/jespinosa/phecomp/data/CRG/20120502_FDF_CRG/20120502_FDF_CRG/20120518_FDF_CRG_c12.mtb	3863	358	WWSS	food_sc	4	245081	1337577596	1	0.0200000000000005	0.000769230769230788	8465	1
3	Food 1	Intake 3	657	246122	1337578637	/users/cn/jespinosa/phecomp/data/CRG/20120502_FDF_CRG/20120502_FDF_CRG/20120518_FDF_CRG_c12.mtb	2294	174	WWSS	food_sc	3	245465	1337577980	1	0.18	0.000273972602739726	8466	1
3	Drink 2	Intake 2	27	246140	1337578655	/users/cn/jespinosa/phecomp/data/CRG/20120502_FDF_CRG/20120502_FDF_CRG/20120518_FDF_CRG_c12.mtb	2820	NA	WWSS	water	2	246113	1337578628	1	0.0799999999999996	0.00296296296296295	8467	1
3	Drink 2	Intake 2	23	246238	1337578753	/users/cn/jespinosa/phecomp/data/CRG/20120502_FDF_CRG/20120502_FDF_CRG/20120518_FDF_CRG_c12.mtb	2821	NA	WWSS	water	2	246215	1337578730	1	0.0600000000000005	0.00260869565217393	8468	1
3	Food 1	Intake 3	152	246448	1337578963	/users/cn/jespinosa/phecomp/data/CRG/20120502_FDF_CRG/20120502_FDF_CRG/20120518_FDF_CRG_c12.mtb	2296	75	WWSS	food_sc	3	246296	1337578811	1	0.0399999999999996	0.000263157894736839	8469	1
3	Drink 2	Intake 2	18	246466	1337578981	/users/cn/jespinosa/phecomp/data/CRG/20120502_FDF_CRG/20120502_FDF_CRG/20120518_FDF_CRG_c12.mtb	2822	NA	WWSS	water	2	246448	1337578963	1	0.0599999999999996	0.00333333333333331	8470	1
3	Food 1	Intake 3	147	246670	1337579185	/users/cn/jespinosa/phecomp/data/CRG/20120502_FDF_CRG/20120502_FDF_CRG/20120518_FDF_CRG_c12.mtb	2298	690	WWSS	food_sc	3	246523	1337579038	1	0.04	0.000272108843537415	8471	1
3	Drink 2	Intake 2	15	246771	1337579286	/users/cn/jespinosa/phecomp/data/CRG/20120502_FDF_CRG/20120502_FDF_CRG/20120518_FDF_CRG_c12.mtb	2823	NA	WWSS	water	2	246756	1337579271	1	0.02	0.00133333333333333	8472	1
3	Drink 1	Intake 1	18	246828	1337579343	/users/cn/jespinosa/phecomp/data/CRG/20120502_FDF_CRG/20120502_FDF_CRG/20120518_FDF_CRG_c12.mtb	1309	NA	WWSS	water	1	246810	1337579325	1	0.0200000000000005	0.00111111111111114	8473	1
3	Food 1	Intake 3	96	247456	1337579971	/users/cn/jespinosa/phecomp/data/CRG/20120502_FDF_CRG/20120502_FDF_CRG/20120518_FDF_CRG_c12.mtb	2302	5765	WWSS	food_sc	3	247360	1337579875	1	0.0200000000000005	0.000208333333333339	8474	1
3	Drink 2	Intake 2	28	247572	1337580087	/users/cn/jespinosa/phecomp/data/CRG/20120502_FDF_CRG/20120502_FDF_CRG/20120518_FDF_CRG_c12.mtb	2824	NA	WWSS	water	2	247544	1337580059	1	0.02	0.000714285714285714	8475	1
3	Drink 2	Intake 2	19	247687	1337580202	/users/cn/jespinosa/phecomp/data/CRG/20120502_FDF_CRG/20120502_FDF_CRG/20120518_FDF_CRG_c12.mtb	2825	NA	WWSS	water	2	247668	1337580183	1	0.02	0.00105263157894737	8476	1
3	Drink 1	Intake 1	16	248351	1337580866	/users/cn/jespinosa/phecomp/data/CRG/20120502_FDF_CRG/20120502_FDF_CRG/20120518_FDF_CRG_c12.mtb	1311	NA	WWSS	water	1	248335	1337580850	1	0.0200000000000005	0.00125000000000003	8477	1
3	Drink 2	Intake 2	39	249753	1337582268	/users/cn/jespinosa/phecomp/data/CRG/20120502_FDF_CRG/20120502_FDF_CRG/20120518_FDF_CRG_c12.mtb	2827	NA	WWSS	water	2	249714	1337582229	1	0.02	0.000512820512820513	8478	1
3	Food 2	Intake 4	226	253447	1337585962	/users/cn/jespinosa/phecomp/data/CRG/20120502_FDF_CRG/20120502_FDF_CRG/20120518_FDF_CRG_c12.mtb	3883	37941	WWSS	food_sc	4	253221	1337585736	1	0.54	0.00238938053097345	8479	1
3	Drink 2	Intake 2	29	253954	1337586469	/users/cn/jespinosa/phecomp/data/CRG/20120502_FDF_CRG/20120502_FDF_CRG/20120518_FDF_CRG_c12.mtb	2828	NA	WWSS	water	2	253925	1337586440	1	0.0600000000000001	0.00206896551724138	8480	1
3	Drink 2	Intake 2	31	254044	1337586559	/users/cn/jespinosa/phecomp/data/CRG/20120502_FDF_CRG/20120502_FDF_CRG/20120518_FDF_CRG_c12.mtb	2829	NA	WWSS	water	2	254013	1337586528	1	0.16	0.00516129032258065	8481	1
3	Drink 1	Intake 1	24	254899	1337587414	/users/cn/jespinosa/phecomp/data/CRG/20120502_FDF_CRG/20120502_FDF_CRG/20120518_FDF_CRG_c12.mtb	1313	NA	WWSS	water	1	254875	1337587390	1	0.0800000000000001	0.00333333333333334	8482	1
3	Drink 1	Intake 1	20	255057	1337587572	/users/cn/jespinosa/phecomp/data/CRG/20120502_FDF_CRG/20120502_FDF_CRG/20120518_FDF_CRG_c12.mtb	1314	NA	WWSS	water	1	255037	1337587552	1	0.0800000000000001	0.00400000000000001	8483	1
3	Drink 2	Intake 2	14	255569	1337588084	/users/cn/jespinosa/phecomp/data/CRG/20120502_FDF_CRG/20120502_FDF_CRG/20120518_FDF_CRG_c12.mtb	2830	NA	WWSS	water	2	255555	1337588070	1	0.04	0.00285714285714286	8484	1
3	Food 1	Intake 3	108	22067	1337624011	/users/cn/jespinosa/phecomp/data/CRG/20120502_FDF_CRG/20120502_FDF_CRG/20120521_FDF_CRG_c12.mtb	2634	18	WWSS	food_sc	3	21959	1337623903	1	0.02	0.000185185185185185	8485	1
3	Food 2	Intake 4	36	22121	1337624065	/users/cn/jespinosa/phecomp/data/CRG/20120502_FDF_CRG/20120502_FDF_CRG/20120521_FDF_CRG_c12.mtb	4524	322	WWSS	food_sc	4	22085	1337624029	1	0.02	0.000555555555555556	8486	1
3	Food 1	Intake 3	163	22606	1337624550	/users/cn/jespinosa/phecomp/data/CRG/20120502_FDF_CRG/20120502_FDF_CRG/20120521_FDF_CRG_c12.mtb	2637	143	WWSS	food_sc	3	22443	1337624387	1	0.02	0.000122699386503067	8487	1
3	Food 1	Intake 3	548	23297	1337625241	/users/cn/jespinosa/phecomp/data/CRG/20120502_FDF_CRG/20120502_FDF_CRG/20120521_FDF_CRG_c12.mtb	2639	2833	WWSS	food_sc	3	22749	1337624693	1	0.12	0.000218978102189781	8488	1
3	Drink 2	Intake 2	23	23354	1337625298	/users/cn/jespinosa/phecomp/data/CRG/20120502_FDF_CRG/20120502_FDF_CRG/20120521_FDF_CRG_c12.mtb	3042	NA	WWSS	water	2	23331	1337625275	1	0.02	0.000869565217391304	8489	1
3	Drink 1	Intake 1	16	23398	1337625342	/users/cn/jespinosa/phecomp/data/CRG/20120502_FDF_CRG/20120502_FDF_CRG/20120521_FDF_CRG_c12.mtb	1598	NA	WWSS	water	1	23382	1337625326	1	0.06	0.00375	8490	1
3	Drink 1	Intake 1	18	24270	1337626214	/users/cn/jespinosa/phecomp/data/CRG/20120502_FDF_CRG/20120502_FDF_CRG/20120521_FDF_CRG_c12.mtb	1599	NA	WWSS	water	1	24252	1337626196	1	0.04	0.00222222222222222	8491	1
3	Drink 1	Intake 1	16	26016	1337627960	/users/cn/jespinosa/phecomp/data/CRG/20120502_FDF_CRG/20120502_FDF_CRG/20120521_FDF_CRG_c12.mtb	1600	NA	WWSS	water	1	26000	1337627944	1	0.02	0.00125	8492	1
3	Drink 2	Intake 2	34	26042	1337627986	/users/cn/jespinosa/phecomp/data/CRG/20120502_FDF_CRG/20120502_FDF_CRG/20120521_FDF_CRG_c12.mtb	3043	NA	WWSS	water	2	26008	1337627952	1	0.06	0.00176470588235294	8493	1
3	Food 1	Intake 3	495	26625	1337628569	/users/cn/jespinosa/phecomp/data/CRG/20120502_FDF_CRG/20120502_FDF_CRG/20120521_FDF_CRG_c12.mtb	2641	804	WWSS	food_sc	3	26130	1337628074	1	0.1	0.000202020202020202	8494	1
3	Drink 1	Intake 1	24	26649	1337628593	/users/cn/jespinosa/phecomp/data/CRG/20120502_FDF_CRG/20120502_FDF_CRG/20120521_FDF_CRG_c12.mtb	1601	NA	WWSS	water	1	26625	1337628569	1	0.1	0.00416666666666667	8495	1
3	Food 1	Intake 3	586	28015	1337629959	/users/cn/jespinosa/phecomp/data/CRG/20120502_FDF_CRG/20120502_FDF_CRG/20120521_FDF_CRG_c12.mtb	2642	1078	WWSS	food_sc	3	27429	1337629373	1	0.24	0.000409556313993174	8496	1
3	Drink 1	Intake 1	28	28045	1337629989	/users/cn/jespinosa/phecomp/data/CRG/20120502_FDF_CRG/20120502_FDF_CRG/20120521_FDF_CRG_c12.mtb	1602	NA	WWSS	water	1	28017	1337629961	1	0.12	0.00428571428571429	8497	1
3	Drink 2	Intake 2	76	28330	1337630274	/users/cn/jespinosa/phecomp/data/CRG/20120502_FDF_CRG/20120502_FDF_CRG/20120521_FDF_CRG_c12.mtb	3044	NA	WWSS	water	2	28254	1337630198	1	0.08	0.00105263157894737	8498	1
3	Food 1	Intake 3	40	29133	1337631077	/users/cn/jespinosa/phecomp/data/CRG/20120502_FDF_CRG/20120502_FDF_CRG/20120521_FDF_CRG_c12.mtb	2643	312	WWSS	food_sc	3	29093	1337631037	1	0.02	0.0005	8499	1
3	Drink 2	Intake 2	28	29185	1337631129	/users/cn/jespinosa/phecomp/data/CRG/20120502_FDF_CRG/20120502_FDF_CRG/20120521_FDF_CRG_c12.mtb	3046	NA	WWSS	water	2	29157	1337631101	1	0.06	0.00214285714285714	8500	1
3	Food 1	Intake 3	438	29883	1337631827	/users/cn/jespinosa/phecomp/data/CRG/20120502_FDF_CRG/20120502_FDF_CRG/20120521_FDF_CRG_c12.mtb	2644	2721	WWSS	food_sc	3	29445	1337631389	1	0.16	0.000365296803652968	8501	1
3	Drink 1	Intake 1	16	29898	1337631842	/users/cn/jespinosa/phecomp/data/CRG/20120502_FDF_CRG/20120502_FDF_CRG/20120521_FDF_CRG_c12.mtb	1604	NA	WWSS	water	1	29882	1337631826	1	0.04	0.0025	8502	1
3	Drink 1	Intake 1	18	30074	1337632018	/users/cn/jespinosa/phecomp/data/CRG/20120502_FDF_CRG/20120502_FDF_CRG/20120521_FDF_CRG_c12.mtb	1605	NA	WWSS	water	1	30056	1337632000	1	0.04	0.00222222222222222	8503	1
3	Food 1	Intake 3	577	33181	1337635125	/users/cn/jespinosa/phecomp/data/CRG/20120502_FDF_CRG/20120502_FDF_CRG/20120521_FDF_CRG_c12.mtb	2647	2008	WWSS	food_sc	3	32604	1337634548	1	0.24	0.000415944540727903	8504	1
3	Drink 1	Intake 1	15	33197	1337635141	/users/cn/jespinosa/phecomp/data/CRG/20120502_FDF_CRG/20120502_FDF_CRG/20120521_FDF_CRG_c12.mtb	1606	NA	WWSS	water	1	33182	1337635126	1	0.04	0.00266666666666667	8505	1
3	Drink 1	Intake 1	15	33275	1337635219	/users/cn/jespinosa/phecomp/data/CRG/20120502_FDF_CRG/20120502_FDF_CRG/20120521_FDF_CRG_c12.mtb	1607	NA	WWSS	water	1	33260	1337635204	1	0.02	0.00133333333333333	8506	1
3	Drink 2	Intake 2	15	33608	1337635552	/users/cn/jespinosa/phecomp/data/CRG/20120502_FDF_CRG/20120502_FDF_CRG/20120521_FDF_CRG_c12.mtb	3048	NA	WWSS	water	2	33593	1337635537	1	0.02	0.00133333333333333	8507	1
3	Drink 2	Intake 2	44	33801	1337635745	/users/cn/jespinosa/phecomp/data/CRG/20120502_FDF_CRG/20120502_FDF_CRG/20120521_FDF_CRG_c12.mtb	3049	NA	WWSS	water	2	33757	1337635701	1	0.02	0.000454545454545455	8508	1
3	Drink 1	Intake 1	15	33812	1337635756	/users/cn/jespinosa/phecomp/data/CRG/20120502_FDF_CRG/20120502_FDF_CRG/20120521_FDF_CRG_c12.mtb	1608	NA	WWSS	water	1	33797	1337635741	1	0.02	0.00133333333333333	8509	1
3	Drink 2	Intake 2	16	34042	1337635986	/users/cn/jespinosa/phecomp/data/CRG/20120502_FDF_CRG/20120502_FDF_CRG/20120521_FDF_CRG_c12.mtb	3050	NA	WWSS	water	2	34026	1337635970	1	0.02	0.00125	8510	1
3	Drink 2	Intake 2	22	34337	1337636281	/users/cn/jespinosa/phecomp/data/CRG/20120502_FDF_CRG/20120502_FDF_CRG/20120521_FDF_CRG_c12.mtb	3051	NA	WWSS	water	2	34315	1337636259	1	0.04	0.00181818181818182	8511	1
3	Food 1	Intake 3	477	35666	1337637610	/users/cn/jespinosa/phecomp/data/CRG/20120502_FDF_CRG/20120502_FDF_CRG/20120521_FDF_CRG_c12.mtb	2649	4315	WWSS	food_sc	3	35189	1337637133	1	0.6	0.00125786163522013	8512	1
3	Drink 1	Intake 1	13	35861	1337637805	/users/cn/jespinosa/phecomp/data/CRG/20120502_FDF_CRG/20120502_FDF_CRG/20120521_FDF_CRG_c12.mtb	1609	NA	WWSS	water	1	35848	1337637792	1	0.08	0.00615384615384615	8513	1
3	Drink 2	Intake 2	18	35951	1337637895	/users/cn/jespinosa/phecomp/data/CRG/20120502_FDF_CRG/20120502_FDF_CRG/20120521_FDF_CRG_c12.mtb	3053	NA	WWSS	water	2	35933	1337637877	1	0.08	0.00444444444444444	8514	1
3	Drink 1	Intake 1	15	36438	1337638382	/users/cn/jespinosa/phecomp/data/CRG/20120502_FDF_CRG/20120502_FDF_CRG/20120521_FDF_CRG_c12.mtb	1610	NA	WWSS	water	1	36423	1337638367	1	0.02	0.00133333333333333	8515	1
3	Drink 2	Intake 2	29	36773	1337638717	/users/cn/jespinosa/phecomp/data/CRG/20120502_FDF_CRG/20120502_FDF_CRG/20120521_FDF_CRG_c12.mtb	3054	NA	WWSS	water	2	36744	1337638688	1	0.08	0.00275862068965517	8516	1
3	Drink 1	Intake 1	44	36892	1337638836	/users/cn/jespinosa/phecomp/data/CRG/20120502_FDF_CRG/20120502_FDF_CRG/20120521_FDF_CRG_c12.mtb	1611	NA	WWSS	water	1	36848	1337638792	1	0.02	0.000454545454545455	8517	1
3	Drink 1	Intake 1	18	37051	1337638995	/users/cn/jespinosa/phecomp/data/CRG/20120502_FDF_CRG/20120502_FDF_CRG/20120521_FDF_CRG_c12.mtb	1612	NA	WWSS	water	1	37033	1337638977	1	0.04	0.00222222222222222	8518	1
3	Drink 2	Intake 2	41	38360	1337640304	/users/cn/jespinosa/phecomp/data/CRG/20120502_FDF_CRG/20120502_FDF_CRG/20120521_FDF_CRG_c12.mtb	3056	NA	WWSS	water	2	38319	1337640263	1	0.0600000000000001	0.00146341463414634	8519	1
3	Drink 1	Intake 1	17	38384	1337640328	/users/cn/jespinosa/phecomp/data/CRG/20120502_FDF_CRG/20120502_FDF_CRG/20120521_FDF_CRG_c12.mtb	1613	NA	WWSS	water	1	38367	1337640311	1	0.0599999999999999	0.00352941176470588	8520	1
3	Food 1	Intake 3	48	40029	1337641973	/users/cn/jespinosa/phecomp/data/CRG/20120502_FDF_CRG/20120502_FDF_CRG/20120521_FDF_CRG_c12.mtb	2652	5121	WWSS	food_sc	3	39981	1337641925	1	0.02	0.000416666666666667	8521	1
3	Drink 1	Intake 1	14	40279	1337642223	/users/cn/jespinosa/phecomp/data/CRG/20120502_FDF_CRG/20120502_FDF_CRG/20120521_FDF_CRG_c12.mtb	1614	NA	WWSS	water	1	40265	1337642209	1	0.04	0.00285714285714286	8522	1
3	Food 1	Intake 3	46	45196	1337647140	/users/cn/jespinosa/phecomp/data/CRG/20120502_FDF_CRG/20120502_FDF_CRG/20120521_FDF_CRG_c12.mtb	2657	564	WWSS	food_sc	3	45150	1337647094	1	0.02	0.000434782608695652	8523	1
3	Drink 2	Intake 2	18	45536	1337647480	/users/cn/jespinosa/phecomp/data/CRG/20120502_FDF_CRG/20120502_FDF_CRG/20120521_FDF_CRG_c12.mtb	3060	NA	WWSS	water	2	45518	1337647462	1	0.0399999999999999	0.00222222222222222	8524	1
3	Food 2	Intake 4	51	45811	1337647755	/users/cn/jespinosa/phecomp/data/CRG/20120502_FDF_CRG/20120502_FDF_CRG/20120521_FDF_CRG_c12.mtb	4561	18	WWSS	food_sc	4	45760	1337647704	1	0.02	0.000392156862745098	8525	1
3	Food 2	Intake 4	575	46404	1337648348	/users/cn/jespinosa/phecomp/data/CRG/20120502_FDF_CRG/20120502_FDF_CRG/20120521_FDF_CRG_c12.mtb	4562	2549	WWSS	food_sc	4	45829	1337647773	1	0.2	0.000347826086956522	8526	1
3	Drink 1	Intake 1	30	46429	1337648373	/users/cn/jespinosa/phecomp/data/CRG/20120502_FDF_CRG/20120502_FDF_CRG/20120521_FDF_CRG_c12.mtb	1615	NA	WWSS	water	1	46399	1337648343	1	0.14	0.00466666666666667	8527	1
3	Drink 2	Intake 2	14	46489	1337648433	/users/cn/jespinosa/phecomp/data/CRG/20120502_FDF_CRG/20120502_FDF_CRG/20120521_FDF_CRG_c12.mtb	3061	NA	WWSS	water	2	46475	1337648419	1	0.02	0.00142857142857143	8528	1
3	Drink 2	Intake 2	10	46942	1337648886	/users/cn/jespinosa/phecomp/data/CRG/20120502_FDF_CRG/20120502_FDF_CRG/20120521_FDF_CRG_c12.mtb	3064	NA	WWSS	water	2	46932	1337648876	1	0.02	0.002	8529	1
3	Drink 2	Intake 2	35	47147	1337649091	/users/cn/jespinosa/phecomp/data/CRG/20120502_FDF_CRG/20120502_FDF_CRG/20120521_FDF_CRG_c12.mtb	3065	NA	WWSS	water	2	47112	1337649056	1	0.0600000000000001	0.00171428571428572	8530	1
3	Food 2	Intake 4	28	48981	1337650925	/users/cn/jespinosa/phecomp/data/CRG/20120502_FDF_CRG/20120502_FDF_CRG/20120521_FDF_CRG_c12.mtb	4569	7028	WWSS	food_sc	4	48953	1337650897	1	0.02	0.000714285714285714	8531	1
3	Food 1	Intake 3	54	56063	1337658007	/users/cn/jespinosa/phecomp/data/CRG/20120502_FDF_CRG/20120502_FDF_CRG/20120521_FDF_CRG_c12.mtb	2663	218	WWSS	food_sc	3	56009	1337657953	1	0.02	0.00037037037037037	8532	1
3	Food 1	Intake 3	120	56401	1337658345	/users/cn/jespinosa/phecomp/data/CRG/20120502_FDF_CRG/20120502_FDF_CRG/20120521_FDF_CRG_c12.mtb	2666	6	WWSS	food_sc	3	56281	1337658225	1	0.02	0.000166666666666667	8533	1
3	Food 1	Intake 3	500	56907	1337658851	/users/cn/jespinosa/phecomp/data/CRG/20120502_FDF_CRG/20120502_FDF_CRG/20120521_FDF_CRG_c12.mtb	2667	130	WWSS	food_sc	3	56407	1337658351	1	0.0799999999999998	0.00016	8534	1
3	Drink 2	Intake 2	20	56939	1337658883	/users/cn/jespinosa/phecomp/data/CRG/20120502_FDF_CRG/20120502_FDF_CRG/20120521_FDF_CRG_c12.mtb	3066	NA	WWSS	water	2	56919	1337658863	1	0.0599999999999999	0.00299999999999999	8535	1
3	Drink 2	Intake 2	17	57045	1337658989	/users/cn/jespinosa/phecomp/data/CRG/20120502_FDF_CRG/20120502_FDF_CRG/20120521_FDF_CRG_c12.mtb	3067	NA	WWSS	water	2	57028	1337658972	1	0.02	0.00117647058823529	8536	1
3	Food 2	Intake 4	516	57553	1337659497	/users/cn/jespinosa/phecomp/data/CRG/20120502_FDF_CRG/20120502_FDF_CRG/20120521_FDF_CRG_c12.mtb	4575	4725	WWSS	food_sc	4	57037	1337658981	1	0.08	0.000155038759689922	8537	1
3	Drink 2	Intake 2	33	57589	1337659533	/users/cn/jespinosa/phecomp/data/CRG/20120502_FDF_CRG/20120502_FDF_CRG/20120521_FDF_CRG_c12.mtb	3068	NA	WWSS	water	2	57556	1337659500	1	0.16	0.00484848484848485	8538	1
3	Drink 2	Intake 2	23	57677	1337659621	/users/cn/jespinosa/phecomp/data/CRG/20120502_FDF_CRG/20120502_FDF_CRG/20120521_FDF_CRG_c12.mtb	3069	NA	WWSS	water	2	57654	1337659598	1	0.0599999999999999	0.00260869565217391	8539	1
3	Drink 1	Intake 1	18	58103	1337660047	/users/cn/jespinosa/phecomp/data/CRG/20120502_FDF_CRG/20120502_FDF_CRG/20120521_FDF_CRG_c12.mtb	1617	NA	WWSS	water	1	58085	1337660029	1	0.0399999999999999	0.00222222222222222	8540	1
3	Food 2	Intake 4	372	62650	1337664594	/users/cn/jespinosa/phecomp/data/CRG/20120502_FDF_CRG/20120502_FDF_CRG/20120521_FDF_CRG_c12.mtb	4582	178	WWSS	food_sc	4	62278	1337664222	1	0.12	0.00032258064516129	8541	1
3	Drink 1	Intake 1	18	62718	1337664662	/users/cn/jespinosa/phecomp/data/CRG/20120502_FDF_CRG/20120502_FDF_CRG/20120521_FDF_CRG_c12.mtb	1619	NA	WWSS	water	1	62700	1337664644	1	0.0600000000000001	0.00333333333333334	8542	1
3	Food 2	Intake 4	329	63157	1337665101	/users/cn/jespinosa/phecomp/data/CRG/20120502_FDF_CRG/20120502_FDF_CRG/20120521_FDF_CRG_c12.mtb	4585	1136	WWSS	food_sc	4	62828	1337664772	1	0.12	0.000364741641337386	8543	1
3	Drink 2	Intake 2	36	63205	1337665149	/users/cn/jespinosa/phecomp/data/CRG/20120502_FDF_CRG/20120502_FDF_CRG/20120521_FDF_CRG_c12.mtb	3074	NA	WWSS	water	2	63169	1337665113	1	0.16	0.00444444444444444	8544	1
3	Drink 2	Intake 2	22	63245	1337665189	/users/cn/jespinosa/phecomp/data/CRG/20120502_FDF_CRG/20120502_FDF_CRG/20120521_FDF_CRG_c12.mtb	3075	NA	WWSS	water	2	63223	1337665167	1	0.0599999999999998	0.00272727272727272	8545	1
3	Drink 2	Intake 2	12	63533	1337665477	/users/cn/jespinosa/phecomp/data/CRG/20120502_FDF_CRG/20120502_FDF_CRG/20120521_FDF_CRG_c12.mtb	3077	NA	WWSS	water	2	63521	1337665465	1	0.02	0.00166666666666667	8546	1
3	Drink 2	Intake 2	19	64085	1337666029	/users/cn/jespinosa/phecomp/data/CRG/20120502_FDF_CRG/20120502_FDF_CRG/20120521_FDF_CRG_c12.mtb	3078	NA	WWSS	water	2	64066	1337666010	1	0.02	0.00105263157894737	8547	1
3	Food 2	Intake 4	132	64425	1337666369	/users/cn/jespinosa/phecomp/data/CRG/20120502_FDF_CRG/20120502_FDF_CRG/20120521_FDF_CRG_c12.mtb	4591	43846	WWSS	food_sc	4	64293	1337666237	1	0.4	0.00303030303030303	8548	1
3	Drink 2	Intake 2	28	64850	1337666794	/users/cn/jespinosa/phecomp/data/CRG/20120502_FDF_CRG/20120502_FDF_CRG/20120521_FDF_CRG_c12.mtb	3079	NA	WWSS	water	2	64822	1337666766	1	0.14	0.005	8549	1
3	Drink 2	Intake 2	20	64956	1337666900	/users/cn/jespinosa/phecomp/data/CRG/20120502_FDF_CRG/20120502_FDF_CRG/20120521_FDF_CRG_c12.mtb	3080	NA	WWSS	water	2	64936	1337666880	1	0.0600000000000001	0.00300000000000001	8550	1
3	Drink 2	Intake 2	25	65212	1337667156	/users/cn/jespinosa/phecomp/data/CRG/20120502_FDF_CRG/20120502_FDF_CRG/20120521_FDF_CRG_c12.mtb	3082	NA	WWSS	water	2	65187	1337667131	1	0.0600000000000001	0.0024	8551	1
3	Drink 2	Intake 2	15	65740	1337667684	/users/cn/jespinosa/phecomp/data/CRG/20120502_FDF_CRG/20120502_FDF_CRG/20120521_FDF_CRG_c12.mtb	3083	NA	WWSS	water	2	65725	1337667669	1	0.02	0.00133333333333333	8552	1
3	Drink 1	Intake 1	13	70234	1337672178	/users/cn/jespinosa/phecomp/data/CRG/20120502_FDF_CRG/20120502_FDF_CRG/20120521_FDF_CRG_c12.mtb	1622	NA	WWSS	water	1	70221	1337672165	1	0.04	0.00307692307692308	8553	1
3	Drink 1	Intake 1	9	81821	1337683765	/users/cn/jespinosa/phecomp/data/CRG/20120502_FDF_CRG/20120502_FDF_CRG/20120521_FDF_CRG_c12.mtb	1623	NA	WWSS	water	1	81812	1337683756	1	0.02	0.00222222222222222	8554	1
3	Food 1	Intake 3	391	108662	1337710606	/users/cn/jespinosa/phecomp/data/CRG/20120502_FDF_CRG/20120502_FDF_CRG/20120521_FDF_CRG_c12.mtb	2680	11	WWSS	food_sc	3	108271	1337710215	1	0.02	5.1150895140665e-05	8555	1
3	Food 1	Intake 3	59	108732	1337710676	/users/cn/jespinosa/phecomp/data/CRG/20120502_FDF_CRG/20120502_FDF_CRG/20120521_FDF_CRG_c12.mtb	2681	1267	WWSS	food_sc	3	108673	1337710617	1	0.02	0.000338983050847458	8556	1
3	Drink 2	Intake 2	21	108868	1337710812	/users/cn/jespinosa/phecomp/data/CRG/20120502_FDF_CRG/20120502_FDF_CRG/20120521_FDF_CRG_c12.mtb	3086	NA	WWSS	water	2	108847	1337710791	1	0.04	0.0019047619047619	8557	1
3	Drink 2	Intake 2	18	109069	1337711013	/users/cn/jespinosa/phecomp/data/CRG/20120502_FDF_CRG/20120502_FDF_CRG/20120521_FDF_CRG_c12.mtb	3087	NA	WWSS	water	2	109051	1337710995	1	0.02	0.00111111111111111	8558	1
3	Food 2	Intake 4	110	110109	1337712053	/users/cn/jespinosa/phecomp/data/CRG/20120502_FDF_CRG/20120502_FDF_CRG/20120521_FDF_CRG_c12.mtb	4615	264	WWSS	food_sc	4	109999	1337711943	1	0.04	0.000363636363636364	8559	1
3	Food 2	Intake 4	69	110442	1337712386	/users/cn/jespinosa/phecomp/data/CRG/20120502_FDF_CRG/20120502_FDF_CRG/20120521_FDF_CRG_c12.mtb	4618	151	WWSS	food_sc	4	110373	1337712317	1	0.02	0.000289855072463768	8560	1
3	Food 1	Intake 3	330	110923	1337712867	/users/cn/jespinosa/phecomp/data/CRG/20120502_FDF_CRG/20120502_FDF_CRG/20120521_FDF_CRG_c12.mtb	2687	140	WWSS	food_sc	3	110593	1337712537	1	0.02	6.06060606060606e-05	8561	1
3	Drink 2	Intake 2	24	110936	1337712880	/users/cn/jespinosa/phecomp/data/CRG/20120502_FDF_CRG/20120502_FDF_CRG/20120521_FDF_CRG_c12.mtb	3092	NA	WWSS	water	2	110912	1337712856	1	0.0600000000000001	0.0025	8562	1
3	Drink 2	Intake 2	21	111027	1337712971	/users/cn/jespinosa/phecomp/data/CRG/20120502_FDF_CRG/20120502_FDF_CRG/20120521_FDF_CRG_c12.mtb	3093	NA	WWSS	water	2	111006	1337712950	1	0.02	0.000952380952380952	8563	1
3	Food 1	Intake 3	460	111523	1337713467	/users/cn/jespinosa/phecomp/data/CRG/20120502_FDF_CRG/20120502_FDF_CRG/20120521_FDF_CRG_c12.mtb	2688	37	WWSS	food_sc	3	111063	1337713007	1	0.02	4.34782608695652e-05	8564	1
3	Drink 2	Intake 2	33	111555	1337713499	/users/cn/jespinosa/phecomp/data/CRG/20120502_FDF_CRG/20120502_FDF_CRG/20120521_FDF_CRG_c12.mtb	3094	NA	WWSS	water	2	111522	1337713466	1	0.0599999999999998	0.00181818181818181	8565	1
3	Food 1	Intake 3	770	112330	1337714274	/users/cn/jespinosa/phecomp/data/CRG/20120502_FDF_CRG/20120502_FDF_CRG/20120521_FDF_CRG_c12.mtb	2689	128	WWSS	food_sc	3	111560	1337713504	1	0.12	0.000155844155844156	8566	1
3	Drink 1	Intake 1	23	112345	1337714289	/users/cn/jespinosa/phecomp/data/CRG/20120502_FDF_CRG/20120502_FDF_CRG/20120521_FDF_CRG_c12.mtb	1628	NA	WWSS	water	1	112322	1337714266	1	0.12	0.00521739130434783	8567	1
3	Drink 2	Intake 2	21	112432	1337714376	/users/cn/jespinosa/phecomp/data/CRG/20120502_FDF_CRG/20120502_FDF_CRG/20120521_FDF_CRG_c12.mtb	3095	NA	WWSS	water	2	112411	1337714355	1	0.04	0.0019047619047619	8568	1
3	Food 1	Intake 3	610	113068	1337715012	/users/cn/jespinosa/phecomp/data/CRG/20120502_FDF_CRG/20120502_FDF_CRG/20120521_FDF_CRG_c12.mtb	2690	768	WWSS	food_sc	3	112458	1337714402	1	0.2	0.000327868852459016	8569	1
3	Drink 1	Intake 1	14	113074	1337715018	/users/cn/jespinosa/phecomp/data/CRG/20120502_FDF_CRG/20120502_FDF_CRG/20120521_FDF_CRG_c12.mtb	1629	NA	WWSS	water	1	113060	1337715004	1	0.1	0.00714285714285714	8570	1
3	Drink 2	Intake 2	20	113114	1337715058	/users/cn/jespinosa/phecomp/data/CRG/20120502_FDF_CRG/20120502_FDF_CRG/20120521_FDF_CRG_c12.mtb	3096	NA	WWSS	water	2	113094	1337715038	1	0.02	0.001	8571	1
3	Food 1	Intake 3	550	114386	1337716330	/users/cn/jespinosa/phecomp/data/CRG/20120502_FDF_CRG/20120502_FDF_CRG/20120521_FDF_CRG_c12.mtb	2691	981	WWSS	food_sc	3	113836	1337715780	1	0.14	0.000254545454545455	8572	1
3	Drink 2	Intake 2	22	114400	1337716344	/users/cn/jespinosa/phecomp/data/CRG/20120502_FDF_CRG/20120502_FDF_CRG/20120521_FDF_CRG_c12.mtb	3097	NA	WWSS	water	2	114378	1337716322	1	0.12	0.00545454545454545	8573	1
3	Drink 1	Intake 1	16	114809	1337716753	/users/cn/jespinosa/phecomp/data/CRG/20120502_FDF_CRG/20120502_FDF_CRG/20120521_FDF_CRG_c12.mtb	1630	NA	WWSS	water	1	114793	1337716737	1	0.02	0.00125	8574	1
3	Food 1	Intake 3	764	116131	1337718075	/users/cn/jespinosa/phecomp/data/CRG/20120502_FDF_CRG/20120502_FDF_CRG/20120521_FDF_CRG_c12.mtb	2692	688	WWSS	food_sc	3	115367	1337717311	1	0.14	0.000183246073298429	8575	1
3	Drink 2	Intake 2	23	116146	1337718090	/users/cn/jespinosa/phecomp/data/CRG/20120502_FDF_CRG/20120502_FDF_CRG/20120521_FDF_CRG_c12.mtb	3098	NA	WWSS	water	2	116123	1337718067	1	0.0800000000000001	0.00347826086956522	8576	1
3	Drink 1	Intake 1	17	116220	1337718164	/users/cn/jespinosa/phecomp/data/CRG/20120502_FDF_CRG/20120502_FDF_CRG/20120521_FDF_CRG_c12.mtb	1631	NA	WWSS	water	1	116203	1337718147	1	0.04	0.00235294117647059	8577	1
3	Drink 2	Intake 2	18	116574	1337718518	/users/cn/jespinosa/phecomp/data/CRG/20120502_FDF_CRG/20120502_FDF_CRG/20120521_FDF_CRG_c12.mtb	3100	NA	WWSS	water	2	116556	1337718500	1	0.04	0.00222222222222222	8578	1
3	Food 1	Intake 3	72	116891	1337718835	/users/cn/jespinosa/phecomp/data/CRG/20120502_FDF_CRG/20120502_FDF_CRG/20120521_FDF_CRG_c12.mtb	2694	3670	WWSS	food_sc	3	116819	1337718763	1	0.02	0.000277777777777778	8579	1
3	Drink 1	Intake 1	25	116975	1337718919	/users/cn/jespinosa/phecomp/data/CRG/20120502_FDF_CRG/20120502_FDF_CRG/20120521_FDF_CRG_c12.mtb	1632	NA	WWSS	water	1	116950	1337718894	1	0.0599999999999998	0.00239999999999999	8580	1
3	Drink 2	Intake 2	18	119953	1337721897	/users/cn/jespinosa/phecomp/data/CRG/20120502_FDF_CRG/20120502_FDF_CRG/20120521_FDF_CRG_c12.mtb	3101	NA	WWSS	water	2	119935	1337721879	1	0.04	0.00222222222222222	8581	1
3	Food 1	Intake 3	304	120865	1337722809	/users/cn/jespinosa/phecomp/data/CRG/20120502_FDF_CRG/20120502_FDF_CRG/20120521_FDF_CRG_c12.mtb	2706	244	WWSS	food_sc	3	120561	1337722505	1	0.02	6.57894736842105e-05	8582	1
3	Drink 2	Intake 2	21	120881	1337722825	/users/cn/jespinosa/phecomp/data/CRG/20120502_FDF_CRG/20120502_FDF_CRG/20120521_FDF_CRG_c12.mtb	3102	NA	WWSS	water	2	120860	1337722804	1	0.04	0.0019047619047619	8583	1
3	Drink 2	Intake 2	23	120955	1337722899	/users/cn/jespinosa/phecomp/data/CRG/20120502_FDF_CRG/20120502_FDF_CRG/20120521_FDF_CRG_c12.mtb	3103	NA	WWSS	water	2	120932	1337722876	1	0.02	0.000869565217391304	8584	1
3	Food 1	Intake 3	1177	122286	1337724230	/users/cn/jespinosa/phecomp/data/CRG/20120502_FDF_CRG/20120502_FDF_CRG/20120521_FDF_CRG_c12.mtb	2707	606	WWSS	food_sc	3	121109	1337723053	1	0.32	0.000271877655055225	8585	1
3	Drink 2	Intake 2	38	122321	1337724265	/users/cn/jespinosa/phecomp/data/CRG/20120502_FDF_CRG/20120502_FDF_CRG/20120521_FDF_CRG_c12.mtb	3104	NA	WWSS	water	2	122283	1337724227	1	0.18	0.00473684210526316	8586	1
3	Drink 2	Intake 2	19	122379	1337724323	/users/cn/jespinosa/phecomp/data/CRG/20120502_FDF_CRG/20120502_FDF_CRG/20120521_FDF_CRG_c12.mtb	3105	NA	WWSS	water	2	122360	1337724304	1	0.04	0.00210526315789474	8587	1
3	Drink 2	Intake 2	26	122652	1337724596	/users/cn/jespinosa/phecomp/data/CRG/20120502_FDF_CRG/20120502_FDF_CRG/20120521_FDF_CRG_c12.mtb	3106	NA	WWSS	water	2	122626	1337724570	1	0.02	0.000769230769230769	8588	1
3	Drink 2	Intake 2	20	122810	1337724754	/users/cn/jespinosa/phecomp/data/CRG/20120502_FDF_CRG/20120502_FDF_CRG/20120521_FDF_CRG_c12.mtb	3107	NA	WWSS	water	2	122790	1337724734	1	0.02	0.001	8589	1
3	Food 1	Intake 3	488	123380	1337725324	/users/cn/jespinosa/phecomp/data/CRG/20120502_FDF_CRG/20120502_FDF_CRG/20120521_FDF_CRG_c12.mtb	2710	1162	WWSS	food_sc	3	122892	1337724836	1	0.3	0.000614754098360656	8590	1
3	Drink 2	Intake 2	29	123408	1337725352	/users/cn/jespinosa/phecomp/data/CRG/20120502_FDF_CRG/20120502_FDF_CRG/20120521_FDF_CRG_c12.mtb	3108	NA	WWSS	water	2	123379	1337725323	1	0.12	0.00413793103448276	8591	1
3	Drink 1	Intake 1	18	123734	1337725678	/users/cn/jespinosa/phecomp/data/CRG/20120502_FDF_CRG/20120502_FDF_CRG/20120521_FDF_CRG_c12.mtb	1633	NA	WWSS	water	1	123716	1337725660	1	0.04	0.00222222222222222	8592	1
3	Drink 2	Intake 2	15	124050	1337725994	/users/cn/jespinosa/phecomp/data/CRG/20120502_FDF_CRG/20120502_FDF_CRG/20120521_FDF_CRG_c12.mtb	3110	NA	WWSS	water	2	124035	1337725979	1	0.02	0.00133333333333333	8593	1
3	Food 1	Intake 3	345	124887	1337726831	/users/cn/jespinosa/phecomp/data/CRG/20120502_FDF_CRG/20120502_FDF_CRG/20120521_FDF_CRG_c12.mtb	2712	4746	WWSS	food_sc	3	124542	1337726486	1	0.42	0.00121739130434783	8594	1
3	Drink 2	Intake 2	49	125189	1337727133	/users/cn/jespinosa/phecomp/data/CRG/20120502_FDF_CRG/20120502_FDF_CRG/20120521_FDF_CRG_c12.mtb	3111	NA	WWSS	water	2	125140	1337727084	1	0.16	0.00326530612244898	8595	1
3	Drink 2	Intake 2	17	125223	1337727167	/users/cn/jespinosa/phecomp/data/CRG/20120502_FDF_CRG/20120502_FDF_CRG/20120521_FDF_CRG_c12.mtb	3112	NA	WWSS	water	2	125206	1337727150	1	0.02	0.00117647058823529	8596	1
3	Drink 1	Intake 1	18	125597	1337727541	/users/cn/jespinosa/phecomp/data/CRG/20120502_FDF_CRG/20120502_FDF_CRG/20120521_FDF_CRG_c12.mtb	1635	NA	WWSS	water	1	125579	1337727523	1	0.02	0.00111111111111111	8597	1
3	Drink 2	Intake 2	46	125739	1337727683	/users/cn/jespinosa/phecomp/data/CRG/20120502_FDF_CRG/20120502_FDF_CRG/20120521_FDF_CRG_c12.mtb	3118	NA	WWSS	water	2	125693	1337727637	1	0.0200000000000005	0.000434782608695663	8598	1
3	Drink 2	Intake 2	18	125873	1337727817	/users/cn/jespinosa/phecomp/data/CRG/20120502_FDF_CRG/20120502_FDF_CRG/20120521_FDF_CRG_c12.mtb	3121	NA	WWSS	water	2	125855	1337727799	1	0.0200000000000005	0.00111111111111114	8599	1
3	Drink 1	Intake 1	15	126345	1337728289	/users/cn/jespinosa/phecomp/data/CRG/20120502_FDF_CRG/20120502_FDF_CRG/20120521_FDF_CRG_c12.mtb	1636	NA	WWSS	water	1	126330	1337728274	1	0.04	0.00266666666666667	8600	1
3	Drink 2	Intake 2	19	126565	1337728509	/users/cn/jespinosa/phecomp/data/CRG/20120502_FDF_CRG/20120502_FDF_CRG/20120521_FDF_CRG_c12.mtb	3124	NA	WWSS	water	2	126546	1337728490	1	0.0399999999999996	0.00210526315789472	8601	1
3	Drink 2	Intake 2	20	127218	1337729162	/users/cn/jespinosa/phecomp/data/CRG/20120502_FDF_CRG/20120502_FDF_CRG/20120521_FDF_CRG_c12.mtb	3127	NA	WWSS	water	2	127198	1337729142	1	0.02	0.001	8602	1
3	Food 1	Intake 3	15	129648	1337731592	/users/cn/jespinosa/phecomp/data/CRG/20120502_FDF_CRG/20120502_FDF_CRG/20120521_FDF_CRG_c12.mtb	2713	2683	WWSS	food_sc	3	129633	1337731577	1	0.02	0.00133333333333333	8603	1
3	Food 1	Intake 3	773	133104	1337735048	/users/cn/jespinosa/phecomp/data/CRG/20120502_FDF_CRG/20120502_FDF_CRG/20120521_FDF_CRG_c12.mtb	2720	967	WWSS	food_sc	3	132331	1337734275	1	0.3	0.000388098318240621	8604	1
3	Drink 2	Intake 2	28	133129	1337735073	/users/cn/jespinosa/phecomp/data/CRG/20120502_FDF_CRG/20120502_FDF_CRG/20120521_FDF_CRG_c12.mtb	3130	NA	WWSS	water	2	133101	1337735045	1	0.1	0.00357142857142857	8605	1
3	Drink 2	Intake 2	21	133161	1337735105	/users/cn/jespinosa/phecomp/data/CRG/20120502_FDF_CRG/20120502_FDF_CRG/20120521_FDF_CRG_c12.mtb	3131	NA	WWSS	water	2	133140	1337735084	1	0.04	0.0019047619047619	8606	1
3	Drink 2	Intake 2	22	133298	1337735242	/users/cn/jespinosa/phecomp/data/CRG/20120502_FDF_CRG/20120502_FDF_CRG/20120521_FDF_CRG_c12.mtb	3132	NA	WWSS	water	2	133276	1337735220	1	0.02	0.000909090909090909	8607	1
3	Drink 2	Intake 2	19	133446	1337735390	/users/cn/jespinosa/phecomp/data/CRG/20120502_FDF_CRG/20120502_FDF_CRG/20120521_FDF_CRG_c12.mtb	3133	NA	WWSS	water	2	133427	1337735371	1	0.04	0.00210526315789474	8608	1
3	Drink 1	Intake 1	15	133809	1337735753	/users/cn/jespinosa/phecomp/data/CRG/20120502_FDF_CRG/20120502_FDF_CRG/20120521_FDF_CRG_c12.mtb	1637	NA	WWSS	water	1	133794	1337735738	1	0.0600000000000001	0.00400000000000001	8609	1
3	Food 1	Intake 3	344	134415	1337736359	/users/cn/jespinosa/phecomp/data/CRG/20120502_FDF_CRG/20120502_FDF_CRG/20120521_FDF_CRG_c12.mtb	2724	1521	WWSS	food_sc	3	134071	1337736015	1	0.18	0.000523255813953488	8610	1
3	Drink 2	Intake 2	20	134430	1337736374	/users/cn/jespinosa/phecomp/data/CRG/20120502_FDF_CRG/20120502_FDF_CRG/20120521_FDF_CRG_c12.mtb	3135	NA	WWSS	water	2	134410	1337736354	1	0.0800000000000001	0.00400000000000001	8611	1
3	Drink 1	Intake 1	16	134559	1337736503	/users/cn/jespinosa/phecomp/data/CRG/20120502_FDF_CRG/20120502_FDF_CRG/20120521_FDF_CRG_c12.mtb	1639	NA	WWSS	water	1	134543	1337736487	1	0.04	0.0025	8612	1
3	Food 1	Intake 3	19	135955	1337737899	/users/cn/jespinosa/phecomp/data/CRG/20120502_FDF_CRG/20120502_FDF_CRG/20120521_FDF_CRG_c12.mtb	2725	100	WWSS	food_sc	3	135936	1337737880	1	0.02	0.00105263157894737	8613	1
3	Food 1	Intake 3	23	136078	1337738022	/users/cn/jespinosa/phecomp/data/CRG/20120502_FDF_CRG/20120502_FDF_CRG/20120521_FDF_CRG_c12.mtb	2726	4837	WWSS	food_sc	3	136055	1337737999	1	0.02	0.000869565217391304	8614	1
3	Food 1	Intake 3	391	141306	1337743250	/users/cn/jespinosa/phecomp/data/CRG/20120502_FDF_CRG/20120502_FDF_CRG/20120521_FDF_CRG_c12.mtb	2729	249	WWSS	food_sc	3	140915	1337742859	1	0.0999999999999996	0.000255754475703324	8615	1
3	Drink 1	Intake 1	18	141531	1337743475	/users/cn/jespinosa/phecomp/data/CRG/20120502_FDF_CRG/20120502_FDF_CRG/20120521_FDF_CRG_c12.mtb	1640	NA	WWSS	water	1	141513	1337743457	1	0.0600000000000001	0.00333333333333334	8616	1
3	Food 1	Intake 3	120	141675	1337743619	/users/cn/jespinosa/phecomp/data/CRG/20120502_FDF_CRG/20120502_FDF_CRG/20120521_FDF_CRG_c12.mtb	2730	4197	WWSS	food_sc	3	141555	1337743499	1	0.0200000000000005	0.000166666666666671	8617	1
3	Drink 1	Intake 1	13	141966	1337743910	/users/cn/jespinosa/phecomp/data/CRG/20120502_FDF_CRG/20120502_FDF_CRG/20120521_FDF_CRG_c12.mtb	1641	NA	WWSS	water	1	141953	1337743897	1	0.02	0.00153846153846154	8618	1
3	Food 1	Intake 3	443	146315	1337748259	/users/cn/jespinosa/phecomp/data/CRG/20120502_FDF_CRG/20120502_FDF_CRG/20120521_FDF_CRG_c12.mtb	2753	585	WWSS	food_sc	3	145872	1337747816	1	0.0200000000000005	4.51467268623036e-05	8619	1
3	Food 1	Intake 3	216	147116	1337749060	/users/cn/jespinosa/phecomp/data/CRG/20120502_FDF_CRG/20120502_FDF_CRG/20120521_FDF_CRG_c12.mtb	2758	490	WWSS	food_sc	3	146900	1337748844	1	0.04	0.000185185185185185	8620	1
3	Food 1	Intake 3	318	147924	1337749868	/users/cn/jespinosa/phecomp/data/CRG/20120502_FDF_CRG/20120502_FDF_CRG/20120521_FDF_CRG_c12.mtb	2763	695	WWSS	food_sc	3	147606	1337749550	1	0.3	0.000943396226415094	8621	1
3	Drink 2	Intake 2	17	148426	1337750370	/users/cn/jespinosa/phecomp/data/CRG/20120502_FDF_CRG/20120502_FDF_CRG/20120521_FDF_CRG_c12.mtb	3136	NA	WWSS	water	2	148409	1337750353	1	0.04	0.00235294117647059	8622	1
3	Food 2	Intake 4	263	148882	1337750826	/users/cn/jespinosa/phecomp/data/CRG/20120502_FDF_CRG/20120502_FDF_CRG/20120521_FDF_CRG_c12.mtb	4663	265	WWSS	food_sc	4	148619	1337750563	1	0.04	0.000152091254752852	8623	1
3	Drink 2	Intake 2	15	148904	1337750848	/users/cn/jespinosa/phecomp/data/CRG/20120502_FDF_CRG/20120502_FDF_CRG/20120521_FDF_CRG_c12.mtb	3137	NA	WWSS	water	2	148889	1337750833	1	0.04	0.00266666666666667	8624	1
3	Drink 2	Intake 2	17	149105	1337751049	/users/cn/jespinosa/phecomp/data/CRG/20120502_FDF_CRG/20120502_FDF_CRG/20120521_FDF_CRG_c12.mtb	3138	NA	WWSS	water	2	149088	1337751032	1	0.04	0.00235294117647059	8625	1
3	Food 2	Intake 4	377	149524	1337751468	/users/cn/jespinosa/phecomp/data/CRG/20120502_FDF_CRG/20120502_FDF_CRG/20120521_FDF_CRG_c12.mtb	4666	431	WWSS	food_sc	4	149147	1337751091	1	0.0799999999999998	0.000212201591511936	8626	1
3	Drink 2	Intake 2	27	149551	1337751495	/users/cn/jespinosa/phecomp/data/CRG/20120502_FDF_CRG/20120502_FDF_CRG/20120521_FDF_CRG_c12.mtb	3139	NA	WWSS	water	2	149524	1337751468	1	0.12	0.00444444444444444	8627	1
3	Drink 2	Intake 2	23	149612	1337751556	/users/cn/jespinosa/phecomp/data/CRG/20120502_FDF_CRG/20120502_FDF_CRG/20120521_FDF_CRG_c12.mtb	3140	NA	WWSS	water	2	149589	1337751533	1	0.0800000000000001	0.00347826086956522	8628	1
3	Food 2	Intake 4	464	150419	1337752363	/users/cn/jespinosa/phecomp/data/CRG/20120502_FDF_CRG/20120502_FDF_CRG/20120521_FDF_CRG_c12.mtb	4670	371	WWSS	food_sc	4	149955	1337751899	1	0.16	0.000344827586206897	8629	1
3	Drink 2	Intake 2	47	150468	1337752412	/users/cn/jespinosa/phecomp/data/CRG/20120502_FDF_CRG/20120502_FDF_CRG/20120521_FDF_CRG_c12.mtb	3141	NA	WWSS	water	2	150421	1337752365	1	0.1	0.00212765957446809	8630	1
3	Drink 2	Intake 2	22	150629	1337752573	/users/cn/jespinosa/phecomp/data/CRG/20120502_FDF_CRG/20120502_FDF_CRG/20120521_FDF_CRG_c12.mtb	3142	NA	WWSS	water	2	150607	1337752551	1	0.02	0.000909090909090909	8631	1
3	Food 2	Intake 4	76	150866	1337752810	/users/cn/jespinosa/phecomp/data/CRG/20120502_FDF_CRG/20120502_FDF_CRG/20120521_FDF_CRG_c12.mtb	4673	40	WWSS	food_sc	4	150790	1337752734	1	0.02	0.000263157894736842	8632	1
3	Food 2	Intake 4	227	151133	1337753077	/users/cn/jespinosa/phecomp/data/CRG/20120502_FDF_CRG/20120502_FDF_CRG/20120521_FDF_CRG_c12.mtb	4674	411	WWSS	food_sc	4	150906	1337752850	1	0.0399999999999998	0.000176211453744493	8633	1
3	Drink 1	Intake 1	17	151161	1337753105	/users/cn/jespinosa/phecomp/data/CRG/20120502_FDF_CRG/20120502_FDF_CRG/20120521_FDF_CRG_c12.mtb	1645	NA	WWSS	water	1	151144	1337753088	1	0.0399999999999998	0.00235294117647058	8634	1
3	Food 1	Intake 3	62	151606	1337753550	/users/cn/jespinosa/phecomp/data/CRG/20120502_FDF_CRG/20120502_FDF_CRG/20120521_FDF_CRG_c12.mtb	2766	8956	WWSS	food_sc	3	151544	1337753488	1	0.0200000000000005	0.000322580645161298	8635	1
3	Drink 2	Intake 2	25	151723	1337753667	/users/cn/jespinosa/phecomp/data/CRG/20120502_FDF_CRG/20120502_FDF_CRG/20120521_FDF_CRG_c12.mtb	3143	NA	WWSS	water	2	151698	1337753642	1	0.04	0.0016	8636	1
3	Food 2	Intake 4	730	161292	1337763236	/users/cn/jespinosa/phecomp/data/CRG/20120502_FDF_CRG/20120502_FDF_CRG/20120521_FDF_CRG_c12.mtb	4677	LAST	WWSS	food_sc	4	160562	1337762506	1	0.16	0.000219178082191781	8637	1
3	Drink 2	Intake 2	17	161335	1337763279	/users/cn/jespinosa/phecomp/data/CRG/20120502_FDF_CRG/20120502_FDF_CRG/20120521_FDF_CRG_c12.mtb	3144	NA	WWSS	water	2	161318	1337763262	1	0.02	0.00117647058823529	8638	1
3	Drink 1	Intake 1	14	161409	1337763353	/users/cn/jespinosa/phecomp/data/CRG/20120502_FDF_CRG/20120502_FDF_CRG/20120521_FDF_CRG_c12.mtb	1646	NA	WWSS	water	1	161395	1337763339	1	0.04	0.00285714285714286	8639	1
3	Drink 2	Intake 2	17	161821	1337763765	/users/cn/jespinosa/phecomp/data/CRG/20120502_FDF_CRG/20120502_FDF_CRG/20120521_FDF_CRG_c12.mtb	3145	LAST	WWSS	water	2	161804	1337763748	1	0.02	0.00117647058823529	8640	1
